,battleTime,brawlername,event_mode,event_map,no,yes,total_games
0,2023-02-11,TICK,knockout,Flaring Phoenix,281,214,495
1,2023-02-11,TICK,hotZone,Controller Chaos,236,51,287
2,2023-02-11,TICK,gemGrab,Deep Diner,154,74,228
3,2023-02-11,TICK,brawlBall,Super Beach,115,84,199
4,2023-02-11,TICK,brawlBall,Sneaky Fields,40,27,67
5,2023-02-10,TICK,knockout,Flaring Phoenix,481,361,842
6,2023-02-10,TICK,hotZone,Controller Chaos,250,107,357
7,2023-02-10,TICK,heist,Hot Potato,16,3,19
8,2023-02-10,TICK,gemGrab,Undermine,32,21,53
9,2023-02-10,TICK,gemGrab,Deep Diner,306,220,526
10,2023-02-10,TICK,brawlBall,Sneaky Fields,415,288,703
11,2023-02-10,TICK,brawlBall,Pinhole Punt,5,6,11
12,2023-02-10,TICK,bounty,Temple Ruins,143,97,240
13,2023-02-09,TICK,knockout,Riverside,51,28,79
14,2023-02-09,TICK,hotZone,Open Zone,25,15,40
15,2023-02-09,TICK,heist,Hot Potato,8,0,8
16,2023-02-09,TICK,gemGrab,Undermine,32,15,47
17,2023-02-09,TICK,gemGrab,Gem Fort,4,1,5
18,2023-02-09,TICK,brawlBall,Sunny Soccer,2,0,2
19,2023-02-09,TICK,brawlBall,Pinhole Punt,105,62,167
20,2023-02-09,TICK,bounty,Temple Ruins,42,33,75
21,2023-02-08,TICK,knockout,Riverside,20,20,40
22,2023-02-08,TICK,hotZone,Open Zone,20,6,26
23,2023-02-08,TICK,heist,Safe Zone,7,1,8
24,2023-02-08,TICK,gemGrab,Gem Fort,15,15,30
25,2023-02-08,TICK,gemGrab,Crystal Arcade,7,1,8
26,2023-02-08,TICK,brawlBall,Sunny Soccer,65,41,106
27,2023-02-08,TICK,brawlBall,Beach Ball,3,0,3
28,2023-02-08,TICK,bounty,Excel,76,63,139
29,2023-02-07,TICK,knockout,New Perspective,11,1,12
30,2023-02-07,TICK,hotZone,Dueling Beetles,64,17,81
31,2023-02-07,TICK,heist,Safe Zone,3,1,4
32,2023-02-07,TICK,gemGrab,Minecart Madness,38,8,46
33,2023-02-07,TICK,gemGrab,Crystal Arcade,8,3,11
34,2023-02-07,TICK,brawlBall,Center Stage,3,2,5
35,2023-02-07,TICK,brawlBall,Beach Ball,30,31,61
36,2023-02-07,TICK,bounty,Excel,50,21,71
37,2023-02-06,TICK,knockout,New Perspective,372,263,635
38,2023-02-06,TICK,knockout,Goldarm Gulch,19,19,38
39,2023-02-06,TICK,hotZone,Dueling Beetles,799,258,1057
40,2023-02-06,TICK,heist,Snaked Assault,19,3,22
41,2023-02-06,TICK,heist,Pit Stop,2,0,2
42,2023-02-06,TICK,gemGrab,Minecart Madness,1059,745,1804
43,2023-02-06,TICK,gemGrab,Double Swoosh,96,46,142
44,2023-02-06,TICK,brawlBall,Sneaky Fields,4,7,11
45,2023-02-06,TICK,brawlBall,Center Stage,673,440,1113
46,2023-02-06,TICK,brawlBall,Backyard Bowl,61,34,95
47,2023-02-06,TICK,bounty,Layer Cake,683,492,1175
48,2023-02-05,TICK,knockout,X Marks the Spot,333,288,621
49,2023-02-05,TICK,knockout,Goldarm Gulch,82,45,127
50,2023-02-05,TICK,hotZone,Ring of Fire,425,160,585
51,2023-02-05,TICK,heist,Snaked Assault,28,6,34
52,2023-02-05,TICK,heist,Pit Stop,9,0,9
53,2023-02-05,TICK,gemGrab,Hard Rock Mine,36,10,46
54,2023-02-05,TICK,gemGrab,Double Swoosh,274,153,427
55,2023-02-05,TICK,brawlBall,Super Beach,14,10,24
56,2023-02-05,TICK,brawlBall,Sneaky Fields,13,3,16
57,2023-02-05,TICK,brawlBall,Backyard Bowl,491,269,760
58,2023-02-05,TICK,bounty,Layer Cake,755,601,1356
59,2023-02-04,TICK,knockout,X Marks the Spot,128,118,246
60,2023-02-04,TICK,knockout,Goldarm Gulch,37,22,59
61,2023-02-04,TICK,hotZone,Ring of Fire,76,48,124
62,2023-02-04,TICK,heist,Tornado Ring,3,1,4
63,2023-02-04,TICK,heist,Pit Stop,1,0,1
64,2023-02-04,TICK,gemGrab,Hard Rock Mine,42,19,61
65,2023-02-04,TICK,gemGrab,Double Swoosh,33,11,44
66,2023-02-04,TICK,gemGrab,Deep Diner,20,10,30
67,2023-02-04,TICK,brawlBall,Super Beach,144,94,238
68,2023-02-04,TICK,brawlBall,Sneaky Fields,15,12,27
69,2023-02-04,TICK,bounty,Dry Season,132,96,228
70,2023-02-03,TICK,knockout,Out in the Open,341,302,643
71,2023-02-03,TICK,knockout,Goldarm Gulch,182,145,327
72,2023-02-03,TICK,hotZone,Split,352,129,481
73,2023-02-03,TICK,heist,Tornado Ring,27,6,33
74,2023-02-03,TICK,heist,Pit Stop,25,2,27
75,2023-02-03,TICK,gemGrab,Undermine,29,16,45
76,2023-02-03,TICK,gemGrab,Double Swoosh,171,17,188
77,2023-02-03,TICK,gemGrab,Deep Diner,398,254,652
78,2023-02-03,TICK,brawlBall,Sneaky Fields,523,312,835
79,2023-02-03,TICK,brawlBall,Pinhole Punt,21,11,32
80,2023-02-03,TICK,bounty,Dry Season,636,536,1172
81,2023-02-02,TICK,knockout,Out in the Open,136,107,243
82,2023-02-02,TICK,hotZone,Split,161,100,261
83,2023-02-02,TICK,heist,Kaboom Canyon,6,3,9
84,2023-02-02,TICK,gemGrab,Undermine,45,14,59
85,2023-02-02,TICK,gemGrab,Gem Fort,10,6,16
86,2023-02-02,TICK,brawlBall,Sunny Soccer,15,12,27
87,2023-02-02,TICK,brawlBall,Pinhole Punt,110,68,178
88,2023-02-02,TICK,bounty,Shooting Star,96,111,207
89,2023-02-01,TICK,knockout,Goldarm Gulch,339,284,623
90,2023-02-01,TICK,hotZone,Parallel Plays,321,86,407
91,2023-02-01,TICK,heist,Kaboom Canyon,24,7,31
92,2023-02-01,TICK,gemGrab,Gem Fort,83,51,134
93,2023-02-01,TICK,gemGrab,Crystal Arcade,63,28,91
94,2023-02-01,TICK,brawlBall,Sunny Soccer,525,411,936
95,2023-02-01,TICK,brawlBall,Beach Ball,16,6,22
96,2023-02-01,TICK,bounty,Shooting Star,248,184,432
97,2023-01-31,TICK,knockout,Goldarm Gulch,147,151,298
98,2023-01-31,TICK,hotZone,Parallel Plays,132,47,179
99,2023-01-31,TICK,heist,Pit Stop,8,1,9
100,2023-01-31,TICK,gemGrab,Minecart Madness,63,47,110
101,2023-01-31,TICK,gemGrab,Crystal Arcade,75,56,131
102,2023-01-31,TICK,brawlBall,Center Stage,5,4,9
103,2023-01-31,TICK,brawlBall,Beach Ball,241,155,396
104,2023-01-31,TICK,bounty,Hideout,150,103,253
105,2023-01-30,TICK,knockout,Belle's Rock,1032,905,1937
106,2023-01-30,TICK,hotZone,Quarter Pounder,502,143,645
107,2023-01-30,TICK,heist,Pit Stop,20,7,27
108,2023-01-30,TICK,gemGrab,Minecart Madness,637,405,1042
109,2023-01-30,TICK,gemGrab,Double Swoosh,73,30,103
110,2023-01-30,TICK,brawlBall,Center Stage,381,262,643
111,2023-01-30,TICK,brawlBall,Backyard Bowl,36,20,56
112,2023-01-30,TICK,bounty,Hideout,200,143,343
113,2023-01-29,TICK,knockout,Belle's Rock,940,841,1781
114,2023-01-29,TICK,hotZone,Quarter Pounder,304,62,366
115,2023-01-29,TICK,heist,Bridge Too Far,16,5,21
116,2023-01-29,TICK,gemGrab,Hard Rock Mine,21,9,30
117,2023-01-29,TICK,gemGrab,Double Swoosh,144,84,228
118,2023-01-29,TICK,brawlBall,Super Beach,10,2,12
119,2023-01-29,TICK,brawlBall,Backyard Bowl,313,161,474
120,2023-01-29,TICK,bounty,Canal Grande,274,174,448
121,2023-01-28,TICK,knockout,Flaring Phoenix,319,231,550
122,2023-01-28,TICK,hotZone,Controller Chaos,210,45,255
123,2023-01-28,TICK,heist,Bridge Too Far,31,11,42
124,2023-01-28,TICK,gemGrab,Hard Rock Mine,152,73,225
125,2023-01-28,TICK,gemGrab,Deep Diner,94,58,152
126,2023-01-28,TICK,brawlBall,Super Beach,515,353,868
127,2023-01-28,TICK,brawlBall,Sneaky Fields,19,8,27
128,2023-01-28,TICK,bounty,Canal Grande,394,269,663
129,2023-01-27,TICK,knockout,Flaring Phoenix,133,93,226
130,2023-01-27,TICK,hotZone,Controller Chaos,68,20,88
131,2023-01-27,TICK,heist,Hot Potato,8,1,9
132,2023-01-27,TICK,gemGrab,Undermine,9,5,14
133,2023-01-27,TICK,gemGrab,Deep Diner,122,71,193
134,2023-01-27,TICK,brawlBall,Sneaky Fields,112,85,197
135,2023-01-27,TICK,brawlBall,Pinhole Punt,5,3,8
136,2023-01-27,TICK,bounty,Temple Ruins,39,21,60
137,2023-01-26,TICK,knockout,Riverside,303,185,488
138,2023-01-26,TICK,hotZone,Open Zone,212,58,270
139,2023-01-26,TICK,heist,Hot Potato,17,5,22
140,2023-01-26,TICK,gemGrab,Undermine,71,35,106
141,2023-01-26,TICK,gemGrab,Gem Fort,23,18,41
142,2023-01-26,TICK,brawlBall,Sunny Soccer,35,20,55
143,2023-01-26,TICK,brawlBall,Pinhole Punt,407,236,643
144,2023-01-26,TICK,bounty,Temple Ruins,124,83,207
145,2023-01-25,TICK,knockout,Riverside,123,101,224
146,2023-01-25,TICK,hotZone,Open Zone,86,41,127
147,2023-01-25,TICK,heist,Safe Zone,27,5,32
148,2023-01-25,TICK,gemGrab,Gem Fort,44,26,70
149,2023-01-25,TICK,gemGrab,Crystal Arcade,96,29,125
150,2023-01-25,TICK,brawlBall,Sunny Soccer,371,283,654
151,2023-01-25,TICK,brawlBall,Beach Ball,61,46,107
152,2023-01-25,TICK,bounty,Excel,342,225,567
153,2023-01-24,TICK,knockout,New Perspective,197,178,375
154,2023-01-24,TICK,hotZone,Dueling Beetles,389,144,533
155,2023-01-24,TICK,heist,Safe Zone,78,22,100
156,2023-01-24,TICK,gemGrab,Minecart Madness,206,114,320
157,2023-01-24,TICK,gemGrab,Crystal Arcade,147,69,216
158,2023-01-24,TICK,brawlBall,Center Stage,41,39,80
159,2023-01-24,TICK,brawlBall,Beach Ball,544,334,878
160,2023-01-24,TICK,bounty,Excel,573,405,978
161,2023-01-23,TICK,knockout,New Perspective,340,232,572
162,2023-01-23,TICK,hotZone,Dueling Beetles,543,174,717
163,2023-01-23,TICK,heist,Snaked Assault,23,2,25
164,2023-01-23,TICK,gemGrab,Minecart Madness,867,517,1384
165,2023-01-23,TICK,gemGrab,Double Swoosh,54,29,83
166,2023-01-23,TICK,brawlBall,Center Stage,550,404,954
167,2023-01-23,TICK,brawlBall,Backyard Bowl,27,15,42
168,2023-01-23,TICK,bounty,Layer Cake,614,474,1088
169,2023-01-22,TICK,knockout,X Marks the Spot,204,146,350
170,2023-01-22,TICK,hotZone,Ring of Fire,183,55,238
171,2023-01-22,TICK,heist,Snaked Assault,15,2,17
172,2023-01-22,TICK,gemGrab,Hard Rock Mine,36,15,51
173,2023-01-22,TICK,gemGrab,Double Swoosh,69,40,109
174,2023-01-22,TICK,brawlBall,Super Beach,55,29,84
175,2023-01-22,TICK,brawlBall,Backyard Bowl,168,96,264
176,2023-01-22,TICK,bounty,Layer Cake,286,229,515
177,2023-01-21,TICK,knockout,X Marks the Spot,727,566,1293
178,2023-01-21,TICK,hotZone,Ring of Fire,502,205,707
179,2023-01-21,TICK,heist,Tornado Ring,14,9,23
180,2023-01-21,TICK,gemGrab,Hard Rock Mine,210,98,308
181,2023-01-21,TICK,gemGrab,Deep Diner,67,63,130
182,2023-01-21,TICK,brawlBall,Super Beach,650,412,1062
183,2023-01-21,TICK,brawlBall,Sneaky Fields,19,17,36
184,2023-01-21,TICK,bounty,Dry Season,498,403,901
185,2023-01-20,TICK,knockout,Out in the Open,374,296,670
186,2023-01-20,TICK,hotZone,Split,455,188,643
187,2023-01-20,TICK,heist,Tornado Ring,12,1,13
188,2023-01-20,TICK,gemGrab,Undermine,48,23,71
189,2023-01-20,TICK,gemGrab,Deep Diner,422,257,679
190,2023-01-20,TICK,brawlBall,Sneaky Fields,385,225,610
191,2023-01-20,TICK,brawlBall,Pinhole Punt,27,15,42
192,2023-01-20,TICK,bounty,Dry Season,338,326,664
193,2023-01-19,TICK,knockout,Out in the Open,481,414,895
194,2023-01-19,TICK,hotZone,Split,587,294,881
195,2023-01-19,TICK,heist,Kaboom Canyon,25,6,31
196,2023-01-19,TICK,gemGrab,Undermine,155,70,225
197,2023-01-19,TICK,gemGrab,Gem Fort,25,13,38
198,2023-01-19,TICK,brawlBall,Sunny Soccer,27,21,48
199,2023-01-19,TICK,brawlBall,Pinhole Punt,439,305,744
200,2023-01-19,TICK,bounty,Shooting Star,381,264,645
201,2023-01-18,TICK,knockout,Goldarm Gulch,45,46,91
202,2023-01-18,TICK,hotZone,Parallel Plays,49,16,65
203,2023-01-18,TICK,heist,Kaboom Canyon,6,0,6
204,2023-01-18,TICK,gemGrab,Gem Fort,22,17,39
205,2023-01-18,TICK,gemGrab,Crystal Arcade,5,3,8
206,2023-01-18,TICK,brawlBall,Sunny Soccer,185,136,321
207,2023-01-18,TICK,brawlBall,Beach Ball,5,7,12
208,2023-01-18,TICK,bounty,Shooting Star,167,134,301
209,2023-01-17,TICK,knockout,Goldarm Gulch,29,12,41
210,2023-01-17,TICK,hotZone,Parallel Plays,7,7,14
211,2023-01-17,TICK,heist,Pit Stop,1,1,2
212,2023-01-17,TICK,gemGrab,Minecart Madness,9,4,13
213,2023-01-17,TICK,gemGrab,Crystal Arcade,13,4,17
214,2023-01-17,TICK,brawlBall,Center Stage,1,1,2
215,2023-01-17,TICK,brawlBall,Beach Ball,45,23,68
216,2023-01-17,TICK,bounty,Hideout,19,21,40
217,2023-01-16,TICK,knockout,Belle's Rock,63,44,107
218,2023-01-16,TICK,hotZone,Quarter Pounder,58,2,60
219,2023-01-16,TICK,heist,Pit Stop,0,1,1
220,2023-01-16,TICK,gemGrab,Minecart Madness,66,39,105
221,2023-01-16,TICK,gemGrab,Double Swoosh,3,1,4
222,2023-01-16,TICK,brawlBall,Center Stage,26,19,45
223,2023-01-16,TICK,brawlBall,Backyard Bowl,6,1,7
224,2023-01-16,TICK,bounty,Hideout,56,44,100
225,2023-01-15,TICK,knockout,Belle's Rock,119,82,201
226,2023-01-15,TICK,hotZone,Quarter Pounder,84,4,88
227,2023-01-15,TICK,heist,Bridge Too Far,4,1,5
228,2023-01-15,TICK,gemGrab,Hard Rock Mine,3,1,4
229,2023-01-15,TICK,gemGrab,Double Swoosh,12,6,18
230,2023-01-15,TICK,brawlBall,Super Beach,6,2,8
231,2023-01-15,TICK,brawlBall,Backyard Bowl,39,13,52
232,2023-01-15,TICK,bounty,Canal Grande,31,9,40
233,2023-01-14,TICK,knockout,Flaring Phoenix,23,13,36
234,2023-01-14,TICK,hotZone,Controller Chaos,56,7,63
235,2023-01-14,TICK,heist,Bridge Too Far,4,1,5
236,2023-01-14,TICK,gemGrab,Hard Rock Mine,6,0,6
237,2023-01-14,TICK,gemGrab,Deep Diner,14,4,18
238,2023-01-14,TICK,brawlBall,Super Beach,37,23,60
239,2023-01-14,TICK,brawlBall,Sneaky Fields,4,1,5
240,2023-01-14,TICK,bounty,Canal Grande,29,11,40
241,2023-01-13,TICK,knockout,Flaring Phoenix,28,9,37
242,2023-01-13,TICK,hotZone,Controller Chaos,41,15,56
243,2023-01-13,TICK,heist,Hot Potato,1,0,1
244,2023-01-13,TICK,gemGrab,Deep Diner,27,6,33
245,2023-01-13,TICK,brawlBall,Sneaky Fields,16,6,22
246,2023-01-13,TICK,bounty,Temple Ruins,6,2,8
247,2023-01-12,TICK,knockout,Riverside,25,14,39
248,2023-01-12,TICK,hotZone,Open Zone,23,0,23
249,2023-01-12,TICK,gemGrab,Undermine,4,2,6
250,2023-01-12,TICK,brawlBall,Pinhole Punt,13,2,15
251,2023-01-11,TICK,knockout,Riverside,2,3,5
252,2023-01-11,TICK,hotZone,Open Zone,5,1,6
253,2023-01-11,TICK,heist,Safe Zone,1,0,1
254,2023-01-11,TICK,gemGrab,Gem Fort,2,0,2
255,2023-01-11,TICK,brawlBall,Sunny Soccer,15,9,24
256,2023-01-11,TICK,brawlBall,Beach Ball,2,0,2
257,2023-01-11,TICK,bounty,Excel,22,9,31
258,2023-01-10,TICK,knockout,New Perspective,10,4,14
259,2023-01-10,TICK,hotZone,Dueling Beetles,62,11,73
260,2023-01-10,TICK,heist,Safe Zone,2,0,2
261,2023-01-10,TICK,gemGrab,Minecart Madness,31,5,36
262,2023-01-10,TICK,gemGrab,Crystal Arcade,15,1,16
263,2023-01-10,TICK,brawlBall,Center Stage,7,1,8
264,2023-01-10,TICK,brawlBall,Beach Ball,16,9,25
265,2023-01-10,TICK,bounty,Excel,12,4,16
266,2023-01-09,TICK,knockout,New Perspective,17,1,18
267,2023-01-09,TICK,hotZone,Dueling Beetles,34,11,45
268,2023-01-09,TICK,gemGrab,Minecart Madness,57,15,72
269,2023-01-09,TICK,gemGrab,Double Swoosh,5,0,5
270,2023-01-09,TICK,brawlBall,Center Stage,43,31,74
271,2023-01-09,TICK,brawlBall,Backyard Bowl,2,0,2
272,2023-01-09,TICK,bounty,Layer Cake,67,30,97
273,2023-01-08,TICK,knockout,X Marks the Spot,41,9,50
274,2023-01-08,TICK,hotZone,Ring of Fire,50,1,51
275,2023-01-08,TICK,heist,Snaked Assault,1,0,1
276,2023-01-08,TICK,gemGrab,Hard Rock Mine,2,0,2
277,2023-01-08,TICK,gemGrab,Double Swoosh,6,0,6
278,2023-01-08,TICK,brawlBall,Super Beach,4,2,6
279,2023-01-08,TICK,brawlBall,Backyard Bowl,18,4,22
280,2023-01-08,TICK,bounty,Layer Cake,14,4,18
281,2023-01-07,TICK,knockout,X Marks the Spot,27,9,36
282,2023-01-07,TICK,hotZone,Ring of Fire,16,4,20
283,2023-01-07,TICK,gemGrab,Hard Rock Mine,6,1,7
284,2023-01-07,TICK,gemGrab,Deep Diner,6,1,7
285,2023-01-07,TICK,brawlBall,Super Beach,11,3,14
286,2023-01-07,TICK,brawlBall,Sneaky Fields,2,0,2
287,2023-01-07,TICK,bounty,Dry Season,32,10,42
288,2023-01-06,TICK,knockout,Out in the Open,25,4,29
289,2023-01-06,TICK,hotZone,Split,41,4,45
290,2023-01-06,TICK,heist,Tornado Ring,2,1,3
291,2023-01-06,TICK,gemGrab,Undermine,1,3,4
292,2023-01-06,TICK,gemGrab,Deep Diner,31,1,32
293,2023-01-06,TICK,brawlBall,Sneaky Fields,10,7,17
294,2023-01-06,TICK,bounty,Dry Season,28,27,55
295,2023-01-05,TICK,knockout,Out in the Open,44,24,68
296,2023-01-05,TICK,hotZone,Split,82,10,92
297,2023-01-05,TICK,heist,Kaboom Canyon,1,0,1
298,2023-01-05,TICK,gemGrab,Undermine,5,1,6
299,2023-01-05,TICK,brawlBall,Sunny Soccer,3,0,3
300,2023-01-05,TICK,brawlBall,Pinhole Punt,19,3,22
301,2023-01-05,TICK,bounty,Shooting Star,29,21,50
302,2023-01-04,TICK,knockout,Goldarm Gulch,15,5,20
303,2023-01-04,TICK,hotZone,Parallel Plays,21,0,21
304,2023-01-04,TICK,gemGrab,Gem Fort,5,2,7
305,2023-01-04,TICK,gemGrab,Crystal Arcade,3,0,3
306,2023-01-04,TICK,brawlBall,Sunny Soccer,30,7,37
307,2023-01-04,TICK,brawlBall,Beach Ball,2,0,2
308,2023-01-04,TICK,bounty,Shooting Star,74,117,191
309,2023-01-03,TICK,knockout,Goldarm Gulch,10,15,25
310,2023-01-03,TICK,hotZone,Parallel Plays,22,1,23
311,2023-01-03,TICK,heist,Kaboom Canyon,1,0,1
312,2023-01-03,TICK,gemGrab,Minecart Madness,16,1,17
313,2023-01-03,TICK,gemGrab,Crystal Arcade,14,4,18
314,2023-01-03,TICK,brawlBall,Center Stage,1,1,2
315,2023-01-03,TICK,brawlBall,Beach Ball,28,5,33
316,2023-01-03,TICK,bounty,Hideout,51,46,97
317,2023-01-02,TICK,knockout,Belle's Rock,91,66,157
318,2023-01-02,TICK,hotZone,Quarter Pounder,70,2,72
319,2023-01-02,TICK,hotZone,Controller Chaos,0,2,2
320,2023-01-02,TICK,heist,Pit Stop,1,0,1
321,2023-01-02,TICK,gemGrab,Minecart Madness,60,7,67
322,2023-01-02,TICK,gemGrab,Double Swoosh,2,1,3
323,2023-01-02,TICK,brawlBall,Center Stage,15,6,21
324,2023-01-02,TICK,brawlBall,Backyard Bowl,2,1,3
325,2023-01-02,TICK,bounty,Hideout,64,46,110
326,2023-01-01,TICK,knockout,Belle's Rock,18,19,37
327,2023-01-01,TICK,hotZone,Quarter Pounder,21,1,22
328,2023-01-01,TICK,hotZone,Controller Chaos,1,0,1
329,2023-01-01,TICK,heist,Kaboom Canyon,2,0,2
330,2023-01-01,TICK,heist,Bridge Too Far,1,0,1
331,2023-01-01,TICK,gemGrab,Minecart Madness,0,1,1
332,2023-01-01,TICK,gemGrab,Double Swoosh,4,2,6
333,2023-01-01,TICK,brawlBall,Backyard Bowl,7,6,13
334,2023-01-01,TICK,bounty,Canal Grande,9,4,13
335,2022-12-31,TICK,hotZone,Controller Chaos,5,0,5
336,2022-12-31,TICK,gemGrab,Minecart Madness,1,0,1
337,2022-12-31,TICK,gemGrab,Hard Rock Mine,2,1,3
338,2022-12-31,TICK,gemGrab,Deep Diner,7,2,9
339,2022-12-31,TICK,brawlBall,Super Beach,1,0,1
340,2022-12-31,TICK,bounty,Canal Grande,2,1,3
341,2022-12-30,TICK,knockout,Flaring Phoenix,2,4,6
342,2022-12-30,TICK,hotZone,Controller Chaos,5,0,5
343,2022-12-30,TICK,gemGrab,Deep Diner,7,1,8
344,2022-12-30,TICK,brawlBall,Sneaky Fields,1,1,2
345,2022-12-29,TICK,gemGrab,Minecart Madness,1,1,2
346,2022-12-29,TICK,brawlBall,Pinhole Punt,2,6,8
347,2022-12-27,TICK,hotZone,Dueling Beetles,1,1,2
348,2022-12-27,TICK,gemGrab,Minecart Madness,0,2,2
349,2022-12-27,TICK,brawlBall,Beach Ball,1,2,3
350,2022-12-27,TICK,bounty,Excel,2,2,4
351,2022-12-26,TICK,hotZone,Controller Chaos,1,0,1
352,2022-12-26,TICK,gemGrab,Minecart Madness,1,0,1
353,2022-12-25,TICK,bounty,Layer Cake,2,0,2
354,2022-12-24,TICK,brawlBall,Super Beach,1,0,1
355,2022-12-23,TICK,knockout,Out in the Open,4,2,6
356,2022-12-22,TICK,brawlBall,Pinhole Punt,0,1,1
357,2022-12-21,TICK,brawlBall,Sunny Soccer,1,1,2
358,2022-12-20,TICK,brawlBall,Beach Ball,0,2,2
359,2022-12-19,TICK,gemGrab,Minecart Madness,2,0,2
360,2022-12-19,TICK,brawlBall,Center Stage,0,1,1
361,2022-12-18,TICK,knockout,Belle's Rock,1,1,2
362,2022-12-16,TICK,brawlBall,Sneaky Fields,0,1,1
363,2022-12-16,TICK,bounty,Temple Ruins,2,0,2
364,2022-12-13,TICK,knockout,New Perspective,1,0,1
365,2022-12-13,TICK,heist,Safe Zone,1,0,1
366,2022-12-11,TICK,gemGrab,Double Swoosh,4,0,4
367,2022-12-10,TICK,hotZone,Ring of Fire,1,0,1
368,2022-11-18,TICK,brawlBall,Beach Ball,2,0,2
369,2022-11-11,TICK,knockout,New Perspective,4,0,4
370,2022-11-11,TICK,brawlBall,Sneaky Fields,2,0,2
371,2022-11-01,TICK,knockout,New Perspective,4,0,4
372,2022-10-30,TICK,hotZone,Dueling Beetles,1,2,3
373,2022-10-28,TICK,knockout,Out in the Open,0,4,4
374,2022-10-28,TICK,hotZone,Dueling Beetles,0,4,4
375,2022-10-28,TICK,heist,Safe Zone,2,0,2
376,2022-10-26,TICK,brawlBall,Sunny Soccer,0,2,2
377,2022-10-26,TICK,bounty,Shooting Star,1,1,2
378,2022-10-15,TICK,hotZone,Ring of Fire,2,0,2
379,2022-10-15,TICK,gemGrab,Hard Rock Mine,2,0,2
380,2022-10-10,TICK,knockout,Belle's Rock,1,3,4
381,2022-09-06,TICK,brawlBall,Beach Ball,2,2,4
382,2023-02-11,TARA,knockout,Flaring Phoenix,221,302,523
383,2023-02-11,TARA,hotZone,Controller Chaos,50,24,74
384,2023-02-11,TARA,gemGrab,Deep Diner,44,33,77
385,2023-02-11,TARA,brawlBall,Super Beach,68,82,150
386,2023-02-11,TARA,brawlBall,Sneaky Fields,71,75,146
387,2023-02-10,TARA,knockout,Flaring Phoenix,764,886,1650
388,2023-02-10,TARA,hotZone,Controller Chaos,40,25,65
389,2023-02-10,TARA,heist,Hot Potato,56,57,113
390,2023-02-10,TARA,gemGrab,Undermine,59,70,129
391,2023-02-10,TARA,gemGrab,Deep Diner,141,141,282
392,2023-02-10,TARA,brawlBall,Sneaky Fields,738,695,1433
393,2023-02-10,TARA,brawlBall,Pinhole Punt,6,6,12
394,2023-02-10,TARA,bounty,Temple Ruins,37,23,60
395,2023-02-09,TARA,hotZone,Open Zone,6,2,8
396,2023-02-09,TARA,heist,Hot Potato,24,16,40
397,2023-02-09,TARA,gemGrab,Undermine,99,121,220
398,2023-02-09,TARA,gemGrab,Gem Fort,12,20,32
399,2023-02-09,TARA,brawlBall,Sunny Soccer,1,0,1
400,2023-02-09,TARA,brawlBall,Pinhole Punt,136,153,289
401,2023-02-09,TARA,bounty,Temple Ruins,10,15,25
402,2023-02-08,TARA,hotZone,Open Zone,1,1,2
403,2023-02-08,TARA,heist,Safe Zone,2,1,3
404,2023-02-08,TARA,gemGrab,Gem Fort,17,22,39
405,2023-02-08,TARA,gemGrab,Crystal Arcade,6,6,12
406,2023-02-08,TARA,brawlBall,Sunny Soccer,45,38,83
407,2023-02-08,TARA,brawlBall,Beach Ball,2,2,4
408,2023-02-08,TARA,bounty,Excel,3,0,3
409,2023-02-07,TARA,knockout,New Perspective,20,9,29
410,2023-02-07,TARA,hotZone,Dueling Beetles,6,0,6
411,2023-02-07,TARA,gemGrab,Minecart Madness,6,2,8
412,2023-02-07,TARA,gemGrab,Crystal Arcade,15,5,20
413,2023-02-07,TARA,brawlBall,Center Stage,6,4,10
414,2023-02-07,TARA,brawlBall,Beach Ball,28,23,51
415,2023-02-06,TARA,knockout,New Perspective,547,650,1197
416,2023-02-06,TARA,knockout,Goldarm Gulch,4,1,5
417,2023-02-06,TARA,hotZone,Dueling Beetles,67,17,84
418,2023-02-06,TARA,heist,Snaked Assault,75,78,153
419,2023-02-06,TARA,heist,Pit Stop,4,2,6
420,2023-02-06,TARA,gemGrab,Minecart Madness,79,50,129
421,2023-02-06,TARA,gemGrab,Double Swoosh,306,370,676
422,2023-02-06,TARA,brawlBall,Sneaky Fields,46,30,76
423,2023-02-06,TARA,brawlBall,Center Stage,979,1077,2056
424,2023-02-06,TARA,brawlBall,Backyard Bowl,24,16,40
425,2023-02-06,TARA,bounty,Layer Cake,21,4,25
426,2023-02-05,TARA,knockout,X Marks the Spot,23,15,38
427,2023-02-05,TARA,knockout,Goldarm Gulch,13,17,30
428,2023-02-05,TARA,hotZone,Ring of Fire,57,45,102
429,2023-02-05,TARA,heist,Snaked Assault,154,206,360
430,2023-02-05,TARA,heist,Pit Stop,9,7,16
431,2023-02-05,TARA,gemGrab,Hard Rock Mine,72,66,138
432,2023-02-05,TARA,gemGrab,Double Swoosh,1013,1139,2152
433,2023-02-05,TARA,brawlBall,Super Beach,15,9,24
434,2023-02-05,TARA,brawlBall,Sneaky Fields,156,102,258
435,2023-02-05,TARA,brawlBall,Backyard Bowl,316,191,507
436,2023-02-05,TARA,bounty,Layer Cake,19,21,40
437,2023-02-04,TARA,knockout,X Marks the Spot,23,12,35
438,2023-02-04,TARA,knockout,Goldarm Gulch,4,4,8
439,2023-02-04,TARA,hotZone,Ring of Fire,5,3,8
440,2023-02-04,TARA,heist,Tornado Ring,10,9,19
441,2023-02-04,TARA,heist,Pit Stop,17,4,21
442,2023-02-04,TARA,gemGrab,Hard Rock Mine,95,84,179
443,2023-02-04,TARA,gemGrab,Double Swoosh,137,150,287
444,2023-02-04,TARA,gemGrab,Deep Diner,3,12,15
445,2023-02-04,TARA,brawlBall,Super Beach,138,130,268
446,2023-02-04,TARA,brawlBall,Sneaky Fields,88,56,144
447,2023-02-03,TARA,knockout,Out in the Open,72,90,162
448,2023-02-03,TARA,knockout,Goldarm Gulch,27,17,44
449,2023-02-03,TARA,hotZone,Split,26,10,36
450,2023-02-03,TARA,heist,Tornado Ring,107,101,208
451,2023-02-03,TARA,heist,Pit Stop,35,24,59
452,2023-02-03,TARA,gemGrab,Undermine,85,146,231
453,2023-02-03,TARA,gemGrab,Double Swoosh,726,894,1620
454,2023-02-03,TARA,gemGrab,Deep Diner,161,136,297
455,2023-02-03,TARA,brawlBall,Sneaky Fields,1293,994,2287
456,2023-02-03,TARA,brawlBall,Pinhole Punt,23,30,53
457,2023-02-03,TARA,bounty,Dry Season,13,8,21
458,2023-02-02,TARA,knockout,Out in the Open,39,47,86
459,2023-02-02,TARA,hotZone,Split,8,6,14
460,2023-02-02,TARA,heist,Kaboom Canyon,3,0,3
461,2023-02-02,TARA,gemGrab,Undermine,84,102,186
462,2023-02-02,TARA,gemGrab,Gem Fort,19,28,47
463,2023-02-02,TARA,brawlBall,Sunny Soccer,4,3,7
464,2023-02-02,TARA,brawlBall,Pinhole Punt,170,160,330
465,2023-02-02,TARA,bounty,Shooting Star,1,0,1
466,2023-02-01,TARA,knockout,Goldarm Gulch,107,102,209
467,2023-02-01,TARA,hotZone,Parallel Plays,52,21,73
468,2023-02-01,TARA,heist,Kaboom Canyon,11,6,17
469,2023-02-01,TARA,gemGrab,Gem Fort,263,338,601
470,2023-02-01,TARA,gemGrab,Crystal Arcade,95,105,200
471,2023-02-01,TARA,brawlBall,Sunny Soccer,417,399,816
472,2023-02-01,TARA,brawlBall,Beach Ball,7,7,14
473,2023-02-01,TARA,bounty,Shooting Star,2,1,3
474,2023-01-31,TARA,knockout,Goldarm Gulch,73,101,174
475,2023-01-31,TARA,hotZone,Parallel Plays,18,20,38
476,2023-01-31,TARA,heist,Pit Stop,26,33,59
477,2023-01-31,TARA,gemGrab,Minecart Madness,1,1,2
478,2023-01-31,TARA,gemGrab,Crystal Arcade,116,170,286
479,2023-01-31,TARA,brawlBall,Center Stage,3,13,16
480,2023-01-31,TARA,brawlBall,Beach Ball,220,181,401
481,2023-01-31,TARA,bounty,Hideout,1,0,1
482,2023-01-30,TARA,knockout,Belle's Rock,28,10,38
483,2023-01-30,TARA,hotZone,Quarter Pounder,66,19,85
484,2023-01-30,TARA,heist,Pit Stop,39,40,79
485,2023-01-30,TARA,gemGrab,Minecart Madness,46,27,73
486,2023-01-30,TARA,gemGrab,Double Swoosh,284,274,558
487,2023-01-30,TARA,brawlBall,Center Stage,593,597,1190
488,2023-01-30,TARA,brawlBall,Backyard Bowl,20,14,34
489,2023-01-30,TARA,bounty,Hideout,2,3,5
490,2023-01-29,TARA,knockout,Belle's Rock,10,5,15
491,2023-01-29,TARA,hotZone,Quarter Pounder,37,15,52
492,2023-01-29,TARA,heist,Bridge Too Far,5,4,9
493,2023-01-29,TARA,gemGrab,Hard Rock Mine,46,53,99
494,2023-01-29,TARA,gemGrab,Double Swoosh,493,533,1026
495,2023-01-29,TARA,brawlBall,Super Beach,7,2,9
496,2023-01-29,TARA,brawlBall,Backyard Bowl,233,204,437
497,2023-01-29,TARA,bounty,Canal Grande,15,5,20
498,2023-01-28,TARA,knockout,Flaring Phoenix,333,364,697
499,2023-01-28,TARA,hotZone,Controller Chaos,66,42,108
500,2023-01-28,TARA,heist,Bridge Too Far,10,13,23
501,2023-01-28,TARA,gemGrab,Hard Rock Mine,302,249,551
502,2023-01-28,TARA,gemGrab,Deep Diner,41,37,78
503,2023-01-28,TARA,brawlBall,Super Beach,600,528,1128
504,2023-01-28,TARA,brawlBall,Sneaky Fields,24,26,50
505,2023-01-28,TARA,bounty,Canal Grande,43,47,90
506,2023-01-27,TARA,knockout,Flaring Phoenix,159,203,362
507,2023-01-27,TARA,hotZone,Controller Chaos,14,8,22
508,2023-01-27,TARA,heist,Hot Potato,17,17,34
509,2023-01-27,TARA,gemGrab,Undermine,17,41,58
510,2023-01-27,TARA,gemGrab,Deep Diner,52,54,106
511,2023-01-27,TARA,brawlBall,Sneaky Fields,236,231,467
512,2023-01-27,TARA,brawlBall,Pinhole Punt,4,6,10
513,2023-01-27,TARA,bounty,Temple Ruins,12,13,25
514,2023-01-26,TARA,knockout,Riverside,12,9,21
515,2023-01-26,TARA,hotZone,Open Zone,38,13,51
516,2023-01-26,TARA,heist,Hot Potato,72,58,130
517,2023-01-26,TARA,gemGrab,Undermine,272,269,541
518,2023-01-26,TARA,gemGrab,Gem Fort,133,171,304
519,2023-01-26,TARA,brawlBall,Sunny Soccer,28,37,65
520,2023-01-26,TARA,brawlBall,Pinhole Punt,550,581,1131
521,2023-01-26,TARA,bounty,Temple Ruins,53,53,106
522,2023-01-25,TARA,knockout,Riverside,7,6,13
523,2023-01-25,TARA,hotZone,Open Zone,17,8,25
524,2023-01-25,TARA,heist,Safe Zone,11,9,20
525,2023-01-25,TARA,gemGrab,Gem Fort,153,163,316
526,2023-01-25,TARA,gemGrab,Crystal Arcade,117,134,251
527,2023-01-25,TARA,brawlBall,Sunny Soccer,320,317,637
528,2023-01-25,TARA,brawlBall,Beach Ball,39,29,68
529,2023-01-25,TARA,bounty,Excel,7,1,8
530,2023-01-24,TARA,knockout,New Perspective,73,134,207
531,2023-01-24,TARA,hotZone,Dueling Beetles,53,13,66
532,2023-01-24,TARA,heist,Safe Zone,14,7,21
533,2023-01-24,TARA,gemGrab,Minecart Madness,9,9,18
534,2023-01-24,TARA,gemGrab,Crystal Arcade,272,241,513
535,2023-01-24,TARA,brawlBall,Center Stage,94,98,192
536,2023-01-24,TARA,brawlBall,Beach Ball,515,449,964
537,2023-01-24,TARA,bounty,Excel,13,3,16
538,2023-01-23,TARA,knockout,New Perspective,358,521,879
539,2023-01-23,TARA,hotZone,Dueling Beetles,52,19,71
540,2023-01-23,TARA,heist,Snaked Assault,106,142,248
541,2023-01-23,TARA,gemGrab,Minecart Madness,87,45,132
542,2023-01-23,TARA,gemGrab,Double Swoosh,223,326,549
543,2023-01-23,TARA,brawlBall,Center Stage,1121,1132,2253
544,2023-01-23,TARA,brawlBall,Backyard Bowl,19,10,29
545,2023-01-23,TARA,bounty,Layer Cake,18,12,30
546,2023-01-22,TARA,knockout,X Marks the Spot,14,18,32
547,2023-01-22,TARA,hotZone,Ring of Fire,29,18,47
548,2023-01-22,TARA,heist,Snaked Assault,75,90,165
549,2023-01-22,TARA,gemGrab,Hard Rock Mine,75,51,126
550,2023-01-22,TARA,gemGrab,Double Swoosh,311,311,622
551,2023-01-22,TARA,brawlBall,Super Beach,56,33,89
552,2023-01-22,TARA,brawlBall,Backyard Bowl,120,105,225
553,2023-01-22,TARA,bounty,Layer Cake,10,17,27
554,2023-01-21,TARA,knockout,X Marks the Spot,70,36,106
555,2023-01-21,TARA,hotZone,Ring of Fire,73,30,103
556,2023-01-21,TARA,heist,Tornado Ring,95,124,219
557,2023-01-21,TARA,gemGrab,Hard Rock Mine,357,313,670
558,2023-01-21,TARA,gemGrab,Deep Diner,42,37,79
559,2023-01-21,TARA,brawlBall,Super Beach,729,677,1406
560,2023-01-21,TARA,brawlBall,Sneaky Fields,21,29,50
561,2023-01-21,TARA,bounty,Dry Season,6,2,8
562,2023-01-20,TARA,knockout,Out in the Open,72,71,143
563,2023-01-20,TARA,hotZone,Split,19,9,28
564,2023-01-20,TARA,heist,Tornado Ring,86,64,150
565,2023-01-20,TARA,gemGrab,Undermine,97,93,190
566,2023-01-20,TARA,gemGrab,Deep Diner,203,159,362
567,2023-01-20,TARA,brawlBall,Sneaky Fields,794,769,1563
568,2023-01-20,TARA,brawlBall,Pinhole Punt,18,21,39
569,2023-01-20,TARA,bounty,Dry Season,9,5,14
570,2023-01-19,TARA,knockout,Out in the Open,170,165,335
571,2023-01-19,TARA,hotZone,Split,37,20,57
572,2023-01-19,TARA,heist,Kaboom Canyon,18,15,33
573,2023-01-19,TARA,gemGrab,Undermine,390,452,842
574,2023-01-19,TARA,gemGrab,Gem Fort,101,80,181
575,2023-01-19,TARA,brawlBall,Sunny Soccer,19,17,36
576,2023-01-19,TARA,brawlBall,Pinhole Punt,529,574,1103
577,2023-01-19,TARA,bounty,Shooting Star,7,2,9
578,2023-01-18,TARA,knockout,Goldarm Gulch,11,6,17
579,2023-01-18,TARA,hotZone,Parallel Plays,5,4,9
580,2023-01-18,TARA,heist,Kaboom Canyon,3,0,3
581,2023-01-18,TARA,gemGrab,Gem Fort,67,107,174
582,2023-01-18,TARA,gemGrab,Crystal Arcade,13,8,21
583,2023-01-18,TARA,brawlBall,Sunny Soccer,141,127,268
584,2023-01-18,TARA,brawlBall,Beach Ball,2,8,10
585,2023-01-18,TARA,bounty,Shooting Star,1,0,1
586,2023-01-17,TARA,knockout,Goldarm Gulch,19,6,25
587,2023-01-17,TARA,hotZone,Parallel Plays,2,2,4
588,2023-01-17,TARA,heist,Pit Stop,8,8,16
589,2023-01-17,TARA,gemGrab,Crystal Arcade,23,34,57
590,2023-01-17,TARA,brawlBall,Center Stage,2,2,4
591,2023-01-17,TARA,brawlBall,Beach Ball,34,41,75
592,2023-01-17,TARA,bounty,Hideout,1,0,1
593,2023-01-16,TARA,knockout,Belle's Rock,0,3,3
594,2023-01-16,TARA,hotZone,Quarter Pounder,6,3,9
595,2023-01-16,TARA,heist,Pit Stop,17,12,29
596,2023-01-16,TARA,gemGrab,Minecart Madness,5,5,10
597,2023-01-16,TARA,gemGrab,Double Swoosh,29,45,74
598,2023-01-16,TARA,brawlBall,Center Stage,64,76,140
599,2023-01-16,TARA,brawlBall,Backyard Bowl,5,0,5
600,2023-01-16,TARA,bounty,Hideout,1,0,1
601,2023-01-15,TARA,knockout,Belle's Rock,5,2,7
602,2023-01-15,TARA,hotZone,Quarter Pounder,20,2,22
603,2023-01-15,TARA,heist,Bridge Too Far,4,1,5
604,2023-01-15,TARA,gemGrab,Hard Rock Mine,19,8,27
605,2023-01-15,TARA,gemGrab,Double Swoosh,92,66,158
606,2023-01-15,TARA,brawlBall,Super Beach,12,0,12
607,2023-01-15,TARA,brawlBall,Backyard Bowl,30,21,51
608,2023-01-15,TARA,bounty,Canal Grande,3,2,5
609,2023-01-14,TARA,knockout,Flaring Phoenix,18,27,45
610,2023-01-14,TARA,hotZone,Controller Chaos,24,2,26
611,2023-01-14,TARA,heist,Bridge Too Far,4,1,5
612,2023-01-14,TARA,gemGrab,Hard Rock Mine,23,7,30
613,2023-01-14,TARA,gemGrab,Deep Diner,17,6,23
614,2023-01-14,TARA,brawlBall,Super Beach,45,21,66
615,2023-01-14,TARA,brawlBall,Sneaky Fields,11,8,19
616,2023-01-14,TARA,bounty,Canal Grande,6,10,16
617,2023-01-13,TARA,knockout,Flaring Phoenix,22,32,54
618,2023-01-13,TARA,hotZone,Controller Chaos,9,5,14
619,2023-01-13,TARA,heist,Hot Potato,3,0,3
620,2023-01-13,TARA,gemGrab,Undermine,1,0,1
621,2023-01-13,TARA,gemGrab,Deep Diner,16,9,25
622,2023-01-13,TARA,brawlBall,Sneaky Fields,50,21,71
623,2023-01-13,TARA,brawlBall,Pinhole Punt,3,0,3
624,2023-01-13,TARA,bounty,Temple Ruins,4,0,4
625,2023-01-12,TARA,knockout,Riverside,1,0,1
626,2023-01-12,TARA,hotZone,Open Zone,7,1,8
627,2023-01-12,TARA,heist,Hot Potato,1,1,2
628,2023-01-12,TARA,gemGrab,Undermine,22,16,38
629,2023-01-12,TARA,gemGrab,Gem Fort,6,1,7
630,2023-01-12,TARA,brawlBall,Sunny Soccer,1,0,1
631,2023-01-12,TARA,brawlBall,Pinhole Punt,20,4,24
632,2023-01-12,TARA,bounty,Temple Ruins,0,2,2
633,2023-01-11,TARA,hotZone,Open Zone,1,0,1
634,2023-01-11,TARA,gemGrab,Gem Fort,17,13,30
635,2023-01-11,TARA,brawlBall,Sunny Soccer,6,10,16
636,2023-01-10,TARA,knockout,New Perspective,4,1,5
637,2023-01-10,TARA,hotZone,Dueling Beetles,6,0,6
638,2023-01-10,TARA,gemGrab,Minecart Madness,3,2,5
639,2023-01-10,TARA,gemGrab,Crystal Arcade,42,38,80
640,2023-01-10,TARA,brawlBall,Center Stage,5,1,6
641,2023-01-10,TARA,brawlBall,Beach Ball,24,13,37
642,2023-01-10,TARA,bounty,Excel,1,0,1
643,2023-01-09,TARA,knockout,New Perspective,22,25,47
644,2023-01-09,TARA,hotZone,Dueling Beetles,1,0,1
645,2023-01-09,TARA,heist,Snaked Assault,10,7,17
646,2023-01-09,TARA,gemGrab,Minecart Madness,7,1,8
647,2023-01-09,TARA,gemGrab,Double Swoosh,43,55,98
648,2023-01-09,TARA,brawlBall,Center Stage,73,61,134
649,2023-01-09,TARA,brawlBall,Backyard Bowl,4,0,4
650,2023-01-09,TARA,bounty,Layer Cake,0,1,1
651,2023-01-08,TARA,knockout,X Marks the Spot,1,0,1
652,2023-01-08,TARA,hotZone,Ring of Fire,8,21,29
653,2023-01-08,TARA,heist,Snaked Assault,12,13,25
654,2023-01-08,TARA,gemGrab,Hard Rock Mine,12,9,21
655,2023-01-08,TARA,gemGrab,Double Swoosh,36,17,53
656,2023-01-08,TARA,brawlBall,Super Beach,7,2,9
657,2023-01-08,TARA,brawlBall,Backyard Bowl,17,4,21
658,2023-01-08,TARA,bounty,Layer Cake,0,2,2
659,2023-01-07,TARA,knockout,X Marks the Spot,0,1,1
660,2023-01-07,TARA,hotZone,Ring of Fire,6,11,17
661,2023-01-07,TARA,heist,Tornado Ring,12,12,24
662,2023-01-07,TARA,gemGrab,Hard Rock Mine,33,35,68
663,2023-01-07,TARA,gemGrab,Deep Diner,21,3,24
664,2023-01-07,TARA,brawlBall,Super Beach,17,15,32
665,2023-01-07,TARA,brawlBall,Sneaky Fields,6,1,7
666,2023-01-07,TARA,bounty,Dry Season,1,0,1
667,2023-01-06,TARA,knockout,Out in the Open,9,23,32
668,2023-01-06,TARA,heist,Tornado Ring,11,3,14
669,2023-01-06,TARA,gemGrab,Undermine,19,14,33
670,2023-01-06,TARA,gemGrab,Deep Diner,26,7,33
671,2023-01-06,TARA,brawlBall,Sneaky Fields,47,36,83
672,2023-01-06,TARA,brawlBall,Pinhole Punt,5,1,6
673,2023-01-06,TARA,bounty,Dry Season,0,1,1
674,2023-01-05,TARA,knockout,Out in the Open,22,9,31
675,2023-01-05,TARA,hotZone,Split,12,0,12
676,2023-01-05,TARA,heist,Kaboom Canyon,4,0,4
677,2023-01-05,TARA,gemGrab,Undermine,65,50,115
678,2023-01-05,TARA,gemGrab,Gem Fort,13,8,21
679,2023-01-05,TARA,brawlBall,Sunny Soccer,0,1,1
680,2023-01-05,TARA,brawlBall,Pinhole Punt,70,38,108
681,2023-01-04,TARA,knockout,Goldarm Gulch,3,0,3
682,2023-01-04,TARA,hotZone,Parallel Plays,1,0,1
683,2023-01-04,TARA,heist,Kaboom Canyon,0,1,1
684,2023-01-04,TARA,gemGrab,Gem Fort,82,60,142
685,2023-01-04,TARA,gemGrab,Crystal Arcade,16,2,18
686,2023-01-04,TARA,brawlBall,Sunny Soccer,44,27,71
687,2023-01-04,TARA,bounty,Shooting Star,1,0,1
688,2023-01-03,TARA,knockout,Goldarm Gulch,8,1,9
689,2023-01-03,TARA,hotZone,Parallel Plays,2,1,3
690,2023-01-03,TARA,heist,Pit Stop,4,0,4
691,2023-01-03,TARA,gemGrab,Crystal Arcade,58,19,77
692,2023-01-03,TARA,brawlBall,Center Stage,2,0,2
693,2023-01-03,TARA,brawlBall,Beach Ball,54,44,98
694,2023-01-03,TARA,bounty,Hideout,1,0,1
695,2023-01-02,TARA,knockout,Belle's Rock,4,0,4
696,2023-01-02,TARA,hotZone,Quarter Pounder,10,2,12
697,2023-01-02,TARA,heist,Pit Stop,7,1,8
698,2023-01-02,TARA,gemGrab,Minecart Madness,13,4,17
699,2023-01-02,TARA,gemGrab,Double Swoosh,38,14,52
700,2023-01-02,TARA,brawlBall,Center Stage,94,70,164
701,2023-01-02,TARA,brawlBall,Backyard Bowl,1,1,2
702,2023-01-02,TARA,bounty,Hideout,2,0,2
703,2023-01-01,TARA,hotZone,Quarter Pounder,3,1,4
704,2023-01-01,TARA,heist,Bridge Too Far,0,1,1
705,2023-01-01,TARA,gemGrab,Minecart Madness,1,0,1
706,2023-01-01,TARA,gemGrab,Hard Rock Mine,1,2,3
707,2023-01-01,TARA,gemGrab,Double Swoosh,38,43,81
708,2023-01-01,TARA,brawlBall,Backyard Bowl,8,3,11
709,2022-12-31,TARA,knockout,Flaring Phoenix,2,0,2
710,2022-12-31,TARA,hotZone,Controller Chaos,1,0,1
711,2022-12-31,TARA,gemGrab,Hard Rock Mine,9,6,15
712,2022-12-31,TARA,gemGrab,Deep Diner,3,2,5
713,2022-12-31,TARA,brawlBall,Super Beach,2,3,5
714,2022-12-30,TARA,knockout,Flaring Phoenix,3,2,5
715,2022-12-30,TARA,hotZone,Controller Chaos,2,1,3
716,2022-12-30,TARA,heist,Kaboom Canyon,0,1,1
717,2022-12-30,TARA,heist,Hot Potato,1,0,1
718,2022-12-30,TARA,gemGrab,Undermine,3,0,3
719,2022-12-30,TARA,gemGrab,Deep Diner,1,1,2
720,2022-12-30,TARA,brawlBall,Sneaky Fields,4,11,15
721,2022-12-29,TARA,hotZone,Controller Chaos,1,0,1
722,2022-12-29,TARA,gemGrab,Undermine,1,0,1
723,2022-12-29,TARA,gemGrab,Gem Fort,0,1,1
724,2022-12-29,TARA,brawlBall,Pinhole Punt,3,2,5
725,2022-12-28,TARA,brawlBall,Sunny Soccer,0,2,2
726,2022-12-28,TARA,brawlBall,Beach Ball,2,2,4
727,2022-12-27,TARA,knockout,New Perspective,4,5,9
728,2022-12-27,TARA,brawlBall,Beach Ball,0,2,2
729,2022-12-26,TARA,gemGrab,Minecart Madness,0,1,1
730,2022-12-26,TARA,brawlBall,Center Stage,1,2,3
731,2022-12-23,TARA,knockout,Out in the Open,2,0,2
732,2022-12-22,TARA,gemGrab,Gem Fort,7,12,19
733,2022-12-22,TARA,brawlBall,Pinhole Punt,5,2,7
734,2022-12-20,TARA,brawlBall,Beach Ball,1,2,3
735,2022-12-19,TARA,gemGrab,Minecart Madness,2,0,2
736,2022-12-19,TARA,brawlBall,Center Stage,0,1,1
737,2022-12-17,TARA,knockout,Flaring Phoenix,2,4,6
738,2022-12-16,TARA,brawlBall,Sneaky Fields,0,1,1
739,2022-12-15,TARA,heist,Hot Potato,2,0,2
740,2022-12-13,TARA,knockout,New Perspective,2,1,3
741,2022-12-13,TARA,gemGrab,Crystal Arcade,1,0,1
742,2022-12-10,TARA,gemGrab,Hard Rock Mine,0,1,1
743,2022-11-19,TARA,brawlBall,Sneaky Fields,2,2,4
744,2022-11-11,TARA,brawlBall,Sneaky Fields,2,6,8
745,2022-10-28,TARA,hotZone,Dueling Beetles,2,0,2
746,2022-10-15,TARA,hotZone,Ring of Fire,1,0,1
747,2022-09-07,TARA,brawlBall,Pinhole Punt,2,0,2
748,2023-02-11,SURGE,knockout,Flaring Phoenix,27,20,47
749,2023-02-11,SURGE,hotZone,Controller Chaos,200,299,499
750,2023-02-11,SURGE,gemGrab,Deep Diner,97,92,189
751,2023-02-11,SURGE,brawlBall,Super Beach,395,340,735
752,2023-02-11,SURGE,brawlBall,Sneaky Fields,252,243,495
753,2023-02-10,SURGE,knockout,Flaring Phoenix,75,56,131
754,2023-02-10,SURGE,hotZone,Controller Chaos,373,364,737
755,2023-02-10,SURGE,heist,Hot Potato,31,14,45
756,2023-02-10,SURGE,gemGrab,Undermine,63,36,99
757,2023-02-10,SURGE,gemGrab,Deep Diner,233,202,435
758,2023-02-10,SURGE,brawlBall,Sneaky Fields,2172,2076,4248
759,2023-02-10,SURGE,brawlBall,Pinhole Punt,30,24,54
760,2023-02-10,SURGE,bounty,Temple Ruins,74,51,125
761,2023-02-09,SURGE,knockout,Riverside,6,1,7
762,2023-02-09,SURGE,hotZone,Open Zone,4,2,6
763,2023-02-09,SURGE,heist,Hot Potato,21,19,40
764,2023-02-09,SURGE,gemGrab,Undermine,57,70,127
765,2023-02-09,SURGE,gemGrab,Gem Fort,14,12,26
766,2023-02-09,SURGE,brawlBall,Sunny Soccer,5,10,15
767,2023-02-09,SURGE,brawlBall,Pinhole Punt,266,219,485
768,2023-02-09,SURGE,bounty,Temple Ruins,34,29,63
769,2023-02-08,SURGE,knockout,Riverside,2,0,2
770,2023-02-08,SURGE,hotZone,Open Zone,3,1,4
771,2023-02-08,SURGE,heist,Safe Zone,1,0,1
772,2023-02-08,SURGE,gemGrab,Gem Fort,32,27,59
773,2023-02-08,SURGE,gemGrab,Crystal Arcade,10,9,19
774,2023-02-08,SURGE,brawlBall,Sunny Soccer,137,132,269
775,2023-02-08,SURGE,brawlBall,Beach Ball,3,7,10
776,2023-02-08,SURGE,bounty,Excel,5,2,7
777,2023-02-07,SURGE,knockout,New Perspective,5,6,11
778,2023-02-07,SURGE,hotZone,Dueling Beetles,16,9,25
779,2023-02-07,SURGE,heist,Safe Zone,1,0,1
780,2023-02-07,SURGE,gemGrab,Minecart Madness,4,1,5
781,2023-02-07,SURGE,gemGrab,Crystal Arcade,16,17,33
782,2023-02-07,SURGE,brawlBall,Center Stage,18,28,46
783,2023-02-07,SURGE,brawlBall,Beach Ball,87,119,206
784,2023-02-07,SURGE,bounty,Excel,2,0,2
785,2023-02-06,SURGE,knockout,New Perspective,114,74,188
786,2023-02-06,SURGE,knockout,Goldarm Gulch,1,2,3
787,2023-02-06,SURGE,hotZone,Dueling Beetles,172,110,282
788,2023-02-06,SURGE,heist,Snaked Assault,46,33,79
789,2023-02-06,SURGE,heist,Pit Stop,6,6,12
790,2023-02-06,SURGE,gemGrab,Minecart Madness,89,62,151
791,2023-02-06,SURGE,gemGrab,Double Swoosh,251,246,497
792,2023-02-06,SURGE,brawlBall,Sneaky Fields,101,123,224
793,2023-02-06,SURGE,brawlBall,Center Stage,1742,1750,3492
794,2023-02-06,SURGE,brawlBall,Backyard Bowl,40,44,84
795,2023-02-06,SURGE,bounty,Layer Cake,81,51,132
796,2023-02-05,SURGE,knockout,X Marks the Spot,45,7,52
797,2023-02-05,SURGE,knockout,Goldarm Gulch,5,2,7
798,2023-02-05,SURGE,hotZone,Ring of Fire,53,28,81
799,2023-02-05,SURGE,heist,Snaked Assault,85,80,165
800,2023-02-05,SURGE,heist,Pit Stop,32,27,59
801,2023-02-05,SURGE,gemGrab,Hard Rock Mine,112,85,197
802,2023-02-05,SURGE,gemGrab,Double Swoosh,716,659,1375
803,2023-02-05,SURGE,brawlBall,Super Beach,59,65,124
804,2023-02-05,SURGE,brawlBall,Sneaky Fields,253,337,590
805,2023-02-05,SURGE,brawlBall,Backyard Bowl,684,500,1184
806,2023-02-05,SURGE,bounty,Layer Cake,78,41,119
807,2023-02-04,SURGE,knockout,X Marks the Spot,10,13,23
808,2023-02-04,SURGE,knockout,Goldarm Gulch,5,5,10
809,2023-02-04,SURGE,hotZone,Ring of Fire,11,9,20
810,2023-02-04,SURGE,heist,Tornado Ring,9,2,11
811,2023-02-04,SURGE,heist,Pit Stop,30,26,56
812,2023-02-04,SURGE,gemGrab,Hard Rock Mine,82,75,157
813,2023-02-04,SURGE,gemGrab,Double Swoosh,88,111,199
814,2023-02-04,SURGE,gemGrab,Deep Diner,6,8,14
815,2023-02-04,SURGE,brawlBall,Super Beach,518,517,1035
816,2023-02-04,SURGE,brawlBall,Sneaky Fields,177,203,380
817,2023-02-04,SURGE,bounty,Dry Season,1,2,3
818,2023-02-03,SURGE,knockout,Out in the Open,62,21,83
819,2023-02-03,SURGE,knockout,Goldarm Gulch,18,5,23
820,2023-02-03,SURGE,hotZone,Split,217,263,480
821,2023-02-03,SURGE,heist,Tornado Ring,100,125,225
822,2023-02-03,SURGE,heist,Pit Stop,125,143,268
823,2023-02-03,SURGE,gemGrab,Undermine,68,41,109
824,2023-02-03,SURGE,gemGrab,Double Swoosh,498,453,951
825,2023-02-03,SURGE,gemGrab,Deep Diner,276,233,509
826,2023-02-03,SURGE,brawlBall,Sneaky Fields,2992,3041,6033
827,2023-02-03,SURGE,brawlBall,Pinhole Punt,47,49,96
828,2023-02-03,SURGE,bounty,Dry Season,21,12,33
829,2023-02-02,SURGE,knockout,Out in the Open,20,13,33
830,2023-02-02,SURGE,hotZone,Split,146,161,307
831,2023-02-02,SURGE,gemGrab,Undermine,67,68,135
832,2023-02-02,SURGE,gemGrab,Gem Fort,24,27,51
833,2023-02-02,SURGE,brawlBall,Sunny Soccer,22,19,41
834,2023-02-02,SURGE,brawlBall,Pinhole Punt,272,288,560
835,2023-02-02,SURGE,bounty,Shooting Star,3,2,5
836,2023-02-01,SURGE,knockout,Goldarm Gulch,100,64,164
837,2023-02-01,SURGE,hotZone,Parallel Plays,297,317,614
838,2023-02-01,SURGE,heist,Kaboom Canyon,12,5,17
839,2023-02-01,SURGE,gemGrab,Gem Fort,240,194,434
840,2023-02-01,SURGE,gemGrab,Crystal Arcade,143,182,325
841,2023-02-01,SURGE,brawlBall,Sunny Soccer,1390,1463,2853
842,2023-02-01,SURGE,brawlBall,Beach Ball,44,52,96
843,2023-02-01,SURGE,bounty,Shooting Star,5,0,5
844,2023-01-31,SURGE,knockout,Goldarm Gulch,45,28,73
845,2023-01-31,SURGE,hotZone,Parallel Plays,181,147,328
846,2023-01-31,SURGE,heist,Pit Stop,21,35,56
847,2023-01-31,SURGE,gemGrab,Minecart Madness,2,1,3
848,2023-01-31,SURGE,gemGrab,Crystal Arcade,163,190,353
849,2023-01-31,SURGE,brawlBall,Center Stage,14,19,33
850,2023-01-31,SURGE,brawlBall,Beach Ball,567,544,1111
851,2023-01-31,SURGE,bounty,Hideout,6,1,7
852,2023-01-30,SURGE,knockout,Belle's Rock,51,18,69
853,2023-01-30,SURGE,hotZone,Quarter Pounder,188,108,296
854,2023-01-30,SURGE,heist,Pit Stop,111,86,197
855,2023-01-30,SURGE,gemGrab,Minecart Madness,55,41,96
856,2023-01-30,SURGE,gemGrab,Double Swoosh,240,234,474
857,2023-01-30,SURGE,brawlBall,Center Stage,988,946,1934
858,2023-01-30,SURGE,brawlBall,Backyard Bowl,59,46,105
859,2023-01-30,SURGE,bounty,Hideout,8,2,10
860,2023-01-29,SURGE,knockout,Belle's Rock,49,21,70
861,2023-01-29,SURGE,hotZone,Quarter Pounder,117,65,182
862,2023-01-29,SURGE,heist,Bridge Too Far,5,1,6
863,2023-01-29,SURGE,gemGrab,Hard Rock Mine,66,68,134
864,2023-01-29,SURGE,gemGrab,Double Swoosh,362,308,670
865,2023-01-29,SURGE,brawlBall,Super Beach,48,48,96
866,2023-01-29,SURGE,brawlBall,Backyard Bowl,541,375,916
867,2023-01-29,SURGE,bounty,Canal Grande,121,112,233
868,2023-01-28,SURGE,knockout,Flaring Phoenix,60,40,100
869,2023-01-28,SURGE,hotZone,Controller Chaos,206,199,405
870,2023-01-28,SURGE,heist,Bridge Too Far,17,6,23
871,2023-01-28,SURGE,gemGrab,Hard Rock Mine,317,288,605
872,2023-01-28,SURGE,gemGrab,Deep Diner,88,86,174
873,2023-01-28,SURGE,brawlBall,Super Beach,1964,1893,3857
874,2023-01-28,SURGE,brawlBall,Sneaky Fields,112,155,267
875,2023-01-28,SURGE,bounty,Canal Grande,155,159,314
876,2023-01-27,SURGE,knockout,Flaring Phoenix,19,9,28
877,2023-01-27,SURGE,hotZone,Controller Chaos,76,92,168
878,2023-01-27,SURGE,heist,Hot Potato,10,6,16
879,2023-01-27,SURGE,gemGrab,Undermine,12,24,36
880,2023-01-27,SURGE,gemGrab,Deep Diner,103,84,187
881,2023-01-27,SURGE,brawlBall,Sneaky Fields,607,646,1253
882,2023-01-27,SURGE,brawlBall,Pinhole Punt,14,16,30
883,2023-01-27,SURGE,bounty,Temple Ruins,14,18,32
884,2023-01-26,SURGE,knockout,Riverside,24,5,29
885,2023-01-26,SURGE,hotZone,Open Zone,34,15,49
886,2023-01-26,SURGE,heist,Hot Potato,71,74,145
887,2023-01-26,SURGE,gemGrab,Undermine,183,133,316
888,2023-01-26,SURGE,gemGrab,Gem Fort,110,101,211
889,2023-01-26,SURGE,brawlBall,Sunny Soccer,108,128,236
890,2023-01-26,SURGE,brawlBall,Pinhole Punt,1020,854,1874
891,2023-01-26,SURGE,bounty,Temple Ruins,66,70,136
892,2023-01-25,SURGE,knockout,Riverside,11,3,14
893,2023-01-25,SURGE,hotZone,Open Zone,12,5,17
894,2023-01-25,SURGE,heist,Safe Zone,7,1,8
895,2023-01-25,SURGE,gemGrab,Gem Fort,120,81,201
896,2023-01-25,SURGE,gemGrab,Crystal Arcade,194,249,443
897,2023-01-25,SURGE,brawlBall,Sunny Soccer,998,1019,2017
898,2023-01-25,SURGE,brawlBall,Beach Ball,123,137,260
899,2023-01-25,SURGE,bounty,Excel,21,37,58
900,2023-01-24,SURGE,knockout,New Perspective,52,29,81
901,2023-01-24,SURGE,hotZone,Dueling Beetles,75,32,107
902,2023-01-24,SURGE,heist,Safe Zone,11,7,18
903,2023-01-24,SURGE,gemGrab,Minecart Madness,24,16,40
904,2023-01-24,SURGE,gemGrab,Crystal Arcade,291,321,612
905,2023-01-24,SURGE,brawlBall,Center Stage,161,159,320
906,2023-01-24,SURGE,brawlBall,Beach Ball,1343,1439,2782
907,2023-01-24,SURGE,bounty,Excel,28,11,39
908,2023-01-23,SURGE,knockout,New Perspective,85,48,133
909,2023-01-23,SURGE,hotZone,Dueling Beetles,93,47,140
910,2023-01-23,SURGE,heist,Snaked Assault,65,32,97
911,2023-01-23,SURGE,gemGrab,Minecart Madness,101,61,162
912,2023-01-23,SURGE,gemGrab,Double Swoosh,197,169,366
913,2023-01-23,SURGE,brawlBall,Center Stage,1620,1486,3106
914,2023-01-23,SURGE,brawlBall,Backyard Bowl,33,21,54
915,2023-01-23,SURGE,bounty,Layer Cake,81,67,148
916,2023-01-22,SURGE,knockout,X Marks the Spot,28,14,42
917,2023-01-22,SURGE,hotZone,Ring of Fire,54,48,102
918,2023-01-22,SURGE,heist,Snaked Assault,28,15,43
919,2023-01-22,SURGE,gemGrab,Hard Rock Mine,92,126,218
920,2023-01-22,SURGE,gemGrab,Double Swoosh,189,145,334
921,2023-01-22,SURGE,brawlBall,Super Beach,174,145,319
922,2023-01-22,SURGE,brawlBall,Backyard Bowl,229,189,418
923,2023-01-22,SURGE,bounty,Layer Cake,27,28,55
924,2023-01-21,SURGE,knockout,X Marks the Spot,101,71,172
925,2023-01-21,SURGE,hotZone,Ring of Fire,63,34,97
926,2023-01-21,SURGE,heist,Tornado Ring,43,27,70
927,2023-01-21,SURGE,gemGrab,Hard Rock Mine,437,405,842
928,2023-01-21,SURGE,gemGrab,Deep Diner,62,64,126
929,2023-01-21,SURGE,brawlBall,Super Beach,2478,2409,4887
930,2023-01-21,SURGE,brawlBall,Sneaky Fields,114,105,219
931,2023-01-21,SURGE,bounty,Dry Season,19,9,28
932,2023-01-20,SURGE,knockout,Out in the Open,61,29,90
933,2023-01-20,SURGE,hotZone,Split,207,209,416
934,2023-01-20,SURGE,heist,Tornado Ring,56,44,100
935,2023-01-20,SURGE,gemGrab,Undermine,104,113,217
936,2023-01-20,SURGE,gemGrab,Deep Diner,279,327,606
937,2023-01-20,SURGE,brawlBall,Sneaky Fields,1813,1819,3632
938,2023-01-20,SURGE,brawlBall,Pinhole Punt,42,24,66
939,2023-01-20,SURGE,bounty,Dry Season,17,11,28
940,2023-01-19,SURGE,knockout,Out in the Open,83,38,121
941,2023-01-19,SURGE,hotZone,Split,413,474,887
942,2023-01-19,SURGE,heist,Kaboom Canyon,12,14,26
943,2023-01-19,SURGE,gemGrab,Undermine,201,166,367
944,2023-01-19,SURGE,gemGrab,Gem Fort,55,64,119
945,2023-01-19,SURGE,brawlBall,Sunny Soccer,57,46,103
946,2023-01-19,SURGE,brawlBall,Pinhole Punt,1158,978,2136
947,2023-01-19,SURGE,bounty,Shooting Star,13,8,21
948,2023-01-18,SURGE,knockout,Goldarm Gulch,12,6,18
949,2023-01-18,SURGE,hotZone,Parallel Plays,33,16,49
950,2023-01-18,SURGE,heist,Kaboom Canyon,2,1,3
951,2023-01-18,SURGE,gemGrab,Gem Fort,47,39,86
952,2023-01-18,SURGE,gemGrab,Crystal Arcade,26,38,64
953,2023-01-18,SURGE,brawlBall,Sunny Soccer,418,467,885
954,2023-01-18,SURGE,brawlBall,Beach Ball,12,17,29
955,2023-01-18,SURGE,bounty,Shooting Star,4,3,7
956,2023-01-17,SURGE,knockout,Goldarm Gulch,13,4,17
957,2023-01-17,SURGE,hotZone,Parallel Plays,34,41,75
958,2023-01-17,SURGE,heist,Pit Stop,10,15,25
959,2023-01-17,SURGE,gemGrab,Minecart Madness,1,0,1
960,2023-01-17,SURGE,gemGrab,Crystal Arcade,29,30,59
961,2023-01-17,SURGE,brawlBall,Center Stage,6,6,12
962,2023-01-17,SURGE,brawlBall,Beach Ball,132,126,258
963,2023-01-17,SURGE,bounty,Hideout,0,1,1
964,2023-01-16,SURGE,knockout,Belle's Rock,1,1,2
965,2023-01-16,SURGE,hotZone,Quarter Pounder,20,20,40
966,2023-01-16,SURGE,heist,Pit Stop,28,62,90
967,2023-01-16,SURGE,gemGrab,Minecart Madness,8,2,10
968,2023-01-16,SURGE,gemGrab,Double Swoosh,23,20,43
969,2023-01-16,SURGE,brawlBall,Center Stage,108,100,208
970,2023-01-16,SURGE,brawlBall,Backyard Bowl,9,4,13
971,2023-01-16,SURGE,bounty,Hideout,3,2,5
972,2023-01-15,SURGE,knockout,Belle's Rock,3,0,3
973,2023-01-15,SURGE,hotZone,Quarter Pounder,50,8,58
974,2023-01-15,SURGE,heist,Bridge Too Far,1,0,1
975,2023-01-15,SURGE,gemGrab,Hard Rock Mine,23,27,50
976,2023-01-15,SURGE,gemGrab,Double Swoosh,56,45,101
977,2023-01-15,SURGE,brawlBall,Super Beach,41,36,77
978,2023-01-15,SURGE,brawlBall,Backyard Bowl,68,42,110
979,2023-01-15,SURGE,bounty,Canal Grande,18,6,24
980,2023-01-14,SURGE,knockout,Flaring Phoenix,1,3,4
981,2023-01-14,SURGE,hotZone,Controller Chaos,74,61,135
982,2023-01-14,SURGE,gemGrab,Hard Rock Mine,27,23,50
983,2023-01-14,SURGE,gemGrab,Deep Diner,20,14,34
984,2023-01-14,SURGE,brawlBall,Super Beach,183,166,349
985,2023-01-14,SURGE,brawlBall,Sneaky Fields,38,24,62
986,2023-01-14,SURGE,bounty,Canal Grande,15,11,26
987,2023-01-13,SURGE,knockout,Flaring Phoenix,2,2,4
988,2023-01-13,SURGE,hotZone,Controller Chaos,84,72,156
989,2023-01-13,SURGE,heist,Hot Potato,4,2,6
990,2023-01-13,SURGE,gemGrab,Deep Diner,24,61,85
991,2023-01-13,SURGE,brawlBall,Sneaky Fields,201,150,351
992,2023-01-13,SURGE,brawlBall,Pinhole Punt,1,6,7
993,2023-01-13,SURGE,bounty,Temple Ruins,3,2,5
994,2023-01-12,SURGE,knockout,Riverside,4,0,4
995,2023-01-12,SURGE,hotZone,Open Zone,10,0,10
996,2023-01-12,SURGE,heist,Hot Potato,3,0,3
997,2023-01-12,SURGE,gemGrab,Undermine,6,6,12
998,2023-01-12,SURGE,gemGrab,Gem Fort,2,0,2
999,2023-01-12,SURGE,brawlBall,Sunny Soccer,4,0,4
1000,2023-01-12,SURGE,brawlBall,Pinhole Punt,23,18,41
1001,2023-01-11,SURGE,gemGrab,Gem Fort,7,4,11
1002,2023-01-11,SURGE,brawlBall,Sunny Soccer,50,64,114
1003,2023-01-11,SURGE,brawlBall,Beach Ball,1,0,1
1004,2023-01-11,SURGE,bounty,Excel,1,0,1
1005,2023-01-10,SURGE,knockout,New Perspective,2,0,2
1006,2023-01-10,SURGE,hotZone,Dueling Beetles,17,7,24
1007,2023-01-10,SURGE,heist,Safe Zone,0,2,2
1008,2023-01-10,SURGE,gemGrab,Minecart Madness,4,5,9
1009,2023-01-10,SURGE,gemGrab,Crystal Arcade,33,43,76
1010,2023-01-10,SURGE,brawlBall,Center Stage,9,11,20
1011,2023-01-10,SURGE,brawlBall,Beach Ball,90,83,173
1012,2023-01-09,SURGE,knockout,New Perspective,3,0,3
1013,2023-01-09,SURGE,hotZone,Dueling Beetles,7,0,7
1014,2023-01-09,SURGE,heist,Snaked Assault,8,9,17
1015,2023-01-09,SURGE,gemGrab,Minecart Madness,9,3,12
1016,2023-01-09,SURGE,gemGrab,Double Swoosh,33,12,45
1017,2023-01-09,SURGE,brawlBall,Center Stage,89,84,173
1018,2023-01-09,SURGE,brawlBall,Backyard Bowl,3,1,4
1019,2023-01-09,SURGE,bounty,Layer Cake,8,2,10
1020,2023-01-08,SURGE,knockout,X Marks the Spot,3,0,3
1021,2023-01-08,SURGE,hotZone,Ring of Fire,7,2,9
1022,2023-01-08,SURGE,heist,Snaked Assault,2,2,4
1023,2023-01-08,SURGE,gemGrab,Hard Rock Mine,9,18,27
1024,2023-01-08,SURGE,gemGrab,Double Swoosh,18,4,22
1025,2023-01-08,SURGE,brawlBall,Super Beach,18,14,32
1026,2023-01-08,SURGE,brawlBall,Backyard Bowl,24,7,31
1027,2023-01-08,SURGE,bounty,Layer Cake,1,0,1
1028,2023-01-07,SURGE,hotZone,Ring of Fire,3,2,5
1029,2023-01-07,SURGE,heist,Tornado Ring,6,0,6
1030,2023-01-07,SURGE,gemGrab,Hard Rock Mine,15,11,26
1031,2023-01-07,SURGE,gemGrab,Deep Diner,10,29,39
1032,2023-01-07,SURGE,brawlBall,Super Beach,60,99,159
1033,2023-01-07,SURGE,brawlBall,Sneaky Fields,6,10,16
1034,2023-01-06,SURGE,hotZone,Split,31,33,64
1035,2023-01-06,SURGE,heist,Tornado Ring,13,3,16
1036,2023-01-06,SURGE,gemGrab,Undermine,4,7,11
1037,2023-01-06,SURGE,gemGrab,Deep Diner,28,43,71
1038,2023-01-06,SURGE,brawlBall,Sneaky Fields,107,99,206
1039,2023-01-06,SURGE,brawlBall,Pinhole Punt,3,7,10
1040,2023-01-05,SURGE,knockout,Out in the Open,4,1,5
1041,2023-01-05,SURGE,hotZone,Split,104,97,201
1042,2023-01-05,SURGE,heist,Kaboom Canyon,1,0,1
1043,2023-01-05,SURGE,gemGrab,Undermine,20,44,64
1044,2023-01-05,SURGE,gemGrab,Gem Fort,2,11,13
1045,2023-01-05,SURGE,brawlBall,Sunny Soccer,3,4,7
1046,2023-01-05,SURGE,brawlBall,Pinhole Punt,84,103,187
1047,2023-01-04,SURGE,hotZone,Parallel Plays,20,17,37
1048,2023-01-04,SURGE,heist,Kaboom Canyon,4,0,4
1049,2023-01-04,SURGE,gemGrab,Gem Fort,31,10,41
1050,2023-01-04,SURGE,gemGrab,Crystal Arcade,16,6,22
1051,2023-01-04,SURGE,brawlBall,Sunny Soccer,147,110,257
1052,2023-01-04,SURGE,brawlBall,Beach Ball,1,1,2
1053,2023-01-04,SURGE,bounty,Shooting Star,1,0,1
1054,2023-01-03,SURGE,knockout,Goldarm Gulch,2,0,2
1055,2023-01-03,SURGE,hotZone,Parallel Plays,33,37,70
1056,2023-01-03,SURGE,heist,Pit Stop,17,11,28
1057,2023-01-03,SURGE,heist,Kaboom Canyon,0,1,1
1058,2023-01-03,SURGE,gemGrab,Minecart Madness,7,0,7
1059,2023-01-03,SURGE,gemGrab,Crystal Arcade,44,26,70
1060,2023-01-03,SURGE,brawlBall,Center Stage,1,5,6
1061,2023-01-03,SURGE,brawlBall,Beach Ball,102,98,200
1062,2023-01-03,SURGE,bounty,Hideout,3,2,5
1063,2023-01-02,SURGE,knockout,Belle's Rock,2,0,2
1064,2023-01-02,SURGE,hotZone,Quarter Pounder,30,7,37
1065,2023-01-02,SURGE,heist,Pit Stop,20,12,32
1066,2023-01-02,SURGE,gemGrab,Minecart Madness,12,0,12
1067,2023-01-02,SURGE,gemGrab,Double Swoosh,42,43,85
1068,2023-01-02,SURGE,brawlBall,Center Stage,136,110,246
1069,2023-01-02,SURGE,brawlBall,Backyard Bowl,4,0,4
1070,2023-01-02,SURGE,bounty,Hideout,1,2,3
1071,2023-01-01,SURGE,knockout,Belle's Rock,1,0,1
1072,2023-01-01,SURGE,hotZone,Quarter Pounder,9,4,13
1073,2023-01-01,SURGE,hotZone,Controller Chaos,1,1,2
1074,2023-01-01,SURGE,heist,Kaboom Canyon,2,0,2
1075,2023-01-01,SURGE,gemGrab,Double Swoosh,24,25,49
1076,2023-01-01,SURGE,brawlBall,Backyard Bowl,11,4,15
1077,2023-01-01,SURGE,bounty,Canal Grande,3,0,3
1078,2022-12-31,SURGE,hotZone,Controller Chaos,4,6,10
1079,2022-12-31,SURGE,gemGrab,Hard Rock Mine,9,4,13
1080,2022-12-31,SURGE,gemGrab,Deep Diner,3,2,5
1081,2022-12-31,SURGE,brawlBall,Super Beach,15,25,40
1082,2022-12-31,SURGE,brawlBall,Sneaky Fields,2,0,2
1083,2022-12-30,SURGE,hotZone,Controller Chaos,2,2,4
1084,2022-12-30,SURGE,gemGrab,Undermine,2,0,2
1085,2022-12-30,SURGE,gemGrab,Deep Diner,3,2,5
1086,2022-12-30,SURGE,brawlBall,Sneaky Fields,6,4,10
1087,2022-12-29,SURGE,heist,Hot Potato,0,2,2
1088,2022-12-29,SURGE,gemGrab,Undermine,1,0,1
1089,2022-12-29,SURGE,brawlBall,Pinhole Punt,4,0,4
1090,2022-12-28,SURGE,brawlBall,Sunny Soccer,0,2,2
1091,2022-12-27,SURGE,hotZone,Dueling Beetles,0,1,1
1092,2022-12-27,SURGE,hotZone,Controller Chaos,0,1,1
1093,2022-12-27,SURGE,gemGrab,Minecart Madness,1,0,1
1094,2022-12-27,SURGE,brawlBall,Center Stage,0,1,1
1095,2022-12-27,SURGE,brawlBall,Beach Ball,1,2,3
1096,2022-12-26,SURGE,hotZone,Controller Chaos,0,1,1
1097,2022-12-26,SURGE,heist,Kaboom Canyon,1,0,1
1098,2022-12-26,SURGE,brawlBall,Center Stage,0,1,1
1099,2022-12-25,SURGE,gemGrab,Double Swoosh,0,1,1
1100,2022-12-24,SURGE,brawlBall,Super Beach,0,2,2
1101,2022-12-23,SURGE,brawlBall,Sneaky Fields,0,1,1
1102,2022-12-21,SURGE,brawlBall,Sunny Soccer,3,1,4
1103,2022-12-20,SURGE,brawlBall,Beach Ball,0,1,1
1104,2022-12-19,SURGE,gemGrab,Minecart Madness,2,2,4
1105,2022-12-19,SURGE,brawlBall,Center Stage,1,1,2
1106,2022-12-16,SURGE,hotZone,Controller Chaos,1,0,1
1107,2022-12-16,SURGE,brawlBall,Sneaky Fields,0,3,3
1108,2022-12-16,SURGE,bounty,Temple Ruins,2,0,2
1109,2022-12-13,SURGE,brawlBall,Beach Ball,1,0,1
1110,2022-12-12,SURGE,brawlBall,Center Stage,8,4,12
1111,2022-12-11,SURGE,gemGrab,Double Swoosh,2,0,2
1112,2022-11-18,SURGE,hotZone,Parallel Plays,2,2,4
1113,2022-11-18,SURGE,brawlBall,Beach Ball,2,4,6
1114,2022-11-11,SURGE,brawlBall,Sneaky Fields,0,2,2
1115,2022-10-30,SURGE,brawlBall,Beach Ball,0,2,2
1116,2022-10-26,SURGE,brawlBall,Sunny Soccer,2,0,2
1117,2022-10-15,SURGE,gemGrab,Hard Rock Mine,1,0,1
1118,2022-10-15,SURGE,brawlBall,Super Beach,0,1,1
1119,2023-02-11,STU,knockout,Flaring Phoenix,46,35,81
1120,2023-02-11,STU,hotZone,Controller Chaos,135,212,347
1121,2023-02-11,STU,gemGrab,Deep Diner,117,142,259
1122,2023-02-11,STU,brawlBall,Super Beach,255,267,522
1123,2023-02-11,STU,brawlBall,Sneaky Fields,72,64,136
1124,2023-02-10,STU,knockout,Flaring Phoenix,101,38,139
1125,2023-02-10,STU,hotZone,Controller Chaos,325,408,733
1126,2023-02-10,STU,heist,Hot Potato,9,2,11
1127,2023-02-10,STU,gemGrab,Undermine,15,17,32
1128,2023-02-10,STU,gemGrab,Deep Diner,436,555,991
1129,2023-02-10,STU,brawlBall,Sneaky Fields,529,428,957
1130,2023-02-10,STU,brawlBall,Pinhole Punt,19,25,44
1131,2023-02-10,STU,bounty,Temple Ruins,45,63,108
1132,2023-02-09,STU,knockout,Riverside,7,3,10
1133,2023-02-09,STU,hotZone,Open Zone,25,40,65
1134,2023-02-09,STU,heist,Hot Potato,4,8,12
1135,2023-02-09,STU,gemGrab,Undermine,16,12,28
1136,2023-02-09,STU,gemGrab,Gem Fort,3,2,5
1137,2023-02-09,STU,brawlBall,Sunny Soccer,4,17,21
1138,2023-02-09,STU,brawlBall,Pinhole Punt,288,315,603
1139,2023-02-09,STU,bounty,Temple Ruins,8,13,21
1140,2023-02-08,STU,knockout,Riverside,5,2,7
1141,2023-02-08,STU,hotZone,Open Zone,35,27,62
1142,2023-02-08,STU,heist,Safe Zone,0,2,2
1143,2023-02-08,STU,gemGrab,Gem Fort,4,9,13
1144,2023-02-08,STU,gemGrab,Crystal Arcade,4,5,9
1145,2023-02-08,STU,brawlBall,Sunny Soccer,116,107,223
1146,2023-02-08,STU,brawlBall,Beach Ball,4,2,6
1147,2023-02-08,STU,bounty,Excel,6,5,11
1148,2023-02-07,STU,knockout,New Perspective,7,9,16
1149,2023-02-07,STU,hotZone,Dueling Beetles,29,33,62
1150,2023-02-07,STU,heist,Safe Zone,1,0,1
1151,2023-02-07,STU,gemGrab,Minecart Madness,6,11,17
1152,2023-02-07,STU,gemGrab,Crystal Arcade,5,9,14
1153,2023-02-07,STU,brawlBall,Center Stage,5,2,7
1154,2023-02-07,STU,brawlBall,Beach Ball,78,74,152
1155,2023-02-07,STU,bounty,Excel,5,0,5
1156,2023-02-06,STU,knockout,New Perspective,148,109,257
1157,2023-02-06,STU,knockout,Goldarm Gulch,1,0,1
1158,2023-02-06,STU,hotZone,Dueling Beetles,327,392,719
1159,2023-02-06,STU,heist,Snaked Assault,13,4,17
1160,2023-02-06,STU,heist,Pit Stop,3,0,3
1161,2023-02-06,STU,gemGrab,Minecart Madness,197,253,450
1162,2023-02-06,STU,gemGrab,Double Swoosh,65,42,107
1163,2023-02-06,STU,brawlBall,Sneaky Fields,5,1,6
1164,2023-02-06,STU,brawlBall,Center Stage,749,576,1325
1165,2023-02-06,STU,brawlBall,Backyard Bowl,128,148,276
1166,2023-02-06,STU,bounty,Layer Cake,52,49,101
1167,2023-02-05,STU,knockout,X Marks the Spot,46,23,69
1168,2023-02-05,STU,knockout,Goldarm Gulch,11,10,21
1169,2023-02-05,STU,hotZone,Ring of Fire,74,128,202
1170,2023-02-05,STU,heist,Snaked Assault,10,6,16
1171,2023-02-05,STU,heist,Pit Stop,14,6,20
1172,2023-02-05,STU,gemGrab,Hard Rock Mine,45,53,98
1173,2023-02-05,STU,gemGrab,Double Swoosh,151,165,316
1174,2023-02-05,STU,brawlBall,Super Beach,46,42,88
1175,2023-02-05,STU,brawlBall,Sneaky Fields,35,18,53
1176,2023-02-05,STU,brawlBall,Backyard Bowl,2045,2100,4145
1177,2023-02-05,STU,bounty,Layer Cake,49,39,88
1178,2023-02-04,STU,knockout,X Marks the Spot,14,11,25
1179,2023-02-04,STU,knockout,Goldarm Gulch,10,5,15
1180,2023-02-04,STU,hotZone,Ring of Fire,27,54,81
1181,2023-02-04,STU,heist,Tornado Ring,1,0,1
1182,2023-02-04,STU,heist,Pit Stop,11,14,25
1183,2023-02-04,STU,gemGrab,Hard Rock Mine,50,53,103
1184,2023-02-04,STU,gemGrab,Double Swoosh,32,36,68
1185,2023-02-04,STU,gemGrab,Deep Diner,25,40,65
1186,2023-02-04,STU,brawlBall,Super Beach,388,325,713
1187,2023-02-04,STU,brawlBall,Sneaky Fields,19,9,28
1188,2023-02-04,STU,bounty,Dry Season,10,5,15
1189,2023-02-03,STU,knockout,Out in the Open,118,78,196
1190,2023-02-03,STU,knockout,Goldarm Gulch,45,13,58
1191,2023-02-03,STU,hotZone,Split,161,259,420
1192,2023-02-03,STU,heist,Tornado Ring,16,2,18
1193,2023-02-03,STU,heist,Pit Stop,60,50,110
1194,2023-02-03,STU,gemGrab,Undermine,30,20,50
1195,2023-02-03,STU,gemGrab,Double Swoosh,152,150,302
1196,2023-02-03,STU,gemGrab,Deep Diner,401,472,873
1197,2023-02-03,STU,brawlBall,Sneaky Fields,650,564,1214
1198,2023-02-03,STU,brawlBall,Pinhole Punt,50,54,104
1199,2023-02-03,STU,bounty,Dry Season,60,47,107
1200,2023-02-02,STU,knockout,Out in the Open,36,36,72
1201,2023-02-02,STU,hotZone,Split,77,109,186
1202,2023-02-02,STU,heist,Kaboom Canyon,2,2,4
1203,2023-02-02,STU,gemGrab,Undermine,14,19,33
1204,2023-02-02,STU,gemGrab,Gem Fort,7,6,13
1205,2023-02-02,STU,brawlBall,Sunny Soccer,12,24,36
1206,2023-02-02,STU,brawlBall,Pinhole Punt,352,355,707
1207,2023-02-02,STU,bounty,Shooting Star,5,5,10
1208,2023-02-01,STU,knockout,Goldarm Gulch,78,65,143
1209,2023-02-01,STU,hotZone,Parallel Plays,221,307,528
1210,2023-02-01,STU,heist,Kaboom Canyon,7,14,21
1211,2023-02-01,STU,gemGrab,Gem Fort,85,48,133
1212,2023-02-01,STU,gemGrab,Crystal Arcade,101,115,216
1213,2023-02-01,STU,brawlBall,Sunny Soccer,940,947,1887
1214,2023-02-01,STU,brawlBall,Beach Ball,35,37,72
1215,2023-02-01,STU,bounty,Shooting Star,16,7,23
1216,2023-01-31,STU,knockout,Goldarm Gulch,49,19,68
1217,2023-01-31,STU,hotZone,Parallel Plays,89,109,198
1218,2023-01-31,STU,heist,Pit Stop,5,4,9
1219,2023-01-31,STU,gemGrab,Minecart Madness,9,14,23
1220,2023-01-31,STU,gemGrab,Crystal Arcade,73,64,137
1221,2023-01-31,STU,brawlBall,Center Stage,6,6,12
1222,2023-01-31,STU,brawlBall,Beach Ball,519,600,1119
1223,2023-01-31,STU,bounty,Hideout,20,5,25
1224,2023-01-30,STU,knockout,Belle's Rock,130,84,214
1225,2023-01-30,STU,hotZone,Quarter Pounder,246,423,669
1226,2023-01-30,STU,heist,Pit Stop,20,10,30
1227,2023-01-30,STU,gemGrab,Minecart Madness,106,121,227
1228,2023-01-30,STU,gemGrab,Double Swoosh,54,66,120
1229,2023-01-30,STU,brawlBall,Center Stage,427,376,803
1230,2023-01-30,STU,brawlBall,Backyard Bowl,113,114,227
1231,2023-01-30,STU,bounty,Hideout,20,11,31
1232,2023-01-29,STU,knockout,Belle's Rock,95,74,169
1233,2023-01-29,STU,hotZone,Quarter Pounder,284,382,666
1234,2023-01-29,STU,heist,Bridge Too Far,8,2,10
1235,2023-01-29,STU,gemGrab,Hard Rock Mine,26,30,56
1236,2023-01-29,STU,gemGrab,Double Swoosh,84,65,149
1237,2023-01-29,STU,brawlBall,Super Beach,28,24,52
1238,2023-01-29,STU,brawlBall,Backyard Bowl,1519,1612,3131
1239,2023-01-29,STU,bounty,Canal Grande,20,29,49
1240,2023-01-28,STU,knockout,Flaring Phoenix,43,40,83
1241,2023-01-28,STU,hotZone,Controller Chaos,208,305,513
1242,2023-01-28,STU,heist,Bridge Too Far,17,4,21
1243,2023-01-28,STU,gemGrab,Hard Rock Mine,163,154,317
1244,2023-01-28,STU,gemGrab,Deep Diner,97,147,244
1245,2023-01-28,STU,brawlBall,Super Beach,1366,1421,2787
1246,2023-01-28,STU,brawlBall,Sneaky Fields,24,14,38
1247,2023-01-28,STU,bounty,Canal Grande,20,30,50
1248,2023-01-27,STU,knockout,Flaring Phoenix,34,21,55
1249,2023-01-27,STU,hotZone,Controller Chaos,48,84,132
1250,2023-01-27,STU,heist,Hot Potato,9,5,14
1251,2023-01-27,STU,gemGrab,Undermine,9,7,16
1252,2023-01-27,STU,gemGrab,Deep Diner,128,171,299
1253,2023-01-27,STU,brawlBall,Sneaky Fields,169,125,294
1254,2023-01-27,STU,brawlBall,Pinhole Punt,12,15,27
1255,2023-01-27,STU,bounty,Temple Ruins,11,6,17
1256,2023-01-26,STU,knockout,Riverside,47,19,66
1257,2023-01-26,STU,hotZone,Open Zone,200,240,440
1258,2023-01-26,STU,heist,Hot Potato,16,12,28
1259,2023-01-26,STU,gemGrab,Undermine,59,56,115
1260,2023-01-26,STU,gemGrab,Gem Fort,27,13,40
1261,2023-01-26,STU,brawlBall,Sunny Soccer,51,45,96
1262,2023-01-26,STU,brawlBall,Pinhole Punt,1092,1103,2195
1263,2023-01-26,STU,bounty,Temple Ruins,20,19,39
1264,2023-01-25,STU,knockout,Riverside,10,2,12
1265,2023-01-25,STU,hotZone,Open Zone,128,114,242
1266,2023-01-25,STU,heist,Safe Zone,6,10,16
1267,2023-01-25,STU,gemGrab,Gem Fort,36,30,66
1268,2023-01-25,STU,gemGrab,Crystal Arcade,100,106,206
1269,2023-01-25,STU,brawlBall,Sunny Soccer,708,714,1422
1270,2023-01-25,STU,brawlBall,Beach Ball,106,115,221
1271,2023-01-25,STU,bounty,Excel,24,30,54
1272,2023-01-24,STU,knockout,New Perspective,99,76,175
1273,2023-01-24,STU,hotZone,Dueling Beetles,113,159,272
1274,2023-01-24,STU,heist,Safe Zone,24,10,34
1275,2023-01-24,STU,gemGrab,Minecart Madness,35,43,78
1276,2023-01-24,STU,gemGrab,Crystal Arcade,168,127,295
1277,2023-01-24,STU,brawlBall,Center Stage,53,34,87
1278,2023-01-24,STU,brawlBall,Beach Ball,1230,1438,2668
1279,2023-01-24,STU,bounty,Excel,42,40,82
1280,2023-01-23,STU,knockout,New Perspective,143,85,228
1281,2023-01-23,STU,hotZone,Dueling Beetles,259,259,518
1282,2023-01-23,STU,heist,Snaked Assault,13,3,16
1283,2023-01-23,STU,gemGrab,Minecart Madness,162,203,365
1284,2023-01-23,STU,gemGrab,Double Swoosh,35,25,60
1285,2023-01-23,STU,brawlBall,Center Stage,705,604,1309
1286,2023-01-23,STU,brawlBall,Backyard Bowl,97,82,179
1287,2023-01-23,STU,bounty,Layer Cake,60,32,92
1288,2023-01-22,STU,knockout,X Marks the Spot,41,14,55
1289,2023-01-22,STU,hotZone,Ring of Fire,31,60,91
1290,2023-01-22,STU,heist,Snaked Assault,3,3,6
1291,2023-01-22,STU,gemGrab,Hard Rock Mine,48,58,106
1292,2023-01-22,STU,gemGrab,Double Swoosh,46,49,95
1293,2023-01-22,STU,brawlBall,Super Beach,119,154,273
1294,2023-01-22,STU,brawlBall,Backyard Bowl,768,776,1544
1295,2023-01-22,STU,bounty,Layer Cake,29,21,50
1296,2023-01-21,STU,knockout,X Marks the Spot,112,45,157
1297,2023-01-21,STU,hotZone,Ring of Fire,118,140,258
1298,2023-01-21,STU,heist,Tornado Ring,11,9,20
1299,2023-01-21,STU,gemGrab,Hard Rock Mine,251,297,548
1300,2023-01-21,STU,gemGrab,Deep Diner,70,82,152
1301,2023-01-21,STU,brawlBall,Super Beach,1743,1839,3582
1302,2023-01-21,STU,brawlBall,Sneaky Fields,27,27,54
1303,2023-01-21,STU,bounty,Dry Season,54,66,120
1304,2023-01-20,STU,knockout,Out in the Open,106,63,169
1305,2023-01-20,STU,hotZone,Split,204,310,514
1306,2023-01-20,STU,heist,Tornado Ring,6,8,14
1307,2023-01-20,STU,gemGrab,Undermine,24,39,63
1308,2023-01-20,STU,gemGrab,Deep Diner,355,498,853
1309,2023-01-20,STU,brawlBall,Sneaky Fields,505,426,931
1310,2023-01-20,STU,brawlBall,Pinhole Punt,67,72,139
1311,2023-01-20,STU,bounty,Dry Season,44,19,63
1312,2023-01-19,STU,knockout,Out in the Open,113,66,179
1313,2023-01-19,STU,hotZone,Split,328,526,854
1314,2023-01-19,STU,heist,Kaboom Canyon,18,20,38
1315,2023-01-19,STU,gemGrab,Undermine,87,66,153
1316,2023-01-19,STU,gemGrab,Gem Fort,18,14,32
1317,2023-01-19,STU,brawlBall,Sunny Soccer,40,51,91
1318,2023-01-19,STU,brawlBall,Pinhole Punt,1185,1152,2337
1319,2023-01-19,STU,bounty,Shooting Star,24,14,38
1320,2023-01-18,STU,knockout,Goldarm Gulch,12,10,22
1321,2023-01-18,STU,hotZone,Parallel Plays,29,29,58
1322,2023-01-18,STU,heist,Kaboom Canyon,2,0,2
1323,2023-01-18,STU,gemGrab,Gem Fort,17,34,51
1324,2023-01-18,STU,gemGrab,Crystal Arcade,10,39,49
1325,2023-01-18,STU,brawlBall,Sunny Soccer,287,263,550
1326,2023-01-18,STU,brawlBall,Beach Ball,10,15,25
1327,2023-01-18,STU,bounty,Shooting Star,7,8,15
1328,2023-01-17,STU,knockout,Goldarm Gulch,7,8,15
1329,2023-01-17,STU,hotZone,Parallel Plays,31,39,70
1330,2023-01-17,STU,heist,Pit Stop,3,0,3
1331,2023-01-17,STU,gemGrab,Minecart Madness,2,0,2
1332,2023-01-17,STU,gemGrab,Crystal Arcade,26,21,47
1333,2023-01-17,STU,brawlBall,Center Stage,2,0,2
1334,2023-01-17,STU,brawlBall,Beach Ball,104,98,202
1335,2023-01-17,STU,bounty,Hideout,3,1,4
1336,2023-01-16,STU,knockout,Belle's Rock,13,10,23
1337,2023-01-16,STU,hotZone,Quarter Pounder,32,89,121
1338,2023-01-16,STU,heist,Pit Stop,4,0,4
1339,2023-01-16,STU,gemGrab,Minecart Madness,19,15,34
1340,2023-01-16,STU,gemGrab,Double Swoosh,5,1,6
1341,2023-01-16,STU,brawlBall,Center Stage,43,37,80
1342,2023-01-16,STU,brawlBall,Backyard Bowl,22,30,52
1343,2023-01-16,STU,bounty,Hideout,5,2,7
1344,2023-01-15,STU,knockout,Belle's Rock,17,6,23
1345,2023-01-15,STU,hotZone,Quarter Pounder,60,138,198
1346,2023-01-15,STU,gemGrab,Hard Rock Mine,16,7,23
1347,2023-01-15,STU,gemGrab,Double Swoosh,9,1,10
1348,2023-01-15,STU,brawlBall,Super Beach,16,14,30
1349,2023-01-15,STU,brawlBall,Backyard Bowl,234,279,513
1350,2023-01-15,STU,bounty,Canal Grande,3,8,11
1351,2023-01-14,STU,knockout,Flaring Phoenix,5,1,6
1352,2023-01-14,STU,hotZone,Controller Chaos,38,61,99
1353,2023-01-14,STU,gemGrab,Hard Rock Mine,23,21,44
1354,2023-01-14,STU,gemGrab,Deep Diner,13,13,26
1355,2023-01-14,STU,brawlBall,Super Beach,106,89,195
1356,2023-01-14,STU,brawlBall,Sneaky Fields,11,7,18
1357,2023-01-14,STU,bounty,Canal Grande,2,0,2
1358,2023-01-13,STU,knockout,Flaring Phoenix,10,0,10
1359,2023-01-13,STU,hotZone,Controller Chaos,41,52,93
1360,2023-01-13,STU,gemGrab,Deep Diner,35,23,58
1361,2023-01-13,STU,brawlBall,Sneaky Fields,23,14,37
1362,2023-01-13,STU,brawlBall,Pinhole Punt,3,3,6
1363,2023-01-13,STU,bounty,Temple Ruins,2,0,2
1364,2023-01-12,STU,knockout,Riverside,1,0,1
1365,2023-01-12,STU,hotZone,Open Zone,32,17,49
1366,2023-01-12,STU,gemGrab,Undermine,3,3,6
1367,2023-01-12,STU,brawlBall,Sunny Soccer,4,0,4
1368,2023-01-12,STU,brawlBall,Pinhole Punt,41,40,81
1369,2023-01-11,STU,knockout,Riverside,1,0,1
1370,2023-01-11,STU,hotZone,Open Zone,8,12,20
1371,2023-01-11,STU,gemGrab,Gem Fort,2,3,5
1372,2023-01-11,STU,brawlBall,Sunny Soccer,33,44,77
1373,2023-01-11,STU,bounty,Excel,3,5,8
1374,2023-01-10,STU,knockout,New Perspective,11,1,12
1375,2023-01-10,STU,hotZone,Dueling Beetles,27,9,36
1376,2023-01-10,STU,heist,Safe Zone,0,3,3
1377,2023-01-10,STU,gemGrab,Minecart Madness,5,4,9
1378,2023-01-10,STU,gemGrab,Crystal Arcade,23,11,34
1379,2023-01-10,STU,brawlBall,Center Stage,5,0,5
1380,2023-01-10,STU,brawlBall,Beach Ball,97,98,195
1381,2023-01-10,STU,bounty,Excel,0,2,2
1382,2023-01-09,STU,knockout,New Perspective,3,1,4
1383,2023-01-09,STU,hotZone,Dueling Beetles,15,25,40
1384,2023-01-09,STU,heist,Snaked Assault,1,0,1
1385,2023-01-09,STU,gemGrab,Minecart Madness,21,10,31
1386,2023-01-09,STU,gemGrab,Double Swoosh,10,9,19
1387,2023-01-09,STU,brawlBall,Center Stage,35,18,53
1388,2023-01-09,STU,brawlBall,Backyard Bowl,3,5,8
1389,2023-01-09,STU,bounty,Layer Cake,4,13,17
1390,2023-01-08,STU,knockout,X Marks the Spot,3,2,5
1391,2023-01-08,STU,hotZone,Ring of Fire,6,16,22
1392,2023-01-08,STU,heist,Snaked Assault,2,0,2
1393,2023-01-08,STU,gemGrab,Hard Rock Mine,5,7,12
1394,2023-01-08,STU,gemGrab,Double Swoosh,3,5,8
1395,2023-01-08,STU,brawlBall,Super Beach,7,8,15
1396,2023-01-08,STU,brawlBall,Backyard Bowl,102,96,198
1397,2023-01-07,STU,knockout,X Marks the Spot,2,0,2
1398,2023-01-07,STU,hotZone,Ring of Fire,5,18,23
1399,2023-01-07,STU,gemGrab,Hard Rock Mine,13,35,48
1400,2023-01-07,STU,gemGrab,Deep Diner,13,1,14
1401,2023-01-07,STU,brawlBall,Super Beach,37,35,72
1402,2023-01-07,STU,brawlBall,Sneaky Fields,2,7,9
1403,2023-01-07,STU,bounty,Dry Season,2,0,2
1404,2023-01-06,STU,knockout,Out in the Open,5,4,9
1405,2023-01-06,STU,hotZone,Split,25,66,91
1406,2023-01-06,STU,heist,Tornado Ring,1,0,1
1407,2023-01-06,STU,gemGrab,Undermine,2,1,3
1408,2023-01-06,STU,gemGrab,Deep Diner,46,41,87
1409,2023-01-06,STU,brawlBall,Sneaky Fields,30,23,53
1410,2023-01-06,STU,brawlBall,Pinhole Punt,5,6,11
1411,2023-01-06,STU,bounty,Dry Season,5,1,6
1412,2023-01-05,STU,knockout,Out in the Open,10,4,14
1413,2023-01-05,STU,hotZone,Split,73,109,182
1414,2023-01-05,STU,heist,Kaboom Canyon,1,0,1
1415,2023-01-05,STU,gemGrab,Undermine,10,4,14
1416,2023-01-05,STU,gemGrab,Gem Fort,1,1,2
1417,2023-01-05,STU,brawlBall,Sunny Soccer,1,6,7
1418,2023-01-05,STU,brawlBall,Pinhole Punt,113,141,254
1419,2023-01-04,STU,knockout,Goldarm Gulch,0,2,2
1420,2023-01-04,STU,hotZone,Parallel Plays,18,27,45
1421,2023-01-04,STU,heist,Kaboom Canyon,4,1,5
1422,2023-01-04,STU,gemGrab,Gem Fort,10,4,14
1423,2023-01-04,STU,gemGrab,Crystal Arcade,7,12,19
1424,2023-01-04,STU,brawlBall,Sunny Soccer,106,133,239
1425,2023-01-04,STU,brawlBall,Beach Ball,1,1,2
1426,2023-01-04,STU,bounty,Shooting Star,2,1,3
1427,2023-01-03,STU,knockout,Goldarm Gulch,4,0,4
1428,2023-01-03,STU,hotZone,Parallel Plays,29,22,51
1429,2023-01-03,STU,heist,Pit Stop,1,0,1
1430,2023-01-03,STU,gemGrab,Minecart Madness,3,6,9
1431,2023-01-03,STU,gemGrab,Crystal Arcade,29,78,107
1432,2023-01-03,STU,brawlBall,Center Stage,2,11,13
1433,2023-01-03,STU,brawlBall,Beach Ball,145,174,319
1434,2023-01-03,STU,bounty,Hideout,9,1,10
1435,2023-01-02,STU,knockout,Belle's Rock,10,1,11
1436,2023-01-02,STU,hotZone,Quarter Pounder,51,64,115
1437,2023-01-02,STU,heist,Pit Stop,2,0,2
1438,2023-01-02,STU,gemGrab,Minecart Madness,22,28,50
1439,2023-01-02,STU,gemGrab,Double Swoosh,7,2,9
1440,2023-01-02,STU,brawlBall,Center Stage,52,38,90
1441,2023-01-02,STU,brawlBall,Backyard Bowl,17,12,29
1442,2023-01-02,STU,bounty,Hideout,6,4,10
1443,2023-01-01,STU,knockout,Belle's Rock,3,0,3
1444,2023-01-01,STU,hotZone,Quarter Pounder,20,17,37
1445,2023-01-01,STU,hotZone,Controller Chaos,0,1,1
1446,2023-01-01,STU,heist,Kaboom Canyon,0,1,1
1447,2023-01-01,STU,heist,Bridge Too Far,0,1,1
1448,2023-01-01,STU,gemGrab,Minecart Madness,0,1,1
1449,2023-01-01,STU,gemGrab,Double Swoosh,4,4,8
1450,2023-01-01,STU,brawlBall,Backyard Bowl,52,87,139
1451,2023-01-01,STU,bounty,Canal Grande,1,0,1
1452,2022-12-31,STU,knockout,Flaring Phoenix,1,0,1
1453,2022-12-31,STU,hotZone,Controller Chaos,2,1,3
1454,2022-12-31,STU,gemGrab,Minecart Madness,2,0,2
1455,2022-12-31,STU,gemGrab,Hard Rock Mine,8,23,31
1456,2022-12-31,STU,gemGrab,Deep Diner,5,7,12
1457,2022-12-31,STU,brawlBall,Super Beach,13,9,22
1458,2022-12-31,STU,brawlBall,Sneaky Fields,1,0,1
1459,2022-12-30,STU,knockout,Flaring Phoenix,2,0,2
1460,2022-12-30,STU,hotZone,Controller Chaos,4,1,5
1461,2022-12-30,STU,gemGrab,Undermine,0,1,1
1462,2022-12-30,STU,gemGrab,Minecart Madness,1,0,1
1463,2022-12-30,STU,gemGrab,Deep Diner,9,7,16
1464,2022-12-30,STU,brawlBall,Sneaky Fields,6,2,8
1465,2022-12-29,STU,hotZone,Open Zone,1,1,2
1466,2022-12-29,STU,gemGrab,Minecart Madness,0,1,1
1467,2022-12-29,STU,brawlBall,Pinhole Punt,6,1,7
1468,2022-12-28,STU,hotZone,Open Zone,4,0,4
1469,2022-12-27,STU,hotZone,Controller Chaos,0,2,2
1470,2022-12-27,STU,brawlBall,Center Stage,1,0,1
1471,2022-12-27,STU,brawlBall,Beach Ball,6,6,12
1472,2022-12-26,STU,hotZone,Controller Chaos,1,1,2
1473,2022-12-26,STU,brawlBall,Center Stage,1,0,1
1474,2022-12-25,STU,hotZone,Ring of Fire,1,0,1
1475,2022-12-25,STU,brawlBall,Backyard Bowl,2,0,2
1476,2022-12-24,STU,brawlBall,Super Beach,5,4,9
1477,2022-12-23,STU,knockout,Out in the Open,4,2,6
1478,2022-12-22,STU,brawlBall,Pinhole Punt,3,2,5
1479,2022-12-21,STU,brawlBall,Sunny Soccer,0,1,1
1480,2022-12-19,STU,brawlBall,Center Stage,1,1,2
1481,2022-12-16,STU,brawlBall,Sneaky Fields,0,2,2
1482,2022-12-13,STU,brawlBall,Beach Ball,0,1,1
1483,2022-12-12,STU,brawlBall,Center Stage,2,0,2
1484,2022-11-18,STU,hotZone,Parallel Plays,6,0,6
1485,2022-11-03,STU,brawlBall,Pinhole Punt,0,2,2
1486,2022-10-30,STU,brawlBall,Beach Ball,0,2,2
1487,2022-10-15,STU,gemGrab,Hard Rock Mine,4,2,6
1488,2022-10-10,STU,knockout,Belle's Rock,1,0,1
1489,2023-02-11,SQUEAK,knockout,Flaring Phoenix,40,27,67
1490,2023-02-11,SQUEAK,hotZone,Controller Chaos,77,53,130
1491,2023-02-11,SQUEAK,gemGrab,Deep Diner,40,59,99
1492,2023-02-11,SQUEAK,brawlBall,Super Beach,46,54,100
1493,2023-02-11,SQUEAK,brawlBall,Sneaky Fields,12,17,29
1494,2023-02-10,SQUEAK,knockout,Flaring Phoenix,71,59,130
1495,2023-02-10,SQUEAK,hotZone,Controller Chaos,108,111,219
1496,2023-02-10,SQUEAK,heist,Hot Potato,14,12,26
1497,2023-02-10,SQUEAK,gemGrab,Undermine,26,25,51
1498,2023-02-10,SQUEAK,gemGrab,Deep Diner,111,113,224
1499,2023-02-10,SQUEAK,brawlBall,Sneaky Fields,246,268,514
1500,2023-02-10,SQUEAK,brawlBall,Pinhole Punt,15,11,26
1501,2023-02-10,SQUEAK,bounty,Temple Ruins,30,39,69
1502,2023-02-09,SQUEAK,knockout,Riverside,4,7,11
1503,2023-02-09,SQUEAK,hotZone,Open Zone,12,4,16
1504,2023-02-09,SQUEAK,heist,Hot Potato,2,4,6
1505,2023-02-09,SQUEAK,gemGrab,Undermine,15,10,25
1506,2023-02-09,SQUEAK,gemGrab,Gem Fort,2,2,4
1507,2023-02-09,SQUEAK,brawlBall,Sunny Soccer,2,0,2
1508,2023-02-09,SQUEAK,brawlBall,Pinhole Punt,82,84,166
1509,2023-02-09,SQUEAK,bounty,Temple Ruins,7,6,13
1510,2023-02-08,SQUEAK,knockout,Riverside,6,3,9
1511,2023-02-08,SQUEAK,hotZone,Open Zone,4,6,10
1512,2023-02-08,SQUEAK,heist,Safe Zone,8,2,10
1513,2023-02-08,SQUEAK,gemGrab,Gem Fort,20,9,29
1514,2023-02-08,SQUEAK,gemGrab,Crystal Arcade,5,2,7
1515,2023-02-08,SQUEAK,brawlBall,Sunny Soccer,25,37,62
1516,2023-02-08,SQUEAK,bounty,Excel,8,7,15
1517,2023-02-07,SQUEAK,knockout,New Perspective,1,1,2
1518,2023-02-07,SQUEAK,hotZone,Dueling Beetles,20,48,68
1519,2023-02-07,SQUEAK,heist,Safe Zone,1,1,2
1520,2023-02-07,SQUEAK,gemGrab,Minecart Madness,9,5,14
1521,2023-02-07,SQUEAK,gemGrab,Crystal Arcade,6,6,12
1522,2023-02-07,SQUEAK,brawlBall,Beach Ball,16,16,32
1523,2023-02-07,SQUEAK,bounty,Excel,3,0,3
1524,2023-02-06,SQUEAK,knockout,New Perspective,75,83,158
1525,2023-02-06,SQUEAK,hotZone,Dueling Beetles,386,425,811
1526,2023-02-06,SQUEAK,heist,Snaked Assault,18,2,20
1527,2023-02-06,SQUEAK,heist,Pit Stop,1,0,1
1528,2023-02-06,SQUEAK,gemGrab,Minecart Madness,176,180,356
1529,2023-02-06,SQUEAK,gemGrab,Double Swoosh,51,48,99
1530,2023-02-06,SQUEAK,brawlBall,Sneaky Fields,3,3,6
1531,2023-02-06,SQUEAK,brawlBall,Center Stage,360,393,753
1532,2023-02-06,SQUEAK,brawlBall,Backyard Bowl,16,15,31
1533,2023-02-06,SQUEAK,bounty,Layer Cake,46,27,73
1534,2023-02-05,SQUEAK,knockout,X Marks the Spot,48,31,79
1535,2023-02-05,SQUEAK,knockout,Goldarm Gulch,6,2,8
1536,2023-02-05,SQUEAK,hotZone,Ring of Fire,103,87,190
1537,2023-02-05,SQUEAK,heist,Snaked Assault,33,20,53
1538,2023-02-05,SQUEAK,heist,Pit Stop,5,2,7
1539,2023-02-05,SQUEAK,gemGrab,Hard Rock Mine,13,17,30
1540,2023-02-05,SQUEAK,gemGrab,Double Swoosh,137,127,264
1541,2023-02-05,SQUEAK,brawlBall,Super Beach,8,13,21
1542,2023-02-05,SQUEAK,brawlBall,Sneaky Fields,15,14,29
1543,2023-02-05,SQUEAK,brawlBall,Backyard Bowl,175,151,326
1544,2023-02-05,SQUEAK,bounty,Layer Cake,35,29,64
1545,2023-02-04,SQUEAK,knockout,X Marks the Spot,18,18,36
1546,2023-02-04,SQUEAK,knockout,Goldarm Gulch,3,3,6
1547,2023-02-04,SQUEAK,hotZone,Ring of Fire,37,21,58
1548,2023-02-04,SQUEAK,heist,Tornado Ring,3,0,3
1549,2023-02-04,SQUEAK,heist,Pit Stop,3,1,4
1550,2023-02-04,SQUEAK,gemGrab,Hard Rock Mine,19,20,39
1551,2023-02-04,SQUEAK,gemGrab,Double Swoosh,20,9,29
1552,2023-02-04,SQUEAK,gemGrab,Deep Diner,11,6,17
1553,2023-02-04,SQUEAK,brawlBall,Super Beach,73,77,150
1554,2023-02-04,SQUEAK,brawlBall,Sneaky Fields,17,8,25
1555,2023-02-04,SQUEAK,bounty,Dry Season,11,10,21
1556,2023-02-03,SQUEAK,knockout,Out in the Open,125,137,262
1557,2023-02-03,SQUEAK,knockout,Goldarm Gulch,23,7,30
1558,2023-02-03,SQUEAK,hotZone,Split,39,32,71
1559,2023-02-03,SQUEAK,heist,Tornado Ring,24,16,40
1560,2023-02-03,SQUEAK,heist,Pit Stop,17,10,27
1561,2023-02-03,SQUEAK,gemGrab,Undermine,18,15,33
1562,2023-02-03,SQUEAK,gemGrab,Double Swoosh,97,96,193
1563,2023-02-03,SQUEAK,gemGrab,Deep Diner,128,110,238
1564,2023-02-03,SQUEAK,brawlBall,Sneaky Fields,329,330,659
1565,2023-02-03,SQUEAK,brawlBall,Pinhole Punt,11,4,15
1566,2023-02-03,SQUEAK,bounty,Dry Season,41,41,82
1567,2023-02-02,SQUEAK,knockout,Out in the Open,47,60,107
1568,2023-02-02,SQUEAK,hotZone,Split,13,8,21
1569,2023-02-02,SQUEAK,heist,Kaboom Canyon,6,5,11
1570,2023-02-02,SQUEAK,gemGrab,Undermine,17,20,37
1571,2023-02-02,SQUEAK,gemGrab,Gem Fort,16,5,21
1572,2023-02-02,SQUEAK,brawlBall,Sunny Soccer,3,2,5
1573,2023-02-02,SQUEAK,brawlBall,Pinhole Punt,52,58,110
1574,2023-02-02,SQUEAK,bounty,Shooting Star,2,3,5
1575,2023-02-01,SQUEAK,knockout,Goldarm Gulch,77,52,129
1576,2023-02-01,SQUEAK,hotZone,Parallel Plays,69,83,152
1577,2023-02-01,SQUEAK,heist,Kaboom Canyon,20,11,31
1578,2023-02-01,SQUEAK,gemGrab,Gem Fort,59,42,101
1579,2023-02-01,SQUEAK,gemGrab,Crystal Arcade,49,41,90
1580,2023-02-01,SQUEAK,brawlBall,Sunny Soccer,220,276,496
1581,2023-02-01,SQUEAK,brawlBall,Beach Ball,8,16,24
1582,2023-02-01,SQUEAK,bounty,Shooting Star,15,7,22
1583,2023-01-31,SQUEAK,knockout,Goldarm Gulch,34,30,64
1584,2023-01-31,SQUEAK,hotZone,Parallel Plays,54,49,103
1585,2023-01-31,SQUEAK,heist,Pit Stop,8,2,10
1586,2023-01-31,SQUEAK,gemGrab,Minecart Madness,19,24,43
1587,2023-01-31,SQUEAK,gemGrab,Crystal Arcade,52,50,102
1588,2023-01-31,SQUEAK,brawlBall,Center Stage,2,4,6
1589,2023-01-31,SQUEAK,brawlBall,Beach Ball,116,117,233
1590,2023-01-31,SQUEAK,bounty,Hideout,9,10,19
1591,2023-01-30,SQUEAK,knockout,Belle's Rock,154,152,306
1592,2023-01-30,SQUEAK,hotZone,Quarter Pounder,99,132,231
1593,2023-01-30,SQUEAK,heist,Pit Stop,5,2,7
1594,2023-01-30,SQUEAK,gemGrab,Minecart Madness,121,125,246
1595,2023-01-30,SQUEAK,gemGrab,Double Swoosh,40,63,103
1596,2023-01-30,SQUEAK,brawlBall,Center Stage,157,156,313
1597,2023-01-30,SQUEAK,brawlBall,Backyard Bowl,15,7,22
1598,2023-01-30,SQUEAK,bounty,Hideout,13,15,28
1599,2023-01-29,SQUEAK,knockout,Belle's Rock,123,134,257
1600,2023-01-29,SQUEAK,hotZone,Quarter Pounder,62,72,134
1601,2023-01-29,SQUEAK,heist,Bridge Too Far,29,16,45
1602,2023-01-29,SQUEAK,gemGrab,Hard Rock Mine,17,7,24
1603,2023-01-29,SQUEAK,gemGrab,Double Swoosh,94,102,196
1604,2023-01-29,SQUEAK,brawlBall,Super Beach,1,1,2
1605,2023-01-29,SQUEAK,brawlBall,Backyard Bowl,129,175,304
1606,2023-01-29,SQUEAK,bounty,Canal Grande,36,58,94
1607,2023-01-28,SQUEAK,knockout,Flaring Phoenix,37,23,60
1608,2023-01-28,SQUEAK,hotZone,Controller Chaos,117,192,309
1609,2023-01-28,SQUEAK,heist,Bridge Too Far,62,51,113
1610,2023-01-28,SQUEAK,gemGrab,Hard Rock Mine,42,37,79
1611,2023-01-28,SQUEAK,gemGrab,Deep Diner,46,53,99
1612,2023-01-28,SQUEAK,brawlBall,Super Beach,192,227,419
1613,2023-01-28,SQUEAK,brawlBall,Sneaky Fields,4,8,12
1614,2023-01-28,SQUEAK,bounty,Canal Grande,51,77,128
1615,2023-01-27,SQUEAK,knockout,Flaring Phoenix,14,16,30
1616,2023-01-27,SQUEAK,hotZone,Controller Chaos,29,15,44
1617,2023-01-27,SQUEAK,heist,Hot Potato,11,6,17
1618,2023-01-27,SQUEAK,gemGrab,Undermine,4,2,6
1619,2023-01-27,SQUEAK,gemGrab,Deep Diner,43,26,69
1620,2023-01-27,SQUEAK,brawlBall,Sneaky Fields,75,85,160
1621,2023-01-27,SQUEAK,brawlBall,Pinhole Punt,2,2,4
1622,2023-01-27,SQUEAK,bounty,Temple Ruins,9,5,14
1623,2023-01-26,SQUEAK,knockout,Riverside,62,53,115
1624,2023-01-26,SQUEAK,hotZone,Open Zone,36,37,73
1625,2023-01-26,SQUEAK,heist,Hot Potato,21,13,34
1626,2023-01-26,SQUEAK,gemGrab,Undermine,38,15,53
1627,2023-01-26,SQUEAK,gemGrab,Gem Fort,16,14,30
1628,2023-01-26,SQUEAK,brawlBall,Sunny Soccer,17,16,33
1629,2023-01-26,SQUEAK,brawlBall,Pinhole Punt,209,243,452
1630,2023-01-26,SQUEAK,bounty,Temple Ruins,14,9,23
1631,2023-01-25,SQUEAK,knockout,Riverside,26,24,50
1632,2023-01-25,SQUEAK,hotZone,Open Zone,10,13,23
1633,2023-01-25,SQUEAK,heist,Safe Zone,29,21,50
1634,2023-01-25,SQUEAK,gemGrab,Gem Fort,20,16,36
1635,2023-01-25,SQUEAK,gemGrab,Crystal Arcade,43,30,73
1636,2023-01-25,SQUEAK,brawlBall,Sunny Soccer,125,150,275
1637,2023-01-25,SQUEAK,brawlBall,Beach Ball,12,12,24
1638,2023-01-25,SQUEAK,bounty,Excel,20,12,32
1639,2023-01-24,SQUEAK,knockout,New Perspective,49,38,87
1640,2023-01-24,SQUEAK,hotZone,Dueling Beetles,201,306,507
1641,2023-01-24,SQUEAK,heist,Safe Zone,48,42,90
1642,2023-01-24,SQUEAK,gemGrab,Minecart Madness,37,52,89
1643,2023-01-24,SQUEAK,gemGrab,Crystal Arcade,78,91,169
1644,2023-01-24,SQUEAK,brawlBall,Center Stage,25,32,57
1645,2023-01-24,SQUEAK,brawlBall,Beach Ball,227,235,462
1646,2023-01-24,SQUEAK,bounty,Excel,24,31,55
1647,2023-01-23,SQUEAK,knockout,New Perspective,68,77,145
1648,2023-01-23,SQUEAK,hotZone,Dueling Beetles,354,532,886
1649,2023-01-23,SQUEAK,heist,Snaked Assault,25,25,50
1650,2023-01-23,SQUEAK,gemGrab,Minecart Madness,193,206,399
1651,2023-01-23,SQUEAK,gemGrab,Double Swoosh,41,29,70
1652,2023-01-23,SQUEAK,brawlBall,Center Stage,346,396,742
1653,2023-01-23,SQUEAK,brawlBall,Backyard Bowl,5,5,10
1654,2023-01-23,SQUEAK,bounty,Layer Cake,44,46,90
1655,2023-01-22,SQUEAK,knockout,X Marks the Spot,36,38,74
1656,2023-01-22,SQUEAK,hotZone,Ring of Fire,33,24,57
1657,2023-01-22,SQUEAK,heist,Snaked Assault,8,2,10
1658,2023-01-22,SQUEAK,gemGrab,Hard Rock Mine,17,10,27
1659,2023-01-22,SQUEAK,gemGrab,Double Swoosh,51,60,111
1660,2023-01-22,SQUEAK,brawlBall,Super Beach,18,15,33
1661,2023-01-22,SQUEAK,brawlBall,Backyard Bowl,54,28,82
1662,2023-01-22,SQUEAK,bounty,Layer Cake,24,30,54
1663,2023-01-21,SQUEAK,knockout,X Marks the Spot,126,97,223
1664,2023-01-21,SQUEAK,hotZone,Ring of Fire,116,119,235
1665,2023-01-21,SQUEAK,heist,Tornado Ring,22,7,29
1666,2023-01-21,SQUEAK,gemGrab,Hard Rock Mine,93,58,151
1667,2023-01-21,SQUEAK,gemGrab,Deep Diner,23,34,57
1668,2023-01-21,SQUEAK,brawlBall,Super Beach,309,286,595
1669,2023-01-21,SQUEAK,brawlBall,Sneaky Fields,10,7,17
1670,2023-01-21,SQUEAK,bounty,Dry Season,28,42,70
1671,2023-01-20,SQUEAK,knockout,Out in the Open,123,146,269
1672,2023-01-20,SQUEAK,hotZone,Split,46,51,97
1673,2023-01-20,SQUEAK,heist,Tornado Ring,12,13,25
1674,2023-01-20,SQUEAK,gemGrab,Undermine,28,21,49
1675,2023-01-20,SQUEAK,gemGrab,Deep Diner,122,177,299
1676,2023-01-20,SQUEAK,brawlBall,Sneaky Fields,258,243,501
1677,2023-01-20,SQUEAK,brawlBall,Pinhole Punt,11,14,25
1678,2023-01-20,SQUEAK,bounty,Dry Season,35,53,88
1679,2023-01-19,SQUEAK,knockout,Out in the Open,136,120,256
1680,2023-01-19,SQUEAK,hotZone,Split,44,21,65
1681,2023-01-19,SQUEAK,heist,Kaboom Canyon,19,13,32
1682,2023-01-19,SQUEAK,gemGrab,Undermine,59,57,116
1683,2023-01-19,SQUEAK,gemGrab,Gem Fort,13,4,17
1684,2023-01-19,SQUEAK,brawlBall,Sunny Soccer,7,12,19
1685,2023-01-19,SQUEAK,brawlBall,Pinhole Punt,190,209,399
1686,2023-01-19,SQUEAK,bounty,Shooting Star,19,16,35
1687,2023-01-18,SQUEAK,knockout,Goldarm Gulch,7,12,19
1688,2023-01-18,SQUEAK,hotZone,Parallel Plays,4,5,9
1689,2023-01-18,SQUEAK,heist,Kaboom Canyon,5,10,15
1690,2023-01-18,SQUEAK,gemGrab,Gem Fort,12,5,17
1691,2023-01-18,SQUEAK,gemGrab,Crystal Arcade,6,0,6
1692,2023-01-18,SQUEAK,brawlBall,Sunny Soccer,98,87,185
1693,2023-01-18,SQUEAK,brawlBall,Beach Ball,3,1,4
1694,2023-01-18,SQUEAK,bounty,Shooting Star,10,7,17
1695,2023-01-17,SQUEAK,knockout,Goldarm Gulch,7,7,14
1696,2023-01-17,SQUEAK,hotZone,Parallel Plays,9,4,13
1697,2023-01-17,SQUEAK,heist,Pit Stop,3,1,4
1698,2023-01-17,SQUEAK,gemGrab,Minecart Madness,1,3,4
1699,2023-01-17,SQUEAK,gemGrab,Crystal Arcade,7,9,16
1700,2023-01-17,SQUEAK,brawlBall,Beach Ball,31,18,49
1701,2023-01-17,SQUEAK,bounty,Hideout,2,0,2
1702,2023-01-16,SQUEAK,knockout,Belle's Rock,5,3,8
1703,2023-01-16,SQUEAK,hotZone,Quarter Pounder,9,0,9
1704,2023-01-16,SQUEAK,heist,Pit Stop,3,0,3
1705,2023-01-16,SQUEAK,gemGrab,Minecart Madness,15,16,31
1706,2023-01-16,SQUEAK,gemGrab,Double Swoosh,3,12,15
1707,2023-01-16,SQUEAK,brawlBall,Center Stage,27,45,72
1708,2023-01-16,SQUEAK,brawlBall,Backyard Bowl,2,7,9
1709,2023-01-16,SQUEAK,bounty,Hideout,3,3,6
1710,2023-01-15,SQUEAK,knockout,Belle's Rock,9,3,12
1711,2023-01-15,SQUEAK,hotZone,Quarter Pounder,16,37,53
1712,2023-01-15,SQUEAK,heist,Bridge Too Far,8,3,11
1713,2023-01-15,SQUEAK,gemGrab,Hard Rock Mine,4,0,4
1714,2023-01-15,SQUEAK,gemGrab,Double Swoosh,4,6,10
1715,2023-01-15,SQUEAK,brawlBall,Super Beach,3,4,7
1716,2023-01-15,SQUEAK,brawlBall,Backyard Bowl,11,9,20
1717,2023-01-15,SQUEAK,bounty,Canal Grande,3,7,10
1718,2023-01-14,SQUEAK,knockout,Flaring Phoenix,5,0,5
1719,2023-01-14,SQUEAK,hotZone,Controller Chaos,17,33,50
1720,2023-01-14,SQUEAK,heist,Bridge Too Far,6,6,12
1721,2023-01-14,SQUEAK,gemGrab,Hard Rock Mine,2,0,2
1722,2023-01-14,SQUEAK,gemGrab,Deep Diner,2,0,2
1723,2023-01-14,SQUEAK,brawlBall,Super Beach,11,20,31
1724,2023-01-14,SQUEAK,brawlBall,Sneaky Fields,4,4,8
1725,2023-01-14,SQUEAK,bounty,Canal Grande,3,0,3
1726,2023-01-13,SQUEAK,knockout,Flaring Phoenix,4,1,5
1727,2023-01-13,SQUEAK,hotZone,Controller Chaos,32,72,104
1728,2023-01-13,SQUEAK,heist,Hot Potato,1,1,2
1729,2023-01-13,SQUEAK,gemGrab,Deep Diner,11,31,42
1730,2023-01-13,SQUEAK,brawlBall,Sneaky Fields,11,9,20
1731,2023-01-13,SQUEAK,bounty,Temple Ruins,0,1,1
1732,2023-01-12,SQUEAK,knockout,Riverside,6,0,6
1733,2023-01-12,SQUEAK,hotZone,Open Zone,8,4,12
1734,2023-01-12,SQUEAK,heist,Hot Potato,1,1,2
1735,2023-01-12,SQUEAK,gemGrab,Undermine,1,0,1
1736,2023-01-12,SQUEAK,brawlBall,Pinhole Punt,4,4,8
1737,2023-01-11,SQUEAK,brawlBall,Sunny Soccer,3,3,6
1738,2023-01-11,SQUEAK,bounty,Excel,3,7,10
1739,2023-01-10,SQUEAK,knockout,New Perspective,7,0,7
1740,2023-01-10,SQUEAK,hotZone,Dueling Beetles,29,53,82
1741,2023-01-10,SQUEAK,gemGrab,Minecart Madness,5,2,7
1742,2023-01-10,SQUEAK,gemGrab,Crystal Arcade,2,0,2
1743,2023-01-10,SQUEAK,brawlBall,Center Stage,2,6,8
1744,2023-01-10,SQUEAK,brawlBall,Beach Ball,17,42,59
1745,2023-01-10,SQUEAK,bounty,Excel,1,0,1
1746,2023-01-09,SQUEAK,knockout,New Perspective,1,0,1
1747,2023-01-09,SQUEAK,hotZone,Dueling Beetles,34,65,99
1748,2023-01-09,SQUEAK,heist,Snaked Assault,2,2,4
1749,2023-01-09,SQUEAK,gemGrab,Minecart Madness,6,4,10
1750,2023-01-09,SQUEAK,gemGrab,Double Swoosh,8,8,16
1751,2023-01-09,SQUEAK,brawlBall,Center Stage,9,7,16
1752,2023-01-09,SQUEAK,brawlBall,Backyard Bowl,2,2,4
1753,2023-01-09,SQUEAK,bounty,Layer Cake,1,1,2
1754,2023-01-08,SQUEAK,knockout,X Marks the Spot,5,1,6
1755,2023-01-08,SQUEAK,hotZone,Ring of Fire,14,6,20
1756,2023-01-08,SQUEAK,heist,Snaked Assault,2,1,3
1757,2023-01-08,SQUEAK,gemGrab,Hard Rock Mine,3,0,3
1758,2023-01-08,SQUEAK,gemGrab,Double Swoosh,5,2,7
1759,2023-01-08,SQUEAK,brawlBall,Super Beach,5,3,8
1760,2023-01-08,SQUEAK,brawlBall,Backyard Bowl,10,2,12
1761,2023-01-08,SQUEAK,bounty,Layer Cake,2,4,6
1762,2023-01-07,SQUEAK,knockout,X Marks the Spot,1,0,1
1763,2023-01-07,SQUEAK,hotZone,Ring of Fire,2,1,3
1764,2023-01-07,SQUEAK,gemGrab,Deep Diner,2,2,4
1765,2023-01-07,SQUEAK,brawlBall,Super Beach,7,9,16
1766,2023-01-07,SQUEAK,bounty,Dry Season,4,0,4
1767,2023-01-06,SQUEAK,knockout,Out in the Open,4,2,6
1768,2023-01-06,SQUEAK,heist,Tornado Ring,2,0,2
1769,2023-01-06,SQUEAK,gemGrab,Undermine,2,14,16
1770,2023-01-06,SQUEAK,gemGrab,Deep Diner,9,15,24
1771,2023-01-06,SQUEAK,brawlBall,Sneaky Fields,12,12,24
1772,2023-01-06,SQUEAK,brawlBall,Pinhole Punt,0,2,2
1773,2023-01-06,SQUEAK,bounty,Dry Season,1,2,3
1774,2023-01-05,SQUEAK,knockout,Out in the Open,6,2,8
1775,2023-01-05,SQUEAK,hotZone,Split,11,19,30
1776,2023-01-05,SQUEAK,heist,Kaboom Canyon,2,1,3
1777,2023-01-05,SQUEAK,gemGrab,Undermine,4,10,14
1778,2023-01-05,SQUEAK,gemGrab,Gem Fort,2,0,2
1779,2023-01-05,SQUEAK,brawlBall,Pinhole Punt,16,15,31
1780,2023-01-04,SQUEAK,hotZone,Parallel Plays,4,1,5
1781,2023-01-04,SQUEAK,heist,Kaboom Canyon,3,0,3
1782,2023-01-04,SQUEAK,gemGrab,Gem Fort,1,0,1
1783,2023-01-04,SQUEAK,gemGrab,Crystal Arcade,1,0,1
1784,2023-01-04,SQUEAK,brawlBall,Sunny Soccer,23,26,49
1785,2023-01-04,SQUEAK,bounty,Shooting Star,0,1,1
1786,2023-01-03,SQUEAK,knockout,Goldarm Gulch,0,2,2
1787,2023-01-03,SQUEAK,hotZone,Parallel Plays,4,1,5
1788,2023-01-03,SQUEAK,heist,Pit Stop,4,17,21
1789,2023-01-03,SQUEAK,gemGrab,Minecart Madness,4,11,15
1790,2023-01-03,SQUEAK,gemGrab,Crystal Arcade,6,5,11
1791,2023-01-03,SQUEAK,brawlBall,Center Stage,0,1,1
1792,2023-01-03,SQUEAK,brawlBall,Beach Ball,7,22,29
1793,2023-01-03,SQUEAK,bounty,Hideout,1,2,3
1794,2023-01-02,SQUEAK,knockout,Belle's Rock,4,3,7
1795,2023-01-02,SQUEAK,hotZone,Quarter Pounder,11,19,30
1796,2023-01-02,SQUEAK,heist,Pit Stop,5,0,5
1797,2023-01-02,SQUEAK,heist,Kaboom Canyon,1,0,1
1798,2023-01-02,SQUEAK,gemGrab,Minecart Madness,15,10,25
1799,2023-01-02,SQUEAK,gemGrab,Double Swoosh,3,2,5
1800,2023-01-02,SQUEAK,brawlBall,Center Stage,19,12,31
1801,2023-01-02,SQUEAK,brawlBall,Backyard Bowl,0,1,1
1802,2023-01-02,SQUEAK,bounty,Hideout,2,0,2
1803,2023-01-01,SQUEAK,knockout,Belle's Rock,1,2,3
1804,2023-01-01,SQUEAK,hotZone,Quarter Pounder,8,14,22
1805,2023-01-01,SQUEAK,heist,Kaboom Canyon,0,2,2
1806,2023-01-01,SQUEAK,heist,Bridge Too Far,1,0,1
1807,2023-01-01,SQUEAK,gemGrab,Minecart Madness,1,2,3
1808,2023-01-01,SQUEAK,gemGrab,Double Swoosh,2,5,7
1809,2023-01-01,SQUEAK,brawlBall,Backyard Bowl,2,0,2
1810,2023-01-01,SQUEAK,bounty,Canal Grande,0,2,2
1811,2022-12-31,SQUEAK,heist,Bridge Too Far,1,0,1
1812,2022-12-31,SQUEAK,gemGrab,Minecart Madness,2,0,2
1813,2022-12-31,SQUEAK,gemGrab,Hard Rock Mine,2,0,2
1814,2022-12-31,SQUEAK,gemGrab,Deep Diner,1,5,6
1815,2022-12-31,SQUEAK,brawlBall,Super Beach,5,0,5
1816,2022-12-30,SQUEAK,hotZone,Controller Chaos,2,1,3
1817,2022-12-30,SQUEAK,gemGrab,Undermine,4,14,18
1818,2022-12-30,SQUEAK,gemGrab,Deep Diner,4,0,4
1819,2022-12-30,SQUEAK,brawlBall,Sneaky Fields,4,0,4
1820,2022-12-29,SQUEAK,hotZone,Open Zone,0,1,1
1821,2022-12-29,SQUEAK,gemGrab,Minecart Madness,0,1,1
1822,2022-12-27,SQUEAK,hotZone,Dueling Beetles,1,1,2
1823,2022-12-27,SQUEAK,hotZone,Controller Chaos,0,1,1
1824,2022-12-27,SQUEAK,heist,Kaboom Canyon,0,1,1
1825,2022-12-27,SQUEAK,brawlBall,Beach Ball,1,0,1
1826,2022-12-26,SQUEAK,hotZone,Controller Chaos,0,1,1
1827,2022-12-26,SQUEAK,heist,Kaboom Canyon,0,1,1
1828,2022-12-26,SQUEAK,gemGrab,Minecart Madness,1,0,1
1829,2022-12-23,SQUEAK,knockout,Out in the Open,2,0,2
1830,2022-12-21,SQUEAK,brawlBall,Sunny Soccer,1,0,1
1831,2022-12-20,SQUEAK,brawlBall,Beach Ball,1,0,1
1832,2022-12-19,SQUEAK,gemGrab,Minecart Madness,2,2,4
1833,2022-12-16,SQUEAK,hotZone,Controller Chaos,1,0,1
1834,2022-12-13,SQUEAK,gemGrab,Crystal Arcade,1,0,1
1835,2022-12-11,SQUEAK,brawlBall,Backyard Bowl,2,0,2
1836,2022-11-07,SQUEAK,hotZone,Quarter Pounder,4,4,8
1837,2022-10-15,SQUEAK,gemGrab,Hard Rock Mine,1,0,1
1838,2023-02-11,SPROUT,knockout,Flaring Phoenix,67,83,150
1839,2023-02-11,SPROUT,hotZone,Controller Chaos,11,3,14
1840,2023-02-11,SPROUT,gemGrab,Deep Diner,16,11,27
1841,2023-02-11,SPROUT,brawlBall,Super Beach,7,2,9
1842,2023-02-11,SPROUT,brawlBall,Sneaky Fields,9,2,11
1843,2023-02-10,SPROUT,knockout,Flaring Phoenix,127,122,249
1844,2023-02-10,SPROUT,hotZone,Controller Chaos,46,38,84
1845,2023-02-10,SPROUT,heist,Hot Potato,2,1,3
1846,2023-02-10,SPROUT,gemGrab,Undermine,8,3,11
1847,2023-02-10,SPROUT,gemGrab,Deep Diner,45,45,90
1848,2023-02-10,SPROUT,brawlBall,Sneaky Fields,75,42,117
1849,2023-02-10,SPROUT,brawlBall,Pinhole Punt,2,0,2
1850,2023-02-10,SPROUT,bounty,Temple Ruins,22,32,54
1851,2023-02-09,SPROUT,knockout,Riverside,13,9,22
1852,2023-02-09,SPROUT,heist,Hot Potato,5,0,5
1853,2023-02-09,SPROUT,gemGrab,Undermine,7,5,12
1854,2023-02-09,SPROUT,brawlBall,Sunny Soccer,1,1,2
1855,2023-02-09,SPROUT,brawlBall,Pinhole Punt,16,9,25
1856,2023-02-09,SPROUT,bounty,Temple Ruins,2,4,6
1857,2023-02-08,SPROUT,knockout,Riverside,5,7,12
1858,2023-02-08,SPROUT,hotZone,Open Zone,2,0,2
1859,2023-02-08,SPROUT,heist,Safe Zone,3,1,4
1860,2023-02-08,SPROUT,gemGrab,Gem Fort,6,0,6
1861,2023-02-08,SPROUT,gemGrab,Crystal Arcade,2,0,2
1862,2023-02-08,SPROUT,brawlBall,Sunny Soccer,5,11,16
1863,2023-02-08,SPROUT,brawlBall,Beach Ball,1,0,1
1864,2023-02-08,SPROUT,bounty,Excel,7,23,30
1865,2023-02-07,SPROUT,knockout,New Perspective,4,5,9
1866,2023-02-07,SPROUT,hotZone,Dueling Beetles,13,5,18
1867,2023-02-07,SPROUT,heist,Safe Zone,1,0,1
1868,2023-02-07,SPROUT,gemGrab,Minecart Madness,0,3,3
1869,2023-02-07,SPROUT,gemGrab,Crystal Arcade,6,2,8
1870,2023-02-07,SPROUT,brawlBall,Center Stage,1,1,2
1871,2023-02-07,SPROUT,brawlBall,Beach Ball,5,5,10
1872,2023-02-07,SPROUT,bounty,Excel,5,4,9
1873,2023-02-06,SPROUT,knockout,New Perspective,121,123,244
1874,2023-02-06,SPROUT,knockout,Goldarm Gulch,1,1,2
1875,2023-02-06,SPROUT,hotZone,Dueling Beetles,193,178,371
1876,2023-02-06,SPROUT,heist,Snaked Assault,1,1,2
1877,2023-02-06,SPROUT,gemGrab,Minecart Madness,90,85,175
1878,2023-02-06,SPROUT,gemGrab,Double Swoosh,5,0,5
1879,2023-02-06,SPROUT,brawlBall,Sneaky Fields,1,0,1
1880,2023-02-06,SPROUT,brawlBall,Center Stage,97,77,174
1881,2023-02-06,SPROUT,brawlBall,Backyard Bowl,4,7,11
1882,2023-02-06,SPROUT,bounty,Layer Cake,100,124,224
1883,2023-02-05,SPROUT,knockout,X Marks the Spot,55,82,137
1884,2023-02-05,SPROUT,knockout,Goldarm Gulch,24,19,43
1885,2023-02-05,SPROUT,hotZone,Ring of Fire,17,9,26
1886,2023-02-05,SPROUT,heist,Snaked Assault,4,1,5
1887,2023-02-05,SPROUT,heist,Pit Stop,2,2,4
1888,2023-02-05,SPROUT,gemGrab,Hard Rock Mine,3,2,5
1889,2023-02-05,SPROUT,gemGrab,Double Swoosh,25,12,37
1890,2023-02-05,SPROUT,brawlBall,Super Beach,4,1,5
1891,2023-02-05,SPROUT,brawlBall,Sneaky Fields,4,2,6
1892,2023-02-05,SPROUT,brawlBall,Backyard Bowl,93,113,206
1893,2023-02-05,SPROUT,bounty,Layer Cake,121,135,256
1894,2023-02-04,SPROUT,knockout,X Marks the Spot,33,43,76
1895,2023-02-04,SPROUT,knockout,Goldarm Gulch,21,11,32
1896,2023-02-04,SPROUT,hotZone,Ring of Fire,3,2,5
1897,2023-02-04,SPROUT,heist,Pit Stop,2,0,2
1898,2023-02-04,SPROUT,gemGrab,Hard Rock Mine,5,9,14
1899,2023-02-04,SPROUT,gemGrab,Double Swoosh,3,0,3
1900,2023-02-04,SPROUT,gemGrab,Deep Diner,3,2,5
1901,2023-02-04,SPROUT,brawlBall,Super Beach,29,32,61
1902,2023-02-04,SPROUT,brawlBall,Sneaky Fields,0,5,5
1903,2023-02-04,SPROUT,bounty,Dry Season,12,17,29
1904,2023-02-03,SPROUT,knockout,Out in the Open,98,137,235
1905,2023-02-03,SPROUT,knockout,Goldarm Gulch,83,45,128
1906,2023-02-03,SPROUT,hotZone,Split,56,45,101
1907,2023-02-03,SPROUT,heist,Tornado Ring,8,2,10
1908,2023-02-03,SPROUT,heist,Pit Stop,4,5,9
1909,2023-02-03,SPROUT,gemGrab,Undermine,3,5,8
1910,2023-02-03,SPROUT,gemGrab,Double Swoosh,11,6,17
1911,2023-02-03,SPROUT,gemGrab,Deep Diner,44,50,94
1912,2023-02-03,SPROUT,brawlBall,Sneaky Fields,66,65,131
1913,2023-02-03,SPROUT,brawlBall,Pinhole Punt,3,0,3
1914,2023-02-03,SPROUT,bounty,Dry Season,125,152,277
1915,2023-02-02,SPROUT,knockout,Out in the Open,45,38,83
1916,2023-02-02,SPROUT,hotZone,Split,52,60,112
1917,2023-02-02,SPROUT,heist,Kaboom Canyon,1,0,1
1918,2023-02-02,SPROUT,gemGrab,Undermine,9,14,23
1919,2023-02-02,SPROUT,gemGrab,Gem Fort,0,1,1
1920,2023-02-02,SPROUT,brawlBall,Sunny Soccer,4,5,9
1921,2023-02-02,SPROUT,brawlBall,Pinhole Punt,13,9,22
1922,2023-02-02,SPROUT,bounty,Shooting Star,13,18,31
1923,2023-02-01,SPROUT,knockout,Goldarm Gulch,157,195,352
1924,2023-02-01,SPROUT,hotZone,Parallel Plays,35,37,72
1925,2023-02-01,SPROUT,heist,Kaboom Canyon,2,0,2
1926,2023-02-01,SPROUT,gemGrab,Gem Fort,14,13,27
1927,2023-02-01,SPROUT,gemGrab,Crystal Arcade,5,8,13
1928,2023-02-01,SPROUT,brawlBall,Sunny Soccer,90,107,197
1929,2023-02-01,SPROUT,brawlBall,Beach Ball,6,3,9
1930,2023-02-01,SPROUT,bounty,Shooting Star,45,59,104
1931,2023-01-31,SPROUT,knockout,Goldarm Gulch,89,94,183
1932,2023-01-31,SPROUT,hotZone,Parallel Plays,5,8,13
1933,2023-01-31,SPROUT,heist,Pit Stop,3,1,4
1934,2023-01-31,SPROUT,gemGrab,Minecart Madness,5,3,8
1935,2023-01-31,SPROUT,gemGrab,Crystal Arcade,7,5,12
1936,2023-01-31,SPROUT,brawlBall,Center Stage,2,0,2
1937,2023-01-31,SPROUT,brawlBall,Beach Ball,36,46,82
1938,2023-01-31,SPROUT,bounty,Hideout,14,24,38
1939,2023-01-30,SPROUT,knockout,Belle's Rock,428,481,909
1940,2023-01-30,SPROUT,hotZone,Quarter Pounder,34,36,70
1941,2023-01-30,SPROUT,heist,Pit Stop,2,0,2
1942,2023-01-30,SPROUT,gemGrab,Minecart Madness,66,60,126
1943,2023-01-30,SPROUT,gemGrab,Double Swoosh,4,2,6
1944,2023-01-30,SPROUT,brawlBall,Center Stage,55,26,81
1945,2023-01-30,SPROUT,brawlBall,Backyard Bowl,8,5,13
1946,2023-01-30,SPROUT,bounty,Hideout,41,36,77
1947,2023-01-29,SPROUT,knockout,Belle's Rock,420,489,909
1948,2023-01-29,SPROUT,hotZone,Quarter Pounder,20,19,39
1949,2023-01-29,SPROUT,heist,Bridge Too Far,23,18,41
1950,2023-01-29,SPROUT,gemGrab,Hard Rock Mine,5,3,8
1951,2023-01-29,SPROUT,gemGrab,Double Swoosh,16,4,20
1952,2023-01-29,SPROUT,brawlBall,Super Beach,0,3,3
1953,2023-01-29,SPROUT,brawlBall,Backyard Bowl,75,73,148
1954,2023-01-29,SPROUT,bounty,Canal Grande,22,31,53
1955,2023-01-28,SPROUT,knockout,Flaring Phoenix,99,115,214
1956,2023-01-28,SPROUT,hotZone,Controller Chaos,24,21,45
1957,2023-01-28,SPROUT,heist,Bridge Too Far,24,9,33
1958,2023-01-28,SPROUT,gemGrab,Hard Rock Mine,32,22,54
1959,2023-01-28,SPROUT,gemGrab,Deep Diner,18,19,37
1960,2023-01-28,SPROUT,brawlBall,Super Beach,90,43,133
1961,2023-01-28,SPROUT,brawlBall,Sneaky Fields,2,0,2
1962,2023-01-28,SPROUT,bounty,Canal Grande,40,37,77
1963,2023-01-27,SPROUT,knockout,Flaring Phoenix,35,39,74
1964,2023-01-27,SPROUT,hotZone,Controller Chaos,8,4,12
1965,2023-01-27,SPROUT,heist,Hot Potato,2,1,3
1966,2023-01-27,SPROUT,gemGrab,Undermine,1,0,1
1967,2023-01-27,SPROUT,gemGrab,Deep Diner,23,29,52
1968,2023-01-27,SPROUT,brawlBall,Sneaky Fields,40,24,64
1969,2023-01-27,SPROUT,brawlBall,Pinhole Punt,1,0,1
1970,2023-01-27,SPROUT,bounty,Temple Ruins,3,7,10
1971,2023-01-26,SPROUT,knockout,Riverside,58,69,127
1972,2023-01-26,SPROUT,hotZone,Open Zone,7,3,10
1973,2023-01-26,SPROUT,heist,Hot Potato,6,3,9
1974,2023-01-26,SPROUT,gemGrab,Undermine,17,13,30
1975,2023-01-26,SPROUT,gemGrab,Gem Fort,7,2,9
1976,2023-01-26,SPROUT,brawlBall,Sunny Soccer,7,4,11
1977,2023-01-26,SPROUT,brawlBall,Pinhole Punt,54,45,99
1978,2023-01-26,SPROUT,bounty,Temple Ruins,4,9,13
1979,2023-01-25,SPROUT,knockout,Riverside,30,40,70
1980,2023-01-25,SPROUT,hotZone,Open Zone,3,0,3
1981,2023-01-25,SPROUT,heist,Safe Zone,10,8,18
1982,2023-01-25,SPROUT,gemGrab,Gem Fort,9,13,22
1983,2023-01-25,SPROUT,gemGrab,Crystal Arcade,17,12,29
1984,2023-01-25,SPROUT,brawlBall,Sunny Soccer,63,56,119
1985,2023-01-25,SPROUT,brawlBall,Beach Ball,9,11,20
1986,2023-01-25,SPROUT,bounty,Excel,33,36,69
1987,2023-01-24,SPROUT,knockout,New Perspective,50,56,106
1988,2023-01-24,SPROUT,hotZone,Dueling Beetles,77,75,152
1989,2023-01-24,SPROUT,heist,Safe Zone,16,3,19
1990,2023-01-24,SPROUT,gemGrab,Minecart Madness,24,27,51
1991,2023-01-24,SPROUT,gemGrab,Crystal Arcade,19,2,21
1992,2023-01-24,SPROUT,brawlBall,Center Stage,1,4,5
1993,2023-01-24,SPROUT,brawlBall,Beach Ball,92,82,174
1994,2023-01-24,SPROUT,bounty,Excel,78,73,151
1995,2023-01-23,SPROUT,knockout,New Perspective,77,77,154
1996,2023-01-23,SPROUT,hotZone,Dueling Beetles,109,135,244
1997,2023-01-23,SPROUT,heist,Snaked Assault,2,0,2
1998,2023-01-23,SPROUT,gemGrab,Minecart Madness,83,86,169
1999,2023-01-23,SPROUT,gemGrab,Double Swoosh,3,1,4
2000,2023-01-23,SPROUT,brawlBall,Center Stage,86,62,148
2001,2023-01-23,SPROUT,brawlBall,Backyard Bowl,11,29,40
2002,2023-01-23,SPROUT,bounty,Layer Cake,86,114,200
2003,2023-01-22,SPROUT,knockout,X Marks the Spot,49,57,106
2004,2023-01-22,SPROUT,hotZone,Ring of Fire,10,3,13
2005,2023-01-22,SPROUT,heist,Snaked Assault,0,1,1
2006,2023-01-22,SPROUT,gemGrab,Hard Rock Mine,5,1,6
2007,2023-01-22,SPROUT,gemGrab,Double Swoosh,3,4,7
2008,2023-01-22,SPROUT,brawlBall,Super Beach,10,14,24
2009,2023-01-22,SPROUT,brawlBall,Backyard Bowl,36,31,67
2010,2023-01-22,SPROUT,bounty,Layer Cake,51,51,102
2011,2023-01-21,SPROUT,knockout,X Marks the Spot,164,178,342
2012,2023-01-21,SPROUT,hotZone,Ring of Fire,24,9,33
2013,2023-01-21,SPROUT,heist,Tornado Ring,1,3,4
2014,2023-01-21,SPROUT,gemGrab,Hard Rock Mine,33,11,44
2015,2023-01-21,SPROUT,gemGrab,Deep Diner,14,10,24
2016,2023-01-21,SPROUT,brawlBall,Super Beach,92,66,158
2017,2023-01-21,SPROUT,brawlBall,Sneaky Fields,4,3,7
2018,2023-01-21,SPROUT,bounty,Dry Season,85,125,210
2019,2023-01-20,SPROUT,knockout,Out in the Open,88,111,199
2020,2023-01-20,SPROUT,hotZone,Split,79,50,129
2021,2023-01-20,SPROUT,heist,Tornado Ring,5,2,7
2022,2023-01-20,SPROUT,gemGrab,Undermine,8,8,16
2023,2023-01-20,SPROUT,gemGrab,Deep Diner,43,23,66
2024,2023-01-20,SPROUT,brawlBall,Sneaky Fields,64,57,121
2025,2023-01-20,SPROUT,brawlBall,Pinhole Punt,1,0,1
2026,2023-01-20,SPROUT,bounty,Dry Season,77,74,151
2027,2023-01-19,SPROUT,knockout,Out in the Open,109,136,245
2028,2023-01-19,SPROUT,hotZone,Split,119,138,257
2029,2023-01-19,SPROUT,heist,Kaboom Canyon,4,7,11
2030,2023-01-19,SPROUT,gemGrab,Undermine,10,16,26
2031,2023-01-19,SPROUT,gemGrab,Gem Fort,3,1,4
2032,2023-01-19,SPROUT,brawlBall,Sunny Soccer,3,5,8
2033,2023-01-19,SPROUT,brawlBall,Pinhole Punt,55,56,111
2034,2023-01-19,SPROUT,bounty,Shooting Star,84,105,189
2035,2023-01-18,SPROUT,knockout,Goldarm Gulch,17,22,39
2036,2023-01-18,SPROUT,hotZone,Parallel Plays,3,2,5
2037,2023-01-18,SPROUT,heist,Kaboom Canyon,2,2,4
2038,2023-01-18,SPROUT,gemGrab,Gem Fort,2,0,2
2039,2023-01-18,SPROUT,gemGrab,Crystal Arcade,1,1,2
2040,2023-01-18,SPROUT,brawlBall,Sunny Soccer,17,24,41
2041,2023-01-18,SPROUT,brawlBall,Beach Ball,4,3,7
2042,2023-01-18,SPROUT,bounty,Shooting Star,45,43,88
2043,2023-01-17,SPROUT,knockout,Goldarm Gulch,17,18,35
2044,2023-01-17,SPROUT,gemGrab,Minecart Madness,0,1,1
2045,2023-01-17,SPROUT,gemGrab,Crystal Arcade,3,1,4
2046,2023-01-17,SPROUT,brawlBall,Beach Ball,11,5,16
2047,2023-01-17,SPROUT,bounty,Hideout,3,8,11
2048,2023-01-16,SPROUT,knockout,Belle's Rock,55,55,110
2049,2023-01-16,SPROUT,hotZone,Quarter Pounder,1,0,1
2050,2023-01-16,SPROUT,gemGrab,Minecart Madness,8,6,14
2051,2023-01-16,SPROUT,brawlBall,Center Stage,11,12,23
2052,2023-01-16,SPROUT,brawlBall,Backyard Bowl,2,4,6
2053,2023-01-16,SPROUT,bounty,Hideout,6,7,13
2054,2023-01-15,SPROUT,knockout,Belle's Rock,38,59,97
2055,2023-01-15,SPROUT,hotZone,Quarter Pounder,18,50,68
2056,2023-01-15,SPROUT,heist,Bridge Too Far,3,1,4
2057,2023-01-15,SPROUT,gemGrab,Hard Rock Mine,2,0,2
2058,2023-01-15,SPROUT,gemGrab,Double Swoosh,2,1,3
2059,2023-01-15,SPROUT,brawlBall,Backyard Bowl,24,27,51
2060,2023-01-15,SPROUT,bounty,Canal Grande,0,1,1
2061,2023-01-14,SPROUT,knockout,Flaring Phoenix,12,10,22
2062,2023-01-14,SPROUT,hotZone,Controller Chaos,2,0,2
2063,2023-01-14,SPROUT,heist,Bridge Too Far,1,0,1
2064,2023-01-14,SPROUT,gemGrab,Hard Rock Mine,1,0,1
2065,2023-01-14,SPROUT,gemGrab,Deep Diner,3,10,13
2066,2023-01-14,SPROUT,brawlBall,Super Beach,6,6,12
2067,2023-01-14,SPROUT,bounty,Canal Grande,2,0,2
2068,2023-01-13,SPROUT,knockout,Flaring Phoenix,13,8,21
2069,2023-01-13,SPROUT,hotZone,Controller Chaos,7,23,30
2070,2023-01-13,SPROUT,gemGrab,Deep Diner,4,27,31
2071,2023-01-13,SPROUT,brawlBall,Sneaky Fields,6,4,10
2072,2023-01-12,SPROUT,knockout,Riverside,16,26,42
2073,2023-01-12,SPROUT,gemGrab,Undermine,1,0,1
2074,2023-01-12,SPROUT,brawlBall,Pinhole Punt,4,8,12
2075,2023-01-11,SPROUT,gemGrab,Gem Fort,0,1,1
2076,2023-01-11,SPROUT,brawlBall,Sunny Soccer,1,0,1
2077,2023-01-11,SPROUT,bounty,Excel,1,0,1
2078,2023-01-10,SPROUT,knockout,New Perspective,5,5,10
2079,2023-01-10,SPROUT,hotZone,Dueling Beetles,32,61,93
2080,2023-01-10,SPROUT,heist,Safe Zone,1,0,1
2081,2023-01-10,SPROUT,gemGrab,Minecart Madness,0,1,1
2082,2023-01-10,SPROUT,brawlBall,Beach Ball,11,13,24
2083,2023-01-10,SPROUT,bounty,Excel,1,2,3
2084,2023-01-09,SPROUT,knockout,New Perspective,0,1,1
2085,2023-01-09,SPROUT,hotZone,Dueling Beetles,18,16,34
2086,2023-01-09,SPROUT,gemGrab,Minecart Madness,3,3,6
2087,2023-01-09,SPROUT,brawlBall,Center Stage,1,0,1
2088,2023-01-09,SPROUT,brawlBall,Backyard Bowl,2,0,2
2089,2023-01-09,SPROUT,bounty,Layer Cake,13,12,25
2090,2023-01-08,SPROUT,knockout,X Marks the Spot,5,1,6
2091,2023-01-08,SPROUT,hotZone,Ring of Fire,2,14,16
2092,2023-01-08,SPROUT,heist,Snaked Assault,1,0,1
2093,2023-01-08,SPROUT,gemGrab,Double Swoosh,1,0,1
2094,2023-01-08,SPROUT,brawlBall,Super Beach,0,3,3
2095,2023-01-08,SPROUT,brawlBall,Backyard Bowl,4,4,8
2096,2023-01-08,SPROUT,bounty,Layer Cake,3,3,6
2097,2023-01-07,SPROUT,knockout,X Marks the Spot,8,6,14
2098,2023-01-07,SPROUT,gemGrab,Hard Rock Mine,1,1,2
2099,2023-01-07,SPROUT,brawlBall,Super Beach,2,1,3
2100,2023-01-07,SPROUT,bounty,Dry Season,7,6,13
2101,2023-01-06,SPROUT,knockout,Out in the Open,3,5,8
2102,2023-01-06,SPROUT,hotZone,Split,4,0,4
2103,2023-01-06,SPROUT,brawlBall,Sneaky Fields,3,1,4
2104,2023-01-06,SPROUT,brawlBall,Pinhole Punt,1,2,3
2105,2023-01-06,SPROUT,bounty,Dry Season,12,10,22
2106,2023-01-05,SPROUT,knockout,Out in the Open,3,3,6
2107,2023-01-05,SPROUT,hotZone,Split,17,8,25
2108,2023-01-05,SPROUT,gemGrab,Undermine,0,2,2
2109,2023-01-05,SPROUT,gemGrab,Gem Fort,2,0,2
2110,2023-01-05,SPROUT,bounty,Shooting Star,7,1,8
2111,2023-01-04,SPROUT,knockout,Goldarm Gulch,5,4,9
2112,2023-01-04,SPROUT,gemGrab,Gem Fort,1,0,1
2113,2023-01-04,SPROUT,brawlBall,Sunny Soccer,5,11,16
2114,2023-01-04,SPROUT,bounty,Shooting Star,15,28,43
2115,2023-01-03,SPROUT,knockout,Goldarm Gulch,1,2,3
2116,2023-01-03,SPROUT,hotZone,Parallel Plays,2,0,2
2117,2023-01-03,SPROUT,gemGrab,Crystal Arcade,1,0,1
2118,2023-01-03,SPROUT,brawlBall,Beach Ball,1,0,1
2119,2023-01-03,SPROUT,bounty,Hideout,3,11,14
2120,2023-01-02,SPROUT,knockout,Belle's Rock,25,24,49
2121,2023-01-02,SPROUT,hotZone,Quarter Pounder,10,18,28
2122,2023-01-02,SPROUT,gemGrab,Minecart Madness,3,3,6
2123,2023-01-02,SPROUT,brawlBall,Center Stage,2,0,2
2124,2023-01-02,SPROUT,bounty,Hideout,8,2,10
2125,2023-01-01,SPROUT,knockout,Belle's Rock,22,11,33
2126,2023-01-01,SPROUT,hotZone,Quarter Pounder,3,9,12
2127,2023-01-01,SPROUT,hotZone,Controller Chaos,1,0,1
2128,2023-01-01,SPROUT,heist,Kaboom Canyon,1,0,1
2129,2023-01-01,SPROUT,brawlBall,Backyard Bowl,6,18,24
2130,2022-12-31,SPROUT,hotZone,Controller Chaos,1,0,1
2131,2022-12-31,SPROUT,gemGrab,Deep Diner,0,1,1
2132,2022-12-31,SPROUT,brawlBall,Super Beach,0,2,2
2133,2022-12-29,SPROUT,hotZone,Controller Chaos,0,1,1
2134,2022-12-29,SPROUT,brawlBall,Pinhole Punt,0,1,1
2135,2022-12-28,SPROUT,brawlBall,Sunny Soccer,1,0,1
2136,2022-12-27,SPROUT,hotZone,Dueling Beetles,2,0,2
2137,2022-12-27,SPROUT,brawlBall,Beach Ball,2,0,2
2138,2022-12-26,SPROUT,gemGrab,Minecart Madness,1,0,1
2139,2022-12-24,SPROUT,knockout,X Marks the Spot,2,1,3
2140,2022-12-24,SPROUT,bounty,Dry Season,1,0,1
2141,2022-12-23,SPROUT,knockout,Out in the Open,18,18,36
2142,2022-12-22,SPROUT,brawlBall,Pinhole Punt,0,10,10
2143,2022-12-19,SPROUT,gemGrab,Minecart Madness,4,0,4
2144,2022-12-13,SPROUT,knockout,New Perspective,1,0,1
2145,2022-11-01,SPROUT,knockout,New Perspective,0,2,2
2146,2022-10-28,SPROUT,brawlBall,Beach Ball,2,0,2
2147,2022-10-26,SPROUT,bounty,Shooting Star,0,1,1
2148,2022-10-15,SPROUT,gemGrab,Hard Rock Mine,1,0,1
2149,2022-10-10,SPROUT,knockout,Belle's Rock,4,5,9
2150,2022-09-07,SPROUT,brawlBall,Sunny Soccer,0,2,2
2151,2023-02-11,SPIKE,knockout,Flaring Phoenix,71,35,106
2152,2023-02-11,SPIKE,hotZone,Controller Chaos,101,89,190
2153,2023-02-11,SPIKE,gemGrab,Deep Diner,65,51,116
2154,2023-02-11,SPIKE,brawlBall,Super Beach,146,167,313
2155,2023-02-11,SPIKE,brawlBall,Sneaky Fields,86,82,168
2156,2023-02-10,SPIKE,knockout,Flaring Phoenix,121,77,198
2157,2023-02-10,SPIKE,hotZone,Controller Chaos,189,174,363
2158,2023-02-10,SPIKE,heist,Hot Potato,50,26,76
2159,2023-02-10,SPIKE,gemGrab,Undermine,39,46,85
2160,2023-02-10,SPIKE,gemGrab,Deep Diner,181,213,394
2161,2023-02-10,SPIKE,brawlBall,Sneaky Fields,588,617,1205
2162,2023-02-10,SPIKE,brawlBall,Pinhole Punt,13,13,26
2163,2023-02-10,SPIKE,bounty,Temple Ruins,48,50,98
2164,2023-02-09,SPIKE,knockout,Riverside,12,11,23
2165,2023-02-09,SPIKE,hotZone,Open Zone,15,6,21
2166,2023-02-09,SPIKE,heist,Hot Potato,20,20,40
2167,2023-02-09,SPIKE,gemGrab,Undermine,18,23,41
2168,2023-02-09,SPIKE,gemGrab,Gem Fort,7,4,11
2169,2023-02-09,SPIKE,brawlBall,Sunny Soccer,1,1,2
2170,2023-02-09,SPIKE,brawlBall,Pinhole Punt,217,222,439
2171,2023-02-09,SPIKE,bounty,Temple Ruins,23,20,43
2172,2023-02-08,SPIKE,knockout,Riverside,4,3,7
2173,2023-02-08,SPIKE,hotZone,Open Zone,15,10,25
2174,2023-02-08,SPIKE,heist,Safe Zone,6,8,14
2175,2023-02-08,SPIKE,gemGrab,Gem Fort,11,9,20
2176,2023-02-08,SPIKE,gemGrab,Crystal Arcade,4,5,9
2177,2023-02-08,SPIKE,brawlBall,Sunny Soccer,58,60,118
2178,2023-02-08,SPIKE,brawlBall,Beach Ball,6,3,9
2179,2023-02-08,SPIKE,bounty,Excel,6,3,9
2180,2023-02-07,SPIKE,knockout,New Perspective,7,9,16
2181,2023-02-07,SPIKE,hotZone,Dueling Beetles,22,9,31
2182,2023-02-07,SPIKE,heist,Safe Zone,5,3,8
2183,2023-02-07,SPIKE,gemGrab,Minecart Madness,15,32,47
2184,2023-02-07,SPIKE,gemGrab,Crystal Arcade,5,6,11
2185,2023-02-07,SPIKE,brawlBall,Center Stage,4,0,4
2186,2023-02-07,SPIKE,brawlBall,Beach Ball,49,30,79
2187,2023-02-07,SPIKE,bounty,Excel,2,0,2
2188,2023-02-06,SPIKE,knockout,New Perspective,179,97,276
2189,2023-02-06,SPIKE,knockout,Goldarm Gulch,11,6,17
2190,2023-02-06,SPIKE,hotZone,Dueling Beetles,257,229,486
2191,2023-02-06,SPIKE,heist,Snaked Assault,130,94,224
2192,2023-02-06,SPIKE,heist,Pit Stop,26,23,49
2193,2023-02-06,SPIKE,gemGrab,Minecart Madness,242,304,546
2194,2023-02-06,SPIKE,gemGrab,Double Swoosh,153,138,291
2195,2023-02-06,SPIKE,brawlBall,Sneaky Fields,79,54,133
2196,2023-02-06,SPIKE,brawlBall,Center Stage,920,844,1764
2197,2023-02-06,SPIKE,brawlBall,Backyard Bowl,106,117,223
2198,2023-02-06,SPIKE,bounty,Layer Cake,53,26,79
2199,2023-02-05,SPIKE,knockout,X Marks the Spot,106,53,159
2200,2023-02-05,SPIKE,knockout,Goldarm Gulch,48,19,67
2201,2023-02-05,SPIKE,hotZone,Ring of Fire,104,134,238
2202,2023-02-05,SPIKE,heist,Snaked Assault,180,148,328
2203,2023-02-05,SPIKE,heist,Pit Stop,66,66,132
2204,2023-02-05,SPIKE,gemGrab,Hard Rock Mine,33,30,63
2205,2023-02-05,SPIKE,gemGrab,Double Swoosh,419,426,845
2206,2023-02-05,SPIKE,brawlBall,Super Beach,24,19,43
2207,2023-02-05,SPIKE,brawlBall,Sneaky Fields,137,143,280
2208,2023-02-05,SPIKE,brawlBall,Backyard Bowl,1134,1102,2236
2209,2023-02-05,SPIKE,bounty,Layer Cake,69,30,99
2210,2023-02-04,SPIKE,knockout,X Marks the Spot,47,32,79
2211,2023-02-04,SPIKE,knockout,Goldarm Gulch,17,9,26
2212,2023-02-04,SPIKE,hotZone,Ring of Fire,31,30,61
2213,2023-02-04,SPIKE,heist,Tornado Ring,24,20,44
2214,2023-02-04,SPIKE,heist,Pit Stop,47,37,84
2215,2023-02-04,SPIKE,gemGrab,Hard Rock Mine,60,55,115
2216,2023-02-04,SPIKE,gemGrab,Double Swoosh,60,97,157
2217,2023-02-04,SPIKE,gemGrab,Deep Diner,16,26,42
2218,2023-02-04,SPIKE,brawlBall,Super Beach,207,285,492
2219,2023-02-04,SPIKE,brawlBall,Sneaky Fields,94,78,172
2220,2023-02-04,SPIKE,bounty,Dry Season,15,12,27
2221,2023-02-03,SPIKE,knockout,Out in the Open,149,94,243
2222,2023-02-03,SPIKE,knockout,Goldarm Gulch,115,57,172
2223,2023-02-03,SPIKE,hotZone,Split,26,9,35
2224,2023-02-03,SPIKE,heist,Tornado Ring,124,82,206
2225,2023-02-03,SPIKE,heist,Pit Stop,213,123,336
2226,2023-02-03,SPIKE,gemGrab,Undermine,62,43,105
2227,2023-02-03,SPIKE,gemGrab,Double Swoosh,250,300,550
2228,2023-02-03,SPIKE,gemGrab,Deep Diner,204,217,421
2229,2023-02-03,SPIKE,brawlBall,Sneaky Fields,1020,1109,2129
2230,2023-02-03,SPIKE,brawlBall,Pinhole Punt,43,43,86
2231,2023-02-03,SPIKE,bounty,Dry Season,92,46,138
2232,2023-02-02,SPIKE,knockout,Out in the Open,55,48,103
2233,2023-02-02,SPIKE,hotZone,Split,11,21,32
2234,2023-02-02,SPIKE,heist,Kaboom Canyon,19,7,26
2235,2023-02-02,SPIKE,gemGrab,Undermine,39,49,88
2236,2023-02-02,SPIKE,gemGrab,Gem Fort,38,32,70
2237,2023-02-02,SPIKE,brawlBall,Sunny Soccer,5,7,12
2238,2023-02-02,SPIKE,brawlBall,Pinhole Punt,244,229,473
2239,2023-02-02,SPIKE,bounty,Shooting Star,16,11,27
2240,2023-02-01,SPIKE,knockout,Goldarm Gulch,153,91,244
2241,2023-02-01,SPIKE,hotZone,Parallel Plays,153,121,274
2242,2023-02-01,SPIKE,heist,Kaboom Canyon,52,49,101
2243,2023-02-01,SPIKE,gemGrab,Gem Fort,88,83,171
2244,2023-02-01,SPIKE,gemGrab,Crystal Arcade,79,61,140
2245,2023-02-01,SPIKE,brawlBall,Sunny Soccer,668,676,1344
2246,2023-02-01,SPIKE,brawlBall,Beach Ball,25,19,44
2247,2023-02-01,SPIKE,bounty,Shooting Star,24,15,39
2248,2023-01-31,SPIKE,knockout,Goldarm Gulch,71,70,141
2249,2023-01-31,SPIKE,hotZone,Parallel Plays,58,60,118
2250,2023-01-31,SPIKE,heist,Pit Stop,19,16,35
2251,2023-01-31,SPIKE,gemGrab,Minecart Madness,10,9,19
2252,2023-01-31,SPIKE,gemGrab,Crystal Arcade,93,93,186
2253,2023-01-31,SPIKE,brawlBall,Center Stage,11,12,23
2254,2023-01-31,SPIKE,brawlBall,Beach Ball,327,337,664
2255,2023-01-31,SPIKE,bounty,Hideout,19,15,34
2256,2023-01-30,SPIKE,knockout,Belle's Rock,189,133,322
2257,2023-01-30,SPIKE,hotZone,Quarter Pounder,205,174,379
2258,2023-01-30,SPIKE,heist,Pit Stop,61,30,91
2259,2023-01-30,SPIKE,gemGrab,Minecart Madness,192,267,459
2260,2023-01-30,SPIKE,gemGrab,Double Swoosh,150,138,288
2261,2023-01-30,SPIKE,brawlBall,Center Stage,497,507,1004
2262,2023-01-30,SPIKE,brawlBall,Backyard Bowl,79,67,146
2263,2023-01-30,SPIKE,bounty,Hideout,34,27,61
2264,2023-01-29,SPIKE,knockout,Belle's Rock,211,107,318
2265,2023-01-29,SPIKE,hotZone,Quarter Pounder,137,107,244
2266,2023-01-29,SPIKE,heist,Bridge Too Far,68,50,118
2267,2023-01-29,SPIKE,gemGrab,Hard Rock Mine,22,13,35
2268,2023-01-29,SPIKE,gemGrab,Double Swoosh,188,182,370
2269,2023-01-29,SPIKE,brawlBall,Super Beach,11,9,20
2270,2023-01-29,SPIKE,brawlBall,Backyard Bowl,809,860,1669
2271,2023-01-29,SPIKE,bounty,Canal Grande,23,18,41
2272,2023-01-28,SPIKE,knockout,Flaring Phoenix,78,42,120
2273,2023-01-28,SPIKE,hotZone,Controller Chaos,120,161,281
2274,2023-01-28,SPIKE,heist,Bridge Too Far,195,157,352
2275,2023-01-28,SPIKE,gemGrab,Hard Rock Mine,122,100,222
2276,2023-01-28,SPIKE,gemGrab,Deep Diner,62,51,113
2277,2023-01-28,SPIKE,brawlBall,Super Beach,740,691,1431
2278,2023-01-28,SPIKE,brawlBall,Sneaky Fields,40,38,78
2279,2023-01-28,SPIKE,bounty,Canal Grande,53,43,96
2280,2023-01-27,SPIKE,knockout,Flaring Phoenix,39,20,59
2281,2023-01-27,SPIKE,hotZone,Controller Chaos,35,23,58
2282,2023-01-27,SPIKE,heist,Hot Potato,30,24,54
2283,2023-01-27,SPIKE,gemGrab,Undermine,15,11,26
2284,2023-01-27,SPIKE,gemGrab,Deep Diner,82,98,180
2285,2023-01-27,SPIKE,brawlBall,Sneaky Fields,214,204,418
2286,2023-01-27,SPIKE,brawlBall,Pinhole Punt,11,7,18
2287,2023-01-27,SPIKE,bounty,Temple Ruins,18,16,34
2288,2023-01-26,SPIKE,knockout,Riverside,128,73,201
2289,2023-01-26,SPIKE,hotZone,Open Zone,131,88,219
2290,2023-01-26,SPIKE,heist,Hot Potato,89,80,169
2291,2023-01-26,SPIKE,gemGrab,Undermine,91,149,240
2292,2023-01-26,SPIKE,gemGrab,Gem Fort,34,35,69
2293,2023-01-26,SPIKE,brawlBall,Sunny Soccer,40,40,80
2294,2023-01-26,SPIKE,brawlBall,Pinhole Punt,779,798,1577
2295,2023-01-26,SPIKE,bounty,Temple Ruins,50,36,86
2296,2023-01-25,SPIKE,knockout,Riverside,55,36,91
2297,2023-01-25,SPIKE,hotZone,Open Zone,58,65,123
2298,2023-01-25,SPIKE,heist,Safe Zone,66,35,101
2299,2023-01-25,SPIKE,gemGrab,Gem Fort,40,32,72
2300,2023-01-25,SPIKE,gemGrab,Crystal Arcade,94,113,207
2301,2023-01-25,SPIKE,brawlBall,Sunny Soccer,517,512,1029
2302,2023-01-25,SPIKE,brawlBall,Beach Ball,87,92,179
2303,2023-01-25,SPIKE,bounty,Excel,29,14,43
2304,2023-01-24,SPIKE,knockout,New Perspective,105,108,213
2305,2023-01-24,SPIKE,hotZone,Dueling Beetles,108,108,216
2306,2023-01-24,SPIKE,heist,Safe Zone,96,67,163
2307,2023-01-24,SPIKE,gemGrab,Minecart Madness,59,73,132
2308,2023-01-24,SPIKE,gemGrab,Crystal Arcade,180,240,420
2309,2023-01-24,SPIKE,brawlBall,Center Stage,84,94,178
2310,2023-01-24,SPIKE,brawlBall,Beach Ball,693,730,1423
2311,2023-01-24,SPIKE,bounty,Excel,46,28,74
2312,2023-01-23,SPIKE,knockout,New Perspective,167,87,254
2313,2023-01-23,SPIKE,hotZone,Dueling Beetles,187,152,339
2314,2023-01-23,SPIKE,heist,Snaked Assault,133,75,208
2315,2023-01-23,SPIKE,gemGrab,Minecart Madness,299,385,684
2316,2023-01-23,SPIKE,gemGrab,Double Swoosh,106,90,196
2317,2023-01-23,SPIKE,brawlBall,Center Stage,964,816,1780
2318,2023-01-23,SPIKE,brawlBall,Backyard Bowl,46,63,109
2319,2023-01-23,SPIKE,bounty,Layer Cake,38,21,59
2320,2023-01-22,SPIKE,knockout,X Marks the Spot,87,57,144
2321,2023-01-22,SPIKE,hotZone,Ring of Fire,49,43,92
2322,2023-01-22,SPIKE,heist,Snaked Assault,80,52,132
2323,2023-01-22,SPIKE,gemGrab,Hard Rock Mine,32,26,58
2324,2023-01-22,SPIKE,gemGrab,Double Swoosh,111,133,244
2325,2023-01-22,SPIKE,brawlBall,Super Beach,80,101,181
2326,2023-01-22,SPIKE,brawlBall,Backyard Bowl,467,436,903
2327,2023-01-22,SPIKE,bounty,Layer Cake,18,8,26
2328,2023-01-21,SPIKE,knockout,X Marks the Spot,261,153,414
2329,2023-01-21,SPIKE,hotZone,Ring of Fire,211,198,409
2330,2023-01-21,SPIKE,heist,Tornado Ring,119,75,194
2331,2023-01-21,SPIKE,gemGrab,Hard Rock Mine,161,151,312
2332,2023-01-21,SPIKE,gemGrab,Deep Diner,44,26,70
2333,2023-01-21,SPIKE,brawlBall,Super Beach,1046,1028,2074
2334,2023-01-21,SPIKE,brawlBall,Sneaky Fields,32,23,55
2335,2023-01-21,SPIKE,bounty,Dry Season,69,40,109
2336,2023-01-20,SPIKE,knockout,Out in the Open,194,113,307
2337,2023-01-20,SPIKE,hotZone,Split,54,50,104
2338,2023-01-20,SPIKE,heist,Tornado Ring,105,89,194
2339,2023-01-20,SPIKE,gemGrab,Undermine,66,69,135
2340,2023-01-20,SPIKE,gemGrab,Deep Diner,219,203,422
2341,2023-01-20,SPIKE,brawlBall,Sneaky Fields,668,732,1400
2342,2023-01-20,SPIKE,brawlBall,Pinhole Punt,44,58,102
2343,2023-01-20,SPIKE,bounty,Dry Season,66,34,100
2344,2023-01-19,SPIKE,knockout,Out in the Open,217,137,354
2345,2023-01-19,SPIKE,hotZone,Split,63,24,87
2346,2023-01-19,SPIKE,heist,Kaboom Canyon,89,68,157
2347,2023-01-19,SPIKE,gemGrab,Undermine,181,189,370
2348,2023-01-19,SPIKE,gemGrab,Gem Fort,33,20,53
2349,2023-01-19,SPIKE,brawlBall,Sunny Soccer,29,43,72
2350,2023-01-19,SPIKE,brawlBall,Pinhole Punt,865,893,1758
2351,2023-01-19,SPIKE,bounty,Shooting Star,53,30,83
2352,2023-01-18,SPIKE,knockout,Goldarm Gulch,24,17,41
2353,2023-01-18,SPIKE,hotZone,Parallel Plays,16,22,38
2354,2023-01-18,SPIKE,heist,Kaboom Canyon,18,18,36
2355,2023-01-18,SPIKE,gemGrab,Gem Fort,22,17,39
2356,2023-01-18,SPIKE,gemGrab,Crystal Arcade,11,21,32
2357,2023-01-18,SPIKE,brawlBall,Sunny Soccer,225,256,481
2358,2023-01-18,SPIKE,brawlBall,Beach Ball,12,4,16
2359,2023-01-18,SPIKE,bounty,Shooting Star,19,15,34
2360,2023-01-17,SPIKE,knockout,Goldarm Gulch,18,16,34
2361,2023-01-17,SPIKE,hotZone,Parallel Plays,13,13,26
2362,2023-01-17,SPIKE,heist,Pit Stop,11,7,18
2363,2023-01-17,SPIKE,gemGrab,Minecart Madness,7,3,10
2364,2023-01-17,SPIKE,gemGrab,Crystal Arcade,26,46,72
2365,2023-01-17,SPIKE,brawlBall,Center Stage,2,3,5
2366,2023-01-17,SPIKE,brawlBall,Beach Ball,84,83,167
2367,2023-01-17,SPIKE,bounty,Hideout,4,2,6
2368,2023-01-16,SPIKE,knockout,Belle's Rock,14,7,21
2369,2023-01-16,SPIKE,hotZone,Quarter Pounder,18,12,30
2370,2023-01-16,SPIKE,heist,Pit Stop,27,13,40
2371,2023-01-16,SPIKE,gemGrab,Minecart Madness,16,20,36
2372,2023-01-16,SPIKE,gemGrab,Double Swoosh,6,2,8
2373,2023-01-16,SPIKE,brawlBall,Center Stage,92,52,144
2374,2023-01-16,SPIKE,brawlBall,Backyard Bowl,10,11,21
2375,2023-01-16,SPIKE,bounty,Hideout,4,2,6
2376,2023-01-15,SPIKE,knockout,Belle's Rock,24,9,33
2377,2023-01-15,SPIKE,hotZone,Quarter Pounder,37,20,57
2378,2023-01-15,SPIKE,heist,Bridge Too Far,17,30,47
2379,2023-01-15,SPIKE,gemGrab,Hard Rock Mine,5,1,6
2380,2023-01-15,SPIKE,gemGrab,Double Swoosh,15,7,22
2381,2023-01-15,SPIKE,brawlBall,Super Beach,21,22,43
2382,2023-01-15,SPIKE,brawlBall,Backyard Bowl,108,96,204
2383,2023-01-15,SPIKE,bounty,Canal Grande,2,4,6
2384,2023-01-14,SPIKE,knockout,Flaring Phoenix,3,0,3
2385,2023-01-14,SPIKE,hotZone,Controller Chaos,27,11,38
2386,2023-01-14,SPIKE,heist,Bridge Too Far,13,2,15
2387,2023-01-14,SPIKE,gemGrab,Hard Rock Mine,6,1,7
2388,2023-01-14,SPIKE,gemGrab,Deep Diner,7,22,29
2389,2023-01-14,SPIKE,brawlBall,Super Beach,50,72,122
2390,2023-01-14,SPIKE,brawlBall,Sneaky Fields,5,23,28
2391,2023-01-14,SPIKE,bounty,Canal Grande,5,2,7
2392,2023-01-13,SPIKE,knockout,Flaring Phoenix,13,2,15
2393,2023-01-13,SPIKE,hotZone,Controller Chaos,63,57,120
2394,2023-01-13,SPIKE,heist,Hot Potato,5,0,5
2395,2023-01-13,SPIKE,gemGrab,Deep Diner,14,20,34
2396,2023-01-13,SPIKE,brawlBall,Sneaky Fields,59,76,135
2397,2023-01-13,SPIKE,brawlBall,Pinhole Punt,1,2,3
2398,2023-01-13,SPIKE,bounty,Temple Ruins,4,2,6
2399,2023-01-12,SPIKE,knockout,Riverside,15,6,21
2400,2023-01-12,SPIKE,hotZone,Open Zone,13,22,35
2401,2023-01-12,SPIKE,gemGrab,Undermine,3,4,7
2402,2023-01-12,SPIKE,brawlBall,Sunny Soccer,5,2,7
2403,2023-01-12,SPIKE,brawlBall,Pinhole Punt,29,35,64
2404,2023-01-11,SPIKE,knockout,Riverside,1,0,1
2405,2023-01-11,SPIKE,hotZone,Open Zone,5,2,7
2406,2023-01-11,SPIKE,brawlBall,Sunny Soccer,21,38,59
2407,2023-01-11,SPIKE,brawlBall,Beach Ball,2,2,4
2408,2023-01-10,SPIKE,knockout,New Perspective,3,2,5
2409,2023-01-10,SPIKE,hotZone,Dueling Beetles,27,36,63
2410,2023-01-10,SPIKE,heist,Safe Zone,9,0,9
2411,2023-01-10,SPIKE,gemGrab,Minecart Madness,8,11,19
2412,2023-01-10,SPIKE,gemGrab,Crystal Arcade,8,7,15
2413,2023-01-10,SPIKE,brawlBall,Center Stage,3,2,5
2414,2023-01-10,SPIKE,brawlBall,Beach Ball,54,54,108
2415,2023-01-10,SPIKE,bounty,Excel,2,0,2
2416,2023-01-09,SPIKE,knockout,New Perspective,6,2,8
2417,2023-01-09,SPIKE,hotZone,Dueling Beetles,13,17,30
2418,2023-01-09,SPIKE,heist,Snaked Assault,24,34,58
2419,2023-01-09,SPIKE,gemGrab,Minecart Madness,22,49,71
2420,2023-01-09,SPIKE,gemGrab,Double Swoosh,9,5,14
2421,2023-01-09,SPIKE,brawlBall,Center Stage,27,18,45
2422,2023-01-09,SPIKE,brawlBall,Backyard Bowl,10,28,38
2423,2023-01-09,SPIKE,bounty,Layer Cake,5,0,5
2424,2023-01-08,SPIKE,knockout,X Marks the Spot,11,35,46
2425,2023-01-08,SPIKE,hotZone,Ring of Fire,22,33,55
2426,2023-01-08,SPIKE,heist,Snaked Assault,11,8,19
2427,2023-01-08,SPIKE,gemGrab,Hard Rock Mine,5,5,10
2428,2023-01-08,SPIKE,gemGrab,Double Swoosh,6,25,31
2429,2023-01-08,SPIKE,brawlBall,Super Beach,7,22,29
2430,2023-01-08,SPIKE,brawlBall,Backyard Bowl,50,54,104
2431,2023-01-08,SPIKE,bounty,Layer Cake,2,0,2
2432,2023-01-07,SPIKE,knockout,X Marks the Spot,10,5,15
2433,2023-01-07,SPIKE,hotZone,Ring of Fire,7,8,15
2434,2023-01-07,SPIKE,heist,Tornado Ring,9,19,28
2435,2023-01-07,SPIKE,gemGrab,Hard Rock Mine,10,5,15
2436,2023-01-07,SPIKE,gemGrab,Deep Diner,4,4,8
2437,2023-01-07,SPIKE,brawlBall,Super Beach,25,21,46
2438,2023-01-07,SPIKE,brawlBall,Sneaky Fields,1,1,2
2439,2023-01-07,SPIKE,bounty,Dry Season,7,0,7
2440,2023-01-06,SPIKE,knockout,Out in the Open,9,2,11
2441,2023-01-06,SPIKE,hotZone,Split,3,0,3
2442,2023-01-06,SPIKE,heist,Tornado Ring,23,19,42
2443,2023-01-06,SPIKE,gemGrab,Undermine,6,2,8
2444,2023-01-06,SPIKE,gemGrab,Deep Diner,18,3,21
2445,2023-01-06,SPIKE,brawlBall,Sneaky Fields,53,66,119
2446,2023-01-06,SPIKE,brawlBall,Pinhole Punt,6,4,10
2447,2023-01-06,SPIKE,bounty,Dry Season,3,3,6
2448,2023-01-05,SPIKE,knockout,Out in the Open,12,4,16
2449,2023-01-05,SPIKE,hotZone,Split,28,37,65
2450,2023-01-05,SPIKE,heist,Kaboom Canyon,11,4,15
2451,2023-01-05,SPIKE,gemGrab,Undermine,12,17,29
2452,2023-01-05,SPIKE,gemGrab,Gem Fort,2,0,2
2453,2023-01-05,SPIKE,brawlBall,Pinhole Punt,113,129,242
2454,2023-01-05,SPIKE,bounty,Shooting Star,2,0,2
2455,2023-01-04,SPIKE,knockout,Goldarm Gulch,2,13,15
2456,2023-01-04,SPIKE,hotZone,Parallel Plays,3,2,5
2457,2023-01-04,SPIKE,heist,Kaboom Canyon,18,32,50
2458,2023-01-04,SPIKE,gemGrab,Gem Fort,5,17,22
2459,2023-01-04,SPIKE,gemGrab,Crystal Arcade,8,11,19
2460,2023-01-04,SPIKE,brawlBall,Sunny Soccer,86,83,169
2461,2023-01-04,SPIKE,bounty,Shooting Star,6,3,9
2462,2023-01-03,SPIKE,knockout,Goldarm Gulch,7,3,10
2463,2023-01-03,SPIKE,hotZone,Parallel Plays,17,9,26
2464,2023-01-03,SPIKE,heist,Pit Stop,7,14,21
2465,2023-01-03,SPIKE,gemGrab,Minecart Madness,4,1,5
2466,2023-01-03,SPIKE,gemGrab,Crystal Arcade,25,14,39
2467,2023-01-03,SPIKE,brawlBall,Center Stage,2,0,2
2468,2023-01-03,SPIKE,brawlBall,Beach Ball,53,44,97
2469,2023-01-03,SPIKE,bounty,Hideout,8,2,10
2470,2023-01-02,SPIKE,knockout,Belle's Rock,4,8,12
2471,2023-01-02,SPIKE,hotZone,Quarter Pounder,28,44,72
2472,2023-01-02,SPIKE,heist,Pit Stop,17,17,34
2473,2023-01-02,SPIKE,gemGrab,Minecart Madness,44,32,76
2474,2023-01-02,SPIKE,gemGrab,Double Swoosh,15,31,46
2475,2023-01-02,SPIKE,brawlBall,Center Stage,56,50,106
2476,2023-01-02,SPIKE,brawlBall,Backyard Bowl,6,1,7
2477,2023-01-02,SPIKE,bounty,Hideout,12,19,31
2478,2023-01-01,SPIKE,knockout,Belle's Rock,4,2,6
2479,2023-01-01,SPIKE,hotZone,Quarter Pounder,15,3,18
2480,2023-01-01,SPIKE,hotZone,Controller Chaos,0,3,3
2481,2023-01-01,SPIKE,heist,Kaboom Canyon,0,2,2
2482,2023-01-01,SPIKE,heist,Bridge Too Far,1,2,3
2483,2023-01-01,SPIKE,gemGrab,Minecart Madness,1,0,1
2484,2023-01-01,SPIKE,gemGrab,Double Swoosh,8,7,15
2485,2023-01-01,SPIKE,brawlBall,Backyard Bowl,39,16,55
2486,2023-01-01,SPIKE,bounty,Canal Grande,1,0,1
2487,2022-12-31,SPIKE,hotZone,Controller Chaos,1,0,1
2488,2022-12-31,SPIKE,heist,Kaboom Canyon,2,0,2
2489,2022-12-31,SPIKE,heist,Bridge Too Far,2,0,2
2490,2022-12-31,SPIKE,gemGrab,Hard Rock Mine,1,0,1
2491,2022-12-31,SPIKE,gemGrab,Deep Diner,4,3,7
2492,2022-12-31,SPIKE,brawlBall,Super Beach,6,3,9
2493,2022-12-30,SPIKE,knockout,Flaring Phoenix,1,0,1
2494,2022-12-30,SPIKE,hotZone,Controller Chaos,2,1,3
2495,2022-12-30,SPIKE,heist,Kaboom Canyon,1,0,1
2496,2022-12-30,SPIKE,gemGrab,Undermine,1,1,2
2497,2022-12-30,SPIKE,gemGrab,Deep Diner,2,0,2
2498,2022-12-30,SPIKE,brawlBall,Sneaky Fields,3,1,4
2499,2022-12-29,SPIKE,hotZone,Controller Chaos,1,1,2
2500,2022-12-29,SPIKE,heist,Hot Potato,1,0,1
2501,2022-12-29,SPIKE,gemGrab,Undermine,1,1,2
2502,2022-12-29,SPIKE,gemGrab,Minecart Madness,2,0,2
2503,2022-12-29,SPIKE,brawlBall,Pinhole Punt,6,2,8
2504,2022-12-28,SPIKE,heist,Kaboom Canyon,2,0,2
2505,2022-12-28,SPIKE,gemGrab,Minecart Madness,0,2,2
2506,2022-12-28,SPIKE,brawlBall,Sunny Soccer,2,0,2
2507,2022-12-27,SPIKE,knockout,New Perspective,0,2,2
2508,2022-12-27,SPIKE,hotZone,Dueling Beetles,0,1,1
2509,2022-12-27,SPIKE,hotZone,Controller Chaos,2,2,4
2510,2022-12-27,SPIKE,gemGrab,Minecart Madness,0,1,1
2511,2022-12-27,SPIKE,brawlBall,Beach Ball,1,0,1
2512,2022-12-26,SPIKE,hotZone,Controller Chaos,0,1,1
2513,2022-12-26,SPIKE,heist,Kaboom Canyon,2,0,2
2514,2022-12-26,SPIKE,gemGrab,Minecart Madness,2,1,3
2515,2022-12-26,SPIKE,brawlBall,Center Stage,1,1,2
2516,2022-12-25,SPIKE,hotZone,Ring of Fire,0,1,1
2517,2022-12-25,SPIKE,gemGrab,Double Swoosh,2,0,2
2518,2022-12-25,SPIKE,brawlBall,Backyard Bowl,1,0,1
2519,2022-12-24,SPIKE,knockout,X Marks the Spot,1,0,1
2520,2022-12-24,SPIKE,brawlBall,Super Beach,0,1,1
2521,2022-12-23,SPIKE,knockout,Out in the Open,6,4,10
2522,2022-12-21,SPIKE,brawlBall,Sunny Soccer,0,1,1
2523,2022-12-19,SPIKE,gemGrab,Minecart Madness,0,2,2
2524,2022-12-19,SPIKE,brawlBall,Center Stage,2,1,3
2525,2022-12-16,SPIKE,brawlBall,Sneaky Fields,1,0,1
2526,2022-12-13,SPIKE,knockout,New Perspective,1,0,1
2527,2022-12-13,SPIKE,gemGrab,Crystal Arcade,1,0,1
2528,2022-12-11,SPIKE,brawlBall,Backyard Bowl,2,2,4
2529,2022-12-10,SPIKE,gemGrab,Hard Rock Mine,0,1,1
2530,2022-11-18,SPIKE,hotZone,Parallel Plays,0,2,2
2531,2022-11-18,SPIKE,brawlBall,Beach Ball,2,0,2
2532,2022-11-07,SPIKE,hotZone,Quarter Pounder,0,2,2
2533,2022-10-30,SPIKE,hotZone,Dueling Beetles,1,0,1
2534,2022-10-30,SPIKE,bounty,Canal Grande,1,0,1
2535,2022-10-28,SPIKE,knockout,Out in the Open,0,2,2
2536,2022-10-28,SPIKE,brawlBall,Beach Ball,0,2,2
2537,2023-02-11,SHELLY,knockout,Flaring Phoenix,68,77,145
2538,2023-02-11,SHELLY,hotZone,Controller Chaos,26,13,39
2539,2023-02-11,SHELLY,gemGrab,Deep Diner,10,1,11
2540,2023-02-11,SHELLY,brawlBall,Super Beach,95,68,163
2541,2023-02-11,SHELLY,brawlBall,Sneaky Fields,87,87,174
2542,2023-02-10,SHELLY,knockout,Flaring Phoenix,101,137,238
2543,2023-02-10,SHELLY,hotZone,Controller Chaos,17,17,34
2544,2023-02-10,SHELLY,heist,Hot Potato,7,6,13
2545,2023-02-10,SHELLY,gemGrab,Undermine,8,7,15
2546,2023-02-10,SHELLY,gemGrab,Deep Diner,21,9,30
2547,2023-02-10,SHELLY,brawlBall,Sneaky Fields,1053,1011,2064
2548,2023-02-10,SHELLY,brawlBall,Pinhole Punt,4,4,8
2549,2023-02-10,SHELLY,bounty,Temple Ruins,14,23,37
2550,2023-02-09,SHELLY,knockout,Riverside,12,0,12
2551,2023-02-09,SHELLY,hotZone,Open Zone,4,0,4
2552,2023-02-09,SHELLY,heist,Hot Potato,5,0,5
2553,2023-02-09,SHELLY,gemGrab,Undermine,8,7,15
2554,2023-02-09,SHELLY,gemGrab,Gem Fort,4,1,5
2555,2023-02-09,SHELLY,brawlBall,Pinhole Punt,126,88,214
2556,2023-02-09,SHELLY,bounty,Temple Ruins,3,4,7
2557,2023-02-08,SHELLY,knockout,Riverside,1,0,1
2558,2023-02-08,SHELLY,hotZone,Open Zone,1,0,1
2559,2023-02-08,SHELLY,gemGrab,Gem Fort,13,14,27
2560,2023-02-08,SHELLY,gemGrab,Crystal Arcade,3,6,9
2561,2023-02-08,SHELLY,brawlBall,Sunny Soccer,42,40,82
2562,2023-02-08,SHELLY,brawlBall,Beach Ball,2,6,8
2563,2023-02-08,SHELLY,bounty,Excel,2,1,3
2564,2023-02-07,SHELLY,knockout,New Perspective,4,2,6
2565,2023-02-07,SHELLY,hotZone,Dueling Beetles,2,1,3
2566,2023-02-07,SHELLY,gemGrab,Minecart Madness,3,0,3
2567,2023-02-07,SHELLY,gemGrab,Crystal Arcade,2,0,2
2568,2023-02-07,SHELLY,brawlBall,Center Stage,19,28,47
2569,2023-02-07,SHELLY,brawlBall,Beach Ball,35,24,59
2570,2023-02-07,SHELLY,bounty,Excel,1,0,1
2571,2023-02-06,SHELLY,knockout,New Perspective,157,198,355
2572,2023-02-06,SHELLY,knockout,Goldarm Gulch,12,19,31
2573,2023-02-06,SHELLY,hotZone,Dueling Beetles,36,8,44
2574,2023-02-06,SHELLY,heist,Snaked Assault,17,4,21
2575,2023-02-06,SHELLY,gemGrab,Minecart Madness,28,11,39
2576,2023-02-06,SHELLY,gemGrab,Double Swoosh,42,19,61
2577,2023-02-06,SHELLY,brawlBall,Sneaky Fields,38,30,68
2578,2023-02-06,SHELLY,brawlBall,Center Stage,1250,1263,2513
2579,2023-02-06,SHELLY,brawlBall,Backyard Bowl,21,8,29
2580,2023-02-06,SHELLY,bounty,Layer Cake,5,6,11
2581,2023-02-05,SHELLY,knockout,X Marks the Spot,62,92,154
2582,2023-02-05,SHELLY,knockout,Goldarm Gulch,40,63,103
2583,2023-02-05,SHELLY,hotZone,Ring of Fire,18,7,25
2584,2023-02-05,SHELLY,heist,Snaked Assault,42,6,48
2585,2023-02-05,SHELLY,heist,Pit Stop,3,2,5
2586,2023-02-05,SHELLY,gemGrab,Hard Rock Mine,27,27,54
2587,2023-02-05,SHELLY,gemGrab,Double Swoosh,169,116,285
2588,2023-02-05,SHELLY,brawlBall,Super Beach,15,13,28
2589,2023-02-05,SHELLY,brawlBall,Sneaky Fields,118,64,182
2590,2023-02-05,SHELLY,brawlBall,Backyard Bowl,305,167,472
2591,2023-02-05,SHELLY,bounty,Layer Cake,12,2,14
2592,2023-02-04,SHELLY,knockout,X Marks the Spot,19,15,34
2593,2023-02-04,SHELLY,knockout,Goldarm Gulch,15,41,56
2594,2023-02-04,SHELLY,hotZone,Ring of Fire,3,0,3
2595,2023-02-04,SHELLY,heist,Tornado Ring,7,3,10
2596,2023-02-04,SHELLY,heist,Pit Stop,1,0,1
2597,2023-02-04,SHELLY,gemGrab,Hard Rock Mine,20,13,33
2598,2023-02-04,SHELLY,gemGrab,Double Swoosh,25,5,30
2599,2023-02-04,SHELLY,gemGrab,Deep Diner,2,0,2
2600,2023-02-04,SHELLY,brawlBall,Super Beach,166,110,276
2601,2023-02-04,SHELLY,brawlBall,Sneaky Fields,70,47,117
2602,2023-02-04,SHELLY,bounty,Dry Season,0,1,1
2603,2023-02-03,SHELLY,knockout,Out in the Open,60,68,128
2604,2023-02-03,SHELLY,knockout,Goldarm Gulch,63,103,166
2605,2023-02-03,SHELLY,hotZone,Split,29,35,64
2606,2023-02-03,SHELLY,heist,Tornado Ring,19,7,26
2607,2023-02-03,SHELLY,heist,Pit Stop,12,5,17
2608,2023-02-03,SHELLY,gemGrab,Undermine,14,6,20
2609,2023-02-03,SHELLY,gemGrab,Double Swoosh,146,29,175
2610,2023-02-03,SHELLY,gemGrab,Deep Diner,40,16,56
2611,2023-02-03,SHELLY,brawlBall,Sneaky Fields,1640,1547,3187
2612,2023-02-03,SHELLY,brawlBall,Pinhole Punt,14,6,20
2613,2023-02-03,SHELLY,bounty,Dry Season,5,2,7
2614,2023-02-02,SHELLY,knockout,Out in the Open,35,38,73
2615,2023-02-02,SHELLY,hotZone,Split,12,7,19
2616,2023-02-02,SHELLY,heist,Kaboom Canyon,5,1,6
2617,2023-02-02,SHELLY,gemGrab,Undermine,9,11,20
2618,2023-02-02,SHELLY,gemGrab,Gem Fort,18,10,28
2619,2023-02-02,SHELLY,brawlBall,Sunny Soccer,5,6,11
2620,2023-02-02,SHELLY,brawlBall,Pinhole Punt,119,80,199
2621,2023-02-02,SHELLY,bounty,Shooting Star,0,1,1
2622,2023-02-01,SHELLY,knockout,Goldarm Gulch,160,296,456
2623,2023-02-01,SHELLY,hotZone,Parallel Plays,31,9,40
2624,2023-02-01,SHELLY,heist,Kaboom Canyon,6,0,6
2625,2023-02-01,SHELLY,gemGrab,Gem Fort,64,40,104
2626,2023-02-01,SHELLY,gemGrab,Crystal Arcade,29,37,66
2627,2023-02-01,SHELLY,brawlBall,Sunny Soccer,347,262,609
2628,2023-02-01,SHELLY,brawlBall,Beach Ball,7,8,15
2629,2023-02-01,SHELLY,bounty,Shooting Star,3,2,5
2630,2023-01-31,SHELLY,knockout,Goldarm Gulch,76,72,148
2631,2023-01-31,SHELLY,hotZone,Parallel Plays,13,13,26
2632,2023-01-31,SHELLY,heist,Pit Stop,9,3,12
2633,2023-01-31,SHELLY,gemGrab,Minecart Madness,1,2,3
2634,2023-01-31,SHELLY,gemGrab,Crystal Arcade,18,13,31
2635,2023-01-31,SHELLY,brawlBall,Center Stage,12,11,23
2636,2023-01-31,SHELLY,brawlBall,Beach Ball,185,148,333
2637,2023-01-31,SHELLY,bounty,Hideout,0,2,2
2638,2023-01-30,SHELLY,knockout,Belle's Rock,48,33,81
2639,2023-01-30,SHELLY,hotZone,Quarter Pounder,33,18,51
2640,2023-01-30,SHELLY,heist,Pit Stop,28,15,43
2641,2023-01-30,SHELLY,gemGrab,Minecart Madness,14,13,27
2642,2023-01-30,SHELLY,gemGrab,Double Swoosh,59,25,84
2643,2023-01-30,SHELLY,brawlBall,Center Stage,816,822,1638
2644,2023-01-30,SHELLY,brawlBall,Backyard Bowl,24,14,38
2645,2023-01-30,SHELLY,bounty,Hideout,3,0,3
2646,2023-01-29,SHELLY,knockout,Belle's Rock,79,120,199
2647,2023-01-29,SHELLY,hotZone,Quarter Pounder,25,5,30
2648,2023-01-29,SHELLY,heist,Bridge Too Far,9,1,10
2649,2023-01-29,SHELLY,gemGrab,Hard Rock Mine,19,4,23
2650,2023-01-29,SHELLY,gemGrab,Double Swoosh,84,76,160
2651,2023-01-29,SHELLY,brawlBall,Super Beach,9,9,18
2652,2023-01-29,SHELLY,brawlBall,Backyard Bowl,220,119,339
2653,2023-01-29,SHELLY,bounty,Canal Grande,5,5,10
2654,2023-01-28,SHELLY,knockout,Flaring Phoenix,81,126,207
2655,2023-01-28,SHELLY,hotZone,Controller Chaos,37,9,46
2656,2023-01-28,SHELLY,heist,Bridge Too Far,16,4,20
2657,2023-01-28,SHELLY,gemGrab,Hard Rock Mine,50,40,90
2658,2023-01-28,SHELLY,gemGrab,Deep Diner,8,2,10
2659,2023-01-28,SHELLY,brawlBall,Super Beach,543,442,985
2660,2023-01-28,SHELLY,brawlBall,Sneaky Fields,49,38,87
2661,2023-01-28,SHELLY,bounty,Canal Grande,20,4,24
2662,2023-01-27,SHELLY,knockout,Flaring Phoenix,31,52,83
2663,2023-01-27,SHELLY,hotZone,Controller Chaos,9,0,9
2664,2023-01-27,SHELLY,heist,Hot Potato,6,5,11
2665,2023-01-27,SHELLY,gemGrab,Undermine,3,2,5
2666,2023-01-27,SHELLY,gemGrab,Deep Diner,10,4,14
2667,2023-01-27,SHELLY,brawlBall,Sneaky Fields,330,259,589
2668,2023-01-27,SHELLY,brawlBall,Pinhole Punt,3,4,7
2669,2023-01-27,SHELLY,bounty,Temple Ruins,4,2,6
2670,2023-01-26,SHELLY,knockout,Riverside,10,7,17
2671,2023-01-26,SHELLY,hotZone,Open Zone,19,2,21
2672,2023-01-26,SHELLY,heist,Hot Potato,18,14,32
2673,2023-01-26,SHELLY,gemGrab,Undermine,30,13,43
2674,2023-01-26,SHELLY,gemGrab,Gem Fort,47,34,81
2675,2023-01-26,SHELLY,brawlBall,Sunny Soccer,22,44,66
2676,2023-01-26,SHELLY,brawlBall,Pinhole Punt,421,321,742
2677,2023-01-26,SHELLY,bounty,Temple Ruins,16,16,32
2678,2023-01-25,SHELLY,knockout,Riverside,14,8,22
2679,2023-01-25,SHELLY,hotZone,Open Zone,7,0,7
2680,2023-01-25,SHELLY,heist,Safe Zone,6,2,8
2681,2023-01-25,SHELLY,gemGrab,Gem Fort,35,31,66
2682,2023-01-25,SHELLY,gemGrab,Crystal Arcade,29,6,35
2683,2023-01-25,SHELLY,brawlBall,Sunny Soccer,296,235,531
2684,2023-01-25,SHELLY,brawlBall,Beach Ball,29,50,79
2685,2023-01-25,SHELLY,bounty,Excel,1,1,2
2686,2023-01-24,SHELLY,knockout,New Perspective,27,31,58
2687,2023-01-24,SHELLY,hotZone,Dueling Beetles,10,3,13
2688,2023-01-24,SHELLY,heist,Safe Zone,8,1,9
2689,2023-01-24,SHELLY,gemGrab,Minecart Madness,2,1,3
2690,2023-01-24,SHELLY,gemGrab,Crystal Arcade,28,23,51
2691,2023-01-24,SHELLY,brawlBall,Center Stage,86,92,178
2692,2023-01-24,SHELLY,brawlBall,Beach Ball,410,365,775
2693,2023-01-24,SHELLY,bounty,Excel,9,10,19
2694,2023-01-23,SHELLY,knockout,New Perspective,150,158,308
2695,2023-01-23,SHELLY,hotZone,Dueling Beetles,21,10,31
2696,2023-01-23,SHELLY,heist,Snaked Assault,27,5,32
2697,2023-01-23,SHELLY,gemGrab,Minecart Madness,30,15,45
2698,2023-01-23,SHELLY,gemGrab,Double Swoosh,39,24,63
2699,2023-01-23,SHELLY,brawlBall,Center Stage,1190,1137,2327
2700,2023-01-23,SHELLY,brawlBall,Backyard Bowl,21,8,29
2701,2023-01-23,SHELLY,bounty,Layer Cake,15,2,17
2702,2023-01-22,SHELLY,knockout,X Marks the Spot,76,93,169
2703,2023-01-22,SHELLY,hotZone,Ring of Fire,9,3,12
2704,2023-01-22,SHELLY,heist,Snaked Assault,9,4,13
2705,2023-01-22,SHELLY,gemGrab,Hard Rock Mine,16,13,29
2706,2023-01-22,SHELLY,gemGrab,Double Swoosh,54,46,100
2707,2023-01-22,SHELLY,brawlBall,Super Beach,38,25,63
2708,2023-01-22,SHELLY,brawlBall,Backyard Bowl,97,70,167
2709,2023-01-22,SHELLY,bounty,Layer Cake,5,1,6
2710,2023-01-21,SHELLY,knockout,X Marks the Spot,184,253,437
2711,2023-01-21,SHELLY,hotZone,Ring of Fire,16,6,22
2712,2023-01-21,SHELLY,heist,Tornado Ring,20,5,25
2713,2023-01-21,SHELLY,gemGrab,Hard Rock Mine,56,23,79
2714,2023-01-21,SHELLY,gemGrab,Deep Diner,7,3,10
2715,2023-01-21,SHELLY,brawlBall,Super Beach,655,518,1173
2716,2023-01-21,SHELLY,brawlBall,Sneaky Fields,38,40,78
2717,2023-01-21,SHELLY,bounty,Dry Season,9,3,12
2718,2023-01-20,SHELLY,knockout,Out in the Open,64,72,136
2719,2023-01-20,SHELLY,hotZone,Split,33,39,72
2720,2023-01-20,SHELLY,heist,Tornado Ring,16,9,25
2721,2023-01-20,SHELLY,gemGrab,Undermine,18,11,29
2722,2023-01-20,SHELLY,gemGrab,Deep Diner,33,8,41
2723,2023-01-20,SHELLY,brawlBall,Sneaky Fields,1070,1064,2134
2724,2023-01-20,SHELLY,brawlBall,Pinhole Punt,15,10,25
2725,2023-01-20,SHELLY,bounty,Dry Season,6,5,11
2726,2023-01-19,SHELLY,knockout,Out in the Open,113,138,251
2727,2023-01-19,SHELLY,hotZone,Split,37,9,46
2728,2023-01-19,SHELLY,heist,Kaboom Canyon,8,7,15
2729,2023-01-19,SHELLY,gemGrab,Undermine,51,47,98
2730,2023-01-19,SHELLY,gemGrab,Gem Fort,25,15,40
2731,2023-01-19,SHELLY,brawlBall,Sunny Soccer,16,14,30
2732,2023-01-19,SHELLY,brawlBall,Pinhole Punt,432,306,738
2733,2023-01-19,SHELLY,bounty,Shooting Star,11,3,14
2734,2023-01-18,SHELLY,knockout,Goldarm Gulch,28,34,62
2735,2023-01-18,SHELLY,hotZone,Parallel Plays,2,1,3
2736,2023-01-18,SHELLY,heist,Kaboom Canyon,1,1,2
2737,2023-01-18,SHELLY,gemGrab,Gem Fort,18,15,33
2738,2023-01-18,SHELLY,gemGrab,Crystal Arcade,1,1,2
2739,2023-01-18,SHELLY,brawlBall,Sunny Soccer,115,103,218
2740,2023-01-18,SHELLY,brawlBall,Beach Ball,3,6,9
2741,2023-01-18,SHELLY,bounty,Shooting Star,1,1,2
2742,2023-01-17,SHELLY,knockout,Goldarm Gulch,21,24,45
2743,2023-01-17,SHELLY,hotZone,Parallel Plays,1,1,2
2744,2023-01-17,SHELLY,heist,Pit Stop,3,4,7
2745,2023-01-17,SHELLY,gemGrab,Crystal Arcade,5,3,8
2746,2023-01-17,SHELLY,brawlBall,Center Stage,6,5,11
2747,2023-01-17,SHELLY,brawlBall,Beach Ball,34,26,60
2748,2023-01-16,SHELLY,knockout,Belle's Rock,5,0,5
2749,2023-01-16,SHELLY,hotZone,Quarter Pounder,6,0,6
2750,2023-01-16,SHELLY,heist,Pit Stop,8,8,16
2751,2023-01-16,SHELLY,gemGrab,Double Swoosh,4,2,6
2752,2023-01-16,SHELLY,brawlBall,Center Stage,86,62,148
2753,2023-01-16,SHELLY,brawlBall,Backyard Bowl,3,1,4
2754,2023-01-15,SHELLY,knockout,Belle's Rock,9,20,29
2755,2023-01-15,SHELLY,hotZone,Quarter Pounder,6,0,6
2756,2023-01-15,SHELLY,heist,Bridge Too Far,2,0,2
2757,2023-01-15,SHELLY,gemGrab,Hard Rock Mine,5,0,5
2758,2023-01-15,SHELLY,gemGrab,Double Swoosh,7,3,10
2759,2023-01-15,SHELLY,brawlBall,Super Beach,8,2,10
2760,2023-01-15,SHELLY,brawlBall,Backyard Bowl,32,13,45
2761,2023-01-15,SHELLY,bounty,Canal Grande,6,1,7
2762,2023-01-14,SHELLY,knockout,Flaring Phoenix,11,8,19
2763,2023-01-14,SHELLY,hotZone,Controller Chaos,10,1,11
2764,2023-01-14,SHELLY,heist,Bridge Too Far,3,0,3
2765,2023-01-14,SHELLY,gemGrab,Hard Rock Mine,3,1,4
2766,2023-01-14,SHELLY,gemGrab,Deep Diner,2,1,3
2767,2023-01-14,SHELLY,brawlBall,Super Beach,42,33,75
2768,2023-01-14,SHELLY,brawlBall,Sneaky Fields,3,16,19
2769,2023-01-14,SHELLY,bounty,Canal Grande,3,7,10
2770,2023-01-13,SHELLY,knockout,Flaring Phoenix,6,6,12
2771,2023-01-13,SHELLY,hotZone,Controller Chaos,5,3,8
2772,2023-01-13,SHELLY,gemGrab,Deep Diner,5,3,8
2773,2023-01-13,SHELLY,brawlBall,Sneaky Fields,67,96,163
2774,2023-01-13,SHELLY,bounty,Temple Ruins,2,0,2
2775,2023-01-12,SHELLY,knockout,Riverside,4,0,4
2776,2023-01-12,SHELLY,hotZone,Open Zone,1,1,2
2777,2023-01-12,SHELLY,gemGrab,Undermine,2,0,2
2778,2023-01-12,SHELLY,gemGrab,Gem Fort,2,1,3
2779,2023-01-12,SHELLY,brawlBall,Sunny Soccer,2,0,2
2780,2023-01-12,SHELLY,brawlBall,Pinhole Punt,7,1,8
2781,2023-01-12,SHELLY,bounty,Temple Ruins,0,1,1
2782,2023-01-11,SHELLY,knockout,Riverside,1,0,1
2783,2023-01-11,SHELLY,gemGrab,Gem Fort,3,1,4
2784,2023-01-11,SHELLY,brawlBall,Sunny Soccer,11,11,22
2785,2023-01-11,SHELLY,brawlBall,Beach Ball,1,1,2
2786,2023-01-10,SHELLY,knockout,New Perspective,6,15,21
2787,2023-01-10,SHELLY,hotZone,Dueling Beetles,2,0,2
2788,2023-01-10,SHELLY,heist,Safe Zone,1,0,1
2789,2023-01-10,SHELLY,gemGrab,Minecart Madness,2,0,2
2790,2023-01-10,SHELLY,gemGrab,Crystal Arcade,2,0,2
2791,2023-01-10,SHELLY,brawlBall,Center Stage,5,3,8
2792,2023-01-10,SHELLY,brawlBall,Beach Ball,22,8,30
2793,2023-01-10,SHELLY,bounty,Excel,2,0,2
2794,2023-01-09,SHELLY,knockout,New Perspective,6,23,29
2795,2023-01-09,SHELLY,hotZone,Dueling Beetles,1,4,5
2796,2023-01-09,SHELLY,heist,Snaked Assault,4,1,5
2797,2023-01-09,SHELLY,gemGrab,Minecart Madness,2,0,2
2798,2023-01-09,SHELLY,gemGrab,Double Swoosh,8,0,8
2799,2023-01-09,SHELLY,brawlBall,Center Stage,82,72,154
2800,2023-01-09,SHELLY,brawlBall,Backyard Bowl,2,0,2
2801,2023-01-09,SHELLY,bounty,Layer Cake,3,0,3
2802,2023-01-08,SHELLY,knockout,X Marks the Spot,3,3,6
2803,2023-01-08,SHELLY,hotZone,Ring of Fire,1,0,1
2804,2023-01-08,SHELLY,heist,Snaked Assault,5,0,5
2805,2023-01-08,SHELLY,gemGrab,Hard Rock Mine,3,2,5
2806,2023-01-08,SHELLY,gemGrab,Double Swoosh,7,3,10
2807,2023-01-08,SHELLY,brawlBall,Super Beach,2,1,3
2808,2023-01-08,SHELLY,brawlBall,Backyard Bowl,21,4,25
2809,2023-01-07,SHELLY,hotZone,Ring of Fire,1,0,1
2810,2023-01-07,SHELLY,heist,Tornado Ring,2,0,2
2811,2023-01-07,SHELLY,gemGrab,Hard Rock Mine,1,0,1
2812,2023-01-07,SHELLY,gemGrab,Deep Diner,3,0,3
2813,2023-01-07,SHELLY,brawlBall,Super Beach,7,3,10
2814,2023-01-07,SHELLY,brawlBall,Sneaky Fields,3,0,3
2815,2023-01-06,SHELLY,knockout,Out in the Open,11,22,33
2816,2023-01-06,SHELLY,hotZone,Split,5,0,5
2817,2023-01-06,SHELLY,heist,Tornado Ring,3,0,3
2818,2023-01-06,SHELLY,gemGrab,Deep Diner,1,0,1
2819,2023-01-06,SHELLY,brawlBall,Sneaky Fields,47,63,110
2820,2023-01-06,SHELLY,brawlBall,Pinhole Punt,4,1,5
2821,2023-01-06,SHELLY,bounty,Dry Season,1,0,1
2822,2023-01-05,SHELLY,knockout,Out in the Open,16,13,29
2823,2023-01-05,SHELLY,hotZone,Split,7,0,7
2824,2023-01-05,SHELLY,heist,Kaboom Canyon,3,1,4
2825,2023-01-05,SHELLY,gemGrab,Undermine,5,1,6
2826,2023-01-05,SHELLY,gemGrab,Gem Fort,0,1,1
2827,2023-01-05,SHELLY,brawlBall,Pinhole Punt,31,13,44
2828,2023-01-04,SHELLY,knockout,Goldarm Gulch,7,5,12
2829,2023-01-04,SHELLY,hotZone,Parallel Plays,3,0,3
2830,2023-01-04,SHELLY,heist,Kaboom Canyon,3,0,3
2831,2023-01-04,SHELLY,gemGrab,Gem Fort,4,2,6
2832,2023-01-04,SHELLY,gemGrab,Crystal Arcade,1,3,4
2833,2023-01-04,SHELLY,brawlBall,Sunny Soccer,45,27,72
2834,2023-01-04,SHELLY,brawlBall,Beach Ball,1,0,1
2835,2023-01-03,SHELLY,knockout,Goldarm Gulch,3,0,3
2836,2023-01-03,SHELLY,hotZone,Parallel Plays,3,0,3
2837,2023-01-03,SHELLY,heist,Pit Stop,3,0,3
2838,2023-01-03,SHELLY,gemGrab,Minecart Madness,1,0,1
2839,2023-01-03,SHELLY,gemGrab,Crystal Arcade,2,1,3
2840,2023-01-03,SHELLY,brawlBall,Center Stage,4,10,14
2841,2023-01-03,SHELLY,brawlBall,Beach Ball,23,1,24
2842,2023-01-02,SHELLY,knockout,Belle's Rock,4,0,4
2843,2023-01-02,SHELLY,hotZone,Quarter Pounder,10,1,11
2844,2023-01-02,SHELLY,heist,Pit Stop,5,1,6
2845,2023-01-02,SHELLY,heist,Kaboom Canyon,0,1,1
2846,2023-01-02,SHELLY,gemGrab,Minecart Madness,1,0,1
2847,2023-01-02,SHELLY,gemGrab,Double Swoosh,9,15,24
2848,2023-01-02,SHELLY,brawlBall,Center Stage,65,80,145
2849,2023-01-02,SHELLY,brawlBall,Backyard Bowl,2,3,5
2850,2023-01-02,SHELLY,bounty,Hideout,1,0,1
2851,2023-01-01,SHELLY,knockout,Belle's Rock,2,4,6
2852,2023-01-01,SHELLY,hotZone,Quarter Pounder,1,0,1
2853,2023-01-01,SHELLY,gemGrab,Minecart Madness,2,0,2
2854,2023-01-01,SHELLY,gemGrab,Hard Rock Mine,0,1,1
2855,2023-01-01,SHELLY,gemGrab,Double Swoosh,6,1,7
2856,2023-01-01,SHELLY,brawlBall,Backyard Bowl,6,7,13
2857,2022-12-31,SHELLY,knockout,Flaring Phoenix,0,1,1
2858,2022-12-31,SHELLY,hotZone,Controller Chaos,3,0,3
2859,2022-12-31,SHELLY,gemGrab,Deep Diner,1,0,1
2860,2022-12-31,SHELLY,brawlBall,Super Beach,5,2,7
2861,2022-12-31,SHELLY,brawlBall,Sneaky Fields,0,1,1
2862,2022-12-30,SHELLY,knockout,Flaring Phoenix,2,1,3
2863,2022-12-30,SHELLY,hotZone,Controller Chaos,3,0,3
2864,2022-12-30,SHELLY,gemGrab,Minecart Madness,0,2,2
2865,2022-12-30,SHELLY,gemGrab,Deep Diner,1,0,1
2866,2022-12-30,SHELLY,brawlBall,Sneaky Fields,3,1,4
2867,2022-12-29,SHELLY,gemGrab,Undermine,1,0,1
2868,2022-12-29,SHELLY,brawlBall,Pinhole Punt,0,1,1
2869,2022-12-28,SHELLY,hotZone,Controller Chaos,4,2,6
2870,2022-12-28,SHELLY,gemGrab,Crystal Arcade,2,0,2
2871,2022-12-28,SHELLY,brawlBall,Sunny Soccer,2,0,2
2872,2022-12-28,SHELLY,brawlBall,Beach Ball,2,0,2
2873,2022-12-27,SHELLY,brawlBall,Beach Ball,2,2,4
2874,2022-12-26,SHELLY,hotZone,Controller Chaos,0,2,2
2875,2022-12-26,SHELLY,heist,Kaboom Canyon,0,1,1
2876,2022-12-26,SHELLY,gemGrab,Minecart Madness,1,1,2
2877,2022-12-26,SHELLY,brawlBall,Center Stage,1,0,1
2878,2022-12-24,SHELLY,brawlBall,Super Beach,1,0,1
2879,2022-12-23,SHELLY,brawlBall,Sneaky Fields,0,2,2
2880,2022-12-22,SHELLY,brawlBall,Pinhole Punt,2,0,2
2881,2022-12-20,SHELLY,brawlBall,Beach Ball,1,1,2
2882,2022-12-13,SHELLY,brawlBall,Beach Ball,0,1,1
2883,2022-10-26,SHELLY,brawlBall,Sunny Soccer,0,2,2
2884,2023-02-11,SANDY,knockout,Flaring Phoenix,8,6,14
2885,2023-02-11,SANDY,hotZone,Controller Chaos,36,31,67
2886,2023-02-11,SANDY,gemGrab,Deep Diner,33,41,74
2887,2023-02-11,SANDY,brawlBall,Super Beach,50,56,106
2888,2023-02-11,SANDY,brawlBall,Sneaky Fields,29,34,63
2889,2023-02-10,SANDY,knockout,Flaring Phoenix,12,7,19
2890,2023-02-10,SANDY,hotZone,Controller Chaos,35,32,67
2891,2023-02-10,SANDY,heist,Hot Potato,0,1,1
2892,2023-02-10,SANDY,gemGrab,Undermine,13,20,33
2893,2023-02-10,SANDY,gemGrab,Deep Diner,75,62,137
2894,2023-02-10,SANDY,brawlBall,Sneaky Fields,219,267,486
2895,2023-02-10,SANDY,brawlBall,Pinhole Punt,5,6,11
2896,2023-02-10,SANDY,bounty,Temple Ruins,9,4,13
2897,2023-02-09,SANDY,hotZone,Open Zone,0,4,4
2898,2023-02-09,SANDY,gemGrab,Undermine,13,13,26
2899,2023-02-09,SANDY,gemGrab,Gem Fort,2,2,4
2900,2023-02-09,SANDY,brawlBall,Sunny Soccer,0,4,4
2901,2023-02-09,SANDY,brawlBall,Pinhole Punt,63,79,142
2902,2023-02-09,SANDY,bounty,Temple Ruins,2,6,8
2903,2023-02-08,SANDY,hotZone,Open Zone,0,1,1
2904,2023-02-08,SANDY,gemGrab,Gem Fort,6,3,9
2905,2023-02-08,SANDY,gemGrab,Crystal Arcade,6,5,11
2906,2023-02-08,SANDY,brawlBall,Sunny Soccer,29,35,64
2907,2023-02-08,SANDY,brawlBall,Beach Ball,2,1,3
2908,2023-02-07,SANDY,hotZone,Dueling Beetles,6,3,9
2909,2023-02-07,SANDY,gemGrab,Minecart Madness,4,1,5
2910,2023-02-07,SANDY,gemGrab,Crystal Arcade,1,4,5
2911,2023-02-07,SANDY,brawlBall,Center Stage,2,1,3
2912,2023-02-07,SANDY,brawlBall,Beach Ball,17,10,27
2913,2023-02-06,SANDY,knockout,New Perspective,15,10,25
2914,2023-02-06,SANDY,hotZone,Dueling Beetles,103,81,184
2915,2023-02-06,SANDY,heist,Snaked Assault,1,0,1
2916,2023-02-06,SANDY,gemGrab,Minecart Madness,49,52,101
2917,2023-02-06,SANDY,gemGrab,Double Swoosh,67,83,150
2918,2023-02-06,SANDY,brawlBall,Sneaky Fields,2,5,7
2919,2023-02-06,SANDY,brawlBall,Center Stage,208,230,438
2920,2023-02-06,SANDY,brawlBall,Backyard Bowl,21,10,31
2921,2023-02-06,SANDY,bounty,Layer Cake,7,1,8
2922,2023-02-05,SANDY,knockout,X Marks the Spot,3,3,6
2923,2023-02-05,SANDY,hotZone,Ring of Fire,43,56,99
2924,2023-02-05,SANDY,heist,Snaked Assault,5,0,5
2925,2023-02-05,SANDY,gemGrab,Hard Rock Mine,22,22,44
2926,2023-02-05,SANDY,gemGrab,Double Swoosh,195,214,409
2927,2023-02-05,SANDY,brawlBall,Super Beach,15,21,36
2928,2023-02-05,SANDY,brawlBall,Sneaky Fields,24,5,29
2929,2023-02-05,SANDY,brawlBall,Backyard Bowl,92,86,178
2930,2023-02-05,SANDY,bounty,Layer Cake,6,7,13
2931,2023-02-04,SANDY,knockout,X Marks the Spot,4,0,4
2932,2023-02-04,SANDY,knockout,Goldarm Gulch,0,1,1
2933,2023-02-04,SANDY,hotZone,Ring of Fire,8,12,20
2934,2023-02-04,SANDY,heist,Pit Stop,0,1,1
2935,2023-02-04,SANDY,gemGrab,Hard Rock Mine,15,8,23
2936,2023-02-04,SANDY,gemGrab,Double Swoosh,21,23,44
2937,2023-02-04,SANDY,gemGrab,Deep Diner,1,5,6
2938,2023-02-04,SANDY,brawlBall,Super Beach,84,99,183
2939,2023-02-04,SANDY,brawlBall,Sneaky Fields,7,5,12
2940,2023-02-04,SANDY,bounty,Dry Season,2,0,2
2941,2023-02-03,SANDY,knockout,Out in the Open,8,6,14
2942,2023-02-03,SANDY,knockout,Goldarm Gulch,5,8,13
2943,2023-02-03,SANDY,hotZone,Split,14,7,21
2944,2023-02-03,SANDY,heist,Tornado Ring,2,1,3
2945,2023-02-03,SANDY,heist,Pit Stop,0,7,7
2946,2023-02-03,SANDY,gemGrab,Undermine,16,26,42
2947,2023-02-03,SANDY,gemGrab,Double Swoosh,145,128,273
2948,2023-02-03,SANDY,gemGrab,Deep Diner,86,112,198
2949,2023-02-03,SANDY,brawlBall,Sneaky Fields,299,326,625
2950,2023-02-03,SANDY,brawlBall,Pinhole Punt,7,12,19
2951,2023-02-03,SANDY,bounty,Dry Season,3,1,4
2952,2023-02-02,SANDY,knockout,Out in the Open,2,4,6
2953,2023-02-02,SANDY,hotZone,Split,7,8,15
2954,2023-02-02,SANDY,gemGrab,Undermine,22,20,42
2955,2023-02-02,SANDY,gemGrab,Gem Fort,5,10,15
2956,2023-02-02,SANDY,brawlBall,Sunny Soccer,2,3,5
2957,2023-02-02,SANDY,brawlBall,Pinhole Punt,57,85,142
2958,2023-02-02,SANDY,bounty,Shooting Star,2,1,3
2959,2023-02-01,SANDY,knockout,Goldarm Gulch,20,19,39
2960,2023-02-01,SANDY,hotZone,Parallel Plays,23,15,38
2961,2023-02-01,SANDY,heist,Kaboom Canyon,0,1,1
2962,2023-02-01,SANDY,gemGrab,Gem Fort,54,68,122
2963,2023-02-01,SANDY,gemGrab,Crystal Arcade,46,61,107
2964,2023-02-01,SANDY,brawlBall,Sunny Soccer,215,263,478
2965,2023-02-01,SANDY,brawlBall,Beach Ball,6,15,21
2966,2023-02-01,SANDY,bounty,Shooting Star,2,0,2
2967,2023-01-31,SANDY,knockout,Goldarm Gulch,8,8,16
2968,2023-01-31,SANDY,hotZone,Parallel Plays,14,7,21
2969,2023-01-31,SANDY,heist,Pit Stop,1,0,1
2970,2023-01-31,SANDY,gemGrab,Minecart Madness,0,2,2
2971,2023-01-31,SANDY,gemGrab,Crystal Arcade,42,63,105
2972,2023-01-31,SANDY,brawlBall,Center Stage,0,1,1
2973,2023-01-31,SANDY,brawlBall,Beach Ball,92,98,190
2974,2023-01-31,SANDY,bounty,Hideout,1,2,3
2975,2023-01-30,SANDY,knockout,Belle's Rock,6,5,11
2976,2023-01-30,SANDY,hotZone,Quarter Pounder,46,67,113
2977,2023-01-30,SANDY,heist,Pit Stop,1,0,1
2978,2023-01-30,SANDY,gemGrab,Minecart Madness,29,35,64
2979,2023-01-30,SANDY,gemGrab,Double Swoosh,57,72,129
2980,2023-01-30,SANDY,brawlBall,Center Stage,146,175,321
2981,2023-01-30,SANDY,brawlBall,Backyard Bowl,4,2,6
2982,2023-01-30,SANDY,bounty,Hideout,2,1,3
2983,2023-01-29,SANDY,knockout,Belle's Rock,9,4,13
2984,2023-01-29,SANDY,hotZone,Quarter Pounder,20,18,38
2985,2023-01-29,SANDY,heist,Bridge Too Far,1,1,2
2986,2023-01-29,SANDY,gemGrab,Hard Rock Mine,10,23,33
2987,2023-01-29,SANDY,gemGrab,Double Swoosh,97,98,195
2988,2023-01-29,SANDY,brawlBall,Super Beach,10,20,30
2989,2023-01-29,SANDY,brawlBall,Backyard Bowl,73,62,135
2990,2023-01-29,SANDY,bounty,Canal Grande,12,7,19
2991,2023-01-28,SANDY,knockout,Flaring Phoenix,5,7,12
2992,2023-01-28,SANDY,hotZone,Controller Chaos,36,53,89
2993,2023-01-28,SANDY,heist,Bridge Too Far,3,0,3
2994,2023-01-28,SANDY,gemGrab,Hard Rock Mine,63,75,138
2995,2023-01-28,SANDY,gemGrab,Deep Diner,20,41,61
2996,2023-01-28,SANDY,brawlBall,Super Beach,302,338,640
2997,2023-01-28,SANDY,brawlBall,Sneaky Fields,7,9,16
2998,2023-01-28,SANDY,bounty,Canal Grande,14,19,33
2999,2023-01-27,SANDY,knockout,Flaring Phoenix,1,2,3
3000,2023-01-27,SANDY,hotZone,Controller Chaos,15,16,31
3001,2023-01-27,SANDY,gemGrab,Undermine,5,6,11
3002,2023-01-27,SANDY,gemGrab,Deep Diner,37,57,94
3003,2023-01-27,SANDY,brawlBall,Sneaky Fields,62,69,131
3004,2023-01-27,SANDY,brawlBall,Pinhole Punt,1,1,2
3005,2023-01-27,SANDY,bounty,Temple Ruins,3,7,10
3006,2023-01-26,SANDY,knockout,Riverside,8,9,17
3007,2023-01-26,SANDY,hotZone,Open Zone,28,12,40
3008,2023-01-26,SANDY,heist,Hot Potato,3,1,4
3009,2023-01-26,SANDY,gemGrab,Undermine,60,84,144
3010,2023-01-26,SANDY,gemGrab,Gem Fort,29,24,53
3011,2023-01-26,SANDY,brawlBall,Sunny Soccer,16,4,20
3012,2023-01-26,SANDY,brawlBall,Pinhole Punt,258,269,527
3013,2023-01-26,SANDY,bounty,Temple Ruins,13,10,23
3014,2023-01-25,SANDY,hotZone,Open Zone,1,6,7
3015,2023-01-25,SANDY,heist,Safe Zone,2,0,2
3016,2023-01-25,SANDY,gemGrab,Gem Fort,24,22,46
3017,2023-01-25,SANDY,gemGrab,Crystal Arcade,51,58,109
3018,2023-01-25,SANDY,brawlBall,Sunny Soccer,134,194,328
3019,2023-01-25,SANDY,brawlBall,Beach Ball,24,16,40
3020,2023-01-25,SANDY,bounty,Excel,1,0,1
3021,2023-01-24,SANDY,knockout,New Perspective,12,6,18
3022,2023-01-24,SANDY,hotZone,Dueling Beetles,56,41,97
3023,2023-01-24,SANDY,gemGrab,Minecart Madness,15,12,27
3024,2023-01-24,SANDY,gemGrab,Crystal Arcade,135,178,313
3025,2023-01-24,SANDY,brawlBall,Center Stage,23,34,57
3026,2023-01-24,SANDY,brawlBall,Beach Ball,267,310,577
3027,2023-01-24,SANDY,bounty,Excel,7,2,9
3028,2023-01-23,SANDY,knockout,New Perspective,18,8,26
3029,2023-01-23,SANDY,hotZone,Dueling Beetles,64,51,115
3030,2023-01-23,SANDY,heist,Snaked Assault,1,2,3
3031,2023-01-23,SANDY,gemGrab,Minecart Madness,40,34,74
3032,2023-01-23,SANDY,gemGrab,Double Swoosh,50,60,110
3033,2023-01-23,SANDY,brawlBall,Center Stage,240,322,562
3034,2023-01-23,SANDY,brawlBall,Backyard Bowl,5,3,8
3035,2023-01-23,SANDY,bounty,Layer Cake,3,6,9
3036,2023-01-22,SANDY,knockout,X Marks the Spot,3,3,6
3037,2023-01-22,SANDY,hotZone,Ring of Fire,22,17,39
3038,2023-01-22,SANDY,heist,Snaked Assault,1,0,1
3039,2023-01-22,SANDY,gemGrab,Hard Rock Mine,19,21,40
3040,2023-01-22,SANDY,gemGrab,Double Swoosh,92,109,201
3041,2023-01-22,SANDY,brawlBall,Super Beach,27,26,53
3042,2023-01-22,SANDY,brawlBall,Backyard Bowl,36,41,77
3043,2023-01-22,SANDY,bounty,Layer Cake,5,3,8
3044,2023-01-21,SANDY,knockout,X Marks the Spot,20,9,29
3045,2023-01-21,SANDY,hotZone,Ring of Fire,76,76,152
3046,2023-01-21,SANDY,heist,Tornado Ring,2,0,2
3047,2023-01-21,SANDY,gemGrab,Hard Rock Mine,108,99,207
3048,2023-01-21,SANDY,gemGrab,Deep Diner,16,10,26
3049,2023-01-21,SANDY,brawlBall,Super Beach,409,477,886
3050,2023-01-21,SANDY,brawlBall,Sneaky Fields,6,8,14
3051,2023-01-21,SANDY,bounty,Dry Season,1,3,4
3052,2023-01-20,SANDY,knockout,Out in the Open,14,21,35
3053,2023-01-20,SANDY,hotZone,Split,17,17,34
3054,2023-01-20,SANDY,heist,Tornado Ring,0,2,2
3055,2023-01-20,SANDY,gemGrab,Undermine,34,31,65
3056,2023-01-20,SANDY,gemGrab,Deep Diner,80,90,170
3057,2023-01-20,SANDY,brawlBall,Sneaky Fields,297,291,588
3058,2023-01-20,SANDY,brawlBall,Pinhole Punt,3,6,9
3059,2023-01-20,SANDY,bounty,Dry Season,4,10,14
3060,2023-01-19,SANDY,knockout,Out in the Open,19,9,28
3061,2023-01-19,SANDY,hotZone,Split,18,16,34
3062,2023-01-19,SANDY,heist,Kaboom Canyon,3,4,7
3063,2023-01-19,SANDY,gemGrab,Undermine,65,119,184
3064,2023-01-19,SANDY,gemGrab,Gem Fort,10,12,22
3065,2023-01-19,SANDY,brawlBall,Sunny Soccer,8,7,15
3066,2023-01-19,SANDY,brawlBall,Pinhole Punt,236,282,518
3067,2023-01-19,SANDY,bounty,Shooting Star,3,1,4
3068,2023-01-18,SANDY,knockout,Goldarm Gulch,4,4,8
3069,2023-01-18,SANDY,hotZone,Parallel Plays,5,12,17
3070,2023-01-18,SANDY,heist,Kaboom Canyon,0,1,1
3071,2023-01-18,SANDY,gemGrab,Gem Fort,16,14,30
3072,2023-01-18,SANDY,gemGrab,Crystal Arcade,9,15,24
3073,2023-01-18,SANDY,brawlBall,Sunny Soccer,88,94,182
3074,2023-01-18,SANDY,brawlBall,Beach Ball,4,2,6
3075,2023-01-18,SANDY,bounty,Shooting Star,2,0,2
3076,2023-01-17,SANDY,knockout,Goldarm Gulch,5,8,13
3077,2023-01-17,SANDY,hotZone,Parallel Plays,5,4,9
3078,2023-01-17,SANDY,heist,Pit Stop,0,1,1
3079,2023-01-17,SANDY,gemGrab,Crystal Arcade,7,7,14
3080,2023-01-17,SANDY,brawlBall,Beach Ball,23,31,54
3081,2023-01-17,SANDY,bounty,Hideout,3,4,7
3082,2023-01-16,SANDY,knockout,Belle's Rock,1,0,1
3083,2023-01-16,SANDY,hotZone,Quarter Pounder,7,4,11
3084,2023-01-16,SANDY,heist,Pit Stop,1,1,2
3085,2023-01-16,SANDY,gemGrab,Minecart Madness,1,0,1
3086,2023-01-16,SANDY,gemGrab,Double Swoosh,7,4,11
3087,2023-01-16,SANDY,brawlBall,Center Stage,13,4,17
3088,2023-01-16,SANDY,brawlBall,Backyard Bowl,1,0,1
3089,2023-01-15,SANDY,hotZone,Quarter Pounder,2,0,2
3090,2023-01-15,SANDY,heist,Bridge Too Far,0,1,1
3091,2023-01-15,SANDY,gemGrab,Hard Rock Mine,7,22,29
3092,2023-01-15,SANDY,gemGrab,Double Swoosh,16,16,32
3093,2023-01-15,SANDY,brawlBall,Super Beach,5,8,13
3094,2023-01-15,SANDY,brawlBall,Backyard Bowl,12,3,15
3095,2023-01-15,SANDY,bounty,Canal Grande,1,1,2
3096,2023-01-14,SANDY,hotZone,Controller Chaos,15,32,47
3097,2023-01-14,SANDY,gemGrab,Hard Rock Mine,4,2,6
3098,2023-01-14,SANDY,gemGrab,Deep Diner,1,4,5
3099,2023-01-14,SANDY,brawlBall,Super Beach,21,29,50
3100,2023-01-14,SANDY,brawlBall,Sneaky Fields,0,5,5
3101,2023-01-14,SANDY,bounty,Canal Grande,9,12,21
3102,2023-01-13,SANDY,knockout,Flaring Phoenix,1,0,1
3103,2023-01-13,SANDY,hotZone,Controller Chaos,3,0,3
3104,2023-01-13,SANDY,gemGrab,Undermine,0,1,1
3105,2023-01-13,SANDY,gemGrab,Deep Diner,6,2,8
3106,2023-01-13,SANDY,brawlBall,Sneaky Fields,10,6,16
3107,2023-01-13,SANDY,brawlBall,Pinhole Punt,0,1,1
3108,2023-01-12,SANDY,hotZone,Open Zone,4,0,4
3109,2023-01-12,SANDY,gemGrab,Undermine,4,5,9
3110,2023-01-12,SANDY,gemGrab,Gem Fort,2,3,5
3111,2023-01-12,SANDY,brawlBall,Sunny Soccer,2,13,15
3112,2023-01-12,SANDY,brawlBall,Pinhole Punt,10,11,21
3113,2023-01-11,SANDY,hotZone,Open Zone,0,3,3
3114,2023-01-11,SANDY,gemGrab,Gem Fort,1,0,1
3115,2023-01-11,SANDY,brawlBall,Sunny Soccer,6,2,8
3116,2023-01-11,SANDY,brawlBall,Beach Ball,0,1,1
3117,2023-01-10,SANDY,knockout,New Perspective,1,1,2
3118,2023-01-10,SANDY,hotZone,Dueling Beetles,13,12,25
3119,2023-01-10,SANDY,gemGrab,Crystal Arcade,15,40,55
3120,2023-01-10,SANDY,brawlBall,Center Stage,0,1,1
3121,2023-01-10,SANDY,brawlBall,Beach Ball,25,8,33
3122,2023-01-09,SANDY,knockout,New Perspective,2,0,2
3123,2023-01-09,SANDY,hotZone,Dueling Beetles,12,14,26
3124,2023-01-09,SANDY,gemGrab,Minecart Madness,1,1,2
3125,2023-01-09,SANDY,gemGrab,Double Swoosh,7,4,11
3126,2023-01-09,SANDY,brawlBall,Center Stage,7,14,21
3127,2023-01-09,SANDY,brawlBall,Backyard Bowl,2,0,2
3128,2023-01-08,SANDY,knockout,X Marks the Spot,2,0,2
3129,2023-01-08,SANDY,hotZone,Ring of Fire,3,4,7
3130,2023-01-08,SANDY,gemGrab,Hard Rock Mine,1,0,1
3131,2023-01-08,SANDY,gemGrab,Double Swoosh,7,21,28
3132,2023-01-08,SANDY,brawlBall,Super Beach,2,0,2
3133,2023-01-08,SANDY,brawlBall,Backyard Bowl,2,5,7
3134,2023-01-07,SANDY,hotZone,Ring of Fire,4,5,9
3135,2023-01-07,SANDY,gemGrab,Hard Rock Mine,6,3,9
3136,2023-01-07,SANDY,gemGrab,Deep Diner,4,7,11
3137,2023-01-07,SANDY,brawlBall,Super Beach,13,18,31
3138,2023-01-07,SANDY,brawlBall,Sneaky Fields,2,0,2
3139,2023-01-06,SANDY,hotZone,Split,2,4,6
3140,2023-01-06,SANDY,heist,Tornado Ring,1,0,1
3141,2023-01-06,SANDY,gemGrab,Undermine,4,1,5
3142,2023-01-06,SANDY,gemGrab,Deep Diner,11,7,18
3143,2023-01-06,SANDY,brawlBall,Sneaky Fields,11,11,22
3144,2023-01-06,SANDY,brawlBall,Pinhole Punt,4,1,5
3145,2023-01-06,SANDY,bounty,Dry Season,1,0,1
3146,2023-01-05,SANDY,hotZone,Split,6,13,19
3147,2023-01-05,SANDY,gemGrab,Undermine,5,3,8
3148,2023-01-05,SANDY,gemGrab,Gem Fort,2,12,14
3149,2023-01-05,SANDY,brawlBall,Pinhole Punt,24,22,46
3150,2023-01-04,SANDY,knockout,Goldarm Gulch,1,0,1
3151,2023-01-04,SANDY,hotZone,Parallel Plays,1,1,2
3152,2023-01-04,SANDY,gemGrab,Gem Fort,6,14,20
3153,2023-01-04,SANDY,gemGrab,Crystal Arcade,5,5,10
3154,2023-01-04,SANDY,brawlBall,Sunny Soccer,20,22,42
3155,2023-01-03,SANDY,gemGrab,Minecart Madness,1,0,1
3156,2023-01-03,SANDY,gemGrab,Crystal Arcade,22,5,27
3157,2023-01-03,SANDY,brawlBall,Beach Ball,13,11,24
3158,2023-01-02,SANDY,knockout,Belle's Rock,1,0,1
3159,2023-01-02,SANDY,hotZone,Quarter Pounder,2,1,3
3160,2023-01-02,SANDY,gemGrab,Minecart Madness,7,0,7
3161,2023-01-02,SANDY,gemGrab,Double Swoosh,8,16,24
3162,2023-01-02,SANDY,brawlBall,Center Stage,10,10,20
3163,2023-01-02,SANDY,brawlBall,Backyard Bowl,0,1,1
3164,2023-01-01,SANDY,hotZone,Quarter Pounder,6,11,17
3165,2023-01-01,SANDY,gemGrab,Double Swoosh,19,22,41
3166,2023-01-01,SANDY,brawlBall,Backyard Bowl,3,5,8
3167,2022-12-31,SANDY,hotZone,Controller Chaos,0,1,1
3168,2022-12-31,SANDY,gemGrab,Deep Diner,1,0,1
3169,2022-12-31,SANDY,brawlBall,Super Beach,5,2,7
3170,2022-12-30,SANDY,hotZone,Controller Chaos,1,2,3
3171,2022-12-30,SANDY,gemGrab,Minecart Madness,1,0,1
3172,2022-12-30,SANDY,gemGrab,Deep Diner,0,2,2
3173,2022-12-30,SANDY,brawlBall,Sneaky Fields,5,8,13
3174,2022-12-29,SANDY,brawlBall,Pinhole Punt,4,4,8
3175,2022-12-28,SANDY,gemGrab,Crystal Arcade,0,2,2
3176,2022-12-27,SANDY,hotZone,Dueling Beetles,1,0,1
3177,2022-12-27,SANDY,brawlBall,Beach Ball,0,2,2
3178,2022-12-24,SANDY,brawlBall,Super Beach,2,0,2
3179,2022-12-21,SANDY,brawlBall,Sunny Soccer,0,1,1
3180,2022-12-20,SANDY,brawlBall,Beach Ball,0,1,1
3181,2022-12-19,SANDY,brawlBall,Center Stage,0,1,1
3182,2022-12-13,SANDY,knockout,New Perspective,1,0,1
3183,2022-12-13,SANDY,brawlBall,Beach Ball,0,1,1
3184,2022-10-30,SANDY,brawlBall,Beach Ball,1,0,1
3185,2022-10-15,SANDY,gemGrab,Hard Rock Mine,1,2,3
3186,2023-02-11,SAM,knockout,Flaring Phoenix,33,17,50
3187,2023-02-11,SAM,hotZone,Controller Chaos,63,116,179
3188,2023-02-11,SAM,gemGrab,Deep Diner,42,94,136
3189,2023-02-11,SAM,brawlBall,Super Beach,129,170,299
3190,2023-02-11,SAM,brawlBall,Sneaky Fields,82,83,165
3191,2023-02-10,SAM,knockout,Flaring Phoenix,47,47,94
3192,2023-02-10,SAM,hotZone,Controller Chaos,121,169,290
3193,2023-02-10,SAM,heist,Hot Potato,89,99,188
3194,2023-02-10,SAM,gemGrab,Undermine,16,12,28
3195,2023-02-10,SAM,gemGrab,Deep Diner,84,97,181
3196,2023-02-10,SAM,brawlBall,Sneaky Fields,584,727,1311
3197,2023-02-10,SAM,brawlBall,Pinhole Punt,9,7,16
3198,2023-02-10,SAM,bounty,Temple Ruins,25,17,42
3199,2023-02-09,SAM,knockout,Riverside,8,7,15
3200,2023-02-09,SAM,hotZone,Open Zone,5,6,11
3201,2023-02-09,SAM,heist,Hot Potato,17,21,38
3202,2023-02-09,SAM,gemGrab,Undermine,19,19,38
3203,2023-02-09,SAM,gemGrab,Gem Fort,5,5,10
3204,2023-02-09,SAM,brawlBall,Sunny Soccer,3,2,5
3205,2023-02-09,SAM,brawlBall,Pinhole Punt,96,153,249
3206,2023-02-09,SAM,bounty,Temple Ruins,6,14,20
3207,2023-02-08,SAM,hotZone,Open Zone,6,1,7
3208,2023-02-08,SAM,heist,Safe Zone,6,2,8
3209,2023-02-08,SAM,gemGrab,Gem Fort,12,21,33
3210,2023-02-08,SAM,gemGrab,Crystal Arcade,10,9,19
3211,2023-02-08,SAM,brawlBall,Sunny Soccer,44,61,105
3212,2023-02-08,SAM,brawlBall,Beach Ball,3,3,6
3213,2023-02-08,SAM,bounty,Excel,6,9,15
3214,2023-02-07,SAM,knockout,New Perspective,5,0,5
3215,2023-02-07,SAM,hotZone,Dueling Beetles,12,5,17
3216,2023-02-07,SAM,heist,Safe Zone,4,6,10
3217,2023-02-07,SAM,gemGrab,Minecart Madness,1,0,1
3218,2023-02-07,SAM,gemGrab,Crystal Arcade,4,3,7
3219,2023-02-07,SAM,brawlBall,Center Stage,3,5,8
3220,2023-02-07,SAM,brawlBall,Beach Ball,22,26,48
3221,2023-02-07,SAM,bounty,Excel,3,1,4
3222,2023-02-06,SAM,knockout,New Perspective,52,47,99
3223,2023-02-06,SAM,knockout,Goldarm Gulch,1,4,5
3224,2023-02-06,SAM,hotZone,Dueling Beetles,214,265,479
3225,2023-02-06,SAM,heist,Snaked Assault,133,161,294
3226,2023-02-06,SAM,heist,Pit Stop,21,36,57
3227,2023-02-06,SAM,gemGrab,Minecart Madness,58,96,154
3228,2023-02-06,SAM,gemGrab,Double Swoosh,62,43,105
3229,2023-02-06,SAM,brawlBall,Sneaky Fields,24,24,48
3230,2023-02-06,SAM,brawlBall,Center Stage,695,1033,1728
3231,2023-02-06,SAM,brawlBall,Backyard Bowl,44,59,103
3232,2023-02-06,SAM,bounty,Layer Cake,25,42,67
3233,2023-02-05,SAM,knockout,X Marks the Spot,21,16,37
3234,2023-02-05,SAM,knockout,Goldarm Gulch,5,7,12
3235,2023-02-05,SAM,hotZone,Ring of Fire,37,45,82
3236,2023-02-05,SAM,heist,Snaked Assault,121,141,262
3237,2023-02-05,SAM,heist,Pit Stop,65,88,153
3238,2023-02-05,SAM,gemGrab,Hard Rock Mine,51,115,166
3239,2023-02-05,SAM,gemGrab,Double Swoosh,153,157,310
3240,2023-02-05,SAM,brawlBall,Super Beach,28,29,57
3241,2023-02-05,SAM,brawlBall,Sneaky Fields,97,87,184
3242,2023-02-05,SAM,brawlBall,Backyard Bowl,419,531,950
3243,2023-02-05,SAM,bounty,Layer Cake,32,23,55
3244,2023-02-04,SAM,knockout,X Marks the Spot,13,6,19
3245,2023-02-04,SAM,knockout,Goldarm Gulch,3,12,15
3246,2023-02-04,SAM,hotZone,Ring of Fire,8,7,15
3247,2023-02-04,SAM,heist,Tornado Ring,18,16,34
3248,2023-02-04,SAM,heist,Pit Stop,32,58,90
3249,2023-02-04,SAM,gemGrab,Hard Rock Mine,32,50,82
3250,2023-02-04,SAM,gemGrab,Double Swoosh,27,6,33
3251,2023-02-04,SAM,gemGrab,Deep Diner,3,5,8
3252,2023-02-04,SAM,brawlBall,Super Beach,210,260,470
3253,2023-02-04,SAM,brawlBall,Sneaky Fields,64,54,118
3254,2023-02-04,SAM,bounty,Dry Season,5,0,5
3255,2023-02-03,SAM,knockout,Out in the Open,39,52,91
3256,2023-02-03,SAM,knockout,Goldarm Gulch,15,21,36
3257,2023-02-03,SAM,hotZone,Split,112,199,311
3258,2023-02-03,SAM,heist,Tornado Ring,102,145,247
3259,2023-02-03,SAM,heist,Pit Stop,229,289,518
3260,2023-02-03,SAM,gemGrab,Undermine,19,30,49
3261,2023-02-03,SAM,gemGrab,Double Swoosh,129,106,235
3262,2023-02-03,SAM,gemGrab,Deep Diner,67,90,157
3263,2023-02-03,SAM,brawlBall,Sneaky Fields,830,934,1764
3264,2023-02-03,SAM,brawlBall,Pinhole Punt,19,31,50
3265,2023-02-03,SAM,bounty,Dry Season,25,18,43
3266,2023-02-02,SAM,knockout,Out in the Open,17,19,36
3267,2023-02-02,SAM,hotZone,Split,49,101,150
3268,2023-02-02,SAM,heist,Kaboom Canyon,6,7,13
3269,2023-02-02,SAM,gemGrab,Undermine,25,17,42
3270,2023-02-02,SAM,gemGrab,Gem Fort,4,3,7
3271,2023-02-02,SAM,brawlBall,Sunny Soccer,7,11,18
3272,2023-02-02,SAM,brawlBall,Pinhole Punt,155,165,320
3273,2023-02-02,SAM,bounty,Shooting Star,3,1,4
3274,2023-02-01,SAM,knockout,Goldarm Gulch,72,76,148
3275,2023-02-01,SAM,hotZone,Parallel Plays,178,279,457
3276,2023-02-01,SAM,heist,Kaboom Canyon,23,27,50
3277,2023-02-01,SAM,gemGrab,Gem Fort,58,71,129
3278,2023-02-01,SAM,gemGrab,Crystal Arcade,33,51,84
3279,2023-02-01,SAM,brawlBall,Sunny Soccer,543,672,1215
3280,2023-02-01,SAM,brawlBall,Beach Ball,20,32,52
3281,2023-02-01,SAM,bounty,Shooting Star,7,5,12
3282,2023-01-31,SAM,knockout,Goldarm Gulch,44,34,78
3283,2023-01-31,SAM,hotZone,Parallel Plays,75,136,211
3284,2023-01-31,SAM,heist,Pit Stop,52,63,115
3285,2023-01-31,SAM,gemGrab,Minecart Madness,7,3,10
3286,2023-01-31,SAM,gemGrab,Crystal Arcade,33,21,54
3287,2023-01-31,SAM,brawlBall,Center Stage,8,4,12
3288,2023-01-31,SAM,brawlBall,Beach Ball,182,226,408
3289,2023-01-31,SAM,bounty,Hideout,2,1,3
3290,2023-01-30,SAM,knockout,Belle's Rock,85,79,164
3291,2023-01-30,SAM,hotZone,Quarter Pounder,108,138,246
3292,2023-01-30,SAM,heist,Pit Stop,144,146,290
3293,2023-01-30,SAM,gemGrab,Minecart Madness,28,30,58
3294,2023-01-30,SAM,gemGrab,Double Swoosh,32,31,63
3295,2023-01-30,SAM,brawlBall,Center Stage,411,616,1027
3296,2023-01-30,SAM,brawlBall,Backyard Bowl,33,44,77
3297,2023-01-30,SAM,bounty,Hideout,7,5,12
3298,2023-01-29,SAM,knockout,Belle's Rock,86,90,176
3299,2023-01-29,SAM,hotZone,Quarter Pounder,92,143,235
3300,2023-01-29,SAM,heist,Bridge Too Far,199,319,518
3301,2023-01-29,SAM,gemGrab,Hard Rock Mine,25,34,59
3302,2023-01-29,SAM,gemGrab,Double Swoosh,61,75,136
3303,2023-01-29,SAM,brawlBall,Super Beach,10,16,26
3304,2023-01-29,SAM,brawlBall,Backyard Bowl,293,440,733
3305,2023-01-29,SAM,bounty,Canal Grande,25,29,54
3306,2023-01-28,SAM,knockout,Flaring Phoenix,45,33,78
3307,2023-01-28,SAM,hotZone,Controller Chaos,72,142,214
3308,2023-01-28,SAM,heist,Bridge Too Far,303,423,726
3309,2023-01-28,SAM,gemGrab,Hard Rock Mine,99,152,251
3310,2023-01-28,SAM,gemGrab,Deep Diner,27,19,46
3311,2023-01-28,SAM,brawlBall,Super Beach,637,824,1461
3312,2023-01-28,SAM,brawlBall,Sneaky Fields,28,37,65
3313,2023-01-28,SAM,bounty,Canal Grande,28,26,54
3314,2023-01-27,SAM,knockout,Flaring Phoenix,15,29,44
3315,2023-01-27,SAM,hotZone,Controller Chaos,21,39,60
3316,2023-01-27,SAM,heist,Hot Potato,47,82,129
3317,2023-01-27,SAM,gemGrab,Undermine,5,6,11
3318,2023-01-27,SAM,gemGrab,Deep Diner,34,51,85
3319,2023-01-27,SAM,brawlBall,Sneaky Fields,203,210,413
3320,2023-01-27,SAM,brawlBall,Pinhole Punt,6,8,14
3321,2023-01-27,SAM,bounty,Temple Ruins,9,9,18
3322,2023-01-26,SAM,knockout,Riverside,29,23,52
3323,2023-01-26,SAM,hotZone,Open Zone,30,24,54
3324,2023-01-26,SAM,heist,Hot Potato,115,132,247
3325,2023-01-26,SAM,gemGrab,Undermine,66,62,128
3326,2023-01-26,SAM,gemGrab,Gem Fort,33,41,74
3327,2023-01-26,SAM,brawlBall,Sunny Soccer,33,41,74
3328,2023-01-26,SAM,brawlBall,Pinhole Punt,476,608,1084
3329,2023-01-26,SAM,bounty,Temple Ruins,23,22,45
3330,2023-01-25,SAM,knockout,Riverside,6,8,14
3331,2023-01-25,SAM,hotZone,Open Zone,7,1,8
3332,2023-01-25,SAM,heist,Safe Zone,41,53,94
3333,2023-01-25,SAM,gemGrab,Gem Fort,44,38,82
3334,2023-01-25,SAM,gemGrab,Crystal Arcade,30,23,53
3335,2023-01-25,SAM,brawlBall,Sunny Soccer,379,467,846
3336,2023-01-25,SAM,brawlBall,Beach Ball,70,77,147
3337,2023-01-25,SAM,bounty,Excel,11,13,24
3338,2023-01-24,SAM,knockout,New Perspective,37,29,66
3339,2023-01-24,SAM,hotZone,Dueling Beetles,80,107,187
3340,2023-01-24,SAM,heist,Safe Zone,52,110,162
3341,2023-01-24,SAM,gemGrab,Minecart Madness,15,23,38
3342,2023-01-24,SAM,gemGrab,Crystal Arcade,76,98,174
3343,2023-01-24,SAM,brawlBall,Center Stage,75,82,157
3344,2023-01-24,SAM,brawlBall,Beach Ball,466,620,1086
3345,2023-01-24,SAM,bounty,Excel,41,77,118
3346,2023-01-23,SAM,knockout,New Perspective,47,61,108
3347,2023-01-23,SAM,hotZone,Dueling Beetles,93,119,212
3348,2023-01-23,SAM,heist,Snaked Assault,122,96,218
3349,2023-01-23,SAM,gemGrab,Minecart Madness,70,80,150
3350,2023-01-23,SAM,gemGrab,Double Swoosh,16,28,44
3351,2023-01-23,SAM,brawlBall,Center Stage,638,811,1449
3352,2023-01-23,SAM,brawlBall,Backyard Bowl,15,21,36
3353,2023-01-23,SAM,bounty,Layer Cake,19,30,49
3354,2023-01-22,SAM,knockout,X Marks the Spot,18,21,39
3355,2023-01-22,SAM,hotZone,Ring of Fire,38,37,75
3356,2023-01-22,SAM,heist,Snaked Assault,43,48,91
3357,2023-01-22,SAM,gemGrab,Hard Rock Mine,25,33,58
3358,2023-01-22,SAM,gemGrab,Double Swoosh,48,53,101
3359,2023-01-22,SAM,brawlBall,Super Beach,58,97,155
3360,2023-01-22,SAM,brawlBall,Backyard Bowl,131,208,339
3361,2023-01-22,SAM,bounty,Layer Cake,11,9,20
3362,2023-01-21,SAM,knockout,X Marks the Spot,82,68,150
3363,2023-01-21,SAM,hotZone,Ring of Fire,73,75,148
3364,2023-01-21,SAM,heist,Tornado Ring,108,100,208
3365,2023-01-21,SAM,gemGrab,Hard Rock Mine,109,202,311
3366,2023-01-21,SAM,gemGrab,Deep Diner,21,34,55
3367,2023-01-21,SAM,brawlBall,Super Beach,715,971,1686
3368,2023-01-21,SAM,brawlBall,Sneaky Fields,52,64,116
3369,2023-01-21,SAM,bounty,Dry Season,14,19,33
3370,2023-01-20,SAM,knockout,Out in the Open,41,59,100
3371,2023-01-20,SAM,hotZone,Split,78,119,197
3372,2023-01-20,SAM,heist,Tornado Ring,68,84,152
3373,2023-01-20,SAM,gemGrab,Undermine,43,53,96
3374,2023-01-20,SAM,gemGrab,Deep Diner,84,92,176
3375,2023-01-20,SAM,brawlBall,Sneaky Fields,600,710,1310
3376,2023-01-20,SAM,brawlBall,Pinhole Punt,22,24,46
3377,2023-01-20,SAM,bounty,Dry Season,17,14,31
3378,2023-01-19,SAM,knockout,Out in the Open,46,49,95
3379,2023-01-19,SAM,hotZone,Split,194,289,483
3380,2023-01-19,SAM,heist,Kaboom Canyon,30,32,62
3381,2023-01-19,SAM,gemGrab,Undermine,54,68,122
3382,2023-01-19,SAM,gemGrab,Gem Fort,24,21,45
3383,2023-01-19,SAM,brawlBall,Sunny Soccer,23,16,39
3384,2023-01-19,SAM,brawlBall,Pinhole Punt,426,604,1030
3385,2023-01-19,SAM,bounty,Shooting Star,3,9,12
3386,2023-01-18,SAM,knockout,Goldarm Gulch,7,7,14
3387,2023-01-18,SAM,hotZone,Parallel Plays,21,16,37
3388,2023-01-18,SAM,heist,Kaboom Canyon,9,5,14
3389,2023-01-18,SAM,gemGrab,Gem Fort,12,8,20
3390,2023-01-18,SAM,gemGrab,Crystal Arcade,9,11,20
3391,2023-01-18,SAM,brawlBall,Sunny Soccer,160,205,365
3392,2023-01-18,SAM,brawlBall,Beach Ball,4,3,7
3393,2023-01-18,SAM,bounty,Shooting Star,1,3,4
3394,2023-01-17,SAM,knockout,Goldarm Gulch,19,12,31
3395,2023-01-17,SAM,hotZone,Parallel Plays,11,24,35
3396,2023-01-17,SAM,heist,Pit Stop,21,18,39
3397,2023-01-17,SAM,gemGrab,Minecart Madness,1,3,4
3398,2023-01-17,SAM,gemGrab,Crystal Arcade,7,5,12
3399,2023-01-17,SAM,brawlBall,Center Stage,0,2,2
3400,2023-01-17,SAM,brawlBall,Beach Ball,43,31,74
3401,2023-01-16,SAM,knockout,Belle's Rock,1,2,3
3402,2023-01-16,SAM,hotZone,Quarter Pounder,19,5,24
3403,2023-01-16,SAM,heist,Pit Stop,62,69,131
3404,2023-01-16,SAM,gemGrab,Minecart Madness,9,12,21
3405,2023-01-16,SAM,gemGrab,Double Swoosh,4,3,7
3406,2023-01-16,SAM,brawlBall,Center Stage,47,44,91
3407,2023-01-16,SAM,brawlBall,Backyard Bowl,5,1,6
3408,2023-01-16,SAM,bounty,Hideout,1,4,5
3409,2023-01-15,SAM,knockout,Belle's Rock,5,0,5
3410,2023-01-15,SAM,hotZone,Quarter Pounder,19,28,47
3411,2023-01-15,SAM,heist,Bridge Too Far,20,32,52
3412,2023-01-15,SAM,gemGrab,Hard Rock Mine,6,5,11
3413,2023-01-15,SAM,gemGrab,Double Swoosh,4,3,7
3414,2023-01-15,SAM,brawlBall,Super Beach,7,27,34
3415,2023-01-15,SAM,brawlBall,Backyard Bowl,18,24,42
3416,2023-01-15,SAM,bounty,Canal Grande,4,3,7
3417,2023-01-14,SAM,knockout,Flaring Phoenix,3,0,3
3418,2023-01-14,SAM,hotZone,Controller Chaos,23,12,35
3419,2023-01-14,SAM,heist,Bridge Too Far,25,17,42
3420,2023-01-14,SAM,gemGrab,Hard Rock Mine,4,2,6
3421,2023-01-14,SAM,gemGrab,Deep Diner,2,4,6
3422,2023-01-14,SAM,brawlBall,Super Beach,52,55,107
3423,2023-01-14,SAM,brawlBall,Sneaky Fields,3,2,5
3424,2023-01-14,SAM,bounty,Canal Grande,2,1,3
3425,2023-01-13,SAM,knockout,Flaring Phoenix,4,6,10
3426,2023-01-13,SAM,hotZone,Controller Chaos,9,4,13
3427,2023-01-13,SAM,heist,Hot Potato,6,18,24
3428,2023-01-13,SAM,gemGrab,Deep Diner,10,7,17
3429,2023-01-13,SAM,brawlBall,Sneaky Fields,20,37,57
3430,2023-01-12,SAM,hotZone,Open Zone,4,3,7
3431,2023-01-12,SAM,heist,Hot Potato,1,1,2
3432,2023-01-12,SAM,gemGrab,Undermine,2,0,2
3433,2023-01-12,SAM,gemGrab,Gem Fort,1,0,1
3434,2023-01-12,SAM,brawlBall,Sunny Soccer,1,5,6
3435,2023-01-12,SAM,brawlBall,Pinhole Punt,6,13,19
3436,2023-01-11,SAM,knockout,Riverside,1,0,1
3437,2023-01-11,SAM,hotZone,Open Zone,1,1,2
3438,2023-01-11,SAM,gemGrab,Gem Fort,1,1,2
3439,2023-01-11,SAM,brawlBall,Sunny Soccer,9,19,28
3440,2023-01-11,SAM,brawlBall,Beach Ball,0,2,2
3441,2023-01-11,SAM,bounty,Excel,1,0,1
3442,2023-01-10,SAM,knockout,New Perspective,0,1,1
3443,2023-01-10,SAM,hotZone,Dueling Beetles,11,4,15
3444,2023-01-10,SAM,gemGrab,Minecart Madness,2,8,10
3445,2023-01-10,SAM,gemGrab,Crystal Arcade,2,3,5
3446,2023-01-10,SAM,brawlBall,Center Stage,4,0,4
3447,2023-01-10,SAM,brawlBall,Beach Ball,18,9,27
3448,2023-01-09,SAM,knockout,New Perspective,0,1,1
3449,2023-01-09,SAM,hotZone,Dueling Beetles,1,7,8
3450,2023-01-09,SAM,heist,Snaked Assault,12,21,33
3451,2023-01-09,SAM,gemGrab,Minecart Madness,5,0,5
3452,2023-01-09,SAM,gemGrab,Double Swoosh,5,0,5
3453,2023-01-09,SAM,brawlBall,Center Stage,23,40,63
3454,2023-01-09,SAM,bounty,Layer Cake,1,3,4
3455,2023-01-08,SAM,knockout,X Marks the Spot,3,0,3
3456,2023-01-08,SAM,hotZone,Ring of Fire,2,5,7
3457,2023-01-08,SAM,heist,Snaked Assault,4,1,5
3458,2023-01-08,SAM,gemGrab,Hard Rock Mine,3,2,5
3459,2023-01-08,SAM,gemGrab,Double Swoosh,1,0,1
3460,2023-01-08,SAM,brawlBall,Backyard Bowl,14,5,19
3461,2023-01-07,SAM,hotZone,Ring of Fire,3,2,5
3462,2023-01-07,SAM,heist,Tornado Ring,7,1,8
3463,2023-01-07,SAM,gemGrab,Hard Rock Mine,0,4,4
3464,2023-01-07,SAM,gemGrab,Deep Diner,3,0,3
3465,2023-01-07,SAM,brawlBall,Super Beach,6,3,9
3466,2023-01-07,SAM,brawlBall,Sneaky Fields,5,0,5
3467,2023-01-07,SAM,bounty,Dry Season,0,1,1
3468,2023-01-06,SAM,hotZone,Split,8,14,22
3469,2023-01-06,SAM,heist,Tornado Ring,5,1,6
3470,2023-01-06,SAM,gemGrab,Deep Diner,3,2,5
3471,2023-01-06,SAM,brawlBall,Sneaky Fields,28,63,91
3472,2023-01-06,SAM,brawlBall,Pinhole Punt,1,0,1
3473,2023-01-06,SAM,bounty,Dry Season,2,7,9
3474,2023-01-05,SAM,knockout,Out in the Open,2,0,2
3475,2023-01-05,SAM,hotZone,Split,14,2,16
3476,2023-01-05,SAM,heist,Kaboom Canyon,9,0,9
3477,2023-01-05,SAM,gemGrab,Undermine,5,11,16
3478,2023-01-05,SAM,brawlBall,Sunny Soccer,1,0,1
3479,2023-01-05,SAM,brawlBall,Pinhole Punt,22,11,33
3480,2023-01-04,SAM,hotZone,Parallel Plays,2,1,3
3481,2023-01-04,SAM,heist,Kaboom Canyon,8,2,10
3482,2023-01-04,SAM,gemGrab,Gem Fort,7,2,9
3483,2023-01-04,SAM,gemGrab,Crystal Arcade,2,1,3
3484,2023-01-04,SAM,brawlBall,Sunny Soccer,34,31,65
3485,2023-01-04,SAM,bounty,Shooting Star,4,11,15
3486,2023-01-03,SAM,knockout,Goldarm Gulch,3,1,4
3487,2023-01-03,SAM,hotZone,Parallel Plays,5,13,18
3488,2023-01-03,SAM,heist,Pit Stop,24,46,70
3489,2023-01-03,SAM,gemGrab,Minecart Madness,1,0,1
3490,2023-01-03,SAM,gemGrab,Crystal Arcade,5,0,5
3491,2023-01-03,SAM,brawlBall,Center Stage,1,0,1
3492,2023-01-03,SAM,brawlBall,Beach Ball,18,35,53
3493,2023-01-03,SAM,bounty,Hideout,2,4,6
3494,2023-01-02,SAM,knockout,Belle's Rock,2,1,3
3495,2023-01-02,SAM,hotZone,Quarter Pounder,8,24,32
3496,2023-01-02,SAM,heist,Pit Stop,23,33,56
3497,2023-01-02,SAM,gemGrab,Minecart Madness,8,1,9
3498,2023-01-02,SAM,brawlBall,Center Stage,27,51,78
3499,2023-01-02,SAM,brawlBall,Backyard Bowl,1,2,3
3500,2023-01-02,SAM,bounty,Hideout,1,2,3
3501,2023-01-01,SAM,knockout,Belle's Rock,1,0,1
3502,2023-01-01,SAM,hotZone,Quarter Pounder,1,0,1
3503,2023-01-01,SAM,heist,Bridge Too Far,5,3,8
3504,2023-01-01,SAM,gemGrab,Double Swoosh,3,0,3
3505,2023-01-01,SAM,brawlBall,Backyard Bowl,1,3,4
3506,2023-01-01,SAM,bounty,Canal Grande,0,2,2
3507,2022-12-31,SAM,hotZone,Controller Chaos,3,2,5
3508,2022-12-31,SAM,heist,Bridge Too Far,2,3,5
3509,2022-12-31,SAM,gemGrab,Hard Rock Mine,1,0,1
3510,2022-12-31,SAM,brawlBall,Super Beach,6,6,12
3511,2022-12-31,SAM,brawlBall,Sneaky Fields,1,0,1
3512,2022-12-30,SAM,hotZone,Controller Chaos,1,0,1
3513,2022-12-30,SAM,gemGrab,Deep Diner,2,6,8
3514,2022-12-30,SAM,brawlBall,Sneaky Fields,2,3,5
3515,2022-12-29,SAM,gemGrab,Undermine,1,0,1
3516,2022-12-29,SAM,brawlBall,Pinhole Punt,1,1,2
3517,2022-12-28,SAM,gemGrab,Crystal Arcade,2,0,2
3518,2022-12-28,SAM,brawlBall,Beach Ball,4,0,4
3519,2022-12-27,SAM,brawlBall,Center Stage,0,1,1
3520,2022-12-26,SAM,brawlBall,Center Stage,1,0,1
3521,2022-12-23,SAM,knockout,Out in the Open,0,2,2
3522,2022-12-21,SAM,brawlBall,Sunny Soccer,1,0,1
3523,2022-12-20,SAM,brawlBall,Beach Ball,1,1,2
3524,2022-12-19,SAM,gemGrab,Minecart Madness,2,2,4
3525,2022-12-18,SAM,heist,Bridge Too Far,0,1,1
3526,2022-12-16,SAM,brawlBall,Sneaky Fields,0,2,2
3527,2022-12-13,SAM,brawlBall,Beach Ball,1,0,1
3528,2022-12-12,SAM,brawlBall,Center Stage,0,2,2
3529,2022-11-07,SAM,hotZone,Quarter Pounder,0,2,2
3530,2022-10-28,SAM,brawlBall,Beach Ball,0,2,2
3531,2022-10-15,SAM,brawlBall,Super Beach,0,1,1
3532,2022-10-10,SAM,knockout,Belle's Rock,0,1,1
3533,2023-02-11,RUFFS,knockout,Flaring Phoenix,20,35,55
3534,2023-02-11,RUFFS,hotZone,Controller Chaos,18,30,48
3535,2023-02-11,RUFFS,gemGrab,Deep Diner,55,92,147
3536,2023-02-11,RUFFS,brawlBall,Super Beach,34,29,63
3537,2023-02-11,RUFFS,brawlBall,Sneaky Fields,20,15,35
3538,2023-02-10,RUFFS,knockout,Flaring Phoenix,47,44,91
3539,2023-02-10,RUFFS,hotZone,Controller Chaos,23,9,32
3540,2023-02-10,RUFFS,heist,Hot Potato,20,14,34
3541,2023-02-10,RUFFS,gemGrab,Undermine,4,0,4
3542,2023-02-10,RUFFS,gemGrab,Deep Diner,195,310,505
3543,2023-02-10,RUFFS,brawlBall,Sneaky Fields,161,150,311
3544,2023-02-10,RUFFS,bounty,Temple Ruins,10,26,36
3545,2023-02-09,RUFFS,knockout,Riverside,4,1,5
3546,2023-02-09,RUFFS,hotZone,Open Zone,1,0,1
3547,2023-02-09,RUFFS,heist,Hot Potato,14,29,43
3548,2023-02-09,RUFFS,gemGrab,Undermine,12,13,25
3549,2023-02-09,RUFFS,gemGrab,Gem Fort,6,5,11
3550,2023-02-09,RUFFS,brawlBall,Sunny Soccer,0,1,1
3551,2023-02-09,RUFFS,brawlBall,Pinhole Punt,65,67,132
3552,2023-02-09,RUFFS,bounty,Temple Ruins,20,23,43
3553,2023-02-08,RUFFS,knockout,Riverside,1,1,2
3554,2023-02-08,RUFFS,hotZone,Open Zone,2,0,2
3555,2023-02-08,RUFFS,heist,Safe Zone,2,9,11
3556,2023-02-08,RUFFS,gemGrab,Gem Fort,5,7,12
3557,2023-02-08,RUFFS,gemGrab,Crystal Arcade,4,7,11
3558,2023-02-08,RUFFS,brawlBall,Sunny Soccer,14,22,36
3559,2023-02-08,RUFFS,brawlBall,Beach Ball,2,1,3
3560,2023-02-08,RUFFS,bounty,Excel,5,9,14
3561,2023-02-07,RUFFS,knockout,New Perspective,3,3,6
3562,2023-02-07,RUFFS,hotZone,Dueling Beetles,9,16,25
3563,2023-02-07,RUFFS,heist,Safe Zone,0,1,1
3564,2023-02-07,RUFFS,gemGrab,Minecart Madness,1,10,11
3565,2023-02-07,RUFFS,gemGrab,Crystal Arcade,0,7,7
3566,2023-02-07,RUFFS,brawlBall,Beach Ball,19,26,45
3567,2023-02-07,RUFFS,bounty,Excel,1,0,1
3568,2023-02-06,RUFFS,knockout,New Perspective,72,90,162
3569,2023-02-06,RUFFS,hotZone,Dueling Beetles,43,50,93
3570,2023-02-06,RUFFS,heist,Snaked Assault,11,4,15
3571,2023-02-06,RUFFS,heist,Pit Stop,4,4,8
3572,2023-02-06,RUFFS,gemGrab,Minecart Madness,74,86,160
3573,2023-02-06,RUFFS,gemGrab,Double Swoosh,25,25,50
3574,2023-02-06,RUFFS,brawlBall,Sneaky Fields,1,0,1
3575,2023-02-06,RUFFS,brawlBall,Center Stage,327,352,679
3576,2023-02-06,RUFFS,brawlBall,Backyard Bowl,14,28,42
3577,2023-02-06,RUFFS,bounty,Layer Cake,8,16,24
3578,2023-02-05,RUFFS,knockout,X Marks the Spot,20,15,35
3579,2023-02-05,RUFFS,knockout,Goldarm Gulch,8,6,14
3580,2023-02-05,RUFFS,hotZone,Ring of Fire,33,53,86
3581,2023-02-05,RUFFS,heist,Snaked Assault,14,21,35
3582,2023-02-05,RUFFS,heist,Pit Stop,11,21,32
3583,2023-02-05,RUFFS,gemGrab,Hard Rock Mine,42,72,114
3584,2023-02-05,RUFFS,gemGrab,Double Swoosh,47,45,92
3585,2023-02-05,RUFFS,brawlBall,Super Beach,1,8,9
3586,2023-02-05,RUFFS,brawlBall,Sneaky Fields,3,4,7
3587,2023-02-05,RUFFS,brawlBall,Backyard Bowl,274,285,559
3588,2023-02-05,RUFFS,bounty,Layer Cake,33,47,80
3589,2023-02-04,RUFFS,knockout,X Marks the Spot,19,19,38
3590,2023-02-04,RUFFS,knockout,Goldarm Gulch,8,9,17
3591,2023-02-04,RUFFS,hotZone,Ring of Fire,8,6,14
3592,2023-02-04,RUFFS,heist,Tornado Ring,3,2,5
3593,2023-02-04,RUFFS,heist,Pit Stop,8,12,20
3594,2023-02-04,RUFFS,gemGrab,Hard Rock Mine,65,103,168
3595,2023-02-04,RUFFS,gemGrab,Double Swoosh,5,6,11
3596,2023-02-04,RUFFS,gemGrab,Deep Diner,29,32,61
3597,2023-02-04,RUFFS,brawlBall,Super Beach,75,129,204
3598,2023-02-04,RUFFS,brawlBall,Sneaky Fields,5,7,12
3599,2023-02-04,RUFFS,bounty,Dry Season,9,3,12
3600,2023-02-03,RUFFS,knockout,Out in the Open,36,31,67
3601,2023-02-03,RUFFS,knockout,Goldarm Gulch,25,17,42
3602,2023-02-03,RUFFS,hotZone,Split,76,98,174
3603,2023-02-03,RUFFS,heist,Tornado Ring,10,16,26
3604,2023-02-03,RUFFS,heist,Pit Stop,47,61,108
3605,2023-02-03,RUFFS,gemGrab,Undermine,12,17,29
3606,2023-02-03,RUFFS,gemGrab,Double Swoosh,14,21,35
3607,2023-02-03,RUFFS,gemGrab,Deep Diner,124,217,341
3608,2023-02-03,RUFFS,brawlBall,Sneaky Fields,226,258,484
3609,2023-02-03,RUFFS,brawlBall,Pinhole Punt,7,11,18
3610,2023-02-03,RUFFS,bounty,Dry Season,82,99,181
3611,2023-02-02,RUFFS,knockout,Out in the Open,26,22,48
3612,2023-02-02,RUFFS,hotZone,Split,45,67,112
3613,2023-02-02,RUFFS,heist,Kaboom Canyon,5,5,10
3614,2023-02-02,RUFFS,gemGrab,Undermine,14,12,26
3615,2023-02-02,RUFFS,gemGrab,Gem Fort,9,5,14
3616,2023-02-02,RUFFS,brawlBall,Sunny Soccer,3,2,5
3617,2023-02-02,RUFFS,brawlBall,Pinhole Punt,73,107,180
3618,2023-02-02,RUFFS,bounty,Shooting Star,2,1,3
3619,2023-02-01,RUFFS,knockout,Goldarm Gulch,45,48,93
3620,2023-02-01,RUFFS,hotZone,Parallel Plays,21,38,59
3621,2023-02-01,RUFFS,heist,Kaboom Canyon,2,2,4
3622,2023-02-01,RUFFS,gemGrab,Gem Fort,45,57,102
3623,2023-02-01,RUFFS,gemGrab,Crystal Arcade,69,110,179
3624,2023-02-01,RUFFS,brawlBall,Sunny Soccer,139,222,361
3625,2023-02-01,RUFFS,brawlBall,Beach Ball,6,4,10
3626,2023-02-01,RUFFS,bounty,Shooting Star,4,2,6
3627,2023-01-31,RUFFS,knockout,Goldarm Gulch,29,25,54
3628,2023-01-31,RUFFS,hotZone,Parallel Plays,14,16,30
3629,2023-01-31,RUFFS,heist,Pit Stop,5,10,15
3630,2023-01-31,RUFFS,gemGrab,Minecart Madness,3,5,8
3631,2023-01-31,RUFFS,gemGrab,Crystal Arcade,49,66,115
3632,2023-01-31,RUFFS,brawlBall,Center Stage,3,3,6
3633,2023-01-31,RUFFS,brawlBall,Beach Ball,94,147,241
3634,2023-01-31,RUFFS,bounty,Hideout,8,6,14
3635,2023-01-30,RUFFS,knockout,Belle's Rock,31,43,74
3636,2023-01-30,RUFFS,hotZone,Quarter Pounder,58,115,173
3637,2023-01-30,RUFFS,heist,Pit Stop,17,17,34
3638,2023-01-30,RUFFS,gemGrab,Minecart Madness,40,67,107
3639,2023-01-30,RUFFS,gemGrab,Double Swoosh,30,33,63
3640,2023-01-30,RUFFS,brawlBall,Center Stage,149,157,306
3641,2023-01-30,RUFFS,brawlBall,Backyard Bowl,11,17,28
3642,2023-01-30,RUFFS,bounty,Hideout,4,2,6
3643,2023-01-29,RUFFS,knockout,Belle's Rock,51,72,123
3644,2023-01-29,RUFFS,hotZone,Quarter Pounder,93,215,308
3645,2023-01-29,RUFFS,heist,Bridge Too Far,9,1,10
3646,2023-01-29,RUFFS,gemGrab,Hard Rock Mine,27,38,65
3647,2023-01-29,RUFFS,gemGrab,Double Swoosh,28,22,50
3648,2023-01-29,RUFFS,brawlBall,Super Beach,1,2,3
3649,2023-01-29,RUFFS,brawlBall,Backyard Bowl,161,204,365
3650,2023-01-29,RUFFS,bounty,Canal Grande,10,20,30
3651,2023-01-28,RUFFS,knockout,Flaring Phoenix,28,26,54
3652,2023-01-28,RUFFS,hotZone,Controller Chaos,18,28,46
3653,2023-01-28,RUFFS,heist,Bridge Too Far,16,6,22
3654,2023-01-28,RUFFS,gemGrab,Hard Rock Mine,179,298,477
3655,2023-01-28,RUFFS,gemGrab,Deep Diner,66,100,166
3656,2023-01-28,RUFFS,brawlBall,Super Beach,213,245,458
3657,2023-01-28,RUFFS,brawlBall,Sneaky Fields,11,15,26
3658,2023-01-28,RUFFS,bounty,Canal Grande,21,37,58
3659,2023-01-27,RUFFS,knockout,Flaring Phoenix,19,26,45
3660,2023-01-27,RUFFS,hotZone,Controller Chaos,6,4,10
3661,2023-01-27,RUFFS,heist,Hot Potato,9,7,16
3662,2023-01-27,RUFFS,gemGrab,Undermine,5,1,6
3663,2023-01-27,RUFFS,gemGrab,Deep Diner,66,98,164
3664,2023-01-27,RUFFS,brawlBall,Sneaky Fields,64,66,130
3665,2023-01-27,RUFFS,brawlBall,Pinhole Punt,3,1,4
3666,2023-01-27,RUFFS,bounty,Temple Ruins,3,4,7
3667,2023-01-26,RUFFS,knockout,Riverside,18,33,51
3668,2023-01-26,RUFFS,hotZone,Open Zone,7,9,16
3669,2023-01-26,RUFFS,heist,Hot Potato,30,27,57
3670,2023-01-26,RUFFS,gemGrab,Undermine,12,19,31
3671,2023-01-26,RUFFS,gemGrab,Gem Fort,19,24,43
3672,2023-01-26,RUFFS,brawlBall,Sunny Soccer,5,10,15
3673,2023-01-26,RUFFS,brawlBall,Pinhole Punt,220,286,506
3674,2023-01-26,RUFFS,bounty,Temple Ruins,12,8,20
3675,2023-01-25,RUFFS,knockout,Riverside,7,8,15
3676,2023-01-25,RUFFS,hotZone,Open Zone,12,6,18
3677,2023-01-25,RUFFS,heist,Safe Zone,18,21,39
3678,2023-01-25,RUFFS,gemGrab,Gem Fort,16,14,30
3679,2023-01-25,RUFFS,gemGrab,Crystal Arcade,47,68,115
3680,2023-01-25,RUFFS,brawlBall,Sunny Soccer,137,140,277
3681,2023-01-25,RUFFS,brawlBall,Beach Ball,23,22,45
3682,2023-01-25,RUFFS,bounty,Excel,19,26,45
3683,2023-01-24,RUFFS,knockout,New Perspective,47,32,79
3684,2023-01-24,RUFFS,hotZone,Dueling Beetles,33,14,47
3685,2023-01-24,RUFFS,heist,Safe Zone,24,41,65
3686,2023-01-24,RUFFS,gemGrab,Minecart Madness,10,6,16
3687,2023-01-24,RUFFS,gemGrab,Crystal Arcade,76,85,161
3688,2023-01-24,RUFFS,brawlBall,Center Stage,19,30,49
3689,2023-01-24,RUFFS,brawlBall,Beach Ball,189,301,490
3690,2023-01-24,RUFFS,bounty,Excel,23,35,58
3691,2023-01-23,RUFFS,knockout,New Perspective,45,53,98
3692,2023-01-23,RUFFS,hotZone,Dueling Beetles,34,27,61
3693,2023-01-23,RUFFS,heist,Snaked Assault,6,3,9
3694,2023-01-23,RUFFS,gemGrab,Minecart Madness,44,81,125
3695,2023-01-23,RUFFS,gemGrab,Double Swoosh,12,14,26
3696,2023-01-23,RUFFS,brawlBall,Center Stage,261,331,592
3697,2023-01-23,RUFFS,brawlBall,Backyard Bowl,15,10,25
3698,2023-01-23,RUFFS,bounty,Layer Cake,18,11,29
3699,2023-01-22,RUFFS,knockout,X Marks the Spot,5,7,12
3700,2023-01-22,RUFFS,hotZone,Ring of Fire,21,25,46
3701,2023-01-22,RUFFS,heist,Snaked Assault,6,4,10
3702,2023-01-22,RUFFS,gemGrab,Hard Rock Mine,42,90,132
3703,2023-01-22,RUFFS,gemGrab,Double Swoosh,18,21,39
3704,2023-01-22,RUFFS,brawlBall,Super Beach,13,23,36
3705,2023-01-22,RUFFS,brawlBall,Backyard Bowl,75,122,197
3706,2023-01-22,RUFFS,bounty,Layer Cake,14,34,48
3707,2023-01-21,RUFFS,knockout,X Marks the Spot,38,45,83
3708,2023-01-21,RUFFS,hotZone,Ring of Fire,86,111,197
3709,2023-01-21,RUFFS,heist,Tornado Ring,5,10,15
3710,2023-01-21,RUFFS,gemGrab,Hard Rock Mine,261,457,718
3711,2023-01-21,RUFFS,gemGrab,Deep Diner,20,45,65
3712,2023-01-21,RUFFS,brawlBall,Super Beach,233,261,494
3713,2023-01-21,RUFFS,brawlBall,Sneaky Fields,2,7,9
3714,2023-01-21,RUFFS,bounty,Dry Season,28,35,63
3715,2023-01-20,RUFFS,knockout,Out in the Open,59,66,125
3716,2023-01-20,RUFFS,hotZone,Split,73,125,198
3717,2023-01-20,RUFFS,heist,Tornado Ring,8,11,19
3718,2023-01-20,RUFFS,gemGrab,Undermine,6,13,19
3719,2023-01-20,RUFFS,gemGrab,Deep Diner,166,330,496
3720,2023-01-20,RUFFS,brawlBall,Sneaky Fields,162,212,374
3721,2023-01-20,RUFFS,brawlBall,Pinhole Punt,5,3,8
3722,2023-01-20,RUFFS,bounty,Dry Season,51,93,144
3723,2023-01-19,RUFFS,knockout,Out in the Open,51,53,104
3724,2023-01-19,RUFFS,hotZone,Split,93,184,277
3725,2023-01-19,RUFFS,heist,Kaboom Canyon,10,6,16
3726,2023-01-19,RUFFS,gemGrab,Undermine,19,29,48
3727,2023-01-19,RUFFS,gemGrab,Gem Fort,6,17,23
3728,2023-01-19,RUFFS,brawlBall,Sunny Soccer,6,7,13
3729,2023-01-19,RUFFS,brawlBall,Pinhole Punt,239,362,601
3730,2023-01-19,RUFFS,bounty,Shooting Star,10,12,22
3731,2023-01-18,RUFFS,knockout,Goldarm Gulch,10,11,21
3732,2023-01-18,RUFFS,hotZone,Parallel Plays,7,3,10
3733,2023-01-18,RUFFS,heist,Kaboom Canyon,1,0,1
3734,2023-01-18,RUFFS,gemGrab,Gem Fort,9,18,27
3735,2023-01-18,RUFFS,gemGrab,Crystal Arcade,5,6,11
3736,2023-01-18,RUFFS,brawlBall,Sunny Soccer,63,75,138
3737,2023-01-18,RUFFS,brawlBall,Beach Ball,1,4,5
3738,2023-01-18,RUFFS,bounty,Shooting Star,3,7,10
3739,2023-01-17,RUFFS,knockout,Goldarm Gulch,11,9,20
3740,2023-01-17,RUFFS,hotZone,Parallel Plays,14,7,21
3741,2023-01-17,RUFFS,heist,Pit Stop,2,3,5
3742,2023-01-17,RUFFS,gemGrab,Crystal Arcade,7,8,15
3743,2023-01-17,RUFFS,brawlBall,Center Stage,1,0,1
3744,2023-01-17,RUFFS,brawlBall,Beach Ball,18,22,40
3745,2023-01-17,RUFFS,bounty,Hideout,1,1,2
3746,2023-01-16,RUFFS,knockout,Belle's Rock,1,2,3
3747,2023-01-16,RUFFS,hotZone,Quarter Pounder,7,7,14
3748,2023-01-16,RUFFS,heist,Pit Stop,9,14,23
3749,2023-01-16,RUFFS,gemGrab,Minecart Madness,3,6,9
3750,2023-01-16,RUFFS,gemGrab,Double Swoosh,1,0,1
3751,2023-01-16,RUFFS,brawlBall,Center Stage,16,14,30
3752,2023-01-16,RUFFS,brawlBall,Backyard Bowl,0,1,1
3753,2023-01-16,RUFFS,bounty,Hideout,1,0,1
3754,2023-01-15,RUFFS,knockout,Belle's Rock,3,2,5
3755,2023-01-15,RUFFS,hotZone,Quarter Pounder,7,9,16
3756,2023-01-15,RUFFS,heist,Bridge Too Far,1,1,2
3757,2023-01-15,RUFFS,gemGrab,Hard Rock Mine,13,11,24
3758,2023-01-15,RUFFS,gemGrab,Double Swoosh,3,6,9
3759,2023-01-15,RUFFS,brawlBall,Super Beach,0,1,1
3760,2023-01-15,RUFFS,brawlBall,Backyard Bowl,16,22,38
3761,2023-01-15,RUFFS,bounty,Canal Grande,1,2,3
3762,2023-01-14,RUFFS,knockout,Flaring Phoenix,0,2,2
3763,2023-01-14,RUFFS,hotZone,Controller Chaos,3,4,7
3764,2023-01-14,RUFFS,heist,Bridge Too Far,1,0,1
3765,2023-01-14,RUFFS,gemGrab,Hard Rock Mine,18,43,61
3766,2023-01-14,RUFFS,gemGrab,Deep Diner,1,4,5
3767,2023-01-14,RUFFS,brawlBall,Super Beach,13,18,31
3768,2023-01-14,RUFFS,bounty,Canal Grande,1,2,3
3769,2023-01-13,RUFFS,knockout,Flaring Phoenix,5,6,11
3770,2023-01-13,RUFFS,hotZone,Controller Chaos,8,8,16
3771,2023-01-13,RUFFS,heist,Hot Potato,1,0,1
3772,2023-01-13,RUFFS,gemGrab,Deep Diner,4,21,25
3773,2023-01-13,RUFFS,brawlBall,Sneaky Fields,8,9,17
3774,2023-01-12,RUFFS,knockout,Riverside,1,0,1
3775,2023-01-12,RUFFS,gemGrab,Undermine,4,2,6
3776,2023-01-12,RUFFS,gemGrab,Gem Fort,1,0,1
3777,2023-01-12,RUFFS,brawlBall,Pinhole Punt,3,19,22
3778,2023-01-11,RUFFS,hotZone,Open Zone,1,0,1
3779,2023-01-11,RUFFS,gemGrab,Gem Fort,1,1,2
3780,2023-01-11,RUFFS,brawlBall,Sunny Soccer,13,20,33
3781,2023-01-11,RUFFS,bounty,Excel,1,2,3
3782,2023-01-10,RUFFS,knockout,New Perspective,2,9,11
3783,2023-01-10,RUFFS,hotZone,Dueling Beetles,5,6,11
3784,2023-01-10,RUFFS,heist,Safe Zone,9,19,28
3785,2023-01-10,RUFFS,gemGrab,Minecart Madness,2,6,8
3786,2023-01-10,RUFFS,gemGrab,Crystal Arcade,1,0,1
3787,2023-01-10,RUFFS,brawlBall,Center Stage,2,0,2
3788,2023-01-10,RUFFS,brawlBall,Beach Ball,16,59,75
3789,2023-01-10,RUFFS,bounty,Excel,3,0,3
3790,2023-01-09,RUFFS,knockout,New Perspective,1,0,1
3791,2023-01-09,RUFFS,hotZone,Dueling Beetles,2,4,6
3792,2023-01-09,RUFFS,heist,Snaked Assault,1,1,2
3793,2023-01-09,RUFFS,gemGrab,Minecart Madness,6,6,12
3794,2023-01-09,RUFFS,gemGrab,Double Swoosh,2,0,2
3795,2023-01-09,RUFFS,brawlBall,Center Stage,7,16,23
3796,2023-01-09,RUFFS,bounty,Layer Cake,0,3,3
3797,2023-01-08,RUFFS,knockout,X Marks the Spot,3,2,5
3798,2023-01-08,RUFFS,hotZone,Ring of Fire,5,18,23
3799,2023-01-08,RUFFS,gemGrab,Hard Rock Mine,7,14,21
3800,2023-01-08,RUFFS,brawlBall,Backyard Bowl,5,4,9
3801,2023-01-07,RUFFS,knockout,X Marks the Spot,2,5,7
3802,2023-01-07,RUFFS,hotZone,Ring of Fire,5,8,13
3803,2023-01-07,RUFFS,heist,Tornado Ring,1,0,1
3804,2023-01-07,RUFFS,gemGrab,Hard Rock Mine,6,23,29
3805,2023-01-07,RUFFS,gemGrab,Deep Diner,7,6,13
3806,2023-01-07,RUFFS,brawlBall,Super Beach,2,2,4
3807,2023-01-07,RUFFS,bounty,Dry Season,6,8,14
3808,2023-01-06,RUFFS,hotZone,Split,7,12,19
3809,2023-01-06,RUFFS,heist,Tornado Ring,2,1,3
3810,2023-01-06,RUFFS,gemGrab,Deep Diner,20,15,35
3811,2023-01-06,RUFFS,brawlBall,Sneaky Fields,2,0,2
3812,2023-01-06,RUFFS,brawlBall,Pinhole Punt,1,0,1
3813,2023-01-06,RUFFS,bounty,Dry Season,8,13,21
3814,2023-01-05,RUFFS,knockout,Out in the Open,6,3,9
3815,2023-01-05,RUFFS,hotZone,Split,28,65,93
3816,2023-01-05,RUFFS,heist,Kaboom Canyon,1,3,4
3817,2023-01-05,RUFFS,gemGrab,Undermine,2,1,3
3818,2023-01-05,RUFFS,brawlBall,Sunny Soccer,1,0,1
3819,2023-01-05,RUFFS,brawlBall,Pinhole Punt,48,60,108
3820,2023-01-04,RUFFS,knockout,Goldarm Gulch,2,1,3
3821,2023-01-04,RUFFS,hotZone,Parallel Plays,1,2,3
3822,2023-01-04,RUFFS,gemGrab,Crystal Arcade,3,0,3
3823,2023-01-04,RUFFS,brawlBall,Sunny Soccer,27,34,61
3824,2023-01-03,RUFFS,knockout,Goldarm Gulch,6,2,8
3825,2023-01-03,RUFFS,hotZone,Parallel Plays,8,1,9
3826,2023-01-03,RUFFS,heist,Pit Stop,4,1,5
3827,2023-01-03,RUFFS,gemGrab,Crystal Arcade,8,18,26
3828,2023-01-03,RUFFS,brawlBall,Center Stage,3,0,3
3829,2023-01-03,RUFFS,brawlBall,Beach Ball,24,26,50
3830,2023-01-02,RUFFS,knockout,Belle's Rock,7,6,13
3831,2023-01-02,RUFFS,hotZone,Quarter Pounder,10,5,15
3832,2023-01-02,RUFFS,heist,Pit Stop,3,4,7
3833,2023-01-02,RUFFS,gemGrab,Minecart Madness,4,6,10
3834,2023-01-02,RUFFS,gemGrab,Double Swoosh,6,5,11
3835,2023-01-02,RUFFS,brawlBall,Center Stage,16,11,27
3836,2023-01-02,RUFFS,brawlBall,Backyard Bowl,2,0,2
3837,2023-01-02,RUFFS,bounty,Hideout,1,1,2
3838,2023-01-01,RUFFS,knockout,Belle's Rock,1,0,1
3839,2023-01-01,RUFFS,hotZone,Quarter Pounder,3,16,19
3840,2023-01-01,RUFFS,gemGrab,Hard Rock Mine,1,1,2
3841,2023-01-01,RUFFS,brawlBall,Backyard Bowl,5,5,10
3842,2022-12-31,RUFFS,gemGrab,Minecart Madness,0,1,1
3843,2022-12-31,RUFFS,gemGrab,Hard Rock Mine,2,3,5
3844,2022-12-31,RUFFS,brawlBall,Super Beach,1,0,1
3845,2022-12-31,RUFFS,brawlBall,Sneaky Fields,1,0,1
3846,2022-12-30,RUFFS,hotZone,Controller Chaos,1,0,1
3847,2022-12-30,RUFFS,gemGrab,Undermine,0,1,1
3848,2022-12-30,RUFFS,gemGrab,Deep Diner,1,0,1
3849,2022-12-30,RUFFS,brawlBall,Sneaky Fields,3,0,3
3850,2022-12-29,RUFFS,brawlBall,Pinhole Punt,1,0,1
3851,2022-12-25,RUFFS,brawlBall,Backyard Bowl,1,1,2
3852,2022-12-22,RUFFS,brawlBall,Pinhole Punt,0,2,2
3853,2022-12-19,RUFFS,gemGrab,Minecart Madness,2,4,6
3854,2022-12-19,RUFFS,brawlBall,Center Stage,2,1,3
3855,2022-11-01,RUFFS,knockout,New Perspective,2,0,2
3856,2022-10-30,RUFFS,knockout,Out in the Open,1,0,1
3857,2022-10-15,RUFFS,gemGrab,Hard Rock Mine,7,8,15
3858,2022-10-15,RUFFS,brawlBall,Super Beach,2,0,2
3859,2023-02-11,ROSA,knockout,Flaring Phoenix,6,4,10
3860,2023-02-11,ROSA,hotZone,Controller Chaos,25,25,50
3861,2023-02-11,ROSA,gemGrab,Deep Diner,7,4,11
3862,2023-02-11,ROSA,brawlBall,Super Beach,20,6,26
3863,2023-02-11,ROSA,brawlBall,Sneaky Fields,70,97,167
3864,2023-02-10,ROSA,knockout,Flaring Phoenix,16,12,28
3865,2023-02-10,ROSA,hotZone,Controller Chaos,56,65,121
3866,2023-02-10,ROSA,heist,Hot Potato,10,5,15
3867,2023-02-10,ROSA,gemGrab,Undermine,13,24,37
3868,2023-02-10,ROSA,gemGrab,Deep Diner,14,8,22
3869,2023-02-10,ROSA,brawlBall,Sneaky Fields,758,1052,1810
3870,2023-02-10,ROSA,brawlBall,Pinhole Punt,1,1,2
3871,2023-02-10,ROSA,bounty,Temple Ruins,8,4,12
3872,2023-02-09,ROSA,knockout,Riverside,1,1,2
3873,2023-02-09,ROSA,hotZone,Open Zone,3,0,3
3874,2023-02-09,ROSA,heist,Hot Potato,4,3,7
3875,2023-02-09,ROSA,gemGrab,Undermine,12,12,24
3876,2023-02-09,ROSA,gemGrab,Gem Fort,4,2,6
3877,2023-02-09,ROSA,brawlBall,Pinhole Punt,18,28,46
3878,2023-02-09,ROSA,bounty,Temple Ruins,5,13,18
3879,2023-02-08,ROSA,gemGrab,Gem Fort,13,14,27
3880,2023-02-08,ROSA,brawlBall,Sunny Soccer,6,3,9
3881,2023-02-08,ROSA,bounty,Excel,1,0,1
3882,2023-02-07,ROSA,hotZone,Dueling Beetles,6,27,33
3883,2023-02-07,ROSA,gemGrab,Crystal Arcade,3,1,4
3884,2023-02-07,ROSA,brawlBall,Center Stage,3,1,4
3885,2023-02-07,ROSA,brawlBall,Beach Ball,9,6,15
3886,2023-02-06,ROSA,knockout,New Perspective,14,15,29
3887,2023-02-06,ROSA,knockout,Goldarm Gulch,2,4,6
3888,2023-02-06,ROSA,hotZone,Dueling Beetles,60,86,146
3889,2023-02-06,ROSA,heist,Snaked Assault,26,30,56
3890,2023-02-06,ROSA,gemGrab,Minecart Madness,15,8,23
3891,2023-02-06,ROSA,gemGrab,Double Swoosh,132,135,267
3892,2023-02-06,ROSA,brawlBall,Sneaky Fields,64,51,115
3893,2023-02-06,ROSA,brawlBall,Center Stage,692,905,1597
3894,2023-02-06,ROSA,brawlBall,Backyard Bowl,3,1,4
3895,2023-02-06,ROSA,bounty,Layer Cake,11,7,18
3896,2023-02-05,ROSA,knockout,X Marks the Spot,15,17,32
3897,2023-02-05,ROSA,knockout,Goldarm Gulch,7,8,15
3898,2023-02-05,ROSA,hotZone,Ring of Fire,13,29,42
3899,2023-02-05,ROSA,heist,Snaked Assault,21,12,33
3900,2023-02-05,ROSA,heist,Pit Stop,2,2,4
3901,2023-02-05,ROSA,gemGrab,Hard Rock Mine,23,19,42
3902,2023-02-05,ROSA,gemGrab,Double Swoosh,435,393,828
3903,2023-02-05,ROSA,brawlBall,Super Beach,2,2,4
3904,2023-02-05,ROSA,brawlBall,Sneaky Fields,226,173,399
3905,2023-02-05,ROSA,brawlBall,Backyard Bowl,24,13,37
3906,2023-02-05,ROSA,bounty,Layer Cake,5,15,20
3907,2023-02-04,ROSA,knockout,X Marks the Spot,0,2,2
3908,2023-02-04,ROSA,knockout,Goldarm Gulch,2,1,3
3909,2023-02-04,ROSA,hotZone,Ring of Fire,7,4,11
3910,2023-02-04,ROSA,heist,Tornado Ring,2,0,2
3911,2023-02-04,ROSA,gemGrab,Hard Rock Mine,24,35,59
3912,2023-02-04,ROSA,gemGrab,Double Swoosh,91,79,170
3913,2023-02-04,ROSA,brawlBall,Super Beach,24,28,52
3914,2023-02-04,ROSA,brawlBall,Sneaky Fields,95,96,191
3915,2023-02-04,ROSA,bounty,Dry Season,2,0,2
3916,2023-02-03,ROSA,knockout,Out in the Open,3,6,9
3917,2023-02-03,ROSA,knockout,Goldarm Gulch,3,3,6
3918,2023-02-03,ROSA,hotZone,Split,24,23,47
3919,2023-02-03,ROSA,heist,Tornado Ring,18,8,26
3920,2023-02-03,ROSA,heist,Pit Stop,4,6,10
3921,2023-02-03,ROSA,gemGrab,Undermine,13,6,19
3922,2023-02-03,ROSA,gemGrab,Double Swoosh,562,398,960
3923,2023-02-03,ROSA,gemGrab,Deep Diner,13,6,19
3924,2023-02-03,ROSA,brawlBall,Sneaky Fields,1443,1724,3167
3925,2023-02-03,ROSA,brawlBall,Pinhole Punt,5,7,12
3926,2023-02-03,ROSA,bounty,Dry Season,5,2,7
3927,2023-02-02,ROSA,knockout,Out in the Open,4,1,5
3928,2023-02-02,ROSA,hotZone,Split,14,11,25
3929,2023-02-02,ROSA,heist,Kaboom Canyon,1,1,2
3930,2023-02-02,ROSA,gemGrab,Undermine,15,8,23
3931,2023-02-02,ROSA,gemGrab,Gem Fort,14,10,24
3932,2023-02-02,ROSA,brawlBall,Sunny Soccer,3,0,3
3933,2023-02-02,ROSA,brawlBall,Pinhole Punt,40,49,89
3934,2023-02-01,ROSA,knockout,Goldarm Gulch,9,9,18
3935,2023-02-01,ROSA,hotZone,Parallel Plays,35,31,66
3936,2023-02-01,ROSA,heist,Kaboom Canyon,3,0,3
3937,2023-02-01,ROSA,gemGrab,Gem Fort,153,204,357
3938,2023-02-01,ROSA,gemGrab,Crystal Arcade,20,27,47
3939,2023-02-01,ROSA,brawlBall,Sunny Soccer,80,69,149
3940,2023-02-01,ROSA,brawlBall,Beach Ball,1,0,1
3941,2023-01-31,ROSA,knockout,Goldarm Gulch,9,7,16
3942,2023-01-31,ROSA,hotZone,Parallel Plays,14,18,32
3943,2023-01-31,ROSA,heist,Pit Stop,1,5,6
3944,2023-01-31,ROSA,gemGrab,Crystal Arcade,25,21,46
3945,2023-01-31,ROSA,brawlBall,Center Stage,3,1,4
3946,2023-01-31,ROSA,brawlBall,Beach Ball,27,25,52
3947,2023-01-30,ROSA,knockout,Belle's Rock,6,8,14
3948,2023-01-30,ROSA,hotZone,Quarter Pounder,9,6,15
3949,2023-01-30,ROSA,heist,Pit Stop,2,3,5
3950,2023-01-30,ROSA,gemGrab,Minecart Madness,11,2,13
3951,2023-01-30,ROSA,gemGrab,Double Swoosh,85,65,150
3952,2023-01-30,ROSA,brawlBall,Center Stage,321,499,820
3953,2023-01-30,ROSA,brawlBall,Backyard Bowl,0,2,2
3954,2023-01-29,ROSA,knockout,Belle's Rock,1,1,2
3955,2023-01-29,ROSA,hotZone,Quarter Pounder,9,2,11
3956,2023-01-29,ROSA,heist,Bridge Too Far,2,2,4
3957,2023-01-29,ROSA,gemGrab,Hard Rock Mine,17,31,48
3958,2023-01-29,ROSA,gemGrab,Double Swoosh,173,229,402
3959,2023-01-29,ROSA,brawlBall,Super Beach,2,1,3
3960,2023-01-29,ROSA,brawlBall,Backyard Bowl,13,8,21
3961,2023-01-29,ROSA,bounty,Canal Grande,17,25,42
3962,2023-01-28,ROSA,knockout,Flaring Phoenix,15,48,63
3963,2023-01-28,ROSA,hotZone,Controller Chaos,45,61,106
3964,2023-01-28,ROSA,heist,Bridge Too Far,8,2,10
3965,2023-01-28,ROSA,gemGrab,Hard Rock Mine,110,106,216
3966,2023-01-28,ROSA,gemGrab,Deep Diner,7,7,14
3967,2023-01-28,ROSA,brawlBall,Super Beach,114,86,200
3968,2023-01-28,ROSA,brawlBall,Sneaky Fields,36,33,69
3969,2023-01-28,ROSA,bounty,Canal Grande,42,73,115
3970,2023-01-27,ROSA,knockout,Flaring Phoenix,2,1,3
3971,2023-01-27,ROSA,hotZone,Controller Chaos,15,20,35
3972,2023-01-27,ROSA,heist,Hot Potato,2,0,2
3973,2023-01-27,ROSA,gemGrab,Undermine,1,1,2
3974,2023-01-27,ROSA,gemGrab,Deep Diner,6,15,21
3975,2023-01-27,ROSA,brawlBall,Sneaky Fields,220,281,501
3976,2023-01-27,ROSA,brawlBall,Pinhole Punt,1,0,1
3977,2023-01-27,ROSA,bounty,Temple Ruins,5,17,22
3978,2023-01-26,ROSA,knockout,Riverside,3,0,3
3979,2023-01-26,ROSA,hotZone,Open Zone,13,4,17
3980,2023-01-26,ROSA,heist,Hot Potato,2,6,8
3981,2023-01-26,ROSA,gemGrab,Undermine,67,57,124
3982,2023-01-26,ROSA,gemGrab,Gem Fort,70,101,171
3983,2023-01-26,ROSA,brawlBall,Sunny Soccer,3,1,4
3984,2023-01-26,ROSA,brawlBall,Pinhole Punt,118,163,281
3985,2023-01-26,ROSA,bounty,Temple Ruins,12,18,30
3986,2023-01-25,ROSA,knockout,Riverside,0,1,1
3987,2023-01-25,ROSA,hotZone,Open Zone,1,5,6
3988,2023-01-25,ROSA,heist,Safe Zone,1,2,3
3989,2023-01-25,ROSA,gemGrab,Gem Fort,70,119,189
3990,2023-01-25,ROSA,gemGrab,Crystal Arcade,28,33,61
3991,2023-01-25,ROSA,brawlBall,Sunny Soccer,47,53,100
3992,2023-01-25,ROSA,brawlBall,Beach Ball,2,4,6
3993,2023-01-25,ROSA,bounty,Excel,1,2,3
3994,2023-01-24,ROSA,knockout,New Perspective,13,15,28
3995,2023-01-24,ROSA,hotZone,Dueling Beetles,18,15,33
3996,2023-01-24,ROSA,heist,Safe Zone,6,0,6
3997,2023-01-24,ROSA,gemGrab,Minecart Madness,1,1,2
3998,2023-01-24,ROSA,gemGrab,Crystal Arcade,56,116,172
3999,2023-01-24,ROSA,brawlBall,Center Stage,38,54,92
4000,2023-01-24,ROSA,brawlBall,Beach Ball,72,82,154
4001,2023-01-24,ROSA,bounty,Excel,0,5,5
4002,2023-01-23,ROSA,knockout,New Perspective,11,14,25
4003,2023-01-23,ROSA,hotZone,Dueling Beetles,32,39,71
4004,2023-01-23,ROSA,heist,Snaked Assault,14,3,17
4005,2023-01-23,ROSA,gemGrab,Minecart Madness,9,12,21
4006,2023-01-23,ROSA,gemGrab,Double Swoosh,59,81,140
4007,2023-01-23,ROSA,brawlBall,Center Stage,600,935,1535
4008,2023-01-23,ROSA,brawlBall,Backyard Bowl,1,1,2
4009,2023-01-23,ROSA,bounty,Layer Cake,10,5,15
4010,2023-01-22,ROSA,knockout,X Marks the Spot,1,2,3
4011,2023-01-22,ROSA,hotZone,Ring of Fire,15,13,28
4012,2023-01-22,ROSA,heist,Snaked Assault,5,2,7
4013,2023-01-22,ROSA,gemGrab,Hard Rock Mine,40,37,77
4014,2023-01-22,ROSA,gemGrab,Double Swoosh,90,118,208
4015,2023-01-22,ROSA,brawlBall,Super Beach,4,6,10
4016,2023-01-22,ROSA,brawlBall,Backyard Bowl,7,21,28
4017,2023-01-22,ROSA,bounty,Layer Cake,6,8,14
4018,2023-01-21,ROSA,knockout,X Marks the Spot,9,7,16
4019,2023-01-21,ROSA,hotZone,Ring of Fire,35,63,98
4020,2023-01-21,ROSA,heist,Tornado Ring,22,15,37
4021,2023-01-21,ROSA,gemGrab,Hard Rock Mine,148,163,311
4022,2023-01-21,ROSA,gemGrab,Deep Diner,3,1,4
4023,2023-01-21,ROSA,brawlBall,Super Beach,102,119,221
4024,2023-01-21,ROSA,brawlBall,Sneaky Fields,39,50,89
4025,2023-01-21,ROSA,bounty,Dry Season,3,2,5
4026,2023-01-20,ROSA,knockout,Out in the Open,6,10,16
4027,2023-01-20,ROSA,hotZone,Split,31,41,72
4028,2023-01-20,ROSA,heist,Tornado Ring,11,12,23
4029,2023-01-20,ROSA,gemGrab,Undermine,20,47,67
4030,2023-01-20,ROSA,gemGrab,Deep Diner,18,12,30
4031,2023-01-20,ROSA,brawlBall,Sneaky Fields,643,873,1516
4032,2023-01-20,ROSA,brawlBall,Pinhole Punt,9,8,17
4033,2023-01-20,ROSA,bounty,Dry Season,2,1,3
4034,2023-01-19,ROSA,knockout,Out in the Open,11,18,29
4035,2023-01-19,ROSA,hotZone,Split,49,63,112
4036,2023-01-19,ROSA,heist,Kaboom Canyon,3,3,6
4037,2023-01-19,ROSA,gemGrab,Undermine,67,103,170
4038,2023-01-19,ROSA,gemGrab,Gem Fort,37,56,93
4039,2023-01-19,ROSA,brawlBall,Sunny Soccer,0,4,4
4040,2023-01-19,ROSA,brawlBall,Pinhole Punt,92,159,251
4041,2023-01-19,ROSA,bounty,Shooting Star,2,1,3
4042,2023-01-18,ROSA,knockout,Goldarm Gulch,2,2,4
4043,2023-01-18,ROSA,hotZone,Parallel Plays,2,2,4
4044,2023-01-18,ROSA,heist,Kaboom Canyon,3,0,3
4045,2023-01-18,ROSA,gemGrab,Gem Fort,44,51,95
4046,2023-01-18,ROSA,gemGrab,Crystal Arcade,1,0,1
4047,2023-01-18,ROSA,brawlBall,Sunny Soccer,39,46,85
4048,2023-01-18,ROSA,brawlBall,Beach Ball,0,1,1
4049,2023-01-18,ROSA,bounty,Shooting Star,2,2,4
4050,2023-01-17,ROSA,knockout,Goldarm Gulch,4,0,4
4051,2023-01-17,ROSA,hotZone,Parallel Plays,3,7,10
4052,2023-01-17,ROSA,heist,Pit Stop,0,1,1
4053,2023-01-17,ROSA,gemGrab,Crystal Arcade,2,2,4
4054,2023-01-17,ROSA,brawlBall,Center Stage,1,2,3
4055,2023-01-17,ROSA,brawlBall,Beach Ball,5,8,13
4056,2023-01-17,ROSA,bounty,Hideout,0,1,1
4057,2023-01-16,ROSA,knockout,Belle's Rock,2,0,2
4058,2023-01-16,ROSA,hotZone,Quarter Pounder,1,1,2
4059,2023-01-16,ROSA,gemGrab,Double Swoosh,2,1,3
4060,2023-01-16,ROSA,brawlBall,Center Stage,31,63,94
4061,2023-01-16,ROSA,bounty,Hideout,1,0,1
4062,2023-01-15,ROSA,hotZone,Quarter Pounder,2,0,2
4063,2023-01-15,ROSA,gemGrab,Hard Rock Mine,8,24,32
4064,2023-01-15,ROSA,gemGrab,Double Swoosh,19,42,61
4065,2023-01-15,ROSA,brawlBall,Backyard Bowl,3,0,3
4066,2023-01-15,ROSA,bounty,Canal Grande,6,15,21
4067,2023-01-14,ROSA,knockout,Flaring Phoenix,2,0,2
4068,2023-01-14,ROSA,hotZone,Controller Chaos,13,32,45
4069,2023-01-14,ROSA,gemGrab,Hard Rock Mine,7,31,38
4070,2023-01-14,ROSA,gemGrab,Deep Diner,1,0,1
4071,2023-01-14,ROSA,brawlBall,Super Beach,5,2,7
4072,2023-01-14,ROSA,brawlBall,Sneaky Fields,8,10,18
4073,2023-01-14,ROSA,bounty,Canal Grande,3,2,5
4074,2023-01-13,ROSA,hotZone,Controller Chaos,11,14,25
4075,2023-01-13,ROSA,gemGrab,Deep Diner,7,0,7
4076,2023-01-13,ROSA,brawlBall,Sneaky Fields,77,100,177
4077,2023-01-13,ROSA,bounty,Temple Ruins,0,2,2
4078,2023-01-12,ROSA,hotZone,Open Zone,2,0,2
4079,2023-01-12,ROSA,gemGrab,Undermine,0,1,1
4080,2023-01-12,ROSA,gemGrab,Gem Fort,3,5,8
4081,2023-01-12,ROSA,brawlBall,Pinhole Punt,4,0,4
4082,2023-01-11,ROSA,gemGrab,Gem Fort,4,4,8
4083,2023-01-11,ROSA,brawlBall,Sunny Soccer,2,0,2
4084,2023-01-10,ROSA,hotZone,Dueling Beetles,4,3,7
4085,2023-01-10,ROSA,heist,Safe Zone,0,1,1
4086,2023-01-10,ROSA,gemGrab,Crystal Arcade,7,2,9
4087,2023-01-10,ROSA,brawlBall,Center Stage,5,2,7
4088,2023-01-10,ROSA,brawlBall,Beach Ball,5,1,6
4089,2023-01-09,ROSA,hotZone,Dueling Beetles,8,3,11
4090,2023-01-09,ROSA,gemGrab,Double Swoosh,2,3,5
4091,2023-01-09,ROSA,brawlBall,Center Stage,36,57,93
4092,2023-01-09,ROSA,bounty,Layer Cake,2,3,5
4093,2023-01-08,ROSA,hotZone,Ring of Fire,3,5,8
4094,2023-01-08,ROSA,heist,Snaked Assault,0,1,1
4095,2023-01-08,ROSA,gemGrab,Hard Rock Mine,5,1,6
4096,2023-01-08,ROSA,gemGrab,Double Swoosh,7,6,13
4097,2023-01-08,ROSA,brawlBall,Super Beach,1,0,1
4098,2023-01-08,ROSA,bounty,Layer Cake,0,2,2
4099,2023-01-07,ROSA,hotZone,Ring of Fire,2,0,2
4100,2023-01-07,ROSA,heist,Tornado Ring,3,1,4
4101,2023-01-07,ROSA,gemGrab,Hard Rock Mine,5,2,7
4102,2023-01-07,ROSA,gemGrab,Deep Diner,2,0,2
4103,2023-01-07,ROSA,brawlBall,Super Beach,2,0,2
4104,2023-01-07,ROSA,brawlBall,Sneaky Fields,5,1,6
4105,2023-01-06,ROSA,hotZone,Split,2,0,2
4106,2023-01-06,ROSA,heist,Tornado Ring,1,0,1
4107,2023-01-06,ROSA,gemGrab,Undermine,4,1,5
4108,2023-01-06,ROSA,brawlBall,Sneaky Fields,49,45,94
4109,2023-01-06,ROSA,brawlBall,Pinhole Punt,1,0,1
4110,2023-01-05,ROSA,knockout,Out in the Open,1,0,1
4111,2023-01-05,ROSA,hotZone,Split,5,3,8
4112,2023-01-05,ROSA,gemGrab,Undermine,2,0,2
4113,2023-01-05,ROSA,gemGrab,Gem Fort,2,1,3
4114,2023-01-05,ROSA,brawlBall,Pinhole Punt,12,6,18
4115,2023-01-04,ROSA,hotZone,Parallel Plays,1,1,2
4116,2023-01-04,ROSA,gemGrab,Gem Fort,19,22,41
4117,2023-01-04,ROSA,brawlBall,Sunny Soccer,5,4,9
4118,2023-01-03,ROSA,knockout,Goldarm Gulch,1,0,1
4119,2023-01-03,ROSA,hotZone,Parallel Plays,2,0,2
4120,2023-01-03,ROSA,heist,Pit Stop,2,2,4
4121,2023-01-03,ROSA,gemGrab,Crystal Arcade,14,1,15
4122,2023-01-03,ROSA,brawlBall,Center Stage,1,1,2
4123,2023-01-03,ROSA,brawlBall,Beach Ball,8,1,9
4124,2023-01-02,ROSA,hotZone,Quarter Pounder,1,0,1
4125,2023-01-02,ROSA,heist,Pit Stop,1,0,1
4126,2023-01-02,ROSA,heist,Kaboom Canyon,1,0,1
4127,2023-01-02,ROSA,gemGrab,Double Swoosh,10,2,12
4128,2023-01-02,ROSA,brawlBall,Center Stage,49,57,106
4129,2023-01-02,ROSA,bounty,Hideout,1,0,1
4130,2023-01-01,ROSA,hotZone,Quarter Pounder,7,10,17
4131,2023-01-01,ROSA,gemGrab,Double Swoosh,7,3,10
4132,2023-01-01,ROSA,brawlBall,Backyard Bowl,0,1,1
4133,2023-01-01,ROSA,bounty,Canal Grande,2,0,2
4134,2022-12-31,ROSA,hotZone,Controller Chaos,0,1,1
4135,2022-12-31,ROSA,gemGrab,Minecart Madness,1,0,1
4136,2022-12-31,ROSA,gemGrab,Hard Rock Mine,2,0,2
4137,2022-12-30,ROSA,hotZone,Controller Chaos,0,1,1
4138,2022-12-30,ROSA,gemGrab,Undermine,1,0,1
4139,2022-12-30,ROSA,brawlBall,Sneaky Fields,3,5,8
4140,2022-12-29,ROSA,heist,Hot Potato,0,3,3
4141,2022-12-28,ROSA,brawlBall,Sunny Soccer,0,2,2
4142,2022-12-27,ROSA,brawlBall,Center Stage,0,1,1
4143,2022-12-26,ROSA,brawlBall,Center Stage,0,2,2
4144,2022-12-22,ROSA,gemGrab,Gem Fort,6,1,7
4145,2022-12-19,ROSA,brawlBall,Center Stage,1,0,1
4146,2022-12-16,ROSA,brawlBall,Sneaky Fields,0,1,1
4147,2022-12-13,ROSA,gemGrab,Crystal Arcade,0,1,1
4148,2022-12-10,ROSA,gemGrab,Hard Rock Mine,0,1,1
4149,2022-10-30,ROSA,bounty,Canal Grande,1,1,2
4150,2023-02-11,RICO,knockout,Flaring Phoenix,16,13,29
4151,2023-02-11,RICO,hotZone,Controller Chaos,6,9,15
4152,2023-02-11,RICO,gemGrab,Deep Diner,40,28,68
4153,2023-02-11,RICO,brawlBall,Super Beach,75,73,148
4154,2023-02-11,RICO,brawlBall,Sneaky Fields,151,177,328
4155,2023-02-10,RICO,knockout,Flaring Phoenix,36,42,78
4156,2023-02-10,RICO,hotZone,Controller Chaos,14,7,21
4157,2023-02-10,RICO,heist,Hot Potato,138,115,253
4158,2023-02-10,RICO,gemGrab,Undermine,22,11,33
4159,2023-02-10,RICO,gemGrab,Deep Diner,87,81,168
4160,2023-02-10,RICO,brawlBall,Sneaky Fields,1175,1206,2381
4161,2023-02-10,RICO,brawlBall,Pinhole Punt,5,9,14
4162,2023-02-10,RICO,bounty,Temple Ruins,62,69,131
4163,2023-02-09,RICO,knockout,Riverside,10,1,11
4164,2023-02-09,RICO,hotZone,Open Zone,1,1,2
4165,2023-02-09,RICO,heist,Hot Potato,109,105,214
4166,2023-02-09,RICO,gemGrab,Undermine,15,11,26
4167,2023-02-09,RICO,gemGrab,Gem Fort,9,14,23
4168,2023-02-09,RICO,brawlBall,Pinhole Punt,139,101,240
4169,2023-02-09,RICO,bounty,Temple Ruins,42,58,100
4170,2023-02-08,RICO,knockout,Riverside,5,1,6
4171,2023-02-08,RICO,hotZone,Open Zone,3,0,3
4172,2023-02-08,RICO,heist,Safe Zone,19,29,48
4173,2023-02-08,RICO,gemGrab,Gem Fort,25,16,41
4174,2023-02-08,RICO,gemGrab,Crystal Arcade,5,1,6
4175,2023-02-08,RICO,brawlBall,Sunny Soccer,34,38,72
4176,2023-02-08,RICO,brawlBall,Beach Ball,2,1,3
4177,2023-02-08,RICO,bounty,Excel,10,11,21
4178,2023-02-07,RICO,knockout,New Perspective,3,4,7
4179,2023-02-07,RICO,hotZone,Dueling Beetles,4,1,5
4180,2023-02-07,RICO,heist,Safe Zone,19,10,29
4181,2023-02-07,RICO,gemGrab,Minecart Madness,0,1,1
4182,2023-02-07,RICO,gemGrab,Crystal Arcade,3,0,3
4183,2023-02-07,RICO,brawlBall,Center Stage,28,27,55
4184,2023-02-07,RICO,brawlBall,Beach Ball,19,36,55
4185,2023-02-07,RICO,bounty,Excel,12,25,37
4186,2023-02-06,RICO,knockout,New Perspective,98,91,189
4187,2023-02-06,RICO,knockout,Goldarm Gulch,37,31,68
4188,2023-02-06,RICO,hotZone,Dueling Beetles,37,25,62
4189,2023-02-06,RICO,heist,Snaked Assault,16,12,28
4190,2023-02-06,RICO,heist,Pit Stop,38,27,65
4191,2023-02-06,RICO,gemGrab,Minecart Madness,64,36,100
4192,2023-02-06,RICO,gemGrab,Double Swoosh,21,15,36
4193,2023-02-06,RICO,brawlBall,Sneaky Fields,35,42,77
4194,2023-02-06,RICO,brawlBall,Center Stage,2216,2231,4447
4195,2023-02-06,RICO,brawlBall,Backyard Bowl,14,16,30
4196,2023-02-06,RICO,bounty,Layer Cake,25,19,44
4197,2023-02-05,RICO,knockout,X Marks the Spot,16,6,22
4198,2023-02-05,RICO,knockout,Goldarm Gulch,158,122,280
4199,2023-02-05,RICO,hotZone,Ring of Fire,93,69,162
4200,2023-02-05,RICO,heist,Snaked Assault,38,16,54
4201,2023-02-05,RICO,heist,Pit Stop,148,145,293
4202,2023-02-05,RICO,gemGrab,Hard Rock Mine,219,268,487
4203,2023-02-05,RICO,gemGrab,Double Swoosh,85,37,122
4204,2023-02-05,RICO,brawlBall,Super Beach,12,26,38
4205,2023-02-05,RICO,brawlBall,Sneaky Fields,74,102,176
4206,2023-02-05,RICO,brawlBall,Backyard Bowl,222,145,367
4207,2023-02-05,RICO,bounty,Layer Cake,39,29,68
4208,2023-02-04,RICO,knockout,X Marks the Spot,4,2,6
4209,2023-02-04,RICO,knockout,Goldarm Gulch,86,70,156
4210,2023-02-04,RICO,hotZone,Ring of Fire,32,11,43
4211,2023-02-04,RICO,heist,Tornado Ring,4,10,14
4212,2023-02-04,RICO,heist,Pit Stop,97,71,168
4213,2023-02-04,RICO,gemGrab,Hard Rock Mine,253,244,497
4214,2023-02-04,RICO,gemGrab,Double Swoosh,14,3,17
4215,2023-02-04,RICO,gemGrab,Deep Diner,6,3,9
4216,2023-02-04,RICO,brawlBall,Super Beach,90,77,167
4217,2023-02-04,RICO,brawlBall,Sneaky Fields,49,75,124
4218,2023-02-04,RICO,bounty,Dry Season,4,7,11
4219,2023-02-03,RICO,knockout,Out in the Open,40,33,73
4220,2023-02-03,RICO,knockout,Goldarm Gulch,564,430,994
4221,2023-02-03,RICO,hotZone,Split,479,592,1071
4222,2023-02-03,RICO,heist,Tornado Ring,42,42,84
4223,2023-02-03,RICO,heist,Pit Stop,475,468,943
4224,2023-02-03,RICO,gemGrab,Undermine,15,11,26
4225,2023-02-03,RICO,gemGrab,Double Swoosh,57,22,79
4226,2023-02-03,RICO,gemGrab,Deep Diner,74,80,154
4227,2023-02-03,RICO,brawlBall,Sneaky Fields,1252,1531,2783
4228,2023-02-03,RICO,brawlBall,Pinhole Punt,24,24,48
4229,2023-02-03,RICO,bounty,Dry Season,12,11,23
4230,2023-02-02,RICO,knockout,Out in the Open,17,13,30
4231,2023-02-02,RICO,hotZone,Split,327,370,697
4232,2023-02-02,RICO,heist,Kaboom Canyon,6,12,18
4233,2023-02-02,RICO,gemGrab,Undermine,15,11,26
4234,2023-02-02,RICO,gemGrab,Gem Fort,18,14,32
4235,2023-02-02,RICO,brawlBall,Sunny Soccer,4,3,7
4236,2023-02-02,RICO,brawlBall,Pinhole Punt,195,159,354
4237,2023-02-02,RICO,bounty,Shooting Star,2,0,2
4238,2023-02-01,RICO,knockout,Goldarm Gulch,408,304,712
4239,2023-02-01,RICO,hotZone,Parallel Plays,26,15,41
4240,2023-02-01,RICO,heist,Kaboom Canyon,14,13,27
4241,2023-02-01,RICO,gemGrab,Gem Fort,139,124,263
4242,2023-02-01,RICO,gemGrab,Crystal Arcade,26,35,61
4243,2023-02-01,RICO,brawlBall,Sunny Soccer,367,388,755
4244,2023-02-01,RICO,brawlBall,Beach Ball,14,22,36
4245,2023-02-01,RICO,bounty,Shooting Star,1,0,1
4246,2023-01-31,RICO,knockout,Goldarm Gulch,249,228,477
4247,2023-01-31,RICO,hotZone,Parallel Plays,4,4,8
4248,2023-01-31,RICO,heist,Pit Stop,54,27,81
4249,2023-01-31,RICO,gemGrab,Minecart Madness,1,3,4
4250,2023-01-31,RICO,gemGrab,Crystal Arcade,40,18,58
4251,2023-01-31,RICO,brawlBall,Center Stage,21,18,39
4252,2023-01-31,RICO,brawlBall,Beach Ball,210,218,428
4253,2023-01-31,RICO,bounty,Hideout,7,6,13
4254,2023-01-30,RICO,knockout,Belle's Rock,130,126,256
4255,2023-01-30,RICO,hotZone,Quarter Pounder,71,174,245
4256,2023-01-30,RICO,heist,Pit Stop,157,100,257
4257,2023-01-30,RICO,gemGrab,Minecart Madness,39,30,69
4258,2023-01-30,RICO,gemGrab,Double Swoosh,19,9,28
4259,2023-01-30,RICO,brawlBall,Center Stage,1339,1428,2767
4260,2023-01-30,RICO,brawlBall,Backyard Bowl,24,19,43
4261,2023-01-30,RICO,bounty,Hideout,5,3,8
4262,2023-01-29,RICO,knockout,Belle's Rock,217,189,406
4263,2023-01-29,RICO,hotZone,Quarter Pounder,68,72,140
4264,2023-01-29,RICO,heist,Bridge Too Far,37,21,58
4265,2023-01-29,RICO,gemGrab,Hard Rock Mine,137,139,276
4266,2023-01-29,RICO,gemGrab,Double Swoosh,39,19,58
4267,2023-01-29,RICO,brawlBall,Super Beach,3,1,4
4268,2023-01-29,RICO,brawlBall,Backyard Bowl,138,107,245
4269,2023-01-29,RICO,bounty,Canal Grande,8,2,10
4270,2023-01-28,RICO,knockout,Flaring Phoenix,14,13,27
4271,2023-01-28,RICO,hotZone,Controller Chaos,17,4,21
4272,2023-01-28,RICO,heist,Bridge Too Far,92,33,125
4273,2023-01-28,RICO,gemGrab,Hard Rock Mine,802,902,1704
4274,2023-01-28,RICO,gemGrab,Deep Diner,36,27,63
4275,2023-01-28,RICO,brawlBall,Super Beach,339,312,651
4276,2023-01-28,RICO,brawlBall,Sneaky Fields,54,56,110
4277,2023-01-28,RICO,bounty,Canal Grande,16,7,23
4278,2023-01-27,RICO,knockout,Flaring Phoenix,5,6,11
4279,2023-01-27,RICO,hotZone,Controller Chaos,11,3,14
4280,2023-01-27,RICO,heist,Hot Potato,68,102,170
4281,2023-01-27,RICO,gemGrab,Undermine,8,3,11
4282,2023-01-27,RICO,gemGrab,Deep Diner,33,49,82
4283,2023-01-27,RICO,brawlBall,Sneaky Fields,353,347,700
4284,2023-01-27,RICO,brawlBall,Pinhole Punt,4,6,10
4285,2023-01-27,RICO,bounty,Temple Ruins,13,38,51
4286,2023-01-26,RICO,knockout,Riverside,32,27,59
4287,2023-01-26,RICO,hotZone,Open Zone,12,4,16
4288,2023-01-26,RICO,heist,Hot Potato,363,310,673
4289,2023-01-26,RICO,gemGrab,Undermine,54,72,126
4290,2023-01-26,RICO,gemGrab,Gem Fort,66,80,146
4291,2023-01-26,RICO,brawlBall,Sunny Soccer,17,31,48
4292,2023-01-26,RICO,brawlBall,Pinhole Punt,482,561,1043
4293,2023-01-26,RICO,bounty,Temple Ruins,37,39,76
4294,2023-01-25,RICO,knockout,Riverside,8,5,13
4295,2023-01-25,RICO,hotZone,Open Zone,6,2,8
4296,2023-01-25,RICO,heist,Safe Zone,222,308,530
4297,2023-01-25,RICO,gemGrab,Gem Fort,80,72,152
4298,2023-01-25,RICO,gemGrab,Crystal Arcade,26,30,56
4299,2023-01-25,RICO,brawlBall,Sunny Soccer,267,287,554
4300,2023-01-25,RICO,brawlBall,Beach Ball,26,26,52
4301,2023-01-25,RICO,bounty,Excel,64,46,110
4302,2023-01-24,RICO,knockout,New Perspective,64,55,119
4303,2023-01-24,RICO,hotZone,Dueling Beetles,18,10,28
4304,2023-01-24,RICO,heist,Safe Zone,502,655,1157
4305,2023-01-24,RICO,gemGrab,Minecart Madness,7,1,8
4306,2023-01-24,RICO,gemGrab,Crystal Arcade,52,52,104
4307,2023-01-24,RICO,brawlBall,Center Stage,205,170,375
4308,2023-01-24,RICO,brawlBall,Beach Ball,427,485,912
4309,2023-01-24,RICO,bounty,Excel,125,159,284
4310,2023-01-23,RICO,knockout,New Perspective,110,105,215
4311,2023-01-23,RICO,hotZone,Dueling Beetles,28,9,37
4312,2023-01-23,RICO,heist,Snaked Assault,24,12,36
4313,2023-01-23,RICO,gemGrab,Minecart Madness,56,27,83
4314,2023-01-23,RICO,gemGrab,Double Swoosh,12,8,20
4315,2023-01-23,RICO,brawlBall,Center Stage,2163,2102,4265
4316,2023-01-23,RICO,brawlBall,Backyard Bowl,16,16,32
4317,2023-01-23,RICO,bounty,Layer Cake,24,23,47
4318,2023-01-22,RICO,knockout,X Marks the Spot,12,6,18
4319,2023-01-22,RICO,hotZone,Ring of Fire,54,64,118
4320,2023-01-22,RICO,heist,Snaked Assault,14,7,21
4321,2023-01-22,RICO,gemGrab,Hard Rock Mine,203,199,402
4322,2023-01-22,RICO,gemGrab,Double Swoosh,24,20,44
4323,2023-01-22,RICO,brawlBall,Super Beach,44,25,69
4324,2023-01-22,RICO,brawlBall,Backyard Bowl,77,61,138
4325,2023-01-22,RICO,bounty,Layer Cake,23,32,55
4326,2023-01-21,RICO,knockout,X Marks the Spot,34,15,49
4327,2023-01-21,RICO,hotZone,Ring of Fire,193,155,348
4328,2023-01-21,RICO,heist,Tornado Ring,23,16,39
4329,2023-01-21,RICO,gemGrab,Hard Rock Mine,970,1100,2070
4330,2023-01-21,RICO,gemGrab,Deep Diner,31,18,49
4331,2023-01-21,RICO,brawlBall,Super Beach,455,405,860
4332,2023-01-21,RICO,brawlBall,Sneaky Fields,56,54,110
4333,2023-01-21,RICO,bounty,Dry Season,12,9,21
4334,2023-01-20,RICO,knockout,Out in the Open,44,23,67
4335,2023-01-20,RICO,hotZone,Split,549,675,1224
4336,2023-01-20,RICO,heist,Tornado Ring,25,9,34
4337,2023-01-20,RICO,gemGrab,Undermine,29,48,77
4338,2023-01-20,RICO,gemGrab,Deep Diner,93,69,162
4339,2023-01-20,RICO,brawlBall,Sneaky Fields,910,938,1848
4340,2023-01-20,RICO,brawlBall,Pinhole Punt,20,32,52
4341,2023-01-20,RICO,bounty,Dry Season,16,16,32
4342,2023-01-19,RICO,knockout,Out in the Open,43,43,86
4343,2023-01-19,RICO,hotZone,Split,954,1020,1974
4344,2023-01-19,RICO,heist,Kaboom Canyon,23,8,31
4345,2023-01-19,RICO,gemGrab,Undermine,73,93,166
4346,2023-01-19,RICO,gemGrab,Gem Fort,60,97,157
4347,2023-01-19,RICO,brawlBall,Sunny Soccer,18,17,35
4348,2023-01-19,RICO,brawlBall,Pinhole Punt,523,632,1155
4349,2023-01-19,RICO,bounty,Shooting Star,9,7,16
4350,2023-01-18,RICO,knockout,Goldarm Gulch,86,71,157
4351,2023-01-18,RICO,hotZone,Parallel Plays,1,0,1
4352,2023-01-18,RICO,heist,Kaboom Canyon,11,4,15
4353,2023-01-18,RICO,gemGrab,Gem Fort,33,39,72
4354,2023-01-18,RICO,gemGrab,Crystal Arcade,1,3,4
4355,2023-01-18,RICO,brawlBall,Sunny Soccer,98,87,185
4356,2023-01-18,RICO,brawlBall,Beach Ball,1,7,8
4357,2023-01-18,RICO,bounty,Shooting Star,3,1,4
4358,2023-01-17,RICO,knockout,Goldarm Gulch,68,69,137
4359,2023-01-17,RICO,hotZone,Parallel Plays,2,1,3
4360,2023-01-17,RICO,heist,Pit Stop,19,22,41
4361,2023-01-17,RICO,gemGrab,Crystal Arcade,2,3,5
4362,2023-01-17,RICO,brawlBall,Center Stage,4,3,7
4363,2023-01-17,RICO,brawlBall,Beach Ball,30,51,81
4364,2023-01-17,RICO,bounty,Hideout,2,0,2
4365,2023-01-16,RICO,knockout,Belle's Rock,12,7,19
4366,2023-01-16,RICO,hotZone,Quarter Pounder,13,39,52
4367,2023-01-16,RICO,heist,Pit Stop,54,43,97
4368,2023-01-16,RICO,gemGrab,Minecart Madness,1,1,2
4369,2023-01-16,RICO,gemGrab,Double Swoosh,4,0,4
4370,2023-01-16,RICO,brawlBall,Center Stage,161,173,334
4371,2023-01-16,RICO,brawlBall,Backyard Bowl,1,0,1
4372,2023-01-16,RICO,bounty,Hideout,2,2,4
4373,2023-01-15,RICO,knockout,Belle's Rock,23,30,53
4374,2023-01-15,RICO,hotZone,Quarter Pounder,25,23,48
4375,2023-01-15,RICO,heist,Bridge Too Far,6,14,20
4376,2023-01-15,RICO,gemGrab,Hard Rock Mine,38,42,80
4377,2023-01-15,RICO,gemGrab,Double Swoosh,7,2,9
4378,2023-01-15,RICO,brawlBall,Super Beach,2,1,3
4379,2023-01-15,RICO,brawlBall,Backyard Bowl,16,7,23
4380,2023-01-15,RICO,bounty,Canal Grande,1,5,6
4381,2023-01-14,RICO,knockout,Flaring Phoenix,0,2,2
4382,2023-01-14,RICO,hotZone,Controller Chaos,8,5,13
4383,2023-01-14,RICO,heist,Bridge Too Far,7,0,7
4384,2023-01-14,RICO,gemGrab,Hard Rock Mine,73,74,147
4385,2023-01-14,RICO,gemGrab,Deep Diner,5,5,10
4386,2023-01-14,RICO,brawlBall,Super Beach,28,17,45
4387,2023-01-14,RICO,brawlBall,Sneaky Fields,19,43,62
4388,2023-01-14,RICO,bounty,Canal Grande,1,0,1
4389,2023-01-13,RICO,knockout,Flaring Phoenix,2,0,2
4390,2023-01-13,RICO,hotZone,Controller Chaos,5,4,9
4391,2023-01-13,RICO,heist,Hot Potato,15,8,23
4392,2023-01-13,RICO,gemGrab,Deep Diner,8,3,11
4393,2023-01-13,RICO,brawlBall,Sneaky Fields,122,111,233
4394,2023-01-13,RICO,brawlBall,Pinhole Punt,1,1,2
4395,2023-01-13,RICO,bounty,Temple Ruins,2,14,16
4396,2023-01-12,RICO,knockout,Riverside,2,1,3
4397,2023-01-12,RICO,heist,Hot Potato,8,31,39
4398,2023-01-12,RICO,gemGrab,Undermine,2,3,5
4399,2023-01-12,RICO,gemGrab,Gem Fort,6,5,11
4400,2023-01-12,RICO,brawlBall,Sunny Soccer,4,2,6
4401,2023-01-12,RICO,brawlBall,Pinhole Punt,30,40,70
4402,2023-01-12,RICO,bounty,Temple Ruins,1,0,1
4403,2023-01-11,RICO,heist,Safe Zone,2,1,3
4404,2023-01-11,RICO,gemGrab,Gem Fort,6,3,9
4405,2023-01-11,RICO,brawlBall,Sunny Soccer,12,11,23
4406,2023-01-11,RICO,brawlBall,Beach Ball,2,0,2
4407,2023-01-11,RICO,bounty,Excel,0,4,4
4408,2023-01-10,RICO,knockout,New Perspective,6,4,10
4409,2023-01-10,RICO,hotZone,Dueling Beetles,2,0,2
4410,2023-01-10,RICO,heist,Safe Zone,38,74,112
4411,2023-01-10,RICO,gemGrab,Minecart Madness,1,0,1
4412,2023-01-10,RICO,gemGrab,Crystal Arcade,6,2,8
4413,2023-01-10,RICO,brawlBall,Center Stage,11,7,18
4414,2023-01-10,RICO,brawlBall,Beach Ball,27,38,65
4415,2023-01-10,RICO,bounty,Excel,3,6,9
4416,2023-01-09,RICO,knockout,New Perspective,2,2,4
4417,2023-01-09,RICO,hotZone,Dueling Beetles,2,0,2
4418,2023-01-09,RICO,heist,Snaked Assault,8,4,12
4419,2023-01-09,RICO,gemGrab,Minecart Madness,3,1,4
4420,2023-01-09,RICO,gemGrab,Double Swoosh,3,0,3
4421,2023-01-09,RICO,brawlBall,Center Stage,125,135,260
4422,2023-01-09,RICO,bounty,Layer Cake,5,8,13
4423,2023-01-08,RICO,knockout,X Marks the Spot,1,0,1
4424,2023-01-08,RICO,hotZone,Ring of Fire,9,0,9
4425,2023-01-08,RICO,heist,Snaked Assault,3,1,4
4426,2023-01-08,RICO,gemGrab,Hard Rock Mine,35,47,82
4427,2023-01-08,RICO,gemGrab,Double Swoosh,1,0,1
4428,2023-01-08,RICO,brawlBall,Super Beach,4,1,5
4429,2023-01-08,RICO,brawlBall,Backyard Bowl,12,8,20
4430,2023-01-08,RICO,bounty,Layer Cake,0,1,1
4431,2023-01-07,RICO,knockout,X Marks the Spot,1,0,1
4432,2023-01-07,RICO,hotZone,Ring of Fire,14,9,23
4433,2023-01-07,RICO,heist,Tornado Ring,1,0,1
4434,2023-01-07,RICO,gemGrab,Hard Rock Mine,57,71,128
4435,2023-01-07,RICO,gemGrab,Deep Diner,4,3,7
4436,2023-01-07,RICO,brawlBall,Super Beach,6,3,9
4437,2023-01-07,RICO,brawlBall,Sneaky Fields,4,2,6
4438,2023-01-06,RICO,knockout,Out in the Open,1,0,1
4439,2023-01-06,RICO,hotZone,Split,67,42,109
4440,2023-01-06,RICO,heist,Tornado Ring,3,2,5
4441,2023-01-06,RICO,gemGrab,Undermine,1,0,1
4442,2023-01-06,RICO,gemGrab,Deep Diner,15,20,35
4443,2023-01-06,RICO,brawlBall,Sneaky Fields,69,77,146
4444,2023-01-06,RICO,brawlBall,Pinhole Punt,9,11,20
4445,2023-01-05,RICO,knockout,Out in the Open,3,1,4
4446,2023-01-05,RICO,hotZone,Split,199,226,425
4447,2023-01-05,RICO,heist,Kaboom Canyon,2,1,3
4448,2023-01-05,RICO,gemGrab,Undermine,7,5,12
4449,2023-01-05,RICO,gemGrab,Gem Fort,0,11,11
4450,2023-01-05,RICO,brawlBall,Sunny Soccer,2,3,5
4451,2023-01-05,RICO,brawlBall,Pinhole Punt,81,86,167
4452,2023-01-05,RICO,bounty,Shooting Star,2,0,2
4453,2023-01-04,RICO,knockout,Goldarm Gulch,23,33,56
4454,2023-01-04,RICO,hotZone,Parallel Plays,1,2,3
4455,2023-01-04,RICO,heist,Kaboom Canyon,1,1,2
4456,2023-01-04,RICO,gemGrab,Gem Fort,23,30,53
4457,2023-01-04,RICO,gemGrab,Crystal Arcade,4,1,5
4458,2023-01-04,RICO,brawlBall,Sunny Soccer,42,59,101
4459,2023-01-04,RICO,brawlBall,Beach Ball,1,0,1
4460,2023-01-04,RICO,bounty,Shooting Star,1,0,1
4461,2023-01-03,RICO,knockout,Goldarm Gulch,23,23,46
4462,2023-01-03,RICO,hotZone,Controller Chaos,0,1,1
4463,2023-01-03,RICO,heist,Pit Stop,37,36,73
4464,2023-01-03,RICO,gemGrab,Crystal Arcade,7,3,10
4465,2023-01-03,RICO,brawlBall,Center Stage,6,2,8
4466,2023-01-03,RICO,brawlBall,Beach Ball,30,27,57
4467,2023-01-03,RICO,bounty,Hideout,1,0,1
4468,2023-01-02,RICO,knockout,Belle's Rock,18,10,28
4469,2023-01-02,RICO,hotZone,Quarter Pounder,11,16,27
4470,2023-01-02,RICO,heist,Pit Stop,56,24,80
4471,2023-01-02,RICO,heist,Kaboom Canyon,1,0,1
4472,2023-01-02,RICO,gemGrab,Minecart Madness,5,3,8
4473,2023-01-02,RICO,gemGrab,Double Swoosh,2,0,2
4474,2023-01-02,RICO,brawlBall,Center Stage,151,106,257
4475,2023-01-02,RICO,bounty,Hideout,2,0,2
4476,2023-01-01,RICO,knockout,Belle's Rock,9,4,13
4477,2023-01-01,RICO,hotZone,Quarter Pounder,5,1,6
4478,2023-01-01,RICO,hotZone,Controller Chaos,0,2,2
4479,2023-01-01,RICO,gemGrab,Double Swoosh,3,0,3
4480,2023-01-01,RICO,brawlBall,Backyard Bowl,2,2,4
4481,2022-12-31,RICO,hotZone,Controller Chaos,1,0,1
4482,2022-12-31,RICO,gemGrab,Hard Rock Mine,15,11,26
4483,2022-12-31,RICO,gemGrab,Deep Diner,5,3,8
4484,2022-12-31,RICO,brawlBall,Super Beach,2,0,2
4485,2022-12-31,RICO,brawlBall,Sneaky Fields,1,1,2
4486,2022-12-30,RICO,heist,Hot Potato,0,1,1
4487,2022-12-30,RICO,gemGrab,Undermine,1,0,1
4488,2022-12-30,RICO,gemGrab,Deep Diner,4,0,4
4489,2022-12-30,RICO,brawlBall,Sneaky Fields,3,11,14
4490,2022-12-29,RICO,heist,Hot Potato,1,1,2
4491,2022-12-29,RICO,gemGrab,Gem Fort,2,0,2
4492,2022-12-29,RICO,brawlBall,Pinhole Punt,2,0,2
4493,2022-12-28,RICO,brawlBall,Sunny Soccer,5,2,7
4494,2022-12-27,RICO,hotZone,Dueling Beetles,0,1,1
4495,2022-12-27,RICO,hotZone,Controller Chaos,0,2,2
4496,2022-12-27,RICO,brawlBall,Center Stage,2,1,3
4497,2022-12-27,RICO,bounty,Excel,0,1,1
4498,2022-12-26,RICO,brawlBall,Center Stage,2,2,4
4499,2022-12-25,RICO,brawlBall,Backyard Bowl,1,0,1
4500,2022-12-20,RICO,brawlBall,Beach Ball,2,1,3
4501,2022-12-19,RICO,brawlBall,Center Stage,4,7,11
4502,2022-12-18,RICO,knockout,Belle's Rock,1,0,1
4503,2022-12-16,RICO,brawlBall,Sneaky Fields,2,0,2
4504,2022-12-13,RICO,heist,Safe Zone,2,0,2
4505,2022-12-13,RICO,gemGrab,Crystal Arcade,2,0,2
4506,2022-12-12,RICO,brawlBall,Center Stage,4,0,4
4507,2022-12-11,RICO,gemGrab,Double Swoosh,0,2,2
4508,2022-12-10,RICO,gemGrab,Hard Rock Mine,2,1,3
4509,2022-11-18,RICO,hotZone,Parallel Plays,0,2,2
4510,2022-11-11,RICO,knockout,New Perspective,0,4,4
4511,2022-11-11,RICO,brawlBall,Sneaky Fields,2,2,4
4512,2022-11-01,RICO,knockout,New Perspective,4,0,4
4513,2022-10-15,RICO,gemGrab,Hard Rock Mine,2,3,5
4514,2023-02-11,POCO,knockout,Flaring Phoenix,28,9,37
4515,2023-02-11,POCO,hotZone,Controller Chaos,253,246,499
4516,2023-02-11,POCO,gemGrab,Deep Diner,86,58,144
4517,2023-02-11,POCO,brawlBall,Super Beach,138,176,314
4518,2023-02-11,POCO,brawlBall,Sneaky Fields,150,166,316
4519,2023-02-10,POCO,knockout,Flaring Phoenix,60,39,99
4520,2023-02-10,POCO,hotZone,Controller Chaos,478,582,1060
4521,2023-02-10,POCO,heist,Hot Potato,16,7,23
4522,2023-02-10,POCO,gemGrab,Undermine,56,69,125
4523,2023-02-10,POCO,gemGrab,Deep Diner,285,191,476
4524,2023-02-10,POCO,brawlBall,Sneaky Fields,946,1141,2087
4525,2023-02-10,POCO,brawlBall,Pinhole Punt,22,28,50
4526,2023-02-10,POCO,bounty,Temple Ruins,36,30,66
4527,2023-02-09,POCO,knockout,Riverside,10,8,18
4528,2023-02-09,POCO,hotZone,Open Zone,61,80,141
4529,2023-02-09,POCO,heist,Hot Potato,6,2,8
4530,2023-02-09,POCO,gemGrab,Undermine,45,40,85
4531,2023-02-09,POCO,gemGrab,Gem Fort,3,11,14
4532,2023-02-09,POCO,brawlBall,Sunny Soccer,3,3,6
4533,2023-02-09,POCO,brawlBall,Pinhole Punt,274,327,601
4534,2023-02-09,POCO,bounty,Temple Ruins,18,12,30
4535,2023-02-08,POCO,knockout,Riverside,1,1,2
4536,2023-02-08,POCO,hotZone,Open Zone,43,64,107
4537,2023-02-08,POCO,heist,Safe Zone,5,4,9
4538,2023-02-08,POCO,gemGrab,Gem Fort,30,31,61
4539,2023-02-08,POCO,gemGrab,Crystal Arcade,16,5,21
4540,2023-02-08,POCO,brawlBall,Sunny Soccer,54,50,104
4541,2023-02-08,POCO,brawlBall,Beach Ball,4,3,7
4542,2023-02-08,POCO,bounty,Excel,4,4,8
4543,2023-02-07,POCO,knockout,New Perspective,4,2,6
4544,2023-02-07,POCO,hotZone,Dueling Beetles,114,175,289
4545,2023-02-07,POCO,heist,Safe Zone,3,0,3
4546,2023-02-07,POCO,gemGrab,Minecart Madness,14,1,15
4547,2023-02-07,POCO,gemGrab,Crystal Arcade,12,15,27
4548,2023-02-07,POCO,brawlBall,Center Stage,3,5,8
4549,2023-02-07,POCO,brawlBall,Beach Ball,31,38,69
4550,2023-02-07,POCO,bounty,Excel,5,0,5
4551,2023-02-06,POCO,knockout,New Perspective,38,25,63
4552,2023-02-06,POCO,hotZone,Dueling Beetles,1173,1610,2783
4553,2023-02-06,POCO,heist,Snaked Assault,25,3,28
4554,2023-02-06,POCO,gemGrab,Minecart Madness,163,162,325
4555,2023-02-06,POCO,gemGrab,Double Swoosh,191,156,347
4556,2023-02-06,POCO,brawlBall,Sneaky Fields,86,128,214
4557,2023-02-06,POCO,brawlBall,Center Stage,601,644,1245
4558,2023-02-06,POCO,brawlBall,Backyard Bowl,47,33,80
4559,2023-02-06,POCO,bounty,Layer Cake,24,17,41
4560,2023-02-05,POCO,knockout,X Marks the Spot,40,15,55
4561,2023-02-05,POCO,knockout,Goldarm Gulch,5,3,8
4562,2023-02-05,POCO,hotZone,Ring of Fire,471,621,1092
4563,2023-02-05,POCO,heist,Snaked Assault,21,9,30
4564,2023-02-05,POCO,heist,Pit Stop,1,2,3
4565,2023-02-05,POCO,gemGrab,Hard Rock Mine,41,28,69
4566,2023-02-05,POCO,gemGrab,Double Swoosh,540,475,1015
4567,2023-02-05,POCO,brawlBall,Super Beach,25,17,42
4568,2023-02-05,POCO,brawlBall,Sneaky Fields,221,255,476
4569,2023-02-05,POCO,brawlBall,Backyard Bowl,437,445,882
4570,2023-02-05,POCO,bounty,Layer Cake,29,51,80
4571,2023-02-04,POCO,knockout,X Marks the Spot,12,10,22
4572,2023-02-04,POCO,knockout,Goldarm Gulch,4,1,5
4573,2023-02-04,POCO,hotZone,Ring of Fire,102,151,253
4574,2023-02-04,POCO,heist,Tornado Ring,1,2,3
4575,2023-02-04,POCO,gemGrab,Hard Rock Mine,38,36,74
4576,2023-02-04,POCO,gemGrab,Double Swoosh,74,58,132
4577,2023-02-04,POCO,gemGrab,Deep Diner,10,13,23
4578,2023-02-04,POCO,brawlBall,Super Beach,183,216,399
4579,2023-02-04,POCO,brawlBall,Sneaky Fields,128,168,296
4580,2023-02-04,POCO,bounty,Dry Season,7,2,9
4581,2023-02-03,POCO,knockout,Out in the Open,61,43,104
4582,2023-02-03,POCO,knockout,Goldarm Gulch,6,8,14
4583,2023-02-03,POCO,hotZone,Split,90,50,140
4584,2023-02-03,POCO,heist,Tornado Ring,16,7,23
4585,2023-02-03,POCO,heist,Pit Stop,3,4,7
4586,2023-02-03,POCO,gemGrab,Undermine,42,47,89
4587,2023-02-03,POCO,gemGrab,Double Swoosh,382,346,728
4588,2023-02-03,POCO,gemGrab,Deep Diner,190,156,346
4589,2023-02-03,POCO,brawlBall,Sneaky Fields,1359,1546,2905
4590,2023-02-03,POCO,brawlBall,Pinhole Punt,50,54,104
4591,2023-02-03,POCO,bounty,Dry Season,32,28,60
4592,2023-02-02,POCO,knockout,Out in the Open,27,14,41
4593,2023-02-02,POCO,hotZone,Split,26,25,51
4594,2023-02-02,POCO,heist,Kaboom Canyon,6,4,10
4595,2023-02-02,POCO,gemGrab,Undermine,40,40,80
4596,2023-02-02,POCO,gemGrab,Gem Fort,13,16,29
4597,2023-02-02,POCO,brawlBall,Sunny Soccer,4,7,11
4598,2023-02-02,POCO,brawlBall,Pinhole Punt,210,277,487
4599,2023-02-02,POCO,bounty,Shooting Star,6,1,7
4600,2023-02-01,POCO,knockout,Goldarm Gulch,42,39,81
4601,2023-02-01,POCO,hotZone,Parallel Plays,173,107,280
4602,2023-02-01,POCO,heist,Kaboom Canyon,15,5,20
4603,2023-02-01,POCO,gemGrab,Gem Fort,239,224,463
4604,2023-02-01,POCO,gemGrab,Crystal Arcade,81,57,138
4605,2023-02-01,POCO,brawlBall,Sunny Soccer,404,460,864
4606,2023-02-01,POCO,brawlBall,Beach Ball,17,15,32
4607,2023-02-01,POCO,bounty,Shooting Star,2,4,6
4608,2023-01-31,POCO,knockout,Goldarm Gulch,29,17,46
4609,2023-01-31,POCO,hotZone,Parallel Plays,68,83,151
4610,2023-01-31,POCO,heist,Pit Stop,12,2,14
4611,2023-01-31,POCO,gemGrab,Minecart Madness,14,10,24
4612,2023-01-31,POCO,gemGrab,Crystal Arcade,108,111,219
4613,2023-01-31,POCO,brawlBall,Center Stage,4,1,5
4614,2023-01-31,POCO,brawlBall,Beach Ball,242,236,478
4615,2023-01-31,POCO,bounty,Hideout,7,6,13
4616,2023-01-30,POCO,knockout,Belle's Rock,37,36,73
4617,2023-01-30,POCO,hotZone,Quarter Pounder,256,154,410
4618,2023-01-30,POCO,heist,Pit Stop,7,2,9
4619,2023-01-30,POCO,gemGrab,Minecart Madness,104,78,182
4620,2023-01-30,POCO,gemGrab,Double Swoosh,127,139,266
4621,2023-01-30,POCO,brawlBall,Center Stage,373,453,826
4622,2023-01-30,POCO,brawlBall,Backyard Bowl,45,32,77
4623,2023-01-30,POCO,bounty,Hideout,7,2,9
4624,2023-01-29,POCO,knockout,Belle's Rock,30,13,43
4625,2023-01-29,POCO,hotZone,Quarter Pounder,175,115,290
4626,2023-01-29,POCO,heist,Bridge Too Far,11,3,14
4627,2023-01-29,POCO,gemGrab,Hard Rock Mine,49,22,71
4628,2023-01-29,POCO,gemGrab,Double Swoosh,237,266,503
4629,2023-01-29,POCO,brawlBall,Super Beach,9,16,25
4630,2023-01-29,POCO,brawlBall,Backyard Bowl,338,385,723
4631,2023-01-29,POCO,bounty,Canal Grande,11,20,31
4632,2023-01-28,POCO,knockout,Flaring Phoenix,19,12,31
4633,2023-01-28,POCO,hotZone,Controller Chaos,300,317,617
4634,2023-01-28,POCO,heist,Bridge Too Far,16,6,22
4635,2023-01-28,POCO,gemGrab,Hard Rock Mine,143,96,239
4636,2023-01-28,POCO,gemGrab,Deep Diner,68,58,126
4637,2023-01-28,POCO,brawlBall,Super Beach,722,767,1489
4638,2023-01-28,POCO,brawlBall,Sneaky Fields,49,44,93
4639,2023-01-28,POCO,bounty,Canal Grande,25,36,61
4640,2023-01-27,POCO,knockout,Flaring Phoenix,10,6,16
4641,2023-01-27,POCO,hotZone,Controller Chaos,92,124,216
4642,2023-01-27,POCO,heist,Hot Potato,6,3,9
4643,2023-01-27,POCO,gemGrab,Undermine,12,10,22
4644,2023-01-27,POCO,gemGrab,Deep Diner,69,44,113
4645,2023-01-27,POCO,brawlBall,Sneaky Fields,274,291,565
4646,2023-01-27,POCO,brawlBall,Pinhole Punt,17,16,33
4647,2023-01-27,POCO,bounty,Temple Ruins,7,2,9
4648,2023-01-26,POCO,knockout,Riverside,44,22,66
4649,2023-01-26,POCO,hotZone,Open Zone,446,564,1010
4650,2023-01-26,POCO,heist,Hot Potato,26,15,41
4651,2023-01-26,POCO,gemGrab,Undermine,122,96,218
4652,2023-01-26,POCO,gemGrab,Gem Fort,70,88,158
4653,2023-01-26,POCO,brawlBall,Sunny Soccer,40,43,83
4654,2023-01-26,POCO,brawlBall,Pinhole Punt,938,969,1907
4655,2023-01-26,POCO,bounty,Temple Ruins,24,21,45
4656,2023-01-25,POCO,knockout,Riverside,17,6,23
4657,2023-01-25,POCO,hotZone,Open Zone,214,263,477
4658,2023-01-25,POCO,heist,Safe Zone,17,7,24
4659,2023-01-25,POCO,gemGrab,Gem Fort,108,130,238
4660,2023-01-25,POCO,gemGrab,Crystal Arcade,119,82,201
4661,2023-01-25,POCO,brawlBall,Sunny Soccer,348,392,740
4662,2023-01-25,POCO,brawlBall,Beach Ball,59,51,110
4663,2023-01-25,POCO,bounty,Excel,17,4,21
4664,2023-01-24,POCO,knockout,New Perspective,37,20,57
4665,2023-01-24,POCO,hotZone,Dueling Beetles,514,672,1186
4666,2023-01-24,POCO,heist,Safe Zone,20,20,40
4667,2023-01-24,POCO,gemGrab,Minecart Madness,32,29,61
4668,2023-01-24,POCO,gemGrab,Crystal Arcade,188,128,316
4669,2023-01-24,POCO,brawlBall,Center Stage,46,57,103
4670,2023-01-24,POCO,brawlBall,Beach Ball,554,618,1172
4671,2023-01-24,POCO,bounty,Excel,31,28,59
4672,2023-01-23,POCO,knockout,New Perspective,52,24,76
4673,2023-01-23,POCO,hotZone,Dueling Beetles,794,1040,1834
4674,2023-01-23,POCO,heist,Snaked Assault,19,3,22
4675,2023-01-23,POCO,gemGrab,Minecart Madness,166,137,303
4676,2023-01-23,POCO,gemGrab,Double Swoosh,116,85,201
4677,2023-01-23,POCO,brawlBall,Center Stage,631,612,1243
4678,2023-01-23,POCO,brawlBall,Backyard Bowl,17,8,25
4679,2023-01-23,POCO,bounty,Layer Cake,29,30,59
4680,2023-01-22,POCO,knockout,X Marks the Spot,18,9,27
4681,2023-01-22,POCO,hotZone,Ring of Fire,234,251,485
4682,2023-01-22,POCO,heist,Snaked Assault,9,10,19
4683,2023-01-22,POCO,gemGrab,Hard Rock Mine,36,49,85
4684,2023-01-22,POCO,gemGrab,Double Swoosh,136,89,225
4685,2023-01-22,POCO,brawlBall,Super Beach,73,69,142
4686,2023-01-22,POCO,brawlBall,Backyard Bowl,172,141,313
4687,2023-01-22,POCO,bounty,Layer Cake,28,36,64
4688,2023-01-21,POCO,knockout,X Marks the Spot,70,43,113
4689,2023-01-21,POCO,hotZone,Ring of Fire,759,936,1695
4690,2023-01-21,POCO,heist,Tornado Ring,18,6,24
4691,2023-01-21,POCO,gemGrab,Hard Rock Mine,203,179,382
4692,2023-01-21,POCO,gemGrab,Deep Diner,63,26,89
4693,2023-01-21,POCO,brawlBall,Super Beach,847,917,1764
4694,2023-01-21,POCO,brawlBall,Sneaky Fields,47,43,90
4695,2023-01-21,POCO,bounty,Dry Season,37,15,52
4696,2023-01-20,POCO,knockout,Out in the Open,81,48,129
4697,2023-01-20,POCO,hotZone,Split,87,44,131
4698,2023-01-20,POCO,heist,Tornado Ring,24,9,33
4699,2023-01-20,POCO,gemGrab,Undermine,62,48,110
4700,2023-01-20,POCO,gemGrab,Deep Diner,218,192,410
4701,2023-01-20,POCO,brawlBall,Sneaky Fields,779,858,1637
4702,2023-01-20,POCO,brawlBall,Pinhole Punt,36,42,78
4703,2023-01-20,POCO,bounty,Dry Season,18,15,33
4704,2023-01-19,POCO,knockout,Out in the Open,78,49,127
4705,2023-01-19,POCO,hotZone,Split,103,64,167
4706,2023-01-19,POCO,heist,Kaboom Canyon,28,19,47
4707,2023-01-19,POCO,gemGrab,Undermine,195,146,341
4708,2023-01-19,POCO,gemGrab,Gem Fort,35,43,78
4709,2023-01-19,POCO,brawlBall,Sunny Soccer,17,16,33
4710,2023-01-19,POCO,brawlBall,Pinhole Punt,894,1096,1990
4711,2023-01-19,POCO,bounty,Shooting Star,33,27,60
4712,2023-01-18,POCO,knockout,Goldarm Gulch,7,1,8
4713,2023-01-18,POCO,hotZone,Parallel Plays,21,13,34
4714,2023-01-18,POCO,heist,Kaboom Canyon,2,3,5
4715,2023-01-18,POCO,gemGrab,Gem Fort,49,41,90
4716,2023-01-18,POCO,gemGrab,Crystal Arcade,18,10,28
4717,2023-01-18,POCO,brawlBall,Sunny Soccer,149,143,292
4718,2023-01-18,POCO,brawlBall,Beach Ball,3,5,8
4719,2023-01-18,POCO,bounty,Shooting Star,8,9,17
4720,2023-01-17,POCO,knockout,Goldarm Gulch,7,2,9
4721,2023-01-17,POCO,hotZone,Parallel Plays,7,8,15
4722,2023-01-17,POCO,heist,Pit Stop,3,0,3
4723,2023-01-17,POCO,gemGrab,Minecart Madness,1,0,1
4724,2023-01-17,POCO,gemGrab,Crystal Arcade,14,9,23
4725,2023-01-17,POCO,brawlBall,Center Stage,1,4,5
4726,2023-01-17,POCO,brawlBall,Beach Ball,48,45,93
4727,2023-01-17,POCO,bounty,Hideout,4,2,6
4728,2023-01-16,POCO,knockout,Belle's Rock,1,1,2
4729,2023-01-16,POCO,hotZone,Quarter Pounder,36,13,49
4730,2023-01-16,POCO,heist,Pit Stop,4,0,4
4731,2023-01-16,POCO,gemGrab,Minecart Madness,19,9,28
4732,2023-01-16,POCO,gemGrab,Double Swoosh,10,4,14
4733,2023-01-16,POCO,brawlBall,Center Stage,42,39,81
4734,2023-01-16,POCO,brawlBall,Backyard Bowl,2,1,3
4735,2023-01-16,POCO,bounty,Hideout,1,1,2
4736,2023-01-15,POCO,knockout,Belle's Rock,2,0,2
4737,2023-01-15,POCO,hotZone,Quarter Pounder,59,35,94
4738,2023-01-15,POCO,heist,Bridge Too Far,3,0,3
4739,2023-01-15,POCO,gemGrab,Hard Rock Mine,3,2,5
4740,2023-01-15,POCO,gemGrab,Double Swoosh,38,33,71
4741,2023-01-15,POCO,brawlBall,Super Beach,9,7,16
4742,2023-01-15,POCO,brawlBall,Backyard Bowl,38,31,69
4743,2023-01-15,POCO,bounty,Canal Grande,3,1,4
4744,2023-01-14,POCO,knockout,Flaring Phoenix,2,0,2
4745,2023-01-14,POCO,hotZone,Controller Chaos,55,115,170
4746,2023-01-14,POCO,heist,Bridge Too Far,4,1,5
4747,2023-01-14,POCO,gemGrab,Hard Rock Mine,10,7,17
4748,2023-01-14,POCO,gemGrab,Deep Diner,11,4,15
4749,2023-01-14,POCO,brawlBall,Super Beach,55,53,108
4750,2023-01-14,POCO,brawlBall,Sneaky Fields,12,1,13
4751,2023-01-14,POCO,bounty,Canal Grande,4,11,15
4752,2023-01-13,POCO,knockout,Flaring Phoenix,2,1,3
4753,2023-01-13,POCO,hotZone,Controller Chaos,103,85,188
4754,2023-01-13,POCO,gemGrab,Undermine,0,2,2
4755,2023-01-13,POCO,gemGrab,Deep Diner,19,13,32
4756,2023-01-13,POCO,brawlBall,Sneaky Fields,99,143,242
4757,2023-01-13,POCO,brawlBall,Pinhole Punt,3,1,4
4758,2023-01-13,POCO,bounty,Temple Ruins,2,1,3
4759,2023-01-12,POCO,knockout,Riverside,6,2,8
4760,2023-01-12,POCO,hotZone,Open Zone,89,101,190
4761,2023-01-12,POCO,gemGrab,Undermine,3,1,4
4762,2023-01-12,POCO,gemGrab,Gem Fort,2,5,7
4763,2023-01-12,POCO,brawlBall,Sunny Soccer,1,1,2
4764,2023-01-12,POCO,brawlBall,Pinhole Punt,33,38,71
4765,2023-01-12,POCO,bounty,Temple Ruins,0,1,1
4766,2023-01-11,POCO,hotZone,Open Zone,22,20,42
4767,2023-01-11,POCO,heist,Safe Zone,0,1,1
4768,2023-01-11,POCO,gemGrab,Gem Fort,5,2,7
4769,2023-01-11,POCO,brawlBall,Sunny Soccer,7,8,15
4770,2023-01-11,POCO,brawlBall,Beach Ball,1,0,1
4771,2023-01-11,POCO,bounty,Excel,1,0,1
4772,2023-01-10,POCO,knockout,New Perspective,2,2,4
4773,2023-01-10,POCO,hotZone,Dueling Beetles,97,122,219
4774,2023-01-10,POCO,heist,Safe Zone,1,3,4
4775,2023-01-10,POCO,gemGrab,Minecart Madness,9,1,10
4776,2023-01-10,POCO,gemGrab,Crystal Arcade,21,6,27
4777,2023-01-10,POCO,brawlBall,Center Stage,5,0,5
4778,2023-01-10,POCO,brawlBall,Beach Ball,43,28,71
4779,2023-01-09,POCO,knockout,New Perspective,2,2,4
4780,2023-01-09,POCO,hotZone,Dueling Beetles,56,38,94
4781,2023-01-09,POCO,heist,Snaked Assault,2,0,2
4782,2023-01-09,POCO,gemGrab,Minecart Madness,11,3,14
4783,2023-01-09,POCO,gemGrab,Double Swoosh,33,45,78
4784,2023-01-09,POCO,brawlBall,Center Stage,28,23,51
4785,2023-01-09,POCO,brawlBall,Backyard Bowl,3,1,4
4786,2023-01-08,POCO,knockout,X Marks the Spot,7,0,7
4787,2023-01-08,POCO,hotZone,Ring of Fire,88,98,186
4788,2023-01-08,POCO,heist,Snaked Assault,1,0,1
4789,2023-01-08,POCO,gemGrab,Hard Rock Mine,6,1,7
4790,2023-01-08,POCO,gemGrab,Double Swoosh,8,6,14
4791,2023-01-08,POCO,brawlBall,Super Beach,4,4,8
4792,2023-01-08,POCO,brawlBall,Backyard Bowl,34,13,47
4793,2023-01-08,POCO,bounty,Layer Cake,0,2,2
4794,2023-01-07,POCO,knockout,X Marks the Spot,1,0,1
4795,2023-01-07,POCO,hotZone,Ring of Fire,43,29,72
4796,2023-01-07,POCO,heist,Tornado Ring,1,0,1
4797,2023-01-07,POCO,gemGrab,Hard Rock Mine,9,8,17
4798,2023-01-07,POCO,gemGrab,Deep Diner,7,2,9
4799,2023-01-07,POCO,brawlBall,Super Beach,23,15,38
4800,2023-01-07,POCO,brawlBall,Sneaky Fields,3,3,6
4801,2023-01-07,POCO,bounty,Dry Season,1,0,1
4802,2023-01-06,POCO,knockout,Out in the Open,1,0,1
4803,2023-01-06,POCO,hotZone,Split,7,1,8
4804,2023-01-06,POCO,gemGrab,Undermine,3,0,3
4805,2023-01-06,POCO,gemGrab,Deep Diner,26,8,34
4806,2023-01-06,POCO,brawlBall,Sneaky Fields,77,83,160
4807,2023-01-06,POCO,brawlBall,Pinhole Punt,1,9,10
4808,2023-01-06,POCO,bounty,Dry Season,3,0,3
4809,2023-01-05,POCO,knockout,Out in the Open,3,0,3
4810,2023-01-05,POCO,hotZone,Split,20,23,43
4811,2023-01-05,POCO,heist,Kaboom Canyon,2,0,2
4812,2023-01-05,POCO,gemGrab,Undermine,9,3,12
4813,2023-01-05,POCO,gemGrab,Gem Fort,5,6,11
4814,2023-01-05,POCO,brawlBall,Sunny Soccer,1,0,1
4815,2023-01-05,POCO,brawlBall,Pinhole Punt,108,72,180
4816,2023-01-05,POCO,bounty,Shooting Star,0,1,1
4817,2023-01-04,POCO,hotZone,Parallel Plays,15,4,19
4818,2023-01-04,POCO,heist,Kaboom Canyon,3,0,3
4819,2023-01-04,POCO,gemGrab,Gem Fort,44,40,84
4820,2023-01-04,POCO,gemGrab,Crystal Arcade,8,13,21
4821,2023-01-04,POCO,brawlBall,Sunny Soccer,43,48,91
4822,2023-01-04,POCO,brawlBall,Beach Ball,1,1,2
4823,2023-01-04,POCO,bounty,Shooting Star,3,11,14
4824,2023-01-03,POCO,knockout,Goldarm Gulch,1,0,1
4825,2023-01-03,POCO,hotZone,Parallel Plays,23,26,49
4826,2023-01-03,POCO,heist,Pit Stop,0,1,1
4827,2023-01-03,POCO,gemGrab,Minecart Madness,4,0,4
4828,2023-01-03,POCO,gemGrab,Crystal Arcade,31,6,37
4829,2023-01-03,POCO,brawlBall,Center Stage,1,0,1
4830,2023-01-03,POCO,brawlBall,Beach Ball,44,37,81
4831,2023-01-03,POCO,bounty,Hideout,1,0,1
4832,2023-01-02,POCO,knockout,Belle's Rock,1,0,1
4833,2023-01-02,POCO,hotZone,Quarter Pounder,67,74,141
4834,2023-01-02,POCO,hotZone,Controller Chaos,0,2,2
4835,2023-01-02,POCO,heist,Pit Stop,0,1,1
4836,2023-01-02,POCO,gemGrab,Minecart Madness,26,7,33
4837,2023-01-02,POCO,gemGrab,Double Swoosh,24,16,40
4838,2023-01-02,POCO,brawlBall,Center Stage,64,70,134
4839,2023-01-02,POCO,brawlBall,Backyard Bowl,2,1,3
4840,2023-01-02,POCO,bounty,Hideout,3,0,3
4841,2023-01-01,POCO,knockout,Belle's Rock,1,0,1
4842,2023-01-01,POCO,hotZone,Quarter Pounder,11,1,12
4843,2023-01-01,POCO,heist,Bridge Too Far,1,0,1
4844,2023-01-01,POCO,gemGrab,Minecart Madness,1,0,1
4845,2023-01-01,POCO,gemGrab,Double Swoosh,15,14,29
4846,2023-01-01,POCO,brawlBall,Backyard Bowl,11,4,15
4847,2023-01-01,POCO,bounty,Canal Grande,3,3,6
4848,2022-12-31,POCO,hotZone,Controller Chaos,7,2,9
4849,2022-12-31,POCO,gemGrab,Hard Rock Mine,3,1,4
4850,2022-12-31,POCO,gemGrab,Deep Diner,2,0,2
4851,2022-12-31,POCO,brawlBall,Super Beach,7,3,10
4852,2022-12-31,POCO,brawlBall,Sneaky Fields,0,1,1
4853,2022-12-31,POCO,bounty,Canal Grande,1,0,1
4854,2022-12-30,POCO,hotZone,Controller Chaos,5,2,7
4855,2022-12-30,POCO,gemGrab,Deep Diner,5,3,8
4856,2022-12-30,POCO,brawlBall,Sneaky Fields,4,5,9
4857,2022-12-29,POCO,hotZone,Open Zone,1,2,3
4858,2022-12-29,POCO,gemGrab,Gem Fort,1,0,1
4859,2022-12-29,POCO,brawlBall,Pinhole Punt,3,1,4
4860,2022-12-28,POCO,hotZone,Open Zone,4,3,7
4861,2022-12-27,POCO,hotZone,Dueling Beetles,2,0,2
4862,2022-12-26,POCO,brawlBall,Center Stage,1,0,1
4863,2022-12-24,POCO,brawlBall,Super Beach,0,1,1
4864,2022-12-23,POCO,knockout,Out in the Open,0,2,2
4865,2022-12-23,POCO,gemGrab,Deep Diner,1,0,1
4866,2022-12-23,POCO,brawlBall,Sneaky Fields,0,1,1
4867,2022-12-22,POCO,gemGrab,Gem Fort,3,0,3
4868,2022-12-22,POCO,brawlBall,Pinhole Punt,4,0,4
4869,2022-12-21,POCO,brawlBall,Sunny Soccer,1,0,1
4870,2022-12-19,POCO,gemGrab,Minecart Madness,2,0,2
4871,2022-12-16,POCO,hotZone,Controller Chaos,1,0,1
4872,2022-12-15,POCO,heist,Hot Potato,0,2,2
4873,2022-12-13,POCO,knockout,New Perspective,1,0,1
4874,2022-12-13,POCO,heist,Safe Zone,2,0,2
4875,2022-12-11,POCO,gemGrab,Double Swoosh,0,2,2
4876,2022-12-10,POCO,gemGrab,Hard Rock Mine,0,1,1
4877,2022-11-11,POCO,brawlBall,Sneaky Fields,0,2,2
4878,2022-10-30,POCO,bounty,Canal Grande,1,0,1
4879,2022-10-28,POCO,knockout,Out in the Open,2,0,2
4880,2022-10-15,POCO,hotZone,Ring of Fire,1,2,3
4881,2022-10-15,POCO,gemGrab,Hard Rock Mine,0,3,3
4882,2022-10-10,POCO,knockout,Belle's Rock,1,0,1
4883,2022-09-07,POCO,brawlBall,Pinhole Punt,0,2,2
4884,2022-09-06,POCO,brawlBall,Beach Ball,2,2,4
4885,2023-02-11,PIPER,knockout,Flaring Phoenix,191,159,350
4886,2023-02-11,PIPER,hotZone,Controller Chaos,7,3,10
4887,2023-02-11,PIPER,gemGrab,Deep Diner,76,26,102
4888,2023-02-11,PIPER,brawlBall,Super Beach,22,10,32
4889,2023-02-11,PIPER,brawlBall,Sneaky Fields,11,4,15
4890,2023-02-10,PIPER,knockout,Flaring Phoenix,396,312,708
4891,2023-02-10,PIPER,hotZone,Controller Chaos,18,4,22
4892,2023-02-10,PIPER,heist,Hot Potato,14,2,16
4893,2023-02-10,PIPER,gemGrab,Undermine,35,37,72
4894,2023-02-10,PIPER,gemGrab,Deep Diner,237,236,473
4895,2023-02-10,PIPER,brawlBall,Sneaky Fields,101,88,189
4896,2023-02-10,PIPER,brawlBall,Pinhole Punt,7,4,11
4897,2023-02-10,PIPER,bounty,Temple Ruins,139,115,254
4898,2023-02-09,PIPER,knockout,Riverside,206,220,426
4899,2023-02-09,PIPER,hotZone,Open Zone,6,4,10
4900,2023-02-09,PIPER,heist,Hot Potato,5,3,8
4901,2023-02-09,PIPER,gemGrab,Undermine,45,48,93
4902,2023-02-09,PIPER,gemGrab,Gem Fort,1,1,2
4903,2023-02-09,PIPER,brawlBall,Pinhole Punt,52,44,96
4904,2023-02-09,PIPER,bounty,Temple Ruins,51,32,83
4905,2023-02-08,PIPER,knockout,Riverside,166,203,369
4906,2023-02-08,PIPER,hotZone,Open Zone,8,2,10
4907,2023-02-08,PIPER,heist,Safe Zone,17,32,49
4908,2023-02-08,PIPER,gemGrab,Gem Fort,7,8,15
4909,2023-02-08,PIPER,gemGrab,Crystal Arcade,1,3,4
4910,2023-02-08,PIPER,brawlBall,Sunny Soccer,3,5,8
4911,2023-02-08,PIPER,brawlBall,Beach Ball,1,1,2
4912,2023-02-08,PIPER,bounty,Excel,11,7,18
4913,2023-02-07,PIPER,knockout,New Perspective,14,16,30
4914,2023-02-07,PIPER,hotZone,Dueling Beetles,1,0,1
4915,2023-02-07,PIPER,heist,Safe Zone,11,8,19
4916,2023-02-07,PIPER,gemGrab,Minecart Madness,28,31,59
4917,2023-02-07,PIPER,gemGrab,Crystal Arcade,8,3,11
4918,2023-02-07,PIPER,brawlBall,Center Stage,1,0,1
4919,2023-02-07,PIPER,brawlBall,Beach Ball,4,1,5
4920,2023-02-07,PIPER,bounty,Excel,1,2,3
4921,2023-02-06,PIPER,knockout,New Perspective,401,335,736
4922,2023-02-06,PIPER,knockout,Goldarm Gulch,20,10,30
4923,2023-02-06,PIPER,hotZone,Dueling Beetles,31,6,37
4924,2023-02-06,PIPER,heist,Snaked Assault,17,1,18
4925,2023-02-06,PIPER,gemGrab,Minecart Madness,343,305,648
4926,2023-02-06,PIPER,gemGrab,Double Swoosh,36,17,53
4927,2023-02-06,PIPER,brawlBall,Center Stage,79,51,130
4928,2023-02-06,PIPER,brawlBall,Backyard Bowl,138,192,330
4929,2023-02-06,PIPER,bounty,Layer Cake,164,155,319
4930,2023-02-05,PIPER,knockout,X Marks the Spot,294,226,520
4931,2023-02-05,PIPER,knockout,Goldarm Gulch,104,83,187
4932,2023-02-05,PIPER,hotZone,Ring of Fire,38,18,56
4933,2023-02-05,PIPER,heist,Snaked Assault,40,19,59
4934,2023-02-05,PIPER,gemGrab,Hard Rock Mine,47,39,86
4935,2023-02-05,PIPER,gemGrab,Double Swoosh,90,77,167
4936,2023-02-05,PIPER,brawlBall,Super Beach,0,1,1
4937,2023-02-05,PIPER,brawlBall,Sneaky Fields,1,0,1
4938,2023-02-05,PIPER,brawlBall,Backyard Bowl,1804,1702,3506
4939,2023-02-05,PIPER,bounty,Layer Cake,178,163,341
4940,2023-02-04,PIPER,knockout,X Marks the Spot,119,132,251
4941,2023-02-04,PIPER,knockout,Goldarm Gulch,64,40,104
4942,2023-02-04,PIPER,hotZone,Ring of Fire,10,7,17
4943,2023-02-04,PIPER,heist,Tornado Ring,2,3,5
4944,2023-02-04,PIPER,gemGrab,Hard Rock Mine,81,89,170
4945,2023-02-04,PIPER,gemGrab,Double Swoosh,4,4,8
4946,2023-02-04,PIPER,gemGrab,Deep Diner,8,16,24
4947,2023-02-04,PIPER,brawlBall,Super Beach,37,25,62
4948,2023-02-04,PIPER,bounty,Dry Season,96,79,175
4949,2023-02-03,PIPER,knockout,Out in the Open,557,518,1075
4950,2023-02-03,PIPER,knockout,Goldarm Gulch,363,338,701
4951,2023-02-03,PIPER,hotZone,Split,6,3,9
4952,2023-02-03,PIPER,heist,Tornado Ring,18,11,29
4953,2023-02-03,PIPER,heist,Pit Stop,1,0,1
4954,2023-02-03,PIPER,gemGrab,Undermine,53,90,143
4955,2023-02-03,PIPER,gemGrab,Double Swoosh,19,31,50
4956,2023-02-03,PIPER,gemGrab,Deep Diner,131,115,246
4957,2023-02-03,PIPER,brawlBall,Sneaky Fields,74,68,142
4958,2023-02-03,PIPER,brawlBall,Pinhole Punt,10,8,18
4959,2023-02-03,PIPER,bounty,Dry Season,600,571,1171
4960,2023-02-02,PIPER,knockout,Out in the Open,234,198,432
4961,2023-02-02,PIPER,hotZone,Split,2,3,5
4962,2023-02-02,PIPER,heist,Kaboom Canyon,18,21,39
4963,2023-02-02,PIPER,gemGrab,Undermine,36,43,79
4964,2023-02-02,PIPER,gemGrab,Gem Fort,5,2,7
4965,2023-02-02,PIPER,brawlBall,Sunny Soccer,1,0,1
4966,2023-02-02,PIPER,brawlBall,Pinhole Punt,55,49,104
4967,2023-02-02,PIPER,bounty,Shooting Star,193,210,403
4968,2023-02-01,PIPER,knockout,Goldarm Gulch,417,327,744
4969,2023-02-01,PIPER,hotZone,Parallel Plays,15,7,22
4970,2023-02-01,PIPER,heist,Kaboom Canyon,90,89,179
4971,2023-02-01,PIPER,gemGrab,Gem Fort,61,35,96
4972,2023-02-01,PIPER,gemGrab,Crystal Arcade,69,72,141
4973,2023-02-01,PIPER,brawlBall,Sunny Soccer,50,47,97
4974,2023-02-01,PIPER,brawlBall,Beach Ball,6,0,6
4975,2023-02-01,PIPER,bounty,Shooting Star,431,416,847
4976,2023-01-31,PIPER,knockout,Goldarm Gulch,158,113,271
4977,2023-01-31,PIPER,hotZone,Parallel Plays,6,5,11
4978,2023-01-31,PIPER,gemGrab,Minecart Madness,15,16,31
4979,2023-01-31,PIPER,gemGrab,Crystal Arcade,74,64,138
4980,2023-01-31,PIPER,brawlBall,Center Stage,2,2,4
4981,2023-01-31,PIPER,brawlBall,Beach Ball,27,30,57
4982,2023-01-31,PIPER,bounty,Hideout,114,112,226
4983,2023-01-30,PIPER,knockout,Belle's Rock,463,445,908
4984,2023-01-30,PIPER,hotZone,Quarter Pounder,26,22,48
4985,2023-01-30,PIPER,heist,Pit Stop,2,2,4
4986,2023-01-30,PIPER,gemGrab,Minecart Madness,200,290,490
4987,2023-01-30,PIPER,gemGrab,Double Swoosh,31,33,64
4988,2023-01-30,PIPER,brawlBall,Center Stage,49,17,66
4989,2023-01-30,PIPER,brawlBall,Backyard Bowl,110,112,222
4990,2023-01-30,PIPER,bounty,Hideout,211,222,433
4991,2023-01-29,PIPER,knockout,Belle's Rock,466,483,949
4992,2023-01-29,PIPER,hotZone,Quarter Pounder,33,16,49
4993,2023-01-29,PIPER,heist,Bridge Too Far,382,313,695
4994,2023-01-29,PIPER,gemGrab,Hard Rock Mine,29,53,82
4995,2023-01-29,PIPER,gemGrab,Double Swoosh,69,40,109
4996,2023-01-29,PIPER,brawlBall,Super Beach,2,1,3
4997,2023-01-29,PIPER,brawlBall,Backyard Bowl,1189,1147,2336
4998,2023-01-29,PIPER,bounty,Canal Grande,34,54,88
4999,2023-01-28,PIPER,knockout,Flaring Phoenix,214,147,361
5000,2023-01-28,PIPER,hotZone,Controller Chaos,12,1,13
5001,2023-01-28,PIPER,heist,Bridge Too Far,884,855,1739
5002,2023-01-28,PIPER,gemGrab,Hard Rock Mine,253,279,532
5003,2023-01-28,PIPER,gemGrab,Deep Diner,46,54,100
5004,2023-01-28,PIPER,brawlBall,Super Beach,86,66,152
5005,2023-01-28,PIPER,brawlBall,Sneaky Fields,3,0,3
5006,2023-01-28,PIPER,bounty,Canal Grande,66,33,99
5007,2023-01-27,PIPER,knockout,Flaring Phoenix,91,87,178
5008,2023-01-27,PIPER,hotZone,Controller Chaos,4,2,6
5009,2023-01-27,PIPER,heist,Hot Potato,13,4,17
5010,2023-01-27,PIPER,gemGrab,Undermine,11,9,20
5011,2023-01-27,PIPER,gemGrab,Deep Diner,67,58,125
5012,2023-01-27,PIPER,brawlBall,Sneaky Fields,14,11,25
5013,2023-01-27,PIPER,brawlBall,Pinhole Punt,6,8,14
5014,2023-01-27,PIPER,bounty,Temple Ruins,34,37,71
5015,2023-01-26,PIPER,knockout,Riverside,1499,1593,3092
5016,2023-01-26,PIPER,hotZone,Open Zone,75,47,122
5017,2023-01-26,PIPER,heist,Hot Potato,15,22,37
5018,2023-01-26,PIPER,gemGrab,Undermine,127,148,275
5019,2023-01-26,PIPER,gemGrab,Gem Fort,13,9,22
5020,2023-01-26,PIPER,brawlBall,Sunny Soccer,6,2,8
5021,2023-01-26,PIPER,brawlBall,Pinhole Punt,172,99,271
5022,2023-01-26,PIPER,bounty,Temple Ruins,104,84,188
5023,2023-01-25,PIPER,knockout,Riverside,785,833,1618
5024,2023-01-25,PIPER,hotZone,Open Zone,33,15,48
5025,2023-01-25,PIPER,heist,Safe Zone,169,143,312
5026,2023-01-25,PIPER,gemGrab,Gem Fort,29,17,46
5027,2023-01-25,PIPER,gemGrab,Crystal Arcade,73,74,147
5028,2023-01-25,PIPER,brawlBall,Sunny Soccer,26,20,46
5029,2023-01-25,PIPER,brawlBall,Beach Ball,12,6,18
5030,2023-01-25,PIPER,bounty,Excel,45,64,109
5031,2023-01-24,PIPER,knockout,New Perspective,267,251,518
5032,2023-01-24,PIPER,hotZone,Dueling Beetles,20,3,23
5033,2023-01-24,PIPER,heist,Safe Zone,307,229,536
5034,2023-01-24,PIPER,gemGrab,Minecart Madness,74,104,178
5035,2023-01-24,PIPER,gemGrab,Crystal Arcade,177,168,345
5036,2023-01-24,PIPER,brawlBall,Center Stage,2,7,9
5037,2023-01-24,PIPER,brawlBall,Beach Ball,67,44,111
5038,2023-01-24,PIPER,bounty,Excel,73,50,123
5039,2023-01-23,PIPER,knockout,New Perspective,393,329,722
5040,2023-01-23,PIPER,hotZone,Dueling Beetles,28,24,52
5041,2023-01-23,PIPER,heist,Snaked Assault,26,8,34
5042,2023-01-23,PIPER,gemGrab,Minecart Madness,310,358,668
5043,2023-01-23,PIPER,gemGrab,Double Swoosh,40,48,88
5044,2023-01-23,PIPER,brawlBall,Center Stage,89,52,141
5045,2023-01-23,PIPER,brawlBall,Backyard Bowl,66,70,136
5046,2023-01-23,PIPER,bounty,Layer Cake,146,154,300
5047,2023-01-22,PIPER,knockout,X Marks the Spot,263,224,487
5048,2023-01-22,PIPER,hotZone,Ring of Fire,21,4,25
5049,2023-01-22,PIPER,heist,Snaked Assault,5,4,9
5050,2023-01-22,PIPER,gemGrab,Hard Rock Mine,65,94,159
5051,2023-01-22,PIPER,gemGrab,Double Swoosh,38,30,68
5052,2023-01-22,PIPER,brawlBall,Super Beach,6,2,8
5053,2023-01-22,PIPER,brawlBall,Backyard Bowl,649,583,1232
5054,2023-01-22,PIPER,bounty,Layer Cake,90,98,188
5055,2023-01-21,PIPER,knockout,X Marks the Spot,818,821,1639
5056,2023-01-21,PIPER,hotZone,Ring of Fire,76,31,107
5057,2023-01-21,PIPER,heist,Tornado Ring,21,6,27
5058,2023-01-21,PIPER,gemGrab,Hard Rock Mine,354,350,704
5059,2023-01-21,PIPER,gemGrab,Deep Diner,42,14,56
5060,2023-01-21,PIPER,brawlBall,Super Beach,125,95,220
5061,2023-01-21,PIPER,brawlBall,Sneaky Fields,1,0,1
5062,2023-01-21,PIPER,bounty,Dry Season,476,463,939
5063,2023-01-20,PIPER,knockout,Out in the Open,677,578,1255
5064,2023-01-20,PIPER,hotZone,Split,5,2,7
5065,2023-01-20,PIPER,heist,Tornado Ring,10,8,18
5066,2023-01-20,PIPER,gemGrab,Undermine,53,44,97
5067,2023-01-20,PIPER,gemGrab,Deep Diner,147,120,267
5068,2023-01-20,PIPER,brawlBall,Sneaky Fields,55,39,94
5069,2023-01-20,PIPER,brawlBall,Pinhole Punt,9,10,19
5070,2023-01-20,PIPER,bounty,Dry Season,380,323,703
5071,2023-01-19,PIPER,knockout,Out in the Open,799,683,1482
5072,2023-01-19,PIPER,hotZone,Split,6,3,9
5073,2023-01-19,PIPER,heist,Kaboom Canyon,55,67,122
5074,2023-01-19,PIPER,gemGrab,Undermine,169,209,378
5075,2023-01-19,PIPER,gemGrab,Gem Fort,14,6,20
5076,2023-01-19,PIPER,brawlBall,Sunny Soccer,2,1,3
5077,2023-01-19,PIPER,brawlBall,Pinhole Punt,180,124,304
5078,2023-01-19,PIPER,bounty,Shooting Star,546,557,1103
5079,2023-01-18,PIPER,knockout,Goldarm Gulch,47,33,80
5080,2023-01-18,PIPER,hotZone,Parallel Plays,0,2,2
5081,2023-01-18,PIPER,heist,Kaboom Canyon,21,16,37
5082,2023-01-18,PIPER,gemGrab,Gem Fort,12,6,18
5083,2023-01-18,PIPER,gemGrab,Crystal Arcade,4,4,8
5084,2023-01-18,PIPER,brawlBall,Sunny Soccer,28,14,42
5085,2023-01-18,PIPER,bounty,Shooting Star,255,261,516
5086,2023-01-17,PIPER,knockout,Goldarm Gulch,68,54,122
5087,2023-01-17,PIPER,hotZone,Parallel Plays,2,0,2
5088,2023-01-17,PIPER,gemGrab,Minecart Madness,6,1,7
5089,2023-01-17,PIPER,gemGrab,Crystal Arcade,12,8,20
5090,2023-01-17,PIPER,brawlBall,Beach Ball,7,2,9
5091,2023-01-17,PIPER,bounty,Hideout,32,39,71
5092,2023-01-16,PIPER,knockout,Belle's Rock,49,61,110
5093,2023-01-16,PIPER,hotZone,Quarter Pounder,2,1,3
5094,2023-01-16,PIPER,heist,Pit Stop,1,0,1
5095,2023-01-16,PIPER,gemGrab,Minecart Madness,26,28,54
5096,2023-01-16,PIPER,gemGrab,Double Swoosh,1,0,1
5097,2023-01-16,PIPER,brawlBall,Center Stage,5,0,5
5098,2023-01-16,PIPER,brawlBall,Backyard Bowl,8,9,17
5099,2023-01-16,PIPER,bounty,Hideout,56,52,108
5100,2023-01-15,PIPER,knockout,Belle's Rock,58,102,160
5101,2023-01-15,PIPER,hotZone,Quarter Pounder,7,14,21
5102,2023-01-15,PIPER,heist,Bridge Too Far,106,104,210
5103,2023-01-15,PIPER,gemGrab,Hard Rock Mine,18,17,35
5104,2023-01-15,PIPER,gemGrab,Double Swoosh,10,3,13
5105,2023-01-15,PIPER,brawlBall,Super Beach,0,1,1
5106,2023-01-15,PIPER,brawlBall,Backyard Bowl,150,180,330
5107,2023-01-15,PIPER,bounty,Canal Grande,7,4,11
5108,2023-01-14,PIPER,knockout,Flaring Phoenix,23,5,28
5109,2023-01-14,PIPER,hotZone,Controller Chaos,1,1,2
5110,2023-01-14,PIPER,heist,Bridge Too Far,161,133,294
5111,2023-01-14,PIPER,gemGrab,Hard Rock Mine,16,23,39
5112,2023-01-14,PIPER,gemGrab,Deep Diner,7,11,18
5113,2023-01-14,PIPER,brawlBall,Super Beach,4,8,12
5114,2023-01-14,PIPER,bounty,Canal Grande,6,0,6
5115,2023-01-13,PIPER,knockout,Flaring Phoenix,13,3,16
5116,2023-01-13,PIPER,hotZone,Controller Chaos,1,6,7
5117,2023-01-13,PIPER,gemGrab,Deep Diner,18,13,31
5118,2023-01-13,PIPER,brawlBall,Sneaky Fields,8,2,10
5119,2023-01-13,PIPER,bounty,Temple Ruins,6,6,12
5120,2023-01-12,PIPER,knockout,Riverside,220,238,458
5121,2023-01-12,PIPER,hotZone,Open Zone,13,15,28
5122,2023-01-12,PIPER,gemGrab,Undermine,14,21,35
5123,2023-01-12,PIPER,brawlBall,Pinhole Punt,8,3,11
5124,2023-01-12,PIPER,bounty,Temple Ruins,1,0,1
5125,2023-01-11,PIPER,knockout,Riverside,68,73,141
5126,2023-01-11,PIPER,hotZone,Open Zone,0,1,1
5127,2023-01-11,PIPER,brawlBall,Sunny Soccer,1,0,1
5128,2023-01-11,PIPER,bounty,Excel,1,1,2
5129,2023-01-10,PIPER,knockout,New Perspective,23,13,36
5130,2023-01-10,PIPER,hotZone,Dueling Beetles,1,0,1
5131,2023-01-10,PIPER,heist,Safe Zone,30,37,67
5132,2023-01-10,PIPER,gemGrab,Minecart Madness,16,33,49
5133,2023-01-10,PIPER,gemGrab,Crystal Arcade,22,16,38
5134,2023-01-10,PIPER,brawlBall,Beach Ball,6,7,13
5135,2023-01-10,PIPER,bounty,Excel,4,0,4
5136,2023-01-09,PIPER,knockout,New Perspective,15,7,22
5137,2023-01-09,PIPER,hotZone,Dueling Beetles,1,1,2
5138,2023-01-09,PIPER,heist,Snaked Assault,2,1,3
5139,2023-01-09,PIPER,gemGrab,Minecart Madness,46,37,83
5140,2023-01-09,PIPER,gemGrab,Double Swoosh,4,1,5
5141,2023-01-09,PIPER,brawlBall,Center Stage,10,0,10
5142,2023-01-09,PIPER,brawlBall,Backyard Bowl,4,8,12
5143,2023-01-09,PIPER,bounty,Layer Cake,15,14,29
5144,2023-01-08,PIPER,knockout,X Marks the Spot,47,32,79
5145,2023-01-08,PIPER,hotZone,Ring of Fire,10,12,22
5146,2023-01-08,PIPER,heist,Snaked Assault,7,10,17
5147,2023-01-08,PIPER,gemGrab,Hard Rock Mine,9,20,29
5148,2023-01-08,PIPER,gemGrab,Double Swoosh,3,1,4
5149,2023-01-08,PIPER,brawlBall,Super Beach,0,1,1
5150,2023-01-08,PIPER,brawlBall,Backyard Bowl,126,119,245
5151,2023-01-08,PIPER,bounty,Layer Cake,4,2,6
5152,2023-01-07,PIPER,knockout,X Marks the Spot,54,56,110
5153,2023-01-07,PIPER,hotZone,Ring of Fire,4,1,5
5154,2023-01-07,PIPER,heist,Tornado Ring,0,1,1
5155,2023-01-07,PIPER,gemGrab,Hard Rock Mine,17,5,22
5156,2023-01-07,PIPER,gemGrab,Deep Diner,14,14,28
5157,2023-01-07,PIPER,brawlBall,Super Beach,4,0,4
5158,2023-01-07,PIPER,bounty,Dry Season,36,41,77
5159,2023-01-06,PIPER,knockout,Out in the Open,61,56,117
5160,2023-01-06,PIPER,hotZone,Split,4,0,4
5161,2023-01-06,PIPER,heist,Tornado Ring,2,0,2
5162,2023-01-06,PIPER,gemGrab,Undermine,13,15,28
5163,2023-01-06,PIPER,gemGrab,Deep Diner,25,17,42
5164,2023-01-06,PIPER,brawlBall,Sneaky Fields,7,1,8
5165,2023-01-06,PIPER,brawlBall,Pinhole Punt,4,7,11
5166,2023-01-06,PIPER,bounty,Dry Season,70,48,118
5167,2023-01-05,PIPER,knockout,Out in the Open,81,84,165
5168,2023-01-05,PIPER,heist,Kaboom Canyon,8,21,29
5169,2023-01-05,PIPER,gemGrab,Undermine,45,31,76
5170,2023-01-05,PIPER,brawlBall,Pinhole Punt,23,14,37
5171,2023-01-05,PIPER,bounty,Shooting Star,82,93,175
5172,2023-01-04,PIPER,knockout,Goldarm Gulch,14,6,20
5173,2023-01-04,PIPER,hotZone,Parallel Plays,1,1,2
5174,2023-01-04,PIPER,heist,Kaboom Canyon,34,28,62
5175,2023-01-04,PIPER,gemGrab,Gem Fort,1,0,1
5176,2023-01-04,PIPER,gemGrab,Crystal Arcade,6,2,8
5177,2023-01-04,PIPER,brawlBall,Sunny Soccer,2,2,4
5178,2023-01-04,PIPER,bounty,Shooting Star,197,175,372
5179,2023-01-03,PIPER,knockout,Goldarm Gulch,13,14,27
5180,2023-01-03,PIPER,hotZone,Parallel Plays,2,0,2
5181,2023-01-03,PIPER,heist,Kaboom Canyon,0,1,1
5182,2023-01-03,PIPER,gemGrab,Minecart Madness,5,11,16
5183,2023-01-03,PIPER,gemGrab,Crystal Arcade,21,17,38
5184,2023-01-03,PIPER,brawlBall,Center Stage,1,0,1
5185,2023-01-03,PIPER,brawlBall,Beach Ball,8,1,9
5186,2023-01-03,PIPER,bounty,Hideout,77,73,150
5187,2023-01-02,PIPER,knockout,Belle's Rock,51,83,134
5188,2023-01-02,PIPER,hotZone,Quarter Pounder,7,10,17
5189,2023-01-02,PIPER,heist,Pit Stop,2,0,2
5190,2023-01-02,PIPER,heist,Kaboom Canyon,1,0,1
5191,2023-01-02,PIPER,gemGrab,Minecart Madness,46,36,82
5192,2023-01-02,PIPER,gemGrab,Double Swoosh,2,1,3
5193,2023-01-02,PIPER,brawlBall,Center Stage,9,7,16
5194,2023-01-02,PIPER,brawlBall,Backyard Bowl,3,11,14
5195,2023-01-02,PIPER,bounty,Hideout,105,126,231
5196,2023-01-01,PIPER,knockout,Belle's Rock,42,64,106
5197,2023-01-01,PIPER,hotZone,Quarter Pounder,2,0,2
5198,2023-01-01,PIPER,heist,Bridge Too Far,20,11,31
5199,2023-01-01,PIPER,gemGrab,Hard Rock Mine,2,2,4
5200,2023-01-01,PIPER,gemGrab,Double Swoosh,3,0,3
5201,2023-01-01,PIPER,brawlBall,Backyard Bowl,66,47,113
5202,2023-01-01,PIPER,bounty,Canal Grande,2,0,2
5203,2022-12-31,PIPER,heist,Bridge Too Far,14,17,31
5204,2022-12-31,PIPER,gemGrab,Hard Rock Mine,3,1,4
5205,2022-12-31,PIPER,gemGrab,Deep Diner,4,1,5
5206,2022-12-31,PIPER,brawlBall,Super Beach,0,1,1
5207,2022-12-31,PIPER,bounty,Canal Grande,0,1,1
5208,2022-12-30,PIPER,knockout,Flaring Phoenix,6,8,14
5209,2022-12-30,PIPER,gemGrab,Deep Diner,2,1,3
5210,2022-12-30,PIPER,brawlBall,Sneaky Fields,1,0,1
5211,2022-12-29,PIPER,gemGrab,Undermine,1,1,2
5212,2022-12-29,PIPER,gemGrab,Minecart Madness,1,2,3
5213,2022-12-29,PIPER,gemGrab,Gem Fort,1,2,3
5214,2022-12-29,PIPER,brawlBall,Pinhole Punt,0,1,1
5215,2022-12-27,PIPER,knockout,New Perspective,1,1,2
5216,2022-12-27,PIPER,brawlBall,Beach Ball,0,1,1
5217,2022-12-26,PIPER,heist,Kaboom Canyon,0,2,2
5218,2022-12-26,PIPER,gemGrab,Minecart Madness,1,5,6
5219,2022-12-26,PIPER,brawlBall,Center Stage,1,2,3
5220,2022-12-25,PIPER,brawlBall,Backyard Bowl,3,12,15
5221,2022-12-25,PIPER,bounty,Layer Cake,0,2,2
5222,2022-12-24,PIPER,bounty,Dry Season,1,1,2
5223,2022-12-23,PIPER,knockout,Out in the Open,6,4,10
5224,2022-12-21,PIPER,bounty,Shooting Star,1,1,2
5225,2022-12-20,PIPER,brawlBall,Beach Ball,1,0,1
5226,2022-12-19,PIPER,gemGrab,Minecart Madness,0,2,2
5227,2022-12-18,PIPER,heist,Bridge Too Far,1,1,2
5228,2022-12-17,PIPER,knockout,Flaring Phoenix,1,0,1
5229,2022-12-16,PIPER,bounty,Temple Ruins,2,0,2
5230,2022-12-13,PIPER,knockout,New Perspective,1,0,1
5231,2022-11-11,PIPER,knockout,New Perspective,2,0,2
5232,2022-11-01,PIPER,knockout,New Perspective,4,8,12
5233,2022-10-30,PIPER,knockout,Out in the Open,1,0,1
5234,2022-10-28,PIPER,knockout,Out in the Open,2,2,4
5235,2022-10-26,PIPER,bounty,Shooting Star,4,2,6
5236,2022-10-15,PIPER,gemGrab,Hard Rock Mine,1,2,3
5237,2022-10-10,PIPER,knockout,Belle's Rock,0,2,2
5238,2023-02-11,PENNY,knockout,Flaring Phoenix,57,71,128
5239,2023-02-11,PENNY,hotZone,Controller Chaos,99,83,182
5240,2023-02-11,PENNY,gemGrab,Deep Diner,108,122,230
5241,2023-02-11,PENNY,brawlBall,Super Beach,55,90,145
5242,2023-02-11,PENNY,brawlBall,Sneaky Fields,17,21,38
5243,2023-02-10,PENNY,knockout,Flaring Phoenix,169,186,355
5244,2023-02-10,PENNY,hotZone,Controller Chaos,168,204,372
5245,2023-02-10,PENNY,heist,Hot Potato,55,30,85
5246,2023-02-10,PENNY,gemGrab,Undermine,35,58,93
5247,2023-02-10,PENNY,gemGrab,Deep Diner,305,376,681
5248,2023-02-10,PENNY,brawlBall,Sneaky Fields,229,237,466
5249,2023-02-10,PENNY,brawlBall,Pinhole Punt,6,7,13
5250,2023-02-10,PENNY,bounty,Temple Ruins,34,40,74
5251,2023-02-09,PENNY,knockout,Riverside,12,1,13
5252,2023-02-09,PENNY,hotZone,Open Zone,24,19,43
5253,2023-02-09,PENNY,heist,Hot Potato,26,7,33
5254,2023-02-09,PENNY,gemGrab,Undermine,25,37,62
5255,2023-02-09,PENNY,gemGrab,Gem Fort,3,3,6
5256,2023-02-09,PENNY,brawlBall,Sunny Soccer,0,1,1
5257,2023-02-09,PENNY,brawlBall,Pinhole Punt,92,101,193
5258,2023-02-09,PENNY,bounty,Temple Ruins,20,25,45
5259,2023-02-08,PENNY,knockout,Riverside,1,4,5
5260,2023-02-08,PENNY,hotZone,Open Zone,22,26,48
5261,2023-02-08,PENNY,heist,Safe Zone,17,9,26
5262,2023-02-08,PENNY,gemGrab,Gem Fort,10,2,12
5263,2023-02-08,PENNY,gemGrab,Crystal Arcade,9,6,15
5264,2023-02-08,PENNY,brawlBall,Sunny Soccer,21,18,39
5265,2023-02-08,PENNY,brawlBall,Beach Ball,3,2,5
5266,2023-02-08,PENNY,bounty,Excel,8,9,17
5267,2023-02-07,PENNY,knockout,New Perspective,5,4,9
5268,2023-02-07,PENNY,hotZone,Dueling Beetles,66,128,194
5269,2023-02-07,PENNY,heist,Safe Zone,10,4,14
5270,2023-02-07,PENNY,gemGrab,Minecart Madness,13,28,41
5271,2023-02-07,PENNY,gemGrab,Crystal Arcade,7,6,13
5272,2023-02-07,PENNY,brawlBall,Center Stage,1,1,2
5273,2023-02-07,PENNY,brawlBall,Beach Ball,10,23,33
5274,2023-02-07,PENNY,bounty,Excel,7,5,12
5275,2023-02-06,PENNY,knockout,New Perspective,104,83,187
5276,2023-02-06,PENNY,knockout,Goldarm Gulch,11,17,28
5277,2023-02-06,PENNY,hotZone,Dueling Beetles,982,1354,2336
5278,2023-02-06,PENNY,heist,Snaked Assault,78,75,153
5279,2023-02-06,PENNY,heist,Pit Stop,8,5,13
5280,2023-02-06,PENNY,gemGrab,Minecart Madness,268,317,585
5281,2023-02-06,PENNY,gemGrab,Double Swoosh,153,273,426
5282,2023-02-06,PENNY,brawlBall,Sneaky Fields,4,1,5
5283,2023-02-06,PENNY,brawlBall,Center Stage,192,224,416
5284,2023-02-06,PENNY,brawlBall,Backyard Bowl,41,43,84
5285,2023-02-06,PENNY,bounty,Layer Cake,136,149,285
5286,2023-02-05,PENNY,knockout,X Marks the Spot,40,36,76
5287,2023-02-05,PENNY,knockout,Goldarm Gulch,23,35,58
5288,2023-02-05,PENNY,hotZone,Ring of Fire,267,354,621
5289,2023-02-05,PENNY,heist,Snaked Assault,128,100,228
5290,2023-02-05,PENNY,heist,Pit Stop,52,11,63
5291,2023-02-05,PENNY,gemGrab,Hard Rock Mine,55,73,128
5292,2023-02-05,PENNY,gemGrab,Double Swoosh,398,646,1044
5293,2023-02-05,PENNY,brawlBall,Super Beach,5,16,21
5294,2023-02-05,PENNY,brawlBall,Sneaky Fields,19,21,40
5295,2023-02-05,PENNY,brawlBall,Backyard Bowl,377,590,967
5296,2023-02-05,PENNY,bounty,Layer Cake,160,223,383
5297,2023-02-04,PENNY,knockout,X Marks the Spot,17,15,32
5298,2023-02-04,PENNY,knockout,Goldarm Gulch,20,20,40
5299,2023-02-04,PENNY,hotZone,Ring of Fire,64,89,153
5300,2023-02-04,PENNY,heist,Tornado Ring,23,13,36
5301,2023-02-04,PENNY,heist,Pit Stop,21,12,33
5302,2023-02-04,PENNY,gemGrab,Hard Rock Mine,49,78,127
5303,2023-02-04,PENNY,gemGrab,Double Swoosh,34,90,124
5304,2023-02-04,PENNY,gemGrab,Deep Diner,13,19,32
5305,2023-02-04,PENNY,brawlBall,Super Beach,103,128,231
5306,2023-02-04,PENNY,brawlBall,Sneaky Fields,3,5,8
5307,2023-02-04,PENNY,bounty,Dry Season,32,37,69
5308,2023-02-03,PENNY,knockout,Out in the Open,86,69,155
5309,2023-02-03,PENNY,knockout,Goldarm Gulch,66,58,124
5310,2023-02-03,PENNY,hotZone,Split,51,47,98
5311,2023-02-03,PENNY,heist,Tornado Ring,64,49,113
5312,2023-02-03,PENNY,heist,Pit Stop,129,45,174
5313,2023-02-03,PENNY,gemGrab,Undermine,31,45,76
5314,2023-02-03,PENNY,gemGrab,Double Swoosh,234,474,708
5315,2023-02-03,PENNY,gemGrab,Deep Diner,311,445,756
5316,2023-02-03,PENNY,brawlBall,Sneaky Fields,232,249,481
5317,2023-02-03,PENNY,brawlBall,Pinhole Punt,23,34,57
5318,2023-02-03,PENNY,bounty,Dry Season,96,125,221
5319,2023-02-02,PENNY,knockout,Out in the Open,50,39,89
5320,2023-02-02,PENNY,hotZone,Split,20,17,37
5321,2023-02-02,PENNY,heist,Kaboom Canyon,20,14,34
5322,2023-02-02,PENNY,gemGrab,Undermine,41,43,84
5323,2023-02-02,PENNY,gemGrab,Gem Fort,9,12,21
5324,2023-02-02,PENNY,brawlBall,Sunny Soccer,13,18,31
5325,2023-02-02,PENNY,brawlBall,Pinhole Punt,63,72,135
5326,2023-02-02,PENNY,bounty,Shooting Star,8,1,9
5327,2023-02-01,PENNY,knockout,Goldarm Gulch,91,97,188
5328,2023-02-01,PENNY,hotZone,Parallel Plays,91,131,222
5329,2023-02-01,PENNY,heist,Kaboom Canyon,59,38,97
5330,2023-02-01,PENNY,gemGrab,Gem Fort,79,142,221
5331,2023-02-01,PENNY,gemGrab,Crystal Arcade,102,150,252
5332,2023-02-01,PENNY,brawlBall,Sunny Soccer,205,244,449
5333,2023-02-01,PENNY,brawlBall,Beach Ball,11,12,23
5334,2023-02-01,PENNY,bounty,Shooting Star,24,19,43
5335,2023-01-31,PENNY,knockout,Goldarm Gulch,58,58,116
5336,2023-01-31,PENNY,hotZone,Parallel Plays,62,58,120
5337,2023-01-31,PENNY,heist,Pit Stop,11,22,33
5338,2023-01-31,PENNY,gemGrab,Minecart Madness,17,14,31
5339,2023-01-31,PENNY,gemGrab,Crystal Arcade,90,124,214
5340,2023-01-31,PENNY,brawlBall,Center Stage,3,0,3
5341,2023-01-31,PENNY,brawlBall,Beach Ball,147,154,301
5342,2023-01-31,PENNY,bounty,Hideout,11,14,25
5343,2023-01-30,PENNY,knockout,Belle's Rock,83,99,182
5344,2023-01-30,PENNY,hotZone,Quarter Pounder,217,176,393
5345,2023-01-30,PENNY,heist,Pit Stop,47,19,66
5346,2023-01-30,PENNY,gemGrab,Minecart Madness,143,123,266
5347,2023-01-30,PENNY,gemGrab,Double Swoosh,85,141,226
5348,2023-01-30,PENNY,brawlBall,Center Stage,151,144,295
5349,2023-01-30,PENNY,brawlBall,Backyard Bowl,24,34,58
5350,2023-01-30,PENNY,bounty,Hideout,21,31,52
5351,2023-01-29,PENNY,knockout,Belle's Rock,123,117,240
5352,2023-01-29,PENNY,hotZone,Quarter Pounder,151,170,321
5353,2023-01-29,PENNY,heist,Bridge Too Far,46,24,70
5354,2023-01-29,PENNY,gemGrab,Hard Rock Mine,40,39,79
5355,2023-01-29,PENNY,gemGrab,Double Swoosh,179,290,469
5356,2023-01-29,PENNY,brawlBall,Super Beach,13,17,30
5357,2023-01-29,PENNY,brawlBall,Backyard Bowl,293,503,796
5358,2023-01-29,PENNY,bounty,Canal Grande,74,96,170
5359,2023-01-28,PENNY,knockout,Flaring Phoenix,95,84,179
5360,2023-01-28,PENNY,hotZone,Controller Chaos,130,133,263
5361,2023-01-28,PENNY,heist,Bridge Too Far,91,46,137
5362,2023-01-28,PENNY,gemGrab,Hard Rock Mine,183,185,368
5363,2023-01-28,PENNY,gemGrab,Deep Diner,99,118,217
5364,2023-01-28,PENNY,brawlBall,Super Beach,374,413,787
5365,2023-01-28,PENNY,brawlBall,Sneaky Fields,12,6,18
5366,2023-01-28,PENNY,bounty,Canal Grande,129,174,303
5367,2023-01-27,PENNY,knockout,Flaring Phoenix,38,51,89
5368,2023-01-27,PENNY,hotZone,Controller Chaos,34,19,53
5369,2023-01-27,PENNY,heist,Hot Potato,29,25,54
5370,2023-01-27,PENNY,gemGrab,Undermine,14,18,32
5371,2023-01-27,PENNY,gemGrab,Deep Diner,133,194,327
5372,2023-01-27,PENNY,brawlBall,Sneaky Fields,59,70,129
5373,2023-01-27,PENNY,brawlBall,Pinhole Punt,1,2,3
5374,2023-01-27,PENNY,bounty,Temple Ruins,6,3,9
5375,2023-01-26,PENNY,knockout,Riverside,32,38,70
5376,2023-01-26,PENNY,hotZone,Open Zone,110,130,240
5377,2023-01-26,PENNY,heist,Hot Potato,61,29,90
5378,2023-01-26,PENNY,gemGrab,Undermine,91,76,167
5379,2023-01-26,PENNY,gemGrab,Gem Fort,25,20,45
5380,2023-01-26,PENNY,brawlBall,Sunny Soccer,13,21,34
5381,2023-01-26,PENNY,brawlBall,Pinhole Punt,277,333,610
5382,2023-01-26,PENNY,bounty,Temple Ruins,28,46,74
5383,2023-01-25,PENNY,knockout,Riverside,19,20,39
5384,2023-01-25,PENNY,hotZone,Open Zone,54,65,119
5385,2023-01-25,PENNY,heist,Safe Zone,139,93,232
5386,2023-01-25,PENNY,gemGrab,Gem Fort,35,30,65
5387,2023-01-25,PENNY,gemGrab,Crystal Arcade,92,141,233
5388,2023-01-25,PENNY,brawlBall,Sunny Soccer,178,204,382
5389,2023-01-25,PENNY,brawlBall,Beach Ball,39,48,87
5390,2023-01-25,PENNY,bounty,Excel,30,35,65
5391,2023-01-24,PENNY,knockout,New Perspective,30,30,60
5392,2023-01-24,PENNY,hotZone,Dueling Beetles,379,412,791
5393,2023-01-24,PENNY,heist,Safe Zone,172,156,328
5394,2023-01-24,PENNY,gemGrab,Minecart Madness,40,49,89
5395,2023-01-24,PENNY,gemGrab,Crystal Arcade,163,200,363
5396,2023-01-24,PENNY,brawlBall,Center Stage,22,26,48
5397,2023-01-24,PENNY,brawlBall,Beach Ball,278,362,640
5398,2023-01-24,PENNY,bounty,Excel,67,113,180
5399,2023-01-23,PENNY,knockout,New Perspective,72,52,124
5400,2023-01-23,PENNY,hotZone,Dueling Beetles,625,843,1468
5401,2023-01-23,PENNY,heist,Snaked Assault,69,24,93
5402,2023-01-23,PENNY,gemGrab,Minecart Madness,243,246,489
5403,2023-01-23,PENNY,gemGrab,Double Swoosh,84,148,232
5404,2023-01-23,PENNY,brawlBall,Center Stage,221,261,482
5405,2023-01-23,PENNY,brawlBall,Backyard Bowl,16,25,41
5406,2023-01-23,PENNY,bounty,Layer Cake,123,209,332
5407,2023-01-22,PENNY,knockout,X Marks the Spot,37,28,65
5408,2023-01-22,PENNY,hotZone,Ring of Fire,153,162,315
5409,2023-01-22,PENNY,heist,Snaked Assault,45,18,63
5410,2023-01-22,PENNY,gemGrab,Hard Rock Mine,41,30,71
5411,2023-01-22,PENNY,gemGrab,Double Swoosh,111,171,282
5412,2023-01-22,PENNY,brawlBall,Super Beach,32,41,73
5413,2023-01-22,PENNY,brawlBall,Backyard Bowl,138,197,335
5414,2023-01-22,PENNY,bounty,Layer Cake,89,98,187
5415,2023-01-21,PENNY,knockout,X Marks the Spot,83,98,181
5416,2023-01-21,PENNY,hotZone,Ring of Fire,443,552,995
5417,2023-01-21,PENNY,heist,Tornado Ring,58,27,85
5418,2023-01-21,PENNY,gemGrab,Hard Rock Mine,240,329,569
5419,2023-01-21,PENNY,gemGrab,Deep Diner,61,78,139
5420,2023-01-21,PENNY,brawlBall,Super Beach,405,535,940
5421,2023-01-21,PENNY,brawlBall,Sneaky Fields,18,11,29
5422,2023-01-21,PENNY,bounty,Dry Season,84,95,179
5423,2023-01-20,PENNY,knockout,Out in the Open,92,93,185
5424,2023-01-20,PENNY,hotZone,Split,61,54,115
5425,2023-01-20,PENNY,heist,Tornado Ring,44,23,67
5426,2023-01-20,PENNY,gemGrab,Undermine,58,61,119
5427,2023-01-20,PENNY,gemGrab,Deep Diner,308,395,703
5428,2023-01-20,PENNY,brawlBall,Sneaky Fields,164,212,376
5429,2023-01-20,PENNY,brawlBall,Pinhole Punt,8,10,18
5430,2023-01-20,PENNY,bounty,Dry Season,70,106,176
5431,2023-01-19,PENNY,knockout,Out in the Open,137,159,296
5432,2023-01-19,PENNY,hotZone,Split,73,41,114
5433,2023-01-19,PENNY,heist,Kaboom Canyon,66,42,108
5434,2023-01-19,PENNY,gemGrab,Undermine,156,219,375
5435,2023-01-19,PENNY,gemGrab,Gem Fort,16,31,47
5436,2023-01-19,PENNY,brawlBall,Sunny Soccer,7,7,14
5437,2023-01-19,PENNY,brawlBall,Pinhole Punt,222,267,489
5438,2023-01-19,PENNY,bounty,Shooting Star,50,21,71
5439,2023-01-18,PENNY,knockout,Goldarm Gulch,7,7,14
5440,2023-01-18,PENNY,hotZone,Parallel Plays,14,14,28
5441,2023-01-18,PENNY,heist,Kaboom Canyon,20,20,40
5442,2023-01-18,PENNY,gemGrab,Gem Fort,27,31,58
5443,2023-01-18,PENNY,gemGrab,Crystal Arcade,15,22,37
5444,2023-01-18,PENNY,brawlBall,Sunny Soccer,72,91,163
5445,2023-01-18,PENNY,brawlBall,Beach Ball,2,1,3
5446,2023-01-18,PENNY,bounty,Shooting Star,8,13,21
5447,2023-01-17,PENNY,knockout,Goldarm Gulch,9,12,21
5448,2023-01-17,PENNY,hotZone,Parallel Plays,10,25,35
5449,2023-01-17,PENNY,heist,Pit Stop,7,3,10
5450,2023-01-17,PENNY,gemGrab,Minecart Madness,1,5,6
5451,2023-01-17,PENNY,gemGrab,Crystal Arcade,17,13,30
5452,2023-01-17,PENNY,brawlBall,Center Stage,0,2,2
5453,2023-01-17,PENNY,brawlBall,Beach Ball,20,24,44
5454,2023-01-17,PENNY,bounty,Hideout,1,3,4
5455,2023-01-16,PENNY,knockout,Belle's Rock,18,30,48
5456,2023-01-16,PENNY,hotZone,Quarter Pounder,16,37,53
5457,2023-01-16,PENNY,heist,Pit Stop,11,5,16
5458,2023-01-16,PENNY,gemGrab,Minecart Madness,7,15,22
5459,2023-01-16,PENNY,gemGrab,Double Swoosh,3,3,6
5460,2023-01-16,PENNY,brawlBall,Center Stage,8,5,13
5461,2023-01-16,PENNY,brawlBall,Backyard Bowl,3,29,32
5462,2023-01-16,PENNY,bounty,Hideout,3,1,4
5463,2023-01-15,PENNY,knockout,Belle's Rock,16,7,23
5464,2023-01-15,PENNY,hotZone,Quarter Pounder,35,66,101
5465,2023-01-15,PENNY,heist,Bridge Too Far,13,24,37
5466,2023-01-15,PENNY,gemGrab,Hard Rock Mine,10,7,17
5467,2023-01-15,PENNY,gemGrab,Double Swoosh,29,57,86
5468,2023-01-15,PENNY,brawlBall,Super Beach,4,3,7
5469,2023-01-15,PENNY,brawlBall,Backyard Bowl,38,94,132
5470,2023-01-15,PENNY,bounty,Canal Grande,4,22,26
5471,2023-01-14,PENNY,knockout,Flaring Phoenix,3,2,5
5472,2023-01-14,PENNY,hotZone,Controller Chaos,36,38,74
5473,2023-01-14,PENNY,heist,Bridge Too Far,10,17,27
5474,2023-01-14,PENNY,gemGrab,Hard Rock Mine,12,14,26
5475,2023-01-14,PENNY,gemGrab,Deep Diner,14,3,17
5476,2023-01-14,PENNY,brawlBall,Super Beach,14,44,58
5477,2023-01-14,PENNY,brawlBall,Sneaky Fields,1,6,7
5478,2023-01-14,PENNY,bounty,Canal Grande,9,14,23
5479,2023-01-13,PENNY,knockout,Flaring Phoenix,5,16,21
5480,2023-01-13,PENNY,hotZone,Controller Chaos,33,69,102
5481,2023-01-13,PENNY,heist,Hot Potato,1,0,1
5482,2023-01-13,PENNY,gemGrab,Deep Diner,27,30,57
5483,2023-01-13,PENNY,brawlBall,Sneaky Fields,11,11,22
5484,2023-01-13,PENNY,bounty,Temple Ruins,2,0,2
5485,2023-01-12,PENNY,knockout,Riverside,5,1,6
5486,2023-01-12,PENNY,hotZone,Open Zone,14,26,40
5487,2023-01-12,PENNY,gemGrab,Undermine,9,9,18
5488,2023-01-12,PENNY,gemGrab,Gem Fort,1,1,2
5489,2023-01-12,PENNY,brawlBall,Sunny Soccer,1,1,2
5490,2023-01-12,PENNY,brawlBall,Pinhole Punt,8,10,18
5491,2023-01-11,PENNY,knockout,Riverside,1,0,1
5492,2023-01-11,PENNY,hotZone,Open Zone,1,0,1
5493,2023-01-11,PENNY,heist,Safe Zone,0,1,1
5494,2023-01-11,PENNY,gemGrab,Gem Fort,2,3,5
5495,2023-01-11,PENNY,brawlBall,Sunny Soccer,8,11,19
5496,2023-01-11,PENNY,brawlBall,Beach Ball,1,0,1
5497,2023-01-11,PENNY,bounty,Excel,4,0,4
5498,2023-01-10,PENNY,knockout,New Perspective,2,1,3
5499,2023-01-10,PENNY,hotZone,Dueling Beetles,61,81,142
5500,2023-01-10,PENNY,heist,Safe Zone,10,3,13
5501,2023-01-10,PENNY,gemGrab,Minecart Madness,10,2,12
5502,2023-01-10,PENNY,gemGrab,Crystal Arcade,34,49,83
5503,2023-01-10,PENNY,brawlBall,Beach Ball,18,40,58
5504,2023-01-10,PENNY,bounty,Excel,0,6,6
5505,2023-01-09,PENNY,knockout,New Perspective,2,1,3
5506,2023-01-09,PENNY,hotZone,Dueling Beetles,42,60,102
5507,2023-01-09,PENNY,heist,Snaked Assault,12,2,14
5508,2023-01-09,PENNY,gemGrab,Minecart Madness,17,11,28
5509,2023-01-09,PENNY,gemGrab,Double Swoosh,15,6,21
5510,2023-01-09,PENNY,brawlBall,Center Stage,5,6,11
5511,2023-01-09,PENNY,brawlBall,Backyard Bowl,2,0,2
5512,2023-01-09,PENNY,bounty,Layer Cake,20,20,40
5513,2023-01-08,PENNY,knockout,X Marks the Spot,4,2,6
5514,2023-01-08,PENNY,hotZone,Ring of Fire,25,48,73
5515,2023-01-08,PENNY,heist,Snaked Assault,6,2,8
5516,2023-01-08,PENNY,gemGrab,Hard Rock Mine,10,13,23
5517,2023-01-08,PENNY,gemGrab,Double Swoosh,3,8,11
5518,2023-01-08,PENNY,brawlBall,Super Beach,4,8,12
5519,2023-01-08,PENNY,brawlBall,Backyard Bowl,14,34,48
5520,2023-01-08,PENNY,bounty,Layer Cake,3,5,8
5521,2023-01-07,PENNY,knockout,X Marks the Spot,3,1,4
5522,2023-01-07,PENNY,hotZone,Ring of Fire,13,38,51
5523,2023-01-07,PENNY,heist,Tornado Ring,5,2,7
5524,2023-01-07,PENNY,gemGrab,Hard Rock Mine,6,19,25
5525,2023-01-07,PENNY,gemGrab,Deep Diner,8,2,10
5526,2023-01-07,PENNY,brawlBall,Super Beach,12,19,31
5527,2023-01-07,PENNY,brawlBall,Sneaky Fields,0,1,1
5528,2023-01-07,PENNY,bounty,Dry Season,5,10,15
5529,2023-01-06,PENNY,knockout,Out in the Open,12,12,24
5530,2023-01-06,PENNY,hotZone,Split,3,1,4
5531,2023-01-06,PENNY,heist,Tornado Ring,6,2,8
5532,2023-01-06,PENNY,gemGrab,Undermine,3,0,3
5533,2023-01-06,PENNY,gemGrab,Deep Diner,45,50,95
5534,2023-01-06,PENNY,brawlBall,Sneaky Fields,7,19,26
5535,2023-01-06,PENNY,bounty,Dry Season,11,14,25
5536,2023-01-05,PENNY,knockout,Out in the Open,15,21,36
5537,2023-01-05,PENNY,hotZone,Split,12,10,22
5538,2023-01-05,PENNY,heist,Kaboom Canyon,14,14,28
5539,2023-01-05,PENNY,gemGrab,Undermine,12,45,57
5540,2023-01-05,PENNY,gemGrab,Gem Fort,0,3,3
5541,2023-01-05,PENNY,brawlBall,Sunny Soccer,1,0,1
5542,2023-01-05,PENNY,brawlBall,Pinhole Punt,22,35,57
5543,2023-01-05,PENNY,bounty,Shooting Star,4,0,4
5544,2023-01-04,PENNY,knockout,Goldarm Gulch,3,15,18
5545,2023-01-04,PENNY,hotZone,Parallel Plays,7,5,12
5546,2023-01-04,PENNY,heist,Kaboom Canyon,13,2,15
5547,2023-01-04,PENNY,gemGrab,Gem Fort,22,32,54
5548,2023-01-04,PENNY,gemGrab,Crystal Arcade,6,4,10
5549,2023-01-04,PENNY,brawlBall,Sunny Soccer,29,36,65
5550,2023-01-04,PENNY,bounty,Shooting Star,7,1,8
5551,2023-01-03,PENNY,knockout,Goldarm Gulch,4,5,9
5552,2023-01-03,PENNY,hotZone,Parallel Plays,6,11,17
5553,2023-01-03,PENNY,hotZone,Controller Chaos,1,1,2
5554,2023-01-03,PENNY,heist,Pit Stop,5,0,5
5555,2023-01-03,PENNY,gemGrab,Minecart Madness,10,18,28
5556,2023-01-03,PENNY,gemGrab,Crystal Arcade,23,23,46
5557,2023-01-03,PENNY,brawlBall,Center Stage,1,0,1
5558,2023-01-03,PENNY,brawlBall,Beach Ball,10,34,44
5559,2023-01-03,PENNY,bounty,Hideout,6,1,7
5560,2023-01-02,PENNY,knockout,Belle's Rock,6,3,9
5561,2023-01-02,PENNY,hotZone,Quarter Pounder,19,23,42
5562,2023-01-02,PENNY,heist,Pit Stop,3,3,6
5563,2023-01-02,PENNY,heist,Kaboom Canyon,0,1,1
5564,2023-01-02,PENNY,gemGrab,Minecart Madness,25,40,65
5565,2023-01-02,PENNY,gemGrab,Double Swoosh,25,36,61
5566,2023-01-02,PENNY,brawlBall,Center Stage,12,5,17
5567,2023-01-02,PENNY,brawlBall,Backyard Bowl,3,7,10
5568,2023-01-02,PENNY,bounty,Hideout,12,7,19
5569,2023-01-01,PENNY,knockout,Belle's Rock,2,2,4
5570,2023-01-01,PENNY,hotZone,Quarter Pounder,5,9,14
5571,2023-01-01,PENNY,heist,Kaboom Canyon,1,0,1
5572,2023-01-01,PENNY,heist,Bridge Too Far,1,0,1
5573,2023-01-01,PENNY,gemGrab,Minecart Madness,1,1,2
5574,2023-01-01,PENNY,gemGrab,Double Swoosh,16,37,53
5575,2023-01-01,PENNY,brawlBall,Backyard Bowl,12,5,17
5576,2023-01-01,PENNY,bounty,Canal Grande,0,1,1
5577,2022-12-31,PENNY,hotZone,Controller Chaos,0,1,1
5578,2022-12-31,PENNY,heist,Bridge Too Far,1,1,2
5579,2022-12-31,PENNY,gemGrab,Minecart Madness,2,3,5
5580,2022-12-31,PENNY,gemGrab,Hard Rock Mine,6,5,11
5581,2022-12-31,PENNY,gemGrab,Deep Diner,6,19,25
5582,2022-12-31,PENNY,brawlBall,Super Beach,4,7,11
5583,2022-12-31,PENNY,bounty,Canal Grande,1,1,2
5584,2022-12-30,PENNY,heist,Hot Potato,1,0,1
5585,2022-12-30,PENNY,gemGrab,Minecart Madness,0,1,1
5586,2022-12-30,PENNY,gemGrab,Deep Diner,10,15,25
5587,2022-12-30,PENNY,brawlBall,Sneaky Fields,1,0,1
5588,2022-12-29,PENNY,hotZone,Controller Chaos,1,0,1
5589,2022-12-29,PENNY,heist,Kaboom Canyon,0,1,1
5590,2022-12-29,PENNY,gemGrab,Undermine,1,0,1
5591,2022-12-29,PENNY,brawlBall,Pinhole Punt,3,0,3
5592,2022-12-27,PENNY,hotZone,Dueling Beetles,2,1,3
5593,2022-12-27,PENNY,heist,Kaboom Canyon,0,2,2
5594,2022-12-27,PENNY,gemGrab,Minecart Madness,1,0,1
5595,2022-12-27,PENNY,bounty,Excel,1,0,1
5596,2022-12-26,PENNY,brawlBall,Center Stage,2,1,3
5597,2022-12-25,PENNY,gemGrab,Double Swoosh,2,4,6
5598,2022-12-24,PENNY,bounty,Dry Season,1,1,2
5599,2022-12-23,PENNY,knockout,Out in the Open,4,0,4
5600,2022-12-22,PENNY,gemGrab,Gem Fort,1,0,1
5601,2022-12-20,PENNY,brawlBall,Beach Ball,1,1,2
5602,2022-12-18,PENNY,heist,Bridge Too Far,1,0,1
5603,2022-12-17,PENNY,brawlBall,Super Beach,0,1,1
5604,2022-12-16,PENNY,gemGrab,Undermine,0,2,2
5605,2022-12-16,PENNY,brawlBall,Sneaky Fields,2,0,2
5606,2022-12-16,PENNY,bounty,Temple Ruins,2,6,8
5607,2022-12-13,PENNY,heist,Safe Zone,1,1,2
5608,2022-12-13,PENNY,gemGrab,Crystal Arcade,0,3,3
5609,2022-12-12,PENNY,brawlBall,Center Stage,0,2,2
5610,2022-10-30,PENNY,hotZone,Dueling Beetles,0,2,2
5611,2022-10-28,PENNY,hotZone,Dueling Beetles,2,0,2
5612,2022-10-15,PENNY,hotZone,Ring of Fire,2,2,4
5613,2022-10-15,PENNY,gemGrab,Hard Rock Mine,1,0,1
5614,2022-10-15,PENNY,bounty,Dry Season,2,0,2
5615,2022-10-10,PENNY,knockout,Belle's Rock,1,0,1
5616,2023-02-11,PAM,knockout,Flaring Phoenix,3,5,8
5617,2023-02-11,PAM,hotZone,Controller Chaos,46,63,109
5618,2023-02-11,PAM,gemGrab,Deep Diner,17,24,41
5619,2023-02-11,PAM,brawlBall,Super Beach,19,16,35
5620,2023-02-11,PAM,brawlBall,Sneaky Fields,5,9,14
5621,2023-02-10,PAM,knockout,Flaring Phoenix,11,15,26
5622,2023-02-10,PAM,hotZone,Controller Chaos,130,172,302
5623,2023-02-10,PAM,heist,Hot Potato,15,3,18
5624,2023-02-10,PAM,gemGrab,Undermine,24,34,58
5625,2023-02-10,PAM,gemGrab,Deep Diner,51,44,95
5626,2023-02-10,PAM,brawlBall,Sneaky Fields,120,107,227
5627,2023-02-10,PAM,brawlBall,Pinhole Punt,5,3,8
5628,2023-02-10,PAM,bounty,Temple Ruins,26,41,67
5629,2023-02-09,PAM,knockout,Riverside,6,5,11
5630,2023-02-09,PAM,hotZone,Open Zone,23,16,39
5631,2023-02-09,PAM,heist,Hot Potato,5,6,11
5632,2023-02-09,PAM,gemGrab,Undermine,22,24,46
5633,2023-02-09,PAM,gemGrab,Gem Fort,3,4,7
5634,2023-02-09,PAM,brawlBall,Pinhole Punt,42,49,91
5635,2023-02-09,PAM,bounty,Temple Ruins,5,6,11
5636,2023-02-08,PAM,hotZone,Open Zone,14,12,26
5637,2023-02-08,PAM,heist,Safe Zone,1,1,2
5638,2023-02-08,PAM,gemGrab,Gem Fort,11,20,31
5639,2023-02-08,PAM,gemGrab,Crystal Arcade,2,1,3
5640,2023-02-08,PAM,brawlBall,Sunny Soccer,15,14,29
5641,2023-02-08,PAM,brawlBall,Beach Ball,0,2,2
5642,2023-02-08,PAM,bounty,Excel,2,3,5
5643,2023-02-07,PAM,knockout,New Perspective,1,1,2
5644,2023-02-07,PAM,hotZone,Dueling Beetles,11,7,18
5645,2023-02-07,PAM,heist,Safe Zone,1,1,2
5646,2023-02-07,PAM,gemGrab,Minecart Madness,3,6,9
5647,2023-02-07,PAM,gemGrab,Crystal Arcade,3,2,5
5648,2023-02-07,PAM,brawlBall,Beach Ball,5,13,18
5649,2023-02-06,PAM,knockout,New Perspective,10,15,25
5650,2023-02-06,PAM,knockout,Goldarm Gulch,3,0,3
5651,2023-02-06,PAM,hotZone,Dueling Beetles,62,93,155
5652,2023-02-06,PAM,heist,Snaked Assault,24,14,38
5653,2023-02-06,PAM,gemGrab,Minecart Madness,67,61,128
5654,2023-02-06,PAM,gemGrab,Double Swoosh,69,109,178
5655,2023-02-06,PAM,brawlBall,Sneaky Fields,2,0,2
5656,2023-02-06,PAM,brawlBall,Center Stage,113,110,223
5657,2023-02-06,PAM,brawlBall,Backyard Bowl,20,30,50
5658,2023-02-06,PAM,bounty,Layer Cake,3,3,6
5659,2023-02-05,PAM,knockout,X Marks the Spot,11,1,12
5660,2023-02-05,PAM,knockout,Goldarm Gulch,0,2,2
5661,2023-02-05,PAM,hotZone,Ring of Fire,69,111,180
5662,2023-02-05,PAM,heist,Snaked Assault,10,12,22
5663,2023-02-05,PAM,heist,Pit Stop,0,2,2
5664,2023-02-05,PAM,gemGrab,Hard Rock Mine,15,12,27
5665,2023-02-05,PAM,gemGrab,Double Swoosh,195,299,494
5666,2023-02-05,PAM,brawlBall,Super Beach,10,10,20
5667,2023-02-05,PAM,brawlBall,Sneaky Fields,8,11,19
5668,2023-02-05,PAM,brawlBall,Backyard Bowl,299,519,818
5669,2023-02-05,PAM,bounty,Layer Cake,1,3,4
5670,2023-02-04,PAM,knockout,X Marks the Spot,5,4,9
5671,2023-02-04,PAM,knockout,Goldarm Gulch,3,1,4
5672,2023-02-04,PAM,hotZone,Ring of Fire,30,15,45
5673,2023-02-04,PAM,heist,Tornado Ring,5,4,9
5674,2023-02-04,PAM,heist,Pit Stop,0,1,1
5675,2023-02-04,PAM,gemGrab,Hard Rock Mine,21,27,48
5676,2023-02-04,PAM,gemGrab,Double Swoosh,20,36,56
5677,2023-02-04,PAM,gemGrab,Deep Diner,1,1,2
5678,2023-02-04,PAM,brawlBall,Super Beach,40,62,102
5679,2023-02-04,PAM,brawlBall,Sneaky Fields,7,7,14
5680,2023-02-04,PAM,bounty,Dry Season,0,3,3
5681,2023-02-03,PAM,knockout,Out in the Open,19,11,30
5682,2023-02-03,PAM,knockout,Goldarm Gulch,4,0,4
5683,2023-02-03,PAM,hotZone,Split,26,16,42
5684,2023-02-03,PAM,heist,Tornado Ring,16,12,28
5685,2023-02-03,PAM,heist,Pit Stop,4,6,10
5686,2023-02-03,PAM,gemGrab,Undermine,33,64,97
5687,2023-02-03,PAM,gemGrab,Double Swoosh,99,145,244
5688,2023-02-03,PAM,gemGrab,Deep Diner,70,77,147
5689,2023-02-03,PAM,brawlBall,Sneaky Fields,108,143,251
5690,2023-02-03,PAM,brawlBall,Pinhole Punt,10,8,18
5691,2023-02-03,PAM,bounty,Dry Season,14,9,23
5692,2023-02-02,PAM,knockout,Out in the Open,9,27,36
5693,2023-02-02,PAM,hotZone,Split,15,15,30
5694,2023-02-02,PAM,heist,Kaboom Canyon,13,10,23
5695,2023-02-02,PAM,gemGrab,Undermine,29,49,78
5696,2023-02-02,PAM,gemGrab,Gem Fort,9,13,22
5697,2023-02-02,PAM,brawlBall,Sunny Soccer,5,0,5
5698,2023-02-02,PAM,brawlBall,Pinhole Punt,67,96,163
5699,2023-02-02,PAM,bounty,Shooting Star,2,4,6
5700,2023-02-01,PAM,knockout,Goldarm Gulch,24,10,34
5701,2023-02-01,PAM,hotZone,Parallel Plays,107,176,283
5702,2023-02-01,PAM,heist,Kaboom Canyon,12,5,17
5703,2023-02-01,PAM,gemGrab,Gem Fort,93,141,234
5704,2023-02-01,PAM,gemGrab,Crystal Arcade,28,36,64
5705,2023-02-01,PAM,brawlBall,Sunny Soccer,83,78,161
5706,2023-02-01,PAM,brawlBall,Beach Ball,3,9,12
5707,2023-02-01,PAM,bounty,Shooting Star,4,6,10
5708,2023-01-31,PAM,knockout,Goldarm Gulch,9,6,15
5709,2023-01-31,PAM,hotZone,Parallel Plays,62,55,117
5710,2023-01-31,PAM,heist,Pit Stop,9,6,15
5711,2023-01-31,PAM,gemGrab,Minecart Madness,12,11,23
5712,2023-01-31,PAM,gemGrab,Crystal Arcade,35,31,66
5713,2023-01-31,PAM,brawlBall,Center Stage,2,2,4
5714,2023-01-31,PAM,brawlBall,Beach Ball,41,54,95
5715,2023-01-31,PAM,bounty,Hideout,5,1,6
5716,2023-01-30,PAM,knockout,Belle's Rock,9,7,16
5717,2023-01-30,PAM,hotZone,Quarter Pounder,92,113,205
5718,2023-01-30,PAM,heist,Pit Stop,5,6,11
5719,2023-01-30,PAM,gemGrab,Minecart Madness,49,44,93
5720,2023-01-30,PAM,gemGrab,Double Swoosh,50,75,125
5721,2023-01-30,PAM,brawlBall,Center Stage,65,104,169
5722,2023-01-30,PAM,brawlBall,Backyard Bowl,33,43,76
5723,2023-01-30,PAM,bounty,Hideout,2,2,4
5724,2023-01-29,PAM,knockout,Belle's Rock,7,5,12
5725,2023-01-29,PAM,hotZone,Quarter Pounder,40,54,94
5726,2023-01-29,PAM,heist,Bridge Too Far,22,24,46
5727,2023-01-29,PAM,gemGrab,Hard Rock Mine,11,22,33
5728,2023-01-29,PAM,gemGrab,Double Swoosh,91,112,203
5729,2023-01-29,PAM,brawlBall,Super Beach,3,3,6
5730,2023-01-29,PAM,brawlBall,Backyard Bowl,279,379,658
5731,2023-01-29,PAM,bounty,Canal Grande,4,3,7
5732,2023-01-28,PAM,knockout,Flaring Phoenix,18,8,26
5733,2023-01-28,PAM,hotZone,Controller Chaos,80,71,151
5734,2023-01-28,PAM,heist,Bridge Too Far,32,27,59
5735,2023-01-28,PAM,gemGrab,Hard Rock Mine,65,90,155
5736,2023-01-28,PAM,gemGrab,Deep Diner,21,18,39
5737,2023-01-28,PAM,brawlBall,Super Beach,91,101,192
5738,2023-01-28,PAM,brawlBall,Sneaky Fields,4,3,7
5739,2023-01-28,PAM,bounty,Canal Grande,9,17,26
5740,2023-01-27,PAM,knockout,Flaring Phoenix,4,4,8
5741,2023-01-27,PAM,hotZone,Controller Chaos,36,40,76
5742,2023-01-27,PAM,heist,Hot Potato,4,4,8
5743,2023-01-27,PAM,gemGrab,Undermine,2,11,13
5744,2023-01-27,PAM,gemGrab,Deep Diner,33,32,65
5745,2023-01-27,PAM,brawlBall,Sneaky Fields,39,61,100
5746,2023-01-27,PAM,brawlBall,Pinhole Punt,3,2,5
5747,2023-01-27,PAM,bounty,Temple Ruins,4,3,7
5748,2023-01-26,PAM,knockout,Riverside,12,17,29
5749,2023-01-26,PAM,hotZone,Open Zone,134,205,339
5750,2023-01-26,PAM,heist,Hot Potato,19,15,34
5751,2023-01-26,PAM,gemGrab,Undermine,72,141,213
5752,2023-01-26,PAM,gemGrab,Gem Fort,36,53,89
5753,2023-01-26,PAM,brawlBall,Sunny Soccer,5,1,6
5754,2023-01-26,PAM,brawlBall,Pinhole Punt,190,251,441
5755,2023-01-26,PAM,bounty,Temple Ruins,16,13,29
5756,2023-01-25,PAM,knockout,Riverside,6,2,8
5757,2023-01-25,PAM,hotZone,Open Zone,75,113,188
5758,2023-01-25,PAM,heist,Safe Zone,5,3,8
5759,2023-01-25,PAM,gemGrab,Gem Fort,29,28,57
5760,2023-01-25,PAM,gemGrab,Crystal Arcade,34,33,67
5761,2023-01-25,PAM,brawlBall,Sunny Soccer,66,57,123
5762,2023-01-25,PAM,brawlBall,Beach Ball,7,7,14
5763,2023-01-25,PAM,bounty,Excel,2,1,3
5764,2023-01-24,PAM,knockout,New Perspective,15,22,37
5765,2023-01-24,PAM,hotZone,Dueling Beetles,65,79,144
5766,2023-01-24,PAM,heist,Safe Zone,14,25,39
5767,2023-01-24,PAM,gemGrab,Minecart Madness,13,12,25
5768,2023-01-24,PAM,gemGrab,Crystal Arcade,53,68,121
5769,2023-01-24,PAM,brawlBall,Center Stage,13,26,39
5770,2023-01-24,PAM,brawlBall,Beach Ball,119,155,274
5771,2023-01-24,PAM,bounty,Excel,2,12,14
5772,2023-01-23,PAM,knockout,New Perspective,13,8,21
5773,2023-01-23,PAM,hotZone,Dueling Beetles,77,66,143
5774,2023-01-23,PAM,heist,Snaked Assault,13,5,18
5775,2023-01-23,PAM,gemGrab,Minecart Madness,55,80,135
5776,2023-01-23,PAM,gemGrab,Double Swoosh,45,39,84
5777,2023-01-23,PAM,brawlBall,Center Stage,118,128,246
5778,2023-01-23,PAM,brawlBall,Backyard Bowl,18,38,56
5779,2023-01-23,PAM,bounty,Layer Cake,3,3,6
5780,2023-01-22,PAM,knockout,X Marks the Spot,6,10,16
5781,2023-01-22,PAM,hotZone,Ring of Fire,27,38,65
5782,2023-01-22,PAM,heist,Snaked Assault,8,10,18
5783,2023-01-22,PAM,gemGrab,Hard Rock Mine,6,12,18
5784,2023-01-22,PAM,gemGrab,Double Swoosh,59,68,127
5785,2023-01-22,PAM,brawlBall,Super Beach,3,5,8
5786,2023-01-22,PAM,brawlBall,Backyard Bowl,147,250,397
5787,2023-01-22,PAM,bounty,Layer Cake,2,1,3
5788,2023-01-21,PAM,knockout,X Marks the Spot,25,25,50
5789,2023-01-21,PAM,hotZone,Ring of Fire,116,127,243
5790,2023-01-21,PAM,heist,Tornado Ring,22,19,41
5791,2023-01-21,PAM,gemGrab,Hard Rock Mine,64,82,146
5792,2023-01-21,PAM,gemGrab,Deep Diner,21,29,50
5793,2023-01-21,PAM,brawlBall,Super Beach,102,98,200
5794,2023-01-21,PAM,brawlBall,Sneaky Fields,7,9,16
5795,2023-01-21,PAM,bounty,Dry Season,11,6,17
5796,2023-01-20,PAM,knockout,Out in the Open,31,19,50
5797,2023-01-20,PAM,hotZone,Split,25,18,43
5798,2023-01-20,PAM,heist,Tornado Ring,20,5,25
5799,2023-01-20,PAM,gemGrab,Undermine,52,107,159
5800,2023-01-20,PAM,gemGrab,Deep Diner,76,80,156
5801,2023-01-20,PAM,brawlBall,Sneaky Fields,96,114,210
5802,2023-01-20,PAM,brawlBall,Pinhole Punt,11,21,32
5803,2023-01-20,PAM,bounty,Dry Season,8,6,14
5804,2023-01-19,PAM,knockout,Out in the Open,30,23,53
5805,2023-01-19,PAM,hotZone,Split,51,61,112
5806,2023-01-19,PAM,heist,Kaboom Canyon,29,18,47
5807,2023-01-19,PAM,gemGrab,Undermine,94,157,251
5808,2023-01-19,PAM,gemGrab,Gem Fort,15,11,26
5809,2023-01-19,PAM,brawlBall,Sunny Soccer,0,3,3
5810,2023-01-19,PAM,brawlBall,Pinhole Punt,224,318,542
5811,2023-01-19,PAM,bounty,Shooting Star,16,10,26
5812,2023-01-18,PAM,knockout,Goldarm Gulch,2,2,4
5813,2023-01-18,PAM,hotZone,Parallel Plays,11,6,17
5814,2023-01-18,PAM,heist,Kaboom Canyon,7,17,24
5815,2023-01-18,PAM,gemGrab,Gem Fort,28,39,67
5816,2023-01-18,PAM,gemGrab,Crystal Arcade,2,1,3
5817,2023-01-18,PAM,brawlBall,Sunny Soccer,29,33,62
5818,2023-01-18,PAM,brawlBall,Beach Ball,4,3,7
5819,2023-01-18,PAM,bounty,Shooting Star,5,3,8
5820,2023-01-17,PAM,knockout,Goldarm Gulch,3,1,4
5821,2023-01-17,PAM,hotZone,Parallel Plays,19,14,33
5822,2023-01-17,PAM,heist,Pit Stop,0,1,1
5823,2023-01-17,PAM,gemGrab,Crystal Arcade,1,5,6
5824,2023-01-17,PAM,brawlBall,Beach Ball,16,12,28
5825,2023-01-16,PAM,hotZone,Quarter Pounder,3,4,7
5826,2023-01-16,PAM,heist,Pit Stop,1,0,1
5827,2023-01-16,PAM,gemGrab,Minecart Madness,8,5,13
5828,2023-01-16,PAM,gemGrab,Double Swoosh,6,18,24
5829,2023-01-16,PAM,brawlBall,Center Stage,10,28,38
5830,2023-01-16,PAM,brawlBall,Backyard Bowl,6,0,6
5831,2023-01-15,PAM,hotZone,Quarter Pounder,20,24,44
5832,2023-01-15,PAM,heist,Bridge Too Far,2,1,3
5833,2023-01-15,PAM,gemGrab,Hard Rock Mine,1,16,17
5834,2023-01-15,PAM,gemGrab,Double Swoosh,11,7,18
5835,2023-01-15,PAM,brawlBall,Super Beach,1,0,1
5836,2023-01-15,PAM,brawlBall,Backyard Bowl,38,57,95
5837,2023-01-14,PAM,knockout,Flaring Phoenix,1,0,1
5838,2023-01-14,PAM,hotZone,Controller Chaos,18,41,59
5839,2023-01-14,PAM,heist,Bridge Too Far,4,2,6
5840,2023-01-14,PAM,gemGrab,Hard Rock Mine,1,10,11
5841,2023-01-14,PAM,gemGrab,Deep Diner,2,1,3
5842,2023-01-14,PAM,brawlBall,Super Beach,4,7,11
5843,2023-01-14,PAM,bounty,Canal Grande,1,0,1
5844,2023-01-13,PAM,hotZone,Controller Chaos,9,9,18
5845,2023-01-13,PAM,gemGrab,Deep Diner,3,5,8
5846,2023-01-13,PAM,brawlBall,Sneaky Fields,12,7,19
5847,2023-01-13,PAM,brawlBall,Pinhole Punt,0,1,1
5848,2023-01-13,PAM,bounty,Temple Ruins,1,1,2
5849,2023-01-12,PAM,knockout,Riverside,7,7,14
5850,2023-01-12,PAM,hotZone,Open Zone,17,14,31
5851,2023-01-12,PAM,gemGrab,Undermine,9,13,22
5852,2023-01-12,PAM,gemGrab,Gem Fort,2,1,3
5853,2023-01-12,PAM,brawlBall,Pinhole Punt,7,13,20
5854,2023-01-11,PAM,hotZone,Open Zone,7,4,11
5855,2023-01-11,PAM,gemGrab,Gem Fort,1,2,3
5856,2023-01-10,PAM,knockout,New Perspective,1,0,1
5857,2023-01-10,PAM,hotZone,Dueling Beetles,8,14,22
5858,2023-01-10,PAM,heist,Safe Zone,9,14,23
5859,2023-01-10,PAM,gemGrab,Minecart Madness,2,5,7
5860,2023-01-10,PAM,gemGrab,Crystal Arcade,6,3,9
5861,2023-01-10,PAM,brawlBall,Beach Ball,1,1,2
5862,2023-01-10,PAM,bounty,Excel,1,0,1
5863,2023-01-09,PAM,hotZone,Dueling Beetles,4,1,5
5864,2023-01-09,PAM,heist,Snaked Assault,2,0,2
5865,2023-01-09,PAM,gemGrab,Minecart Madness,6,10,16
5866,2023-01-09,PAM,gemGrab,Double Swoosh,5,10,15
5867,2023-01-09,PAM,brawlBall,Center Stage,8,2,10
5868,2023-01-09,PAM,brawlBall,Backyard Bowl,0,11,11
5869,2023-01-09,PAM,bounty,Layer Cake,1,0,1
5870,2023-01-08,PAM,hotZone,Ring of Fire,20,23,43
5871,2023-01-08,PAM,heist,Snaked Assault,2,0,2
5872,2023-01-08,PAM,gemGrab,Double Swoosh,2,1,3
5873,2023-01-08,PAM,brawlBall,Super Beach,0,2,2
5874,2023-01-08,PAM,brawlBall,Backyard Bowl,13,42,55
5875,2023-01-07,PAM,hotZone,Ring of Fire,7,22,29
5876,2023-01-07,PAM,heist,Tornado Ring,1,3,4
5877,2023-01-07,PAM,gemGrab,Hard Rock Mine,2,2,4
5878,2023-01-07,PAM,gemGrab,Deep Diner,1,0,1
5879,2023-01-07,PAM,brawlBall,Super Beach,1,7,8
5880,2023-01-07,PAM,brawlBall,Sneaky Fields,1,0,1
5881,2023-01-06,PAM,heist,Tornado Ring,3,1,4
5882,2023-01-06,PAM,gemGrab,Undermine,1,0,1
5883,2023-01-06,PAM,gemGrab,Deep Diner,1,2,3
5884,2023-01-06,PAM,brawlBall,Sneaky Fields,2,6,8
5885,2023-01-05,PAM,knockout,Out in the Open,1,0,1
5886,2023-01-05,PAM,hotZone,Split,3,0,3
5887,2023-01-05,PAM,heist,Kaboom Canyon,2,0,2
5888,2023-01-05,PAM,gemGrab,Undermine,10,5,15
5889,2023-01-05,PAM,gemGrab,Gem Fort,3,9,12
5890,2023-01-05,PAM,brawlBall,Pinhole Punt,24,42,66
5891,2023-01-04,PAM,knockout,Goldarm Gulch,1,0,1
5892,2023-01-04,PAM,hotZone,Parallel Plays,4,8,12
5893,2023-01-04,PAM,heist,Kaboom Canyon,1,0,1
5894,2023-01-04,PAM,gemGrab,Gem Fort,2,7,9
5895,2023-01-04,PAM,gemGrab,Crystal Arcade,2,0,2
5896,2023-01-04,PAM,brawlBall,Sunny Soccer,10,12,22
5897,2023-01-04,PAM,bounty,Shooting Star,1,0,1
5898,2023-01-03,PAM,knockout,Goldarm Gulch,1,0,1
5899,2023-01-03,PAM,hotZone,Parallel Plays,5,8,13
5900,2023-01-03,PAM,heist,Pit Stop,1,0,1
5901,2023-01-03,PAM,gemGrab,Minecart Madness,1,2,3
5902,2023-01-03,PAM,gemGrab,Crystal Arcade,6,0,6
5903,2023-01-03,PAM,brawlBall,Center Stage,2,0,2
5904,2023-01-03,PAM,brawlBall,Beach Ball,7,4,11
5905,2023-01-03,PAM,bounty,Hideout,2,0,2
5906,2023-01-02,PAM,knockout,Belle's Rock,1,0,1
5907,2023-01-02,PAM,hotZone,Quarter Pounder,11,7,18
5908,2023-01-02,PAM,gemGrab,Minecart Madness,9,10,19
5909,2023-01-02,PAM,gemGrab,Double Swoosh,8,7,15
5910,2023-01-02,PAM,brawlBall,Center Stage,12,8,20
5911,2023-01-02,PAM,brawlBall,Backyard Bowl,2,2,4
5912,2023-01-02,PAM,bounty,Hideout,1,2,3
5913,2023-01-01,PAM,hotZone,Quarter Pounder,5,4,9
5914,2023-01-01,PAM,hotZone,Controller Chaos,0,2,2
5915,2023-01-01,PAM,heist,Bridge Too Far,1,0,1
5916,2023-01-01,PAM,gemGrab,Double Swoosh,6,2,8
5917,2023-01-01,PAM,brawlBall,Backyard Bowl,12,9,21
5918,2022-12-31,PAM,hotZone,Controller Chaos,2,3,5
5919,2022-12-31,PAM,gemGrab,Deep Diner,2,0,2
5920,2022-12-31,PAM,brawlBall,Super Beach,0,1,1
5921,2022-12-31,PAM,bounty,Canal Grande,1,0,1
5922,2022-12-30,PAM,hotZone,Controller Chaos,1,3,4
5923,2022-12-30,PAM,gemGrab,Deep Diner,1,1,2
5924,2022-12-30,PAM,brawlBall,Sneaky Fields,1,2,3
5925,2022-12-29,PAM,hotZone,Controller Chaos,1,0,1
5926,2022-12-29,PAM,heist,Kaboom Canyon,0,1,1
5927,2022-12-29,PAM,gemGrab,Undermine,0,8,8
5928,2022-12-29,PAM,brawlBall,Pinhole Punt,1,0,1
5929,2022-12-28,PAM,hotZone,Open Zone,0,1,1
5930,2022-12-27,PAM,hotZone,Controller Chaos,0,2,2
5931,2022-12-27,PAM,brawlBall,Beach Ball,4,0,4
5932,2022-12-26,PAM,hotZone,Controller Chaos,2,0,2
5933,2022-12-26,PAM,heist,Kaboom Canyon,0,1,1
5934,2022-12-26,PAM,gemGrab,Minecart Madness,1,0,1
5935,2022-12-25,PAM,brawlBall,Backyard Bowl,1,1,2
5936,2022-12-22,PAM,brawlBall,Pinhole Punt,0,5,5
5937,2022-12-20,PAM,brawlBall,Beach Ball,0,1,1
5938,2022-12-19,PAM,gemGrab,Minecart Madness,2,0,2
5939,2022-12-16,PAM,brawlBall,Sneaky Fields,2,0,2
5940,2022-12-13,PAM,hotZone,Dueling Beetles,0,1,1
5941,2022-12-13,PAM,gemGrab,Crystal Arcade,1,0,1
5942,2022-11-07,PAM,hotZone,Quarter Pounder,2,0,2
5943,2022-10-30,PAM,brawlBall,Beach Ball,1,0,1
5944,2022-10-15,PAM,hotZone,Ring of Fire,0,2,2
5945,2022-10-15,PAM,gemGrab,Hard Rock Mine,0,1,1
5946,2022-09-06,PAM,brawlBall,Beach Ball,2,2,4
5947,2023-02-11,OTIS,knockout,Flaring Phoenix,23,19,42
5948,2023-02-11,OTIS,hotZone,Controller Chaos,39,64,103
5949,2023-02-11,OTIS,gemGrab,Deep Diner,37,62,99
5950,2023-02-11,OTIS,brawlBall,Super Beach,61,98,159
5951,2023-02-11,OTIS,brawlBall,Sneaky Fields,62,78,140
5952,2023-02-10,OTIS,knockout,Flaring Phoenix,36,32,68
5953,2023-02-10,OTIS,hotZone,Controller Chaos,114,212,326
5954,2023-02-10,OTIS,heist,Hot Potato,7,7,14
5955,2023-02-10,OTIS,gemGrab,Undermine,16,10,26
5956,2023-02-10,OTIS,gemGrab,Deep Diner,55,83,138
5957,2023-02-10,OTIS,brawlBall,Sneaky Fields,445,694,1139
5958,2023-02-10,OTIS,brawlBall,Pinhole Punt,8,19,27
5959,2023-02-10,OTIS,bounty,Temple Ruins,42,62,104
5960,2023-02-09,OTIS,knockout,Riverside,7,1,8
5961,2023-02-09,OTIS,hotZone,Open Zone,10,19,29
5962,2023-02-09,OTIS,heist,Hot Potato,5,5,10
5963,2023-02-09,OTIS,gemGrab,Undermine,14,19,33
5964,2023-02-09,OTIS,gemGrab,Gem Fort,1,1,2
5965,2023-02-09,OTIS,brawlBall,Sunny Soccer,0,1,1
5966,2023-02-09,OTIS,brawlBall,Pinhole Punt,110,175,285
5967,2023-02-09,OTIS,bounty,Temple Ruins,8,20,28
5968,2023-02-08,OTIS,knockout,Riverside,2,2,4
5969,2023-02-08,OTIS,hotZone,Open Zone,3,3,6
5970,2023-02-08,OTIS,heist,Safe Zone,1,2,3
5971,2023-02-08,OTIS,gemGrab,Gem Fort,7,11,18
5972,2023-02-08,OTIS,gemGrab,Crystal Arcade,1,6,7
5973,2023-02-08,OTIS,brawlBall,Sunny Soccer,30,34,64
5974,2023-02-08,OTIS,brawlBall,Beach Ball,2,2,4
5975,2023-02-08,OTIS,bounty,Excel,0,1,1
5976,2023-02-07,OTIS,knockout,New Perspective,2,3,5
5977,2023-02-07,OTIS,hotZone,Dueling Beetles,6,19,25
5978,2023-02-07,OTIS,heist,Safe Zone,0,1,1
5979,2023-02-07,OTIS,gemGrab,Minecart Madness,10,28,38
5980,2023-02-07,OTIS,gemGrab,Crystal Arcade,4,2,6
5981,2023-02-07,OTIS,brawlBall,Center Stage,3,3,6
5982,2023-02-07,OTIS,brawlBall,Beach Ball,12,31,43
5983,2023-02-07,OTIS,bounty,Excel,1,0,1
5984,2023-02-06,OTIS,knockout,New Perspective,57,74,131
5985,2023-02-06,OTIS,knockout,Goldarm Gulch,12,4,16
5986,2023-02-06,OTIS,hotZone,Dueling Beetles,80,84,164
5987,2023-02-06,OTIS,heist,Snaked Assault,58,89,147
5988,2023-02-06,OTIS,heist,Pit Stop,3,0,3
5989,2023-02-06,OTIS,gemGrab,Minecart Madness,60,99,159
5990,2023-02-06,OTIS,gemGrab,Double Swoosh,84,124,208
5991,2023-02-06,OTIS,brawlBall,Sneaky Fields,33,37,70
5992,2023-02-06,OTIS,brawlBall,Center Stage,552,865,1417
5993,2023-02-06,OTIS,brawlBall,Backyard Bowl,47,90,137
5994,2023-02-06,OTIS,bounty,Layer Cake,14,25,39
5995,2023-02-05,OTIS,knockout,X Marks the Spot,30,27,57
5996,2023-02-05,OTIS,knockout,Goldarm Gulch,28,20,48
5997,2023-02-05,OTIS,hotZone,Ring of Fire,38,21,59
5998,2023-02-05,OTIS,heist,Snaked Assault,48,101,149
5999,2023-02-05,OTIS,heist,Pit Stop,13,9,22
6000,2023-02-05,OTIS,gemGrab,Hard Rock Mine,24,26,50
6001,2023-02-05,OTIS,gemGrab,Double Swoosh,184,342,526
6002,2023-02-05,OTIS,brawlBall,Super Beach,9,7,16
6003,2023-02-05,OTIS,brawlBall,Sneaky Fields,72,123,195
6004,2023-02-05,OTIS,brawlBall,Backyard Bowl,405,674,1079
6005,2023-02-05,OTIS,bounty,Layer Cake,14,26,40
6006,2023-02-04,OTIS,knockout,X Marks the Spot,8,8,16
6007,2023-02-04,OTIS,knockout,Goldarm Gulch,15,18,33
6008,2023-02-04,OTIS,hotZone,Ring of Fire,11,16,27
6009,2023-02-04,OTIS,heist,Tornado Ring,1,6,7
6010,2023-02-04,OTIS,heist,Pit Stop,9,4,13
6011,2023-02-04,OTIS,gemGrab,Hard Rock Mine,33,26,59
6012,2023-02-04,OTIS,gemGrab,Double Swoosh,31,79,110
6013,2023-02-04,OTIS,gemGrab,Deep Diner,5,4,9
6014,2023-02-04,OTIS,brawlBall,Super Beach,70,118,188
6015,2023-02-04,OTIS,brawlBall,Sneaky Fields,52,106,158
6016,2023-02-04,OTIS,bounty,Dry Season,4,10,14
6017,2023-02-03,OTIS,knockout,Out in the Open,38,38,76
6018,2023-02-03,OTIS,knockout,Goldarm Gulch,70,72,142
6019,2023-02-03,OTIS,hotZone,Split,15,33,48
6020,2023-02-03,OTIS,heist,Tornado Ring,29,49,78
6021,2023-02-03,OTIS,heist,Pit Stop,54,73,127
6022,2023-02-03,OTIS,gemGrab,Undermine,15,23,38
6023,2023-02-03,OTIS,gemGrab,Double Swoosh,130,301,431
6024,2023-02-03,OTIS,gemGrab,Deep Diner,70,77,147
6025,2023-02-03,OTIS,brawlBall,Sneaky Fields,565,886,1451
6026,2023-02-03,OTIS,brawlBall,Pinhole Punt,15,12,27
6027,2023-02-03,OTIS,bounty,Dry Season,24,14,38
6028,2023-02-02,OTIS,knockout,Out in the Open,30,50,80
6029,2023-02-02,OTIS,hotZone,Split,3,1,4
6030,2023-02-02,OTIS,heist,Kaboom Canyon,7,3,10
6031,2023-02-02,OTIS,gemGrab,Undermine,16,11,27
6032,2023-02-02,OTIS,gemGrab,Gem Fort,7,8,15
6033,2023-02-02,OTIS,brawlBall,Sunny Soccer,2,0,2
6034,2023-02-02,OTIS,brawlBall,Pinhole Punt,139,198,337
6035,2023-02-02,OTIS,bounty,Shooting Star,1,2,3
6036,2023-02-01,OTIS,knockout,Goldarm Gulch,63,101,164
6037,2023-02-01,OTIS,hotZone,Parallel Plays,57,79,136
6038,2023-02-01,OTIS,heist,Kaboom Canyon,23,29,52
6039,2023-02-01,OTIS,gemGrab,Gem Fort,58,118,176
6040,2023-02-01,OTIS,gemGrab,Crystal Arcade,67,69,136
6041,2023-02-01,OTIS,brawlBall,Sunny Soccer,251,401,652
6042,2023-02-01,OTIS,brawlBall,Beach Ball,17,24,41
6043,2023-02-01,OTIS,bounty,Shooting Star,10,14,24
6044,2023-01-31,OTIS,knockout,Goldarm Gulch,40,42,82
6045,2023-01-31,OTIS,hotZone,Parallel Plays,27,47,74
6046,2023-01-31,OTIS,heist,Pit Stop,3,5,8
6047,2023-01-31,OTIS,gemGrab,Minecart Madness,3,9,12
6048,2023-01-31,OTIS,gemGrab,Crystal Arcade,44,64,108
6049,2023-01-31,OTIS,brawlBall,Center Stage,7,7,14
6050,2023-01-31,OTIS,brawlBall,Beach Ball,150,220,370
6051,2023-01-31,OTIS,bounty,Hideout,3,5,8
6052,2023-01-30,OTIS,knockout,Belle's Rock,43,49,92
6053,2023-01-30,OTIS,hotZone,Quarter Pounder,62,156,218
6054,2023-01-30,OTIS,heist,Pit Stop,14,11,25
6055,2023-01-30,OTIS,gemGrab,Minecart Madness,45,55,100
6056,2023-01-30,OTIS,gemGrab,Double Swoosh,42,64,106
6057,2023-01-30,OTIS,brawlBall,Center Stage,316,504,820
6058,2023-01-30,OTIS,brawlBall,Backyard Bowl,41,45,86
6059,2023-01-30,OTIS,bounty,Hideout,2,1,3
6060,2023-01-29,OTIS,knockout,Belle's Rock,51,49,100
6061,2023-01-29,OTIS,hotZone,Quarter Pounder,42,65,107
6062,2023-01-29,OTIS,heist,Bridge Too Far,41,58,99
6063,2023-01-29,OTIS,gemGrab,Hard Rock Mine,13,24,37
6064,2023-01-29,OTIS,gemGrab,Double Swoosh,92,97,189
6065,2023-01-29,OTIS,brawlBall,Super Beach,9,13,22
6066,2023-01-29,OTIS,brawlBall,Backyard Bowl,349,393,742
6067,2023-01-29,OTIS,bounty,Canal Grande,9,16,25
6068,2023-01-28,OTIS,knockout,Flaring Phoenix,19,12,31
6069,2023-01-28,OTIS,hotZone,Controller Chaos,91,134,225
6070,2023-01-28,OTIS,heist,Bridge Too Far,87,82,169
6071,2023-01-28,OTIS,gemGrab,Hard Rock Mine,93,133,226
6072,2023-01-28,OTIS,gemGrab,Deep Diner,19,22,41
6073,2023-01-28,OTIS,brawlBall,Super Beach,279,410,689
6074,2023-01-28,OTIS,brawlBall,Sneaky Fields,16,15,31
6075,2023-01-28,OTIS,bounty,Canal Grande,22,18,40
6076,2023-01-27,OTIS,knockout,Flaring Phoenix,17,21,38
6077,2023-01-27,OTIS,hotZone,Controller Chaos,19,35,54
6078,2023-01-27,OTIS,heist,Hot Potato,5,12,17
6079,2023-01-27,OTIS,gemGrab,Undermine,5,6,11
6080,2023-01-27,OTIS,gemGrab,Deep Diner,24,27,51
6081,2023-01-27,OTIS,brawlBall,Sneaky Fields,132,163,295
6082,2023-01-27,OTIS,brawlBall,Pinhole Punt,13,8,21
6083,2023-01-27,OTIS,bounty,Temple Ruins,10,32,42
6084,2023-01-26,OTIS,knockout,Riverside,34,15,49
6085,2023-01-26,OTIS,hotZone,Open Zone,48,64,112
6086,2023-01-26,OTIS,heist,Hot Potato,19,16,35
6087,2023-01-26,OTIS,gemGrab,Undermine,43,62,105
6088,2023-01-26,OTIS,gemGrab,Gem Fort,31,31,62
6089,2023-01-26,OTIS,brawlBall,Sunny Soccer,11,31,42
6090,2023-01-26,OTIS,brawlBall,Pinhole Punt,375,584,959
6091,2023-01-26,OTIS,bounty,Temple Ruins,16,28,44
6092,2023-01-25,OTIS,knockout,Riverside,5,11,16
6093,2023-01-25,OTIS,hotZone,Open Zone,13,22,35
6094,2023-01-25,OTIS,heist,Safe Zone,18,27,45
6095,2023-01-25,OTIS,gemGrab,Gem Fort,23,64,87
6096,2023-01-25,OTIS,gemGrab,Crystal Arcade,49,89,138
6097,2023-01-25,OTIS,brawlBall,Sunny Soccer,204,316,520
6098,2023-01-25,OTIS,brawlBall,Beach Ball,45,67,112
6099,2023-01-25,OTIS,bounty,Excel,9,9,18
6100,2023-01-24,OTIS,knockout,New Perspective,36,34,70
6101,2023-01-24,OTIS,hotZone,Dueling Beetles,26,31,57
6102,2023-01-24,OTIS,heist,Safe Zone,24,18,42
6103,2023-01-24,OTIS,gemGrab,Minecart Madness,16,22,38
6104,2023-01-24,OTIS,gemGrab,Crystal Arcade,56,96,152
6105,2023-01-24,OTIS,brawlBall,Center Stage,39,44,83
6106,2023-01-24,OTIS,brawlBall,Beach Ball,361,458,819
6107,2023-01-24,OTIS,bounty,Excel,20,10,30
6108,2023-01-23,OTIS,knockout,New Perspective,52,66,118
6109,2023-01-23,OTIS,hotZone,Dueling Beetles,91,81,172
6110,2023-01-23,OTIS,heist,Snaked Assault,36,43,79
6111,2023-01-23,OTIS,gemGrab,Minecart Madness,77,138,215
6112,2023-01-23,OTIS,gemGrab,Double Swoosh,36,36,72
6113,2023-01-23,OTIS,brawlBall,Center Stage,514,767,1281
6114,2023-01-23,OTIS,brawlBall,Backyard Bowl,24,31,55
6115,2023-01-23,OTIS,bounty,Layer Cake,13,33,46
6116,2023-01-22,OTIS,knockout,X Marks the Spot,12,14,26
6117,2023-01-22,OTIS,hotZone,Ring of Fire,16,23,39
6118,2023-01-22,OTIS,heist,Snaked Assault,20,26,46
6119,2023-01-22,OTIS,gemGrab,Hard Rock Mine,29,51,80
6120,2023-01-22,OTIS,gemGrab,Double Swoosh,42,74,116
6121,2023-01-22,OTIS,brawlBall,Super Beach,34,59,93
6122,2023-01-22,OTIS,brawlBall,Backyard Bowl,171,259,430
6123,2023-01-22,OTIS,bounty,Layer Cake,8,6,14
6124,2023-01-21,OTIS,knockout,X Marks the Spot,55,75,130
6125,2023-01-21,OTIS,hotZone,Ring of Fire,73,91,164
6126,2023-01-21,OTIS,heist,Tornado Ring,17,22,39
6127,2023-01-21,OTIS,gemGrab,Hard Rock Mine,87,88,175
6128,2023-01-21,OTIS,gemGrab,Deep Diner,17,31,48
6129,2023-01-21,OTIS,brawlBall,Super Beach,516,773,1289
6130,2023-01-21,OTIS,brawlBall,Sneaky Fields,9,12,21
6131,2023-01-21,OTIS,bounty,Dry Season,22,34,56
6132,2023-01-20,OTIS,knockout,Out in the Open,73,88,161
6133,2023-01-20,OTIS,hotZone,Split,10,16,26
6134,2023-01-20,OTIS,heist,Tornado Ring,19,22,41
6135,2023-01-20,OTIS,gemGrab,Undermine,20,30,50
6136,2023-01-20,OTIS,gemGrab,Deep Diner,84,112,196
6137,2023-01-20,OTIS,brawlBall,Sneaky Fields,375,546,921
6138,2023-01-20,OTIS,brawlBall,Pinhole Punt,22,48,70
6139,2023-01-20,OTIS,bounty,Dry Season,21,28,49
6140,2023-01-19,OTIS,knockout,Out in the Open,82,90,172
6141,2023-01-19,OTIS,hotZone,Split,14,11,25
6142,2023-01-19,OTIS,heist,Kaboom Canyon,17,13,30
6143,2023-01-19,OTIS,gemGrab,Undermine,58,68,126
6144,2023-01-19,OTIS,gemGrab,Gem Fort,15,4,19
6145,2023-01-19,OTIS,brawlBall,Sunny Soccer,3,6,9
6146,2023-01-19,OTIS,brawlBall,Pinhole Punt,422,612,1034
6147,2023-01-19,OTIS,bounty,Shooting Star,12,13,25
6148,2023-01-18,OTIS,knockout,Goldarm Gulch,6,6,12
6149,2023-01-18,OTIS,hotZone,Parallel Plays,3,11,14
6150,2023-01-18,OTIS,heist,Kaboom Canyon,7,14,21
6151,2023-01-18,OTIS,gemGrab,Gem Fort,23,36,59
6152,2023-01-18,OTIS,gemGrab,Crystal Arcade,5,5,10
6153,2023-01-18,OTIS,brawlBall,Sunny Soccer,112,167,279
6154,2023-01-18,OTIS,brawlBall,Beach Ball,0,2,2
6155,2023-01-18,OTIS,bounty,Shooting Star,8,3,11
6156,2023-01-17,OTIS,knockout,Goldarm Gulch,16,15,31
6157,2023-01-17,OTIS,hotZone,Parallel Plays,10,6,16
6158,2023-01-17,OTIS,heist,Pit Stop,5,2,7
6159,2023-01-17,OTIS,gemGrab,Minecart Madness,1,1,2
6160,2023-01-17,OTIS,gemGrab,Crystal Arcade,13,19,32
6161,2023-01-17,OTIS,brawlBall,Center Stage,1,1,2
6162,2023-01-17,OTIS,brawlBall,Beach Ball,28,50,78
6163,2023-01-17,OTIS,bounty,Hideout,0,1,1
6164,2023-01-16,OTIS,knockout,Belle's Rock,4,2,6
6165,2023-01-16,OTIS,hotZone,Quarter Pounder,6,22,28
6166,2023-01-16,OTIS,heist,Pit Stop,8,3,11
6167,2023-01-16,OTIS,gemGrab,Minecart Madness,6,8,14
6168,2023-01-16,OTIS,gemGrab,Double Swoosh,1,6,7
6169,2023-01-16,OTIS,brawlBall,Center Stage,36,70,106
6170,2023-01-16,OTIS,brawlBall,Backyard Bowl,3,6,9
6171,2023-01-15,OTIS,knockout,Belle's Rock,4,5,9
6172,2023-01-15,OTIS,hotZone,Quarter Pounder,18,4,22
6173,2023-01-15,OTIS,heist,Bridge Too Far,7,8,15
6174,2023-01-15,OTIS,gemGrab,Hard Rock Mine,2,11,13
6175,2023-01-15,OTIS,gemGrab,Double Swoosh,16,45,61
6176,2023-01-15,OTIS,brawlBall,Super Beach,4,9,13
6177,2023-01-15,OTIS,brawlBall,Backyard Bowl,39,72,111
6178,2023-01-15,OTIS,bounty,Canal Grande,3,1,4
6179,2023-01-14,OTIS,knockout,Flaring Phoenix,3,4,7
6180,2023-01-14,OTIS,hotZone,Controller Chaos,30,65,95
6181,2023-01-14,OTIS,heist,Bridge Too Far,15,24,39
6182,2023-01-14,OTIS,gemGrab,Hard Rock Mine,5,4,9
6183,2023-01-14,OTIS,gemGrab,Deep Diner,5,20,25
6184,2023-01-14,OTIS,brawlBall,Super Beach,26,42,68
6185,2023-01-14,OTIS,brawlBall,Sneaky Fields,11,35,46
6186,2023-01-14,OTIS,bounty,Canal Grande,2,1,3
6187,2023-01-13,OTIS,knockout,Flaring Phoenix,2,0,2
6188,2023-01-13,OTIS,hotZone,Controller Chaos,13,25,38
6189,2023-01-13,OTIS,heist,Hot Potato,3,7,10
6190,2023-01-13,OTIS,gemGrab,Deep Diner,5,23,28
6191,2023-01-13,OTIS,brawlBall,Sneaky Fields,47,39,86
6192,2023-01-13,OTIS,brawlBall,Pinhole Punt,2,1,3
6193,2023-01-13,OTIS,bounty,Temple Ruins,1,2,3
6194,2023-01-12,OTIS,knockout,Riverside,1,4,5
6195,2023-01-12,OTIS,hotZone,Open Zone,9,7,16
6196,2023-01-12,OTIS,heist,Hot Potato,2,0,2
6197,2023-01-12,OTIS,gemGrab,Undermine,4,6,10
6198,2023-01-12,OTIS,brawlBall,Sunny Soccer,3,6,9
6199,2023-01-12,OTIS,brawlBall,Pinhole Punt,16,9,25
6200,2023-01-11,OTIS,hotZone,Open Zone,1,0,1
6201,2023-01-11,OTIS,gemGrab,Gem Fort,1,1,2
6202,2023-01-11,OTIS,brawlBall,Sunny Soccer,5,22,27
6203,2023-01-10,OTIS,hotZone,Dueling Beetles,10,47,57
6204,2023-01-10,OTIS,heist,Safe Zone,4,7,11
6205,2023-01-10,OTIS,gemGrab,Minecart Madness,5,5,10
6206,2023-01-10,OTIS,gemGrab,Crystal Arcade,10,12,22
6207,2023-01-10,OTIS,brawlBall,Center Stage,6,3,9
6208,2023-01-10,OTIS,brawlBall,Beach Ball,28,41,69
6209,2023-01-09,OTIS,knockout,New Perspective,1,2,3
6210,2023-01-09,OTIS,hotZone,Dueling Beetles,4,0,4
6211,2023-01-09,OTIS,heist,Snaked Assault,3,2,5
6212,2023-01-09,OTIS,gemGrab,Minecart Madness,10,23,33
6213,2023-01-09,OTIS,gemGrab,Double Swoosh,9,17,26
6214,2023-01-09,OTIS,brawlBall,Center Stage,34,35,69
6215,2023-01-09,OTIS,bounty,Layer Cake,3,15,18
6216,2023-01-08,OTIS,knockout,X Marks the Spot,5,17,22
6217,2023-01-08,OTIS,hotZone,Ring of Fire,12,18,30
6218,2023-01-08,OTIS,heist,Snaked Assault,2,5,7
6219,2023-01-08,OTIS,gemGrab,Hard Rock Mine,1,0,1
6220,2023-01-08,OTIS,gemGrab,Double Swoosh,4,10,14
6221,2023-01-08,OTIS,brawlBall,Super Beach,7,19,26
6222,2023-01-08,OTIS,brawlBall,Backyard Bowl,30,40,70
6223,2023-01-07,OTIS,hotZone,Ring of Fire,8,9,17
6224,2023-01-07,OTIS,heist,Tornado Ring,2,0,2
6225,2023-01-07,OTIS,gemGrab,Hard Rock Mine,7,20,27
6226,2023-01-07,OTIS,gemGrab,Deep Diner,2,0,2
6227,2023-01-07,OTIS,brawlBall,Super Beach,11,8,19
6228,2023-01-07,OTIS,brawlBall,Sneaky Fields,1,9,10
6229,2023-01-07,OTIS,bounty,Dry Season,3,13,16
6230,2023-01-06,OTIS,knockout,Out in the Open,4,0,4
6231,2023-01-06,OTIS,hotZone,Split,1,2,3
6232,2023-01-06,OTIS,heist,Tornado Ring,6,0,6
6233,2023-01-06,OTIS,gemGrab,Undermine,2,1,3
6234,2023-01-06,OTIS,gemGrab,Deep Diner,4,2,6
6235,2023-01-06,OTIS,brawlBall,Sneaky Fields,40,100,140
6236,2023-01-06,OTIS,brawlBall,Pinhole Punt,1,1,2
6237,2023-01-06,OTIS,bounty,Dry Season,3,4,7
6238,2023-01-05,OTIS,knockout,Out in the Open,11,16,27
6239,2023-01-05,OTIS,hotZone,Split,5,16,21
6240,2023-01-05,OTIS,heist,Kaboom Canyon,1,6,7
6241,2023-01-05,OTIS,gemGrab,Undermine,6,0,6
6242,2023-01-05,OTIS,brawlBall,Pinhole Punt,46,119,165
6243,2023-01-04,OTIS,knockout,Goldarm Gulch,4,5,9
6244,2023-01-04,OTIS,hotZone,Parallel Plays,7,7,14
6245,2023-01-04,OTIS,heist,Kaboom Canyon,8,3,11
6246,2023-01-04,OTIS,gemGrab,Gem Fort,6,7,13
6247,2023-01-04,OTIS,gemGrab,Crystal Arcade,5,5,10
6248,2023-01-04,OTIS,brawlBall,Sunny Soccer,41,74,115
6249,2023-01-04,OTIS,bounty,Shooting Star,1,0,1
6250,2023-01-03,OTIS,knockout,Goldarm Gulch,7,14,21
6251,2023-01-03,OTIS,hotZone,Parallel Plays,4,7,11
6252,2023-01-03,OTIS,heist,Pit Stop,3,0,3
6253,2023-01-03,OTIS,gemGrab,Minecart Madness,1,0,1
6254,2023-01-03,OTIS,gemGrab,Crystal Arcade,3,5,8
6255,2023-01-03,OTIS,brawlBall,Center Stage,1,4,5
6256,2023-01-03,OTIS,brawlBall,Beach Ball,40,106,146
6257,2023-01-03,OTIS,bounty,Hideout,3,0,3
6258,2023-01-02,OTIS,knockout,Belle's Rock,7,5,12
6259,2023-01-02,OTIS,hotZone,Quarter Pounder,10,30,40
6260,2023-01-02,OTIS,heist,Pit Stop,0,2,2
6261,2023-01-02,OTIS,gemGrab,Minecart Madness,7,57,64
6262,2023-01-02,OTIS,gemGrab,Double Swoosh,8,4,12
6263,2023-01-02,OTIS,brawlBall,Center Stage,46,63,109
6264,2023-01-02,OTIS,brawlBall,Backyard Bowl,4,8,12
6265,2023-01-02,OTIS,bounty,Hideout,1,4,5
6266,2023-01-01,OTIS,knockout,Belle's Rock,3,2,5
6267,2023-01-01,OTIS,hotZone,Quarter Pounder,6,9,15
6268,2023-01-01,OTIS,heist,Bridge Too Far,6,2,8
6269,2023-01-01,OTIS,gemGrab,Double Swoosh,6,7,13
6270,2023-01-01,OTIS,brawlBall,Backyard Bowl,14,38,52
6271,2023-01-01,OTIS,bounty,Canal Grande,0,2,2
6272,2022-12-31,OTIS,hotZone,Controller Chaos,2,14,16
6273,2022-12-31,OTIS,heist,Bridge Too Far,2,0,2
6274,2022-12-31,OTIS,gemGrab,Minecart Madness,0,2,2
6275,2022-12-31,OTIS,brawlBall,Super Beach,5,0,5
6276,2022-12-31,OTIS,brawlBall,Sneaky Fields,0,1,1
6277,2022-12-30,OTIS,heist,Kaboom Canyon,0,1,1
6278,2022-12-30,OTIS,gemGrab,Deep Diner,1,3,4
6279,2022-12-30,OTIS,brawlBall,Sneaky Fields,4,5,9
6280,2022-12-29,OTIS,hotZone,Open Zone,5,3,8
6281,2022-12-29,OTIS,heist,Hot Potato,1,5,6
6282,2022-12-29,OTIS,gemGrab,Minecart Madness,0,1,1
6283,2022-12-29,OTIS,brawlBall,Pinhole Punt,1,1,2
6284,2022-12-28,OTIS,hotZone,Open Zone,7,13,20
6285,2022-12-27,OTIS,hotZone,Dueling Beetles,1,0,1
6286,2022-12-27,OTIS,brawlBall,Beach Ball,0,3,3
6287,2022-12-26,OTIS,gemGrab,Minecart Madness,0,1,1
6288,2022-12-25,OTIS,brawlBall,Backyard Bowl,1,0,1
6289,2022-12-22,OTIS,gemGrab,Gem Fort,1,12,13
6290,2022-12-22,OTIS,brawlBall,Pinhole Punt,1,8,9
6291,2022-12-21,OTIS,brawlBall,Sunny Soccer,0,1,1
6292,2022-12-19,OTIS,brawlBall,Center Stage,2,1,3
6293,2022-12-16,OTIS,brawlBall,Sneaky Fields,3,2,5
6294,2022-12-13,OTIS,gemGrab,Crystal Arcade,0,1,1
6295,2022-12-11,OTIS,brawlBall,Backyard Bowl,2,0,2
6296,2022-11-18,OTIS,hotZone,Parallel Plays,2,0,2
6297,2022-11-07,OTIS,hotZone,Quarter Pounder,6,2,8
6298,2022-10-26,OTIS,brawlBall,Sunny Soccer,2,4,6
6299,2022-10-15,OTIS,gemGrab,Hard Rock Mine,0,1,1
6300,2022-10-15,OTIS,bounty,Dry Season,0,2,2
6301,2022-10-10,OTIS,knockout,Belle's Rock,1,0,1
6302,2023-02-11,NITA,knockout,Flaring Phoenix,10,2,12
6303,2023-02-11,NITA,hotZone,Controller Chaos,258,320,578
6304,2023-02-11,NITA,gemGrab,Deep Diner,70,111,181
6305,2023-02-11,NITA,brawlBall,Super Beach,159,166,325
6306,2023-02-11,NITA,brawlBall,Sneaky Fields,223,265,488
6307,2023-02-10,NITA,knockout,Flaring Phoenix,24,17,41
6308,2023-02-10,NITA,hotZone,Controller Chaos,488,554,1042
6309,2023-02-10,NITA,heist,Hot Potato,309,330,639
6310,2023-02-10,NITA,gemGrab,Undermine,37,44,81
6311,2023-02-10,NITA,gemGrab,Deep Diner,161,185,346
6312,2023-02-10,NITA,brawlBall,Sneaky Fields,1505,1765,3270
6313,2023-02-10,NITA,brawlBall,Pinhole Punt,5,10,15
6314,2023-02-10,NITA,bounty,Temple Ruins,21,28,49
6315,2023-02-09,NITA,knockout,Riverside,1,0,1
6316,2023-02-09,NITA,hotZone,Open Zone,5,5,10
6317,2023-02-09,NITA,heist,Hot Potato,141,143,284
6318,2023-02-09,NITA,gemGrab,Undermine,50,71,121
6319,2023-02-09,NITA,gemGrab,Gem Fort,2,7,9
6320,2023-02-09,NITA,brawlBall,Sunny Soccer,3,0,3
6321,2023-02-09,NITA,brawlBall,Pinhole Punt,120,162,282
6322,2023-02-09,NITA,bounty,Temple Ruins,11,10,21
6323,2023-02-08,NITA,knockout,Riverside,2,1,3
6324,2023-02-08,NITA,hotZone,Open Zone,5,0,5
6325,2023-02-08,NITA,heist,Safe Zone,7,7,14
6326,2023-02-08,NITA,gemGrab,Gem Fort,14,18,32
6327,2023-02-08,NITA,gemGrab,Crystal Arcade,8,8,16
6328,2023-02-08,NITA,brawlBall,Sunny Soccer,72,80,152
6329,2023-02-08,NITA,brawlBall,Beach Ball,2,3,5
6330,2023-02-08,NITA,bounty,Excel,2,0,2
6331,2023-02-07,NITA,hotZone,Dueling Beetles,15,3,18
6332,2023-02-07,NITA,heist,Safe Zone,5,2,7
6333,2023-02-07,NITA,gemGrab,Minecart Madness,2,0,2
6334,2023-02-07,NITA,gemGrab,Crystal Arcade,5,11,16
6335,2023-02-07,NITA,brawlBall,Center Stage,29,35,64
6336,2023-02-07,NITA,brawlBall,Beach Ball,36,47,83
6337,2023-02-07,NITA,bounty,Excel,0,1,1
6338,2023-02-06,NITA,knockout,New Perspective,28,11,39
6339,2023-02-06,NITA,hotZone,Dueling Beetles,164,77,241
6340,2023-02-06,NITA,heist,Snaked Assault,908,982,1890
6341,2023-02-06,NITA,heist,Pit Stop,191,198,389
6342,2023-02-06,NITA,gemGrab,Minecart Madness,72,41,113
6343,2023-02-06,NITA,gemGrab,Double Swoosh,150,98,248
6344,2023-02-06,NITA,brawlBall,Sneaky Fields,78,81,159
6345,2023-02-06,NITA,brawlBall,Center Stage,1094,1244,2338
6346,2023-02-06,NITA,brawlBall,Backyard Bowl,16,15,31
6347,2023-02-06,NITA,bounty,Layer Cake,15,10,25
6348,2023-02-05,NITA,knockout,X Marks the Spot,20,5,25
6349,2023-02-05,NITA,knockout,Goldarm Gulch,0,1,1
6350,2023-02-05,NITA,hotZone,Ring of Fire,78,78,156
6351,2023-02-05,NITA,heist,Snaked Assault,1217,1288,2505
6352,2023-02-05,NITA,heist,Pit Stop,550,576,1126
6353,2023-02-05,NITA,gemGrab,Hard Rock Mine,55,30,85
6354,2023-02-05,NITA,gemGrab,Double Swoosh,485,448,933
6355,2023-02-05,NITA,brawlBall,Super Beach,22,48,70
6356,2023-02-05,NITA,brawlBall,Sneaky Fields,187,184,371
6357,2023-02-05,NITA,brawlBall,Backyard Bowl,241,189,430
6358,2023-02-05,NITA,bounty,Layer Cake,26,5,31
6359,2023-02-04,NITA,knockout,X Marks the Spot,7,1,8
6360,2023-02-04,NITA,hotZone,Ring of Fire,17,21,38
6361,2023-02-04,NITA,heist,Tornado Ring,126,202,328
6362,2023-02-04,NITA,heist,Pit Stop,350,363,713
6363,2023-02-04,NITA,gemGrab,Hard Rock Mine,87,88,175
6364,2023-02-04,NITA,gemGrab,Double Swoosh,47,22,69
6365,2023-02-04,NITA,gemGrab,Deep Diner,8,0,8
6366,2023-02-04,NITA,brawlBall,Super Beach,287,354,641
6367,2023-02-04,NITA,brawlBall,Sneaky Fields,144,155,299
6368,2023-02-04,NITA,bounty,Dry Season,1,0,1
6369,2023-02-03,NITA,knockout,Out in the Open,14,4,18
6370,2023-02-03,NITA,knockout,Goldarm Gulch,3,1,4
6371,2023-02-03,NITA,hotZone,Split,116,112,228
6372,2023-02-03,NITA,heist,Tornado Ring,1193,1315,2508
6373,2023-02-03,NITA,heist,Pit Stop,1868,1733,3601
6374,2023-02-03,NITA,gemGrab,Undermine,34,40,74
6375,2023-02-03,NITA,gemGrab,Double Swoosh,211,138,349
6376,2023-02-03,NITA,gemGrab,Deep Diner,212,214,426
6377,2023-02-03,NITA,brawlBall,Sneaky Fields,2058,2567,4625
6378,2023-02-03,NITA,brawlBall,Pinhole Punt,13,33,46
6379,2023-02-03,NITA,bounty,Dry Season,11,2,13
6380,2023-02-02,NITA,knockout,Out in the Open,3,2,5
6381,2023-02-02,NITA,hotZone,Split,52,29,81
6382,2023-02-02,NITA,heist,Kaboom Canyon,37,19,56
6383,2023-02-02,NITA,gemGrab,Undermine,52,61,113
6384,2023-02-02,NITA,gemGrab,Gem Fort,7,9,16
6385,2023-02-02,NITA,brawlBall,Sunny Soccer,4,3,7
6386,2023-02-02,NITA,brawlBall,Pinhole Punt,141,186,327
6387,2023-02-02,NITA,bounty,Shooting Star,1,0,1
6388,2023-02-01,NITA,knockout,Goldarm Gulch,25,14,39
6389,2023-02-01,NITA,hotZone,Parallel Plays,250,296,546
6390,2023-02-01,NITA,heist,Kaboom Canyon,82,62,144
6391,2023-02-01,NITA,gemGrab,Gem Fort,122,158,280
6392,2023-02-01,NITA,gemGrab,Crystal Arcade,68,65,133
6393,2023-02-01,NITA,brawlBall,Sunny Soccer,727,928,1655
6394,2023-02-01,NITA,brawlBall,Beach Ball,22,42,64
6395,2023-02-01,NITA,bounty,Shooting Star,5,1,6
6396,2023-01-31,NITA,knockout,Goldarm Gulch,10,14,24
6397,2023-01-31,NITA,hotZone,Parallel Plays,125,151,276
6398,2023-01-31,NITA,heist,Pit Stop,186,179,365
6399,2023-01-31,NITA,gemGrab,Minecart Madness,3,4,7
6400,2023-01-31,NITA,gemGrab,Crystal Arcade,125,148,273
6401,2023-01-31,NITA,brawlBall,Center Stage,5,12,17
6402,2023-01-31,NITA,brawlBall,Beach Ball,266,294,560
6403,2023-01-31,NITA,bounty,Hideout,3,0,3
6404,2023-01-30,NITA,knockout,Belle's Rock,15,4,19
6405,2023-01-30,NITA,hotZone,Quarter Pounder,173,65,238
6406,2023-01-30,NITA,heist,Pit Stop,569,429,998
6407,2023-01-30,NITA,gemGrab,Minecart Madness,39,16,55
6408,2023-01-30,NITA,gemGrab,Double Swoosh,135,106,241
6409,2023-01-30,NITA,brawlBall,Center Stage,644,719,1363
6410,2023-01-30,NITA,brawlBall,Backyard Bowl,22,13,35
6411,2023-01-30,NITA,bounty,Hideout,2,3,5
6412,2023-01-29,NITA,knockout,Belle's Rock,17,8,25
6413,2023-01-29,NITA,hotZone,Quarter Pounder,169,130,299
6414,2023-01-29,NITA,heist,Bridge Too Far,64,18,82
6415,2023-01-29,NITA,gemGrab,Hard Rock Mine,40,48,88
6416,2023-01-29,NITA,gemGrab,Double Swoosh,267,300,567
6417,2023-01-29,NITA,brawlBall,Super Beach,12,13,25
6418,2023-01-29,NITA,brawlBall,Backyard Bowl,219,145,364
6419,2023-01-29,NITA,bounty,Canal Grande,24,14,38
6420,2023-01-28,NITA,knockout,Flaring Phoenix,23,10,33
6421,2023-01-28,NITA,hotZone,Controller Chaos,244,264,508
6422,2023-01-28,NITA,heist,Bridge Too Far,128,52,180
6423,2023-01-28,NITA,gemGrab,Hard Rock Mine,173,156,329
6424,2023-01-28,NITA,gemGrab,Deep Diner,43,42,85
6425,2023-01-28,NITA,brawlBall,Super Beach,1097,1162,2259
6426,2023-01-28,NITA,brawlBall,Sneaky Fields,81,112,193
6427,2023-01-28,NITA,bounty,Canal Grande,54,53,107
6428,2023-01-27,NITA,knockout,Flaring Phoenix,2,4,6
6429,2023-01-27,NITA,hotZone,Controller Chaos,58,71,129
6430,2023-01-27,NITA,heist,Hot Potato,153,186,339
6431,2023-01-27,NITA,gemGrab,Undermine,10,5,15
6432,2023-01-27,NITA,gemGrab,Deep Diner,53,37,90
6433,2023-01-27,NITA,brawlBall,Sneaky Fields,416,484,900
6434,2023-01-27,NITA,brawlBall,Pinhole Punt,5,3,8
6435,2023-01-27,NITA,bounty,Temple Ruins,8,1,9
6436,2023-01-26,NITA,knockout,Riverside,18,6,24
6437,2023-01-26,NITA,hotZone,Open Zone,39,16,55
6438,2023-01-26,NITA,heist,Hot Potato,632,632,1264
6439,2023-01-26,NITA,gemGrab,Undermine,124,174,298
6440,2023-01-26,NITA,gemGrab,Gem Fort,48,41,89
6441,2023-01-26,NITA,brawlBall,Sunny Soccer,62,75,137
6442,2023-01-26,NITA,brawlBall,Pinhole Punt,416,534,950
6443,2023-01-26,NITA,bounty,Temple Ruins,13,5,18
6444,2023-01-25,NITA,knockout,Riverside,2,0,2
6445,2023-01-25,NITA,hotZone,Open Zone,21,8,29
6446,2023-01-25,NITA,heist,Safe Zone,88,39,127
6447,2023-01-25,NITA,gemGrab,Gem Fort,74,88,162
6448,2023-01-25,NITA,gemGrab,Crystal Arcade,110,141,251
6449,2023-01-25,NITA,brawlBall,Sunny Soccer,488,504,992
6450,2023-01-25,NITA,brawlBall,Beach Ball,55,48,103
6451,2023-01-25,NITA,bounty,Excel,7,7,14
6452,2023-01-24,NITA,knockout,New Perspective,9,6,15
6453,2023-01-24,NITA,hotZone,Dueling Beetles,80,42,122
6454,2023-01-24,NITA,heist,Safe Zone,108,67,175
6455,2023-01-24,NITA,gemGrab,Minecart Madness,6,5,11
6456,2023-01-24,NITA,gemGrab,Crystal Arcade,334,405,739
6457,2023-01-24,NITA,brawlBall,Center Stage,81,77,158
6458,2023-01-24,NITA,brawlBall,Beach Ball,591,626,1217
6459,2023-01-24,NITA,bounty,Excel,7,4,11
6460,2023-01-23,NITA,knockout,New Perspective,30,15,45
6461,2023-01-23,NITA,hotZone,Dueling Beetles,137,90,227
6462,2023-01-23,NITA,heist,Snaked Assault,989,1132,2121
6463,2023-01-23,NITA,gemGrab,Minecart Madness,60,47,107
6464,2023-01-23,NITA,gemGrab,Double Swoosh,94,97,191
6465,2023-01-23,NITA,brawlBall,Center Stage,1012,1042,2054
6466,2023-01-23,NITA,brawlBall,Backyard Bowl,6,6,12
6467,2023-01-23,NITA,bounty,Layer Cake,14,5,19
6468,2023-01-22,NITA,knockout,X Marks the Spot,10,3,13
6469,2023-01-22,NITA,hotZone,Ring of Fire,43,41,84
6470,2023-01-22,NITA,heist,Snaked Assault,524,575,1099
6471,2023-01-22,NITA,gemGrab,Hard Rock Mine,67,94,161
6472,2023-01-22,NITA,gemGrab,Double Swoosh,142,131,273
6473,2023-01-22,NITA,brawlBall,Super Beach,102,109,211
6474,2023-01-22,NITA,brawlBall,Backyard Bowl,94,89,183
6475,2023-01-22,NITA,bounty,Layer Cake,9,2,11
6476,2023-01-21,NITA,knockout,X Marks the Spot,28,6,34
6477,2023-01-21,NITA,hotZone,Ring of Fire,90,57,147
6478,2023-01-21,NITA,heist,Tornado Ring,746,924,1670
6479,2023-01-21,NITA,gemGrab,Hard Rock Mine,262,258,520
6480,2023-01-21,NITA,gemGrab,Deep Diner,31,53,84
6481,2023-01-21,NITA,brawlBall,Super Beach,1347,1567,2914
6482,2023-01-21,NITA,brawlBall,Sneaky Fields,70,98,168
6483,2023-01-21,NITA,bounty,Dry Season,3,12,15
6484,2023-01-20,NITA,knockout,Out in the Open,20,9,29
6485,2023-01-20,NITA,hotZone,Split,108,50,158
6486,2023-01-20,NITA,heist,Tornado Ring,806,855,1661
6487,2023-01-20,NITA,gemGrab,Undermine,50,56,106
6488,2023-01-20,NITA,gemGrab,Deep Diner,186,218,404
6489,2023-01-20,NITA,brawlBall,Sneaky Fields,1165,1388,2553
6490,2023-01-20,NITA,brawlBall,Pinhole Punt,18,13,31
6491,2023-01-20,NITA,bounty,Dry Season,4,3,7
6492,2023-01-19,NITA,knockout,Out in the Open,25,6,31
6493,2023-01-19,NITA,hotZone,Split,143,115,258
6494,2023-01-19,NITA,heist,Kaboom Canyon,125,93,218
6495,2023-01-19,NITA,gemGrab,Undermine,171,208,379
6496,2023-01-19,NITA,gemGrab,Gem Fort,31,37,68
6497,2023-01-19,NITA,brawlBall,Sunny Soccer,18,15,33
6498,2023-01-19,NITA,brawlBall,Pinhole Punt,529,518,1047
6499,2023-01-19,NITA,bounty,Shooting Star,3,1,4
6500,2023-01-18,NITA,knockout,Goldarm Gulch,4,3,7
6501,2023-01-18,NITA,hotZone,Parallel Plays,29,22,51
6502,2023-01-18,NITA,heist,Kaboom Canyon,41,21,62
6503,2023-01-18,NITA,gemGrab,Gem Fort,32,32,64
6504,2023-01-18,NITA,gemGrab,Crystal Arcade,6,15,21
6505,2023-01-18,NITA,brawlBall,Sunny Soccer,218,222,440
6506,2023-01-18,NITA,brawlBall,Beach Ball,6,6,12
6507,2023-01-18,NITA,bounty,Shooting Star,1,0,1
6508,2023-01-17,NITA,knockout,Goldarm Gulch,7,3,10
6509,2023-01-17,NITA,hotZone,Parallel Plays,25,22,47
6510,2023-01-17,NITA,heist,Pit Stop,56,62,118
6511,2023-01-17,NITA,gemGrab,Crystal Arcade,19,22,41
6512,2023-01-17,NITA,brawlBall,Center Stage,2,2,4
6513,2023-01-17,NITA,brawlBall,Beach Ball,56,70,126
6514,2023-01-16,NITA,knockout,Belle's Rock,1,0,1
6515,2023-01-16,NITA,hotZone,Quarter Pounder,15,8,23
6516,2023-01-16,NITA,heist,Pit Stop,173,187,360
6517,2023-01-16,NITA,gemGrab,Minecart Madness,4,3,7
6518,2023-01-16,NITA,gemGrab,Double Swoosh,4,5,9
6519,2023-01-16,NITA,brawlBall,Center Stage,88,118,206
6520,2023-01-16,NITA,brawlBall,Backyard Bowl,2,0,2
6521,2023-01-15,NITA,knockout,Belle's Rock,1,0,1
6522,2023-01-15,NITA,hotZone,Quarter Pounder,67,35,102
6523,2023-01-15,NITA,heist,Bridge Too Far,10,2,12
6524,2023-01-15,NITA,gemGrab,Hard Rock Mine,15,5,20
6525,2023-01-15,NITA,gemGrab,Double Swoosh,43,40,83
6526,2023-01-15,NITA,brawlBall,Super Beach,15,9,24
6527,2023-01-15,NITA,brawlBall,Backyard Bowl,33,19,52
6528,2023-01-15,NITA,bounty,Canal Grande,5,1,6
6529,2023-01-14,NITA,knockout,Flaring Phoenix,1,0,1
6530,2023-01-14,NITA,hotZone,Controller Chaos,72,35,107
6531,2023-01-14,NITA,heist,Bridge Too Far,21,4,25
6532,2023-01-14,NITA,gemGrab,Hard Rock Mine,9,4,13
6533,2023-01-14,NITA,gemGrab,Deep Diner,13,16,29
6534,2023-01-14,NITA,brawlBall,Super Beach,99,104,203
6535,2023-01-14,NITA,brawlBall,Sneaky Fields,23,27,50
6536,2023-01-14,NITA,bounty,Canal Grande,6,1,7
6537,2023-01-13,NITA,knockout,Flaring Phoenix,4,0,4
6538,2023-01-13,NITA,hotZone,Controller Chaos,137,101,238
6539,2023-01-13,NITA,heist,Hot Potato,32,49,81
6540,2023-01-13,NITA,gemGrab,Deep Diner,9,7,16
6541,2023-01-13,NITA,brawlBall,Sneaky Fields,126,160,286
6542,2023-01-13,NITA,bounty,Temple Ruins,3,0,3
6543,2023-01-12,NITA,hotZone,Open Zone,3,1,4
6544,2023-01-12,NITA,heist,Hot Potato,23,17,40
6545,2023-01-12,NITA,gemGrab,Undermine,10,10,20
6546,2023-01-12,NITA,gemGrab,Gem Fort,2,0,2
6547,2023-01-12,NITA,brawlBall,Sunny Soccer,2,2,4
6548,2023-01-12,NITA,brawlBall,Pinhole Punt,19,6,25
6549,2023-01-11,NITA,knockout,Riverside,2,0,2
6550,2023-01-11,NITA,hotZone,Open Zone,2,0,2
6551,2023-01-11,NITA,heist,Safe Zone,0,1,1
6552,2023-01-11,NITA,gemGrab,Gem Fort,8,3,11
6553,2023-01-11,NITA,brawlBall,Sunny Soccer,23,18,41
6554,2023-01-11,NITA,brawlBall,Beach Ball,0,1,1
6555,2023-01-11,NITA,bounty,Excel,2,2,4
6556,2023-01-10,NITA,hotZone,Dueling Beetles,21,3,24
6557,2023-01-10,NITA,heist,Safe Zone,9,2,11
6558,2023-01-10,NITA,gemGrab,Minecart Madness,2,0,2
6559,2023-01-10,NITA,gemGrab,Crystal Arcade,46,45,91
6560,2023-01-10,NITA,brawlBall,Center Stage,6,14,20
6561,2023-01-10,NITA,brawlBall,Beach Ball,42,79,121
6562,2023-01-09,NITA,knockout,New Perspective,1,0,1
6563,2023-01-09,NITA,hotZone,Dueling Beetles,10,2,12
6564,2023-01-09,NITA,heist,Snaked Assault,146,127,273
6565,2023-01-09,NITA,gemGrab,Minecart Madness,6,0,6
6566,2023-01-09,NITA,gemGrab,Double Swoosh,16,14,30
6567,2023-01-09,NITA,brawlBall,Center Stage,53,56,109
6568,2023-01-09,NITA,brawlBall,Backyard Bowl,3,0,3
6569,2023-01-09,NITA,bounty,Layer Cake,3,0,3
6570,2023-01-08,NITA,hotZone,Ring of Fire,11,1,12
6571,2023-01-08,NITA,heist,Snaked Assault,109,85,194
6572,2023-01-08,NITA,gemGrab,Hard Rock Mine,14,13,27
6573,2023-01-08,NITA,gemGrab,Double Swoosh,13,8,21
6574,2023-01-08,NITA,brawlBall,Super Beach,17,9,26
6575,2023-01-08,NITA,brawlBall,Backyard Bowl,17,7,24
6576,2023-01-07,NITA,hotZone,Ring of Fire,3,0,3
6577,2023-01-07,NITA,heist,Tornado Ring,117,125,242
6578,2023-01-07,NITA,gemGrab,Hard Rock Mine,14,7,21
6579,2023-01-07,NITA,gemGrab,Deep Diner,21,26,47
6580,2023-01-07,NITA,brawlBall,Super Beach,53,42,95
6581,2023-01-07,NITA,brawlBall,Sneaky Fields,5,3,8
6582,2023-01-07,NITA,bounty,Dry Season,1,0,1
6583,2023-01-06,NITA,knockout,Out in the Open,1,0,1
6584,2023-01-06,NITA,hotZone,Split,19,4,23
6585,2023-01-06,NITA,heist,Tornado Ring,199,207,406
6586,2023-01-06,NITA,gemGrab,Undermine,5,0,5
6587,2023-01-06,NITA,gemGrab,Deep Diner,26,23,49
6588,2023-01-06,NITA,brawlBall,Sneaky Fields,120,133,253
6589,2023-01-06,NITA,brawlBall,Pinhole Punt,4,1,5
6590,2023-01-05,NITA,knockout,Out in the Open,2,0,2
6591,2023-01-05,NITA,hotZone,Split,32,11,43
6592,2023-01-05,NITA,heist,Kaboom Canyon,27,8,35
6593,2023-01-05,NITA,gemGrab,Undermine,14,20,34
6594,2023-01-05,NITA,gemGrab,Gem Fort,4,5,9
6595,2023-01-05,NITA,brawlBall,Sunny Soccer,0,1,1
6596,2023-01-05,NITA,brawlBall,Pinhole Punt,47,31,78
6597,2023-01-04,NITA,knockout,Goldarm Gulch,1,0,1
6598,2023-01-04,NITA,hotZone,Parallel Plays,15,8,23
6599,2023-01-04,NITA,heist,Kaboom Canyon,35,7,42
6600,2023-01-04,NITA,gemGrab,Gem Fort,26,38,64
6601,2023-01-04,NITA,gemGrab,Crystal Arcade,7,11,18
6602,2023-01-04,NITA,brawlBall,Sunny Soccer,92,62,154
6603,2023-01-04,NITA,bounty,Shooting Star,1,0,1
6604,2023-01-03,NITA,knockout,Goldarm Gulch,1,1,2
6605,2023-01-03,NITA,hotZone,Parallel Plays,49,38,87
6606,2023-01-03,NITA,hotZone,Controller Chaos,0,1,1
6607,2023-01-03,NITA,heist,Pit Stop,152,105,257
6608,2023-01-03,NITA,gemGrab,Crystal Arcade,67,58,125
6609,2023-01-03,NITA,brawlBall,Center Stage,2,8,10
6610,2023-01-03,NITA,brawlBall,Beach Ball,66,63,129
6611,2023-01-03,NITA,bounty,Hideout,2,0,2
6612,2023-01-02,NITA,knockout,Belle's Rock,5,0,5
6613,2023-01-02,NITA,hotZone,Quarter Pounder,26,27,53
6614,2023-01-02,NITA,hotZone,Controller Chaos,2,0,2
6615,2023-01-02,NITA,heist,Pit Stop,260,181,441
6616,2023-01-02,NITA,heist,Kaboom Canyon,3,1,4
6617,2023-01-02,NITA,gemGrab,Minecart Madness,10,2,12
6618,2023-01-02,NITA,gemGrab,Double Swoosh,26,21,47
6619,2023-01-02,NITA,brawlBall,Center Stage,95,82,177
6620,2023-01-02,NITA,brawlBall,Backyard Bowl,1,0,1
6621,2023-01-01,NITA,hotZone,Quarter Pounder,20,5,25
6622,2023-01-01,NITA,heist,Bridge Too Far,2,0,2
6623,2023-01-01,NITA,gemGrab,Double Swoosh,14,3,17
6624,2023-01-01,NITA,brawlBall,Backyard Bowl,5,0,5
6625,2022-12-31,NITA,hotZone,Controller Chaos,3,1,4
6626,2022-12-31,NITA,heist,Kaboom Canyon,1,0,1
6627,2022-12-31,NITA,gemGrab,Minecart Madness,1,0,1
6628,2022-12-31,NITA,gemGrab,Hard Rock Mine,1,2,3
6629,2022-12-31,NITA,gemGrab,Deep Diner,2,0,2
6630,2022-12-31,NITA,brawlBall,Super Beach,6,2,8
6631,2022-12-31,NITA,brawlBall,Sneaky Fields,5,6,11
6632,2022-12-30,NITA,hotZone,Controller Chaos,5,1,6
6633,2022-12-30,NITA,heist,Hot Potato,1,3,4
6634,2022-12-30,NITA,gemGrab,Undermine,3,14,17
6635,2022-12-30,NITA,gemGrab,Minecart Madness,0,2,2
6636,2022-12-30,NITA,gemGrab,Deep Diner,5,9,14
6637,2022-12-30,NITA,brawlBall,Sneaky Fields,15,19,34
6638,2022-12-29,NITA,heist,Kaboom Canyon,1,0,1
6639,2022-12-29,NITA,heist,Hot Potato,1,3,4
6640,2022-12-29,NITA,gemGrab,Undermine,1,1,2
6641,2022-12-29,NITA,brawlBall,Pinhole Punt,4,0,4
6642,2022-12-28,NITA,brawlBall,Beach Ball,4,6,10
6643,2022-12-27,NITA,hotZone,Controller Chaos,1,0,1
6644,2022-12-27,NITA,heist,Kaboom Canyon,0,2,2
6645,2022-12-27,NITA,brawlBall,Center Stage,2,1,3
6646,2022-12-27,NITA,brawlBall,Beach Ball,2,0,2
6647,2022-12-26,NITA,heist,Kaboom Canyon,2,0,2
6648,2022-12-26,NITA,gemGrab,Minecart Madness,1,0,1
6649,2022-12-26,NITA,brawlBall,Center Stage,1,2,3
6650,2022-12-24,NITA,brawlBall,Super Beach,1,1,2
6651,2022-12-23,NITA,brawlBall,Sneaky Fields,2,2,4
6652,2022-12-22,NITA,gemGrab,Gem Fort,1,0,1
6653,2022-12-22,NITA,brawlBall,Pinhole Punt,2,0,2
6654,2022-12-21,NITA,brawlBall,Sunny Soccer,2,0,2
6655,2022-12-20,NITA,brawlBall,Beach Ball,1,1,2
6656,2022-12-19,NITA,brawlBall,Center Stage,1,2,3
6657,2022-12-16,NITA,brawlBall,Sneaky Fields,1,0,1
6658,2022-12-13,NITA,heist,Safe Zone,1,0,1
6659,2022-12-13,NITA,gemGrab,Crystal Arcade,2,1,3
6660,2022-12-13,NITA,brawlBall,Beach Ball,2,0,2
6661,2022-12-10,NITA,gemGrab,Hard Rock Mine,1,1,2
6662,2022-11-11,NITA,brawlBall,Sneaky Fields,2,4,6
6663,2022-11-03,NITA,brawlBall,Pinhole Punt,2,0,2
6664,2022-10-28,NITA,bounty,Canal Grande,2,0,2
6665,2022-10-15,NITA,gemGrab,Hard Rock Mine,0,1,1
6666,2022-09-07,NITA,brawlBall,Sunny Soccer,2,0,2
6667,2022-09-06,NITA,brawlBall,Beach Ball,0,2,2
6668,2023-02-11,NANI,knockout,Flaring Phoenix,34,36,70
6669,2023-02-11,NANI,hotZone,Controller Chaos,1,0,1
6670,2023-02-11,NANI,gemGrab,Deep Diner,3,7,10
6671,2023-02-11,NANI,brawlBall,Super Beach,5,8,13
6672,2023-02-11,NANI,brawlBall,Sneaky Fields,5,1,6
6673,2023-02-10,NANI,knockout,Flaring Phoenix,69,55,124
6674,2023-02-10,NANI,hotZone,Controller Chaos,3,1,4
6675,2023-02-10,NANI,heist,Hot Potato,3,3,6
6676,2023-02-10,NANI,gemGrab,Undermine,9,8,17
6677,2023-02-10,NANI,gemGrab,Deep Diner,22,15,37
6678,2023-02-10,NANI,brawlBall,Sneaky Fields,29,10,39
6679,2023-02-10,NANI,brawlBall,Pinhole Punt,0,1,1
6680,2023-02-10,NANI,bounty,Temple Ruins,23,17,40
6681,2023-02-09,NANI,knockout,Riverside,108,175,283
6682,2023-02-09,NANI,hotZone,Open Zone,2,1,3
6683,2023-02-09,NANI,heist,Hot Potato,3,4,7
6684,2023-02-09,NANI,gemGrab,Undermine,8,8,16
6685,2023-02-09,NANI,gemGrab,Gem Fort,1,1,2
6686,2023-02-09,NANI,brawlBall,Sunny Soccer,2,0,2
6687,2023-02-09,NANI,brawlBall,Pinhole Punt,15,14,29
6688,2023-02-09,NANI,bounty,Temple Ruins,8,5,13
6689,2023-02-08,NANI,knockout,Riverside,92,131,223
6690,2023-02-08,NANI,hotZone,Open Zone,0,1,1
6691,2023-02-08,NANI,heist,Safe Zone,3,0,3
6692,2023-02-08,NANI,gemGrab,Gem Fort,3,4,7
6693,2023-02-08,NANI,gemGrab,Crystal Arcade,1,0,1
6694,2023-02-08,NANI,brawlBall,Sunny Soccer,2,3,5
6695,2023-02-08,NANI,bounty,Excel,1,0,1
6696,2023-02-07,NANI,knockout,New Perspective,6,3,9
6697,2023-02-07,NANI,gemGrab,Minecart Madness,2,0,2
6698,2023-02-07,NANI,gemGrab,Crystal Arcade,3,0,3
6699,2023-02-07,NANI,brawlBall,Center Stage,1,0,1
6700,2023-02-07,NANI,brawlBall,Beach Ball,3,5,8
6701,2023-02-07,NANI,bounty,Excel,2,0,2
6702,2023-02-06,NANI,knockout,New Perspective,124,116,240
6703,2023-02-06,NANI,hotZone,Dueling Beetles,7,0,7
6704,2023-02-06,NANI,heist,Snaked Assault,4,8,12
6705,2023-02-06,NANI,gemGrab,Minecart Madness,64,56,120
6706,2023-02-06,NANI,gemGrab,Double Swoosh,6,3,9
6707,2023-02-06,NANI,brawlBall,Center Stage,21,21,42
6708,2023-02-06,NANI,brawlBall,Backyard Bowl,19,18,37
6709,2023-02-06,NANI,bounty,Layer Cake,14,8,22
6710,2023-02-05,NANI,knockout,X Marks the Spot,154,200,354
6711,2023-02-05,NANI,knockout,Goldarm Gulch,6,1,7
6712,2023-02-05,NANI,hotZone,Ring of Fire,7,5,12
6713,2023-02-05,NANI,heist,Snaked Assault,6,2,8
6714,2023-02-05,NANI,heist,Pit Stop,2,1,3
6715,2023-02-05,NANI,gemGrab,Hard Rock Mine,3,4,7
6716,2023-02-05,NANI,gemGrab,Double Swoosh,20,10,30
6717,2023-02-05,NANI,brawlBall,Super Beach,0,1,1
6718,2023-02-05,NANI,brawlBall,Sneaky Fields,2,0,2
6719,2023-02-05,NANI,brawlBall,Backyard Bowl,327,354,681
6720,2023-02-05,NANI,bounty,Layer Cake,19,18,37
6721,2023-02-04,NANI,knockout,X Marks the Spot,54,61,115
6722,2023-02-04,NANI,knockout,Goldarm Gulch,3,0,3
6723,2023-02-04,NANI,hotZone,Ring of Fire,1,0,1
6724,2023-02-04,NANI,heist,Tornado Ring,4,0,4
6725,2023-02-04,NANI,gemGrab,Hard Rock Mine,4,1,5
6726,2023-02-04,NANI,gemGrab,Double Swoosh,2,0,2
6727,2023-02-04,NANI,gemGrab,Deep Diner,1,2,3
6728,2023-02-04,NANI,brawlBall,Super Beach,8,2,10
6729,2023-02-04,NANI,brawlBall,Sneaky Fields,1,0,1
6730,2023-02-04,NANI,bounty,Dry Season,9,13,22
6731,2023-02-03,NANI,knockout,Out in the Open,109,113,222
6732,2023-02-03,NANI,knockout,Goldarm Gulch,18,13,31
6733,2023-02-03,NANI,hotZone,Split,6,1,7
6734,2023-02-03,NANI,heist,Tornado Ring,7,1,8
6735,2023-02-03,NANI,heist,Pit Stop,2,1,3
6736,2023-02-03,NANI,gemGrab,Undermine,15,4,19
6737,2023-02-03,NANI,gemGrab,Double Swoosh,24,6,30
6738,2023-02-03,NANI,gemGrab,Deep Diner,15,8,23
6739,2023-02-03,NANI,brawlBall,Sneaky Fields,37,23,60
6740,2023-02-03,NANI,brawlBall,Pinhole Punt,2,5,7
6741,2023-02-03,NANI,bounty,Dry Season,122,113,235
6742,2023-02-02,NANI,knockout,Out in the Open,69,83,152
6743,2023-02-02,NANI,hotZone,Split,2,1,3
6744,2023-02-02,NANI,heist,Kaboom Canyon,1,8,9
6745,2023-02-02,NANI,gemGrab,Undermine,2,0,2
6746,2023-02-02,NANI,gemGrab,Gem Fort,1,0,1
6747,2023-02-02,NANI,brawlBall,Sunny Soccer,2,1,3
6748,2023-02-02,NANI,brawlBall,Pinhole Punt,28,15,43
6749,2023-02-02,NANI,bounty,Shooting Star,67,142,209
6750,2023-02-01,NANI,knockout,Goldarm Gulch,38,45,83
6751,2023-02-01,NANI,hotZone,Parallel Plays,11,4,15
6752,2023-02-01,NANI,heist,Kaboom Canyon,33,37,70
6753,2023-02-01,NANI,gemGrab,Gem Fort,10,5,15
6754,2023-02-01,NANI,gemGrab,Crystal Arcade,3,1,4
6755,2023-02-01,NANI,brawlBall,Sunny Soccer,21,13,34
6756,2023-02-01,NANI,bounty,Shooting Star,200,286,486
6757,2023-01-31,NANI,knockout,Goldarm Gulch,29,22,51
6758,2023-01-31,NANI,hotZone,Parallel Plays,5,1,6
6759,2023-01-31,NANI,heist,Pit Stop,0,3,3
6760,2023-01-31,NANI,gemGrab,Minecart Madness,4,2,6
6761,2023-01-31,NANI,gemGrab,Crystal Arcade,6,4,10
6762,2023-01-31,NANI,brawlBall,Beach Ball,16,9,25
6763,2023-01-31,NANI,bounty,Hideout,62,71,133
6764,2023-01-30,NANI,knockout,Belle's Rock,56,55,111
6765,2023-01-30,NANI,hotZone,Quarter Pounder,6,1,7
6766,2023-01-30,NANI,heist,Pit Stop,2,0,2
6767,2023-01-30,NANI,gemGrab,Minecart Madness,23,16,39
6768,2023-01-30,NANI,gemGrab,Double Swoosh,6,2,8
6769,2023-01-30,NANI,brawlBall,Center Stage,23,24,47
6770,2023-01-30,NANI,brawlBall,Backyard Bowl,16,18,34
6771,2023-01-30,NANI,bounty,Hideout,87,130,217
6772,2023-01-29,NANI,knockout,Belle's Rock,61,69,130
6773,2023-01-29,NANI,hotZone,Quarter Pounder,9,11,20
6774,2023-01-29,NANI,heist,Bridge Too Far,112,92,204
6775,2023-01-29,NANI,gemGrab,Hard Rock Mine,0,3,3
6776,2023-01-29,NANI,gemGrab,Double Swoosh,13,3,16
6777,2023-01-29,NANI,brawlBall,Backyard Bowl,208,210,418
6778,2023-01-29,NANI,bounty,Canal Grande,6,15,21
6779,2023-01-28,NANI,knockout,Flaring Phoenix,39,20,59
6780,2023-01-28,NANI,hotZone,Controller Chaos,3,0,3
6781,2023-01-28,NANI,heist,Bridge Too Far,231,326,557
6782,2023-01-28,NANI,gemGrab,Hard Rock Mine,15,9,24
6783,2023-01-28,NANI,gemGrab,Deep Diner,4,3,7
6784,2023-01-28,NANI,brawlBall,Super Beach,37,24,61
6785,2023-01-28,NANI,brawlBall,Sneaky Fields,1,1,2
6786,2023-01-28,NANI,bounty,Canal Grande,6,4,10
6787,2023-01-27,NANI,knockout,Flaring Phoenix,15,10,25
6788,2023-01-27,NANI,hotZone,Controller Chaos,1,0,1
6789,2023-01-27,NANI,heist,Hot Potato,5,0,5
6790,2023-01-27,NANI,gemGrab,Undermine,1,2,3
6791,2023-01-27,NANI,gemGrab,Deep Diner,4,1,5
6792,2023-01-27,NANI,brawlBall,Sneaky Fields,3,11,14
6793,2023-01-27,NANI,bounty,Temple Ruins,3,3,6
6794,2023-01-26,NANI,knockout,Riverside,737,1108,1845
6795,2023-01-26,NANI,hotZone,Open Zone,24,10,34
6796,2023-01-26,NANI,heist,Hot Potato,6,4,10
6797,2023-01-26,NANI,gemGrab,Undermine,6,2,8
6798,2023-01-26,NANI,gemGrab,Gem Fort,2,3,5
6799,2023-01-26,NANI,brawlBall,Sunny Soccer,1,2,3
6800,2023-01-26,NANI,brawlBall,Pinhole Punt,59,44,103
6801,2023-01-26,NANI,bounty,Temple Ruins,14,11,25
6802,2023-01-25,NANI,knockout,Riverside,481,679,1160
6803,2023-01-25,NANI,hotZone,Open Zone,4,9,13
6804,2023-01-25,NANI,heist,Safe Zone,12,13,25
6805,2023-01-25,NANI,gemGrab,Gem Fort,4,1,5
6806,2023-01-25,NANI,gemGrab,Crystal Arcade,7,4,11
6807,2023-01-25,NANI,brawlBall,Sunny Soccer,21,5,26
6808,2023-01-25,NANI,brawlBall,Beach Ball,1,11,12
6809,2023-01-25,NANI,bounty,Excel,7,6,13
6810,2023-01-24,NANI,knockout,New Perspective,74,91,165
6811,2023-01-24,NANI,hotZone,Dueling Beetles,8,4,12
6812,2023-01-24,NANI,heist,Safe Zone,35,35,70
6813,2023-01-24,NANI,gemGrab,Minecart Madness,5,6,11
6814,2023-01-24,NANI,gemGrab,Crystal Arcade,12,4,16
6815,2023-01-24,NANI,brawlBall,Center Stage,5,0,5
6816,2023-01-24,NANI,brawlBall,Beach Ball,33,13,46
6817,2023-01-24,NANI,bounty,Excel,18,13,31
6818,2023-01-23,NANI,knockout,New Perspective,99,91,190
6819,2023-01-23,NANI,hotZone,Dueling Beetles,2,0,2
6820,2023-01-23,NANI,heist,Snaked Assault,8,1,9
6821,2023-01-23,NANI,gemGrab,Minecart Madness,26,40,66
6822,2023-01-23,NANI,gemGrab,Double Swoosh,5,1,6
6823,2023-01-23,NANI,brawlBall,Center Stage,45,31,76
6824,2023-01-23,NANI,brawlBall,Backyard Bowl,18,21,39
6825,2023-01-23,NANI,bounty,Layer Cake,20,15,35
6826,2023-01-22,NANI,knockout,X Marks the Spot,114,159,273
6827,2023-01-22,NANI,hotZone,Ring of Fire,9,2,11
6828,2023-01-22,NANI,heist,Snaked Assault,8,13,21
6829,2023-01-22,NANI,gemGrab,Hard Rock Mine,1,1,2
6830,2023-01-22,NANI,gemGrab,Double Swoosh,5,2,7
6831,2023-01-22,NANI,brawlBall,Super Beach,1,0,1
6832,2023-01-22,NANI,brawlBall,Backyard Bowl,112,119,231
6833,2023-01-22,NANI,bounty,Layer Cake,3,7,10
6834,2023-01-21,NANI,knockout,X Marks the Spot,357,492,849
6835,2023-01-21,NANI,hotZone,Ring of Fire,9,4,13
6836,2023-01-21,NANI,heist,Tornado Ring,2,2,4
6837,2023-01-21,NANI,gemGrab,Hard Rock Mine,17,12,29
6838,2023-01-21,NANI,gemGrab,Deep Diner,2,0,2
6839,2023-01-21,NANI,brawlBall,Super Beach,35,31,66
6840,2023-01-21,NANI,brawlBall,Sneaky Fields,2,0,2
6841,2023-01-21,NANI,bounty,Dry Season,78,91,169
6842,2023-01-20,NANI,knockout,Out in the Open,149,153,302
6843,2023-01-20,NANI,hotZone,Split,1,1,2
6844,2023-01-20,NANI,heist,Tornado Ring,7,2,9
6845,2023-01-20,NANI,gemGrab,Undermine,5,2,7
6846,2023-01-20,NANI,gemGrab,Deep Diner,29,18,47
6847,2023-01-20,NANI,brawlBall,Sneaky Fields,16,7,23
6848,2023-01-20,NANI,brawlBall,Pinhole Punt,1,7,8
6849,2023-01-20,NANI,bounty,Dry Season,63,68,131
6850,2023-01-19,NANI,knockout,Out in the Open,163,169,332
6851,2023-01-19,NANI,hotZone,Split,6,3,9
6852,2023-01-19,NANI,heist,Kaboom Canyon,41,61,102
6853,2023-01-19,NANI,gemGrab,Undermine,10,11,21
6854,2023-01-19,NANI,gemGrab,Gem Fort,1,1,2
6855,2023-01-19,NANI,brawlBall,Sunny Soccer,1,0,1
6856,2023-01-19,NANI,brawlBall,Pinhole Punt,53,45,98
6857,2023-01-19,NANI,bounty,Shooting Star,281,380,661
6858,2023-01-18,NANI,knockout,Goldarm Gulch,9,10,19
6859,2023-01-18,NANI,hotZone,Parallel Plays,2,1,3
6860,2023-01-18,NANI,heist,Kaboom Canyon,12,8,20
6861,2023-01-18,NANI,gemGrab,Gem Fort,3,0,3
6862,2023-01-18,NANI,brawlBall,Sunny Soccer,12,3,15
6863,2023-01-18,NANI,bounty,Shooting Star,158,158,316
6864,2023-01-17,NANI,knockout,Goldarm Gulch,2,3,5
6865,2023-01-17,NANI,heist,Pit Stop,1,0,1
6866,2023-01-17,NANI,gemGrab,Minecart Madness,0,1,1
6867,2023-01-17,NANI,brawlBall,Beach Ball,4,4,8
6868,2023-01-17,NANI,bounty,Hideout,15,12,27
6869,2023-01-16,NANI,knockout,Belle's Rock,3,2,5
6870,2023-01-16,NANI,hotZone,Quarter Pounder,2,0,2
6871,2023-01-16,NANI,gemGrab,Minecart Madness,3,4,7
6872,2023-01-16,NANI,brawlBall,Center Stage,6,1,7
6873,2023-01-16,NANI,brawlBall,Backyard Bowl,1,3,4
6874,2023-01-16,NANI,bounty,Hideout,19,36,55
6875,2023-01-15,NANI,knockout,Belle's Rock,5,3,8
6876,2023-01-15,NANI,hotZone,Quarter Pounder,1,1,2
6877,2023-01-15,NANI,heist,Bridge Too Far,21,37,58
6878,2023-01-15,NANI,gemGrab,Hard Rock Mine,0,1,1
6879,2023-01-15,NANI,gemGrab,Double Swoosh,1,0,1
6880,2023-01-15,NANI,brawlBall,Backyard Bowl,24,24,48
6881,2023-01-15,NANI,bounty,Canal Grande,1,0,1
6882,2023-01-14,NANI,knockout,Flaring Phoenix,3,1,4
6883,2023-01-14,NANI,hotZone,Controller Chaos,5,0,5
6884,2023-01-14,NANI,heist,Bridge Too Far,46,48,94
6885,2023-01-14,NANI,gemGrab,Deep Diner,3,7,10
6886,2023-01-14,NANI,brawlBall,Super Beach,2,0,2
6887,2023-01-14,NANI,brawlBall,Sneaky Fields,1,0,1
6888,2023-01-14,NANI,bounty,Canal Grande,1,0,1
6889,2023-01-13,NANI,knockout,Flaring Phoenix,7,3,10
6890,2023-01-13,NANI,hotZone,Controller Chaos,2,0,2
6891,2023-01-13,NANI,gemGrab,Deep Diner,1,1,2
6892,2023-01-13,NANI,brawlBall,Sneaky Fields,1,1,2
6893,2023-01-13,NANI,bounty,Temple Ruins,0,1,1
6894,2023-01-12,NANI,knockout,Riverside,133,162,295
6895,2023-01-12,NANI,brawlBall,Pinhole Punt,1,0,1
6896,2023-01-11,NANI,knockout,Riverside,37,50,87
6897,2023-01-11,NANI,hotZone,Open Zone,1,1,2
6898,2023-01-11,NANI,bounty,Excel,1,0,1
6899,2023-01-10,NANI,knockout,New Perspective,4,4,8
6900,2023-01-10,NANI,heist,Safe Zone,1,1,2
6901,2023-01-10,NANI,gemGrab,Minecart Madness,4,14,18
6902,2023-01-10,NANI,gemGrab,Crystal Arcade,3,2,5
6903,2023-01-10,NANI,brawlBall,Beach Ball,2,0,2
6904,2023-01-09,NANI,knockout,New Perspective,2,2,4
6905,2023-01-09,NANI,gemGrab,Minecart Madness,2,5,7
6906,2023-01-09,NANI,brawlBall,Backyard Bowl,2,2,4
6907,2023-01-09,NANI,bounty,Layer Cake,1,0,1
6908,2023-01-08,NANI,knockout,X Marks the Spot,23,12,35
6909,2023-01-08,NANI,hotZone,Ring of Fire,1,0,1
6910,2023-01-08,NANI,brawlBall,Super Beach,1,1,2
6911,2023-01-08,NANI,brawlBall,Backyard Bowl,5,18,23
6912,2023-01-08,NANI,bounty,Layer Cake,1,1,2
6913,2023-01-07,NANI,knockout,X Marks the Spot,11,2,13
6914,2023-01-07,NANI,gemGrab,Hard Rock Mine,2,0,2
6915,2023-01-07,NANI,gemGrab,Deep Diner,1,0,1
6916,2023-01-07,NANI,brawlBall,Super Beach,2,0,2
6917,2023-01-07,NANI,bounty,Dry Season,6,5,11
6918,2023-01-06,NANI,knockout,Out in the Open,5,1,6
6919,2023-01-06,NANI,bounty,Dry Season,7,8,15
6920,2023-01-05,NANI,knockout,Out in the Open,18,11,29
6921,2023-01-05,NANI,heist,Kaboom Canyon,3,1,4
6922,2023-01-05,NANI,gemGrab,Undermine,0,1,1
6923,2023-01-05,NANI,brawlBall,Pinhole Punt,1,0,1
6924,2023-01-05,NANI,bounty,Shooting Star,50,92,142
6925,2023-01-04,NANI,knockout,Goldarm Gulch,0,2,2
6926,2023-01-04,NANI,heist,Kaboom Canyon,5,9,14
6927,2023-01-04,NANI,brawlBall,Sunny Soccer,0,1,1
6928,2023-01-04,NANI,bounty,Shooting Star,133,193,326
6929,2023-01-03,NANI,knockout,Goldarm Gulch,1,4,5
6930,2023-01-03,NANI,gemGrab,Crystal Arcade,1,0,1
6931,2023-01-03,NANI,brawlBall,Beach Ball,3,0,3
6932,2023-01-03,NANI,bounty,Hideout,20,31,51
6933,2023-01-02,NANI,knockout,Belle's Rock,9,8,17
6934,2023-01-02,NANI,hotZone,Quarter Pounder,1,2,3
6935,2023-01-02,NANI,hotZone,Controller Chaos,2,0,2
6936,2023-01-02,NANI,gemGrab,Minecart Madness,1,0,1
6937,2023-01-02,NANI,brawlBall,Center Stage,2,0,2
6938,2023-01-02,NANI,brawlBall,Backyard Bowl,0,1,1
6939,2023-01-02,NANI,bounty,Hideout,35,33,68
6940,2023-01-01,NANI,hotZone,Quarter Pounder,12,13,25
6941,2023-01-01,NANI,heist,Bridge Too Far,4,3,7
6942,2023-01-01,NANI,gemGrab,Double Swoosh,1,0,1
6943,2023-01-01,NANI,brawlBall,Backyard Bowl,10,2,12
6944,2022-12-31,NANI,heist,Bridge Too Far,2,1,3
6945,2022-12-30,NANI,knockout,Flaring Phoenix,0,1,1
6946,2022-12-29,NANI,heist,Kaboom Canyon,1,0,1
6947,2022-12-24,NANI,knockout,X Marks the Spot,0,1,1
6948,2022-12-22,NANI,brawlBall,Pinhole Punt,2,0,2
6949,2022-12-13,NANI,knockout,New Perspective,2,13,15
6950,2022-11-01,NANI,knockout,New Perspective,4,2,6
6951,2022-10-26,NANI,bounty,Shooting Star,2,3,5
6952,2022-10-15,NANI,gemGrab,Hard Rock Mine,0,1,1
6953,2023-02-11,MR. P,knockout,Flaring Phoenix,28,21,49
6954,2023-02-11,MR. P,hotZone,Controller Chaos,13,12,25
6955,2023-02-11,MR. P,gemGrab,Deep Diner,32,61,93
6956,2023-02-11,MR. P,brawlBall,Super Beach,10,14,24
6957,2023-02-11,MR. P,brawlBall,Sneaky Fields,1,3,4
6958,2023-02-10,MR. P,knockout,Flaring Phoenix,71,59,130
6959,2023-02-10,MR. P,hotZone,Controller Chaos,24,24,48
6960,2023-02-10,MR. P,heist,Hot Potato,9,9,18
6961,2023-02-10,MR. P,gemGrab,Undermine,7,23,30
6962,2023-02-10,MR. P,gemGrab,Deep Diner,74,78,152
6963,2023-02-10,MR. P,brawlBall,Sneaky Fields,31,34,65
6964,2023-02-10,MR. P,brawlBall,Pinhole Punt,1,1,2
6965,2023-02-10,MR. P,bounty,Temple Ruins,21,36,57
6966,2023-02-09,MR. P,knockout,Riverside,10,20,30
6967,2023-02-09,MR. P,hotZone,Open Zone,3,8,11
6968,2023-02-09,MR. P,heist,Hot Potato,1,1,2
6969,2023-02-09,MR. P,gemGrab,Undermine,9,7,16
6970,2023-02-09,MR. P,gemGrab,Gem Fort,5,2,7
6971,2023-02-09,MR. P,brawlBall,Pinhole Punt,10,16,26
6972,2023-02-09,MR. P,bounty,Temple Ruins,10,9,19
6973,2023-02-08,MR. P,knockout,Riverside,12,9,21
6974,2023-02-08,MR. P,hotZone,Open Zone,0,1,1
6975,2023-02-08,MR. P,heist,Safe Zone,3,2,5
6976,2023-02-08,MR. P,gemGrab,Gem Fort,5,5,10
6977,2023-02-08,MR. P,gemGrab,Crystal Arcade,0,1,1
6978,2023-02-08,MR. P,brawlBall,Sunny Soccer,8,7,15
6979,2023-02-08,MR. P,brawlBall,Beach Ball,2,1,3
6980,2023-02-08,MR. P,bounty,Excel,11,26,37
6981,2023-02-07,MR. P,knockout,New Perspective,3,3,6
6982,2023-02-07,MR. P,hotZone,Dueling Beetles,2,0,2
6983,2023-02-07,MR. P,heist,Safe Zone,3,1,4
6984,2023-02-07,MR. P,gemGrab,Minecart Madness,5,5,10
6985,2023-02-07,MR. P,gemGrab,Crystal Arcade,2,2,4
6986,2023-02-07,MR. P,brawlBall,Center Stage,1,0,1
6987,2023-02-07,MR. P,brawlBall,Beach Ball,2,2,4
6988,2023-02-07,MR. P,bounty,Excel,3,2,5
6989,2023-02-06,MR. P,knockout,New Perspective,83,73,156
6990,2023-02-06,MR. P,knockout,Goldarm Gulch,10,3,13
6991,2023-02-06,MR. P,hotZone,Dueling Beetles,43,45,88
6992,2023-02-06,MR. P,heist,Snaked Assault,10,3,13
6993,2023-02-06,MR. P,gemGrab,Minecart Madness,72,92,164
6994,2023-02-06,MR. P,gemGrab,Double Swoosh,24,59,83
6995,2023-02-06,MR. P,brawlBall,Center Stage,65,77,142
6996,2023-02-06,MR. P,brawlBall,Backyard Bowl,8,12,20
6997,2023-02-06,MR. P,bounty,Layer Cake,52,71,123
6998,2023-02-05,MR. P,knockout,X Marks the Spot,49,57,106
6999,2023-02-05,MR. P,knockout,Goldarm Gulch,24,11,35
7000,2023-02-05,MR. P,hotZone,Ring of Fire,12,8,20
7001,2023-02-05,MR. P,heist,Snaked Assault,6,7,13
7002,2023-02-05,MR. P,heist,Pit Stop,5,1,6
7003,2023-02-05,MR. P,gemGrab,Hard Rock Mine,4,8,12
7004,2023-02-05,MR. P,gemGrab,Double Swoosh,57,83,140
7005,2023-02-05,MR. P,brawlBall,Super Beach,1,5,6
7006,2023-02-05,MR. P,brawlBall,Sneaky Fields,4,0,4
7007,2023-02-05,MR. P,brawlBall,Backyard Bowl,103,139,242
7008,2023-02-05,MR. P,bounty,Layer Cake,54,62,116
7009,2023-02-04,MR. P,knockout,X Marks the Spot,41,79,120
7010,2023-02-04,MR. P,knockout,Goldarm Gulch,10,9,19
7011,2023-02-04,MR. P,hotZone,Ring of Fire,1,2,3
7012,2023-02-04,MR. P,heist,Tornado Ring,3,2,5
7013,2023-02-04,MR. P,heist,Pit Stop,1,0,1
7014,2023-02-04,MR. P,gemGrab,Hard Rock Mine,10,11,21
7015,2023-02-04,MR. P,gemGrab,Double Swoosh,7,3,10
7016,2023-02-04,MR. P,gemGrab,Deep Diner,5,1,6
7017,2023-02-04,MR. P,brawlBall,Super Beach,20,23,43
7018,2023-02-04,MR. P,bounty,Dry Season,26,18,44
7019,2023-02-03,MR. P,knockout,Out in the Open,105,117,222
7020,2023-02-03,MR. P,knockout,Goldarm Gulch,50,34,84
7021,2023-02-03,MR. P,hotZone,Split,11,8,19
7022,2023-02-03,MR. P,heist,Tornado Ring,6,3,9
7023,2023-02-03,MR. P,heist,Pit Stop,10,0,10
7024,2023-02-03,MR. P,gemGrab,Undermine,14,6,20
7025,2023-02-03,MR. P,gemGrab,Double Swoosh,31,28,59
7026,2023-02-03,MR. P,gemGrab,Deep Diner,55,50,105
7027,2023-02-03,MR. P,brawlBall,Sneaky Fields,30,33,63
7028,2023-02-03,MR. P,brawlBall,Pinhole Punt,5,1,6
7029,2023-02-03,MR. P,bounty,Dry Season,87,155,242
7030,2023-02-02,MR. P,knockout,Out in the Open,34,46,80
7031,2023-02-02,MR. P,hotZone,Split,5,4,9
7032,2023-02-02,MR. P,heist,Kaboom Canyon,5,2,7
7033,2023-02-02,MR. P,gemGrab,Undermine,6,8,14
7034,2023-02-02,MR. P,gemGrab,Gem Fort,1,3,4
7035,2023-02-02,MR. P,brawlBall,Sunny Soccer,2,1,3
7036,2023-02-02,MR. P,brawlBall,Pinhole Punt,22,34,56
7037,2023-02-02,MR. P,bounty,Shooting Star,11,22,33
7038,2023-02-01,MR. P,knockout,Goldarm Gulch,110,145,255
7039,2023-02-01,MR. P,hotZone,Parallel Plays,19,13,32
7040,2023-02-01,MR. P,heist,Kaboom Canyon,9,8,17
7041,2023-02-01,MR. P,gemGrab,Gem Fort,35,33,68
7042,2023-02-01,MR. P,gemGrab,Crystal Arcade,26,22,48
7043,2023-02-01,MR. P,brawlBall,Sunny Soccer,48,56,104
7044,2023-02-01,MR. P,brawlBall,Beach Ball,3,5,8
7045,2023-02-01,MR. P,bounty,Shooting Star,18,21,39
7046,2023-01-31,MR. P,knockout,Goldarm Gulch,54,49,103
7047,2023-01-31,MR. P,hotZone,Parallel Plays,16,20,36
7048,2023-01-31,MR. P,heist,Pit Stop,7,2,9
7049,2023-01-31,MR. P,gemGrab,Minecart Madness,5,3,8
7050,2023-01-31,MR. P,gemGrab,Crystal Arcade,28,21,49
7051,2023-01-31,MR. P,brawlBall,Center Stage,2,1,3
7052,2023-01-31,MR. P,brawlBall,Beach Ball,29,33,62
7053,2023-01-31,MR. P,bounty,Hideout,14,10,24
7054,2023-01-30,MR. P,knockout,Belle's Rock,154,155,309
7055,2023-01-30,MR. P,hotZone,Quarter Pounder,40,13,53
7056,2023-01-30,MR. P,heist,Pit Stop,7,4,11
7057,2023-01-30,MR. P,gemGrab,Minecart Madness,46,47,93
7058,2023-01-30,MR. P,gemGrab,Double Swoosh,24,30,54
7059,2023-01-30,MR. P,brawlBall,Center Stage,50,54,104
7060,2023-01-30,MR. P,brawlBall,Backyard Bowl,16,11,27
7061,2023-01-30,MR. P,bounty,Hideout,17,11,28
7062,2023-01-29,MR. P,knockout,Belle's Rock,161,216,377
7063,2023-01-29,MR. P,hotZone,Quarter Pounder,19,14,33
7064,2023-01-29,MR. P,heist,Bridge Too Far,16,11,27
7065,2023-01-29,MR. P,gemGrab,Hard Rock Mine,11,7,18
7066,2023-01-29,MR. P,gemGrab,Double Swoosh,34,36,70
7067,2023-01-29,MR. P,brawlBall,Backyard Bowl,81,113,194
7068,2023-01-29,MR. P,bounty,Canal Grande,33,35,68
7069,2023-01-28,MR. P,knockout,Flaring Phoenix,69,74,143
7070,2023-01-28,MR. P,hotZone,Controller Chaos,16,9,25
7071,2023-01-28,MR. P,heist,Bridge Too Far,35,40,75
7072,2023-01-28,MR. P,gemGrab,Hard Rock Mine,41,54,95
7073,2023-01-28,MR. P,gemGrab,Deep Diner,21,30,51
7074,2023-01-28,MR. P,brawlBall,Super Beach,50,63,113
7075,2023-01-28,MR. P,brawlBall,Sneaky Fields,5,4,9
7076,2023-01-28,MR. P,bounty,Canal Grande,48,59,107
7077,2023-01-27,MR. P,knockout,Flaring Phoenix,24,15,39
7078,2023-01-27,MR. P,hotZone,Controller Chaos,8,4,12
7079,2023-01-27,MR. P,heist,Hot Potato,4,8,12
7080,2023-01-27,MR. P,gemGrab,Undermine,5,3,8
7081,2023-01-27,MR. P,gemGrab,Deep Diner,50,50,100
7082,2023-01-27,MR. P,brawlBall,Sneaky Fields,15,11,26
7083,2023-01-27,MR. P,brawlBall,Pinhole Punt,1,0,1
7084,2023-01-27,MR. P,bounty,Temple Ruins,9,6,15
7085,2023-01-26,MR. P,knockout,Riverside,97,124,221
7086,2023-01-26,MR. P,hotZone,Open Zone,25,11,36
7087,2023-01-26,MR. P,heist,Hot Potato,7,3,10
7088,2023-01-26,MR. P,gemGrab,Undermine,26,54,80
7089,2023-01-26,MR. P,gemGrab,Gem Fort,8,8,16
7090,2023-01-26,MR. P,brawlBall,Sunny Soccer,4,9,13
7091,2023-01-26,MR. P,brawlBall,Pinhole Punt,69,67,136
7092,2023-01-26,MR. P,bounty,Temple Ruins,16,26,42
7093,2023-01-25,MR. P,knockout,Riverside,39,45,84
7094,2023-01-25,MR. P,hotZone,Open Zone,6,3,9
7095,2023-01-25,MR. P,heist,Safe Zone,9,4,13
7096,2023-01-25,MR. P,gemGrab,Gem Fort,19,12,31
7097,2023-01-25,MR. P,gemGrab,Crystal Arcade,28,36,64
7098,2023-01-25,MR. P,brawlBall,Sunny Soccer,28,39,67
7099,2023-01-25,MR. P,brawlBall,Beach Ball,5,4,9
7100,2023-01-25,MR. P,bounty,Excel,30,32,62
7101,2023-01-24,MR. P,knockout,New Perspective,40,42,82
7102,2023-01-24,MR. P,hotZone,Dueling Beetles,21,23,44
7103,2023-01-24,MR. P,heist,Safe Zone,22,6,28
7104,2023-01-24,MR. P,gemGrab,Minecart Madness,21,22,43
7105,2023-01-24,MR. P,gemGrab,Crystal Arcade,29,32,61
7106,2023-01-24,MR. P,brawlBall,Center Stage,3,2,5
7107,2023-01-24,MR. P,brawlBall,Beach Ball,73,85,158
7108,2023-01-24,MR. P,bounty,Excel,57,76,133
7109,2023-01-23,MR. P,knockout,New Perspective,57,73,130
7110,2023-01-23,MR. P,hotZone,Dueling Beetles,23,17,40
7111,2023-01-23,MR. P,heist,Snaked Assault,14,13,27
7112,2023-01-23,MR. P,gemGrab,Minecart Madness,75,80,155
7113,2023-01-23,MR. P,gemGrab,Double Swoosh,15,21,36
7114,2023-01-23,MR. P,brawlBall,Center Stage,72,87,159
7115,2023-01-23,MR. P,brawlBall,Backyard Bowl,3,4,7
7116,2023-01-23,MR. P,bounty,Layer Cake,62,66,128
7117,2023-01-22,MR. P,knockout,X Marks the Spot,26,39,65
7118,2023-01-22,MR. P,hotZone,Ring of Fire,5,5,10
7119,2023-01-22,MR. P,heist,Snaked Assault,2,2,4
7120,2023-01-22,MR. P,gemGrab,Hard Rock Mine,12,11,23
7121,2023-01-22,MR. P,gemGrab,Double Swoosh,17,25,42
7122,2023-01-22,MR. P,brawlBall,Super Beach,6,11,17
7123,2023-01-22,MR. P,brawlBall,Backyard Bowl,54,67,121
7124,2023-01-22,MR. P,bounty,Layer Cake,32,26,58
7125,2023-01-21,MR. P,knockout,X Marks the Spot,141,173,314
7126,2023-01-21,MR. P,hotZone,Ring of Fire,13,9,22
7127,2023-01-21,MR. P,heist,Tornado Ring,5,2,7
7128,2023-01-21,MR. P,gemGrab,Hard Rock Mine,41,42,83
7129,2023-01-21,MR. P,gemGrab,Deep Diner,22,42,64
7130,2023-01-21,MR. P,brawlBall,Super Beach,82,87,169
7131,2023-01-21,MR. P,brawlBall,Sneaky Fields,2,1,3
7132,2023-01-21,MR. P,bounty,Dry Season,70,92,162
7133,2023-01-20,MR. P,knockout,Out in the Open,79,106,185
7134,2023-01-20,MR. P,hotZone,Split,11,9,20
7135,2023-01-20,MR. P,heist,Tornado Ring,8,9,17
7136,2023-01-20,MR. P,gemGrab,Undermine,13,20,33
7137,2023-01-20,MR. P,gemGrab,Deep Diner,69,99,168
7138,2023-01-20,MR. P,brawlBall,Sneaky Fields,32,37,69
7139,2023-01-20,MR. P,brawlBall,Pinhole Punt,1,0,1
7140,2023-01-20,MR. P,bounty,Dry Season,66,67,133
7141,2023-01-19,MR. P,knockout,Out in the Open,87,59,146
7142,2023-01-19,MR. P,hotZone,Split,12,7,19
7143,2023-01-19,MR. P,heist,Kaboom Canyon,10,15,25
7144,2023-01-19,MR. P,gemGrab,Undermine,50,80,130
7145,2023-01-19,MR. P,gemGrab,Gem Fort,12,16,28
7146,2023-01-19,MR. P,brawlBall,Sunny Soccer,2,2,4
7147,2023-01-19,MR. P,brawlBall,Pinhole Punt,59,76,135
7148,2023-01-19,MR. P,bounty,Shooting Star,29,59,88
7149,2023-01-18,MR. P,knockout,Goldarm Gulch,18,13,31
7150,2023-01-18,MR. P,hotZone,Parallel Plays,1,2,3
7151,2023-01-18,MR. P,heist,Kaboom Canyon,1,2,3
7152,2023-01-18,MR. P,gemGrab,Gem Fort,7,7,14
7153,2023-01-18,MR. P,gemGrab,Crystal Arcade,1,1,2
7154,2023-01-18,MR. P,brawlBall,Sunny Soccer,13,29,42
7155,2023-01-18,MR. P,bounty,Shooting Star,19,29,48
7156,2023-01-17,MR. P,knockout,Goldarm Gulch,8,10,18
7157,2023-01-17,MR. P,hotZone,Parallel Plays,4,3,7
7158,2023-01-17,MR. P,gemGrab,Minecart Madness,1,0,1
7159,2023-01-17,MR. P,gemGrab,Crystal Arcade,5,10,15
7160,2023-01-17,MR. P,brawlBall,Beach Ball,12,11,23
7161,2023-01-17,MR. P,bounty,Hideout,3,2,5
7162,2023-01-16,MR. P,knockout,Belle's Rock,15,8,23
7163,2023-01-16,MR. P,hotZone,Quarter Pounder,1,4,5
7164,2023-01-16,MR. P,heist,Pit Stop,2,3,5
7165,2023-01-16,MR. P,gemGrab,Minecart Madness,2,12,14
7166,2023-01-16,MR. P,gemGrab,Double Swoosh,2,8,10
7167,2023-01-16,MR. P,brawlBall,Center Stage,4,3,7
7168,2023-01-16,MR. P,bounty,Hideout,2,2,4
7169,2023-01-15,MR. P,knockout,Belle's Rock,13,18,31
7170,2023-01-15,MR. P,hotZone,Quarter Pounder,5,1,6
7171,2023-01-15,MR. P,heist,Bridge Too Far,5,6,11
7172,2023-01-15,MR. P,gemGrab,Hard Rock Mine,2,0,2
7173,2023-01-15,MR. P,gemGrab,Double Swoosh,2,3,5
7174,2023-01-15,MR. P,brawlBall,Backyard Bowl,7,35,42
7175,2023-01-15,MR. P,bounty,Canal Grande,4,15,19
7176,2023-01-14,MR. P,knockout,Flaring Phoenix,8,17,25
7177,2023-01-14,MR. P,hotZone,Controller Chaos,7,2,9
7178,2023-01-14,MR. P,heist,Bridge Too Far,8,0,8
7179,2023-01-14,MR. P,gemGrab,Hard Rock Mine,1,1,2
7180,2023-01-14,MR. P,gemGrab,Deep Diner,5,3,8
7181,2023-01-14,MR. P,brawlBall,Super Beach,7,3,10
7182,2023-01-14,MR. P,bounty,Canal Grande,1,2,3
7183,2023-01-13,MR. P,knockout,Flaring Phoenix,8,17,25
7184,2023-01-13,MR. P,gemGrab,Deep Diner,7,1,8
7185,2023-01-13,MR. P,brawlBall,Sneaky Fields,3,7,10
7186,2023-01-13,MR. P,brawlBall,Pinhole Punt,1,0,1
7187,2023-01-13,MR. P,bounty,Temple Ruins,0,3,3
7188,2023-01-12,MR. P,knockout,Riverside,11,1,12
7189,2023-01-12,MR. P,hotZone,Open Zone,2,1,3
7190,2023-01-12,MR. P,gemGrab,Undermine,1,1,2
7191,2023-01-12,MR. P,brawlBall,Pinhole Punt,0,2,2
7192,2023-01-11,MR. P,hotZone,Open Zone,1,0,1
7193,2023-01-11,MR. P,heist,Safe Zone,1,0,1
7194,2023-01-11,MR. P,gemGrab,Gem Fort,1,0,1
7195,2023-01-11,MR. P,brawlBall,Sunny Soccer,3,2,5
7196,2023-01-11,MR. P,bounty,Excel,0,8,8
7197,2023-01-10,MR. P,knockout,New Perspective,8,6,14
7198,2023-01-10,MR. P,hotZone,Dueling Beetles,3,1,4
7199,2023-01-10,MR. P,heist,Safe Zone,2,0,2
7200,2023-01-10,MR. P,gemGrab,Minecart Madness,4,14,18
7201,2023-01-10,MR. P,gemGrab,Crystal Arcade,2,0,2
7202,2023-01-10,MR. P,brawlBall,Beach Ball,5,12,17
7203,2023-01-10,MR. P,bounty,Excel,1,2,3
7204,2023-01-09,MR. P,knockout,New Perspective,1,0,1
7205,2023-01-09,MR. P,hotZone,Dueling Beetles,4,10,14
7206,2023-01-09,MR. P,gemGrab,Minecart Madness,10,13,23
7207,2023-01-09,MR. P,gemGrab,Double Swoosh,2,11,13
7208,2023-01-09,MR. P,brawlBall,Center Stage,1,2,3
7209,2023-01-09,MR. P,bounty,Layer Cake,9,4,13
7210,2023-01-08,MR. P,knockout,X Marks the Spot,4,2,6
7211,2023-01-08,MR. P,hotZone,Ring of Fire,1,0,1
7212,2023-01-08,MR. P,heist,Snaked Assault,4,0,4
7213,2023-01-08,MR. P,gemGrab,Double Swoosh,9,39,48
7214,2023-01-08,MR. P,brawlBall,Backyard Bowl,4,14,18
7215,2023-01-07,MR. P,knockout,X Marks the Spot,3,11,14
7216,2023-01-07,MR. P,hotZone,Ring of Fire,3,1,4
7217,2023-01-07,MR. P,gemGrab,Deep Diner,2,1,3
7218,2023-01-07,MR. P,bounty,Dry Season,6,2,8
7219,2023-01-06,MR. P,knockout,Out in the Open,3,1,4
7220,2023-01-06,MR. P,hotZone,Split,1,0,1
7221,2023-01-06,MR. P,gemGrab,Deep Diner,4,2,6
7222,2023-01-06,MR. P,brawlBall,Sneaky Fields,0,5,5
7223,2023-01-06,MR. P,bounty,Dry Season,11,11,22
7224,2023-01-05,MR. P,knockout,Out in the Open,8,23,31
7225,2023-01-05,MR. P,gemGrab,Undermine,3,1,4
7226,2023-01-05,MR. P,gemGrab,Gem Fort,0,1,1
7227,2023-01-05,MR. P,brawlBall,Pinhole Punt,4,7,11
7228,2023-01-05,MR. P,bounty,Shooting Star,6,0,6
7229,2023-01-04,MR. P,knockout,Goldarm Gulch,0,1,1
7230,2023-01-04,MR. P,heist,Kaboom Canyon,1,0,1
7231,2023-01-04,MR. P,gemGrab,Crystal Arcade,1,3,4
7232,2023-01-04,MR. P,brawlBall,Sunny Soccer,3,3,6
7233,2023-01-04,MR. P,bounty,Shooting Star,11,4,15
7234,2023-01-03,MR. P,knockout,Goldarm Gulch,1,1,2
7235,2023-01-03,MR. P,hotZone,Parallel Plays,1,2,3
7236,2023-01-03,MR. P,heist,Pit Stop,1,0,1
7237,2023-01-03,MR. P,gemGrab,Crystal Arcade,4,5,9
7238,2023-01-03,MR. P,brawlBall,Center Stage,1,0,1
7239,2023-01-03,MR. P,brawlBall,Beach Ball,4,16,20
7240,2023-01-03,MR. P,bounty,Hideout,5,4,9
7241,2023-01-02,MR. P,knockout,Belle's Rock,16,4,20
7242,2023-01-02,MR. P,hotZone,Quarter Pounder,5,9,14
7243,2023-01-02,MR. P,heist,Pit Stop,1,0,1
7244,2023-01-02,MR. P,gemGrab,Minecart Madness,10,17,27
7245,2023-01-02,MR. P,brawlBall,Center Stage,4,2,6
7246,2023-01-02,MR. P,brawlBall,Backyard Bowl,1,0,1
7247,2023-01-02,MR. P,bounty,Hideout,7,4,11
7248,2023-01-01,MR. P,knockout,Belle's Rock,1,2,3
7249,2023-01-01,MR. P,hotZone,Quarter Pounder,1,0,1
7250,2023-01-01,MR. P,gemGrab,Double Swoosh,9,26,35
7251,2023-01-01,MR. P,brawlBall,Backyard Bowl,9,16,25
7252,2023-01-01,MR. P,bounty,Canal Grande,1,1,2
7253,2022-12-31,MR. P,hotZone,Controller Chaos,2,1,3
7254,2022-12-24,MR. P,knockout,X Marks the Spot,1,1,2
7255,2022-12-23,MR. P,knockout,Out in the Open,2,0,2
7256,2022-12-22,MR. P,gemGrab,Gem Fort,1,0,1
7257,2022-12-19,MR. P,gemGrab,Minecart Madness,2,0,2
7258,2022-11-07,MR. P,hotZone,Quarter Pounder,2,0,2
7259,2022-11-01,MR. P,knockout,New Perspective,4,4,8
7260,2022-10-30,MR. P,knockout,Out in the Open,0,2,2
7261,2022-10-26,MR. P,bounty,Shooting Star,0,1,1
7262,2023-02-11,MORTIS,knockout,Flaring Phoenix,408,437,845
7263,2023-02-11,MORTIS,hotZone,Controller Chaos,106,78,184
7264,2023-02-11,MORTIS,gemGrab,Deep Diner,256,206,462
7265,2023-02-11,MORTIS,brawlBall,Super Beach,781,632,1413
7266,2023-02-11,MORTIS,brawlBall,Sneaky Fields,337,225,562
7267,2023-02-10,MORTIS,knockout,Flaring Phoenix,1137,1225,2362
7268,2023-02-10,MORTIS,hotZone,Controller Chaos,79,54,133
7269,2023-02-10,MORTIS,heist,Hot Potato,13,6,19
7270,2023-02-10,MORTIS,gemGrab,Undermine,112,106,218
7271,2023-02-10,MORTIS,gemGrab,Deep Diner,588,528,1116
7272,2023-02-10,MORTIS,brawlBall,Sneaky Fields,3326,2300,5626
7273,2023-02-10,MORTIS,brawlBall,Pinhole Punt,69,59,128
7274,2023-02-10,MORTIS,bounty,Temple Ruins,167,141,308
7275,2023-02-09,MORTIS,knockout,Riverside,18,16,34
7276,2023-02-09,MORTIS,hotZone,Open Zone,12,4,16
7277,2023-02-09,MORTIS,heist,Hot Potato,3,1,4
7278,2023-02-09,MORTIS,gemGrab,Undermine,94,55,149
7279,2023-02-09,MORTIS,gemGrab,Gem Fort,14,12,26
7280,2023-02-09,MORTIS,brawlBall,Sunny Soccer,9,4,13
7281,2023-02-09,MORTIS,brawlBall,Pinhole Punt,1156,910,2066
7282,2023-02-09,MORTIS,bounty,Temple Ruins,69,60,129
7283,2023-02-08,MORTIS,knockout,Riverside,16,4,20
7284,2023-02-08,MORTIS,hotZone,Open Zone,8,4,12
7285,2023-02-08,MORTIS,heist,Safe Zone,3,0,3
7286,2023-02-08,MORTIS,gemGrab,Gem Fort,35,32,67
7287,2023-02-08,MORTIS,gemGrab,Crystal Arcade,15,8,23
7288,2023-02-08,MORTIS,brawlBall,Sunny Soccer,363,318,681
7289,2023-02-08,MORTIS,brawlBall,Beach Ball,16,10,26
7290,2023-02-08,MORTIS,bounty,Excel,36,38,74
7291,2023-02-07,MORTIS,knockout,New Perspective,48,17,65
7292,2023-02-07,MORTIS,hotZone,Dueling Beetles,26,9,35
7293,2023-02-07,MORTIS,gemGrab,Minecart Madness,14,13,27
7294,2023-02-07,MORTIS,gemGrab,Crystal Arcade,22,12,34
7295,2023-02-07,MORTIS,brawlBall,Center Stage,26,27,53
7296,2023-02-07,MORTIS,brawlBall,Beach Ball,251,215,466
7297,2023-02-07,MORTIS,bounty,Excel,30,40,70
7298,2023-02-06,MORTIS,knockout,New Perspective,1007,1015,2022
7299,2023-02-06,MORTIS,knockout,Goldarm Gulch,4,2,6
7300,2023-02-06,MORTIS,hotZone,Dueling Beetles,289,228,517
7301,2023-02-06,MORTIS,heist,Snaked Assault,13,3,16
7302,2023-02-06,MORTIS,heist,Pit Stop,0,1,1
7303,2023-02-06,MORTIS,gemGrab,Minecart Madness,486,447,933
7304,2023-02-06,MORTIS,gemGrab,Double Swoosh,202,167,369
7305,2023-02-06,MORTIS,brawlBall,Sneaky Fields,16,6,22
7306,2023-02-06,MORTIS,brawlBall,Center Stage,4633,3550,8183
7307,2023-02-06,MORTIS,brawlBall,Backyard Bowl,390,252,642
7308,2023-02-06,MORTIS,bounty,Layer Cake,412,387,799
7309,2023-02-05,MORTIS,knockout,X Marks the Spot,246,189,435
7310,2023-02-05,MORTIS,knockout,Goldarm Gulch,16,18,34
7311,2023-02-05,MORTIS,hotZone,Ring of Fire,77,60,137
7312,2023-02-05,MORTIS,heist,Snaked Assault,10,2,12
7313,2023-02-05,MORTIS,heist,Pit Stop,6,2,8
7314,2023-02-05,MORTIS,gemGrab,Hard Rock Mine,134,78,212
7315,2023-02-05,MORTIS,gemGrab,Double Swoosh,668,528,1196
7316,2023-02-05,MORTIS,brawlBall,Super Beach,133,106,239
7317,2023-02-05,MORTIS,brawlBall,Sneaky Fields,57,37,94
7318,2023-02-05,MORTIS,brawlBall,Backyard Bowl,5004,3943,8947
7319,2023-02-05,MORTIS,bounty,Layer Cake,439,440,879
7320,2023-02-04,MORTIS,knockout,X Marks the Spot,115,127,242
7321,2023-02-04,MORTIS,knockout,Goldarm Gulch,14,14,28
7322,2023-02-04,MORTIS,hotZone,Ring of Fire,12,10,22
7323,2023-02-04,MORTIS,heist,Tornado Ring,1,0,1
7324,2023-02-04,MORTIS,heist,Pit Stop,4,1,5
7325,2023-02-04,MORTIS,gemGrab,Hard Rock Mine,155,131,286
7326,2023-02-04,MORTIS,gemGrab,Double Swoosh,39,48,87
7327,2023-02-04,MORTIS,gemGrab,Deep Diner,27,24,51
7328,2023-02-04,MORTIS,brawlBall,Super Beach,1311,1030,2341
7329,2023-02-04,MORTIS,brawlBall,Sneaky Fields,39,46,85
7330,2023-02-04,MORTIS,bounty,Dry Season,60,55,115
7331,2023-02-03,MORTIS,knockout,Out in the Open,332,310,642
7332,2023-02-03,MORTIS,knockout,Goldarm Gulch,88,66,154
7333,2023-02-03,MORTIS,hotZone,Split,64,35,99
7334,2023-02-03,MORTIS,heist,Tornado Ring,18,14,32
7335,2023-02-03,MORTIS,heist,Pit Stop,8,10,18
7336,2023-02-03,MORTIS,gemGrab,Undermine,112,68,180
7337,2023-02-03,MORTIS,gemGrab,Double Swoosh,279,333,612
7338,2023-02-03,MORTIS,gemGrab,Deep Diner,631,559,1190
7339,2023-02-03,MORTIS,brawlBall,Sneaky Fields,4002,2810,6812
7340,2023-02-03,MORTIS,brawlBall,Pinhole Punt,159,120,279
7341,2023-02-03,MORTIS,bounty,Dry Season,479,482,961
7342,2023-02-02,MORTIS,knockout,Out in the Open,144,137,281
7343,2023-02-02,MORTIS,hotZone,Split,19,28,47
7344,2023-02-02,MORTIS,gemGrab,Undermine,119,123,242
7345,2023-02-02,MORTIS,gemGrab,Gem Fort,30,22,52
7346,2023-02-02,MORTIS,brawlBall,Sunny Soccer,33,22,55
7347,2023-02-02,MORTIS,brawlBall,Pinhole Punt,1242,994,2236
7348,2023-02-02,MORTIS,bounty,Shooting Star,24,23,47
7349,2023-02-01,MORTIS,knockout,Goldarm Gulch,474,405,879
7350,2023-02-01,MORTIS,hotZone,Parallel Plays,196,165,361
7351,2023-02-01,MORTIS,heist,Kaboom Canyon,5,5,10
7352,2023-02-01,MORTIS,gemGrab,Gem Fort,396,296,692
7353,2023-02-01,MORTIS,gemGrab,Crystal Arcade,162,87,249
7354,2023-02-01,MORTIS,brawlBall,Sunny Soccer,3653,2730,6383
7355,2023-02-01,MORTIS,brawlBall,Beach Ball,129,84,213
7356,2023-02-01,MORTIS,bounty,Shooting Star,107,87,194
7357,2023-01-31,MORTIS,knockout,Goldarm Gulch,220,242,462
7358,2023-01-31,MORTIS,hotZone,Parallel Plays,65,49,114
7359,2023-01-31,MORTIS,heist,Pit Stop,2,2,4
7360,2023-01-31,MORTIS,gemGrab,Minecart Madness,23,17,40
7361,2023-01-31,MORTIS,gemGrab,Crystal Arcade,198,173,371
7362,2023-01-31,MORTIS,brawlBall,Center Stage,35,30,65
7363,2023-01-31,MORTIS,brawlBall,Beach Ball,1663,1219,2882
7364,2023-01-31,MORTIS,bounty,Hideout,67,71,138
7365,2023-01-30,MORTIS,knockout,Belle's Rock,583,540,1123
7366,2023-01-30,MORTIS,hotZone,Quarter Pounder,100,58,158
7367,2023-01-30,MORTIS,heist,Pit Stop,10,3,13
7368,2023-01-30,MORTIS,gemGrab,Minecart Madness,213,228,441
7369,2023-01-30,MORTIS,gemGrab,Double Swoosh,228,184,412
7370,2023-01-30,MORTIS,brawlBall,Center Stage,2706,2024,4730
7371,2023-01-30,MORTIS,brawlBall,Backyard Bowl,302,198,500
7372,2023-01-30,MORTIS,bounty,Hideout,114,121,235
7373,2023-01-29,MORTIS,knockout,Belle's Rock,566,569,1135
7374,2023-01-29,MORTIS,hotZone,Quarter Pounder,61,53,114
7375,2023-01-29,MORTIS,heist,Bridge Too Far,13,1,14
7376,2023-01-29,MORTIS,gemGrab,Hard Rock Mine,110,70,180
7377,2023-01-29,MORTIS,gemGrab,Double Swoosh,416,338,754
7378,2023-01-29,MORTIS,brawlBall,Super Beach,69,40,109
7379,2023-01-29,MORTIS,brawlBall,Backyard Bowl,3870,3192,7062
7380,2023-01-29,MORTIS,bounty,Canal Grande,72,38,110
7381,2023-01-28,MORTIS,knockout,Flaring Phoenix,543,499,1042
7382,2023-01-28,MORTIS,hotZone,Controller Chaos,77,40,117
7383,2023-01-28,MORTIS,heist,Bridge Too Far,25,6,31
7384,2023-01-28,MORTIS,gemGrab,Hard Rock Mine,455,362,817
7385,2023-01-28,MORTIS,gemGrab,Deep Diner,172,106,278
7386,2023-01-28,MORTIS,brawlBall,Super Beach,4380,3491,7871
7387,2023-01-28,MORTIS,brawlBall,Sneaky Fields,109,81,190
7388,2023-01-28,MORTIS,bounty,Canal Grande,130,89,219
7389,2023-01-27,MORTIS,knockout,Flaring Phoenix,286,301,587
7390,2023-01-27,MORTIS,hotZone,Controller Chaos,20,7,27
7391,2023-01-27,MORTIS,heist,Hot Potato,2,2,4
7392,2023-01-27,MORTIS,gemGrab,Undermine,18,14,32
7393,2023-01-27,MORTIS,gemGrab,Deep Diner,232,201,433
7394,2023-01-27,MORTIS,brawlBall,Sneaky Fields,917,732,1649
7395,2023-01-27,MORTIS,brawlBall,Pinhole Punt,25,26,51
7396,2023-01-27,MORTIS,bounty,Temple Ruins,51,31,82
7397,2023-01-26,MORTIS,knockout,Riverside,120,47,167
7398,2023-01-26,MORTIS,hotZone,Open Zone,69,23,92
7399,2023-01-26,MORTIS,heist,Hot Potato,18,5,23
7400,2023-01-26,MORTIS,gemGrab,Undermine,306,211,517
7401,2023-01-26,MORTIS,gemGrab,Gem Fort,160,118,278
7402,2023-01-26,MORTIS,brawlBall,Sunny Soccer,203,143,346
7403,2023-01-26,MORTIS,brawlBall,Pinhole Punt,3743,2888,6631
7404,2023-01-26,MORTIS,bounty,Temple Ruins,126,132,258
7405,2023-01-25,MORTIS,knockout,Riverside,51,28,79
7406,2023-01-25,MORTIS,hotZone,Open Zone,27,6,33
7407,2023-01-25,MORTIS,heist,Safe Zone,10,1,11
7408,2023-01-25,MORTIS,gemGrab,Gem Fort,184,127,311
7409,2023-01-25,MORTIS,gemGrab,Crystal Arcade,198,135,333
7410,2023-01-25,MORTIS,brawlBall,Sunny Soccer,2198,1654,3852
7411,2023-01-25,MORTIS,brawlBall,Beach Ball,318,243,561
7412,2023-01-25,MORTIS,bounty,Excel,212,230,442
7413,2023-01-24,MORTIS,knockout,New Perspective,288,297,585
7414,2023-01-24,MORTIS,hotZone,Dueling Beetles,113,99,212
7415,2023-01-24,MORTIS,heist,Safe Zone,15,6,21
7416,2023-01-24,MORTIS,gemGrab,Minecart Madness,90,90,180
7417,2023-01-24,MORTIS,gemGrab,Crystal Arcade,420,362,782
7418,2023-01-24,MORTIS,brawlBall,Center Stage,268,220,488
7419,2023-01-24,MORTIS,brawlBall,Beach Ball,3490,2772,6262
7420,2023-01-24,MORTIS,bounty,Excel,353,377,730
7421,2023-01-23,MORTIS,knockout,New Perspective,741,824,1565
7422,2023-01-23,MORTIS,hotZone,Dueling Beetles,176,137,313
7423,2023-01-23,MORTIS,heist,Snaked Assault,14,7,21
7424,2023-01-23,MORTIS,gemGrab,Minecart Madness,455,406,861
7425,2023-01-23,MORTIS,gemGrab,Double Swoosh,182,138,320
7426,2023-01-23,MORTIS,brawlBall,Center Stage,4080,3086,7166
7427,2023-01-23,MORTIS,brawlBall,Backyard Bowl,181,131,312
7428,2023-01-23,MORTIS,bounty,Layer Cake,399,359,758
7429,2023-01-22,MORTIS,knockout,X Marks the Spot,187,140,327
7430,2023-01-22,MORTIS,hotZone,Ring of Fire,48,19,67
7431,2023-01-22,MORTIS,heist,Snaked Assault,5,1,6
7432,2023-01-22,MORTIS,gemGrab,Hard Rock Mine,164,139,303
7433,2023-01-22,MORTIS,gemGrab,Double Swoosh,241,141,382
7434,2023-01-22,MORTIS,brawlBall,Super Beach,350,276,626
7435,2023-01-22,MORTIS,brawlBall,Backyard Bowl,1846,1514,3360
7436,2023-01-22,MORTIS,bounty,Layer Cake,228,227,455
7437,2023-01-21,MORTIS,knockout,X Marks the Spot,613,555,1168
7438,2023-01-21,MORTIS,hotZone,Ring of Fire,82,71,153
7439,2023-01-21,MORTIS,heist,Tornado Ring,17,3,20
7440,2023-01-21,MORTIS,gemGrab,Hard Rock Mine,746,596,1342
7441,2023-01-21,MORTIS,gemGrab,Deep Diner,128,87,215
7442,2023-01-21,MORTIS,brawlBall,Super Beach,5505,4062,9567
7443,2023-01-21,MORTIS,brawlBall,Sneaky Fields,162,104,266
7444,2023-01-21,MORTIS,bounty,Dry Season,293,255,548
7445,2023-01-20,MORTIS,knockout,Out in the Open,365,275,640
7446,2023-01-20,MORTIS,hotZone,Split,86,54,140
7447,2023-01-20,MORTIS,heist,Tornado Ring,23,2,25
7448,2023-01-20,MORTIS,gemGrab,Undermine,177,128,305
7449,2023-01-20,MORTIS,gemGrab,Deep Diner,624,464,1088
7450,2023-01-20,MORTIS,brawlBall,Sneaky Fields,3348,2355,5703
7451,2023-01-20,MORTIS,brawlBall,Pinhole Punt,167,140,307
7452,2023-01-20,MORTIS,bounty,Dry Season,289,319,608
7453,2023-01-19,MORTIS,knockout,Out in the Open,500,417,917
7454,2023-01-19,MORTIS,hotZone,Split,80,48,128
7455,2023-01-19,MORTIS,heist,Kaboom Canyon,13,2,15
7456,2023-01-19,MORTIS,gemGrab,Undermine,436,330,766
7457,2023-01-19,MORTIS,gemGrab,Gem Fort,75,46,121
7458,2023-01-19,MORTIS,brawlBall,Sunny Soccer,112,81,193
7459,2023-01-19,MORTIS,brawlBall,Pinhole Punt,4534,3442,7976
7460,2023-01-19,MORTIS,bounty,Shooting Star,136,109,245
7461,2023-01-18,MORTIS,knockout,Goldarm Gulch,47,40,87
7462,2023-01-18,MORTIS,hotZone,Parallel Plays,8,13,21
7463,2023-01-18,MORTIS,heist,Kaboom Canyon,3,0,3
7464,2023-01-18,MORTIS,gemGrab,Gem Fort,100,74,174
7465,2023-01-18,MORTIS,gemGrab,Crystal Arcade,21,9,30
7466,2023-01-18,MORTIS,brawlBall,Sunny Soccer,1113,868,1981
7467,2023-01-18,MORTIS,brawlBall,Beach Ball,43,40,83
7468,2023-01-18,MORTIS,bounty,Shooting Star,63,68,131
7469,2023-01-17,MORTIS,knockout,Goldarm Gulch,57,47,104
7470,2023-01-17,MORTIS,hotZone,Parallel Plays,7,2,9
7471,2023-01-17,MORTIS,gemGrab,Minecart Madness,3,6,9
7472,2023-01-17,MORTIS,gemGrab,Crystal Arcade,39,19,58
7473,2023-01-17,MORTIS,brawlBall,Center Stage,21,10,31
7474,2023-01-17,MORTIS,brawlBall,Beach Ball,369,282,651
7475,2023-01-17,MORTIS,bounty,Hideout,16,18,34
7476,2023-01-16,MORTIS,knockout,Belle's Rock,47,35,82
7477,2023-01-16,MORTIS,hotZone,Quarter Pounder,10,2,12
7478,2023-01-16,MORTIS,heist,Pit Stop,2,0,2
7479,2023-01-16,MORTIS,gemGrab,Minecart Madness,42,28,70
7480,2023-01-16,MORTIS,gemGrab,Double Swoosh,9,7,16
7481,2023-01-16,MORTIS,brawlBall,Center Stage,244,171,415
7482,2023-01-16,MORTIS,brawlBall,Backyard Bowl,38,10,48
7483,2023-01-16,MORTIS,bounty,Hideout,28,13,41
7484,2023-01-15,MORTIS,knockout,Belle's Rock,84,72,156
7485,2023-01-15,MORTIS,hotZone,Quarter Pounder,11,9,20
7486,2023-01-15,MORTIS,heist,Bridge Too Far,2,0,2
7487,2023-01-15,MORTIS,gemGrab,Hard Rock Mine,41,22,63
7488,2023-01-15,MORTIS,gemGrab,Double Swoosh,82,57,139
7489,2023-01-15,MORTIS,brawlBall,Super Beach,40,22,62
7490,2023-01-15,MORTIS,brawlBall,Backyard Bowl,448,268,716
7491,2023-01-15,MORTIS,bounty,Canal Grande,18,8,26
7492,2023-01-14,MORTIS,knockout,Flaring Phoenix,24,26,50
7493,2023-01-14,MORTIS,hotZone,Controller Chaos,16,7,23
7494,2023-01-14,MORTIS,heist,Bridge Too Far,3,0,3
7495,2023-01-14,MORTIS,gemGrab,Hard Rock Mine,44,36,80
7496,2023-01-14,MORTIS,gemGrab,Deep Diner,25,35,60
7497,2023-01-14,MORTIS,brawlBall,Super Beach,304,209,513
7498,2023-01-14,MORTIS,brawlBall,Sneaky Fields,12,5,17
7499,2023-01-14,MORTIS,bounty,Canal Grande,12,18,30
7500,2023-01-13,MORTIS,knockout,Flaring Phoenix,52,67,119
7501,2023-01-13,MORTIS,hotZone,Controller Chaos,24,45,69
7502,2023-01-13,MORTIS,gemGrab,Undermine,1,0,1
7503,2023-01-13,MORTIS,gemGrab,Deep Diner,70,32,102
7504,2023-01-13,MORTIS,brawlBall,Sneaky Fields,171,97,268
7505,2023-01-13,MORTIS,brawlBall,Pinhole Punt,2,3,5
7506,2023-01-13,MORTIS,bounty,Temple Ruins,7,16,23
7507,2023-01-12,MORTIS,knockout,Riverside,13,5,18
7508,2023-01-12,MORTIS,hotZone,Open Zone,9,2,11
7509,2023-01-12,MORTIS,gemGrab,Undermine,8,7,15
7510,2023-01-12,MORTIS,gemGrab,Gem Fort,3,2,5
7511,2023-01-12,MORTIS,brawlBall,Sunny Soccer,3,0,3
7512,2023-01-12,MORTIS,brawlBall,Pinhole Punt,67,55,122
7513,2023-01-11,MORTIS,knockout,Riverside,2,0,2
7514,2023-01-11,MORTIS,hotZone,Open Zone,1,1,2
7515,2023-01-11,MORTIS,gemGrab,Gem Fort,8,3,11
7516,2023-01-11,MORTIS,brawlBall,Sunny Soccer,56,51,107
7517,2023-01-11,MORTIS,brawlBall,Beach Ball,2,2,4
7518,2023-01-11,MORTIS,bounty,Excel,11,7,18
7519,2023-01-10,MORTIS,knockout,New Perspective,14,17,31
7520,2023-01-10,MORTIS,hotZone,Dueling Beetles,28,21,49
7521,2023-01-10,MORTIS,heist,Safe Zone,1,0,1
7522,2023-01-10,MORTIS,gemGrab,Minecart Madness,23,19,42
7523,2023-01-10,MORTIS,gemGrab,Crystal Arcade,50,30,80
7524,2023-01-10,MORTIS,brawlBall,Center Stage,25,32,57
7525,2023-01-10,MORTIS,brawlBall,Beach Ball,165,82,247
7526,2023-01-10,MORTIS,bounty,Excel,17,8,25
7527,2023-01-09,MORTIS,knockout,New Perspective,32,35,67
7528,2023-01-09,MORTIS,hotZone,Dueling Beetles,13,17,30
7529,2023-01-09,MORTIS,heist,Snaked Assault,1,1,2
7530,2023-01-09,MORTIS,gemGrab,Minecart Madness,43,13,56
7531,2023-01-09,MORTIS,gemGrab,Double Swoosh,24,15,39
7532,2023-01-09,MORTIS,brawlBall,Center Stage,155,131,286
7533,2023-01-09,MORTIS,brawlBall,Backyard Bowl,13,6,19
7534,2023-01-09,MORTIS,bounty,Layer Cake,53,80,133
7535,2023-01-08,MORTIS,knockout,X Marks the Spot,32,21,53
7536,2023-01-08,MORTIS,hotZone,Ring of Fire,8,1,9
7537,2023-01-08,MORTIS,heist,Snaked Assault,1,0,1
7538,2023-01-08,MORTIS,gemGrab,Hard Rock Mine,17,10,27
7539,2023-01-08,MORTIS,gemGrab,Double Swoosh,12,7,19
7540,2023-01-08,MORTIS,brawlBall,Super Beach,16,9,25
7541,2023-01-08,MORTIS,brawlBall,Backyard Bowl,188,101,289
7542,2023-01-08,MORTIS,bounty,Layer Cake,13,13,26
7543,2023-01-07,MORTIS,knockout,X Marks the Spot,15,11,26
7544,2023-01-07,MORTIS,hotZone,Ring of Fire,3,1,4
7545,2023-01-07,MORTIS,heist,Tornado Ring,2,0,2
7546,2023-01-07,MORTIS,gemGrab,Hard Rock Mine,38,15,53
7547,2023-01-07,MORTIS,gemGrab,Deep Diner,29,9,38
7548,2023-01-07,MORTIS,brawlBall,Super Beach,89,36,125
7549,2023-01-07,MORTIS,brawlBall,Sneaky Fields,15,4,19
7550,2023-01-07,MORTIS,bounty,Dry Season,29,22,51
7551,2023-01-06,MORTIS,knockout,Out in the Open,23,31,54
7552,2023-01-06,MORTIS,hotZone,Split,7,3,10
7553,2023-01-06,MORTIS,gemGrab,Undermine,10,17,27
7554,2023-01-06,MORTIS,gemGrab,Deep Diner,56,17,73
7555,2023-01-06,MORTIS,brawlBall,Sneaky Fields,92,38,130
7556,2023-01-06,MORTIS,brawlBall,Pinhole Punt,20,10,30
7557,2023-01-06,MORTIS,bounty,Dry Season,47,35,82
7558,2023-01-05,MORTIS,knockout,Out in the Open,49,20,69
7559,2023-01-05,MORTIS,hotZone,Split,8,2,10
7560,2023-01-05,MORTIS,heist,Kaboom Canyon,1,0,1
7561,2023-01-05,MORTIS,gemGrab,Undermine,37,27,64
7562,2023-01-05,MORTIS,gemGrab,Gem Fort,1,3,4
7563,2023-01-05,MORTIS,brawlBall,Sunny Soccer,4,1,5
7564,2023-01-05,MORTIS,brawlBall,Pinhole Punt,229,92,321
7565,2023-01-05,MORTIS,bounty,Shooting Star,14,17,31
7566,2023-01-04,MORTIS,knockout,Goldarm Gulch,17,13,30
7567,2023-01-04,MORTIS,hotZone,Parallel Plays,10,8,18
7568,2023-01-04,MORTIS,gemGrab,Gem Fort,48,18,66
7569,2023-01-04,MORTIS,gemGrab,Crystal Arcade,17,8,25
7570,2023-01-04,MORTIS,brawlBall,Sunny Soccer,169,78,247
7571,2023-01-04,MORTIS,brawlBall,Beach Ball,5,2,7
7572,2023-01-04,MORTIS,bounty,Shooting Star,36,35,71
7573,2023-01-03,MORTIS,knockout,Goldarm Gulch,17,7,24
7574,2023-01-03,MORTIS,hotZone,Parallel Plays,9,2,11
7575,2023-01-03,MORTIS,heist,Pit Stop,1,0,1
7576,2023-01-03,MORTIS,gemGrab,Minecart Madness,6,3,9
7577,2023-01-03,MORTIS,gemGrab,Crystal Arcade,55,25,80
7578,2023-01-03,MORTIS,brawlBall,Center Stage,15,5,20
7579,2023-01-03,MORTIS,brawlBall,Beach Ball,181,51,232
7580,2023-01-03,MORTIS,bounty,Hideout,36,56,92
7581,2023-01-02,MORTIS,knockout,Belle's Rock,45,38,83
7582,2023-01-02,MORTIS,hotZone,Quarter Pounder,15,11,26
7583,2023-01-02,MORTIS,gemGrab,Minecart Madness,52,11,63
7584,2023-01-02,MORTIS,gemGrab,Double Swoosh,21,4,25
7585,2023-01-02,MORTIS,brawlBall,Center Stage,167,63,230
7586,2023-01-02,MORTIS,brawlBall,Backyard Bowl,25,18,43
7587,2023-01-02,MORTIS,bounty,Hideout,57,37,94
7588,2023-01-01,MORTIS,knockout,Belle's Rock,17,9,26
7589,2023-01-01,MORTIS,hotZone,Quarter Pounder,7,12,19
7590,2023-01-01,MORTIS,hotZone,Controller Chaos,0,1,1
7591,2023-01-01,MORTIS,gemGrab,Minecart Madness,0,1,1
7592,2023-01-01,MORTIS,gemGrab,Hard Rock Mine,1,0,1
7593,2023-01-01,MORTIS,gemGrab,Double Swoosh,14,8,22
7594,2023-01-01,MORTIS,brawlBall,Backyard Bowl,109,37,146
7595,2023-01-01,MORTIS,bounty,Canal Grande,0,3,3
7596,2022-12-31,MORTIS,knockout,Flaring Phoenix,0,1,1
7597,2022-12-31,MORTIS,hotZone,Controller Chaos,1,0,1
7598,2022-12-31,MORTIS,gemGrab,Hard Rock Mine,13,4,17
7599,2022-12-31,MORTIS,gemGrab,Deep Diner,4,4,8
7600,2022-12-31,MORTIS,brawlBall,Super Beach,26,10,36
7601,2022-12-30,MORTIS,knockout,Flaring Phoenix,5,3,8
7602,2022-12-30,MORTIS,hotZone,Controller Chaos,3,6,9
7603,2022-12-30,MORTIS,heist,Kaboom Canyon,1,0,1
7604,2022-12-30,MORTIS,gemGrab,Deep Diner,11,4,15
7605,2022-12-30,MORTIS,brawlBall,Sneaky Fields,21,11,32
7606,2022-12-29,MORTIS,hotZone,Open Zone,1,0,1
7607,2022-12-29,MORTIS,gemGrab,Undermine,1,1,2
7608,2022-12-29,MORTIS,gemGrab,Minecart Madness,1,1,2
7609,2022-12-29,MORTIS,brawlBall,Pinhole Punt,8,14,22
7610,2022-12-28,MORTIS,brawlBall,Sunny Soccer,6,6,12
7611,2022-12-28,MORTIS,brawlBall,Beach Ball,2,0,2
7612,2022-12-27,MORTIS,gemGrab,Minecart Madness,0,2,2
7613,2022-12-27,MORTIS,brawlBall,Beach Ball,15,7,22
7614,2022-12-26,MORTIS,heist,Kaboom Canyon,0,3,3
7615,2022-12-26,MORTIS,gemGrab,Minecart Madness,1,5,6
7616,2022-12-26,MORTIS,brawlBall,Center Stage,5,2,7
7617,2022-12-25,MORTIS,brawlBall,Backyard Bowl,1,0,1
7618,2022-12-25,MORTIS,bounty,Layer Cake,2,2,4
7619,2022-12-24,MORTIS,brawlBall,Super Beach,3,2,5
7620,2022-12-24,MORTIS,bounty,Dry Season,1,0,1
7621,2022-12-23,MORTIS,knockout,Out in the Open,0,2,2
7622,2022-12-23,MORTIS,brawlBall,Sneaky Fields,1,2,3
7623,2022-12-22,MORTIS,gemGrab,Gem Fort,1,2,3
7624,2022-12-22,MORTIS,brawlBall,Pinhole Punt,6,0,6
7625,2022-12-21,MORTIS,brawlBall,Sunny Soccer,3,3,6
7626,2022-12-20,MORTIS,brawlBall,Beach Ball,5,6,11
7627,2022-12-19,MORTIS,gemGrab,Minecart Madness,2,0,2
7628,2022-12-19,MORTIS,brawlBall,Center Stage,7,5,12
7629,2022-12-17,MORTIS,knockout,Flaring Phoenix,4,4,8
7630,2022-12-16,MORTIS,brawlBall,Sneaky Fields,5,2,7
7631,2022-12-16,MORTIS,bounty,Temple Ruins,1,6,7
7632,2022-12-13,MORTIS,knockout,New Perspective,2,1,3
7633,2022-12-13,MORTIS,gemGrab,Crystal Arcade,3,2,5
7634,2022-12-13,MORTIS,brawlBall,Beach Ball,4,1,5
7635,2022-12-12,MORTIS,brawlBall,Center Stage,2,0,2
7636,2022-12-11,MORTIS,gemGrab,Double Swoosh,4,0,4
7637,2022-12-10,MORTIS,knockout,X Marks the Spot,1,1,2
7638,2022-11-11,MORTIS,brawlBall,Sneaky Fields,2,0,2
7639,2022-11-03,MORTIS,bounty,Temple Ruins,0,2,2
7640,2022-10-28,MORTIS,brawlBall,Beach Ball,2,0,2
7641,2022-10-26,MORTIS,brawlBall,Sunny Soccer,4,0,4
7642,2022-10-15,MORTIS,hotZone,Ring of Fire,1,0,1
7643,2022-10-15,MORTIS,gemGrab,Hard Rock Mine,2,2,4
7644,2022-10-15,MORTIS,brawlBall,Super Beach,1,1,2
7645,2022-10-10,MORTIS,knockout,Belle's Rock,1,0,1
7646,2022-09-07,MORTIS,brawlBall,Sunny Soccer,4,4,8
7647,2022-09-07,MORTIS,brawlBall,Pinhole Punt,2,2,4
7648,2022-09-06,MORTIS,brawlBall,Beach Ball,2,0,2
7649,2023-02-11,MEG,knockout,Flaring Phoenix,3,3,6
7650,2023-02-11,MEG,hotZone,Controller Chaos,50,41,91
7651,2023-02-11,MEG,gemGrab,Deep Diner,22,46,68
7652,2023-02-11,MEG,brawlBall,Super Beach,9,18,27
7653,2023-02-11,MEG,brawlBall,Sneaky Fields,7,6,13
7654,2023-02-10,MEG,knockout,Flaring Phoenix,15,19,34
7655,2023-02-10,MEG,hotZone,Controller Chaos,79,97,176
7656,2023-02-10,MEG,heist,Hot Potato,7,5,12
7657,2023-02-10,MEG,gemGrab,Undermine,18,25,43
7658,2023-02-10,MEG,gemGrab,Deep Diner,45,47,92
7659,2023-02-10,MEG,brawlBall,Sneaky Fields,65,73,138
7660,2023-02-10,MEG,brawlBall,Pinhole Punt,3,3,6
7661,2023-02-10,MEG,bounty,Temple Ruins,4,3,7
7662,2023-02-09,MEG,knockout,Riverside,2,3,5
7663,2023-02-09,MEG,hotZone,Open Zone,27,45,72
7664,2023-02-09,MEG,heist,Hot Potato,2,0,2
7665,2023-02-09,MEG,gemGrab,Undermine,14,13,27
7666,2023-02-09,MEG,gemGrab,Gem Fort,4,0,4
7667,2023-02-09,MEG,brawlBall,Pinhole Punt,42,55,97
7668,2023-02-09,MEG,bounty,Temple Ruins,1,0,1
7669,2023-02-08,MEG,knockout,Riverside,3,0,3
7670,2023-02-08,MEG,hotZone,Open Zone,45,68,113
7671,2023-02-08,MEG,heist,Safe Zone,4,2,6
7672,2023-02-08,MEG,gemGrab,Gem Fort,7,8,15
7673,2023-02-08,MEG,brawlBall,Sunny Soccer,22,21,43
7674,2023-02-08,MEG,brawlBall,Beach Ball,2,0,2
7675,2023-02-07,MEG,knockout,New Perspective,1,1,2
7676,2023-02-07,MEG,hotZone,Dueling Beetles,28,45,73
7677,2023-02-07,MEG,heist,Safe Zone,1,1,2
7678,2023-02-07,MEG,gemGrab,Minecart Madness,4,3,7
7679,2023-02-07,MEG,gemGrab,Crystal Arcade,0,2,2
7680,2023-02-07,MEG,brawlBall,Center Stage,1,0,1
7681,2023-02-07,MEG,brawlBall,Beach Ball,10,14,24
7682,2023-02-06,MEG,knockout,New Perspective,37,18,55
7683,2023-02-06,MEG,hotZone,Dueling Beetles,466,814,1280
7684,2023-02-06,MEG,heist,Snaked Assault,14,14,28
7685,2023-02-06,MEG,gemGrab,Minecart Madness,69,150,219
7686,2023-02-06,MEG,gemGrab,Double Swoosh,12,10,22
7687,2023-02-06,MEG,brawlBall,Center Stage,93,125,218
7688,2023-02-06,MEG,brawlBall,Backyard Bowl,33,67,100
7689,2023-02-06,MEG,bounty,Layer Cake,2,0,2
7690,2023-02-05,MEG,knockout,X Marks the Spot,2,11,13
7691,2023-02-05,MEG,hotZone,Ring of Fire,293,536,829
7692,2023-02-05,MEG,heist,Snaked Assault,22,11,33
7693,2023-02-05,MEG,gemGrab,Hard Rock Mine,7,4,11
7694,2023-02-05,MEG,gemGrab,Double Swoosh,38,37,75
7695,2023-02-05,MEG,brawlBall,Super Beach,4,5,9
7696,2023-02-05,MEG,brawlBall,Sneaky Fields,1,0,1
7697,2023-02-05,MEG,brawlBall,Backyard Bowl,453,623,1076
7698,2023-02-05,MEG,bounty,Layer Cake,7,10,17
7699,2023-02-04,MEG,knockout,X Marks the Spot,3,2,5
7700,2023-02-04,MEG,knockout,Goldarm Gulch,3,0,3
7701,2023-02-04,MEG,hotZone,Ring of Fire,66,93,159
7702,2023-02-04,MEG,heist,Tornado Ring,2,0,2
7703,2023-02-04,MEG,gemGrab,Hard Rock Mine,3,6,9
7704,2023-02-04,MEG,gemGrab,Double Swoosh,1,5,6
7705,2023-02-04,MEG,gemGrab,Deep Diner,2,2,4
7706,2023-02-04,MEG,brawlBall,Super Beach,32,31,63
7707,2023-02-04,MEG,brawlBall,Sneaky Fields,1,0,1
7708,2023-02-04,MEG,bounty,Dry Season,2,2,4
7709,2023-02-03,MEG,knockout,Out in the Open,21,12,33
7710,2023-02-03,MEG,knockout,Goldarm Gulch,3,3,6
7711,2023-02-03,MEG,hotZone,Split,12,12,24
7712,2023-02-03,MEG,heist,Tornado Ring,8,3,11
7713,2023-02-03,MEG,heist,Pit Stop,1,1,2
7714,2023-02-03,MEG,gemGrab,Undermine,9,9,18
7715,2023-02-03,MEG,gemGrab,Double Swoosh,13,2,15
7716,2023-02-03,MEG,gemGrab,Deep Diner,42,74,116
7717,2023-02-03,MEG,brawlBall,Sneaky Fields,70,65,135
7718,2023-02-03,MEG,brawlBall,Pinhole Punt,3,2,5
7719,2023-02-03,MEG,bounty,Dry Season,8,12,20
7720,2023-02-02,MEG,knockout,Out in the Open,9,10,19
7721,2023-02-02,MEG,hotZone,Split,4,1,5
7722,2023-02-02,MEG,heist,Kaboom Canyon,8,26,34
7723,2023-02-02,MEG,gemGrab,Undermine,11,18,29
7724,2023-02-02,MEG,gemGrab,Gem Fort,1,5,6
7725,2023-02-02,MEG,brawlBall,Pinhole Punt,58,88,146
7726,2023-02-02,MEG,bounty,Shooting Star,2,3,5
7727,2023-02-01,MEG,knockout,Goldarm Gulch,12,5,17
7728,2023-02-01,MEG,hotZone,Parallel Plays,44,49,93
7729,2023-02-01,MEG,heist,Kaboom Canyon,26,71,97
7730,2023-02-01,MEG,gemGrab,Gem Fort,39,47,86
7731,2023-02-01,MEG,gemGrab,Crystal Arcade,12,15,27
7732,2023-02-01,MEG,brawlBall,Sunny Soccer,88,89,177
7733,2023-02-01,MEG,brawlBall,Beach Ball,1,0,1
7734,2023-02-01,MEG,bounty,Shooting Star,10,10,20
7735,2023-01-31,MEG,knockout,Goldarm Gulch,6,9,15
7736,2023-01-31,MEG,hotZone,Parallel Plays,18,20,38
7737,2023-01-31,MEG,heist,Pit Stop,2,4,6
7738,2023-01-31,MEG,gemGrab,Minecart Madness,2,7,9
7739,2023-01-31,MEG,gemGrab,Crystal Arcade,9,12,21
7740,2023-01-31,MEG,brawlBall,Center Stage,0,2,2
7741,2023-01-31,MEG,brawlBall,Beach Ball,56,60,116
7742,2023-01-31,MEG,bounty,Hideout,2,3,5
7743,2023-01-30,MEG,knockout,Belle's Rock,13,10,23
7744,2023-01-30,MEG,hotZone,Quarter Pounder,129,301,430
7745,2023-01-30,MEG,gemGrab,Minecart Madness,46,115,161
7746,2023-01-30,MEG,gemGrab,Double Swoosh,16,29,45
7747,2023-01-30,MEG,brawlBall,Center Stage,52,45,97
7748,2023-01-30,MEG,brawlBall,Backyard Bowl,31,52,83
7749,2023-01-30,MEG,bounty,Hideout,4,3,7
7750,2023-01-29,MEG,knockout,Belle's Rock,10,19,29
7751,2023-01-29,MEG,hotZone,Quarter Pounder,141,354,495
7752,2023-01-29,MEG,heist,Bridge Too Far,50,110,160
7753,2023-01-29,MEG,gemGrab,Hard Rock Mine,7,7,14
7754,2023-01-29,MEG,gemGrab,Double Swoosh,17,30,47
7755,2023-01-29,MEG,brawlBall,Super Beach,0,1,1
7756,2023-01-29,MEG,brawlBall,Backyard Bowl,326,488,814
7757,2023-01-29,MEG,bounty,Canal Grande,2,1,3
7758,2023-01-28,MEG,knockout,Flaring Phoenix,6,6,12
7759,2023-01-28,MEG,hotZone,Controller Chaos,69,61,130
7760,2023-01-28,MEG,heist,Bridge Too Far,176,212,388
7761,2023-01-28,MEG,gemGrab,Hard Rock Mine,54,48,102
7762,2023-01-28,MEG,gemGrab,Deep Diner,9,19,28
7763,2023-01-28,MEG,brawlBall,Super Beach,109,140,249
7764,2023-01-28,MEG,brawlBall,Sneaky Fields,1,1,2
7765,2023-01-28,MEG,bounty,Canal Grande,1,1,2
7766,2023-01-27,MEG,knockout,Flaring Phoenix,1,2,3
7767,2023-01-27,MEG,hotZone,Controller Chaos,16,16,32
7768,2023-01-27,MEG,heist,Hot Potato,8,5,13
7769,2023-01-27,MEG,gemGrab,Undermine,3,2,5
7770,2023-01-27,MEG,gemGrab,Deep Diner,15,12,27
7771,2023-01-27,MEG,brawlBall,Sneaky Fields,14,28,42
7772,2023-01-27,MEG,brawlBall,Pinhole Punt,1,0,1
7773,2023-01-27,MEG,bounty,Temple Ruins,5,3,8
7774,2023-01-26,MEG,knockout,Riverside,26,26,52
7775,2023-01-26,MEG,hotZone,Open Zone,209,464,673
7776,2023-01-26,MEG,heist,Hot Potato,7,5,12
7777,2023-01-26,MEG,gemGrab,Undermine,14,23,37
7778,2023-01-26,MEG,gemGrab,Gem Fort,8,6,14
7779,2023-01-26,MEG,brawlBall,Sunny Soccer,3,3,6
7780,2023-01-26,MEG,brawlBall,Pinhole Punt,207,248,455
7781,2023-01-26,MEG,bounty,Temple Ruins,5,7,12
7782,2023-01-25,MEG,knockout,Riverside,21,23,44
7783,2023-01-25,MEG,hotZone,Open Zone,148,248,396
7784,2023-01-25,MEG,heist,Safe Zone,22,25,47
7785,2023-01-25,MEG,gemGrab,Gem Fort,21,19,40
7786,2023-01-25,MEG,gemGrab,Crystal Arcade,19,9,28
7787,2023-01-25,MEG,brawlBall,Sunny Soccer,48,68,116
7788,2023-01-25,MEG,brawlBall,Beach Ball,11,13,24
7789,2023-01-24,MEG,knockout,New Perspective,13,22,35
7790,2023-01-24,MEG,hotZone,Dueling Beetles,124,374,498
7791,2023-01-24,MEG,heist,Safe Zone,33,44,77
7792,2023-01-24,MEG,gemGrab,Minecart Madness,36,45,81
7793,2023-01-24,MEG,gemGrab,Crystal Arcade,36,46,82
7794,2023-01-24,MEG,brawlBall,Center Stage,19,12,31
7795,2023-01-24,MEG,brawlBall,Beach Ball,107,146,253
7796,2023-01-24,MEG,bounty,Excel,3,4,7
7797,2023-01-23,MEG,knockout,New Perspective,14,9,23
7798,2023-01-23,MEG,hotZone,Dueling Beetles,299,518,817
7799,2023-01-23,MEG,heist,Snaked Assault,13,16,29
7800,2023-01-23,MEG,gemGrab,Minecart Madness,63,110,173
7801,2023-01-23,MEG,gemGrab,Double Swoosh,17,10,27
7802,2023-01-23,MEG,brawlBall,Center Stage,107,129,236
7803,2023-01-23,MEG,brawlBall,Backyard Bowl,29,37,66
7804,2023-01-23,MEG,bounty,Layer Cake,8,10,18
7805,2023-01-22,MEG,knockout,X Marks the Spot,4,5,9
7806,2023-01-22,MEG,hotZone,Ring of Fire,69,136,205
7807,2023-01-22,MEG,heist,Snaked Assault,4,1,5
7808,2023-01-22,MEG,gemGrab,Hard Rock Mine,0,6,6
7809,2023-01-22,MEG,gemGrab,Double Swoosh,26,22,48
7810,2023-01-22,MEG,brawlBall,Super Beach,11,13,24
7811,2023-01-22,MEG,brawlBall,Backyard Bowl,149,206,355
7812,2023-01-22,MEG,bounty,Layer Cake,1,2,3
7813,2023-01-21,MEG,knockout,X Marks the Spot,27,49,76
7814,2023-01-21,MEG,hotZone,Ring of Fire,254,440,694
7815,2023-01-21,MEG,heist,Tornado Ring,14,13,27
7816,2023-01-21,MEG,gemGrab,Hard Rock Mine,31,32,63
7817,2023-01-21,MEG,gemGrab,Deep Diner,5,12,17
7818,2023-01-21,MEG,brawlBall,Super Beach,99,116,215
7819,2023-01-21,MEG,brawlBall,Sneaky Fields,2,3,5
7820,2023-01-21,MEG,bounty,Dry Season,10,4,14
7821,2023-01-20,MEG,knockout,Out in the Open,17,32,49
7822,2023-01-20,MEG,hotZone,Split,7,6,13
7823,2023-01-20,MEG,heist,Tornado Ring,11,7,18
7824,2023-01-20,MEG,gemGrab,Undermine,11,18,29
7825,2023-01-20,MEG,gemGrab,Deep Diner,39,67,106
7826,2023-01-20,MEG,brawlBall,Sneaky Fields,57,66,123
7827,2023-01-20,MEG,brawlBall,Pinhole Punt,12,11,23
7828,2023-01-20,MEG,bounty,Dry Season,11,7,18
7829,2023-01-19,MEG,knockout,Out in the Open,39,31,70
7830,2023-01-19,MEG,hotZone,Split,11,9,20
7831,2023-01-19,MEG,heist,Kaboom Canyon,20,47,67
7832,2023-01-19,MEG,gemGrab,Undermine,26,32,58
7833,2023-01-19,MEG,gemGrab,Gem Fort,6,5,11
7834,2023-01-19,MEG,brawlBall,Sunny Soccer,3,0,3
7835,2023-01-19,MEG,brawlBall,Pinhole Punt,194,265,459
7836,2023-01-19,MEG,bounty,Shooting Star,10,11,21
7837,2023-01-18,MEG,knockout,Goldarm Gulch,3,1,4
7838,2023-01-18,MEG,hotZone,Parallel Plays,4,0,4
7839,2023-01-18,MEG,heist,Kaboom Canyon,8,27,35
7840,2023-01-18,MEG,gemGrab,Gem Fort,6,6,12
7841,2023-01-18,MEG,gemGrab,Crystal Arcade,2,5,7
7842,2023-01-18,MEG,brawlBall,Sunny Soccer,18,29,47
7843,2023-01-18,MEG,brawlBall,Beach Ball,4,0,4
7844,2023-01-18,MEG,bounty,Shooting Star,7,12,19
7845,2023-01-17,MEG,knockout,Goldarm Gulch,0,1,1
7846,2023-01-17,MEG,hotZone,Parallel Plays,4,3,7
7847,2023-01-17,MEG,gemGrab,Minecart Madness,2,2,4
7848,2023-01-17,MEG,gemGrab,Crystal Arcade,2,5,7
7849,2023-01-17,MEG,brawlBall,Beach Ball,17,16,33
7850,2023-01-17,MEG,bounty,Hideout,0,2,2
7851,2023-01-16,MEG,knockout,Belle's Rock,1,0,1
7852,2023-01-16,MEG,hotZone,Quarter Pounder,8,55,63
7853,2023-01-16,MEG,gemGrab,Minecart Madness,5,12,17
7854,2023-01-16,MEG,gemGrab,Double Swoosh,1,0,1
7855,2023-01-16,MEG,brawlBall,Center Stage,3,2,5
7856,2023-01-16,MEG,brawlBall,Backyard Bowl,3,12,15
7857,2023-01-16,MEG,bounty,Hideout,1,0,1
7858,2023-01-15,MEG,knockout,Belle's Rock,1,1,2
7859,2023-01-15,MEG,hotZone,Quarter Pounder,36,118,154
7860,2023-01-15,MEG,heist,Bridge Too Far,25,42,67
7861,2023-01-15,MEG,gemGrab,Double Swoosh,3,7,10
7862,2023-01-15,MEG,brawlBall,Backyard Bowl,47,53,100
7863,2023-01-14,MEG,knockout,Flaring Phoenix,1,2,3
7864,2023-01-14,MEG,hotZone,Controller Chaos,6,32,38
7865,2023-01-14,MEG,heist,Bridge Too Far,15,51,66
7866,2023-01-14,MEG,gemGrab,Hard Rock Mine,1,0,1
7867,2023-01-14,MEG,gemGrab,Deep Diner,3,0,3
7868,2023-01-14,MEG,brawlBall,Super Beach,7,9,16
7869,2023-01-14,MEG,brawlBall,Sneaky Fields,3,0,3
7870,2023-01-13,MEG,knockout,Flaring Phoenix,0,1,1
7871,2023-01-13,MEG,hotZone,Controller Chaos,12,26,38
7872,2023-01-13,MEG,gemGrab,Deep Diner,1,1,2
7873,2023-01-13,MEG,brawlBall,Sneaky Fields,2,0,2
7874,2023-01-13,MEG,brawlBall,Pinhole Punt,0,1,1
7875,2023-01-13,MEG,bounty,Temple Ruins,0,1,1
7876,2023-01-12,MEG,knockout,Riverside,1,0,1
7877,2023-01-12,MEG,hotZone,Open Zone,13,69,82
7878,2023-01-12,MEG,brawlBall,Pinhole Punt,5,10,15
7879,2023-01-11,MEG,knockout,Riverside,4,3,7
7880,2023-01-11,MEG,hotZone,Open Zone,16,26,42
7881,2023-01-11,MEG,brawlBall,Sunny Soccer,2,2,4
7882,2023-01-10,MEG,hotZone,Dueling Beetles,20,54,74
7883,2023-01-10,MEG,heist,Safe Zone,2,5,7
7884,2023-01-10,MEG,gemGrab,Minecart Madness,2,18,20
7885,2023-01-10,MEG,gemGrab,Crystal Arcade,1,0,1
7886,2023-01-10,MEG,brawlBall,Beach Ball,17,41,58
7887,2023-01-09,MEG,knockout,New Perspective,0,1,1
7888,2023-01-09,MEG,hotZone,Dueling Beetles,9,30,39
7889,2023-01-09,MEG,heist,Snaked Assault,3,0,3
7890,2023-01-09,MEG,gemGrab,Minecart Madness,7,28,35
7891,2023-01-09,MEG,gemGrab,Double Swoosh,1,1,2
7892,2023-01-09,MEG,brawlBall,Center Stage,1,0,1
7893,2023-01-09,MEG,brawlBall,Backyard Bowl,3,9,12
7894,2023-01-09,MEG,bounty,Layer Cake,1,2,3
7895,2023-01-08,MEG,knockout,X Marks the Spot,4,3,7
7896,2023-01-08,MEG,hotZone,Ring of Fire,23,40,63
7897,2023-01-08,MEG,heist,Snaked Assault,1,0,1
7898,2023-01-08,MEG,gemGrab,Hard Rock Mine,1,1,2
7899,2023-01-08,MEG,gemGrab,Double Swoosh,1,0,1
7900,2023-01-08,MEG,brawlBall,Super Beach,0,4,4
7901,2023-01-08,MEG,brawlBall,Backyard Bowl,28,27,55
7902,2023-01-08,MEG,bounty,Layer Cake,1,0,1
7903,2023-01-07,MEG,hotZone,Ring of Fire,19,36,55
7904,2023-01-07,MEG,brawlBall,Sneaky Fields,0,6,6
7905,2023-01-07,MEG,bounty,Dry Season,0,2,2
7906,2023-01-06,MEG,gemGrab,Undermine,2,1,3
7907,2023-01-06,MEG,brawlBall,Sneaky Fields,5,2,7
7908,2023-01-06,MEG,brawlBall,Pinhole Punt,0,2,2
7909,2023-01-05,MEG,knockout,Out in the Open,5,2,7
7910,2023-01-05,MEG,hotZone,Split,1,0,1
7911,2023-01-05,MEG,heist,Kaboom Canyon,5,12,17
7912,2023-01-05,MEG,gemGrab,Undermine,3,5,8
7913,2023-01-05,MEG,gemGrab,Gem Fort,0,2,2
7914,2023-01-05,MEG,brawlBall,Pinhole Punt,9,25,34
7915,2023-01-05,MEG,bounty,Shooting Star,0,1,1
7916,2023-01-04,MEG,hotZone,Parallel Plays,0,2,2
7917,2023-01-04,MEG,heist,Kaboom Canyon,3,7,10
7918,2023-01-04,MEG,gemGrab,Gem Fort,1,0,1
7919,2023-01-04,MEG,gemGrab,Crystal Arcade,1,0,1
7920,2023-01-04,MEG,brawlBall,Sunny Soccer,1,0,1
7921,2023-01-04,MEG,bounty,Shooting Star,1,0,1
7922,2023-01-03,MEG,knockout,Goldarm Gulch,1,0,1
7923,2023-01-03,MEG,hotZone,Parallel Plays,1,0,1
7924,2023-01-03,MEG,gemGrab,Minecart Madness,2,17,19
7925,2023-01-03,MEG,gemGrab,Crystal Arcade,3,0,3
7926,2023-01-03,MEG,brawlBall,Beach Ball,5,1,6
7927,2023-01-03,MEG,bounty,Hideout,1,0,1
7928,2023-01-02,MEG,knockout,Belle's Rock,1,2,3
7929,2023-01-02,MEG,hotZone,Quarter Pounder,23,33,56
7930,2023-01-02,MEG,gemGrab,Minecart Madness,9,15,24
7931,2023-01-02,MEG,gemGrab,Double Swoosh,1,0,1
7932,2023-01-02,MEG,brawlBall,Center Stage,3,0,3
7933,2023-01-02,MEG,brawlBall,Backyard Bowl,1,0,1
7934,2023-01-02,MEG,bounty,Hideout,1,1,2
7935,2023-01-01,MEG,knockout,Belle's Rock,1,6,7
7936,2023-01-01,MEG,hotZone,Quarter Pounder,12,19,31
7937,2023-01-01,MEG,heist,Bridge Too Far,1,1,2
7938,2023-01-01,MEG,brawlBall,Backyard Bowl,13,6,19
7939,2022-12-31,MEG,gemGrab,Hard Rock Mine,0,3,3
7940,2022-12-31,MEG,brawlBall,Super Beach,0,8,8
7941,2022-12-30,MEG,hotZone,Controller Chaos,6,15,21
7942,2022-12-30,MEG,heist,Kaboom Canyon,1,1,2
7943,2022-12-30,MEG,gemGrab,Minecart Madness,0,1,1
7944,2022-12-30,MEG,gemGrab,Deep Diner,2,0,2
7945,2022-12-30,MEG,brawlBall,Sneaky Fields,0,1,1
7946,2022-12-29,MEG,hotZone,Open Zone,1,1,2
7947,2022-12-29,MEG,brawlBall,Pinhole Punt,0,1,1
7948,2022-12-27,MEG,heist,Kaboom Canyon,0,1,1
7949,2022-12-27,MEG,gemGrab,Minecart Madness,0,1,1
7950,2022-12-27,MEG,brawlBall,Beach Ball,3,1,4
7951,2022-12-26,MEG,gemGrab,Minecart Madness,0,1,1
7952,2022-12-22,MEG,brawlBall,Pinhole Punt,0,2,2
7953,2022-12-19,MEG,gemGrab,Minecart Madness,0,2,2
7954,2022-12-11,MEG,brawlBall,Backyard Bowl,0,2,2
7955,2022-12-10,MEG,gemGrab,Hard Rock Mine,1,0,1
7956,2023-02-11,MAX,knockout,Flaring Phoenix,44,27,71
7957,2023-02-11,MAX,hotZone,Controller Chaos,29,14,43
7958,2023-02-11,MAX,gemGrab,Deep Diner,64,76,140
7959,2023-02-11,MAX,brawlBall,Super Beach,241,288,529
7960,2023-02-11,MAX,brawlBall,Sneaky Fields,86,103,189
7961,2023-02-10,MAX,knockout,Flaring Phoenix,64,26,90
7962,2023-02-10,MAX,hotZone,Controller Chaos,43,26,69
7963,2023-02-10,MAX,heist,Hot Potato,46,32,78
7964,2023-02-10,MAX,gemGrab,Undermine,51,59,110
7965,2023-02-10,MAX,gemGrab,Deep Diner,184,211,395
7966,2023-02-10,MAX,brawlBall,Sneaky Fields,868,933,1801
7967,2023-02-10,MAX,brawlBall,Pinhole Punt,22,20,42
7968,2023-02-10,MAX,bounty,Temple Ruins,41,51,92
7969,2023-02-09,MAX,knockout,Riverside,13,7,20
7970,2023-02-09,MAX,hotZone,Open Zone,10,5,15
7971,2023-02-09,MAX,heist,Hot Potato,16,14,30
7972,2023-02-09,MAX,gemGrab,Undermine,22,25,47
7973,2023-02-09,MAX,gemGrab,Gem Fort,2,1,3
7974,2023-02-09,MAX,brawlBall,Sunny Soccer,1,0,1
7975,2023-02-09,MAX,brawlBall,Pinhole Punt,286,301,587
7976,2023-02-09,MAX,bounty,Temple Ruins,13,16,29
7977,2023-02-08,MAX,knockout,Riverside,12,9,21
7978,2023-02-08,MAX,hotZone,Open Zone,9,13,22
7979,2023-02-08,MAX,heist,Safe Zone,9,7,16
7980,2023-02-08,MAX,gemGrab,Gem Fort,13,13,26
7981,2023-02-08,MAX,gemGrab,Crystal Arcade,2,5,7
7982,2023-02-08,MAX,brawlBall,Sunny Soccer,62,63,125
7983,2023-02-08,MAX,brawlBall,Beach Ball,10,4,14
7984,2023-02-08,MAX,bounty,Excel,3,1,4
7985,2023-02-07,MAX,knockout,New Perspective,5,1,6
7986,2023-02-07,MAX,hotZone,Dueling Beetles,15,5,20
7987,2023-02-07,MAX,heist,Safe Zone,1,3,4
7988,2023-02-07,MAX,gemGrab,Minecart Madness,5,19,24
7989,2023-02-07,MAX,gemGrab,Crystal Arcade,10,6,16
7990,2023-02-07,MAX,brawlBall,Center Stage,14,24,38
7991,2023-02-07,MAX,brawlBall,Beach Ball,57,64,121
7992,2023-02-07,MAX,bounty,Excel,5,14,19
7993,2023-02-06,MAX,knockout,New Perspective,115,91,206
7994,2023-02-06,MAX,knockout,Goldarm Gulch,3,7,10
7995,2023-02-06,MAX,hotZone,Dueling Beetles,76,65,141
7996,2023-02-06,MAX,heist,Snaked Assault,82,94,176
7997,2023-02-06,MAX,heist,Pit Stop,5,3,8
7998,2023-02-06,MAX,gemGrab,Minecart Madness,232,228,460
7999,2023-02-06,MAX,gemGrab,Double Swoosh,68,48,116
8000,2023-02-06,MAX,brawlBall,Sneaky Fields,24,29,53
8001,2023-02-06,MAX,brawlBall,Center Stage,893,999,1892
8002,2023-02-06,MAX,brawlBall,Backyard Bowl,141,191,332
8003,2023-02-06,MAX,bounty,Layer Cake,49,31,80
8004,2023-02-05,MAX,knockout,X Marks the Spot,83,78,161
8005,2023-02-05,MAX,knockout,Goldarm Gulch,18,18,36
8006,2023-02-05,MAX,hotZone,Ring of Fire,77,89,166
8007,2023-02-05,MAX,heist,Snaked Assault,94,115,209
8008,2023-02-05,MAX,heist,Pit Stop,7,11,18
8009,2023-02-05,MAX,gemGrab,Hard Rock Mine,44,63,107
8010,2023-02-05,MAX,gemGrab,Double Swoosh,196,250,446
8011,2023-02-05,MAX,brawlBall,Super Beach,33,36,69
8012,2023-02-05,MAX,brawlBall,Sneaky Fields,56,101,157
8013,2023-02-05,MAX,brawlBall,Backyard Bowl,1957,2202,4159
8014,2023-02-05,MAX,bounty,Layer Cake,57,70,127
8015,2023-02-04,MAX,knockout,X Marks the Spot,31,22,53
8016,2023-02-04,MAX,knockout,Goldarm Gulch,11,18,29
8017,2023-02-04,MAX,hotZone,Ring of Fire,20,20,40
8018,2023-02-04,MAX,heist,Tornado Ring,4,5,9
8019,2023-02-04,MAX,heist,Pit Stop,8,12,20
8020,2023-02-04,MAX,gemGrab,Hard Rock Mine,52,41,93
8021,2023-02-04,MAX,gemGrab,Double Swoosh,12,44,56
8022,2023-02-04,MAX,gemGrab,Deep Diner,13,5,18
8023,2023-02-04,MAX,brawlBall,Super Beach,301,362,663
8024,2023-02-04,MAX,brawlBall,Sneaky Fields,33,95,128
8025,2023-02-04,MAX,bounty,Dry Season,14,13,27
8026,2023-02-03,MAX,knockout,Out in the Open,152,124,276
8027,2023-02-03,MAX,knockout,Goldarm Gulch,110,95,205
8028,2023-02-03,MAX,hotZone,Split,24,12,36
8029,2023-02-03,MAX,heist,Tornado Ring,47,25,72
8030,2023-02-03,MAX,heist,Pit Stop,29,24,53
8031,2023-02-03,MAX,gemGrab,Undermine,32,36,68
8032,2023-02-03,MAX,gemGrab,Double Swoosh,90,218,308
8033,2023-02-03,MAX,gemGrab,Deep Diner,164,186,350
8034,2023-02-03,MAX,brawlBall,Sneaky Fields,1117,1442,2559
8035,2023-02-03,MAX,brawlBall,Pinhole Punt,51,27,78
8036,2023-02-03,MAX,bounty,Dry Season,165,159,324
8037,2023-02-02,MAX,knockout,Out in the Open,54,21,75
8038,2023-02-02,MAX,hotZone,Split,8,4,12
8039,2023-02-02,MAX,heist,Kaboom Canyon,14,14,28
8040,2023-02-02,MAX,gemGrab,Undermine,35,39,74
8041,2023-02-02,MAX,gemGrab,Gem Fort,5,6,11
8042,2023-02-02,MAX,brawlBall,Sunny Soccer,8,11,19
8043,2023-02-02,MAX,brawlBall,Pinhole Punt,366,367,733
8044,2023-02-02,MAX,bounty,Shooting Star,35,25,60
8045,2023-02-01,MAX,knockout,Goldarm Gulch,121,108,229
8046,2023-02-01,MAX,hotZone,Parallel Plays,71,101,172
8047,2023-02-01,MAX,heist,Kaboom Canyon,82,81,163
8048,2023-02-01,MAX,gemGrab,Gem Fort,102,116,218
8049,2023-02-01,MAX,gemGrab,Crystal Arcade,64,44,108
8050,2023-02-01,MAX,brawlBall,Sunny Soccer,778,838,1616
8051,2023-02-01,MAX,brawlBall,Beach Ball,31,29,60
8052,2023-02-01,MAX,bounty,Shooting Star,102,127,229
8053,2023-01-31,MAX,knockout,Goldarm Gulch,42,30,72
8054,2023-01-31,MAX,hotZone,Parallel Plays,26,30,56
8055,2023-01-31,MAX,heist,Pit Stop,5,4,9
8056,2023-01-31,MAX,gemGrab,Minecart Madness,16,4,20
8057,2023-01-31,MAX,gemGrab,Crystal Arcade,80,64,144
8058,2023-01-31,MAX,brawlBall,Center Stage,5,6,11
8059,2023-01-31,MAX,brawlBall,Beach Ball,394,462,856
8060,2023-01-31,MAX,bounty,Hideout,27,30,57
8061,2023-01-30,MAX,knockout,Belle's Rock,132,175,307
8062,2023-01-30,MAX,hotZone,Quarter Pounder,101,72,173
8063,2023-01-30,MAX,heist,Pit Stop,35,34,69
8064,2023-01-30,MAX,gemGrab,Minecart Madness,143,158,301
8065,2023-01-30,MAX,gemGrab,Double Swoosh,76,68,144
8066,2023-01-30,MAX,brawlBall,Center Stage,489,544,1033
8067,2023-01-30,MAX,brawlBall,Backyard Bowl,133,151,284
8068,2023-01-30,MAX,bounty,Hideout,64,76,140
8069,2023-01-29,MAX,knockout,Belle's Rock,141,101,242
8070,2023-01-29,MAX,hotZone,Quarter Pounder,71,97,168
8071,2023-01-29,MAX,heist,Bridge Too Far,207,217,424
8072,2023-01-29,MAX,gemGrab,Hard Rock Mine,40,17,57
8073,2023-01-29,MAX,gemGrab,Double Swoosh,114,100,214
8074,2023-01-29,MAX,brawlBall,Super Beach,16,7,23
8075,2023-01-29,MAX,brawlBall,Backyard Bowl,1419,1431,2850
8076,2023-01-29,MAX,bounty,Canal Grande,14,18,32
8077,2023-01-28,MAX,knockout,Flaring Phoenix,28,48,76
8078,2023-01-28,MAX,hotZone,Controller Chaos,43,65,108
8079,2023-01-28,MAX,heist,Bridge Too Far,523,562,1085
8080,2023-01-28,MAX,gemGrab,Hard Rock Mine,193,224,417
8081,2023-01-28,MAX,gemGrab,Deep Diner,58,59,117
8082,2023-01-28,MAX,brawlBall,Super Beach,1025,1108,2133
8083,2023-01-28,MAX,brawlBall,Sneaky Fields,35,44,79
8084,2023-01-28,MAX,bounty,Canal Grande,25,24,49
8085,2023-01-27,MAX,knockout,Flaring Phoenix,23,6,29
8086,2023-01-27,MAX,hotZone,Controller Chaos,14,7,21
8087,2023-01-27,MAX,heist,Hot Potato,13,12,25
8088,2023-01-27,MAX,gemGrab,Undermine,11,16,27
8089,2023-01-27,MAX,gemGrab,Deep Diner,68,66,134
8090,2023-01-27,MAX,brawlBall,Sneaky Fields,248,317,565
8091,2023-01-27,MAX,brawlBall,Pinhole Punt,12,12,24
8092,2023-01-27,MAX,bounty,Temple Ruins,20,19,39
8093,2023-01-26,MAX,knockout,Riverside,117,101,218
8094,2023-01-26,MAX,hotZone,Open Zone,147,157,304
8095,2023-01-26,MAX,heist,Hot Potato,41,33,74
8096,2023-01-26,MAX,gemGrab,Undermine,93,120,213
8097,2023-01-26,MAX,gemGrab,Gem Fort,43,46,89
8098,2023-01-26,MAX,brawlBall,Sunny Soccer,49,53,102
8099,2023-01-26,MAX,brawlBall,Pinhole Punt,1113,1149,2262
8100,2023-01-26,MAX,bounty,Temple Ruins,22,36,58
8101,2023-01-25,MAX,knockout,Riverside,65,66,131
8102,2023-01-25,MAX,hotZone,Open Zone,88,61,149
8103,2023-01-25,MAX,heist,Safe Zone,85,102,187
8104,2023-01-25,MAX,gemGrab,Gem Fort,42,46,88
8105,2023-01-25,MAX,gemGrab,Crystal Arcade,102,123,225
8106,2023-01-25,MAX,brawlBall,Sunny Soccer,488,546,1034
8107,2023-01-25,MAX,brawlBall,Beach Ball,76,123,199
8108,2023-01-25,MAX,bounty,Excel,13,27,40
8109,2023-01-24,MAX,knockout,New Perspective,84,41,125
8110,2023-01-24,MAX,hotZone,Dueling Beetles,46,34,80
8111,2023-01-24,MAX,heist,Safe Zone,207,236,443
8112,2023-01-24,MAX,gemGrab,Minecart Madness,24,35,59
8113,2023-01-24,MAX,gemGrab,Crystal Arcade,152,220,372
8114,2023-01-24,MAX,brawlBall,Center Stage,71,90,161
8115,2023-01-24,MAX,brawlBall,Beach Ball,861,975,1836
8116,2023-01-24,MAX,bounty,Excel,32,34,66
8117,2023-01-23,MAX,knockout,New Perspective,115,85,200
8118,2023-01-23,MAX,hotZone,Dueling Beetles,93,101,194
8119,2023-01-23,MAX,heist,Snaked Assault,91,156,247
8120,2023-01-23,MAX,gemGrab,Minecart Madness,179,236,415
8121,2023-01-23,MAX,gemGrab,Double Swoosh,48,58,106
8122,2023-01-23,MAX,brawlBall,Center Stage,839,937,1776
8123,2023-01-23,MAX,brawlBall,Backyard Bowl,96,90,186
8124,2023-01-23,MAX,bounty,Layer Cake,47,68,115
8125,2023-01-22,MAX,knockout,X Marks the Spot,75,68,143
8126,2023-01-22,MAX,hotZone,Ring of Fire,42,24,66
8127,2023-01-22,MAX,heist,Snaked Assault,48,43,91
8128,2023-01-22,MAX,gemGrab,Hard Rock Mine,44,58,102
8129,2023-01-22,MAX,gemGrab,Double Swoosh,53,65,118
8130,2023-01-22,MAX,brawlBall,Super Beach,123,166,289
8131,2023-01-22,MAX,brawlBall,Backyard Bowl,656,678,1334
8132,2023-01-22,MAX,bounty,Layer Cake,14,28,42
8133,2023-01-21,MAX,knockout,X Marks the Spot,213,176,389
8134,2023-01-21,MAX,hotZone,Ring of Fire,100,61,161
8135,2023-01-21,MAX,heist,Tornado Ring,32,41,73
8136,2023-01-21,MAX,gemGrab,Hard Rock Mine,233,248,481
8137,2023-01-21,MAX,gemGrab,Deep Diner,29,49,78
8138,2023-01-21,MAX,brawlBall,Super Beach,1218,1261,2479
8139,2023-01-21,MAX,brawlBall,Sneaky Fields,41,52,93
8140,2023-01-21,MAX,bounty,Dry Season,80,78,158
8141,2023-01-20,MAX,knockout,Out in the Open,168,152,320
8142,2023-01-20,MAX,hotZone,Split,20,10,30
8143,2023-01-20,MAX,heist,Tornado Ring,45,29,74
8144,2023-01-20,MAX,gemGrab,Undermine,50,50,100
8145,2023-01-20,MAX,gemGrab,Deep Diner,178,132,310
8146,2023-01-20,MAX,brawlBall,Sneaky Fields,640,740,1380
8147,2023-01-20,MAX,brawlBall,Pinhole Punt,29,40,69
8148,2023-01-20,MAX,bounty,Dry Season,75,69,144
8149,2023-01-19,MAX,knockout,Out in the Open,191,110,301
8150,2023-01-19,MAX,hotZone,Split,17,18,35
8151,2023-01-19,MAX,heist,Kaboom Canyon,75,97,172
8152,2023-01-19,MAX,gemGrab,Undermine,86,101,187
8153,2023-01-19,MAX,gemGrab,Gem Fort,25,46,71
8154,2023-01-19,MAX,brawlBall,Sunny Soccer,15,47,62
8155,2023-01-19,MAX,brawlBall,Pinhole Punt,1107,1190,2297
8156,2023-01-19,MAX,bounty,Shooting Star,104,119,223
8157,2023-01-18,MAX,knockout,Goldarm Gulch,10,23,33
8158,2023-01-18,MAX,hotZone,Parallel Plays,4,6,10
8159,2023-01-18,MAX,heist,Kaboom Canyon,37,51,88
8160,2023-01-18,MAX,gemGrab,Gem Fort,9,13,22
8161,2023-01-18,MAX,gemGrab,Crystal Arcade,6,1,7
8162,2023-01-18,MAX,brawlBall,Sunny Soccer,190,215,405
8163,2023-01-18,MAX,brawlBall,Beach Ball,11,18,29
8164,2023-01-18,MAX,bounty,Shooting Star,47,42,89
8165,2023-01-17,MAX,knockout,Goldarm Gulch,9,5,14
8166,2023-01-17,MAX,hotZone,Parallel Plays,1,2,3
8167,2023-01-17,MAX,gemGrab,Minecart Madness,2,3,5
8168,2023-01-17,MAX,gemGrab,Crystal Arcade,13,8,21
8169,2023-01-17,MAX,brawlBall,Center Stage,2,5,7
8170,2023-01-17,MAX,brawlBall,Beach Ball,42,64,106
8171,2023-01-17,MAX,bounty,Hideout,9,9,18
8172,2023-01-16,MAX,knockout,Belle's Rock,14,9,23
8173,2023-01-16,MAX,hotZone,Quarter Pounder,8,7,15
8174,2023-01-16,MAX,heist,Pit Stop,13,6,19
8175,2023-01-16,MAX,gemGrab,Minecart Madness,20,14,34
8176,2023-01-16,MAX,gemGrab,Double Swoosh,8,3,11
8177,2023-01-16,MAX,brawlBall,Center Stage,41,66,107
8178,2023-01-16,MAX,brawlBall,Backyard Bowl,19,8,27
8179,2023-01-16,MAX,bounty,Hideout,19,12,31
8180,2023-01-15,MAX,knockout,Belle's Rock,30,21,51
8181,2023-01-15,MAX,hotZone,Quarter Pounder,15,33,48
8182,2023-01-15,MAX,heist,Bridge Too Far,50,53,103
8183,2023-01-15,MAX,gemGrab,Hard Rock Mine,14,20,34
8184,2023-01-15,MAX,gemGrab,Double Swoosh,15,28,43
8185,2023-01-15,MAX,brawlBall,Super Beach,16,11,27
8186,2023-01-15,MAX,brawlBall,Backyard Bowl,186,243,429
8187,2023-01-15,MAX,bounty,Canal Grande,0,3,3
8188,2023-01-14,MAX,knockout,Flaring Phoenix,6,2,8
8189,2023-01-14,MAX,hotZone,Controller Chaos,9,1,10
8190,2023-01-14,MAX,heist,Bridge Too Far,91,52,143
8191,2023-01-14,MAX,gemGrab,Hard Rock Mine,19,15,34
8192,2023-01-14,MAX,gemGrab,Deep Diner,8,22,30
8193,2023-01-14,MAX,brawlBall,Super Beach,98,153,251
8194,2023-01-14,MAX,brawlBall,Sneaky Fields,17,17,34
8195,2023-01-13,MAX,knockout,Flaring Phoenix,7,4,11
8196,2023-01-13,MAX,hotZone,Controller Chaos,4,1,5
8197,2023-01-13,MAX,heist,Hot Potato,1,2,3
8198,2023-01-13,MAX,gemGrab,Deep Diner,19,20,39
8199,2023-01-13,MAX,brawlBall,Sneaky Fields,88,76,164
8200,2023-01-13,MAX,brawlBall,Pinhole Punt,1,2,3
8201,2023-01-13,MAX,bounty,Temple Ruins,3,2,5
8202,2023-01-12,MAX,knockout,Riverside,17,16,33
8203,2023-01-12,MAX,hotZone,Open Zone,23,13,36
8204,2023-01-12,MAX,heist,Hot Potato,0,1,1
8205,2023-01-12,MAX,gemGrab,Undermine,3,2,5
8206,2023-01-12,MAX,gemGrab,Gem Fort,1,0,1
8207,2023-01-12,MAX,brawlBall,Sunny Soccer,1,1,2
8208,2023-01-12,MAX,brawlBall,Pinhole Punt,54,75,129
8209,2023-01-12,MAX,bounty,Temple Ruins,1,0,1
8210,2023-01-11,MAX,knockout,Riverside,2,1,3
8211,2023-01-11,MAX,hotZone,Open Zone,8,1,9
8212,2023-01-11,MAX,gemGrab,Gem Fort,3,1,4
8213,2023-01-11,MAX,brawlBall,Sunny Soccer,26,31,57
8214,2023-01-11,MAX,bounty,Excel,1,0,1
8215,2023-01-10,MAX,knockout,New Perspective,4,1,5
8216,2023-01-10,MAX,hotZone,Dueling Beetles,13,29,42
8217,2023-01-10,MAX,heist,Safe Zone,9,11,20
8218,2023-01-10,MAX,gemGrab,Minecart Madness,8,1,9
8219,2023-01-10,MAX,gemGrab,Crystal Arcade,23,27,50
8220,2023-01-10,MAX,brawlBall,Center Stage,3,0,3
8221,2023-01-10,MAX,brawlBall,Beach Ball,52,62,114
8222,2023-01-10,MAX,bounty,Excel,3,0,3
8223,2023-01-09,MAX,knockout,New Perspective,2,4,6
8224,2023-01-09,MAX,hotZone,Dueling Beetles,7,4,11
8225,2023-01-09,MAX,heist,Snaked Assault,25,18,43
8226,2023-01-09,MAX,gemGrab,Minecart Madness,21,14,35
8227,2023-01-09,MAX,gemGrab,Double Swoosh,10,12,22
8228,2023-01-09,MAX,brawlBall,Center Stage,55,70,125
8229,2023-01-09,MAX,brawlBall,Backyard Bowl,11,12,23
8230,2023-01-09,MAX,bounty,Layer Cake,12,19,31
8231,2023-01-08,MAX,knockout,X Marks the Spot,14,6,20
8232,2023-01-08,MAX,hotZone,Ring of Fire,19,7,26
8233,2023-01-08,MAX,heist,Snaked Assault,6,7,13
8234,2023-01-08,MAX,gemGrab,Hard Rock Mine,8,5,13
8235,2023-01-08,MAX,gemGrab,Double Swoosh,8,9,17
8236,2023-01-08,MAX,brawlBall,Super Beach,14,26,40
8237,2023-01-08,MAX,brawlBall,Backyard Bowl,171,190,361
8238,2023-01-08,MAX,bounty,Layer Cake,1,0,1
8239,2023-01-07,MAX,knockout,X Marks the Spot,9,8,17
8240,2023-01-07,MAX,hotZone,Ring of Fire,3,3,6
8241,2023-01-07,MAX,heist,Tornado Ring,7,0,7
8242,2023-01-07,MAX,gemGrab,Hard Rock Mine,13,11,24
8243,2023-01-07,MAX,gemGrab,Deep Diner,13,13,26
8244,2023-01-07,MAX,brawlBall,Super Beach,50,89,139
8245,2023-01-07,MAX,brawlBall,Sneaky Fields,4,4,8
8246,2023-01-07,MAX,bounty,Dry Season,10,8,18
8247,2023-01-06,MAX,knockout,Out in the Open,15,8,23
8248,2023-01-06,MAX,hotZone,Split,3,0,3
8249,2023-01-06,MAX,heist,Tornado Ring,8,9,17
8250,2023-01-06,MAX,gemGrab,Undermine,8,20,28
8251,2023-01-06,MAX,gemGrab,Deep Diner,12,31,43
8252,2023-01-06,MAX,brawlBall,Sneaky Fields,53,99,152
8253,2023-01-06,MAX,brawlBall,Pinhole Punt,9,14,23
8254,2023-01-06,MAX,bounty,Dry Season,25,23,48
8255,2023-01-05,MAX,knockout,Out in the Open,33,38,71
8256,2023-01-05,MAX,hotZone,Split,3,0,3
8257,2023-01-05,MAX,heist,Kaboom Canyon,12,34,46
8258,2023-01-05,MAX,gemGrab,Undermine,17,34,51
8259,2023-01-05,MAX,gemGrab,Gem Fort,4,0,4
8260,2023-01-05,MAX,brawlBall,Sunny Soccer,2,0,2
8261,2023-01-05,MAX,brawlBall,Pinhole Punt,151,130,281
8262,2023-01-05,MAX,bounty,Shooting Star,18,13,31
8263,2023-01-04,MAX,knockout,Goldarm Gulch,6,8,14
8264,2023-01-04,MAX,hotZone,Parallel Plays,7,2,9
8265,2023-01-04,MAX,heist,Kaboom Canyon,17,11,28
8266,2023-01-04,MAX,gemGrab,Gem Fort,11,14,25
8267,2023-01-04,MAX,gemGrab,Crystal Arcade,4,1,5
8268,2023-01-04,MAX,brawlBall,Sunny Soccer,90,67,157
8269,2023-01-04,MAX,brawlBall,Beach Ball,1,3,4
8270,2023-01-04,MAX,bounty,Shooting Star,51,23,74
8271,2023-01-03,MAX,knockout,Goldarm Gulch,3,2,5
8272,2023-01-03,MAX,hotZone,Parallel Plays,4,0,4
8273,2023-01-03,MAX,heist,Pit Stop,1,2,3
8274,2023-01-03,MAX,gemGrab,Minecart Madness,6,2,8
8275,2023-01-03,MAX,gemGrab,Crystal Arcade,17,22,39
8276,2023-01-03,MAX,brawlBall,Center Stage,5,0,5
8277,2023-01-03,MAX,brawlBall,Beach Ball,74,87,161
8278,2023-01-03,MAX,bounty,Hideout,35,38,73
8279,2023-01-02,MAX,knockout,Belle's Rock,20,28,48
8280,2023-01-02,MAX,hotZone,Quarter Pounder,28,58,86
8281,2023-01-02,MAX,heist,Pit Stop,5,0,5
8282,2023-01-02,MAX,heist,Kaboom Canyon,1,0,1
8283,2023-01-02,MAX,gemGrab,Minecart Madness,30,33,63
8284,2023-01-02,MAX,gemGrab,Double Swoosh,10,12,22
8285,2023-01-02,MAX,brawlBall,Center Stage,58,61,119
8286,2023-01-02,MAX,brawlBall,Backyard Bowl,10,9,19
8287,2023-01-02,MAX,bounty,Hideout,29,27,56
8288,2023-01-01,MAX,knockout,Belle's Rock,5,5,10
8289,2023-01-01,MAX,hotZone,Quarter Pounder,5,5,10
8290,2023-01-01,MAX,heist,Bridge Too Far,7,10,17
8291,2023-01-01,MAX,gemGrab,Hard Rock Mine,4,3,7
8292,2023-01-01,MAX,gemGrab,Double Swoosh,20,3,23
8293,2023-01-01,MAX,brawlBall,Backyard Bowl,86,86,172
8294,2023-01-01,MAX,bounty,Canal Grande,1,3,4
8295,2022-12-31,MAX,heist,Kaboom Canyon,1,0,1
8296,2022-12-31,MAX,heist,Bridge Too Far,4,2,6
8297,2022-12-31,MAX,gemGrab,Hard Rock Mine,7,4,11
8298,2022-12-31,MAX,brawlBall,Super Beach,10,22,32
8299,2022-12-31,MAX,brawlBall,Sneaky Fields,4,7,11
8300,2022-12-30,MAX,knockout,Flaring Phoenix,1,0,1
8301,2022-12-30,MAX,hotZone,Controller Chaos,6,4,10
8302,2022-12-30,MAX,gemGrab,Minecart Madness,2,0,2
8303,2022-12-30,MAX,gemGrab,Deep Diner,6,6,12
8304,2022-12-30,MAX,brawlBall,Sneaky Fields,7,5,12
8305,2022-12-29,MAX,heist,Kaboom Canyon,0,1,1
8306,2022-12-29,MAX,gemGrab,Undermine,2,0,2
8307,2022-12-29,MAX,gemGrab,Minecart Madness,1,0,1
8308,2022-12-29,MAX,brawlBall,Pinhole Punt,5,4,9
8309,2022-12-28,MAX,hotZone,Open Zone,1,1,2
8310,2022-12-28,MAX,brawlBall,Sunny Soccer,1,2,3
8311,2022-12-27,MAX,brawlBall,Center Stage,1,0,1
8312,2022-12-27,MAX,brawlBall,Beach Ball,5,2,7
8313,2022-12-26,MAX,hotZone,Controller Chaos,1,0,1
8314,2022-12-26,MAX,gemGrab,Minecart Madness,0,1,1
8315,2022-12-26,MAX,brawlBall,Center Stage,0,2,2
8316,2022-12-25,MAX,brawlBall,Backyard Bowl,1,1,2
8317,2022-12-24,MAX,brawlBall,Super Beach,3,0,3
8318,2022-12-23,MAX,knockout,Out in the Open,2,0,2
8319,2022-12-23,MAX,brawlBall,Sneaky Fields,2,0,2
8320,2022-12-22,MAX,gemGrab,Gem Fort,2,0,2
8321,2022-12-22,MAX,brawlBall,Pinhole Punt,4,1,5
8322,2022-12-20,MAX,brawlBall,Beach Ball,2,0,2
8323,2022-12-19,MAX,brawlBall,Center Stage,1,0,1
8324,2022-12-13,MAX,knockout,New Perspective,2,0,2
8325,2022-12-13,MAX,gemGrab,Crystal Arcade,1,0,1
8326,2022-12-13,MAX,brawlBall,Beach Ball,0,2,2
8327,2022-11-11,MAX,brawlBall,Sneaky Fields,0,2,2
8328,2022-11-03,MAX,brawlBall,Pinhole Punt,0,2,2
8329,2022-11-01,MAX,knockout,New Perspective,0,2,2
8330,2022-10-30,MAX,hotZone,Dueling Beetles,1,0,1
8331,2022-10-15,MAX,gemGrab,Hard Rock Mine,1,0,1
8332,2022-10-15,MAX,bounty,Dry Season,2,0,2
8333,2023-02-11,MANDY,knockout,Flaring Phoenix,253,326,579
8334,2023-02-11,MANDY,hotZone,Controller Chaos,9,7,16
8335,2023-02-11,MANDY,gemGrab,Deep Diner,62,95,157
8336,2023-02-11,MANDY,brawlBall,Super Beach,65,83,148
8337,2023-02-11,MANDY,brawlBall,Sneaky Fields,24,38,62
8338,2023-02-10,MANDY,knockout,Flaring Phoenix,595,813,1408
8339,2023-02-10,MANDY,hotZone,Controller Chaos,38,61,99
8340,2023-02-10,MANDY,heist,Hot Potato,42,42,84
8341,2023-02-10,MANDY,gemGrab,Undermine,59,67,126
8342,2023-02-10,MANDY,gemGrab,Deep Diner,146,174,320
8343,2023-02-10,MANDY,brawlBall,Sneaky Fields,357,402,759
8344,2023-02-10,MANDY,brawlBall,Pinhole Punt,5,10,15
8345,2023-02-10,MANDY,bounty,Temple Ruins,112,176,288
8346,2023-02-09,MANDY,knockout,Riverside,136,153,289
8347,2023-02-09,MANDY,hotZone,Open Zone,12,7,19
8348,2023-02-09,MANDY,heist,Hot Potato,15,15,30
8349,2023-02-09,MANDY,gemGrab,Undermine,35,46,81
8350,2023-02-09,MANDY,gemGrab,Gem Fort,5,9,14
8351,2023-02-09,MANDY,brawlBall,Sunny Soccer,1,0,1
8352,2023-02-09,MANDY,brawlBall,Pinhole Punt,176,212,388
8353,2023-02-09,MANDY,bounty,Temple Ruins,62,89,151
8354,2023-02-08,MANDY,knockout,Riverside,74,71,145
8355,2023-02-08,MANDY,hotZone,Open Zone,9,13,22
8356,2023-02-08,MANDY,heist,Safe Zone,21,20,41
8357,2023-02-08,MANDY,gemGrab,Gem Fort,7,14,21
8358,2023-02-08,MANDY,gemGrab,Crystal Arcade,5,14,19
8359,2023-02-08,MANDY,brawlBall,Sunny Soccer,47,51,98
8360,2023-02-08,MANDY,brawlBall,Beach Ball,7,4,11
8361,2023-02-08,MANDY,bounty,Excel,17,52,69
8362,2023-02-07,MANDY,knockout,New Perspective,11,32,43
8363,2023-02-07,MANDY,hotZone,Dueling Beetles,10,6,16
8364,2023-02-07,MANDY,heist,Safe Zone,8,5,13
8365,2023-02-07,MANDY,gemGrab,Minecart Madness,11,29,40
8366,2023-02-07,MANDY,gemGrab,Crystal Arcade,18,21,39
8367,2023-02-07,MANDY,brawlBall,Beach Ball,27,32,59
8368,2023-02-07,MANDY,bounty,Excel,13,20,33
8369,2023-02-06,MANDY,knockout,New Perspective,617,869,1486
8370,2023-02-06,MANDY,knockout,Goldarm Gulch,8,20,28
8371,2023-02-06,MANDY,hotZone,Dueling Beetles,90,122,212
8372,2023-02-06,MANDY,heist,Snaked Assault,34,67,101
8373,2023-02-06,MANDY,heist,Pit Stop,2,0,2
8374,2023-02-06,MANDY,gemGrab,Minecart Madness,282,448,730
8375,2023-02-06,MANDY,gemGrab,Double Swoosh,56,52,108
8376,2023-02-06,MANDY,brawlBall,Center Stage,596,717,1313
8377,2023-02-06,MANDY,brawlBall,Backyard Bowl,88,129,217
8378,2023-02-06,MANDY,bounty,Layer Cake,136,184,320
8379,2023-02-05,MANDY,knockout,X Marks the Spot,409,637,1046
8380,2023-02-05,MANDY,knockout,Goldarm Gulch,86,73,159
8381,2023-02-05,MANDY,hotZone,Ring of Fire,99,117,216
8382,2023-02-05,MANDY,heist,Snaked Assault,50,65,115
8383,2023-02-05,MANDY,heist,Pit Stop,7,0,7
8384,2023-02-05,MANDY,gemGrab,Hard Rock Mine,36,38,74
8385,2023-02-05,MANDY,gemGrab,Double Swoosh,175,193,368
8386,2023-02-05,MANDY,brawlBall,Super Beach,19,18,37
8387,2023-02-05,MANDY,brawlBall,Sneaky Fields,5,4,9
8388,2023-02-05,MANDY,brawlBall,Backyard Bowl,1503,1930,3433
8389,2023-02-05,MANDY,bounty,Layer Cake,134,210,344
8390,2023-02-04,MANDY,knockout,X Marks the Spot,186,276,462
8391,2023-02-04,MANDY,knockout,Goldarm Gulch,55,44,99
8392,2023-02-04,MANDY,hotZone,Ring of Fire,22,21,43
8393,2023-02-04,MANDY,heist,Tornado Ring,2,1,3
8394,2023-02-04,MANDY,heist,Pit Stop,1,2,3
8395,2023-02-04,MANDY,gemGrab,Hard Rock Mine,27,44,71
8396,2023-02-04,MANDY,gemGrab,Double Swoosh,5,10,15
8397,2023-02-04,MANDY,gemGrab,Deep Diner,3,2,5
8398,2023-02-04,MANDY,brawlBall,Super Beach,158,261,419
8399,2023-02-04,MANDY,brawlBall,Sneaky Fields,2,8,10
8400,2023-02-04,MANDY,bounty,Dry Season,55,108,163
8401,2023-02-03,MANDY,knockout,Out in the Open,689,932,1621
8402,2023-02-03,MANDY,knockout,Goldarm Gulch,285,305,590
8403,2023-02-03,MANDY,hotZone,Split,30,47,77
8404,2023-02-03,MANDY,heist,Tornado Ring,37,25,62
8405,2023-02-03,MANDY,heist,Pit Stop,11,13,24
8406,2023-02-03,MANDY,gemGrab,Undermine,28,33,61
8407,2023-02-03,MANDY,gemGrab,Double Swoosh,35,51,86
8408,2023-02-03,MANDY,gemGrab,Deep Diner,147,193,340
8409,2023-02-03,MANDY,brawlBall,Sneaky Fields,443,627,1070
8410,2023-02-03,MANDY,brawlBall,Pinhole Punt,27,33,60
8411,2023-02-03,MANDY,bounty,Dry Season,506,756,1262
8412,2023-02-02,MANDY,knockout,Out in the Open,309,421,730
8413,2023-02-02,MANDY,hotZone,Split,18,22,40
8414,2023-02-02,MANDY,heist,Kaboom Canyon,32,23,55
8415,2023-02-02,MANDY,gemGrab,Undermine,21,29,50
8416,2023-02-02,MANDY,gemGrab,Gem Fort,18,15,33
8417,2023-02-02,MANDY,brawlBall,Sunny Soccer,1,1,2
8418,2023-02-02,MANDY,brawlBall,Pinhole Punt,231,296,527
8419,2023-02-02,MANDY,bounty,Shooting Star,111,141,252
8420,2023-02-01,MANDY,knockout,Goldarm Gulch,677,859,1536
8421,2023-02-01,MANDY,hotZone,Parallel Plays,64,96,160
8422,2023-02-01,MANDY,heist,Kaboom Canyon,70,71,141
8423,2023-02-01,MANDY,gemGrab,Gem Fort,112,138,250
8424,2023-02-01,MANDY,gemGrab,Crystal Arcade,85,105,190
8425,2023-02-01,MANDY,brawlBall,Sunny Soccer,466,627,1093
8426,2023-02-01,MANDY,brawlBall,Beach Ball,9,19,28
8427,2023-02-01,MANDY,bounty,Shooting Star,239,332,571
8428,2023-01-31,MANDY,knockout,Goldarm Gulch,390,468,858
8429,2023-01-31,MANDY,hotZone,Parallel Plays,30,41,71
8430,2023-01-31,MANDY,heist,Pit Stop,12,14,26
8431,2023-01-31,MANDY,gemGrab,Minecart Madness,14,29,43
8432,2023-01-31,MANDY,gemGrab,Crystal Arcade,66,94,160
8433,2023-01-31,MANDY,brawlBall,Center Stage,22,19,41
8434,2023-01-31,MANDY,brawlBall,Beach Ball,318,418,736
8435,2023-01-31,MANDY,bounty,Hideout,75,114,189
8436,2023-01-30,MANDY,knockout,Belle's Rock,569,843,1412
8437,2023-01-30,MANDY,hotZone,Quarter Pounder,55,64,119
8438,2023-01-30,MANDY,heist,Pit Stop,7,13,20
8439,2023-01-30,MANDY,gemGrab,Minecart Madness,205,341,546
8440,2023-01-30,MANDY,gemGrab,Double Swoosh,66,65,131
8441,2023-01-30,MANDY,brawlBall,Center Stage,403,481,884
8442,2023-01-30,MANDY,brawlBall,Backyard Bowl,80,154,234
8443,2023-01-30,MANDY,bounty,Hideout,137,196,333
8444,2023-01-29,MANDY,knockout,Belle's Rock,659,946,1605
8445,2023-01-29,MANDY,hotZone,Quarter Pounder,59,56,115
8446,2023-01-29,MANDY,heist,Bridge Too Far,287,368,655
8447,2023-01-29,MANDY,gemGrab,Hard Rock Mine,19,35,54
8448,2023-01-29,MANDY,gemGrab,Double Swoosh,151,178,329
8449,2023-01-29,MANDY,brawlBall,Super Beach,10,11,21
8450,2023-01-29,MANDY,brawlBall,Backyard Bowl,1151,1666,2817
8451,2023-01-29,MANDY,bounty,Canal Grande,63,81,144
8452,2023-01-28,MANDY,knockout,Flaring Phoenix,368,509,877
8453,2023-01-28,MANDY,hotZone,Controller Chaos,37,51,88
8454,2023-01-28,MANDY,heist,Bridge Too Far,632,672,1304
8455,2023-01-28,MANDY,gemGrab,Hard Rock Mine,139,146,285
8456,2023-01-28,MANDY,gemGrab,Deep Diner,42,55,97
8457,2023-01-28,MANDY,brawlBall,Super Beach,581,844,1425
8458,2023-01-28,MANDY,brawlBall,Sneaky Fields,23,35,58
8459,2023-01-28,MANDY,bounty,Canal Grande,104,160,264
8460,2023-01-27,MANDY,knockout,Flaring Phoenix,172,231,403
8461,2023-01-27,MANDY,hotZone,Controller Chaos,18,10,28
8462,2023-01-27,MANDY,heist,Hot Potato,16,21,37
8463,2023-01-27,MANDY,gemGrab,Undermine,7,7,14
8464,2023-01-27,MANDY,gemGrab,Deep Diner,68,122,190
8465,2023-01-27,MANDY,brawlBall,Sneaky Fields,120,185,305
8466,2023-01-27,MANDY,brawlBall,Pinhole Punt,4,3,7
8467,2023-01-27,MANDY,bounty,Temple Ruins,19,41,60
8468,2023-01-26,MANDY,knockout,Riverside,667,1028,1695
8469,2023-01-26,MANDY,hotZone,Open Zone,98,155,253
8470,2023-01-26,MANDY,heist,Hot Potato,54,67,121
8471,2023-01-26,MANDY,gemGrab,Undermine,76,137,213
8472,2023-01-26,MANDY,gemGrab,Gem Fort,33,37,70
8473,2023-01-26,MANDY,brawlBall,Sunny Soccer,4,12,16
8474,2023-01-26,MANDY,brawlBall,Pinhole Punt,635,1065,1700
8475,2023-01-26,MANDY,bounty,Temple Ruins,63,106,169
8476,2023-01-25,MANDY,knockout,Riverside,411,604,1015
8477,2023-01-25,MANDY,hotZone,Open Zone,42,59,101
8478,2023-01-25,MANDY,heist,Safe Zone,117,131,248
8479,2023-01-25,MANDY,gemGrab,Gem Fort,63,65,128
8480,2023-01-25,MANDY,gemGrab,Crystal Arcade,59,90,149
8481,2023-01-25,MANDY,brawlBall,Sunny Soccer,338,516,854
8482,2023-01-25,MANDY,brawlBall,Beach Ball,34,43,77
8483,2023-01-25,MANDY,bounty,Excel,54,83,137
8484,2023-01-24,MANDY,knockout,New Perspective,277,463,740
8485,2023-01-24,MANDY,hotZone,Dueling Beetles,43,46,89
8486,2023-01-24,MANDY,heist,Safe Zone,248,234,482
8487,2023-01-24,MANDY,gemGrab,Minecart Madness,87,108,195
8488,2023-01-24,MANDY,gemGrab,Crystal Arcade,178,255,433
8489,2023-01-24,MANDY,brawlBall,Center Stage,27,72,99
8490,2023-01-24,MANDY,brawlBall,Beach Ball,474,781,1255
8491,2023-01-24,MANDY,bounty,Excel,92,169,261
8492,2023-01-23,MANDY,knockout,New Perspective,532,725,1257
8493,2023-01-23,MANDY,hotZone,Dueling Beetles,78,110,188
8494,2023-01-23,MANDY,heist,Snaked Assault,43,51,94
8495,2023-01-23,MANDY,gemGrab,Minecart Madness,315,450,765
8496,2023-01-23,MANDY,gemGrab,Double Swoosh,51,89,140
8497,2023-01-23,MANDY,brawlBall,Center Stage,665,971,1636
8498,2023-01-23,MANDY,brawlBall,Backyard Bowl,65,85,150
8499,2023-01-23,MANDY,bounty,Layer Cake,114,161,275
8500,2023-01-22,MANDY,knockout,X Marks the Spot,295,396,691
8501,2023-01-22,MANDY,hotZone,Ring of Fire,28,40,68
8502,2023-01-22,MANDY,heist,Snaked Assault,21,31,52
8503,2023-01-22,MANDY,gemGrab,Hard Rock Mine,63,102,165
8504,2023-01-22,MANDY,gemGrab,Double Swoosh,86,122,208
8505,2023-01-22,MANDY,brawlBall,Super Beach,49,63,112
8506,2023-01-22,MANDY,brawlBall,Backyard Bowl,592,868,1460
8507,2023-01-22,MANDY,bounty,Layer Cake,63,105,168
8508,2023-01-21,MANDY,knockout,X Marks the Spot,890,1266,2156
8509,2023-01-21,MANDY,hotZone,Ring of Fire,103,97,200
8510,2023-01-21,MANDY,heist,Tornado Ring,33,37,70
8511,2023-01-21,MANDY,gemGrab,Hard Rock Mine,203,308,511
8512,2023-01-21,MANDY,gemGrab,Deep Diner,68,79,147
8513,2023-01-21,MANDY,brawlBall,Super Beach,701,1253,1954
8514,2023-01-21,MANDY,brawlBall,Sneaky Fields,14,29,43
8515,2023-01-21,MANDY,bounty,Dry Season,283,416,699
8516,2023-01-20,MANDY,knockout,Out in the Open,668,913,1581
8517,2023-01-20,MANDY,hotZone,Split,26,39,65
8518,2023-01-20,MANDY,heist,Tornado Ring,53,51,104
8519,2023-01-20,MANDY,gemGrab,Undermine,62,103,165
8520,2023-01-20,MANDY,gemGrab,Deep Diner,223,368,591
8521,2023-01-20,MANDY,brawlBall,Sneaky Fields,467,687,1154
8522,2023-01-20,MANDY,brawlBall,Pinhole Punt,29,26,55
8523,2023-01-20,MANDY,bounty,Dry Season,321,505,826
8524,2023-01-19,MANDY,knockout,Out in the Open,680,1009,1689
8525,2023-01-19,MANDY,hotZone,Split,37,57,94
8526,2023-01-19,MANDY,heist,Kaboom Canyon,69,128,197
8527,2023-01-19,MANDY,gemGrab,Undermine,132,198,330
8528,2023-01-19,MANDY,gemGrab,Gem Fort,13,30,43
8529,2023-01-19,MANDY,brawlBall,Sunny Soccer,16,40,56
8530,2023-01-19,MANDY,brawlBall,Pinhole Punt,749,1073,1822
8531,2023-01-19,MANDY,bounty,Shooting Star,238,412,650
8532,2023-01-18,MANDY,knockout,Goldarm Gulch,70,136,206
8533,2023-01-18,MANDY,hotZone,Parallel Plays,6,5,11
8534,2023-01-18,MANDY,heist,Kaboom Canyon,35,65,100
8535,2023-01-18,MANDY,gemGrab,Gem Fort,44,48,92
8536,2023-01-18,MANDY,gemGrab,Crystal Arcade,7,3,10
8537,2023-01-18,MANDY,brawlBall,Sunny Soccer,218,336,554
8538,2023-01-18,MANDY,brawlBall,Beach Ball,12,10,22
8539,2023-01-18,MANDY,bounty,Shooting Star,186,243,429
8540,2023-01-17,MANDY,knockout,Goldarm Gulch,60,84,144
8541,2023-01-17,MANDY,hotZone,Parallel Plays,12,6,18
8542,2023-01-17,MANDY,heist,Pit Stop,2,4,6
8543,2023-01-17,MANDY,gemGrab,Minecart Madness,6,6,12
8544,2023-01-17,MANDY,gemGrab,Crystal Arcade,10,16,26
8545,2023-01-17,MANDY,brawlBall,Center Stage,1,0,1
8546,2023-01-17,MANDY,brawlBall,Beach Ball,41,103,144
8547,2023-01-17,MANDY,bounty,Hideout,12,11,23
8548,2023-01-16,MANDY,knockout,Belle's Rock,40,71,111
8549,2023-01-16,MANDY,hotZone,Quarter Pounder,9,8,17
8550,2023-01-16,MANDY,heist,Pit Stop,2,0,2
8551,2023-01-16,MANDY,gemGrab,Minecart Madness,20,40,60
8552,2023-01-16,MANDY,gemGrab,Double Swoosh,1,0,1
8553,2023-01-16,MANDY,brawlBall,Center Stage,54,60,114
8554,2023-01-16,MANDY,brawlBall,Backyard Bowl,9,44,53
8555,2023-01-16,MANDY,bounty,Hideout,29,75,104
8556,2023-01-15,MANDY,knockout,Belle's Rock,71,126,197
8557,2023-01-15,MANDY,hotZone,Quarter Pounder,17,21,38
8558,2023-01-15,MANDY,heist,Bridge Too Far,56,68,124
8559,2023-01-15,MANDY,gemGrab,Hard Rock Mine,7,26,33
8560,2023-01-15,MANDY,gemGrab,Double Swoosh,11,13,24
8561,2023-01-15,MANDY,brawlBall,Super Beach,5,4,9
8562,2023-01-15,MANDY,brawlBall,Backyard Bowl,103,222,325
8563,2023-01-15,MANDY,bounty,Canal Grande,4,24,28
8564,2023-01-14,MANDY,knockout,Flaring Phoenix,20,40,60
8565,2023-01-14,MANDY,hotZone,Controller Chaos,16,18,34
8566,2023-01-14,MANDY,heist,Bridge Too Far,76,148,224
8567,2023-01-14,MANDY,gemGrab,Hard Rock Mine,5,11,16
8568,2023-01-14,MANDY,gemGrab,Deep Diner,13,24,37
8569,2023-01-14,MANDY,brawlBall,Super Beach,63,196,259
8570,2023-01-14,MANDY,brawlBall,Sneaky Fields,3,1,4
8571,2023-01-14,MANDY,bounty,Canal Grande,3,8,11
8572,2023-01-13,MANDY,knockout,Flaring Phoenix,31,86,117
8573,2023-01-13,MANDY,hotZone,Controller Chaos,1,1,2
8574,2023-01-13,MANDY,gemGrab,Undermine,1,1,2
8575,2023-01-13,MANDY,gemGrab,Deep Diner,12,14,26
8576,2023-01-13,MANDY,brawlBall,Sneaky Fields,39,93,132
8577,2023-01-13,MANDY,bounty,Temple Ruins,1,1,2
8578,2023-01-12,MANDY,knockout,Riverside,44,106,150
8579,2023-01-12,MANDY,hotZone,Open Zone,11,25,36
8580,2023-01-12,MANDY,gemGrab,Undermine,8,2,10
8581,2023-01-12,MANDY,brawlBall,Sunny Soccer,3,11,14
8582,2023-01-12,MANDY,brawlBall,Pinhole Punt,7,4,11
8583,2023-01-11,MANDY,knockout,Riverside,8,7,15
8584,2023-01-11,MANDY,hotZone,Open Zone,0,1,1
8585,2023-01-11,MANDY,gemGrab,Gem Fort,2,7,9
8586,2023-01-11,MANDY,brawlBall,Sunny Soccer,4,10,14
8587,2023-01-10,MANDY,knockout,New Perspective,3,9,12
8588,2023-01-10,MANDY,hotZone,Dueling Beetles,8,17,25
8589,2023-01-10,MANDY,heist,Safe Zone,1,0,1
8590,2023-01-10,MANDY,gemGrab,Minecart Madness,5,30,35
8591,2023-01-10,MANDY,gemGrab,Crystal Arcade,12,26,38
8592,2023-01-10,MANDY,brawlBall,Beach Ball,28,48,76
8593,2023-01-09,MANDY,knockout,New Perspective,4,9,13
8594,2023-01-09,MANDY,hotZone,Dueling Beetles,9,20,29
8595,2023-01-09,MANDY,gemGrab,Minecart Madness,8,25,33
8596,2023-01-09,MANDY,gemGrab,Double Swoosh,3,7,10
8597,2023-01-09,MANDY,brawlBall,Center Stage,9,24,33
8598,2023-01-09,MANDY,brawlBall,Backyard Bowl,2,1,3
8599,2023-01-09,MANDY,bounty,Layer Cake,3,5,8
8600,2023-01-08,MANDY,knockout,X Marks the Spot,8,3,11
8601,2023-01-08,MANDY,hotZone,Ring of Fire,0,9,9
8602,2023-01-08,MANDY,heist,Snaked Assault,5,17,22
8603,2023-01-08,MANDY,gemGrab,Hard Rock Mine,0,2,2
8604,2023-01-08,MANDY,brawlBall,Super Beach,3,0,3
8605,2023-01-08,MANDY,brawlBall,Backyard Bowl,7,10,17
8606,2023-01-08,MANDY,bounty,Layer Cake,0,1,1
8607,2023-01-07,MANDY,knockout,X Marks the Spot,4,10,14
8608,2023-01-07,MANDY,heist,Tornado Ring,1,0,1
8609,2023-01-07,MANDY,brawlBall,Super Beach,3,8,11
8610,2023-01-07,MANDY,bounty,Dry Season,3,15,18
8611,2023-01-06,MANDY,knockout,Out in the Open,3,16,19
8612,2023-01-06,MANDY,heist,Tornado Ring,4,11,15
8613,2023-01-06,MANDY,gemGrab,Deep Diner,1,2,3
8614,2023-01-06,MANDY,brawlBall,Sneaky Fields,27,51,78
8615,2023-01-06,MANDY,brawlBall,Pinhole Punt,2,5,7
8616,2023-01-06,MANDY,bounty,Dry Season,15,32,47
8617,2023-01-05,MANDY,knockout,Out in the Open,45,88,133
8618,2023-01-05,MANDY,heist,Kaboom Canyon,2,2,4
8619,2023-01-05,MANDY,brawlBall,Pinhole Punt,49,126,175
8620,2023-01-05,MANDY,bounty,Shooting Star,10,8,18
8621,2023-01-04,MANDY,knockout,Goldarm Gulch,6,30,36
8622,2023-01-04,MANDY,hotZone,Parallel Plays,1,20,21
8623,2023-01-04,MANDY,heist,Kaboom Canyon,1,17,18
8624,2023-01-04,MANDY,gemGrab,Gem Fort,2,1,3
8625,2023-01-04,MANDY,gemGrab,Crystal Arcade,0,2,2
8626,2023-01-04,MANDY,brawlBall,Sunny Soccer,36,95,131
8627,2023-01-04,MANDY,bounty,Shooting Star,18,54,72
8628,2023-01-03,MANDY,knockout,Goldarm Gulch,11,22,33
8629,2023-01-03,MANDY,hotZone,Parallel Plays,3,13,16
8630,2023-01-03,MANDY,heist,Pit Stop,2,0,2
8631,2023-01-03,MANDY,gemGrab,Minecart Madness,11,34,45
8632,2023-01-03,MANDY,gemGrab,Crystal Arcade,11,45,56
8633,2023-01-03,MANDY,brawlBall,Center Stage,4,21,25
8634,2023-01-03,MANDY,brawlBall,Beach Ball,47,151,198
8635,2023-01-03,MANDY,bounty,Hideout,13,37,50
8636,2023-01-02,MANDY,knockout,Belle's Rock,8,49,57
8637,2023-01-02,MANDY,hotZone,Quarter Pounder,0,1,1
8638,2023-01-02,MANDY,heist,Pit Stop,1,0,1
8639,2023-01-02,MANDY,gemGrab,Minecart Madness,40,133,173
8640,2023-01-02,MANDY,brawlBall,Center Stage,91,283,374
8641,2023-01-02,MANDY,bounty,Hideout,25,83,108
8642,2023-02-11,LOU,knockout,Flaring Phoenix,3,9,12
8643,2023-02-11,LOU,hotZone,Controller Chaos,101,243,344
8644,2023-02-11,LOU,gemGrab,Deep Diner,14,15,29
8645,2023-02-11,LOU,brawlBall,Super Beach,62,78,140
8646,2023-02-11,LOU,brawlBall,Sneaky Fields,47,69,116
8647,2023-02-10,LOU,knockout,Flaring Phoenix,22,21,43
8648,2023-02-10,LOU,hotZone,Controller Chaos,205,281,486
8649,2023-02-10,LOU,heist,Hot Potato,10,22,32
8650,2023-02-10,LOU,gemGrab,Undermine,8,9,17
8651,2023-02-10,LOU,gemGrab,Deep Diner,39,38,77
8652,2023-02-10,LOU,brawlBall,Sneaky Fields,398,551,949
8653,2023-02-10,LOU,brawlBall,Pinhole Punt,2,8,10
8654,2023-02-10,LOU,bounty,Temple Ruins,15,18,33
8655,2023-02-09,LOU,knockout,Riverside,6,5,11
8656,2023-02-09,LOU,hotZone,Open Zone,16,13,29
8657,2023-02-09,LOU,heist,Hot Potato,3,4,7
8658,2023-02-09,LOU,gemGrab,Undermine,9,9,18
8659,2023-02-09,LOU,gemGrab,Gem Fort,1,3,4
8660,2023-02-09,LOU,brawlBall,Sunny Soccer,2,0,2
8661,2023-02-09,LOU,brawlBall,Pinhole Punt,62,90,152
8662,2023-02-09,LOU,bounty,Temple Ruins,1,5,6
8663,2023-02-08,LOU,knockout,Riverside,1,2,3
8664,2023-02-08,LOU,hotZone,Open Zone,12,25,37
8665,2023-02-08,LOU,heist,Safe Zone,1,1,2
8666,2023-02-08,LOU,gemGrab,Gem Fort,2,3,5
8667,2023-02-08,LOU,gemGrab,Crystal Arcade,2,0,2
8668,2023-02-08,LOU,brawlBall,Sunny Soccer,31,33,64
8669,2023-02-08,LOU,brawlBall,Beach Ball,1,0,1
8670,2023-02-08,LOU,bounty,Excel,0,1,1
8671,2023-02-07,LOU,hotZone,Dueling Beetles,40,102,142
8672,2023-02-07,LOU,heist,Safe Zone,0,2,2
8673,2023-02-07,LOU,gemGrab,Minecart Madness,5,19,24
8674,2023-02-07,LOU,gemGrab,Crystal Arcade,1,4,5
8675,2023-02-07,LOU,brawlBall,Center Stage,2,10,12
8676,2023-02-07,LOU,brawlBall,Beach Ball,6,12,18
8677,2023-02-06,LOU,knockout,New Perspective,13,14,27
8678,2023-02-06,LOU,hotZone,Dueling Beetles,690,1196,1886
8679,2023-02-06,LOU,heist,Snaked Assault,1,2,3
8680,2023-02-06,LOU,gemGrab,Minecart Madness,89,119,208
8681,2023-02-06,LOU,gemGrab,Double Swoosh,17,20,37
8682,2023-02-06,LOU,brawlBall,Sneaky Fields,2,19,21
8683,2023-02-06,LOU,brawlBall,Center Stage,247,343,590
8684,2023-02-06,LOU,brawlBall,Backyard Bowl,17,16,33
8685,2023-02-06,LOU,bounty,Layer Cake,8,2,10
8686,2023-02-05,LOU,knockout,X Marks the Spot,9,10,19
8687,2023-02-05,LOU,knockout,Goldarm Gulch,1,0,1
8688,2023-02-05,LOU,hotZone,Ring of Fire,247,394,641
8689,2023-02-05,LOU,heist,Snaked Assault,21,12,33
8690,2023-02-05,LOU,heist,Pit Stop,1,1,2
8691,2023-02-05,LOU,gemGrab,Hard Rock Mine,5,5,10
8692,2023-02-05,LOU,gemGrab,Double Swoosh,53,48,101
8693,2023-02-05,LOU,brawlBall,Super Beach,7,4,11
8694,2023-02-05,LOU,brawlBall,Sneaky Fields,6,16,22
8695,2023-02-05,LOU,brawlBall,Backyard Bowl,237,300,537
8696,2023-02-05,LOU,bounty,Layer Cake,3,0,3
8697,2023-02-04,LOU,knockout,X Marks the Spot,8,6,14
8698,2023-02-04,LOU,knockout,Goldarm Gulch,1,0,1
8699,2023-02-04,LOU,hotZone,Ring of Fire,83,82,165
8700,2023-02-04,LOU,heist,Tornado Ring,1,1,2
8701,2023-02-04,LOU,heist,Pit Stop,1,0,1
8702,2023-02-04,LOU,gemGrab,Hard Rock Mine,7,7,14
8703,2023-02-04,LOU,gemGrab,Double Swoosh,10,0,10
8704,2023-02-04,LOU,gemGrab,Deep Diner,3,2,5
8705,2023-02-04,LOU,brawlBall,Super Beach,79,100,179
8706,2023-02-04,LOU,brawlBall,Sneaky Fields,13,9,22
8707,2023-02-04,LOU,bounty,Dry Season,1,2,3
8708,2023-02-03,LOU,knockout,Out in the Open,22,17,39
8709,2023-02-03,LOU,knockout,Goldarm Gulch,2,5,7
8710,2023-02-03,LOU,hotZone,Split,25,22,47
8711,2023-02-03,LOU,heist,Tornado Ring,8,4,12
8712,2023-02-03,LOU,heist,Pit Stop,5,8,13
8713,2023-02-03,LOU,gemGrab,Undermine,8,7,15
8714,2023-02-03,LOU,gemGrab,Double Swoosh,52,22,74
8715,2023-02-03,LOU,gemGrab,Deep Diner,43,34,77
8716,2023-02-03,LOU,brawlBall,Sneaky Fields,353,575,928
8717,2023-02-03,LOU,brawlBall,Pinhole Punt,14,17,31
8718,2023-02-03,LOU,bounty,Dry Season,17,4,21
8719,2023-02-02,LOU,knockout,Out in the Open,5,4,9
8720,2023-02-02,LOU,hotZone,Split,6,7,13
8721,2023-02-02,LOU,heist,Kaboom Canyon,2,0,2
8722,2023-02-02,LOU,gemGrab,Undermine,7,4,11
8723,2023-02-02,LOU,gemGrab,Gem Fort,4,0,4
8724,2023-02-02,LOU,brawlBall,Sunny Soccer,3,0,3
8725,2023-02-02,LOU,brawlBall,Pinhole Punt,101,148,249
8726,2023-02-02,LOU,bounty,Shooting Star,2,1,3
8727,2023-02-01,LOU,knockout,Goldarm Gulch,22,13,35
8728,2023-02-01,LOU,hotZone,Parallel Plays,70,92,162
8729,2023-02-01,LOU,heist,Kaboom Canyon,11,20,31
8730,2023-02-01,LOU,gemGrab,Gem Fort,32,39,71
8731,2023-02-01,LOU,gemGrab,Crystal Arcade,16,17,33
8732,2023-02-01,LOU,brawlBall,Sunny Soccer,179,291,470
8733,2023-02-01,LOU,brawlBall,Beach Ball,5,1,6
8734,2023-02-01,LOU,bounty,Shooting Star,3,0,3
8735,2023-01-31,LOU,knockout,Goldarm Gulch,6,4,10
8736,2023-01-31,LOU,hotZone,Parallel Plays,55,86,141
8737,2023-01-31,LOU,heist,Pit Stop,3,2,5
8738,2023-01-31,LOU,gemGrab,Minecart Madness,5,0,5
8739,2023-01-31,LOU,gemGrab,Crystal Arcade,12,26,38
8740,2023-01-31,LOU,brawlBall,Center Stage,3,2,5
8741,2023-01-31,LOU,brawlBall,Beach Ball,109,171,280
8742,2023-01-31,LOU,bounty,Hideout,7,7,14
8743,2023-01-30,LOU,knockout,Belle's Rock,12,12,24
8744,2023-01-30,LOU,hotZone,Quarter Pounder,123,249,372
8745,2023-01-30,LOU,heist,Pit Stop,5,0,5
8746,2023-01-30,LOU,gemGrab,Minecart Madness,31,34,65
8747,2023-01-30,LOU,gemGrab,Double Swoosh,31,21,52
8748,2023-01-30,LOU,brawlBall,Center Stage,163,236,399
8749,2023-01-30,LOU,brawlBall,Backyard Bowl,20,24,44
8750,2023-01-30,LOU,bounty,Hideout,6,0,6
8751,2023-01-29,LOU,knockout,Belle's Rock,18,10,28
8752,2023-01-29,LOU,hotZone,Quarter Pounder,84,120,204
8753,2023-01-29,LOU,heist,Bridge Too Far,17,11,28
8754,2023-01-29,LOU,gemGrab,Hard Rock Mine,5,3,8
8755,2023-01-29,LOU,gemGrab,Double Swoosh,30,16,46
8756,2023-01-29,LOU,brawlBall,Super Beach,4,3,7
8757,2023-01-29,LOU,brawlBall,Backyard Bowl,178,203,381
8758,2023-01-29,LOU,bounty,Canal Grande,8,6,14
8759,2023-01-28,LOU,knockout,Flaring Phoenix,15,6,21
8760,2023-01-28,LOU,hotZone,Controller Chaos,113,160,273
8761,2023-01-28,LOU,heist,Bridge Too Far,22,32,54
8762,2023-01-28,LOU,gemGrab,Hard Rock Mine,46,33,79
8763,2023-01-28,LOU,gemGrab,Deep Diner,16,19,35
8764,2023-01-28,LOU,brawlBall,Super Beach,259,320,579
8765,2023-01-28,LOU,brawlBall,Sneaky Fields,12,27,39
8766,2023-01-28,LOU,bounty,Canal Grande,13,9,22
8767,2023-01-27,LOU,knockout,Flaring Phoenix,4,3,7
8768,2023-01-27,LOU,hotZone,Controller Chaos,24,22,46
8769,2023-01-27,LOU,heist,Hot Potato,3,1,4
8770,2023-01-27,LOU,gemGrab,Undermine,4,4,8
8771,2023-01-27,LOU,gemGrab,Deep Diner,24,28,52
8772,2023-01-27,LOU,brawlBall,Sneaky Fields,79,116,195
8773,2023-01-27,LOU,brawlBall,Pinhole Punt,3,0,3
8774,2023-01-27,LOU,bounty,Temple Ruins,6,9,15
8775,2023-01-26,LOU,knockout,Riverside,22,10,32
8776,2023-01-26,LOU,hotZone,Open Zone,98,113,211
8777,2023-01-26,LOU,heist,Hot Potato,6,3,9
8778,2023-01-26,LOU,gemGrab,Undermine,18,25,43
8779,2023-01-26,LOU,gemGrab,Gem Fort,8,10,18
8780,2023-01-26,LOU,brawlBall,Sunny Soccer,13,11,24
8781,2023-01-26,LOU,brawlBall,Pinhole Punt,261,352,613
8782,2023-01-26,LOU,bounty,Temple Ruins,10,3,13
8783,2023-01-25,LOU,knockout,Riverside,7,3,10
8784,2023-01-25,LOU,hotZone,Open Zone,55,80,135
8785,2023-01-25,LOU,heist,Safe Zone,7,1,8
8786,2023-01-25,LOU,gemGrab,Gem Fort,11,11,22
8787,2023-01-25,LOU,gemGrab,Crystal Arcade,13,10,23
8788,2023-01-25,LOU,brawlBall,Sunny Soccer,150,204,354
8789,2023-01-25,LOU,brawlBall,Beach Ball,24,36,60
8790,2023-01-25,LOU,bounty,Excel,6,9,15
8791,2023-01-24,LOU,knockout,New Perspective,8,4,12
8792,2023-01-24,LOU,hotZone,Dueling Beetles,257,524,781
8793,2023-01-24,LOU,heist,Safe Zone,16,5,21
8794,2023-01-24,LOU,gemGrab,Minecart Madness,16,6,22
8795,2023-01-24,LOU,gemGrab,Crystal Arcade,35,34,69
8796,2023-01-24,LOU,brawlBall,Center Stage,11,13,24
8797,2023-01-24,LOU,brawlBall,Beach Ball,214,268,482
8798,2023-01-24,LOU,bounty,Excel,7,2,9
8799,2023-01-23,LOU,knockout,New Perspective,20,18,38
8800,2023-01-23,LOU,hotZone,Dueling Beetles,546,902,1448
8801,2023-01-23,LOU,heist,Snaked Assault,4,4,8
8802,2023-01-23,LOU,gemGrab,Minecart Madness,65,100,165
8803,2023-01-23,LOU,gemGrab,Double Swoosh,15,4,19
8804,2023-01-23,LOU,brawlBall,Center Stage,240,404,644
8805,2023-01-23,LOU,brawlBall,Backyard Bowl,4,19,23
8806,2023-01-23,LOU,bounty,Layer Cake,3,4,7
8807,2023-01-22,LOU,knockout,X Marks the Spot,6,2,8
8808,2023-01-22,LOU,hotZone,Ring of Fire,130,239,369
8809,2023-01-22,LOU,heist,Snaked Assault,4,1,5
8810,2023-01-22,LOU,gemGrab,Hard Rock Mine,2,5,7
8811,2023-01-22,LOU,gemGrab,Double Swoosh,13,17,30
8812,2023-01-22,LOU,brawlBall,Super Beach,25,61,86
8813,2023-01-22,LOU,brawlBall,Backyard Bowl,84,101,185
8814,2023-01-22,LOU,bounty,Layer Cake,3,5,8
8815,2023-01-21,LOU,knockout,X Marks the Spot,25,25,50
8816,2023-01-21,LOU,hotZone,Ring of Fire,459,638,1097
8817,2023-01-21,LOU,heist,Tornado Ring,4,2,6
8818,2023-01-21,LOU,gemGrab,Hard Rock Mine,21,23,44
8819,2023-01-21,LOU,gemGrab,Deep Diner,14,5,19
8820,2023-01-21,LOU,brawlBall,Super Beach,328,568,896
8821,2023-01-21,LOU,brawlBall,Sneaky Fields,8,9,17
8822,2023-01-21,LOU,bounty,Dry Season,7,6,13
8823,2023-01-20,LOU,knockout,Out in the Open,23,10,33
8824,2023-01-20,LOU,hotZone,Split,24,19,43
8825,2023-01-20,LOU,heist,Tornado Ring,10,9,19
8826,2023-01-20,LOU,gemGrab,Undermine,8,11,19
8827,2023-01-20,LOU,gemGrab,Deep Diner,56,47,103
8828,2023-01-20,LOU,brawlBall,Sneaky Fields,239,268,507
8829,2023-01-20,LOU,brawlBall,Pinhole Punt,9,18,27
8830,2023-01-20,LOU,bounty,Dry Season,4,6,10
8831,2023-01-19,LOU,knockout,Out in the Open,24,19,43
8832,2023-01-19,LOU,hotZone,Split,33,33,66
8833,2023-01-19,LOU,heist,Kaboom Canyon,9,5,14
8834,2023-01-19,LOU,gemGrab,Undermine,21,25,46
8835,2023-01-19,LOU,gemGrab,Gem Fort,5,2,7
8836,2023-01-19,LOU,brawlBall,Sunny Soccer,7,4,11
8837,2023-01-19,LOU,brawlBall,Pinhole Punt,208,242,450
8838,2023-01-19,LOU,bounty,Shooting Star,5,7,12
8839,2023-01-18,LOU,knockout,Goldarm Gulch,2,1,3
8840,2023-01-18,LOU,hotZone,Parallel Plays,6,10,16
8841,2023-01-18,LOU,heist,Kaboom Canyon,3,7,10
8842,2023-01-18,LOU,gemGrab,Gem Fort,9,3,12
8843,2023-01-18,LOU,gemGrab,Crystal Arcade,0,4,4
8844,2023-01-18,LOU,brawlBall,Sunny Soccer,56,48,104
8845,2023-01-18,LOU,bounty,Shooting Star,2,2,4
8846,2023-01-17,LOU,knockout,Goldarm Gulch,3,2,5
8847,2023-01-17,LOU,hotZone,Parallel Plays,4,4,8
8848,2023-01-17,LOU,gemGrab,Minecart Madness,1,2,3
8849,2023-01-17,LOU,gemGrab,Crystal Arcade,3,0,3
8850,2023-01-17,LOU,brawlBall,Beach Ball,11,20,31
8851,2023-01-17,LOU,bounty,Hideout,0,2,2
8852,2023-01-16,LOU,knockout,Belle's Rock,1,0,1
8853,2023-01-16,LOU,hotZone,Quarter Pounder,4,2,6
8854,2023-01-16,LOU,heist,Pit Stop,4,1,5
8855,2023-01-16,LOU,gemGrab,Minecart Madness,6,9,15
8856,2023-01-16,LOU,brawlBall,Center Stage,8,17,25
8857,2023-01-16,LOU,brawlBall,Backyard Bowl,3,0,3
8858,2023-01-15,LOU,knockout,Belle's Rock,0,1,1
8859,2023-01-15,LOU,hotZone,Quarter Pounder,13,17,30
8860,2023-01-15,LOU,heist,Bridge Too Far,0,5,5
8861,2023-01-15,LOU,gemGrab,Double Swoosh,7,8,15
8862,2023-01-15,LOU,brawlBall,Super Beach,8,8,16
8863,2023-01-15,LOU,brawlBall,Backyard Bowl,17,34,51
8864,2023-01-15,LOU,bounty,Canal Grande,0,1,1
8865,2023-01-14,LOU,knockout,Flaring Phoenix,1,0,1
8866,2023-01-14,LOU,hotZone,Controller Chaos,20,77,97
8867,2023-01-14,LOU,heist,Bridge Too Far,3,0,3
8868,2023-01-14,LOU,gemGrab,Hard Rock Mine,1,1,2
8869,2023-01-14,LOU,gemGrab,Deep Diner,1,0,1
8870,2023-01-14,LOU,brawlBall,Super Beach,29,23,52
8871,2023-01-14,LOU,brawlBall,Sneaky Fields,5,4,9
8872,2023-01-13,LOU,knockout,Flaring Phoenix,1,2,3
8873,2023-01-13,LOU,hotZone,Controller Chaos,47,69,116
8874,2023-01-13,LOU,gemGrab,Deep Diner,4,10,14
8875,2023-01-13,LOU,brawlBall,Sneaky Fields,17,39,56
8876,2023-01-13,LOU,brawlBall,Pinhole Punt,2,1,3
8877,2023-01-12,LOU,knockout,Riverside,1,0,1
8878,2023-01-12,LOU,hotZone,Open Zone,7,14,21
8879,2023-01-12,LOU,heist,Hot Potato,1,0,1
8880,2023-01-12,LOU,gemGrab,Undermine,1,0,1
8881,2023-01-12,LOU,brawlBall,Sunny Soccer,2,2,4
8882,2023-01-12,LOU,brawlBall,Pinhole Punt,5,2,7
8883,2023-01-11,LOU,knockout,Riverside,1,0,1
8884,2023-01-11,LOU,hotZone,Open Zone,4,2,6
8885,2023-01-11,LOU,gemGrab,Gem Fort,1,0,1
8886,2023-01-11,LOU,brawlBall,Sunny Soccer,7,20,27
8887,2023-01-11,LOU,bounty,Excel,2,0,2
8888,2023-01-10,LOU,knockout,New Perspective,0,1,1
8889,2023-01-10,LOU,hotZone,Dueling Beetles,54,79,133
8890,2023-01-10,LOU,heist,Safe Zone,1,0,1
8891,2023-01-10,LOU,gemGrab,Minecart Madness,2,0,2
8892,2023-01-10,LOU,gemGrab,Crystal Arcade,2,0,2
8893,2023-01-10,LOU,brawlBall,Center Stage,1,0,1
8894,2023-01-10,LOU,brawlBall,Beach Ball,7,9,16
8895,2023-01-09,LOU,hotZone,Dueling Beetles,38,73,111
8896,2023-01-09,LOU,gemGrab,Minecart Madness,4,1,5
8897,2023-01-09,LOU,gemGrab,Double Swoosh,2,2,4
8898,2023-01-09,LOU,brawlBall,Center Stage,10,19,29
8899,2023-01-09,LOU,bounty,Layer Cake,1,0,1
8900,2023-01-08,LOU,knockout,X Marks the Spot,1,0,1
8901,2023-01-08,LOU,hotZone,Ring of Fire,26,25,51
8902,2023-01-08,LOU,heist,Snaked Assault,2,0,2
8903,2023-01-08,LOU,gemGrab,Double Swoosh,1,0,1
8904,2023-01-08,LOU,brawlBall,Backyard Bowl,9,12,21
8905,2023-01-07,LOU,knockout,X Marks the Spot,1,0,1
8906,2023-01-07,LOU,hotZone,Ring of Fire,14,14,28
8907,2023-01-07,LOU,heist,Tornado Ring,1,3,4
8908,2023-01-07,LOU,gemGrab,Deep Diner,0,1,1
8909,2023-01-07,LOU,brawlBall,Super Beach,7,13,20
8910,2023-01-06,LOU,gemGrab,Undermine,1,0,1
8911,2023-01-06,LOU,gemGrab,Deep Diner,2,0,2
8912,2023-01-06,LOU,brawlBall,Sneaky Fields,20,15,35
8913,2023-01-05,LOU,knockout,Out in the Open,3,1,4
8914,2023-01-05,LOU,hotZone,Split,7,8,15
8915,2023-01-05,LOU,brawlBall,Pinhole Punt,29,71,100
8916,2023-01-04,LOU,hotZone,Parallel Plays,3,2,5
8917,2023-01-04,LOU,heist,Kaboom Canyon,0,2,2
8918,2023-01-04,LOU,gemGrab,Gem Fort,4,3,7
8919,2023-01-04,LOU,gemGrab,Crystal Arcade,0,1,1
8920,2023-01-04,LOU,brawlBall,Sunny Soccer,26,24,50
8921,2023-01-03,LOU,hotZone,Parallel Plays,3,0,3
8922,2023-01-03,LOU,hotZone,Controller Chaos,1,0,1
8923,2023-01-03,LOU,gemGrab,Minecart Madness,4,6,10
8924,2023-01-03,LOU,gemGrab,Crystal Arcade,0,2,2
8925,2023-01-03,LOU,brawlBall,Beach Ball,16,24,40
8926,2023-01-02,LOU,knockout,Belle's Rock,3,0,3
8927,2023-01-02,LOU,hotZone,Quarter Pounder,24,19,43
8928,2023-01-02,LOU,heist,Pit Stop,0,1,1
8929,2023-01-02,LOU,gemGrab,Minecart Madness,1,3,4
8930,2023-01-02,LOU,gemGrab,Double Swoosh,1,3,4
8931,2023-01-02,LOU,brawlBall,Center Stage,16,24,40
8932,2023-01-02,LOU,brawlBall,Backyard Bowl,1,1,2
8933,2023-01-01,LOU,hotZone,Quarter Pounder,4,3,7
8934,2023-01-01,LOU,gemGrab,Double Swoosh,3,0,3
8935,2023-01-01,LOU,brawlBall,Backyard Bowl,9,11,20
8936,2022-12-31,LOU,hotZone,Controller Chaos,7,15,22
8937,2022-12-31,LOU,gemGrab,Minecart Madness,2,1,3
8938,2022-12-31,LOU,gemGrab,Deep Diner,1,0,1
8939,2022-12-31,LOU,brawlBall,Super Beach,0,1,1
8940,2022-12-31,LOU,brawlBall,Sneaky Fields,1,0,1
8941,2022-12-30,LOU,hotZone,Controller Chaos,7,16,23
8942,2022-12-30,LOU,brawlBall,Sneaky Fields,4,2,6
8943,2022-12-29,LOU,hotZone,Open Zone,0,2,2
8944,2022-12-29,LOU,heist,Hot Potato,1,0,1
8945,2022-12-28,LOU,hotZone,Open Zone,3,2,5
8946,2022-12-28,LOU,brawlBall,Sunny Soccer,1,1,2
8947,2022-12-27,LOU,hotZone,Controller Chaos,0,2,2
8948,2022-12-26,LOU,hotZone,Controller Chaos,1,0,1
8949,2022-12-26,LOU,gemGrab,Minecart Madness,1,0,1
8950,2022-12-22,LOU,brawlBall,Pinhole Punt,3,2,5
8951,2022-12-20,LOU,brawlBall,Beach Ball,2,1,3
8952,2022-12-17,LOU,brawlBall,Super Beach,1,1,2
8953,2022-12-16,LOU,gemGrab,Undermine,2,0,2
8954,2022-12-16,LOU,brawlBall,Sneaky Fields,2,0,2
8955,2022-12-10,LOU,hotZone,Ring of Fire,0,1,1
8956,2022-11-07,LOU,hotZone,Quarter Pounder,6,2,8
8957,2022-10-30,LOU,hotZone,Dueling Beetles,0,2,2
8958,2022-10-30,LOU,heist,Safe Zone,0,1,1
8959,2022-10-28,LOU,hotZone,Dueling Beetles,2,0,2
8960,2023-02-11,LOLA,knockout,Flaring Phoenix,4,0,4
8961,2023-02-11,LOLA,hotZone,Controller Chaos,16,25,41
8962,2023-02-11,LOLA,gemGrab,Deep Diner,11,16,27
8963,2023-02-11,LOLA,brawlBall,Super Beach,11,11,22
8964,2023-02-11,LOLA,brawlBall,Sneaky Fields,10,5,15
8965,2023-02-10,LOLA,knockout,Flaring Phoenix,26,27,53
8966,2023-02-10,LOLA,hotZone,Controller Chaos,21,5,26
8967,2023-02-10,LOLA,heist,Hot Potato,15,12,27
8968,2023-02-10,LOLA,gemGrab,Undermine,13,12,25
8969,2023-02-10,LOLA,gemGrab,Deep Diner,40,56,96
8970,2023-02-10,LOLA,brawlBall,Sneaky Fields,71,99,170
8971,2023-02-10,LOLA,brawlBall,Pinhole Punt,4,1,5
8972,2023-02-10,LOLA,bounty,Temple Ruins,19,33,52
8973,2023-02-09,LOLA,knockout,Riverside,8,20,28
8974,2023-02-09,LOLA,hotZone,Open Zone,11,16,27
8975,2023-02-09,LOLA,heist,Hot Potato,6,24,30
8976,2023-02-09,LOLA,gemGrab,Undermine,13,17,30
8977,2023-02-09,LOLA,gemGrab,Gem Fort,2,1,3
8978,2023-02-09,LOLA,brawlBall,Sunny Soccer,2,7,9
8979,2023-02-09,LOLA,brawlBall,Pinhole Punt,52,77,129
8980,2023-02-09,LOLA,bounty,Temple Ruins,10,9,19
8981,2023-02-08,LOLA,knockout,Riverside,4,2,6
8982,2023-02-08,LOLA,hotZone,Open Zone,10,23,33
8983,2023-02-08,LOLA,heist,Safe Zone,10,6,16
8984,2023-02-08,LOLA,gemGrab,Gem Fort,6,3,9
8985,2023-02-08,LOLA,gemGrab,Crystal Arcade,2,6,8
8986,2023-02-08,LOLA,brawlBall,Sunny Soccer,11,14,25
8987,2023-02-08,LOLA,brawlBall,Beach Ball,2,0,2
8988,2023-02-07,LOLA,knockout,New Perspective,4,5,9
8989,2023-02-07,LOLA,hotZone,Dueling Beetles,3,24,27
8990,2023-02-07,LOLA,heist,Safe Zone,5,3,8
8991,2023-02-07,LOLA,gemGrab,Minecart Madness,2,3,5
8992,2023-02-07,LOLA,gemGrab,Crystal Arcade,1,1,2
8993,2023-02-07,LOLA,brawlBall,Center Stage,0,1,1
8994,2023-02-07,LOLA,brawlBall,Beach Ball,12,12,24
8995,2023-02-06,LOLA,knockout,New Perspective,47,46,93
8996,2023-02-06,LOLA,hotZone,Dueling Beetles,73,124,197
8997,2023-02-06,LOLA,heist,Snaked Assault,63,121,184
8998,2023-02-06,LOLA,heist,Pit Stop,2,0,2
8999,2023-02-06,LOLA,gemGrab,Minecart Madness,58,83,141
9000,2023-02-06,LOLA,gemGrab,Double Swoosh,17,11,28
9001,2023-02-06,LOLA,brawlBall,Center Stage,121,126,247
9002,2023-02-06,LOLA,brawlBall,Backyard Bowl,32,72,104
9003,2023-02-06,LOLA,bounty,Layer Cake,3,1,4
9004,2023-02-05,LOLA,knockout,X Marks the Spot,21,20,41
9005,2023-02-05,LOLA,knockout,Goldarm Gulch,0,1,1
9006,2023-02-05,LOLA,hotZone,Ring of Fire,42,87,129
9007,2023-02-05,LOLA,heist,Snaked Assault,71,89,160
9008,2023-02-05,LOLA,heist,Pit Stop,1,0,1
9009,2023-02-05,LOLA,gemGrab,Hard Rock Mine,8,21,29
9010,2023-02-05,LOLA,gemGrab,Double Swoosh,50,64,114
9011,2023-02-05,LOLA,brawlBall,Super Beach,2,2,4
9012,2023-02-05,LOLA,brawlBall,Sneaky Fields,1,0,1
9013,2023-02-05,LOLA,brawlBall,Backyard Bowl,446,645,1091
9014,2023-02-05,LOLA,bounty,Layer Cake,10,14,24
9015,2023-02-04,LOLA,knockout,X Marks the Spot,1,10,11
9016,2023-02-04,LOLA,knockout,Goldarm Gulch,2,0,2
9017,2023-02-04,LOLA,hotZone,Ring of Fire,27,40,67
9018,2023-02-04,LOLA,heist,Tornado Ring,2,3,5
9019,2023-02-04,LOLA,heist,Pit Stop,8,1,9
9020,2023-02-04,LOLA,gemGrab,Hard Rock Mine,13,10,23
9021,2023-02-04,LOLA,gemGrab,Double Swoosh,4,7,11
9022,2023-02-04,LOLA,gemGrab,Deep Diner,0,1,1
9023,2023-02-04,LOLA,brawlBall,Super Beach,30,44,74
9024,2023-02-04,LOLA,brawlBall,Sneaky Fields,1,0,1
9025,2023-02-04,LOLA,bounty,Dry Season,2,1,3
9026,2023-02-03,LOLA,knockout,Out in the Open,32,40,72
9027,2023-02-03,LOLA,knockout,Goldarm Gulch,4,0,4
9028,2023-02-03,LOLA,hotZone,Split,4,3,7
9029,2023-02-03,LOLA,heist,Tornado Ring,22,14,36
9030,2023-02-03,LOLA,heist,Pit Stop,7,15,22
9031,2023-02-03,LOLA,gemGrab,Undermine,10,27,37
9032,2023-02-03,LOLA,gemGrab,Double Swoosh,20,23,43
9033,2023-02-03,LOLA,gemGrab,Deep Diner,34,27,61
9034,2023-02-03,LOLA,brawlBall,Sneaky Fields,84,121,205
9035,2023-02-03,LOLA,brawlBall,Pinhole Punt,7,30,37
9036,2023-02-03,LOLA,bounty,Dry Season,15,19,34
9037,2023-02-02,LOLA,knockout,Out in the Open,16,17,33
9038,2023-02-02,LOLA,hotZone,Split,3,1,4
9039,2023-02-02,LOLA,heist,Kaboom Canyon,21,50,71
9040,2023-02-02,LOLA,gemGrab,Undermine,12,12,24
9041,2023-02-02,LOLA,gemGrab,Gem Fort,7,12,19
9042,2023-02-02,LOLA,brawlBall,Pinhole Punt,70,86,156
9043,2023-02-02,LOLA,bounty,Shooting Star,3,3,6
9044,2023-02-01,LOLA,knockout,Goldarm Gulch,21,25,46
9045,2023-02-01,LOLA,hotZone,Parallel Plays,21,56,77
9046,2023-02-01,LOLA,heist,Kaboom Canyon,67,62,129
9047,2023-02-01,LOLA,gemGrab,Gem Fort,20,36,56
9048,2023-02-01,LOLA,gemGrab,Crystal Arcade,10,20,30
9049,2023-02-01,LOLA,brawlBall,Sunny Soccer,64,76,140
9050,2023-02-01,LOLA,brawlBall,Beach Ball,1,4,5
9051,2023-02-01,LOLA,bounty,Shooting Star,7,15,22
9052,2023-01-31,LOLA,knockout,Goldarm Gulch,24,15,39
9053,2023-01-31,LOLA,hotZone,Parallel Plays,10,5,15
9054,2023-01-31,LOLA,heist,Pit Stop,8,4,12
9055,2023-01-31,LOLA,gemGrab,Minecart Madness,4,3,7
9056,2023-01-31,LOLA,gemGrab,Crystal Arcade,20,15,35
9057,2023-01-31,LOLA,brawlBall,Center Stage,2,1,3
9058,2023-01-31,LOLA,brawlBall,Beach Ball,40,57,97
9059,2023-01-31,LOLA,bounty,Hideout,4,4,8
9060,2023-01-30,LOLA,knockout,Belle's Rock,11,17,28
9061,2023-01-30,LOLA,hotZone,Quarter Pounder,34,97,131
9062,2023-01-30,LOLA,heist,Pit Stop,8,1,9
9063,2023-01-30,LOLA,gemGrab,Minecart Madness,42,40,82
9064,2023-01-30,LOLA,gemGrab,Double Swoosh,13,23,36
9065,2023-01-30,LOLA,brawlBall,Center Stage,71,56,127
9066,2023-01-30,LOLA,brawlBall,Backyard Bowl,32,51,83
9067,2023-01-30,LOLA,bounty,Hideout,13,19,32
9068,2023-01-29,LOLA,knockout,Belle's Rock,16,8,24
9069,2023-01-29,LOLA,hotZone,Quarter Pounder,47,110,157
9070,2023-01-29,LOLA,heist,Bridge Too Far,171,223,394
9071,2023-01-29,LOLA,gemGrab,Hard Rock Mine,15,33,48
9072,2023-01-29,LOLA,gemGrab,Double Swoosh,33,45,78
9073,2023-01-29,LOLA,brawlBall,Super Beach,7,5,12
9074,2023-01-29,LOLA,brawlBall,Backyard Bowl,334,416,750
9075,2023-01-29,LOLA,bounty,Canal Grande,3,3,6
9076,2023-01-28,LOLA,knockout,Flaring Phoenix,10,6,16
9077,2023-01-28,LOLA,hotZone,Controller Chaos,27,38,65
9078,2023-01-28,LOLA,heist,Bridge Too Far,443,553,996
9079,2023-01-28,LOLA,gemGrab,Hard Rock Mine,44,76,120
9080,2023-01-28,LOLA,gemGrab,Deep Diner,8,18,26
9081,2023-01-28,LOLA,brawlBall,Super Beach,113,117,230
9082,2023-01-28,LOLA,brawlBall,Sneaky Fields,6,0,6
9083,2023-01-28,LOLA,bounty,Canal Grande,2,3,5
9084,2023-01-27,LOLA,knockout,Flaring Phoenix,11,17,28
9085,2023-01-27,LOLA,hotZone,Controller Chaos,4,4,8
9086,2023-01-27,LOLA,heist,Hot Potato,22,39,61
9087,2023-01-27,LOLA,gemGrab,Undermine,4,1,5
9088,2023-01-27,LOLA,gemGrab,Deep Diner,8,8,16
9089,2023-01-27,LOLA,brawlBall,Sneaky Fields,28,15,43
9090,2023-01-27,LOLA,brawlBall,Pinhole Punt,0,1,1
9091,2023-01-27,LOLA,bounty,Temple Ruins,6,3,9
9092,2023-01-26,LOLA,knockout,Riverside,43,56,99
9093,2023-01-26,LOLA,hotZone,Open Zone,90,139,229
9094,2023-01-26,LOLA,heist,Hot Potato,40,32,72
9095,2023-01-26,LOLA,gemGrab,Undermine,22,27,49
9096,2023-01-26,LOLA,gemGrab,Gem Fort,16,16,32
9097,2023-01-26,LOLA,brawlBall,Sunny Soccer,2,2,4
9098,2023-01-26,LOLA,brawlBall,Pinhole Punt,216,335,551
9099,2023-01-26,LOLA,bounty,Temple Ruins,16,13,29
9100,2023-01-25,LOLA,knockout,Riverside,23,23,46
9101,2023-01-25,LOLA,hotZone,Open Zone,70,95,165
9102,2023-01-25,LOLA,heist,Safe Zone,62,129,191
9103,2023-01-25,LOLA,gemGrab,Gem Fort,8,10,18
9104,2023-01-25,LOLA,gemGrab,Crystal Arcade,19,22,41
9105,2023-01-25,LOLA,brawlBall,Sunny Soccer,40,55,95
9106,2023-01-25,LOLA,brawlBall,Beach Ball,11,6,17
9107,2023-01-25,LOLA,bounty,Excel,1,1,2
9108,2023-01-24,LOLA,knockout,New Perspective,9,11,20
9109,2023-01-24,LOLA,hotZone,Dueling Beetles,35,32,67
9110,2023-01-24,LOLA,heist,Safe Zone,111,119,230
9111,2023-01-24,LOLA,gemGrab,Minecart Madness,11,35,46
9112,2023-01-24,LOLA,gemGrab,Crystal Arcade,35,27,62
9113,2023-01-24,LOLA,brawlBall,Center Stage,6,5,11
9114,2023-01-24,LOLA,brawlBall,Beach Ball,79,103,182
9115,2023-01-24,LOLA,bounty,Excel,5,2,7
9116,2023-01-23,LOLA,knockout,New Perspective,22,15,37
9117,2023-01-23,LOLA,hotZone,Dueling Beetles,45,83,128
9118,2023-01-23,LOLA,heist,Snaked Assault,95,145,240
9119,2023-01-23,LOLA,gemGrab,Minecart Madness,72,117,189
9120,2023-01-23,LOLA,gemGrab,Double Swoosh,6,17,23
9121,2023-01-23,LOLA,brawlBall,Center Stage,84,122,206
9122,2023-01-23,LOLA,brawlBall,Backyard Bowl,25,44,69
9123,2023-01-23,LOLA,bounty,Layer Cake,10,9,19
9124,2023-01-22,LOLA,knockout,X Marks the Spot,4,5,9
9125,2023-01-22,LOLA,hotZone,Ring of Fire,20,61,81
9126,2023-01-22,LOLA,heist,Snaked Assault,40,60,100
9127,2023-01-22,LOLA,gemGrab,Hard Rock Mine,15,11,26
9128,2023-01-22,LOLA,gemGrab,Double Swoosh,23,23,46
9129,2023-01-22,LOLA,brawlBall,Super Beach,9,28,37
9130,2023-01-22,LOLA,brawlBall,Backyard Bowl,151,207,358
9131,2023-01-22,LOLA,bounty,Layer Cake,3,1,4
9132,2023-01-21,LOLA,knockout,X Marks the Spot,47,50,97
9133,2023-01-21,LOLA,hotZone,Ring of Fire,87,98,185
9134,2023-01-21,LOLA,heist,Tornado Ring,26,29,55
9135,2023-01-21,LOLA,gemGrab,Hard Rock Mine,43,36,79
9136,2023-01-21,LOLA,gemGrab,Deep Diner,15,16,31
9137,2023-01-21,LOLA,brawlBall,Super Beach,128,165,293
9138,2023-01-21,LOLA,brawlBall,Sneaky Fields,1,1,2
9139,2023-01-21,LOLA,bounty,Dry Season,14,10,24
9140,2023-01-20,LOLA,knockout,Out in the Open,33,26,59
9141,2023-01-20,LOLA,hotZone,Split,9,10,19
9142,2023-01-20,LOLA,heist,Tornado Ring,30,15,45
9143,2023-01-20,LOLA,gemGrab,Undermine,7,17,24
9144,2023-01-20,LOLA,gemGrab,Deep Diner,35,72,107
9145,2023-01-20,LOLA,brawlBall,Sneaky Fields,58,53,111
9146,2023-01-20,LOLA,brawlBall,Pinhole Punt,8,5,13
9147,2023-01-20,LOLA,bounty,Dry Season,5,18,23
9148,2023-01-19,LOLA,knockout,Out in the Open,53,46,99
9149,2023-01-19,LOLA,hotZone,Split,7,10,17
9150,2023-01-19,LOLA,heist,Kaboom Canyon,68,122,190
9151,2023-01-19,LOLA,gemGrab,Undermine,33,48,81
9152,2023-01-19,LOLA,gemGrab,Gem Fort,15,20,35
9153,2023-01-19,LOLA,brawlBall,Sunny Soccer,5,10,15
9154,2023-01-19,LOLA,brawlBall,Pinhole Punt,231,315,546
9155,2023-01-19,LOLA,bounty,Shooting Star,10,13,23
9156,2023-01-18,LOLA,knockout,Goldarm Gulch,5,4,9
9157,2023-01-18,LOLA,hotZone,Parallel Plays,2,2,4
9158,2023-01-18,LOLA,heist,Kaboom Canyon,21,39,60
9159,2023-01-18,LOLA,gemGrab,Gem Fort,4,5,9
9160,2023-01-18,LOLA,gemGrab,Crystal Arcade,3,0,3
9161,2023-01-18,LOLA,brawlBall,Sunny Soccer,24,23,47
9162,2023-01-18,LOLA,brawlBall,Beach Ball,4,1,5
9163,2023-01-18,LOLA,bounty,Shooting Star,6,8,14
9164,2023-01-17,LOLA,knockout,Goldarm Gulch,5,6,11
9165,2023-01-17,LOLA,hotZone,Parallel Plays,2,3,5
9166,2023-01-17,LOLA,heist,Pit Stop,0,1,1
9167,2023-01-17,LOLA,gemGrab,Minecart Madness,1,5,6
9168,2023-01-17,LOLA,gemGrab,Crystal Arcade,2,4,6
9169,2023-01-17,LOLA,brawlBall,Beach Ball,6,8,14
9170,2023-01-17,LOLA,bounty,Hideout,2,2,4
9171,2023-01-16,LOLA,knockout,Belle's Rock,1,5,6
9172,2023-01-16,LOLA,hotZone,Quarter Pounder,11,21,32
9173,2023-01-16,LOLA,heist,Pit Stop,3,0,3
9174,2023-01-16,LOLA,gemGrab,Minecart Madness,17,14,31
9175,2023-01-16,LOLA,gemGrab,Double Swoosh,1,14,15
9176,2023-01-16,LOLA,brawlBall,Center Stage,2,6,8
9177,2023-01-16,LOLA,brawlBall,Backyard Bowl,3,9,12
9178,2023-01-16,LOLA,bounty,Hideout,1,3,4
9179,2023-01-15,LOLA,hotZone,Quarter Pounder,7,14,21
9180,2023-01-15,LOLA,heist,Bridge Too Far,52,54,106
9181,2023-01-15,LOLA,gemGrab,Hard Rock Mine,1,0,1
9182,2023-01-15,LOLA,gemGrab,Double Swoosh,2,3,5
9183,2023-01-15,LOLA,brawlBall,Super Beach,1,0,1
9184,2023-01-15,LOLA,brawlBall,Backyard Bowl,51,63,114
9185,2023-01-15,LOLA,bounty,Canal Grande,1,0,1
9186,2023-01-14,LOLA,knockout,Flaring Phoenix,1,10,11
9187,2023-01-14,LOLA,hotZone,Controller Chaos,3,3,6
9188,2023-01-14,LOLA,heist,Bridge Too Far,97,134,231
9189,2023-01-14,LOLA,gemGrab,Hard Rock Mine,1,0,1
9190,2023-01-14,LOLA,gemGrab,Deep Diner,2,0,2
9191,2023-01-14,LOLA,brawlBall,Super Beach,15,14,29
9192,2023-01-13,LOLA,knockout,Flaring Phoenix,2,0,2
9193,2023-01-13,LOLA,hotZone,Controller Chaos,4,1,5
9194,2023-01-13,LOLA,heist,Hot Potato,0,1,1
9195,2023-01-13,LOLA,gemGrab,Deep Diner,5,1,6
9196,2023-01-13,LOLA,brawlBall,Sneaky Fields,7,8,15
9197,2023-01-13,LOLA,brawlBall,Pinhole Punt,1,1,2
9198,2023-01-12,LOLA,knockout,Riverside,3,0,3
9199,2023-01-12,LOLA,hotZone,Open Zone,9,7,16
9200,2023-01-12,LOLA,gemGrab,Undermine,3,6,9
9201,2023-01-12,LOLA,brawlBall,Pinhole Punt,1,1,2
9202,2023-01-11,LOLA,hotZone,Open Zone,4,6,10
9203,2023-01-11,LOLA,gemGrab,Gem Fort,0,1,1
9204,2023-01-11,LOLA,brawlBall,Sunny Soccer,1,4,5
9205,2023-01-10,LOLA,knockout,New Perspective,1,0,1
9206,2023-01-10,LOLA,hotZone,Dueling Beetles,4,12,16
9207,2023-01-10,LOLA,heist,Safe Zone,6,8,14
9208,2023-01-10,LOLA,gemGrab,Minecart Madness,1,3,4
9209,2023-01-10,LOLA,gemGrab,Crystal Arcade,0,2,2
9210,2023-01-10,LOLA,brawlBall,Beach Ball,2,2,4
9211,2023-01-09,LOLA,knockout,New Perspective,1,0,1
9212,2023-01-09,LOLA,hotZone,Dueling Beetles,3,2,5
9213,2023-01-09,LOLA,heist,Snaked Assault,5,3,8
9214,2023-01-09,LOLA,gemGrab,Minecart Madness,13,23,36
9215,2023-01-09,LOLA,gemGrab,Double Swoosh,2,2,4
9216,2023-01-09,LOLA,brawlBall,Center Stage,1,6,7
9217,2023-01-09,LOLA,brawlBall,Backyard Bowl,2,3,5
9218,2023-01-08,LOLA,knockout,X Marks the Spot,2,0,2
9219,2023-01-08,LOLA,hotZone,Ring of Fire,8,3,11
9220,2023-01-08,LOLA,heist,Snaked Assault,8,2,10
9221,2023-01-08,LOLA,gemGrab,Hard Rock Mine,3,5,8
9222,2023-01-08,LOLA,gemGrab,Double Swoosh,3,1,4
9223,2023-01-08,LOLA,brawlBall,Backyard Bowl,16,35,51
9224,2023-01-07,LOLA,knockout,X Marks the Spot,2,0,2
9225,2023-01-07,LOLA,hotZone,Ring of Fire,4,0,4
9226,2023-01-07,LOLA,heist,Tornado Ring,3,1,4
9227,2023-01-07,LOLA,gemGrab,Hard Rock Mine,1,0,1
9228,2023-01-07,LOLA,gemGrab,Deep Diner,1,1,2
9229,2023-01-07,LOLA,brawlBall,Super Beach,1,7,8
9230,2023-01-07,LOLA,bounty,Dry Season,1,0,1
9231,2023-01-06,LOLA,knockout,Out in the Open,0,4,4
9232,2023-01-06,LOLA,hotZone,Split,2,0,2
9233,2023-01-06,LOLA,heist,Tornado Ring,4,1,5
9234,2023-01-06,LOLA,gemGrab,Undermine,2,0,2
9235,2023-01-06,LOLA,gemGrab,Deep Diner,0,17,17
9236,2023-01-06,LOLA,brawlBall,Sneaky Fields,4,8,12
9237,2023-01-06,LOLA,brawlBall,Pinhole Punt,1,2,3
9238,2023-01-06,LOLA,bounty,Dry Season,4,7,11
9239,2023-01-05,LOLA,heist,Kaboom Canyon,17,56,73
9240,2023-01-05,LOLA,brawlBall,Pinhole Punt,21,60,81
9241,2023-01-05,LOLA,bounty,Shooting Star,4,8,12
9242,2023-01-04,LOLA,knockout,Goldarm Gulch,1,0,1
9243,2023-01-04,LOLA,hotZone,Parallel Plays,1,0,1
9244,2023-01-04,LOLA,heist,Kaboom Canyon,36,80,116
9245,2023-01-04,LOLA,gemGrab,Gem Fort,2,1,3
9246,2023-01-04,LOLA,brawlBall,Sunny Soccer,1,1,2
9247,2023-01-04,LOLA,bounty,Shooting Star,3,0,3
9248,2023-01-03,LOLA,knockout,Goldarm Gulch,2,3,5
9249,2023-01-03,LOLA,hotZone,Parallel Plays,3,0,3
9250,2023-01-03,LOLA,heist,Pit Stop,1,0,1
9251,2023-01-03,LOLA,gemGrab,Minecart Madness,1,24,25
9252,2023-01-03,LOLA,brawlBall,Center Stage,2,0,2
9253,2023-01-03,LOLA,brawlBall,Beach Ball,4,1,5
9254,2023-01-02,LOLA,knockout,Belle's Rock,1,1,2
9255,2023-01-02,LOLA,hotZone,Quarter Pounder,6,6,12
9256,2023-01-02,LOLA,heist,Pit Stop,3,0,3
9257,2023-01-02,LOLA,gemGrab,Minecart Madness,9,14,23
9258,2023-01-02,LOLA,gemGrab,Double Swoosh,2,0,2
9259,2023-01-02,LOLA,brawlBall,Center Stage,8,4,12
9260,2023-01-02,LOLA,brawlBall,Backyard Bowl,2,4,6
9261,2023-01-02,LOLA,bounty,Hideout,2,1,3
9262,2023-01-01,LOLA,knockout,Belle's Rock,2,0,2
9263,2023-01-01,LOLA,hotZone,Quarter Pounder,2,1,3
9264,2023-01-01,LOLA,heist,Bridge Too Far,12,22,34
9265,2023-01-01,LOLA,gemGrab,Double Swoosh,2,4,6
9266,2023-01-01,LOLA,brawlBall,Backyard Bowl,22,45,67
9267,2022-12-31,LOLA,heist,Bridge Too Far,6,10,16
9268,2022-12-31,LOLA,gemGrab,Minecart Madness,1,0,1
9269,2022-12-31,LOLA,gemGrab,Hard Rock Mine,2,0,2
9270,2022-12-31,LOLA,gemGrab,Deep Diner,0,1,1
9271,2022-12-31,LOLA,brawlBall,Super Beach,1,3,4
9272,2022-12-30,LOLA,hotZone,Controller Chaos,1,0,1
9273,2022-12-30,LOLA,heist,Hot Potato,1,0,1
9274,2022-12-30,LOLA,gemGrab,Undermine,2,0,2
9275,2022-12-30,LOLA,brawlBall,Sneaky Fields,2,2,4
9276,2022-12-29,LOLA,hotZone,Open Zone,0,1,1
9277,2022-12-29,LOLA,heist,Hot Potato,1,0,1
9278,2022-12-29,LOLA,gemGrab,Undermine,1,0,1
9279,2022-12-28,LOLA,hotZone,Open Zone,2,8,10
9280,2022-12-27,LOLA,knockout,New Perspective,2,0,2
9281,2022-12-26,LOLA,heist,Kaboom Canyon,0,1,1
9282,2022-12-26,LOLA,brawlBall,Center Stage,1,0,1
9283,2022-12-22,LOLA,brawlBall,Pinhole Punt,1,0,1
9284,2022-12-21,LOLA,brawlBall,Sunny Soccer,0,1,1
9285,2022-12-19,LOLA,gemGrab,Minecart Madness,4,0,4
9286,2022-12-16,LOLA,gemGrab,Undermine,2,0,2
9287,2022-12-13,LOLA,heist,Safe Zone,0,2,2
9288,2022-12-13,LOLA,gemGrab,Crystal Arcade,2,0,2
9289,2022-12-11,LOLA,gemGrab,Double Swoosh,0,2,2
9290,2022-11-01,LOLA,knockout,New Perspective,0,2,2
9291,2022-10-10,LOLA,knockout,Belle's Rock,2,0,2
9292,2023-02-11,LEON,knockout,Flaring Phoenix,117,73,190
9293,2023-02-11,LEON,hotZone,Controller Chaos,39,12,51
9294,2023-02-11,LEON,gemGrab,Deep Diner,58,74,132
9295,2023-02-11,LEON,brawlBall,Super Beach,62,49,111
9296,2023-02-11,LEON,brawlBall,Sneaky Fields,22,28,50
9297,2023-02-10,LEON,knockout,Flaring Phoenix,192,154,346
9298,2023-02-10,LEON,hotZone,Controller Chaos,60,52,112
9299,2023-02-10,LEON,heist,Hot Potato,14,3,17
9300,2023-02-10,LEON,gemGrab,Undermine,28,30,58
9301,2023-02-10,LEON,gemGrab,Deep Diner,160,135,295
9302,2023-02-10,LEON,brawlBall,Sneaky Fields,217,198,415
9303,2023-02-10,LEON,brawlBall,Pinhole Punt,14,13,27
9304,2023-02-10,LEON,bounty,Temple Ruins,93,74,167
9305,2023-02-09,LEON,knockout,Riverside,19,12,31
9306,2023-02-09,LEON,hotZone,Open Zone,3,1,4
9307,2023-02-09,LEON,heist,Hot Potato,6,5,11
9308,2023-02-09,LEON,gemGrab,Undermine,34,18,52
9309,2023-02-09,LEON,gemGrab,Gem Fort,7,5,12
9310,2023-02-09,LEON,brawlBall,Sunny Soccer,3,0,3
9311,2023-02-09,LEON,brawlBall,Pinhole Punt,170,164,334
9312,2023-02-09,LEON,bounty,Temple Ruins,36,29,65
9313,2023-02-08,LEON,knockout,Riverside,15,13,28
9314,2023-02-08,LEON,hotZone,Open Zone,9,10,19
9315,2023-02-08,LEON,heist,Safe Zone,2,4,6
9316,2023-02-08,LEON,gemGrab,Gem Fort,21,15,36
9317,2023-02-08,LEON,gemGrab,Crystal Arcade,7,2,9
9318,2023-02-08,LEON,brawlBall,Sunny Soccer,33,23,56
9319,2023-02-08,LEON,brawlBall,Beach Ball,3,4,7
9320,2023-02-08,LEON,bounty,Excel,12,4,16
9321,2023-02-07,LEON,knockout,New Perspective,17,4,21
9322,2023-02-07,LEON,hotZone,Dueling Beetles,4,1,5
9323,2023-02-07,LEON,heist,Safe Zone,1,0,1
9324,2023-02-07,LEON,gemGrab,Minecart Madness,4,10,14
9325,2023-02-07,LEON,gemGrab,Crystal Arcade,3,9,12
9326,2023-02-07,LEON,brawlBall,Center Stage,3,0,3
9327,2023-02-07,LEON,brawlBall,Beach Ball,24,18,42
9328,2023-02-07,LEON,bounty,Excel,9,6,15
9329,2023-02-06,LEON,knockout,New Perspective,278,214,492
9330,2023-02-06,LEON,knockout,Goldarm Gulch,7,9,16
9331,2023-02-06,LEON,hotZone,Dueling Beetles,91,74,165
9332,2023-02-06,LEON,heist,Snaked Assault,25,8,33
9333,2023-02-06,LEON,heist,Pit Stop,3,1,4
9334,2023-02-06,LEON,gemGrab,Minecart Madness,156,123,279
9335,2023-02-06,LEON,gemGrab,Double Swoosh,85,34,119
9336,2023-02-06,LEON,brawlBall,Sneaky Fields,4,1,5
9337,2023-02-06,LEON,brawlBall,Center Stage,382,328,710
9338,2023-02-06,LEON,brawlBall,Backyard Bowl,85,96,181
9339,2023-02-06,LEON,bounty,Layer Cake,118,122,240
9340,2023-02-05,LEON,knockout,X Marks the Spot,136,79,215
9341,2023-02-05,LEON,knockout,Goldarm Gulch,26,26,52
9342,2023-02-05,LEON,hotZone,Ring of Fire,77,110,187
9343,2023-02-05,LEON,heist,Snaked Assault,23,23,46
9344,2023-02-05,LEON,heist,Pit Stop,2,0,2
9345,2023-02-05,LEON,gemGrab,Hard Rock Mine,60,21,81
9346,2023-02-05,LEON,gemGrab,Double Swoosh,231,148,379
9347,2023-02-05,LEON,brawlBall,Super Beach,13,11,24
9348,2023-02-05,LEON,brawlBall,Sneaky Fields,13,6,19
9349,2023-02-05,LEON,brawlBall,Backyard Bowl,1033,1211,2244
9350,2023-02-05,LEON,bounty,Layer Cake,105,113,218
9351,2023-02-04,LEON,knockout,X Marks the Spot,34,28,62
9352,2023-02-04,LEON,knockout,Goldarm Gulch,20,9,29
9353,2023-02-04,LEON,hotZone,Ring of Fire,4,5,9
9354,2023-02-04,LEON,heist,Tornado Ring,7,0,7
9355,2023-02-04,LEON,heist,Pit Stop,1,0,1
9356,2023-02-04,LEON,gemGrab,Hard Rock Mine,49,54,103
9357,2023-02-04,LEON,gemGrab,Double Swoosh,38,6,44
9358,2023-02-04,LEON,gemGrab,Deep Diner,14,14,28
9359,2023-02-04,LEON,brawlBall,Super Beach,93,65,158
9360,2023-02-04,LEON,brawlBall,Sneaky Fields,10,2,12
9361,2023-02-04,LEON,bounty,Dry Season,32,23,55
9362,2023-02-03,LEON,knockout,Out in the Open,209,137,346
9363,2023-02-03,LEON,knockout,Goldarm Gulch,110,75,185
9364,2023-02-03,LEON,hotZone,Split,31,15,46
9365,2023-02-03,LEON,heist,Tornado Ring,26,15,41
9366,2023-02-03,LEON,heist,Pit Stop,8,0,8
9367,2023-02-03,LEON,gemGrab,Undermine,52,30,82
9368,2023-02-03,LEON,gemGrab,Double Swoosh,158,70,228
9369,2023-02-03,LEON,gemGrab,Deep Diner,160,118,278
9370,2023-02-03,LEON,brawlBall,Sneaky Fields,342,238,580
9371,2023-02-03,LEON,brawlBall,Pinhole Punt,27,20,47
9372,2023-02-03,LEON,bounty,Dry Season,141,161,302
9373,2023-02-02,LEON,knockout,Out in the Open,64,66,130
9374,2023-02-02,LEON,hotZone,Split,13,3,16
9375,2023-02-02,LEON,heist,Kaboom Canyon,4,3,7
9376,2023-02-02,LEON,gemGrab,Undermine,29,14,43
9377,2023-02-02,LEON,gemGrab,Gem Fort,8,12,20
9378,2023-02-02,LEON,brawlBall,Sunny Soccer,5,2,7
9379,2023-02-02,LEON,brawlBall,Pinhole Punt,160,154,314
9380,2023-02-02,LEON,bounty,Shooting Star,29,24,53
9381,2023-02-01,LEON,knockout,Goldarm Gulch,297,222,519
9382,2023-02-01,LEON,hotZone,Parallel Plays,90,93,183
9383,2023-02-01,LEON,heist,Kaboom Canyon,15,5,20
9384,2023-02-01,LEON,gemGrab,Gem Fort,134,111,245
9385,2023-02-01,LEON,gemGrab,Crystal Arcade,85,53,138
9386,2023-02-01,LEON,brawlBall,Sunny Soccer,291,234,525
9387,2023-02-01,LEON,brawlBall,Beach Ball,26,27,53
9388,2023-02-01,LEON,bounty,Shooting Star,56,59,115
9389,2023-01-31,LEON,knockout,Goldarm Gulch,131,108,239
9390,2023-01-31,LEON,hotZone,Parallel Plays,74,88,162
9391,2023-01-31,LEON,heist,Pit Stop,6,2,8
9392,2023-01-31,LEON,gemGrab,Minecart Madness,9,12,21
9393,2023-01-31,LEON,gemGrab,Crystal Arcade,89,62,151
9394,2023-01-31,LEON,brawlBall,Center Stage,3,1,4
9395,2023-01-31,LEON,brawlBall,Beach Ball,198,138,336
9396,2023-01-31,LEON,bounty,Hideout,36,37,73
9397,2023-01-30,LEON,knockout,Belle's Rock,215,176,391
9398,2023-01-30,LEON,hotZone,Quarter Pounder,65,34,99
9399,2023-01-30,LEON,heist,Pit Stop,13,2,15
9400,2023-01-30,LEON,gemGrab,Minecart Madness,79,78,157
9401,2023-01-30,LEON,gemGrab,Double Swoosh,84,55,139
9402,2023-01-30,LEON,brawlBall,Center Stage,252,180,432
9403,2023-01-30,LEON,brawlBall,Backyard Bowl,58,80,138
9404,2023-01-30,LEON,bounty,Hideout,64,56,120
9405,2023-01-29,LEON,knockout,Belle's Rock,240,200,440
9406,2023-01-29,LEON,hotZone,Quarter Pounder,36,13,49
9407,2023-01-29,LEON,heist,Bridge Too Far,17,5,22
9408,2023-01-29,LEON,gemGrab,Hard Rock Mine,23,18,41
9409,2023-01-29,LEON,gemGrab,Double Swoosh,122,99,221
9410,2023-01-29,LEON,brawlBall,Super Beach,3,3,6
9411,2023-01-29,LEON,brawlBall,Backyard Bowl,784,848,1632
9412,2023-01-29,LEON,bounty,Canal Grande,47,23,70
9413,2023-01-28,LEON,knockout,Flaring Phoenix,154,101,255
9414,2023-01-28,LEON,hotZone,Controller Chaos,46,12,58
9415,2023-01-28,LEON,heist,Bridge Too Far,32,14,46
9416,2023-01-28,LEON,gemGrab,Hard Rock Mine,202,169,371
9417,2023-01-28,LEON,gemGrab,Deep Diner,76,71,147
9418,2023-01-28,LEON,brawlBall,Super Beach,346,275,621
9419,2023-01-28,LEON,brawlBall,Sneaky Fields,6,8,14
9420,2023-01-28,LEON,bounty,Canal Grande,87,74,161
9421,2023-01-27,LEON,knockout,Flaring Phoenix,73,57,130
9422,2023-01-27,LEON,hotZone,Controller Chaos,16,4,20
9423,2023-01-27,LEON,heist,Hot Potato,7,1,8
9424,2023-01-27,LEON,gemGrab,Undermine,11,12,23
9425,2023-01-27,LEON,gemGrab,Deep Diner,89,75,164
9426,2023-01-27,LEON,brawlBall,Sneaky Fields,84,73,157
9427,2023-01-27,LEON,brawlBall,Pinhole Punt,5,5,10
9428,2023-01-27,LEON,bounty,Temple Ruins,32,18,50
9429,2023-01-26,LEON,knockout,Riverside,180,85,265
9430,2023-01-26,LEON,hotZone,Open Zone,66,36,102
9431,2023-01-26,LEON,heist,Hot Potato,14,3,17
9432,2023-01-26,LEON,gemGrab,Undermine,89,44,133
9433,2023-01-26,LEON,gemGrab,Gem Fort,47,41,88
9434,2023-01-26,LEON,brawlBall,Sunny Soccer,27,5,32
9435,2023-01-26,LEON,brawlBall,Pinhole Punt,501,522,1023
9436,2023-01-26,LEON,bounty,Temple Ruins,64,47,111
9437,2023-01-25,LEON,knockout,Riverside,100,70,170
9438,2023-01-25,LEON,hotZone,Open Zone,32,30,62
9439,2023-01-25,LEON,heist,Safe Zone,18,6,24
9440,2023-01-25,LEON,gemGrab,Gem Fort,51,52,103
9441,2023-01-25,LEON,gemGrab,Crystal Arcade,91,44,135
9442,2023-01-25,LEON,brawlBall,Sunny Soccer,230,189,419
9443,2023-01-25,LEON,brawlBall,Beach Ball,50,23,73
9444,2023-01-25,LEON,bounty,Excel,39,44,83
9445,2023-01-24,LEON,knockout,New Perspective,196,115,311
9446,2023-01-24,LEON,hotZone,Dueling Beetles,38,41,79
9447,2023-01-24,LEON,heist,Safe Zone,25,7,32
9448,2023-01-24,LEON,gemGrab,Minecart Madness,31,23,54
9449,2023-01-24,LEON,gemGrab,Crystal Arcade,153,107,260
9450,2023-01-24,LEON,brawlBall,Center Stage,39,20,59
9451,2023-01-24,LEON,brawlBall,Beach Ball,443,395,838
9452,2023-01-24,LEON,bounty,Excel,66,56,122
9453,2023-01-23,LEON,knockout,New Perspective,265,194,459
9454,2023-01-23,LEON,hotZone,Dueling Beetles,59,49,108
9455,2023-01-23,LEON,heist,Snaked Assault,30,11,41
9456,2023-01-23,LEON,gemGrab,Minecart Madness,129,89,218
9457,2023-01-23,LEON,gemGrab,Double Swoosh,52,22,74
9458,2023-01-23,LEON,brawlBall,Center Stage,404,291,695
9459,2023-01-23,LEON,brawlBall,Backyard Bowl,43,72,115
9460,2023-01-23,LEON,bounty,Layer Cake,114,121,235
9461,2023-01-22,LEON,knockout,X Marks the Spot,83,77,160
9462,2023-01-22,LEON,hotZone,Ring of Fire,46,31,77
9463,2023-01-22,LEON,heist,Snaked Assault,13,4,17
9464,2023-01-22,LEON,gemGrab,Hard Rock Mine,54,37,91
9465,2023-01-22,LEON,gemGrab,Double Swoosh,69,57,126
9466,2023-01-22,LEON,brawlBall,Super Beach,31,20,51
9467,2023-01-22,LEON,brawlBall,Backyard Bowl,367,408,775
9468,2023-01-22,LEON,bounty,Layer Cake,83,75,158
9469,2023-01-21,LEON,knockout,X Marks the Spot,312,252,564
9470,2023-01-21,LEON,hotZone,Ring of Fire,100,136,236
9471,2023-01-21,LEON,heist,Tornado Ring,24,20,44
9472,2023-01-21,LEON,gemGrab,Hard Rock Mine,249,200,449
9473,2023-01-21,LEON,gemGrab,Deep Diner,68,66,134
9474,2023-01-21,LEON,brawlBall,Super Beach,459,300,759
9475,2023-01-21,LEON,brawlBall,Sneaky Fields,16,15,31
9476,2023-01-21,LEON,bounty,Dry Season,108,148,256
9477,2023-01-20,LEON,knockout,Out in the Open,247,182,429
9478,2023-01-20,LEON,hotZone,Split,25,14,39
9479,2023-01-20,LEON,heist,Tornado Ring,15,8,23
9480,2023-01-20,LEON,gemGrab,Undermine,66,42,108
9481,2023-01-20,LEON,gemGrab,Deep Diner,204,194,398
9482,2023-01-20,LEON,brawlBall,Sneaky Fields,301,184,485
9483,2023-01-20,LEON,brawlBall,Pinhole Punt,35,40,75
9484,2023-01-20,LEON,bounty,Dry Season,134,112,246
9485,2023-01-19,LEON,knockout,Out in the Open,260,152,412
9486,2023-01-19,LEON,hotZone,Split,37,19,56
9487,2023-01-19,LEON,heist,Kaboom Canyon,14,12,26
9488,2023-01-19,LEON,gemGrab,Undermine,134,111,245
9489,2023-01-19,LEON,gemGrab,Gem Fort,30,28,58
9490,2023-01-19,LEON,brawlBall,Sunny Soccer,18,5,23
9491,2023-01-19,LEON,brawlBall,Pinhole Punt,547,510,1057
9492,2023-01-19,LEON,bounty,Shooting Star,78,51,129
9493,2023-01-18,LEON,knockout,Goldarm Gulch,41,30,71
9494,2023-01-18,LEON,hotZone,Parallel Plays,7,2,9
9495,2023-01-18,LEON,heist,Kaboom Canyon,4,2,6
9496,2023-01-18,LEON,gemGrab,Gem Fort,37,29,66
9497,2023-01-18,LEON,gemGrab,Crystal Arcade,9,7,16
9498,2023-01-18,LEON,brawlBall,Sunny Soccer,117,79,196
9499,2023-01-18,LEON,brawlBall,Beach Ball,6,0,6
9500,2023-01-18,LEON,bounty,Shooting Star,37,37,74
9501,2023-01-17,LEON,knockout,Goldarm Gulch,37,21,58
9502,2023-01-17,LEON,hotZone,Parallel Plays,12,7,19
9503,2023-01-17,LEON,heist,Pit Stop,1,1,2
9504,2023-01-17,LEON,gemGrab,Minecart Madness,1,1,2
9505,2023-01-17,LEON,gemGrab,Crystal Arcade,5,4,9
9506,2023-01-17,LEON,brawlBall,Center Stage,3,1,4
9507,2023-01-17,LEON,brawlBall,Beach Ball,50,30,80
9508,2023-01-17,LEON,bounty,Hideout,7,8,15
9509,2023-01-16,LEON,knockout,Belle's Rock,9,7,16
9510,2023-01-16,LEON,hotZone,Quarter Pounder,7,14,21
9511,2023-01-16,LEON,heist,Pit Stop,2,0,2
9512,2023-01-16,LEON,gemGrab,Minecart Madness,16,15,31
9513,2023-01-16,LEON,gemGrab,Double Swoosh,6,0,6
9514,2023-01-16,LEON,brawlBall,Center Stage,18,12,30
9515,2023-01-16,LEON,brawlBall,Backyard Bowl,12,0,12
9516,2023-01-16,LEON,bounty,Hideout,11,18,29
9517,2023-01-15,LEON,knockout,Belle's Rock,32,16,48
9518,2023-01-15,LEON,hotZone,Quarter Pounder,11,1,12
9519,2023-01-15,LEON,heist,Bridge Too Far,1,1,2
9520,2023-01-15,LEON,gemGrab,Hard Rock Mine,16,26,42
9521,2023-01-15,LEON,gemGrab,Double Swoosh,14,4,18
9522,2023-01-15,LEON,brawlBall,Super Beach,2,5,7
9523,2023-01-15,LEON,brawlBall,Backyard Bowl,113,111,224
9524,2023-01-15,LEON,bounty,Canal Grande,7,3,10
9525,2023-01-14,LEON,knockout,Flaring Phoenix,12,5,17
9526,2023-01-14,LEON,hotZone,Controller Chaos,8,4,12
9527,2023-01-14,LEON,heist,Bridge Too Far,6,0,6
9528,2023-01-14,LEON,gemGrab,Hard Rock Mine,17,11,28
9529,2023-01-14,LEON,gemGrab,Deep Diner,6,4,10
9530,2023-01-14,LEON,brawlBall,Super Beach,22,10,32
9531,2023-01-14,LEON,brawlBall,Sneaky Fields,2,0,2
9532,2023-01-14,LEON,bounty,Canal Grande,7,5,12
9533,2023-01-13,LEON,knockout,Flaring Phoenix,11,8,19
9534,2023-01-13,LEON,hotZone,Controller Chaos,10,0,10
9535,2023-01-13,LEON,gemGrab,Deep Diner,23,3,26
9536,2023-01-13,LEON,brawlBall,Sneaky Fields,10,2,12
9537,2023-01-13,LEON,brawlBall,Pinhole Punt,0,1,1
9538,2023-01-13,LEON,bounty,Temple Ruins,3,2,5
9539,2023-01-12,LEON,knockout,Riverside,21,9,30
9540,2023-01-12,LEON,hotZone,Open Zone,10,2,12
9541,2023-01-12,LEON,gemGrab,Undermine,5,3,8
9542,2023-01-12,LEON,gemGrab,Gem Fort,1,1,2
9543,2023-01-12,LEON,brawlBall,Sunny Soccer,3,0,3
9544,2023-01-12,LEON,brawlBall,Pinhole Punt,21,10,31
9545,2023-01-11,LEON,knockout,Riverside,1,5,6
9546,2023-01-11,LEON,hotZone,Open Zone,11,30,41
9547,2023-01-11,LEON,gemGrab,Gem Fort,5,2,7
9548,2023-01-11,LEON,brawlBall,Sunny Soccer,16,23,39
9549,2023-01-11,LEON,bounty,Excel,3,3,6
9550,2023-01-10,LEON,knockout,New Perspective,11,11,22
9551,2023-01-10,LEON,hotZone,Dueling Beetles,8,2,10
9552,2023-01-10,LEON,gemGrab,Minecart Madness,7,4,11
9553,2023-01-10,LEON,gemGrab,Crystal Arcade,19,4,23
9554,2023-01-10,LEON,brawlBall,Center Stage,1,0,1
9555,2023-01-10,LEON,brawlBall,Beach Ball,18,11,29
9556,2023-01-10,LEON,bounty,Excel,5,0,5
9557,2023-01-09,LEON,knockout,New Perspective,12,6,18
9558,2023-01-09,LEON,hotZone,Dueling Beetles,9,6,15
9559,2023-01-09,LEON,heist,Snaked Assault,3,1,4
9560,2023-01-09,LEON,gemGrab,Minecart Madness,21,10,31
9561,2023-01-09,LEON,gemGrab,Double Swoosh,7,0,7
9562,2023-01-09,LEON,brawlBall,Center Stage,21,12,33
9563,2023-01-09,LEON,brawlBall,Backyard Bowl,4,0,4
9564,2023-01-09,LEON,bounty,Layer Cake,17,9,26
9565,2023-01-08,LEON,knockout,X Marks the Spot,28,31,59
9566,2023-01-08,LEON,hotZone,Ring of Fire,8,4,12
9567,2023-01-08,LEON,heist,Snaked Assault,3,1,4
9568,2023-01-08,LEON,gemGrab,Hard Rock Mine,4,3,7
9569,2023-01-08,LEON,gemGrab,Double Swoosh,4,0,4
9570,2023-01-08,LEON,brawlBall,Super Beach,4,2,6
9571,2023-01-08,LEON,brawlBall,Backyard Bowl,68,58,126
9572,2023-01-08,LEON,bounty,Layer Cake,0,1,1
9573,2023-01-07,LEON,knockout,X Marks the Spot,5,2,7
9574,2023-01-07,LEON,hotZone,Ring of Fire,1,0,1
9575,2023-01-07,LEON,heist,Tornado Ring,4,0,4
9576,2023-01-07,LEON,gemGrab,Hard Rock Mine,16,16,32
9577,2023-01-07,LEON,gemGrab,Deep Diner,6,2,8
9578,2023-01-07,LEON,brawlBall,Super Beach,8,3,11
9579,2023-01-07,LEON,brawlBall,Sneaky Fields,3,2,5
9580,2023-01-07,LEON,bounty,Dry Season,11,8,19
9581,2023-01-06,LEON,knockout,Out in the Open,11,6,17
9582,2023-01-06,LEON,hotZone,Split,5,0,5
9583,2023-01-06,LEON,heist,Tornado Ring,4,1,5
9584,2023-01-06,LEON,gemGrab,Undermine,5,0,5
9585,2023-01-06,LEON,gemGrab,Deep Diner,18,5,23
9586,2023-01-06,LEON,brawlBall,Sneaky Fields,13,9,22
9587,2023-01-06,LEON,brawlBall,Pinhole Punt,0,2,2
9588,2023-01-06,LEON,bounty,Dry Season,15,29,44
9589,2023-01-05,LEON,knockout,Out in the Open,28,18,46
9590,2023-01-05,LEON,hotZone,Split,5,2,7
9591,2023-01-05,LEON,heist,Kaboom Canyon,1,0,1
9592,2023-01-05,LEON,gemGrab,Undermine,12,6,18
9593,2023-01-05,LEON,gemGrab,Gem Fort,4,1,5
9594,2023-01-05,LEON,brawlBall,Pinhole Punt,56,120,176
9595,2023-01-05,LEON,bounty,Shooting Star,19,6,25
9596,2023-01-04,LEON,knockout,Goldarm Gulch,16,1,17
9597,2023-01-04,LEON,hotZone,Parallel Plays,10,4,14
9598,2023-01-04,LEON,heist,Kaboom Canyon,3,0,3
9599,2023-01-04,LEON,gemGrab,Gem Fort,8,4,12
9600,2023-01-04,LEON,gemGrab,Crystal Arcade,5,1,6
9601,2023-01-04,LEON,brawlBall,Sunny Soccer,15,12,27
9602,2023-01-04,LEON,bounty,Shooting Star,28,5,33
9603,2023-01-03,LEON,knockout,Goldarm Gulch,12,2,14
9604,2023-01-03,LEON,hotZone,Parallel Plays,28,90,118
9605,2023-01-03,LEON,heist,Pit Stop,0,1,1
9606,2023-01-03,LEON,gemGrab,Minecart Madness,4,0,4
9607,2023-01-03,LEON,gemGrab,Crystal Arcade,24,1,25
9608,2023-01-03,LEON,brawlBall,Center Stage,3,0,3
9609,2023-01-03,LEON,brawlBall,Beach Ball,20,16,36
9610,2023-01-03,LEON,bounty,Hideout,23,17,40
9611,2023-01-02,LEON,knockout,Belle's Rock,20,3,23
9612,2023-01-02,LEON,hotZone,Quarter Pounder,12,10,22
9613,2023-01-02,LEON,hotZone,Controller Chaos,0,2,2
9614,2023-01-02,LEON,heist,Pit Stop,2,0,2
9615,2023-01-02,LEON,gemGrab,Minecart Madness,24,5,29
9616,2023-01-02,LEON,gemGrab,Double Swoosh,8,1,9
9617,2023-01-02,LEON,brawlBall,Center Stage,21,11,32
9618,2023-01-02,LEON,brawlBall,Backyard Bowl,5,1,6
9619,2023-01-02,LEON,bounty,Hideout,37,42,79
9620,2023-01-01,LEON,knockout,Belle's Rock,8,5,13
9621,2023-01-01,LEON,hotZone,Quarter Pounder,2,11,13
9622,2023-01-01,LEON,gemGrab,Double Swoosh,8,3,11
9623,2023-01-01,LEON,brawlBall,Backyard Bowl,22,21,43
9624,2023-01-01,LEON,bounty,Canal Grande,1,0,1
9625,2022-12-31,LEON,gemGrab,Hard Rock Mine,2,11,13
9626,2022-12-31,LEON,gemGrab,Deep Diner,5,7,12
9627,2022-12-31,LEON,brawlBall,Super Beach,3,4,7
9628,2022-12-31,LEON,bounty,Canal Grande,1,0,1
9629,2022-12-30,LEON,knockout,Flaring Phoenix,2,0,2
9630,2022-12-30,LEON,hotZone,Controller Chaos,1,0,1
9631,2022-12-30,LEON,gemGrab,Deep Diner,14,7,21
9632,2022-12-30,LEON,brawlBall,Sneaky Fields,4,3,7
9633,2022-12-29,LEON,hotZone,Open Zone,1,0,1
9634,2022-12-29,LEON,gemGrab,Gem Fort,2,1,3
9635,2022-12-29,LEON,brawlBall,Pinhole Punt,3,0,3
9636,2022-12-28,LEON,hotZone,Open Zone,0,1,1
9637,2022-12-28,LEON,gemGrab,Minecart Madness,0,2,2
9638,2022-12-27,LEON,knockout,New Perspective,0,1,1
9639,2022-12-27,LEON,hotZone,Controller Chaos,1,0,1
9640,2022-12-27,LEON,heist,Safe Zone,2,2,4
9641,2022-12-27,LEON,gemGrab,Minecart Madness,1,0,1
9642,2022-12-27,LEON,brawlBall,Beach Ball,14,5,19
9643,2022-12-27,LEON,bounty,Excel,2,1,3
9644,2022-12-25,LEON,brawlBall,Backyard Bowl,1,0,1
9645,2022-12-24,LEON,brawlBall,Super Beach,1,1,2
9646,2022-12-23,LEON,knockout,Out in the Open,2,2,4
9647,2022-12-22,LEON,brawlBall,Pinhole Punt,4,0,4
9648,2022-12-21,LEON,brawlBall,Sunny Soccer,1,0,1
9649,2022-12-20,LEON,brawlBall,Beach Ball,1,2,3
9650,2022-12-19,LEON,gemGrab,Minecart Madness,0,2,2
9651,2022-12-16,LEON,bounty,Temple Ruins,2,0,2
9652,2022-12-13,LEON,knockout,New Perspective,3,0,3
9653,2022-12-13,LEON,gemGrab,Crystal Arcade,6,0,6
9654,2022-12-12,LEON,brawlBall,Center Stage,2,0,2
9655,2022-11-18,LEON,hotZone,Parallel Plays,2,2,4
9656,2022-11-07,LEON,hotZone,Quarter Pounder,2,0,2
9657,2022-11-01,LEON,knockout,New Perspective,0,2,2
9658,2022-10-26,LEON,bounty,Shooting Star,1,3,4
9659,2022-10-15,LEON,gemGrab,Hard Rock Mine,2,2,4
9660,2022-09-07,LEON,brawlBall,Sunny Soccer,2,0,2
9661,2023-02-11,JESSIE,knockout,Flaring Phoenix,10,10,20
9662,2023-02-11,JESSIE,hotZone,Controller Chaos,139,178,317
9663,2023-02-11,JESSIE,gemGrab,Deep Diner,72,69,141
9664,2023-02-11,JESSIE,brawlBall,Super Beach,63,59,122
9665,2023-02-11,JESSIE,brawlBall,Sneaky Fields,43,48,91
9666,2023-02-10,JESSIE,knockout,Flaring Phoenix,34,22,56
9667,2023-02-10,JESSIE,hotZone,Controller Chaos,162,146,308
9668,2023-02-10,JESSIE,heist,Hot Potato,265,180,445
9669,2023-02-10,JESSIE,gemGrab,Undermine,23,16,39
9670,2023-02-10,JESSIE,gemGrab,Deep Diner,141,109,250
9671,2023-02-10,JESSIE,brawlBall,Sneaky Fields,274,323,597
9672,2023-02-10,JESSIE,brawlBall,Pinhole Punt,4,3,7
9673,2023-02-10,JESSIE,bounty,Temple Ruins,19,16,35
9674,2023-02-09,JESSIE,knockout,Riverside,3,3,6
9675,2023-02-09,JESSIE,hotZone,Open Zone,12,6,18
9676,2023-02-09,JESSIE,heist,Hot Potato,83,61,144
9677,2023-02-09,JESSIE,gemGrab,Undermine,23,19,42
9678,2023-02-09,JESSIE,gemGrab,Gem Fort,2,2,4
9679,2023-02-09,JESSIE,brawlBall,Sunny Soccer,0,8,8
9680,2023-02-09,JESSIE,brawlBall,Pinhole Punt,59,80,139
9681,2023-02-09,JESSIE,bounty,Temple Ruins,7,4,11
9682,2023-02-08,JESSIE,knockout,Riverside,1,0,1
9683,2023-02-08,JESSIE,hotZone,Open Zone,14,7,21
9684,2023-02-08,JESSIE,heist,Safe Zone,38,35,73
9685,2023-02-08,JESSIE,gemGrab,Gem Fort,17,15,32
9686,2023-02-08,JESSIE,gemGrab,Crystal Arcade,2,3,5
9687,2023-02-08,JESSIE,brawlBall,Sunny Soccer,29,22,51
9688,2023-02-08,JESSIE,bounty,Excel,5,1,6
9689,2023-02-07,JESSIE,knockout,New Perspective,1,0,1
9690,2023-02-07,JESSIE,hotZone,Dueling Beetles,29,9,38
9691,2023-02-07,JESSIE,heist,Safe Zone,15,11,26
9692,2023-02-07,JESSIE,gemGrab,Minecart Madness,8,1,9
9693,2023-02-07,JESSIE,gemGrab,Crystal Arcade,7,9,16
9694,2023-02-07,JESSIE,brawlBall,Center Stage,3,1,4
9695,2023-02-07,JESSIE,brawlBall,Beach Ball,14,11,25
9696,2023-02-07,JESSIE,bounty,Excel,0,1,1
9697,2023-02-06,JESSIE,knockout,New Perspective,24,19,43
9698,2023-02-06,JESSIE,knockout,Goldarm Gulch,1,1,2
9699,2023-02-06,JESSIE,hotZone,Dueling Beetles,301,216,517
9700,2023-02-06,JESSIE,heist,Snaked Assault,518,320,838
9701,2023-02-06,JESSIE,heist,Pit Stop,25,16,41
9702,2023-02-06,JESSIE,gemGrab,Minecart Madness,158,123,281
9703,2023-02-06,JESSIE,gemGrab,Double Swoosh,115,88,203
9704,2023-02-06,JESSIE,brawlBall,Sneaky Fields,10,2,12
9705,2023-02-06,JESSIE,brawlBall,Center Stage,258,227,485
9706,2023-02-06,JESSIE,brawlBall,Backyard Bowl,28,26,54
9707,2023-02-06,JESSIE,bounty,Layer Cake,31,9,40
9708,2023-02-05,JESSIE,knockout,X Marks the Spot,23,14,37
9709,2023-02-05,JESSIE,knockout,Goldarm Gulch,2,0,2
9710,2023-02-05,JESSIE,hotZone,Ring of Fire,118,88,206
9711,2023-02-05,JESSIE,heist,Snaked Assault,633,400,1033
9712,2023-02-05,JESSIE,heist,Pit Stop,105,42,147
9713,2023-02-05,JESSIE,gemGrab,Hard Rock Mine,28,17,45
9714,2023-02-05,JESSIE,gemGrab,Double Swoosh,309,256,565
9715,2023-02-05,JESSIE,brawlBall,Super Beach,7,15,22
9716,2023-02-05,JESSIE,brawlBall,Sneaky Fields,53,18,71
9717,2023-02-05,JESSIE,brawlBall,Backyard Bowl,327,331,658
9718,2023-02-05,JESSIE,bounty,Layer Cake,20,9,29
9719,2023-02-04,JESSIE,knockout,X Marks the Spot,8,6,14
9720,2023-02-04,JESSIE,knockout,Goldarm Gulch,3,4,7
9721,2023-02-04,JESSIE,hotZone,Ring of Fire,20,19,39
9722,2023-02-04,JESSIE,heist,Tornado Ring,61,55,116
9723,2023-02-04,JESSIE,heist,Pit Stop,68,17,85
9724,2023-02-04,JESSIE,gemGrab,Hard Rock Mine,36,9,45
9725,2023-02-04,JESSIE,gemGrab,Double Swoosh,58,27,85
9726,2023-02-04,JESSIE,gemGrab,Deep Diner,9,9,18
9727,2023-02-04,JESSIE,brawlBall,Super Beach,108,115,223
9728,2023-02-04,JESSIE,brawlBall,Sneaky Fields,20,12,32
9729,2023-02-04,JESSIE,bounty,Dry Season,3,2,5
9730,2023-02-03,JESSIE,knockout,Out in the Open,37,13,50
9731,2023-02-03,JESSIE,knockout,Goldarm Gulch,4,3,7
9732,2023-02-03,JESSIE,hotZone,Split,33,10,43
9733,2023-02-03,JESSIE,heist,Tornado Ring,384,271,655
9734,2023-02-03,JESSIE,heist,Pit Stop,397,119,516
9735,2023-02-03,JESSIE,gemGrab,Undermine,28,34,62
9736,2023-02-03,JESSIE,gemGrab,Double Swoosh,255,49,304
9737,2023-02-03,JESSIE,gemGrab,Deep Diner,169,160,329
9738,2023-02-03,JESSIE,brawlBall,Sneaky Fields,411,376,787
9739,2023-02-03,JESSIE,brawlBall,Pinhole Punt,8,17,25
9740,2023-02-03,JESSIE,bounty,Dry Season,23,12,35
9741,2023-02-02,JESSIE,knockout,Out in the Open,19,9,28
9742,2023-02-02,JESSIE,hotZone,Split,21,13,34
9743,2023-02-02,JESSIE,heist,Kaboom Canyon,60,39,99
9744,2023-02-02,JESSIE,gemGrab,Undermine,31,21,52
9745,2023-02-02,JESSIE,gemGrab,Gem Fort,9,9,18
9746,2023-02-02,JESSIE,brawlBall,Sunny Soccer,1,1,2
9747,2023-02-02,JESSIE,brawlBall,Pinhole Punt,98,93,191
9748,2023-02-02,JESSIE,bounty,Shooting Star,5,1,6
9749,2023-02-01,JESSIE,knockout,Goldarm Gulch,30,24,54
9750,2023-02-01,JESSIE,hotZone,Parallel Plays,120,123,243
9751,2023-02-01,JESSIE,heist,Kaboom Canyon,167,144,311
9752,2023-02-01,JESSIE,gemGrab,Gem Fort,126,127,253
9753,2023-02-01,JESSIE,gemGrab,Crystal Arcade,74,57,131
9754,2023-02-01,JESSIE,brawlBall,Sunny Soccer,247,217,464
9755,2023-02-01,JESSIE,brawlBall,Beach Ball,4,7,11
9756,2023-02-01,JESSIE,bounty,Shooting Star,7,7,14
9757,2023-01-31,JESSIE,knockout,Goldarm Gulch,15,14,29
9758,2023-01-31,JESSIE,hotZone,Parallel Plays,75,67,142
9759,2023-01-31,JESSIE,heist,Pit Stop,66,47,113
9760,2023-01-31,JESSIE,gemGrab,Minecart Madness,12,9,21
9761,2023-01-31,JESSIE,gemGrab,Crystal Arcade,52,30,82
9762,2023-01-31,JESSIE,brawlBall,Center Stage,4,2,6
9763,2023-01-31,JESSIE,brawlBall,Beach Ball,145,152,297
9764,2023-01-31,JESSIE,bounty,Hideout,4,4,8
9765,2023-01-30,JESSIE,knockout,Belle's Rock,34,18,52
9766,2023-01-30,JESSIE,hotZone,Quarter Pounder,236,120,356
9767,2023-01-30,JESSIE,heist,Pit Stop,120,77,197
9768,2023-01-30,JESSIE,gemGrab,Minecart Madness,98,76,174
9769,2023-01-30,JESSIE,gemGrab,Double Swoosh,84,57,141
9770,2023-01-30,JESSIE,brawlBall,Center Stage,162,211,373
9771,2023-01-30,JESSIE,brawlBall,Backyard Bowl,30,18,48
9772,2023-01-30,JESSIE,bounty,Hideout,9,8,17
9773,2023-01-29,JESSIE,knockout,Belle's Rock,33,10,43
9774,2023-01-29,JESSIE,hotZone,Quarter Pounder,121,50,171
9775,2023-01-29,JESSIE,heist,Bridge Too Far,176,101,277
9776,2023-01-29,JESSIE,gemGrab,Hard Rock Mine,19,8,27
9777,2023-01-29,JESSIE,gemGrab,Double Swoosh,117,134,251
9778,2023-01-29,JESSIE,brawlBall,Super Beach,12,12,24
9779,2023-01-29,JESSIE,brawlBall,Backyard Bowl,294,267,561
9780,2023-01-29,JESSIE,bounty,Canal Grande,9,8,17
9781,2023-01-28,JESSIE,knockout,Flaring Phoenix,15,11,26
9782,2023-01-28,JESSIE,hotZone,Controller Chaos,132,116,248
9783,2023-01-28,JESSIE,heist,Bridge Too Far,319,251,570
9784,2023-01-28,JESSIE,gemGrab,Hard Rock Mine,96,69,165
9785,2023-01-28,JESSIE,gemGrab,Deep Diner,61,44,105
9786,2023-01-28,JESSIE,brawlBall,Super Beach,416,489,905
9787,2023-01-28,JESSIE,brawlBall,Sneaky Fields,5,6,11
9788,2023-01-28,JESSIE,bounty,Canal Grande,28,8,36
9789,2023-01-27,JESSIE,knockout,Flaring Phoenix,9,6,15
9790,2023-01-27,JESSIE,hotZone,Controller Chaos,20,31,51
9791,2023-01-27,JESSIE,heist,Hot Potato,117,82,199
9792,2023-01-27,JESSIE,gemGrab,Undermine,5,4,9
9793,2023-01-27,JESSIE,gemGrab,Deep Diner,57,40,97
9794,2023-01-27,JESSIE,brawlBall,Sneaky Fields,77,78,155
9795,2023-01-27,JESSIE,brawlBall,Pinhole Punt,2,0,2
9796,2023-01-27,JESSIE,bounty,Temple Ruins,3,1,4
9797,2023-01-26,JESSIE,knockout,Riverside,29,20,49
9798,2023-01-26,JESSIE,hotZone,Open Zone,96,57,153
9799,2023-01-26,JESSIE,heist,Hot Potato,299,223,522
9800,2023-01-26,JESSIE,gemGrab,Undermine,70,75,145
9801,2023-01-26,JESSIE,gemGrab,Gem Fort,54,33,87
9802,2023-01-26,JESSIE,brawlBall,Sunny Soccer,22,18,40
9803,2023-01-26,JESSIE,brawlBall,Pinhole Punt,281,309,590
9804,2023-01-26,JESSIE,bounty,Temple Ruins,13,9,22
9805,2023-01-25,JESSIE,knockout,Riverside,12,6,18
9806,2023-01-25,JESSIE,hotZone,Open Zone,51,42,93
9807,2023-01-25,JESSIE,heist,Safe Zone,261,160,421
9808,2023-01-25,JESSIE,gemGrab,Gem Fort,50,44,94
9809,2023-01-25,JESSIE,gemGrab,Crystal Arcade,69,91,160
9810,2023-01-25,JESSIE,brawlBall,Sunny Soccer,205,216,421
9811,2023-01-25,JESSIE,brawlBall,Beach Ball,25,26,51
9812,2023-01-25,JESSIE,bounty,Excel,9,4,13
9813,2023-01-24,JESSIE,knockout,New Perspective,32,39,71
9814,2023-01-24,JESSIE,hotZone,Dueling Beetles,138,121,259
9815,2023-01-24,JESSIE,heist,Safe Zone,432,297,729
9816,2023-01-24,JESSIE,gemGrab,Minecart Madness,23,12,35
9817,2023-01-24,JESSIE,gemGrab,Crystal Arcade,95,67,162
9818,2023-01-24,JESSIE,brawlBall,Center Stage,27,20,47
9819,2023-01-24,JESSIE,brawlBall,Beach Ball,277,274,551
9820,2023-01-24,JESSIE,bounty,Excel,10,4,14
9821,2023-01-23,JESSIE,knockout,New Perspective,35,19,54
9822,2023-01-23,JESSIE,hotZone,Dueling Beetles,214,137,351
9823,2023-01-23,JESSIE,heist,Snaked Assault,621,343,964
9824,2023-01-23,JESSIE,gemGrab,Minecart Madness,115,79,194
9825,2023-01-23,JESSIE,gemGrab,Double Swoosh,66,63,129
9826,2023-01-23,JESSIE,brawlBall,Center Stage,270,234,504
9827,2023-01-23,JESSIE,brawlBall,Backyard Bowl,24,11,35
9828,2023-01-23,JESSIE,bounty,Layer Cake,19,8,27
9829,2023-01-22,JESSIE,knockout,X Marks the Spot,16,5,21
9830,2023-01-22,JESSIE,hotZone,Ring of Fire,66,39,105
9831,2023-01-22,JESSIE,heist,Snaked Assault,236,151,387
9832,2023-01-22,JESSIE,gemGrab,Hard Rock Mine,24,15,39
9833,2023-01-22,JESSIE,gemGrab,Double Swoosh,74,66,140
9834,2023-01-22,JESSIE,brawlBall,Super Beach,41,45,86
9835,2023-01-22,JESSIE,brawlBall,Backyard Bowl,143,104,247
9836,2023-01-22,JESSIE,bounty,Layer Cake,8,3,11
9837,2023-01-21,JESSIE,knockout,X Marks the Spot,45,18,63
9838,2023-01-21,JESSIE,hotZone,Ring of Fire,174,129,303
9839,2023-01-21,JESSIE,heist,Tornado Ring,365,213,578
9840,2023-01-21,JESSIE,gemGrab,Hard Rock Mine,173,103,276
9841,2023-01-21,JESSIE,gemGrab,Deep Diner,49,61,110
9842,2023-01-21,JESSIE,brawlBall,Super Beach,490,670,1160
9843,2023-01-21,JESSIE,brawlBall,Sneaky Fields,14,10,24
9844,2023-01-21,JESSIE,bounty,Dry Season,19,9,28
9845,2023-01-20,JESSIE,knockout,Out in the Open,44,35,79
9846,2023-01-20,JESSIE,hotZone,Split,40,15,55
9847,2023-01-20,JESSIE,heist,Tornado Ring,313,236,549
9848,2023-01-20,JESSIE,gemGrab,Undermine,39,40,79
9849,2023-01-20,JESSIE,gemGrab,Deep Diner,189,169,358
9850,2023-01-20,JESSIE,brawlBall,Sneaky Fields,234,258,492
9851,2023-01-20,JESSIE,brawlBall,Pinhole Punt,23,29,52
9852,2023-01-20,JESSIE,bounty,Dry Season,10,15,25
9853,2023-01-19,JESSIE,knockout,Out in the Open,57,25,82
9854,2023-01-19,JESSIE,hotZone,Split,62,23,85
9855,2023-01-19,JESSIE,heist,Kaboom Canyon,211,163,374
9856,2023-01-19,JESSIE,gemGrab,Undermine,113,75,188
9857,2023-01-19,JESSIE,gemGrab,Gem Fort,27,16,43
9858,2023-01-19,JESSIE,brawlBall,Sunny Soccer,8,10,18
9859,2023-01-19,JESSIE,brawlBall,Pinhole Punt,334,334,668
9860,2023-01-19,JESSIE,bounty,Shooting Star,13,3,16
9861,2023-01-18,JESSIE,knockout,Goldarm Gulch,4,7,11
9862,2023-01-18,JESSIE,hotZone,Parallel Plays,13,14,27
9863,2023-01-18,JESSIE,heist,Kaboom Canyon,70,46,116
9864,2023-01-18,JESSIE,gemGrab,Gem Fort,34,31,65
9865,2023-01-18,JESSIE,gemGrab,Crystal Arcade,13,1,14
9866,2023-01-18,JESSIE,brawlBall,Sunny Soccer,86,89,175
9867,2023-01-18,JESSIE,brawlBall,Beach Ball,2,2,4
9868,2023-01-18,JESSIE,bounty,Shooting Star,5,5,10
9869,2023-01-17,JESSIE,knockout,Goldarm Gulch,3,0,3
9870,2023-01-17,JESSIE,hotZone,Parallel Plays,16,13,29
9871,2023-01-17,JESSIE,heist,Pit Stop,22,8,30
9872,2023-01-17,JESSIE,gemGrab,Minecart Madness,1,3,4
9873,2023-01-17,JESSIE,gemGrab,Crystal Arcade,7,4,11
9874,2023-01-17,JESSIE,brawlBall,Beach Ball,28,29,57
9875,2023-01-17,JESSIE,bounty,Hideout,2,0,2
9876,2023-01-16,JESSIE,knockout,Belle's Rock,7,1,8
9877,2023-01-16,JESSIE,hotZone,Quarter Pounder,20,4,24
9878,2023-01-16,JESSIE,heist,Pit Stop,30,16,46
9879,2023-01-16,JESSIE,gemGrab,Minecart Madness,16,12,28
9880,2023-01-16,JESSIE,gemGrab,Double Swoosh,5,3,8
9881,2023-01-16,JESSIE,brawlBall,Center Stage,14,12,26
9882,2023-01-16,JESSIE,brawlBall,Backyard Bowl,2,0,2
9883,2023-01-16,JESSIE,bounty,Hideout,0,1,1
9884,2023-01-15,JESSIE,knockout,Belle's Rock,4,4,8
9885,2023-01-15,JESSIE,hotZone,Quarter Pounder,38,12,50
9886,2023-01-15,JESSIE,heist,Bridge Too Far,58,30,88
9887,2023-01-15,JESSIE,gemGrab,Hard Rock Mine,5,1,6
9888,2023-01-15,JESSIE,gemGrab,Double Swoosh,14,15,29
9889,2023-01-15,JESSIE,brawlBall,Super Beach,5,2,7
9890,2023-01-15,JESSIE,brawlBall,Backyard Bowl,31,38,69
9891,2023-01-15,JESSIE,bounty,Canal Grande,3,0,3
9892,2023-01-14,JESSIE,knockout,Flaring Phoenix,2,0,2
9893,2023-01-14,JESSIE,hotZone,Controller Chaos,26,15,41
9894,2023-01-14,JESSIE,heist,Bridge Too Far,44,19,63
9895,2023-01-14,JESSIE,gemGrab,Hard Rock Mine,8,3,11
9896,2023-01-14,JESSIE,gemGrab,Deep Diner,8,6,14
9897,2023-01-14,JESSIE,brawlBall,Super Beach,45,56,101
9898,2023-01-14,JESSIE,brawlBall,Sneaky Fields,3,1,4
9899,2023-01-14,JESSIE,bounty,Canal Grande,1,1,2
9900,2023-01-13,JESSIE,knockout,Flaring Phoenix,3,1,4
9901,2023-01-13,JESSIE,hotZone,Controller Chaos,25,6,31
9902,2023-01-13,JESSIE,heist,Hot Potato,16,20,36
9903,2023-01-13,JESSIE,gemGrab,Undermine,1,0,1
9904,2023-01-13,JESSIE,gemGrab,Deep Diner,13,6,19
9905,2023-01-13,JESSIE,brawlBall,Sneaky Fields,15,32,47
9906,2023-01-13,JESSIE,brawlBall,Pinhole Punt,1,0,1
9907,2023-01-13,JESSIE,bounty,Temple Ruins,1,0,1
9908,2023-01-12,JESSIE,knockout,Riverside,4,0,4
9909,2023-01-12,JESSIE,hotZone,Open Zone,21,1,22
9910,2023-01-12,JESSIE,heist,Hot Potato,8,3,11
9911,2023-01-12,JESSIE,gemGrab,Undermine,2,1,3
9912,2023-01-12,JESSIE,brawlBall,Sunny Soccer,0,1,1
9913,2023-01-12,JESSIE,brawlBall,Pinhole Punt,12,26,38
9914,2023-01-11,JESSIE,knockout,Riverside,1,0,1
9915,2023-01-11,JESSIE,hotZone,Open Zone,1,2,3
9916,2023-01-11,JESSIE,heist,Safe Zone,2,1,3
9917,2023-01-11,JESSIE,gemGrab,Gem Fort,4,1,5
9918,2023-01-11,JESSIE,brawlBall,Sunny Soccer,5,8,13
9919,2023-01-10,JESSIE,hotZone,Dueling Beetles,35,28,63
9920,2023-01-10,JESSIE,heist,Safe Zone,34,8,42
9921,2023-01-10,JESSIE,gemGrab,Minecart Madness,8,5,13
9922,2023-01-10,JESSIE,gemGrab,Crystal Arcade,6,1,7
9923,2023-01-10,JESSIE,brawlBall,Center Stage,3,1,4
9924,2023-01-10,JESSIE,brawlBall,Beach Ball,13,18,31
9925,2023-01-09,JESSIE,knockout,New Perspective,1,0,1
9926,2023-01-09,JESSIE,hotZone,Dueling Beetles,11,13,24
9927,2023-01-09,JESSIE,heist,Snaked Assault,77,49,126
9928,2023-01-09,JESSIE,gemGrab,Minecart Madness,16,10,26
9929,2023-01-09,JESSIE,gemGrab,Double Swoosh,7,2,9
9930,2023-01-09,JESSIE,brawlBall,Center Stage,10,1,11
9931,2023-01-09,JESSIE,brawlBall,Backyard Bowl,1,1,2
9932,2023-01-09,JESSIE,bounty,Layer Cake,0,1,1
9933,2023-01-08,JESSIE,knockout,X Marks the Spot,2,0,2
9934,2023-01-08,JESSIE,hotZone,Ring of Fire,27,2,29
9935,2023-01-08,JESSIE,heist,Snaked Assault,38,19,57
9936,2023-01-08,JESSIE,gemGrab,Hard Rock Mine,6,1,7
9937,2023-01-08,JESSIE,gemGrab,Double Swoosh,8,10,18
9938,2023-01-08,JESSIE,brawlBall,Super Beach,4,10,14
9939,2023-01-08,JESSIE,brawlBall,Backyard Bowl,19,14,33
9940,2023-01-08,JESSIE,bounty,Layer Cake,1,0,1
9941,2023-01-07,JESSIE,hotZone,Ring of Fire,8,2,10
9942,2023-01-07,JESSIE,heist,Tornado Ring,27,10,37
9943,2023-01-07,JESSIE,gemGrab,Hard Rock Mine,8,4,12
9944,2023-01-07,JESSIE,gemGrab,Deep Diner,13,7,20
9945,2023-01-07,JESSIE,brawlBall,Super Beach,15,23,38
9946,2023-01-07,JESSIE,brawlBall,Sneaky Fields,1,0,1
9947,2023-01-07,JESSIE,bounty,Dry Season,2,0,2
9948,2023-01-06,JESSIE,knockout,Out in the Open,3,1,4
9949,2023-01-06,JESSIE,hotZone,Split,4,0,4
9950,2023-01-06,JESSIE,heist,Tornado Ring,42,31,73
9951,2023-01-06,JESSIE,gemGrab,Undermine,1,3,4
9952,2023-01-06,JESSIE,gemGrab,Deep Diner,18,3,21
9953,2023-01-06,JESSIE,brawlBall,Sneaky Fields,5,7,12
9954,2023-01-06,JESSIE,brawlBall,Pinhole Punt,1,1,2
9955,2023-01-06,JESSIE,bounty,Dry Season,1,0,1
9956,2023-01-05,JESSIE,knockout,Out in the Open,2,1,3
9957,2023-01-05,JESSIE,hotZone,Split,3,1,4
9958,2023-01-05,JESSIE,heist,Kaboom Canyon,40,7,47
9959,2023-01-05,JESSIE,gemGrab,Undermine,20,5,25
9960,2023-01-05,JESSIE,gemGrab,Gem Fort,1,3,4
9961,2023-01-05,JESSIE,brawlBall,Pinhole Punt,17,17,34
9962,2023-01-05,JESSIE,bounty,Shooting Star,1,0,1
9963,2023-01-04,JESSIE,knockout,Goldarm Gulch,1,0,1
9964,2023-01-04,JESSIE,hotZone,Parallel Plays,11,20,31
9965,2023-01-04,JESSIE,heist,Kaboom Canyon,60,40,100
9966,2023-01-04,JESSIE,gemGrab,Gem Fort,12,7,19
9967,2023-01-04,JESSIE,gemGrab,Crystal Arcade,7,4,11
9968,2023-01-04,JESSIE,brawlBall,Sunny Soccer,27,11,38
9969,2023-01-04,JESSIE,brawlBall,Beach Ball,1,0,1
9970,2023-01-04,JESSIE,bounty,Shooting Star,2,1,3
9971,2023-01-03,JESSIE,hotZone,Parallel Plays,16,7,23
9972,2023-01-03,JESSIE,heist,Pit Stop,16,9,25
9973,2023-01-03,JESSIE,gemGrab,Minecart Madness,3,0,3
9974,2023-01-03,JESSIE,gemGrab,Crystal Arcade,17,10,27
9975,2023-01-03,JESSIE,brawlBall,Center Stage,2,0,2
9976,2023-01-03,JESSIE,brawlBall,Beach Ball,21,31,52
9977,2023-01-03,JESSIE,bounty,Hideout,2,0,2
9978,2023-01-02,JESSIE,knockout,Belle's Rock,3,0,3
9979,2023-01-02,JESSIE,hotZone,Quarter Pounder,26,5,31
9980,2023-01-02,JESSIE,hotZone,Controller Chaos,1,0,1
9981,2023-01-02,JESSIE,heist,Pit Stop,38,2,40
9982,2023-01-02,JESSIE,heist,Kaboom Canyon,0,1,1
9983,2023-01-02,JESSIE,gemGrab,Minecart Madness,15,2,17
9984,2023-01-02,JESSIE,gemGrab,Double Swoosh,6,4,10
9985,2023-01-02,JESSIE,brawlBall,Center Stage,18,13,31
9986,2023-01-02,JESSIE,brawlBall,Backyard Bowl,1,0,1
9987,2023-01-02,JESSIE,bounty,Hideout,2,1,3
9988,2023-01-01,JESSIE,knockout,Belle's Rock,1,0,1
9989,2023-01-01,JESSIE,hotZone,Quarter Pounder,10,2,12
9990,2023-01-01,JESSIE,heist,Kaboom Canyon,0,1,1
9991,2023-01-01,JESSIE,heist,Bridge Too Far,4,3,7
9992,2023-01-01,JESSIE,gemGrab,Minecart Madness,2,0,2
9993,2023-01-01,JESSIE,gemGrab,Double Swoosh,6,13,19
9994,2023-01-01,JESSIE,brawlBall,Backyard Bowl,7,10,17
9995,2023-01-01,JESSIE,bounty,Canal Grande,0,2,2
9996,2022-12-31,JESSIE,hotZone,Controller Chaos,3,0,3
9997,2022-12-31,JESSIE,heist,Bridge Too Far,2,0,2
9998,2022-12-31,JESSIE,gemGrab,Hard Rock Mine,1,0,1
9999,2022-12-31,JESSIE,gemGrab,Deep Diner,1,0,1
10000,2022-12-31,JESSIE,brawlBall,Super Beach,3,10,13
10001,2022-12-30,JESSIE,hotZone,Controller Chaos,3,2,5
10002,2022-12-30,JESSIE,gemGrab,Undermine,2,0,2
10003,2022-12-30,JESSIE,gemGrab,Deep Diner,9,1,10
10004,2022-12-30,JESSIE,brawlBall,Sneaky Fields,1,0,1
10005,2022-12-29,JESSIE,brawlBall,Pinhole Punt,2,3,5
10006,2022-12-28,JESSIE,hotZone,Controller Chaos,2,0,2
10007,2022-12-28,JESSIE,heist,Kaboom Canyon,0,2,2
10008,2022-12-27,JESSIE,heist,Safe Zone,2,0,2
10009,2022-12-27,JESSIE,heist,Kaboom Canyon,3,0,3
10010,2022-12-27,JESSIE,brawlBall,Beach Ball,1,1,2
10011,2022-12-26,JESSIE,heist,Kaboom Canyon,3,0,3
10012,2022-12-26,JESSIE,gemGrab,Minecart Madness,1,0,1
10013,2022-12-26,JESSIE,brawlBall,Center Stage,1,0,1
10014,2022-12-24,JESSIE,brawlBall,Super Beach,1,0,1
10015,2022-12-23,JESSIE,knockout,Out in the Open,0,2,2
10016,2022-12-22,JESSIE,brawlBall,Pinhole Punt,1,0,1
10017,2022-12-15,JESSIE,heist,Hot Potato,2,0,2
10018,2022-12-13,JESSIE,heist,Safe Zone,2,3,5
10019,2022-12-12,JESSIE,brawlBall,Center Stage,0,2,2
10020,2022-12-10,JESSIE,knockout,X Marks the Spot,2,0,2
10021,2022-12-10,JESSIE,hotZone,Ring of Fire,0,1,1
10022,2022-11-11,JESSIE,brawlBall,Sneaky Fields,2,0,2
10023,2022-11-01,JESSIE,knockout,New Perspective,2,0,2
10024,2022-10-30,JESSIE,heist,Safe Zone,1,0,1
10025,2022-10-30,JESSIE,brawlBall,Beach Ball,1,0,1
10026,2022-10-30,JESSIE,bounty,Canal Grande,1,0,1
10027,2022-10-15,JESSIE,gemGrab,Hard Rock Mine,0,2,2
10028,2023-02-11,JANET,knockout,Flaring Phoenix,37,27,64
10029,2023-02-11,JANET,hotZone,Controller Chaos,22,68,90
10030,2023-02-11,JANET,gemGrab,Deep Diner,36,41,77
10031,2023-02-11,JANET,brawlBall,Super Beach,25,54,79
10032,2023-02-11,JANET,brawlBall,Sneaky Fields,22,12,34
10033,2023-02-10,JANET,knockout,Flaring Phoenix,60,42,102
10034,2023-02-10,JANET,hotZone,Controller Chaos,32,43,75
10035,2023-02-10,JANET,heist,Hot Potato,3,3,6
10036,2023-02-10,JANET,gemGrab,Undermine,15,20,35
10037,2023-02-10,JANET,gemGrab,Deep Diner,84,79,163
10038,2023-02-10,JANET,brawlBall,Sneaky Fields,199,268,467
10039,2023-02-10,JANET,brawlBall,Pinhole Punt,5,10,15
10040,2023-02-10,JANET,bounty,Temple Ruins,31,45,76
10041,2023-02-09,JANET,knockout,Riverside,6,3,9
10042,2023-02-09,JANET,hotZone,Open Zone,4,3,7
10043,2023-02-09,JANET,heist,Hot Potato,1,0,1
10044,2023-02-09,JANET,gemGrab,Undermine,15,14,29
10045,2023-02-09,JANET,gemGrab,Gem Fort,0,2,2
10046,2023-02-09,JANET,brawlBall,Pinhole Punt,65,106,171
10047,2023-02-09,JANET,bounty,Temple Ruins,17,20,37
10048,2023-02-08,JANET,knockout,Riverside,5,2,7
10049,2023-02-08,JANET,hotZone,Open Zone,4,2,6
10050,2023-02-08,JANET,heist,Safe Zone,3,0,3
10051,2023-02-08,JANET,gemGrab,Gem Fort,8,7,15
10052,2023-02-08,JANET,gemGrab,Crystal Arcade,1,4,5
10053,2023-02-08,JANET,brawlBall,Sunny Soccer,11,14,25
10054,2023-02-08,JANET,brawlBall,Beach Ball,0,1,1
10055,2023-02-08,JANET,bounty,Excel,1,1,2
10056,2023-02-07,JANET,knockout,New Perspective,3,3,6
10057,2023-02-07,JANET,hotZone,Dueling Beetles,9,12,21
10058,2023-02-07,JANET,heist,Safe Zone,1,0,1
10059,2023-02-07,JANET,gemGrab,Minecart Madness,2,3,5
10060,2023-02-07,JANET,gemGrab,Crystal Arcade,1,2,3
10061,2023-02-07,JANET,brawlBall,Center Stage,2,10,12
10062,2023-02-07,JANET,brawlBall,Beach Ball,8,7,15
10063,2023-02-06,JANET,knockout,New Perspective,96,84,180
10064,2023-02-06,JANET,knockout,Goldarm Gulch,5,5,10
10065,2023-02-06,JANET,hotZone,Dueling Beetles,84,103,187
10066,2023-02-06,JANET,heist,Snaked Assault,2,1,3
10067,2023-02-06,JANET,gemGrab,Minecart Madness,68,96,164
10068,2023-02-06,JANET,gemGrab,Double Swoosh,73,173,246
10069,2023-02-06,JANET,brawlBall,Sneaky Fields,5,4,9
10070,2023-02-06,JANET,brawlBall,Center Stage,277,421,698
10071,2023-02-06,JANET,brawlBall,Backyard Bowl,18,21,39
10072,2023-02-06,JANET,bounty,Layer Cake,24,60,84
10073,2023-02-05,JANET,knockout,X Marks the Spot,43,44,87
10074,2023-02-05,JANET,knockout,Goldarm Gulch,22,12,34
10075,2023-02-05,JANET,hotZone,Ring of Fire,48,84,132
10076,2023-02-05,JANET,heist,Snaked Assault,4,1,5
10077,2023-02-05,JANET,heist,Pit Stop,1,0,1
10078,2023-02-05,JANET,gemGrab,Hard Rock Mine,19,21,40
10079,2023-02-05,JANET,gemGrab,Double Swoosh,221,363,584
10080,2023-02-05,JANET,brawlBall,Super Beach,5,5,10
10081,2023-02-05,JANET,brawlBall,Sneaky Fields,16,28,44
10082,2023-02-05,JANET,brawlBall,Backyard Bowl,273,341,614
10083,2023-02-05,JANET,bounty,Layer Cake,28,26,54
10084,2023-02-04,JANET,knockout,X Marks the Spot,16,9,25
10085,2023-02-04,JANET,knockout,Goldarm Gulch,16,11,27
10086,2023-02-04,JANET,hotZone,Ring of Fire,10,21,31
10087,2023-02-04,JANET,heist,Tornado Ring,1,1,2
10088,2023-02-04,JANET,gemGrab,Hard Rock Mine,29,50,79
10089,2023-02-04,JANET,gemGrab,Double Swoosh,15,63,78
10090,2023-02-04,JANET,gemGrab,Deep Diner,11,17,28
10091,2023-02-04,JANET,brawlBall,Super Beach,42,47,89
10092,2023-02-04,JANET,brawlBall,Sneaky Fields,6,15,21
10093,2023-02-04,JANET,bounty,Dry Season,4,4,8
10094,2023-02-03,JANET,knockout,Out in the Open,64,56,120
10095,2023-02-03,JANET,knockout,Goldarm Gulch,79,80,159
10096,2023-02-03,JANET,hotZone,Split,7,20,27
10097,2023-02-03,JANET,heist,Tornado Ring,12,9,21
10098,2023-02-03,JANET,heist,Pit Stop,2,6,8
10099,2023-02-03,JANET,gemGrab,Undermine,21,26,47
10100,2023-02-03,JANET,gemGrab,Double Swoosh,121,360,481
10101,2023-02-03,JANET,gemGrab,Deep Diner,60,102,162
10102,2023-02-03,JANET,brawlBall,Sneaky Fields,222,321,543
10103,2023-02-03,JANET,brawlBall,Pinhole Punt,11,4,15
10104,2023-02-03,JANET,bounty,Dry Season,25,38,63
10105,2023-02-02,JANET,knockout,Out in the Open,26,16,42
10106,2023-02-02,JANET,hotZone,Split,8,14,22
10107,2023-02-02,JANET,heist,Kaboom Canyon,1,0,1
10108,2023-02-02,JANET,gemGrab,Undermine,17,16,33
10109,2023-02-02,JANET,gemGrab,Gem Fort,5,9,14
10110,2023-02-02,JANET,brawlBall,Sunny Soccer,2,0,2
10111,2023-02-02,JANET,brawlBall,Pinhole Punt,71,77,148
10112,2023-02-02,JANET,bounty,Shooting Star,4,4,8
10113,2023-02-01,JANET,knockout,Goldarm Gulch,61,90,151
10114,2023-02-01,JANET,hotZone,Parallel Plays,38,30,68
10115,2023-02-01,JANET,heist,Kaboom Canyon,10,8,18
10116,2023-02-01,JANET,gemGrab,Gem Fort,48,64,112
10117,2023-02-01,JANET,gemGrab,Crystal Arcade,28,32,60
10118,2023-02-01,JANET,brawlBall,Sunny Soccer,103,143,246
10119,2023-02-01,JANET,brawlBall,Beach Ball,8,20,28
10120,2023-02-01,JANET,bounty,Shooting Star,8,14,22
10121,2023-01-31,JANET,knockout,Goldarm Gulch,33,30,63
10122,2023-01-31,JANET,hotZone,Parallel Plays,28,34,62
10123,2023-01-31,JANET,heist,Pit Stop,2,2,4
10124,2023-01-31,JANET,gemGrab,Minecart Madness,0,1,1
10125,2023-01-31,JANET,gemGrab,Crystal Arcade,16,32,48
10126,2023-01-31,JANET,brawlBall,Center Stage,2,2,4
10127,2023-01-31,JANET,brawlBall,Beach Ball,70,93,163
10128,2023-01-31,JANET,bounty,Hideout,4,2,6
10129,2023-01-30,JANET,knockout,Belle's Rock,98,120,218
10130,2023-01-30,JANET,hotZone,Quarter Pounder,26,70,96
10131,2023-01-30,JANET,heist,Pit Stop,3,0,3
10132,2023-01-30,JANET,gemGrab,Minecart Madness,51,71,122
10133,2023-01-30,JANET,gemGrab,Double Swoosh,66,120,186
10134,2023-01-30,JANET,brawlBall,Center Stage,175,187,362
10135,2023-01-30,JANET,brawlBall,Backyard Bowl,10,10,20
10136,2023-01-30,JANET,bounty,Hideout,13,20,33
10137,2023-01-29,JANET,knockout,Belle's Rock,90,100,190
10138,2023-01-29,JANET,hotZone,Quarter Pounder,36,69,105
10139,2023-01-29,JANET,heist,Bridge Too Far,4,3,7
10140,2023-01-29,JANET,gemGrab,Hard Rock Mine,18,22,40
10141,2023-01-29,JANET,gemGrab,Double Swoosh,140,213,353
10142,2023-01-29,JANET,brawlBall,Super Beach,2,5,7
10143,2023-01-29,JANET,brawlBall,Backyard Bowl,188,237,425
10144,2023-01-29,JANET,bounty,Canal Grande,21,61,82
10145,2023-01-28,JANET,knockout,Flaring Phoenix,34,48,82
10146,2023-01-28,JANET,hotZone,Controller Chaos,24,56,80
10147,2023-01-28,JANET,heist,Bridge Too Far,21,10,31
10148,2023-01-28,JANET,gemGrab,Hard Rock Mine,83,133,216
10149,2023-01-28,JANET,gemGrab,Deep Diner,32,43,75
10150,2023-01-28,JANET,brawlBall,Super Beach,146,182,328
10151,2023-01-28,JANET,brawlBall,Sneaky Fields,14,23,37
10152,2023-01-28,JANET,bounty,Canal Grande,45,56,101
10153,2023-01-27,JANET,knockout,Flaring Phoenix,10,10,20
10154,2023-01-27,JANET,hotZone,Controller Chaos,12,13,25
10155,2023-01-27,JANET,heist,Hot Potato,1,1,2
10156,2023-01-27,JANET,gemGrab,Undermine,5,7,12
10157,2023-01-27,JANET,gemGrab,Deep Diner,37,44,81
10158,2023-01-27,JANET,brawlBall,Sneaky Fields,45,65,110
10159,2023-01-27,JANET,brawlBall,Pinhole Punt,0,1,1
10160,2023-01-27,JANET,bounty,Temple Ruins,9,5,14
10161,2023-01-26,JANET,knockout,Riverside,53,25,78
10162,2023-01-26,JANET,hotZone,Open Zone,51,74,125
10163,2023-01-26,JANET,heist,Hot Potato,1,5,6
10164,2023-01-26,JANET,gemGrab,Undermine,53,102,155
10165,2023-01-26,JANET,gemGrab,Gem Fort,17,15,32
10166,2023-01-26,JANET,brawlBall,Sunny Soccer,4,8,12
10167,2023-01-26,JANET,brawlBall,Pinhole Punt,199,270,469
10168,2023-01-26,JANET,bounty,Temple Ruins,27,44,71
10169,2023-01-25,JANET,knockout,Riverside,20,17,37
10170,2023-01-25,JANET,hotZone,Open Zone,29,33,62
10171,2023-01-25,JANET,heist,Safe Zone,4,3,7
10172,2023-01-25,JANET,gemGrab,Gem Fort,27,19,46
10173,2023-01-25,JANET,gemGrab,Crystal Arcade,32,44,76
10174,2023-01-25,JANET,brawlBall,Sunny Soccer,72,86,158
10175,2023-01-25,JANET,brawlBall,Beach Ball,15,27,42
10176,2023-01-25,JANET,bounty,Excel,10,10,20
10177,2023-01-24,JANET,knockout,New Perspective,29,25,54
10178,2023-01-24,JANET,hotZone,Dueling Beetles,60,82,142
10179,2023-01-24,JANET,heist,Safe Zone,7,2,9
10180,2023-01-24,JANET,gemGrab,Minecart Madness,19,39,58
10181,2023-01-24,JANET,gemGrab,Crystal Arcade,56,65,121
10182,2023-01-24,JANET,brawlBall,Center Stage,23,27,50
10183,2023-01-24,JANET,brawlBall,Beach Ball,201,274,475
10184,2023-01-24,JANET,bounty,Excel,23,26,49
10185,2023-01-23,JANET,knockout,New Perspective,75,69,144
10186,2023-01-23,JANET,hotZone,Dueling Beetles,100,151,251
10187,2023-01-23,JANET,heist,Snaked Assault,6,3,9
10188,2023-01-23,JANET,gemGrab,Minecart Madness,116,175,291
10189,2023-01-23,JANET,gemGrab,Double Swoosh,56,72,128
10190,2023-01-23,JANET,brawlBall,Center Stage,299,362,661
10191,2023-01-23,JANET,brawlBall,Backyard Bowl,15,34,49
10192,2023-01-23,JANET,bounty,Layer Cake,35,72,107
10193,2023-01-22,JANET,knockout,X Marks the Spot,32,16,48
10194,2023-01-22,JANET,hotZone,Ring of Fire,19,25,44
10195,2023-01-22,JANET,heist,Snaked Assault,1,3,4
10196,2023-01-22,JANET,gemGrab,Hard Rock Mine,14,9,23
10197,2023-01-22,JANET,gemGrab,Double Swoosh,62,104,166
10198,2023-01-22,JANET,brawlBall,Super Beach,22,23,45
10199,2023-01-22,JANET,brawlBall,Backyard Bowl,100,121,221
10200,2023-01-22,JANET,bounty,Layer Cake,18,14,32
10201,2023-01-21,JANET,knockout,X Marks the Spot,134,103,237
10202,2023-01-21,JANET,hotZone,Ring of Fire,62,67,129
10203,2023-01-21,JANET,heist,Tornado Ring,6,3,9
10204,2023-01-21,JANET,gemGrab,Hard Rock Mine,133,150,283
10205,2023-01-21,JANET,gemGrab,Deep Diner,23,38,61
10206,2023-01-21,JANET,brawlBall,Super Beach,164,161,325
10207,2023-01-21,JANET,brawlBall,Sneaky Fields,7,3,10
10208,2023-01-21,JANET,bounty,Dry Season,27,46,73
10209,2023-01-20,JANET,knockout,Out in the Open,84,79,163
10210,2023-01-20,JANET,hotZone,Split,27,26,53
10211,2023-01-20,JANET,heist,Tornado Ring,4,2,6
10212,2023-01-20,JANET,gemGrab,Undermine,29,23,52
10213,2023-01-20,JANET,gemGrab,Deep Diner,100,126,226
10214,2023-01-20,JANET,brawlBall,Sneaky Fields,172,187,359
10215,2023-01-20,JANET,brawlBall,Pinhole Punt,7,4,11
10216,2023-01-20,JANET,bounty,Dry Season,24,14,38
10217,2023-01-19,JANET,knockout,Out in the Open,90,121,211
10218,2023-01-19,JANET,hotZone,Split,14,7,21
10219,2023-01-19,JANET,heist,Kaboom Canyon,8,3,11
10220,2023-01-19,JANET,gemGrab,Undermine,67,87,154
10221,2023-01-19,JANET,gemGrab,Gem Fort,7,21,28
10222,2023-01-19,JANET,brawlBall,Sunny Soccer,4,2,6
10223,2023-01-19,JANET,brawlBall,Pinhole Punt,246,325,571
10224,2023-01-19,JANET,bounty,Shooting Star,20,22,42
10225,2023-01-18,JANET,knockout,Goldarm Gulch,18,30,48
10226,2023-01-18,JANET,hotZone,Parallel Plays,3,17,20
10227,2023-01-18,JANET,heist,Kaboom Canyon,1,1,2
10228,2023-01-18,JANET,gemGrab,Gem Fort,11,15,26
10229,2023-01-18,JANET,gemGrab,Crystal Arcade,6,7,13
10230,2023-01-18,JANET,brawlBall,Sunny Soccer,58,74,132
10231,2023-01-18,JANET,brawlBall,Beach Ball,3,0,3
10232,2023-01-18,JANET,bounty,Shooting Star,15,17,32
10233,2023-01-17,JANET,knockout,Goldarm Gulch,8,6,14
10234,2023-01-17,JANET,hotZone,Parallel Plays,5,4,9
10235,2023-01-17,JANET,heist,Pit Stop,0,1,1
10236,2023-01-17,JANET,gemGrab,Minecart Madness,1,2,3
10237,2023-01-17,JANET,gemGrab,Crystal Arcade,15,12,27
10238,2023-01-17,JANET,brawlBall,Center Stage,1,0,1
10239,2023-01-17,JANET,brawlBall,Beach Ball,10,13,23
10240,2023-01-17,JANET,bounty,Hideout,3,0,3
10241,2023-01-16,JANET,knockout,Belle's Rock,10,16,26
10242,2023-01-16,JANET,hotZone,Quarter Pounder,4,0,4
10243,2023-01-16,JANET,heist,Pit Stop,0,1,1
10244,2023-01-16,JANET,gemGrab,Minecart Madness,7,7,14
10245,2023-01-16,JANET,gemGrab,Double Swoosh,8,1,9
10246,2023-01-16,JANET,brawlBall,Center Stage,17,37,54
10247,2023-01-16,JANET,brawlBall,Backyard Bowl,2,6,8
10248,2023-01-16,JANET,bounty,Hideout,9,12,21
10249,2023-01-15,JANET,knockout,Belle's Rock,9,24,33
10250,2023-01-15,JANET,hotZone,Quarter Pounder,12,9,21
10251,2023-01-15,JANET,heist,Bridge Too Far,1,0,1
10252,2023-01-15,JANET,gemGrab,Hard Rock Mine,3,0,3
10253,2023-01-15,JANET,gemGrab,Double Swoosh,12,54,66
10254,2023-01-15,JANET,brawlBall,Super Beach,1,0,1
10255,2023-01-15,JANET,brawlBall,Backyard Bowl,26,31,57
10256,2023-01-15,JANET,bounty,Canal Grande,3,3,6
10257,2023-01-14,JANET,knockout,Flaring Phoenix,2,1,3
10258,2023-01-14,JANET,hotZone,Controller Chaos,8,6,14
10259,2023-01-14,JANET,heist,Bridge Too Far,1,0,1
10260,2023-01-14,JANET,gemGrab,Hard Rock Mine,3,6,9
10261,2023-01-14,JANET,gemGrab,Deep Diner,5,1,6
10262,2023-01-14,JANET,brawlBall,Super Beach,12,4,16
10263,2023-01-14,JANET,brawlBall,Sneaky Fields,1,0,1
10264,2023-01-14,JANET,bounty,Canal Grande,1,7,8
10265,2023-01-13,JANET,knockout,Flaring Phoenix,2,3,5
10266,2023-01-13,JANET,hotZone,Controller Chaos,7,5,12
10267,2023-01-13,JANET,heist,Hot Potato,1,0,1
10268,2023-01-13,JANET,gemGrab,Deep Diner,6,6,12
10269,2023-01-13,JANET,brawlBall,Sneaky Fields,13,5,18
10270,2023-01-13,JANET,bounty,Temple Ruins,1,0,1
10271,2023-01-12,JANET,knockout,Riverside,3,0,3
10272,2023-01-12,JANET,hotZone,Open Zone,5,13,18
10273,2023-01-12,JANET,gemGrab,Undermine,7,18,25
10274,2023-01-12,JANET,brawlBall,Sunny Soccer,1,0,1
10275,2023-01-12,JANET,brawlBall,Pinhole Punt,11,30,41
10276,2023-01-12,JANET,bounty,Temple Ruins,1,0,1
10277,2023-01-11,JANET,hotZone,Open Zone,2,7,9
10278,2023-01-11,JANET,gemGrab,Gem Fort,3,1,4
10279,2023-01-11,JANET,brawlBall,Sunny Soccer,1,4,5
10280,2023-01-10,JANET,knockout,New Perspective,5,2,7
10281,2023-01-10,JANET,hotZone,Dueling Beetles,5,4,9
10282,2023-01-10,JANET,heist,Safe Zone,0,1,1
10283,2023-01-10,JANET,gemGrab,Minecart Madness,6,22,28
10284,2023-01-10,JANET,gemGrab,Crystal Arcade,3,20,23
10285,2023-01-10,JANET,brawlBall,Center Stage,3,0,3
10286,2023-01-10,JANET,brawlBall,Beach Ball,10,52,62
10287,2023-01-09,JANET,knockout,New Perspective,3,3,6
10288,2023-01-09,JANET,hotZone,Dueling Beetles,6,0,6
10289,2023-01-09,JANET,gemGrab,Minecart Madness,2,11,13
10290,2023-01-09,JANET,gemGrab,Double Swoosh,8,26,34
10291,2023-01-09,JANET,brawlBall,Center Stage,10,21,31
10292,2023-01-09,JANET,bounty,Layer Cake,3,10,13
10293,2023-01-08,JANET,knockout,X Marks the Spot,17,12,29
10294,2023-01-08,JANET,hotZone,Ring of Fire,1,3,4
10295,2023-01-08,JANET,gemGrab,Hard Rock Mine,4,2,6
10296,2023-01-08,JANET,gemGrab,Double Swoosh,3,8,11
10297,2023-01-08,JANET,brawlBall,Backyard Bowl,13,8,21
10298,2023-01-08,JANET,bounty,Layer Cake,5,15,20
10299,2023-01-07,JANET,knockout,X Marks the Spot,2,0,2
10300,2023-01-07,JANET,hotZone,Ring of Fire,5,2,7
10301,2023-01-07,JANET,heist,Tornado Ring,1,0,1
10302,2023-01-07,JANET,gemGrab,Hard Rock Mine,3,1,4
10303,2023-01-07,JANET,gemGrab,Deep Diner,5,4,9
10304,2023-01-07,JANET,brawlBall,Super Beach,2,5,7
10305,2023-01-07,JANET,bounty,Dry Season,3,8,11
10306,2023-01-06,JANET,knockout,Out in the Open,4,2,6
10307,2023-01-06,JANET,hotZone,Split,1,1,2
10308,2023-01-06,JANET,heist,Tornado Ring,1,0,1
10309,2023-01-06,JANET,gemGrab,Undermine,2,2,4
10310,2023-01-06,JANET,gemGrab,Deep Diner,14,2,16
10311,2023-01-06,JANET,brawlBall,Sneaky Fields,5,3,8
10312,2023-01-06,JANET,brawlBall,Pinhole Punt,1,5,6
10313,2023-01-06,JANET,bounty,Dry Season,3,1,4
10314,2023-01-05,JANET,knockout,Out in the Open,7,27,34
10315,2023-01-05,JANET,hotZone,Split,10,11,21
10316,2023-01-05,JANET,heist,Kaboom Canyon,1,0,1
10317,2023-01-05,JANET,gemGrab,Undermine,13,27,40
10318,2023-01-05,JANET,gemGrab,Gem Fort,1,0,1
10319,2023-01-05,JANET,brawlBall,Sunny Soccer,1,0,1
10320,2023-01-05,JANET,brawlBall,Pinhole Punt,24,40,64
10321,2023-01-05,JANET,bounty,Shooting Star,1,2,3
10322,2023-01-04,JANET,knockout,Goldarm Gulch,3,2,5
10323,2023-01-04,JANET,hotZone,Parallel Plays,4,22,26
10324,2023-01-04,JANET,heist,Kaboom Canyon,4,0,4
10325,2023-01-04,JANET,gemGrab,Gem Fort,6,0,6
10326,2023-01-04,JANET,gemGrab,Crystal Arcade,4,17,21
10327,2023-01-04,JANET,brawlBall,Sunny Soccer,8,5,13
10328,2023-01-04,JANET,bounty,Shooting Star,2,1,3
10329,2023-01-03,JANET,knockout,Goldarm Gulch,3,3,6
10330,2023-01-03,JANET,hotZone,Parallel Plays,14,36,50
10331,2023-01-03,JANET,gemGrab,Minecart Madness,1,2,3
10332,2023-01-03,JANET,gemGrab,Crystal Arcade,11,6,17
10333,2023-01-03,JANET,brawlBall,Center Stage,2,11,13
10334,2023-01-03,JANET,brawlBall,Beach Ball,14,60,74
10335,2023-01-03,JANET,bounty,Hideout,5,15,20
10336,2023-01-02,JANET,knockout,Belle's Rock,6,2,8
10337,2023-01-02,JANET,hotZone,Quarter Pounder,9,18,27
10338,2023-01-02,JANET,heist,Pit Stop,1,0,1
10339,2023-01-02,JANET,heist,Kaboom Canyon,0,1,1
10340,2023-01-02,JANET,gemGrab,Minecart Madness,12,16,28
10341,2023-01-02,JANET,gemGrab,Double Swoosh,10,19,29
10342,2023-01-02,JANET,brawlBall,Center Stage,12,39,51
10343,2023-01-02,JANET,brawlBall,Backyard Bowl,1,1,2
10344,2023-01-02,JANET,bounty,Hideout,5,13,18
10345,2023-01-01,JANET,knockout,Belle's Rock,11,12,23
10346,2023-01-01,JANET,hotZone,Quarter Pounder,7,10,17
10347,2023-01-01,JANET,gemGrab,Double Swoosh,11,9,20
10348,2023-01-01,JANET,brawlBall,Backyard Bowl,10,3,13
10349,2023-01-01,JANET,bounty,Canal Grande,6,8,14
10350,2022-12-31,JANET,hotZone,Controller Chaos,1,0,1
10351,2022-12-31,JANET,gemGrab,Minecart Madness,0,2,2
10352,2022-12-31,JANET,gemGrab,Hard Rock Mine,1,0,1
10353,2022-12-31,JANET,gemGrab,Deep Diner,1,0,1
10354,2022-12-31,JANET,brawlBall,Super Beach,0,1,1
10355,2022-12-31,JANET,bounty,Canal Grande,1,2,3
10356,2022-12-30,JANET,knockout,Flaring Phoenix,0,1,1
10357,2022-12-30,JANET,brawlBall,Sneaky Fields,0,3,3
10358,2022-12-29,JANET,gemGrab,Undermine,1,0,1
10359,2022-12-29,JANET,gemGrab,Minecart Madness,1,0,1
10360,2022-12-29,JANET,gemGrab,Gem Fort,1,1,2
10361,2022-12-28,JANET,hotZone,Open Zone,0,1,1
10362,2022-12-28,JANET,hotZone,Controller Chaos,2,2,4
10363,2022-12-27,JANET,brawlBall,Center Stage,0,1,1
10364,2022-12-25,JANET,gemGrab,Double Swoosh,2,3,5
10365,2022-12-23,JANET,knockout,Out in the Open,2,2,4
10366,2022-12-22,JANET,brawlBall,Pinhole Punt,0,2,2
10367,2022-12-19,JANET,gemGrab,Minecart Madness,0,2,2
10368,2022-12-16,JANET,gemGrab,Undermine,0,2,2
10369,2022-12-13,JANET,gemGrab,Crystal Arcade,1,0,1
10370,2022-10-28,JANET,knockout,Out in the Open,2,2,4
10371,2022-10-28,JANET,hotZone,Dueling Beetles,0,4,4
10372,2022-10-28,JANET,bounty,Canal Grande,0,4,4
10373,2022-10-15,JANET,hotZone,Ring of Fire,0,1,1
10374,2022-09-06,JANET,brawlBall,Beach Ball,2,0,2
10375,2023-02-11,JACKY,knockout,Flaring Phoenix,219,324,543
10376,2023-02-11,JACKY,hotZone,Controller Chaos,19,8,27
10377,2023-02-11,JACKY,gemGrab,Deep Diner,7,5,12
10378,2023-02-11,JACKY,brawlBall,Super Beach,141,157,298
10379,2023-02-11,JACKY,brawlBall,Sneaky Fields,228,240,468
10380,2023-02-10,JACKY,knockout,Flaring Phoenix,461,513,974
10381,2023-02-10,JACKY,hotZone,Controller Chaos,34,12,46
10382,2023-02-10,JACKY,heist,Hot Potato,4,3,7
10383,2023-02-10,JACKY,gemGrab,Undermine,4,4,8
10384,2023-02-10,JACKY,gemGrab,Deep Diner,27,27,54
10385,2023-02-10,JACKY,brawlBall,Sneaky Fields,1942,2236,4178
10386,2023-02-10,JACKY,brawlBall,Pinhole Punt,11,14,25
10387,2023-02-10,JACKY,bounty,Temple Ruins,17,12,29
10388,2023-02-09,JACKY,knockout,Riverside,1,0,1
10389,2023-02-09,JACKY,hotZone,Open Zone,3,6,9
10390,2023-02-09,JACKY,heist,Hot Potato,5,5,10
10391,2023-02-09,JACKY,gemGrab,Undermine,15,23,38
10392,2023-02-09,JACKY,gemGrab,Gem Fort,1,2,3
10393,2023-02-09,JACKY,brawlBall,Sunny Soccer,3,2,5
10394,2023-02-09,JACKY,brawlBall,Pinhole Punt,108,111,219
10395,2023-02-09,JACKY,bounty,Temple Ruins,4,3,7
10396,2023-02-08,JACKY,knockout,Riverside,7,4,11
10397,2023-02-08,JACKY,hotZone,Open Zone,0,1,1
10398,2023-02-08,JACKY,heist,Safe Zone,1,0,1
10399,2023-02-08,JACKY,gemGrab,Gem Fort,7,3,10
10400,2023-02-08,JACKY,gemGrab,Crystal Arcade,1,0,1
10401,2023-02-08,JACKY,brawlBall,Sunny Soccer,42,56,98
10402,2023-02-08,JACKY,brawlBall,Beach Ball,3,4,7
10403,2023-02-08,JACKY,bounty,Excel,2,1,3
10404,2023-02-07,JACKY,knockout,New Perspective,29,80,109
10405,2023-02-07,JACKY,hotZone,Dueling Beetles,13,19,32
10406,2023-02-07,JACKY,gemGrab,Minecart Madness,1,0,1
10407,2023-02-07,JACKY,gemGrab,Crystal Arcade,2,0,2
10408,2023-02-07,JACKY,brawlBall,Center Stage,15,6,21
10409,2023-02-07,JACKY,brawlBall,Beach Ball,29,40,69
10410,2023-02-07,JACKY,bounty,Excel,6,13,19
10411,2023-02-06,JACKY,knockout,New Perspective,533,657,1190
10412,2023-02-06,JACKY,knockout,Goldarm Gulch,56,66,122
10413,2023-02-06,JACKY,hotZone,Dueling Beetles,75,61,136
10414,2023-02-06,JACKY,heist,Snaked Assault,14,1,15
10415,2023-02-06,JACKY,heist,Pit Stop,1,0,1
10416,2023-02-06,JACKY,gemGrab,Minecart Madness,30,21,51
10417,2023-02-06,JACKY,gemGrab,Double Swoosh,64,32,96
10418,2023-02-06,JACKY,brawlBall,Sneaky Fields,130,125,255
10419,2023-02-06,JACKY,brawlBall,Center Stage,1392,1636,3028
10420,2023-02-06,JACKY,brawlBall,Backyard Bowl,5,5,10
10421,2023-02-06,JACKY,bounty,Layer Cake,12,7,19
10422,2023-02-05,JACKY,knockout,X Marks the Spot,287,380,667
10423,2023-02-05,JACKY,knockout,Goldarm Gulch,182,227,409
10424,2023-02-05,JACKY,hotZone,Ring of Fire,22,18,40
10425,2023-02-05,JACKY,heist,Snaked Assault,14,9,23
10426,2023-02-05,JACKY,heist,Pit Stop,1,1,2
10427,2023-02-05,JACKY,gemGrab,Hard Rock Mine,18,23,41
10428,2023-02-05,JACKY,gemGrab,Double Swoosh,180,138,318
10429,2023-02-05,JACKY,brawlBall,Super Beach,20,24,44
10430,2023-02-05,JACKY,brawlBall,Sneaky Fields,353,380,733
10431,2023-02-05,JACKY,brawlBall,Backyard Bowl,169,138,307
10432,2023-02-05,JACKY,bounty,Layer Cake,10,3,13
10433,2023-02-04,JACKY,knockout,X Marks the Spot,101,108,209
10434,2023-02-04,JACKY,knockout,Goldarm Gulch,146,192,338
10435,2023-02-04,JACKY,hotZone,Ring of Fire,1,1,2
10436,2023-02-04,JACKY,heist,Tornado Ring,2,2,4
10437,2023-02-04,JACKY,heist,Pit Stop,3,2,5
10438,2023-02-04,JACKY,gemGrab,Hard Rock Mine,11,7,18
10439,2023-02-04,JACKY,gemGrab,Double Swoosh,30,14,44
10440,2023-02-04,JACKY,gemGrab,Deep Diner,2,2,4
10441,2023-02-04,JACKY,brawlBall,Super Beach,218,240,458
10442,2023-02-04,JACKY,brawlBall,Sneaky Fields,192,178,370
10443,2023-02-04,JACKY,bounty,Dry Season,2,1,3
10444,2023-02-03,JACKY,knockout,Out in the Open,206,337,543
10445,2023-02-03,JACKY,knockout,Goldarm Gulch,585,795,1380
10446,2023-02-03,JACKY,hotZone,Split,42,48,90
10447,2023-02-03,JACKY,heist,Tornado Ring,12,3,15
10448,2023-02-03,JACKY,heist,Pit Stop,13,7,20
10449,2023-02-03,JACKY,gemGrab,Undermine,9,6,15
10450,2023-02-03,JACKY,gemGrab,Double Swoosh,134,44,178
10451,2023-02-03,JACKY,gemGrab,Deep Diner,22,22,44
10452,2023-02-03,JACKY,brawlBall,Sneaky Fields,3053,3208,6261
10453,2023-02-03,JACKY,brawlBall,Pinhole Punt,24,22,46
10454,2023-02-03,JACKY,bounty,Dry Season,10,14,24
10455,2023-02-02,JACKY,knockout,Out in the Open,140,216,356
10456,2023-02-02,JACKY,hotZone,Split,22,31,53
10457,2023-02-02,JACKY,heist,Kaboom Canyon,0,1,1
10458,2023-02-02,JACKY,gemGrab,Undermine,15,8,23
10459,2023-02-02,JACKY,gemGrab,Gem Fort,6,13,19
10460,2023-02-02,JACKY,brawlBall,Sunny Soccer,8,15,23
10461,2023-02-02,JACKY,brawlBall,Pinhole Punt,118,134,252
10462,2023-02-02,JACKY,bounty,Shooting Star,0,1,1
10463,2023-02-01,JACKY,knockout,Goldarm Gulch,341,456,797
10464,2023-02-01,JACKY,hotZone,Parallel Plays,73,60,133
10465,2023-02-01,JACKY,heist,Kaboom Canyon,2,0,2
10466,2023-02-01,JACKY,gemGrab,Gem Fort,56,42,98
10467,2023-02-01,JACKY,gemGrab,Crystal Arcade,13,23,36
10468,2023-02-01,JACKY,brawlBall,Sunny Soccer,621,661,1282
10469,2023-02-01,JACKY,brawlBall,Beach Ball,17,24,41
10470,2023-02-01,JACKY,bounty,Shooting Star,1,0,1
10471,2023-01-31,JACKY,knockout,Goldarm Gulch,251,330,581
10472,2023-01-31,JACKY,hotZone,Parallel Plays,29,32,61
10473,2023-01-31,JACKY,heist,Pit Stop,3,4,7
10474,2023-01-31,JACKY,gemGrab,Crystal Arcade,31,47,78
10475,2023-01-31,JACKY,brawlBall,Center Stage,10,22,32
10476,2023-01-31,JACKY,brawlBall,Beach Ball,276,261,537
10477,2023-01-31,JACKY,bounty,Hideout,2,0,2
10478,2023-01-30,JACKY,knockout,Belle's Rock,129,189,318
10479,2023-01-30,JACKY,hotZone,Quarter Pounder,20,11,31
10480,2023-01-30,JACKY,heist,Pit Stop,7,5,12
10481,2023-01-30,JACKY,gemGrab,Minecart Madness,5,7,12
10482,2023-01-30,JACKY,gemGrab,Double Swoosh,45,34,79
10483,2023-01-30,JACKY,brawlBall,Center Stage,892,1143,2035
10484,2023-01-30,JACKY,brawlBall,Backyard Bowl,17,4,21
10485,2023-01-30,JACKY,bounty,Hideout,3,1,4
10486,2023-01-29,JACKY,knockout,Belle's Rock,303,391,694
10487,2023-01-29,JACKY,hotZone,Quarter Pounder,19,10,29
10488,2023-01-29,JACKY,gemGrab,Hard Rock Mine,17,10,27
10489,2023-01-29,JACKY,gemGrab,Double Swoosh,63,45,108
10490,2023-01-29,JACKY,brawlBall,Super Beach,10,19,29
10491,2023-01-29,JACKY,brawlBall,Backyard Bowl,158,101,259
10492,2023-01-29,JACKY,bounty,Canal Grande,32,52,84
10493,2023-01-28,JACKY,knockout,Flaring Phoenix,171,275,446
10494,2023-01-28,JACKY,hotZone,Controller Chaos,27,7,34
10495,2023-01-28,JACKY,heist,Bridge Too Far,13,4,17
10496,2023-01-28,JACKY,gemGrab,Hard Rock Mine,48,45,93
10497,2023-01-28,JACKY,gemGrab,Deep Diner,7,0,7
10498,2023-01-28,JACKY,brawlBall,Super Beach,957,1120,2077
10499,2023-01-28,JACKY,brawlBall,Sneaky Fields,87,73,160
10500,2023-01-28,JACKY,bounty,Canal Grande,57,76,133
10501,2023-01-27,JACKY,knockout,Flaring Phoenix,101,151,252
10502,2023-01-27,JACKY,hotZone,Controller Chaos,10,7,17
10503,2023-01-27,JACKY,heist,Hot Potato,3,1,4
10504,2023-01-27,JACKY,gemGrab,Undermine,2,1,3
10505,2023-01-27,JACKY,gemGrab,Deep Diner,11,9,20
10506,2023-01-27,JACKY,brawlBall,Sneaky Fields,541,582,1123
10507,2023-01-27,JACKY,brawlBall,Pinhole Punt,3,12,15
10508,2023-01-27,JACKY,bounty,Temple Ruins,2,0,2
10509,2023-01-26,JACKY,knockout,Riverside,6,2,8
10510,2023-01-26,JACKY,hotZone,Open Zone,3,2,5
10511,2023-01-26,JACKY,heist,Hot Potato,18,9,27
10512,2023-01-26,JACKY,gemGrab,Undermine,28,13,41
10513,2023-01-26,JACKY,gemGrab,Gem Fort,18,25,43
10514,2023-01-26,JACKY,brawlBall,Sunny Soccer,38,40,78
10515,2023-01-26,JACKY,brawlBall,Pinhole Punt,394,379,773
10516,2023-01-26,JACKY,bounty,Temple Ruins,17,8,25
10517,2023-01-25,JACKY,knockout,Riverside,7,0,7
10518,2023-01-25,JACKY,hotZone,Open Zone,3,0,3
10519,2023-01-25,JACKY,heist,Safe Zone,4,0,4
10520,2023-01-25,JACKY,gemGrab,Gem Fort,40,21,61
10521,2023-01-25,JACKY,gemGrab,Crystal Arcade,17,13,30
10522,2023-01-25,JACKY,brawlBall,Sunny Soccer,409,538,947
10523,2023-01-25,JACKY,brawlBall,Beach Ball,65,47,112
10524,2023-01-25,JACKY,bounty,Excel,4,6,10
10525,2023-01-24,JACKY,knockout,New Perspective,140,226,366
10526,2023-01-24,JACKY,hotZone,Dueling Beetles,33,18,51
10527,2023-01-24,JACKY,heist,Safe Zone,7,4,11
10528,2023-01-24,JACKY,gemGrab,Minecart Madness,3,2,5
10529,2023-01-24,JACKY,gemGrab,Crystal Arcade,20,33,53
10530,2023-01-24,JACKY,brawlBall,Center Stage,81,93,174
10531,2023-01-24,JACKY,brawlBall,Beach Ball,583,582,1165
10532,2023-01-24,JACKY,bounty,Excel,21,29,50
10533,2023-01-23,JACKY,knockout,New Perspective,455,600,1055
10534,2023-01-23,JACKY,hotZone,Dueling Beetles,50,16,66
10535,2023-01-23,JACKY,heist,Snaked Assault,14,2,16
10536,2023-01-23,JACKY,gemGrab,Minecart Madness,10,8,18
10537,2023-01-23,JACKY,gemGrab,Double Swoosh,45,18,63
10538,2023-01-23,JACKY,brawlBall,Center Stage,1358,1402,2760
10539,2023-01-23,JACKY,brawlBall,Backyard Bowl,6,3,9
10540,2023-01-23,JACKY,bounty,Layer Cake,21,19,40
10541,2023-01-22,JACKY,knockout,X Marks the Spot,191,245,436
10542,2023-01-22,JACKY,hotZone,Ring of Fire,8,7,15
10543,2023-01-22,JACKY,heist,Snaked Assault,6,6,12
10544,2023-01-22,JACKY,gemGrab,Hard Rock Mine,17,17,34
10545,2023-01-22,JACKY,gemGrab,Double Swoosh,51,30,81
10546,2023-01-22,JACKY,brawlBall,Super Beach,101,102,203
10547,2023-01-22,JACKY,brawlBall,Backyard Bowl,68,39,107
10548,2023-01-22,JACKY,bounty,Layer Cake,20,30,50
10549,2023-01-21,JACKY,knockout,X Marks the Spot,740,878,1618
10550,2023-01-21,JACKY,hotZone,Ring of Fire,24,50,74
10551,2023-01-21,JACKY,heist,Tornado Ring,16,10,26
10552,2023-01-21,JACKY,gemGrab,Hard Rock Mine,77,60,137
10553,2023-01-21,JACKY,gemGrab,Deep Diner,19,9,28
10554,2023-01-21,JACKY,brawlBall,Super Beach,1159,1321,2480
10555,2023-01-21,JACKY,brawlBall,Sneaky Fields,91,103,194
10556,2023-01-21,JACKY,bounty,Dry Season,11,5,16
10557,2023-01-20,JACKY,knockout,Out in the Open,295,507,802
10558,2023-01-20,JACKY,hotZone,Split,37,74,111
10559,2023-01-20,JACKY,heist,Tornado Ring,9,8,17
10560,2023-01-20,JACKY,gemGrab,Undermine,11,3,14
10561,2023-01-20,JACKY,gemGrab,Deep Diner,21,15,36
10562,2023-01-20,JACKY,brawlBall,Sneaky Fields,1823,2174,3997
10563,2023-01-20,JACKY,brawlBall,Pinhole Punt,22,19,41
10564,2023-01-20,JACKY,bounty,Dry Season,0,11,11
10565,2023-01-19,JACKY,knockout,Out in the Open,688,995,1683
10566,2023-01-19,JACKY,hotZone,Split,58,46,104
10567,2023-01-19,JACKY,heist,Kaboom Canyon,10,3,13
10568,2023-01-19,JACKY,gemGrab,Undermine,46,23,69
10569,2023-01-19,JACKY,gemGrab,Gem Fort,14,13,27
10570,2023-01-19,JACKY,brawlBall,Sunny Soccer,20,23,43
10571,2023-01-19,JACKY,brawlBall,Pinhole Punt,418,448,866
10572,2023-01-19,JACKY,bounty,Shooting Star,4,0,4
10573,2023-01-18,JACKY,knockout,Goldarm Gulch,49,46,95
10574,2023-01-18,JACKY,hotZone,Parallel Plays,5,7,12
10575,2023-01-18,JACKY,heist,Kaboom Canyon,3,0,3
10576,2023-01-18,JACKY,gemGrab,Gem Fort,14,16,30
10577,2023-01-18,JACKY,gemGrab,Crystal Arcade,2,0,2
10578,2023-01-18,JACKY,brawlBall,Sunny Soccer,182,193,375
10579,2023-01-18,JACKY,brawlBall,Beach Ball,4,7,11
10580,2023-01-18,JACKY,bounty,Shooting Star,1,0,1
10581,2023-01-17,JACKY,knockout,Goldarm Gulch,35,72,107
10582,2023-01-17,JACKY,hotZone,Parallel Plays,6,3,9
10583,2023-01-17,JACKY,heist,Pit Stop,0,1,1
10584,2023-01-17,JACKY,gemGrab,Crystal Arcade,4,5,9
10585,2023-01-17,JACKY,brawlBall,Center Stage,5,9,14
10586,2023-01-17,JACKY,brawlBall,Beach Ball,41,50,91
10587,2023-01-16,JACKY,knockout,Belle's Rock,18,32,50
10588,2023-01-16,JACKY,hotZone,Quarter Pounder,2,0,2
10589,2023-01-16,JACKY,heist,Pit Stop,2,0,2
10590,2023-01-16,JACKY,gemGrab,Minecart Madness,1,1,2
10591,2023-01-16,JACKY,gemGrab,Double Swoosh,5,1,6
10592,2023-01-16,JACKY,brawlBall,Center Stage,104,95,199
10593,2023-01-16,JACKY,brawlBall,Backyard Bowl,1,1,2
10594,2023-01-16,JACKY,bounty,Hideout,2,2,4
10595,2023-01-15,JACKY,knockout,Belle's Rock,31,30,61
10596,2023-01-15,JACKY,hotZone,Quarter Pounder,12,1,13
10597,2023-01-15,JACKY,gemGrab,Hard Rock Mine,5,13,18
10598,2023-01-15,JACKY,gemGrab,Double Swoosh,15,6,21
10599,2023-01-15,JACKY,brawlBall,Super Beach,18,11,29
10600,2023-01-15,JACKY,brawlBall,Backyard Bowl,16,8,24
10601,2023-01-15,JACKY,bounty,Canal Grande,8,7,15
10602,2023-01-14,JACKY,knockout,Flaring Phoenix,20,42,62
10603,2023-01-14,JACKY,hotZone,Controller Chaos,5,2,7
10604,2023-01-14,JACKY,heist,Bridge Too Far,1,0,1
10605,2023-01-14,JACKY,gemGrab,Hard Rock Mine,5,2,7
10606,2023-01-14,JACKY,brawlBall,Super Beach,96,108,204
10607,2023-01-14,JACKY,brawlBall,Sneaky Fields,40,29,69
10608,2023-01-14,JACKY,bounty,Canal Grande,8,13,21
10609,2023-01-13,JACKY,knockout,Flaring Phoenix,13,19,32
10610,2023-01-13,JACKY,hotZone,Controller Chaos,5,0,5
10611,2023-01-13,JACKY,gemGrab,Deep Diner,2,0,2
10612,2023-01-13,JACKY,brawlBall,Sneaky Fields,168,178,346
10613,2023-01-13,JACKY,brawlBall,Pinhole Punt,1,0,1
10614,2023-01-13,JACKY,bounty,Temple Ruins,0,2,2
10615,2023-01-12,JACKY,hotZone,Open Zone,3,0,3
10616,2023-01-12,JACKY,gemGrab,Undermine,4,1,5
10617,2023-01-12,JACKY,gemGrab,Gem Fort,1,0,1
10618,2023-01-12,JACKY,brawlBall,Sunny Soccer,1,0,1
10619,2023-01-12,JACKY,brawlBall,Pinhole Punt,21,11,32
10620,2023-01-11,JACKY,gemGrab,Gem Fort,2,12,14
10621,2023-01-11,JACKY,brawlBall,Sunny Soccer,19,21,40
10622,2023-01-11,JACKY,brawlBall,Beach Ball,1,0,1
10623,2023-01-10,JACKY,knockout,New Perspective,12,12,24
10624,2023-01-10,JACKY,hotZone,Dueling Beetles,8,0,8
10625,2023-01-10,JACKY,gemGrab,Crystal Arcade,6,4,10
10626,2023-01-10,JACKY,brawlBall,Center Stage,16,5,21
10627,2023-01-10,JACKY,brawlBall,Beach Ball,54,17,71
10628,2023-01-10,JACKY,bounty,Excel,1,0,1
10629,2023-01-09,JACKY,knockout,New Perspective,27,28,55
10630,2023-01-09,JACKY,hotZone,Dueling Beetles,11,1,12
10631,2023-01-09,JACKY,heist,Snaked Assault,3,0,3
10632,2023-01-09,JACKY,gemGrab,Minecart Madness,1,0,1
10633,2023-01-09,JACKY,gemGrab,Double Swoosh,3,2,5
10634,2023-01-09,JACKY,brawlBall,Center Stage,110,109,219
10635,2023-01-09,JACKY,brawlBall,Backyard Bowl,1,0,1
10636,2023-01-09,JACKY,bounty,Layer Cake,1,0,1
10637,2023-01-08,JACKY,knockout,X Marks the Spot,41,89,130
10638,2023-01-08,JACKY,hotZone,Ring of Fire,2,0,2
10639,2023-01-08,JACKY,gemGrab,Hard Rock Mine,4,0,4
10640,2023-01-08,JACKY,gemGrab,Double Swoosh,4,0,4
10641,2023-01-08,JACKY,brawlBall,Super Beach,5,8,13
10642,2023-01-08,JACKY,brawlBall,Backyard Bowl,13,3,16
10643,2023-01-08,JACKY,bounty,Layer Cake,0,1,1
10644,2023-01-07,JACKY,knockout,X Marks the Spot,26,35,61
10645,2023-01-07,JACKY,hotZone,Ring of Fire,1,0,1
10646,2023-01-07,JACKY,heist,Tornado Ring,3,0,3
10647,2023-01-07,JACKY,gemGrab,Hard Rock Mine,0,1,1
10648,2023-01-07,JACKY,gemGrab,Deep Diner,2,0,2
10649,2023-01-07,JACKY,brawlBall,Super Beach,44,6,50
10650,2023-01-07,JACKY,brawlBall,Sneaky Fields,13,3,16
10651,2023-01-07,JACKY,bounty,Dry Season,1,1,2
10652,2023-01-06,JACKY,knockout,Out in the Open,44,64,108
10653,2023-01-06,JACKY,hotZone,Split,6,0,6
10654,2023-01-06,JACKY,heist,Tornado Ring,1,2,3
10655,2023-01-06,JACKY,gemGrab,Undermine,0,1,1
10656,2023-01-06,JACKY,gemGrab,Deep Diner,1,2,3
10657,2023-01-06,JACKY,brawlBall,Sneaky Fields,142,88,230
10658,2023-01-06,JACKY,brawlBall,Pinhole Punt,4,1,5
10659,2023-01-06,JACKY,bounty,Dry Season,2,2,4
10660,2023-01-05,JACKY,knockout,Out in the Open,66,114,180
10661,2023-01-05,JACKY,hotZone,Split,21,19,40
10662,2023-01-05,JACKY,heist,Kaboom Canyon,1,0,1
10663,2023-01-05,JACKY,gemGrab,Undermine,2,1,3
10664,2023-01-05,JACKY,gemGrab,Gem Fort,3,0,3
10665,2023-01-05,JACKY,brawlBall,Pinhole Punt,50,6,56
10666,2023-01-05,JACKY,bounty,Shooting Star,1,0,1
10667,2023-01-04,JACKY,knockout,Goldarm Gulch,7,2,9
10668,2023-01-04,JACKY,hotZone,Parallel Plays,3,0,3
10669,2023-01-04,JACKY,heist,Kaboom Canyon,0,1,1
10670,2023-01-04,JACKY,gemGrab,Gem Fort,5,6,11
10671,2023-01-04,JACKY,gemGrab,Crystal Arcade,1,0,1
10672,2023-01-04,JACKY,brawlBall,Sunny Soccer,57,37,94
10673,2023-01-04,JACKY,brawlBall,Beach Ball,0,1,1
10674,2023-01-03,JACKY,knockout,Goldarm Gulch,9,9,18
10675,2023-01-03,JACKY,hotZone,Parallel Plays,5,0,5
10676,2023-01-03,JACKY,heist,Pit Stop,1,0,1
10677,2023-01-03,JACKY,gemGrab,Crystal Arcade,8,14,22
10678,2023-01-03,JACKY,brawlBall,Beach Ball,55,12,67
10679,2023-01-03,JACKY,bounty,Hideout,1,0,1
10680,2023-01-02,JACKY,knockout,Belle's Rock,10,22,32
10681,2023-01-02,JACKY,hotZone,Quarter Pounder,11,9,20
10682,2023-01-02,JACKY,heist,Pit Stop,3,0,3
10683,2023-01-02,JACKY,gemGrab,Minecart Madness,1,1,2
10684,2023-01-02,JACKY,gemGrab,Double Swoosh,2,2,4
10685,2023-01-02,JACKY,brawlBall,Center Stage,112,80,192
10686,2023-01-02,JACKY,bounty,Hideout,0,1,1
10687,2023-01-01,JACKY,knockout,Belle's Rock,2,12,14
10688,2023-01-01,JACKY,hotZone,Quarter Pounder,1,0,1
10689,2023-01-01,JACKY,gemGrab,Minecart Madness,0,1,1
10690,2023-01-01,JACKY,gemGrab,Double Swoosh,3,5,8
10691,2023-01-01,JACKY,brawlBall,Backyard Bowl,11,5,16
10692,2023-01-01,JACKY,bounty,Canal Grande,0,1,1
10693,2022-12-31,JACKY,hotZone,Controller Chaos,1,0,1
10694,2022-12-31,JACKY,gemGrab,Hard Rock Mine,1,0,1
10695,2022-12-31,JACKY,gemGrab,Deep Diner,0,1,1
10696,2022-12-31,JACKY,brawlBall,Super Beach,10,7,17
10697,2022-12-31,JACKY,brawlBall,Sneaky Fields,0,1,1
10698,2022-12-30,JACKY,hotZone,Controller Chaos,3,0,3
10699,2022-12-30,JACKY,heist,Kaboom Canyon,2,2,4
10700,2022-12-30,JACKY,gemGrab,Minecart Madness,2,0,2
10701,2022-12-30,JACKY,brawlBall,Sneaky Fields,7,7,14
10702,2022-12-29,JACKY,brawlBall,Pinhole Punt,1,1,2
10703,2022-12-28,JACKY,gemGrab,Minecart Madness,2,0,2
10704,2022-12-28,JACKY,brawlBall,Sunny Soccer,1,1,2
10705,2022-12-27,JACKY,brawlBall,Beach Ball,0,3,3
10706,2022-12-26,JACKY,gemGrab,Minecart Madness,2,0,2
10707,2022-12-26,JACKY,brawlBall,Center Stage,0,1,1
10708,2022-12-24,JACKY,brawlBall,Super Beach,1,1,2
10709,2022-12-23,JACKY,brawlBall,Sneaky Fields,2,0,2
10710,2022-12-22,JACKY,brawlBall,Pinhole Punt,1,0,1
10711,2022-12-21,JACKY,brawlBall,Sunny Soccer,1,0,1
10712,2022-12-19,JACKY,brawlBall,Center Stage,1,0,1
10713,2022-12-16,JACKY,gemGrab,Undermine,2,0,2
10714,2022-12-16,JACKY,brawlBall,Sneaky Fields,1,0,1
10715,2022-11-11,JACKY,brawlBall,Sneaky Fields,6,2,8
10716,2022-10-30,JACKY,bounty,Canal Grande,0,2,2
10717,2022-10-28,JACKY,hotZone,Dueling Beetles,2,0,2
10718,2022-09-07,JACKY,brawlBall,Sunny Soccer,0,2,2
10719,2023-02-11,GUS,knockout,Flaring Phoenix,31,50,81
10720,2023-02-11,GUS,hotZone,Controller Chaos,8,14,22
10721,2023-02-11,GUS,gemGrab,Deep Diner,61,145,206
10722,2023-02-11,GUS,brawlBall,Super Beach,33,31,64
10723,2023-02-11,GUS,brawlBall,Sneaky Fields,11,12,23
10724,2023-02-10,GUS,knockout,Flaring Phoenix,48,79,127
10725,2023-02-10,GUS,hotZone,Controller Chaos,35,32,67
10726,2023-02-10,GUS,heist,Hot Potato,1,0,1
10727,2023-02-10,GUS,gemGrab,Undermine,18,10,28
10728,2023-02-10,GUS,gemGrab,Deep Diner,127,166,293
10729,2023-02-10,GUS,brawlBall,Sneaky Fields,216,238,454
10730,2023-02-10,GUS,brawlBall,Pinhole Punt,2,3,5
10731,2023-02-10,GUS,bounty,Temple Ruins,18,54,72
10732,2023-02-09,GUS,knockout,Riverside,32,48,80
10733,2023-02-09,GUS,hotZone,Open Zone,5,9,14
10734,2023-02-09,GUS,heist,Hot Potato,0,3,3
10735,2023-02-09,GUS,gemGrab,Undermine,16,11,27
10736,2023-02-09,GUS,brawlBall,Sunny Soccer,1,1,2
10737,2023-02-09,GUS,brawlBall,Pinhole Punt,68,84,152
10738,2023-02-09,GUS,bounty,Temple Ruins,9,16,25
10739,2023-02-08,GUS,knockout,Riverside,18,28,46
10740,2023-02-08,GUS,hotZone,Open Zone,11,11,22
10741,2023-02-08,GUS,heist,Safe Zone,2,1,3
10742,2023-02-08,GUS,gemGrab,Gem Fort,5,5,10
10743,2023-02-08,GUS,gemGrab,Crystal Arcade,4,4,8
10744,2023-02-08,GUS,brawlBall,Sunny Soccer,14,16,30
10745,2023-02-08,GUS,brawlBall,Beach Ball,2,1,3
10746,2023-02-08,GUS,bounty,Excel,7,11,18
10747,2023-02-07,GUS,knockout,New Perspective,3,6,9
10748,2023-02-07,GUS,hotZone,Dueling Beetles,7,8,15
10749,2023-02-07,GUS,heist,Safe Zone,1,0,1
10750,2023-02-07,GUS,gemGrab,Minecart Madness,7,19,26
10751,2023-02-07,GUS,gemGrab,Crystal Arcade,4,12,16
10752,2023-02-07,GUS,brawlBall,Beach Ball,8,6,14
10753,2023-02-07,GUS,bounty,Excel,2,1,3
10754,2023-02-06,GUS,knockout,New Perspective,127,174,301
10755,2023-02-06,GUS,knockout,Goldarm Gulch,4,0,4
10756,2023-02-06,GUS,hotZone,Dueling Beetles,95,113,208
10757,2023-02-06,GUS,heist,Snaked Assault,3,1,4
10758,2023-02-06,GUS,gemGrab,Minecart Madness,168,273,441
10759,2023-02-06,GUS,gemGrab,Double Swoosh,24,21,45
10760,2023-02-06,GUS,brawlBall,Sneaky Fields,1,3,4
10761,2023-02-06,GUS,brawlBall,Center Stage,192,179,371
10762,2023-02-06,GUS,brawlBall,Backyard Bowl,56,87,143
10763,2023-02-06,GUS,bounty,Layer Cake,29,71,100
10764,2023-02-05,GUS,knockout,X Marks the Spot,93,148,241
10765,2023-02-05,GUS,knockout,Goldarm Gulch,8,9,17
10766,2023-02-05,GUS,hotZone,Ring of Fire,51,73,124
10767,2023-02-05,GUS,heist,Snaked Assault,8,1,9
10768,2023-02-05,GUS,gemGrab,Hard Rock Mine,32,55,87
10769,2023-02-05,GUS,gemGrab,Double Swoosh,82,113,195
10770,2023-02-05,GUS,brawlBall,Super Beach,7,10,17
10771,2023-02-05,GUS,brawlBall,Sneaky Fields,3,5,8
10772,2023-02-05,GUS,brawlBall,Backyard Bowl,634,943,1577
10773,2023-02-05,GUS,bounty,Layer Cake,44,87,131
10774,2023-02-04,GUS,knockout,X Marks the Spot,32,32,64
10775,2023-02-04,GUS,knockout,Goldarm Gulch,18,11,29
10776,2023-02-04,GUS,hotZone,Ring of Fire,17,11,28
10777,2023-02-04,GUS,gemGrab,Hard Rock Mine,36,40,76
10778,2023-02-04,GUS,gemGrab,Double Swoosh,3,11,14
10779,2023-02-04,GUS,gemGrab,Deep Diner,22,18,40
10780,2023-02-04,GUS,brawlBall,Super Beach,54,76,130
10781,2023-02-04,GUS,brawlBall,Sneaky Fields,4,2,6
10782,2023-02-04,GUS,bounty,Dry Season,16,17,33
10783,2023-02-03,GUS,knockout,Out in the Open,210,318,528
10784,2023-02-03,GUS,knockout,Goldarm Gulch,87,86,173
10785,2023-02-03,GUS,hotZone,Split,16,6,22
10786,2023-02-03,GUS,heist,Tornado Ring,2,0,2
10787,2023-02-03,GUS,gemGrab,Undermine,27,58,85
10788,2023-02-03,GUS,gemGrab,Double Swoosh,36,33,69
10789,2023-02-03,GUS,gemGrab,Deep Diner,116,158,274
10790,2023-02-03,GUS,brawlBall,Sneaky Fields,150,253,403
10791,2023-02-03,GUS,brawlBall,Pinhole Punt,9,8,17
10792,2023-02-03,GUS,bounty,Dry Season,148,217,365
10793,2023-02-02,GUS,knockout,Out in the Open,63,86,149
10794,2023-02-02,GUS,hotZone,Split,2,2,4
10795,2023-02-02,GUS,heist,Kaboom Canyon,7,1,8
10796,2023-02-02,GUS,gemGrab,Undermine,22,35,57
10797,2023-02-02,GUS,gemGrab,Gem Fort,12,10,22
10798,2023-02-02,GUS,brawlBall,Sunny Soccer,2,0,2
10799,2023-02-02,GUS,brawlBall,Pinhole Punt,100,128,228
10800,2023-02-02,GUS,bounty,Shooting Star,29,33,62
10801,2023-02-01,GUS,knockout,Goldarm Gulch,123,172,295
10802,2023-02-01,GUS,hotZone,Parallel Plays,36,55,91
10803,2023-02-01,GUS,heist,Kaboom Canyon,15,37,52
10804,2023-02-01,GUS,gemGrab,Gem Fort,56,61,117
10805,2023-02-01,GUS,gemGrab,Crystal Arcade,54,114,168
10806,2023-02-01,GUS,brawlBall,Sunny Soccer,131,171,302
10807,2023-02-01,GUS,brawlBall,Beach Ball,6,6,12
10808,2023-02-01,GUS,bounty,Shooting Star,65,109,174
10809,2023-01-31,GUS,knockout,Goldarm Gulch,59,78,137
10810,2023-01-31,GUS,hotZone,Parallel Plays,10,14,24
10811,2023-01-31,GUS,heist,Pit Stop,2,0,2
10812,2023-01-31,GUS,gemGrab,Minecart Madness,11,19,30
10813,2023-01-31,GUS,gemGrab,Crystal Arcade,46,59,105
10814,2023-01-31,GUS,brawlBall,Center Stage,1,0,1
10815,2023-01-31,GUS,brawlBall,Beach Ball,76,134,210
10816,2023-01-31,GUS,bounty,Hideout,25,27,52
10817,2023-01-30,GUS,knockout,Belle's Rock,193,302,495
10818,2023-01-30,GUS,hotZone,Quarter Pounder,41,132,173
10819,2023-01-30,GUS,heist,Pit Stop,3,4,7
10820,2023-01-30,GUS,gemGrab,Minecart Madness,112,175,287
10821,2023-01-30,GUS,gemGrab,Double Swoosh,33,26,59
10822,2023-01-30,GUS,brawlBall,Center Stage,86,100,186
10823,2023-01-30,GUS,brawlBall,Backyard Bowl,28,52,80
10824,2023-01-30,GUS,bounty,Hideout,43,73,116
10825,2023-01-29,GUS,knockout,Belle's Rock,173,290,463
10826,2023-01-29,GUS,hotZone,Quarter Pounder,48,55,103
10827,2023-01-29,GUS,heist,Bridge Too Far,19,38,57
10828,2023-01-29,GUS,gemGrab,Hard Rock Mine,22,30,52
10829,2023-01-29,GUS,gemGrab,Double Swoosh,54,51,105
10830,2023-01-29,GUS,brawlBall,Super Beach,4,1,5
10831,2023-01-29,GUS,brawlBall,Backyard Bowl,426,590,1016
10832,2023-01-29,GUS,bounty,Canal Grande,9,13,22
10833,2023-01-28,GUS,knockout,Flaring Phoenix,39,52,91
10834,2023-01-28,GUS,hotZone,Controller Chaos,24,30,54
10835,2023-01-28,GUS,heist,Bridge Too Far,65,83,148
10836,2023-01-28,GUS,gemGrab,Hard Rock Mine,121,139,260
10837,2023-01-28,GUS,gemGrab,Deep Diner,33,39,72
10838,2023-01-28,GUS,brawlBall,Super Beach,236,253,489
10839,2023-01-28,GUS,brawlBall,Sneaky Fields,8,11,19
10840,2023-01-28,GUS,bounty,Canal Grande,16,19,35
10841,2023-01-27,GUS,knockout,Flaring Phoenix,26,22,48
10842,2023-01-27,GUS,hotZone,Controller Chaos,13,14,27
10843,2023-01-27,GUS,heist,Hot Potato,1,1,2
10844,2023-01-27,GUS,gemGrab,Undermine,8,11,19
10845,2023-01-27,GUS,gemGrab,Deep Diner,55,85,140
10846,2023-01-27,GUS,brawlBall,Sneaky Fields,59,53,112
10847,2023-01-27,GUS,brawlBall,Pinhole Punt,1,4,5
10848,2023-01-27,GUS,bounty,Temple Ruins,12,19,31
10849,2023-01-26,GUS,knockout,Riverside,232,378,610
10850,2023-01-26,GUS,hotZone,Open Zone,60,110,170
10851,2023-01-26,GUS,heist,Hot Potato,1,1,2
10852,2023-01-26,GUS,gemGrab,Undermine,50,88,138
10853,2023-01-26,GUS,gemGrab,Gem Fort,10,7,17
10854,2023-01-26,GUS,brawlBall,Sunny Soccer,6,5,11
10855,2023-01-26,GUS,brawlBall,Pinhole Punt,249,298,547
10856,2023-01-26,GUS,bounty,Temple Ruins,17,19,36
10857,2023-01-25,GUS,knockout,Riverside,88,132,220
10858,2023-01-25,GUS,hotZone,Open Zone,45,52,97
10859,2023-01-25,GUS,heist,Safe Zone,15,16,31
10860,2023-01-25,GUS,gemGrab,Gem Fort,15,38,53
10861,2023-01-25,GUS,gemGrab,Crystal Arcade,51,91,142
10862,2023-01-25,GUS,brawlBall,Sunny Soccer,96,119,215
10863,2023-01-25,GUS,brawlBall,Beach Ball,14,5,19
10864,2023-01-25,GUS,bounty,Excel,18,36,54
10865,2023-01-24,GUS,knockout,New Perspective,62,88,150
10866,2023-01-24,GUS,hotZone,Dueling Beetles,42,60,102
10867,2023-01-24,GUS,heist,Safe Zone,26,30,56
10868,2023-01-24,GUS,gemGrab,Minecart Madness,23,34,57
10869,2023-01-24,GUS,gemGrab,Crystal Arcade,115,129,244
10870,2023-01-24,GUS,brawlBall,Center Stage,12,9,21
10871,2023-01-24,GUS,brawlBall,Beach Ball,179,174,353
10872,2023-01-24,GUS,bounty,Excel,41,74,115
10873,2023-01-23,GUS,knockout,New Perspective,118,151,269
10874,2023-01-23,GUS,hotZone,Dueling Beetles,73,85,158
10875,2023-01-23,GUS,heist,Snaked Assault,5,5,10
10876,2023-01-23,GUS,gemGrab,Minecart Madness,131,187,318
10877,2023-01-23,GUS,gemGrab,Double Swoosh,35,40,75
10878,2023-01-23,GUS,brawlBall,Center Stage,173,187,360
10879,2023-01-23,GUS,brawlBall,Backyard Bowl,36,57,93
10880,2023-01-23,GUS,bounty,Layer Cake,38,50,88
10881,2023-01-22,GUS,knockout,X Marks the Spot,67,76,143
10882,2023-01-22,GUS,hotZone,Ring of Fire,26,30,56
10883,2023-01-22,GUS,heist,Snaked Assault,1,1,2
10884,2023-01-22,GUS,gemGrab,Hard Rock Mine,34,67,101
10885,2023-01-22,GUS,gemGrab,Double Swoosh,29,45,74
10886,2023-01-22,GUS,brawlBall,Super Beach,24,16,40
10887,2023-01-22,GUS,brawlBall,Backyard Bowl,254,368,622
10888,2023-01-22,GUS,bounty,Layer Cake,16,22,38
10889,2023-01-21,GUS,knockout,X Marks the Spot,275,331,606
10890,2023-01-21,GUS,hotZone,Ring of Fire,102,116,218
10891,2023-01-21,GUS,heist,Tornado Ring,11,3,14
10892,2023-01-21,GUS,gemGrab,Hard Rock Mine,114,135,249
10893,2023-01-21,GUS,gemGrab,Deep Diner,38,55,93
10894,2023-01-21,GUS,brawlBall,Super Beach,304,384,688
10895,2023-01-21,GUS,brawlBall,Sneaky Fields,8,3,11
10896,2023-01-21,GUS,bounty,Dry Season,113,171,284
10897,2023-01-20,GUS,knockout,Out in the Open,265,310,575
10898,2023-01-20,GUS,hotZone,Split,6,5,11
10899,2023-01-20,GUS,heist,Tornado Ring,1,1,2
10900,2023-01-20,GUS,gemGrab,Undermine,13,24,37
10901,2023-01-20,GUS,gemGrab,Deep Diner,127,209,336
10902,2023-01-20,GUS,brawlBall,Sneaky Fields,164,146,310
10903,2023-01-20,GUS,brawlBall,Pinhole Punt,7,13,20
10904,2023-01-20,GUS,bounty,Dry Season,82,118,200
10905,2023-01-19,GUS,knockout,Out in the Open,204,265,469
10906,2023-01-19,GUS,hotZone,Split,13,7,20
10907,2023-01-19,GUS,heist,Kaboom Canyon,11,16,27
10908,2023-01-19,GUS,gemGrab,Undermine,62,100,162
10909,2023-01-19,GUS,gemGrab,Gem Fort,8,10,18
10910,2023-01-19,GUS,brawlBall,Sunny Soccer,4,0,4
10911,2023-01-19,GUS,brawlBall,Pinhole Punt,296,395,691
10912,2023-01-19,GUS,bounty,Shooting Star,68,130,198
10913,2023-01-18,GUS,knockout,Goldarm Gulch,17,15,32
10914,2023-01-18,GUS,hotZone,Parallel Plays,2,3,5
10915,2023-01-18,GUS,heist,Kaboom Canyon,6,2,8
10916,2023-01-18,GUS,gemGrab,Gem Fort,12,13,25
10917,2023-01-18,GUS,gemGrab,Crystal Arcade,6,11,17
10918,2023-01-18,GUS,brawlBall,Sunny Soccer,39,44,83
10919,2023-01-18,GUS,brawlBall,Beach Ball,4,6,10
10920,2023-01-18,GUS,bounty,Shooting Star,45,49,94
10921,2023-01-17,GUS,knockout,Goldarm Gulch,21,18,39
10922,2023-01-17,GUS,hotZone,Parallel Plays,8,4,12
10923,2023-01-17,GUS,gemGrab,Minecart Madness,6,4,10
10924,2023-01-17,GUS,gemGrab,Crystal Arcade,6,4,10
10925,2023-01-17,GUS,brawlBall,Beach Ball,23,27,50
10926,2023-01-17,GUS,bounty,Hideout,5,5,10
10927,2023-01-16,GUS,knockout,Belle's Rock,37,39,76
10928,2023-01-16,GUS,hotZone,Quarter Pounder,3,3,6
10929,2023-01-16,GUS,gemGrab,Minecart Madness,8,12,20
10930,2023-01-16,GUS,gemGrab,Double Swoosh,2,4,6
10931,2023-01-16,GUS,brawlBall,Center Stage,10,14,24
10932,2023-01-16,GUS,brawlBall,Backyard Bowl,2,5,7
10933,2023-01-16,GUS,bounty,Hideout,12,25,37
10934,2023-01-15,GUS,knockout,Belle's Rock,31,47,78
10935,2023-01-15,GUS,hotZone,Quarter Pounder,10,18,28
10936,2023-01-15,GUS,heist,Bridge Too Far,3,2,5
10937,2023-01-15,GUS,gemGrab,Hard Rock Mine,2,1,3
10938,2023-01-15,GUS,gemGrab,Double Swoosh,5,23,28
10939,2023-01-15,GUS,brawlBall,Super Beach,1,0,1
10940,2023-01-15,GUS,brawlBall,Backyard Bowl,47,87,134
10941,2023-01-15,GUS,bounty,Canal Grande,1,1,2
10942,2023-01-14,GUS,knockout,Flaring Phoenix,16,8,24
10943,2023-01-14,GUS,hotZone,Controller Chaos,7,44,51
10944,2023-01-14,GUS,heist,Bridge Too Far,8,0,8
10945,2023-01-14,GUS,gemGrab,Hard Rock Mine,8,21,29
10946,2023-01-14,GUS,gemGrab,Deep Diner,3,3,6
10947,2023-01-14,GUS,brawlBall,Super Beach,11,11,22
10948,2023-01-14,GUS,brawlBall,Sneaky Fields,2,13,15
10949,2023-01-14,GUS,bounty,Canal Grande,0,2,2
10950,2023-01-13,GUS,knockout,Flaring Phoenix,5,27,32
10951,2023-01-13,GUS,hotZone,Controller Chaos,4,0,4
10952,2023-01-13,GUS,gemGrab,Undermine,1,0,1
10953,2023-01-13,GUS,gemGrab,Deep Diner,5,3,8
10954,2023-01-13,GUS,brawlBall,Sneaky Fields,18,29,47
10955,2023-01-13,GUS,bounty,Temple Ruins,4,1,5
10956,2023-01-12,GUS,knockout,Riverside,25,45,70
10957,2023-01-12,GUS,hotZone,Open Zone,9,27,36
10958,2023-01-12,GUS,gemGrab,Undermine,5,4,9
10959,2023-01-12,GUS,brawlBall,Sunny Soccer,0,1,1
10960,2023-01-12,GUS,brawlBall,Pinhole Punt,9,7,16
10961,2023-01-11,GUS,knockout,Riverside,4,5,9
10962,2023-01-11,GUS,hotZone,Open Zone,5,0,5
10963,2023-01-11,GUS,heist,Safe Zone,5,0,5
10964,2023-01-11,GUS,gemGrab,Gem Fort,1,0,1
10965,2023-01-11,GUS,brawlBall,Sunny Soccer,6,2,8
10966,2023-01-11,GUS,bounty,Excel,1,0,1
10967,2023-01-10,GUS,knockout,New Perspective,1,5,6
10968,2023-01-10,GUS,hotZone,Dueling Beetles,4,11,15
10969,2023-01-10,GUS,heist,Safe Zone,3,0,3
10970,2023-01-10,GUS,gemGrab,Minecart Madness,7,7,14
10971,2023-01-10,GUS,gemGrab,Crystal Arcade,2,7,9
10972,2023-01-10,GUS,brawlBall,Center Stage,3,3,6
10973,2023-01-10,GUS,brawlBall,Beach Ball,11,8,19
10974,2023-01-10,GUS,bounty,Excel,2,11,13
10975,2023-01-09,GUS,knockout,New Perspective,1,12,13
10976,2023-01-09,GUS,hotZone,Dueling Beetles,5,9,14
10977,2023-01-09,GUS,gemGrab,Minecart Madness,17,39,56
10978,2023-01-09,GUS,gemGrab,Double Swoosh,0,2,2
10979,2023-01-09,GUS,brawlBall,Center Stage,4,6,10
10980,2023-01-09,GUS,bounty,Layer Cake,5,29,34
10981,2023-01-08,GUS,knockout,X Marks the Spot,10,30,40
10982,2023-01-08,GUS,hotZone,Ring of Fire,4,9,13
10983,2023-01-08,GUS,heist,Snaked Assault,0,2,2
10984,2023-01-08,GUS,gemGrab,Hard Rock Mine,5,7,12
10985,2023-01-08,GUS,brawlBall,Backyard Bowl,30,57,87
10986,2023-01-07,GUS,knockout,X Marks the Spot,7,5,12
10987,2023-01-07,GUS,hotZone,Ring of Fire,0,1,1
10988,2023-01-07,GUS,heist,Tornado Ring,0,1,1
10989,2023-01-07,GUS,gemGrab,Hard Rock Mine,4,9,13
10990,2023-01-07,GUS,gemGrab,Deep Diner,4,12,16
10991,2023-01-07,GUS,brawlBall,Super Beach,12,5,17
10992,2023-01-07,GUS,bounty,Dry Season,10,8,18
10993,2023-01-06,GUS,knockout,Out in the Open,20,32,52
10994,2023-01-06,GUS,gemGrab,Undermine,0,10,10
10995,2023-01-06,GUS,gemGrab,Deep Diner,11,40,51
10996,2023-01-06,GUS,brawlBall,Sneaky Fields,3,3,6
10997,2023-01-06,GUS,brawlBall,Pinhole Punt,2,4,6
10998,2023-01-06,GUS,bounty,Dry Season,23,19,42
10999,2023-01-05,GUS,knockout,Out in the Open,31,40,71
11000,2023-01-05,GUS,gemGrab,Undermine,8,14,22
11001,2023-01-05,GUS,brawlBall,Pinhole Punt,25,25,50
11002,2023-01-05,GUS,bounty,Shooting Star,14,34,48
11003,2023-01-04,GUS,knockout,Goldarm Gulch,4,2,6
11004,2023-01-04,GUS,hotZone,Parallel Plays,3,2,5
11005,2023-01-04,GUS,heist,Kaboom Canyon,0,5,5
11006,2023-01-04,GUS,gemGrab,Gem Fort,2,6,8
11007,2023-01-04,GUS,gemGrab,Crystal Arcade,5,21,26
11008,2023-01-04,GUS,brawlBall,Sunny Soccer,9,7,16
11009,2023-01-04,GUS,brawlBall,Beach Ball,0,1,1
11010,2023-01-04,GUS,bounty,Shooting Star,20,51,71
11011,2023-01-03,GUS,knockout,Goldarm Gulch,8,9,17
11012,2023-01-03,GUS,hotZone,Parallel Plays,1,3,4
11013,2023-01-03,GUS,gemGrab,Minecart Madness,0,7,7
11014,2023-01-03,GUS,gemGrab,Crystal Arcade,19,68,87
11015,2023-01-03,GUS,brawlBall,Center Stage,0,4,4
11016,2023-01-03,GUS,brawlBall,Beach Ball,11,6,17
11017,2023-01-03,GUS,bounty,Hideout,10,17,27
11018,2023-01-02,GUS,knockout,Belle's Rock,17,55,72
11019,2023-01-02,GUS,hotZone,Quarter Pounder,17,13,30
11020,2023-01-02,GUS,heist,Kaboom Canyon,1,0,1
11021,2023-01-02,GUS,gemGrab,Minecart Madness,7,69,76
11022,2023-01-02,GUS,gemGrab,Double Swoosh,5,5,10
11023,2023-01-02,GUS,brawlBall,Center Stage,8,5,13
11024,2023-01-02,GUS,brawlBall,Backyard Bowl,0,1,1
11025,2023-01-02,GUS,bounty,Hideout,19,53,72
11026,2023-01-01,GUS,knockout,Belle's Rock,18,32,50
11027,2023-01-01,GUS,hotZone,Quarter Pounder,4,5,9
11028,2023-01-01,GUS,heist,Bridge Too Far,1,0,1
11029,2023-01-01,GUS,gemGrab,Hard Rock Mine,1,0,1
11030,2023-01-01,GUS,gemGrab,Double Swoosh,5,7,12
11031,2023-01-01,GUS,brawlBall,Backyard Bowl,22,57,79
11032,2022-12-31,GUS,hotZone,Controller Chaos,2,2,4
11033,2022-12-31,GUS,heist,Bridge Too Far,4,3,7
11034,2022-12-31,GUS,gemGrab,Hard Rock Mine,0,4,4
11035,2022-12-31,GUS,gemGrab,Deep Diner,3,18,21
11036,2022-12-31,GUS,brawlBall,Super Beach,8,2,10
11037,2022-12-31,GUS,bounty,Canal Grande,2,0,2
11038,2022-12-30,GUS,gemGrab,Deep Diner,2,0,2
11039,2022-12-29,GUS,gemGrab,Gem Fort,0,1,1
11040,2022-12-29,GUS,brawlBall,Pinhole Punt,2,3,5
11041,2022-12-28,GUS,brawlBall,Sunny Soccer,0,2,2
11042,2022-12-27,GUS,knockout,New Perspective,0,2,2
11043,2022-12-27,GUS,hotZone,Dueling Beetles,4,3,7
11044,2022-12-27,GUS,brawlBall,Beach Ball,2,0,2
11045,2022-12-26,GUS,hotZone,Controller Chaos,0,1,1
11046,2022-12-23,GUS,gemGrab,Deep Diner,0,1,1
11047,2022-12-22,GUS,brawlBall,Pinhole Punt,2,4,6
11048,2022-12-21,GUS,brawlBall,Sunny Soccer,0,2,2
11049,2022-12-19,GUS,gemGrab,Minecart Madness,2,2,4
11050,2022-12-17,GUS,knockout,Flaring Phoenix,1,0,1
11051,2022-12-16,GUS,brawlBall,Sneaky Fields,1,0,1
11052,2022-12-13,GUS,gemGrab,Crystal Arcade,1,0,1
11053,2022-12-11,GUS,brawlBall,Backyard Bowl,0,2,2
11054,2022-12-10,GUS,knockout,X Marks the Spot,1,0,1
11055,2022-11-07,GUS,hotZone,Quarter Pounder,0,2,2
11056,2022-11-03,GUS,brawlBall,Pinhole Punt,0,2,2
11057,2022-10-15,GUS,gemGrab,Hard Rock Mine,1,0,1
11058,2022-10-15,GUS,bounty,Dry Season,0,2,2
11059,2022-10-10,GUS,knockout,Belle's Rock,1,1,2
11060,2023-02-11,GROM,knockout,Flaring Phoenix,342,267,609
11061,2023-02-11,GROM,hotZone,Controller Chaos,51,27,78
11062,2023-02-11,GROM,gemGrab,Deep Diner,48,47,95
11063,2023-02-11,GROM,brawlBall,Super Beach,29,24,53
11064,2023-02-11,GROM,brawlBall,Sneaky Fields,19,13,32
11065,2023-02-10,GROM,knockout,Flaring Phoenix,565,588,1153
11066,2023-02-10,GROM,hotZone,Controller Chaos,50,35,85
11067,2023-02-10,GROM,heist,Hot Potato,45,39,84
11068,2023-02-10,GROM,gemGrab,Undermine,15,7,22
11069,2023-02-10,GROM,gemGrab,Deep Diner,146,123,269
11070,2023-02-10,GROM,brawlBall,Sneaky Fields,202,176,378
11071,2023-02-10,GROM,brawlBall,Pinhole Punt,4,1,5
11072,2023-02-10,GROM,bounty,Temple Ruins,66,74,140
11073,2023-02-09,GROM,knockout,Riverside,58,34,92
11074,2023-02-09,GROM,hotZone,Open Zone,5,4,9
11075,2023-02-09,GROM,heist,Hot Potato,18,11,29
11076,2023-02-09,GROM,gemGrab,Undermine,8,5,13
11077,2023-02-09,GROM,gemGrab,Gem Fort,3,1,4
11078,2023-02-09,GROM,brawlBall,Sunny Soccer,1,0,1
11079,2023-02-09,GROM,brawlBall,Pinhole Punt,57,51,108
11080,2023-02-09,GROM,bounty,Temple Ruins,33,32,65
11081,2023-02-08,GROM,knockout,Riverside,42,33,75
11082,2023-02-08,GROM,hotZone,Open Zone,4,6,10
11083,2023-02-08,GROM,heist,Safe Zone,18,30,48
11084,2023-02-08,GROM,gemGrab,Gem Fort,4,8,12
11085,2023-02-08,GROM,gemGrab,Crystal Arcade,1,2,3
11086,2023-02-08,GROM,brawlBall,Sunny Soccer,27,31,58
11087,2023-02-08,GROM,brawlBall,Beach Ball,1,1,2
11088,2023-02-08,GROM,bounty,Excel,30,13,43
11089,2023-02-07,GROM,knockout,New Perspective,23,13,36
11090,2023-02-07,GROM,hotZone,Dueling Beetles,25,5,30
11091,2023-02-07,GROM,heist,Safe Zone,17,19,36
11092,2023-02-07,GROM,gemGrab,Minecart Madness,9,20,29
11093,2023-02-07,GROM,gemGrab,Crystal Arcade,0,4,4
11094,2023-02-07,GROM,brawlBall,Center Stage,20,22,42
11095,2023-02-07,GROM,brawlBall,Beach Ball,14,25,39
11096,2023-02-07,GROM,bounty,Excel,31,54,85
11097,2023-02-06,GROM,knockout,New Perspective,567,543,1110
11098,2023-02-06,GROM,knockout,Goldarm Gulch,68,60,128
11099,2023-02-06,GROM,hotZone,Dueling Beetles,204,95,299
11100,2023-02-06,GROM,heist,Snaked Assault,31,17,48
11101,2023-02-06,GROM,heist,Pit Stop,12,8,20
11102,2023-02-06,GROM,gemGrab,Minecart Madness,224,199,423
11103,2023-02-06,GROM,gemGrab,Double Swoosh,35,32,67
11104,2023-02-06,GROM,brawlBall,Sneaky Fields,9,6,15
11105,2023-02-06,GROM,brawlBall,Center Stage,1633,2056,3689
11106,2023-02-06,GROM,brawlBall,Backyard Bowl,13,9,22
11107,2023-02-06,GROM,bounty,Layer Cake,303,373,676
11108,2023-02-05,GROM,knockout,X Marks the Spot,403,375,778
11109,2023-02-05,GROM,knockout,Goldarm Gulch,249,298,547
11110,2023-02-05,GROM,hotZone,Ring of Fire,67,39,106
11111,2023-02-05,GROM,heist,Snaked Assault,56,29,85
11112,2023-02-05,GROM,heist,Pit Stop,52,24,76
11113,2023-02-05,GROM,gemGrab,Hard Rock Mine,16,14,30
11114,2023-02-05,GROM,gemGrab,Double Swoosh,148,137,285
11115,2023-02-05,GROM,brawlBall,Super Beach,5,4,9
11116,2023-02-05,GROM,brawlBall,Sneaky Fields,33,24,57
11117,2023-02-05,GROM,brawlBall,Backyard Bowl,164,132,296
11118,2023-02-05,GROM,bounty,Layer Cake,384,381,765
11119,2023-02-04,GROM,knockout,X Marks the Spot,147,128,275
11120,2023-02-04,GROM,knockout,Goldarm Gulch,150,127,277
11121,2023-02-04,GROM,hotZone,Ring of Fire,11,8,19
11122,2023-02-04,GROM,heist,Tornado Ring,5,3,8
11123,2023-02-04,GROM,heist,Pit Stop,32,18,50
11124,2023-02-04,GROM,gemGrab,Hard Rock Mine,14,36,50
11125,2023-02-04,GROM,gemGrab,Double Swoosh,27,6,33
11126,2023-02-04,GROM,gemGrab,Deep Diner,8,16,24
11127,2023-02-04,GROM,brawlBall,Super Beach,53,63,116
11128,2023-02-04,GROM,brawlBall,Sneaky Fields,25,12,37
11129,2023-02-04,GROM,bounty,Dry Season,36,78,114
11130,2023-02-03,GROM,knockout,Out in the Open,378,319,697
11131,2023-02-03,GROM,knockout,Goldarm Gulch,959,921,1880
11132,2023-02-03,GROM,hotZone,Split,150,120,270
11133,2023-02-03,GROM,heist,Tornado Ring,37,21,58
11134,2023-02-03,GROM,heist,Pit Stop,206,102,308
11135,2023-02-03,GROM,gemGrab,Undermine,12,11,23
11136,2023-02-03,GROM,gemGrab,Double Swoosh,206,115,321
11137,2023-02-03,GROM,gemGrab,Deep Diner,120,98,218
11138,2023-02-03,GROM,brawlBall,Sneaky Fields,337,309,646
11139,2023-02-03,GROM,brawlBall,Pinhole Punt,8,7,15
11140,2023-02-03,GROM,bounty,Dry Season,332,395,727
11141,2023-02-02,GROM,knockout,Out in the Open,176,187,363
11142,2023-02-02,GROM,hotZone,Split,80,49,129
11143,2023-02-02,GROM,heist,Kaboom Canyon,18,14,32
11144,2023-02-02,GROM,gemGrab,Undermine,13,8,21
11145,2023-02-02,GROM,gemGrab,Gem Fort,3,3,6
11146,2023-02-02,GROM,brawlBall,Sunny Soccer,4,3,7
11147,2023-02-02,GROM,brawlBall,Pinhole Punt,57,44,101
11148,2023-02-02,GROM,bounty,Shooting Star,75,102,177
11149,2023-02-01,GROM,knockout,Goldarm Gulch,722,742,1464
11150,2023-02-01,GROM,hotZone,Parallel Plays,62,31,93
11151,2023-02-01,GROM,heist,Kaboom Canyon,74,68,142
11152,2023-02-01,GROM,gemGrab,Gem Fort,34,26,60
11153,2023-02-01,GROM,gemGrab,Crystal Arcade,29,14,43
11154,2023-02-01,GROM,brawlBall,Sunny Soccer,285,248,533
11155,2023-02-01,GROM,brawlBall,Beach Ball,7,9,16
11156,2023-02-01,GROM,bounty,Shooting Star,146,149,295
11157,2023-01-31,GROM,knockout,Goldarm Gulch,341,337,678
11158,2023-01-31,GROM,hotZone,Parallel Plays,38,18,56
11159,2023-01-31,GROM,heist,Pit Stop,18,25,43
11160,2023-01-31,GROM,gemGrab,Minecart Madness,14,9,23
11161,2023-01-31,GROM,gemGrab,Crystal Arcade,25,26,51
11162,2023-01-31,GROM,brawlBall,Center Stage,9,14,23
11163,2023-01-31,GROM,brawlBall,Beach Ball,157,151,308
11164,2023-01-31,GROM,bounty,Hideout,98,120,218
11165,2023-01-30,GROM,knockout,Belle's Rock,1381,1388,2769
11166,2023-01-30,GROM,hotZone,Quarter Pounder,95,74,169
11167,2023-01-30,GROM,heist,Pit Stop,59,63,122
11168,2023-01-30,GROM,gemGrab,Minecart Madness,125,131,256
11169,2023-01-30,GROM,gemGrab,Double Swoosh,21,23,44
11170,2023-01-30,GROM,brawlBall,Center Stage,983,1156,2139
11171,2023-01-30,GROM,brawlBall,Backyard Bowl,19,19,38
11172,2023-01-30,GROM,bounty,Hideout,183,218,401
11173,2023-01-29,GROM,knockout,Belle's Rock,1687,1649,3336
11174,2023-01-29,GROM,hotZone,Quarter Pounder,82,71,153
11175,2023-01-29,GROM,heist,Bridge Too Far,335,522,857
11176,2023-01-29,GROM,gemGrab,Hard Rock Mine,8,5,13
11177,2023-01-29,GROM,gemGrab,Double Swoosh,55,49,104
11178,2023-01-29,GROM,brawlBall,Super Beach,8,17,25
11179,2023-01-29,GROM,brawlBall,Backyard Bowl,123,125,248
11180,2023-01-29,GROM,bounty,Canal Grande,193,208,401
11181,2023-01-28,GROM,knockout,Flaring Phoenix,403,431,834
11182,2023-01-28,GROM,hotZone,Controller Chaos,51,39,90
11183,2023-01-28,GROM,heist,Bridge Too Far,600,849,1449
11184,2023-01-28,GROM,gemGrab,Hard Rock Mine,56,51,107
11185,2023-01-28,GROM,gemGrab,Deep Diner,44,53,97
11186,2023-01-28,GROM,brawlBall,Super Beach,210,186,396
11187,2023-01-28,GROM,brawlBall,Sneaky Fields,10,5,15
11188,2023-01-28,GROM,bounty,Canal Grande,327,392,719
11189,2023-01-27,GROM,knockout,Flaring Phoenix,184,158,342
11190,2023-01-27,GROM,hotZone,Controller Chaos,25,15,40
11191,2023-01-27,GROM,heist,Hot Potato,30,32,62
11192,2023-01-27,GROM,gemGrab,Undermine,1,1,2
11193,2023-01-27,GROM,gemGrab,Deep Diner,63,65,128
11194,2023-01-27,GROM,brawlBall,Sneaky Fields,78,86,164
11195,2023-01-27,GROM,brawlBall,Pinhole Punt,16,10,26
11196,2023-01-27,GROM,bounty,Temple Ruins,29,15,44
11197,2023-01-26,GROM,knockout,Riverside,360,256,616
11198,2023-01-26,GROM,hotZone,Open Zone,45,14,59
11199,2023-01-26,GROM,heist,Hot Potato,54,47,101
11200,2023-01-26,GROM,gemGrab,Undermine,43,21,64
11201,2023-01-26,GROM,gemGrab,Gem Fort,8,13,21
11202,2023-01-26,GROM,brawlBall,Sunny Soccer,23,15,38
11203,2023-01-26,GROM,brawlBall,Pinhole Punt,191,161,352
11204,2023-01-26,GROM,bounty,Temple Ruins,74,81,155
11205,2023-01-25,GROM,knockout,Riverside,155,115,270
11206,2023-01-25,GROM,hotZone,Open Zone,18,13,31
11207,2023-01-25,GROM,heist,Safe Zone,222,230,452
11208,2023-01-25,GROM,gemGrab,Gem Fort,24,11,35
11209,2023-01-25,GROM,gemGrab,Crystal Arcade,31,28,59
11210,2023-01-25,GROM,brawlBall,Sunny Soccer,235,219,454
11211,2023-01-25,GROM,brawlBall,Beach Ball,29,56,85
11212,2023-01-25,GROM,bounty,Excel,210,215,425
11213,2023-01-24,GROM,knockout,New Perspective,290,316,606
11214,2023-01-24,GROM,hotZone,Dueling Beetles,115,69,184
11215,2023-01-24,GROM,heist,Safe Zone,299,356,655
11216,2023-01-24,GROM,gemGrab,Minecart Madness,33,32,65
11217,2023-01-24,GROM,gemGrab,Crystal Arcade,57,33,90
11218,2023-01-24,GROM,brawlBall,Center Stage,156,201,357
11219,2023-01-24,GROM,brawlBall,Beach Ball,412,419,831
11220,2023-01-24,GROM,bounty,Excel,358,331,689
11221,2023-01-23,GROM,knockout,New Perspective,538,509,1047
11222,2023-01-23,GROM,hotZone,Dueling Beetles,188,121,309
11223,2023-01-23,GROM,heist,Snaked Assault,44,13,57
11224,2023-01-23,GROM,gemGrab,Minecart Madness,189,127,316
11225,2023-01-23,GROM,gemGrab,Double Swoosh,28,13,41
11226,2023-01-23,GROM,brawlBall,Center Stage,2029,2503,4532
11227,2023-01-23,GROM,brawlBall,Backyard Bowl,9,3,12
11228,2023-01-23,GROM,bounty,Layer Cake,287,335,622
11229,2023-01-22,GROM,knockout,X Marks the Spot,337,398,735
11230,2023-01-22,GROM,hotZone,Ring of Fire,26,20,46
11231,2023-01-22,GROM,heist,Snaked Assault,15,11,26
11232,2023-01-22,GROM,gemGrab,Hard Rock Mine,14,9,23
11233,2023-01-22,GROM,gemGrab,Double Swoosh,29,47,76
11234,2023-01-22,GROM,brawlBall,Super Beach,22,14,36
11235,2023-01-22,GROM,brawlBall,Backyard Bowl,88,63,151
11236,2023-01-22,GROM,bounty,Layer Cake,213,210,423
11237,2023-01-21,GROM,knockout,X Marks the Spot,1110,1046,2156
11238,2023-01-21,GROM,hotZone,Ring of Fire,97,59,156
11239,2023-01-21,GROM,heist,Tornado Ring,34,17,51
11240,2023-01-21,GROM,gemGrab,Hard Rock Mine,57,59,116
11241,2023-01-21,GROM,gemGrab,Deep Diner,41,35,76
11242,2023-01-21,GROM,brawlBall,Super Beach,313,240,553
11243,2023-01-21,GROM,brawlBall,Sneaky Fields,12,13,25
11244,2023-01-21,GROM,bounty,Dry Season,309,322,631
11245,2023-01-20,GROM,knockout,Out in the Open,455,419,874
11246,2023-01-20,GROM,hotZone,Split,172,90,262
11247,2023-01-20,GROM,heist,Tornado Ring,37,18,55
11248,2023-01-20,GROM,gemGrab,Undermine,20,16,36
11249,2023-01-20,GROM,gemGrab,Deep Diner,186,181,367
11250,2023-01-20,GROM,brawlBall,Sneaky Fields,222,235,457
11251,2023-01-20,GROM,brawlBall,Pinhole Punt,7,9,16
11252,2023-01-20,GROM,bounty,Dry Season,233,224,457
11253,2023-01-19,GROM,knockout,Out in the Open,609,553,1162
11254,2023-01-19,GROM,hotZone,Split,241,188,429
11255,2023-01-19,GROM,heist,Kaboom Canyon,63,61,124
11256,2023-01-19,GROM,gemGrab,Undermine,50,35,85
11257,2023-01-19,GROM,gemGrab,Gem Fort,3,1,4
11258,2023-01-19,GROM,brawlBall,Sunny Soccer,14,7,21
11259,2023-01-19,GROM,brawlBall,Pinhole Punt,198,157,355
11260,2023-01-19,GROM,bounty,Shooting Star,206,272,478
11261,2023-01-18,GROM,knockout,Goldarm Gulch,104,105,209
11262,2023-01-18,GROM,hotZone,Parallel Plays,4,1,5
11263,2023-01-18,GROM,heist,Kaboom Canyon,27,15,42
11264,2023-01-18,GROM,gemGrab,Gem Fort,12,4,16
11265,2023-01-18,GROM,gemGrab,Crystal Arcade,3,0,3
11266,2023-01-18,GROM,brawlBall,Sunny Soccer,98,89,187
11267,2023-01-18,GROM,brawlBall,Beach Ball,3,7,10
11268,2023-01-18,GROM,bounty,Shooting Star,96,110,206
11269,2023-01-17,GROM,knockout,Goldarm Gulch,92,113,205
11270,2023-01-17,GROM,hotZone,Parallel Plays,5,6,11
11271,2023-01-17,GROM,heist,Pit Stop,7,5,12
11272,2023-01-17,GROM,gemGrab,Minecart Madness,1,1,2
11273,2023-01-17,GROM,gemGrab,Crystal Arcade,3,2,5
11274,2023-01-17,GROM,brawlBall,Center Stage,1,2,3
11275,2023-01-17,GROM,brawlBall,Beach Ball,34,28,62
11276,2023-01-17,GROM,bounty,Hideout,26,26,52
11277,2023-01-16,GROM,knockout,Belle's Rock,107,127,234
11278,2023-01-16,GROM,hotZone,Quarter Pounder,13,13,26
11279,2023-01-16,GROM,heist,Pit Stop,17,20,37
11280,2023-01-16,GROM,gemGrab,Minecart Madness,12,12,24
11281,2023-01-16,GROM,gemGrab,Double Swoosh,4,3,7
11282,2023-01-16,GROM,brawlBall,Center Stage,181,206,387
11283,2023-01-16,GROM,brawlBall,Backyard Bowl,1,1,2
11284,2023-01-16,GROM,bounty,Hideout,54,37,91
11285,2023-01-15,GROM,knockout,Belle's Rock,214,219,433
11286,2023-01-15,GROM,hotZone,Quarter Pounder,30,33,63
11287,2023-01-15,GROM,heist,Bridge Too Far,47,45,92
11288,2023-01-15,GROM,gemGrab,Hard Rock Mine,1,1,2
11289,2023-01-15,GROM,gemGrab,Double Swoosh,6,2,8
11290,2023-01-15,GROM,brawlBall,Super Beach,6,0,6
11291,2023-01-15,GROM,brawlBall,Backyard Bowl,21,15,36
11292,2023-01-15,GROM,bounty,Canal Grande,40,42,82
11293,2023-01-14,GROM,knockout,Flaring Phoenix,62,34,96
11294,2023-01-14,GROM,hotZone,Controller Chaos,25,9,34
11295,2023-01-14,GROM,heist,Bridge Too Far,73,70,143
11296,2023-01-14,GROM,gemGrab,Hard Rock Mine,2,7,9
11297,2023-01-14,GROM,gemGrab,Deep Diner,9,8,17
11298,2023-01-14,GROM,brawlBall,Super Beach,24,11,35
11299,2023-01-14,GROM,bounty,Canal Grande,47,52,99
11300,2023-01-13,GROM,knockout,Flaring Phoenix,43,37,80
11301,2023-01-13,GROM,hotZone,Controller Chaos,19,10,29
11302,2023-01-13,GROM,heist,Hot Potato,4,3,7
11303,2023-01-13,GROM,gemGrab,Deep Diner,11,5,16
11304,2023-01-13,GROM,brawlBall,Sneaky Fields,21,14,35
11305,2023-01-13,GROM,brawlBall,Pinhole Punt,1,0,1
11306,2023-01-13,GROM,bounty,Temple Ruins,1,2,3
11307,2023-01-12,GROM,knockout,Riverside,63,31,94
11308,2023-01-12,GROM,hotZone,Open Zone,5,1,6
11309,2023-01-12,GROM,heist,Hot Potato,0,2,2
11310,2023-01-12,GROM,gemGrab,Undermine,3,2,5
11311,2023-01-12,GROM,brawlBall,Sunny Soccer,2,0,2
11312,2023-01-12,GROM,brawlBall,Pinhole Punt,4,3,7
11313,2023-01-12,GROM,bounty,Temple Ruins,0,4,4
11314,2023-01-11,GROM,knockout,Riverside,11,2,13
11315,2023-01-11,GROM,hotZone,Open Zone,2,0,2
11316,2023-01-11,GROM,heist,Safe Zone,1,1,2
11317,2023-01-11,GROM,gemGrab,Gem Fort,0,3,3
11318,2023-01-11,GROM,brawlBall,Sunny Soccer,18,19,37
11319,2023-01-11,GROM,bounty,Excel,9,8,17
11320,2023-01-10,GROM,knockout,New Perspective,38,56,94
11321,2023-01-10,GROM,hotZone,Dueling Beetles,25,30,55
11322,2023-01-10,GROM,heist,Safe Zone,25,9,34
11323,2023-01-10,GROM,gemGrab,Minecart Madness,9,19,28
11324,2023-01-10,GROM,gemGrab,Crystal Arcade,7,5,12
11325,2023-01-10,GROM,brawlBall,Center Stage,17,47,64
11326,2023-01-10,GROM,brawlBall,Beach Ball,29,37,66
11327,2023-01-10,GROM,bounty,Excel,14,14,28
11328,2023-01-09,GROM,knockout,New Perspective,28,28,56
11329,2023-01-09,GROM,hotZone,Dueling Beetles,33,15,48
11330,2023-01-09,GROM,heist,Snaked Assault,8,3,11
11331,2023-01-09,GROM,gemGrab,Minecart Madness,24,6,30
11332,2023-01-09,GROM,gemGrab,Double Swoosh,6,0,6
11333,2023-01-09,GROM,brawlBall,Center Stage,216,284,500
11334,2023-01-09,GROM,brawlBall,Backyard Bowl,1,2,3
11335,2023-01-09,GROM,bounty,Layer Cake,52,34,86
11336,2023-01-08,GROM,knockout,X Marks the Spot,80,74,154
11337,2023-01-08,GROM,hotZone,Ring of Fire,6,4,10
11338,2023-01-08,GROM,heist,Snaked Assault,7,9,16
11339,2023-01-08,GROM,gemGrab,Hard Rock Mine,1,0,1
11340,2023-01-08,GROM,gemGrab,Double Swoosh,5,5,10
11341,2023-01-08,GROM,brawlBall,Backyard Bowl,10,10,20
11342,2023-01-08,GROM,bounty,Layer Cake,14,19,33
11343,2023-01-07,GROM,knockout,X Marks the Spot,41,42,83
11344,2023-01-07,GROM,hotZone,Ring of Fire,8,9,17
11345,2023-01-07,GROM,heist,Tornado Ring,1,4,5
11346,2023-01-07,GROM,gemGrab,Hard Rock Mine,3,4,7
11347,2023-01-07,GROM,gemGrab,Deep Diner,8,13,21
11348,2023-01-07,GROM,brawlBall,Super Beach,13,10,23
11349,2023-01-07,GROM,brawlBall,Sneaky Fields,1,2,3
11350,2023-01-07,GROM,bounty,Dry Season,41,56,97
11351,2023-01-06,GROM,knockout,Out in the Open,49,40,89
11352,2023-01-06,GROM,hotZone,Split,25,24,49
11353,2023-01-06,GROM,heist,Tornado Ring,5,1,6
11354,2023-01-06,GROM,gemGrab,Undermine,0,1,1
11355,2023-01-06,GROM,gemGrab,Deep Diner,29,65,94
11356,2023-01-06,GROM,brawlBall,Sneaky Fields,13,20,33
11357,2023-01-06,GROM,bounty,Dry Season,59,67,126
11358,2023-01-05,GROM,knockout,Out in the Open,100,91,191
11359,2023-01-05,GROM,hotZone,Split,51,91,142
11360,2023-01-05,GROM,heist,Kaboom Canyon,8,5,13
11361,2023-01-05,GROM,gemGrab,Undermine,2,4,6
11362,2023-01-05,GROM,gemGrab,Gem Fort,0,3,3
11363,2023-01-05,GROM,brawlBall,Sunny Soccer,0,1,1
11364,2023-01-05,GROM,brawlBall,Pinhole Punt,25,20,45
11365,2023-01-05,GROM,bounty,Shooting Star,35,40,75
11366,2023-01-04,GROM,knockout,Goldarm Gulch,35,39,74
11367,2023-01-04,GROM,hotZone,Parallel Plays,5,1,6
11368,2023-01-04,GROM,heist,Kaboom Canyon,20,24,44
11369,2023-01-04,GROM,gemGrab,Gem Fort,1,0,1
11370,2023-01-04,GROM,gemGrab,Crystal Arcade,1,1,2
11371,2023-01-04,GROM,brawlBall,Sunny Soccer,46,58,104
11372,2023-01-04,GROM,bounty,Shooting Star,84,94,178
11373,2023-01-03,GROM,knockout,Goldarm Gulch,49,55,104
11374,2023-01-03,GROM,hotZone,Parallel Plays,10,9,19
11375,2023-01-03,GROM,heist,Pit Stop,10,2,12
11376,2023-01-03,GROM,gemGrab,Minecart Madness,6,2,8
11377,2023-01-03,GROM,gemGrab,Crystal Arcade,2,2,4
11378,2023-01-03,GROM,brawlBall,Center Stage,9,1,10
11379,2023-01-03,GROM,brawlBall,Beach Ball,36,33,69
11380,2023-01-03,GROM,bounty,Hideout,66,75,141
11381,2023-01-02,GROM,knockout,Belle's Rock,127,159,286
11382,2023-01-02,GROM,hotZone,Quarter Pounder,17,12,29
11383,2023-01-02,GROM,heist,Pit Stop,5,1,6
11384,2023-01-02,GROM,gemGrab,Minecart Madness,16,15,31
11385,2023-01-02,GROM,gemGrab,Double Swoosh,1,0,1
11386,2023-01-02,GROM,brawlBall,Center Stage,263,297,560
11387,2023-01-02,GROM,brawlBall,Backyard Bowl,2,2,4
11388,2023-01-02,GROM,bounty,Hideout,96,112,208
11389,2023-01-01,GROM,knockout,Belle's Rock,60,77,137
11390,2023-01-01,GROM,hotZone,Quarter Pounder,6,25,31
11391,2023-01-01,GROM,heist,Bridge Too Far,13,20,33
11392,2023-01-01,GROM,gemGrab,Hard Rock Mine,0,1,1
11393,2023-01-01,GROM,gemGrab,Double Swoosh,2,2,4
11394,2023-01-01,GROM,brawlBall,Backyard Bowl,4,0,4
11395,2023-01-01,GROM,bounty,Canal Grande,2,3,5
11396,2022-12-31,GROM,knockout,Flaring Phoenix,2,0,2
11397,2022-12-31,GROM,heist,Bridge Too Far,2,3,5
11398,2022-12-31,GROM,gemGrab,Minecart Madness,0,2,2
11399,2022-12-31,GROM,gemGrab,Hard Rock Mine,1,0,1
11400,2022-12-31,GROM,gemGrab,Deep Diner,1,3,4
11401,2022-12-31,GROM,brawlBall,Super Beach,3,0,3
11402,2022-12-30,GROM,knockout,Flaring Phoenix,8,2,10
11403,2022-12-30,GROM,hotZone,Controller Chaos,4,0,4
11404,2022-12-30,GROM,gemGrab,Deep Diner,4,0,4
11405,2022-12-30,GROM,brawlBall,Sneaky Fields,4,0,4
11406,2022-12-29,GROM,gemGrab,Undermine,0,1,1
11407,2022-12-29,GROM,gemGrab,Minecart Madness,0,1,1
11408,2022-12-29,GROM,brawlBall,Pinhole Punt,2,0,2
11409,2022-12-28,GROM,brawlBall,Sunny Soccer,0,1,1
11410,2022-12-28,GROM,brawlBall,Beach Ball,0,2,2
11411,2022-12-27,GROM,hotZone,Dueling Beetles,0,1,1
11412,2022-12-27,GROM,heist,Safe Zone,4,0,4
11413,2022-12-27,GROM,brawlBall,Center Stage,1,2,3
11414,2022-12-27,GROM,brawlBall,Beach Ball,3,0,3
11415,2022-12-27,GROM,bounty,Excel,0,1,1
11416,2022-12-26,GROM,heist,Kaboom Canyon,0,1,1
11417,2022-12-26,GROM,brawlBall,Center Stage,3,4,7
11418,2022-12-25,GROM,bounty,Layer Cake,4,2,6
11419,2022-12-24,GROM,brawlBall,Super Beach,0,2,2
11420,2022-12-23,GROM,knockout,Out in the Open,8,16,24
11421,2022-12-22,GROM,gemGrab,Gem Fort,1,0,1
11422,2022-12-19,GROM,gemGrab,Minecart Madness,0,6,6
11423,2022-12-19,GROM,brawlBall,Center Stage,2,0,2
11424,2022-12-18,GROM,knockout,Belle's Rock,1,0,1
11425,2022-12-17,GROM,knockout,Flaring Phoenix,3,1,4
11426,2022-12-13,GROM,knockout,New Perspective,4,13,17
11427,2022-12-13,GROM,heist,Safe Zone,0,1,1
11428,2022-12-11,GROM,brawlBall,Backyard Bowl,2,0,2
11429,2022-10-26,GROM,bounty,Shooting Star,1,0,1
11430,2022-10-15,GROM,gemGrab,Hard Rock Mine,1,0,1
11431,2022-10-10,GROM,knockout,Belle's Rock,1,1,2
11432,2023-02-11,GRIFF,knockout,Flaring Phoenix,15,9,24
11433,2023-02-11,GRIFF,hotZone,Controller Chaos,124,202,326
11434,2023-02-11,GRIFF,gemGrab,Deep Diner,62,77,139
11435,2023-02-11,GRIFF,brawlBall,Super Beach,93,113,206
11436,2023-02-11,GRIFF,brawlBall,Sneaky Fields,87,88,175
11437,2023-02-10,GRIFF,knockout,Flaring Phoenix,27,25,52
11438,2023-02-10,GRIFF,hotZone,Controller Chaos,251,274,525
11439,2023-02-10,GRIFF,heist,Hot Potato,87,103,190
11440,2023-02-10,GRIFF,gemGrab,Undermine,21,40,61
11441,2023-02-10,GRIFF,gemGrab,Deep Diner,220,243,463
11442,2023-02-10,GRIFF,brawlBall,Sneaky Fields,605,629,1234
11443,2023-02-10,GRIFF,brawlBall,Pinhole Punt,9,9,18
11444,2023-02-10,GRIFF,bounty,Temple Ruins,29,34,63
11445,2023-02-09,GRIFF,knockout,Riverside,4,3,7
11446,2023-02-09,GRIFF,hotZone,Open Zone,14,12,26
11447,2023-02-09,GRIFF,heist,Hot Potato,24,20,44
11448,2023-02-09,GRIFF,gemGrab,Undermine,25,23,48
11449,2023-02-09,GRIFF,gemGrab,Gem Fort,2,4,6
11450,2023-02-09,GRIFF,brawlBall,Sunny Soccer,1,0,1
11451,2023-02-09,GRIFF,brawlBall,Pinhole Punt,172,166,338
11452,2023-02-09,GRIFF,bounty,Temple Ruins,6,4,10
11453,2023-02-08,GRIFF,hotZone,Open Zone,7,4,11
11454,2023-02-08,GRIFF,heist,Safe Zone,9,2,11
11455,2023-02-08,GRIFF,gemGrab,Gem Fort,7,15,22
11456,2023-02-08,GRIFF,gemGrab,Crystal Arcade,2,1,3
11457,2023-02-08,GRIFF,brawlBall,Sunny Soccer,50,28,78
11458,2023-02-08,GRIFF,brawlBall,Beach Ball,3,1,4
11459,2023-02-08,GRIFF,bounty,Excel,2,1,3
11460,2023-02-07,GRIFF,knockout,New Perspective,2,1,3
11461,2023-02-07,GRIFF,hotZone,Dueling Beetles,33,40,73
11462,2023-02-07,GRIFF,heist,Safe Zone,1,3,4
11463,2023-02-07,GRIFF,gemGrab,Minecart Madness,4,1,5
11464,2023-02-07,GRIFF,gemGrab,Crystal Arcade,8,10,18
11465,2023-02-07,GRIFF,brawlBall,Center Stage,8,9,17
11466,2023-02-07,GRIFF,brawlBall,Beach Ball,26,39,65
11467,2023-02-06,GRIFF,knockout,New Perspective,34,19,53
11468,2023-02-06,GRIFF,knockout,Goldarm Gulch,1,0,1
11469,2023-02-06,GRIFF,hotZone,Dueling Beetles,270,241,511
11470,2023-02-06,GRIFF,heist,Snaked Assault,181,217,398
11471,2023-02-06,GRIFF,heist,Pit Stop,42,21,63
11472,2023-02-06,GRIFF,gemGrab,Minecart Madness,62,70,132
11473,2023-02-06,GRIFF,gemGrab,Double Swoosh,148,121,269
11474,2023-02-06,GRIFF,brawlBall,Sneaky Fields,90,62,152
11475,2023-02-06,GRIFF,brawlBall,Center Stage,650,600,1250
11476,2023-02-06,GRIFF,brawlBall,Backyard Bowl,26,28,54
11477,2023-02-06,GRIFF,bounty,Layer Cake,19,21,40
11478,2023-02-05,GRIFF,knockout,X Marks the Spot,23,25,48
11479,2023-02-05,GRIFF,knockout,Goldarm Gulch,11,1,12
11480,2023-02-05,GRIFF,hotZone,Ring of Fire,100,72,172
11481,2023-02-05,GRIFF,heist,Snaked Assault,331,380,711
11482,2023-02-05,GRIFF,heist,Pit Stop,155,92,247
11483,2023-02-05,GRIFF,gemGrab,Hard Rock Mine,15,23,38
11484,2023-02-05,GRIFF,gemGrab,Double Swoosh,307,280,587
11485,2023-02-05,GRIFF,brawlBall,Super Beach,31,27,58
11486,2023-02-05,GRIFF,brawlBall,Sneaky Fields,239,212,451
11487,2023-02-05,GRIFF,brawlBall,Backyard Bowl,528,463,991
11488,2023-02-05,GRIFF,bounty,Layer Cake,14,11,25
11489,2023-02-04,GRIFF,knockout,X Marks the Spot,7,6,13
11490,2023-02-04,GRIFF,knockout,Goldarm Gulch,8,1,9
11491,2023-02-04,GRIFF,hotZone,Ring of Fire,25,16,41
11492,2023-02-04,GRIFF,heist,Tornado Ring,25,56,81
11493,2023-02-04,GRIFF,heist,Pit Stop,105,63,168
11494,2023-02-04,GRIFF,gemGrab,Hard Rock Mine,22,20,42
11495,2023-02-04,GRIFF,gemGrab,Double Swoosh,53,74,127
11496,2023-02-04,GRIFF,gemGrab,Deep Diner,12,7,19
11497,2023-02-04,GRIFF,brawlBall,Super Beach,141,175,316
11498,2023-02-04,GRIFF,brawlBall,Sneaky Fields,104,127,231
11499,2023-02-04,GRIFF,bounty,Dry Season,2,1,3
11500,2023-02-03,GRIFF,knockout,Out in the Open,38,27,65
11501,2023-02-03,GRIFF,knockout,Goldarm Gulch,23,8,31
11502,2023-02-03,GRIFF,hotZone,Split,85,151,236
11503,2023-02-03,GRIFF,heist,Tornado Ring,178,192,370
11504,2023-02-03,GRIFF,heist,Pit Stop,348,257,605
11505,2023-02-03,GRIFF,gemGrab,Undermine,39,64,103
11506,2023-02-03,GRIFF,gemGrab,Double Swoosh,263,274,537
11507,2023-02-03,GRIFF,gemGrab,Deep Diner,173,190,363
11508,2023-02-03,GRIFF,brawlBall,Sneaky Fields,1092,1097,2189
11509,2023-02-03,GRIFF,brawlBall,Pinhole Punt,27,40,67
11510,2023-02-03,GRIFF,bounty,Dry Season,17,7,24
11511,2023-02-02,GRIFF,knockout,Out in the Open,7,11,18
11512,2023-02-02,GRIFF,hotZone,Split,48,36,84
11513,2023-02-02,GRIFF,heist,Kaboom Canyon,10,4,14
11514,2023-02-02,GRIFF,gemGrab,Undermine,21,22,43
11515,2023-02-02,GRIFF,gemGrab,Gem Fort,16,13,29
11516,2023-02-02,GRIFF,brawlBall,Sunny Soccer,16,29,45
11517,2023-02-02,GRIFF,brawlBall,Pinhole Punt,150,148,298
11518,2023-02-02,GRIFF,bounty,Shooting Star,2,1,3
11519,2023-02-01,GRIFF,knockout,Goldarm Gulch,30,21,51
11520,2023-02-01,GRIFF,hotZone,Parallel Plays,138,164,302
11521,2023-02-01,GRIFF,heist,Kaboom Canyon,37,32,69
11522,2023-02-01,GRIFF,gemGrab,Gem Fort,95,89,184
11523,2023-02-01,GRIFF,gemGrab,Crystal Arcade,60,40,100
11524,2023-02-01,GRIFF,brawlBall,Sunny Soccer,432,437,869
11525,2023-02-01,GRIFF,brawlBall,Beach Ball,35,32,67
11526,2023-02-01,GRIFF,bounty,Shooting Star,3,0,3
11527,2023-01-31,GRIFF,knockout,Goldarm Gulch,22,24,46
11528,2023-01-31,GRIFF,hotZone,Parallel Plays,66,51,117
11529,2023-01-31,GRIFF,heist,Pit Stop,15,20,35
11530,2023-01-31,GRIFF,gemGrab,Minecart Madness,7,4,11
11531,2023-01-31,GRIFF,gemGrab,Crystal Arcade,42,38,80
11532,2023-01-31,GRIFF,brawlBall,Center Stage,7,6,13
11533,2023-01-31,GRIFF,brawlBall,Beach Ball,214,250,464
11534,2023-01-31,GRIFF,bounty,Hideout,6,1,7
11535,2023-01-30,GRIFF,knockout,Belle's Rock,24,12,36
11536,2023-01-30,GRIFF,hotZone,Quarter Pounder,244,396,640
11537,2023-01-30,GRIFF,heist,Pit Stop,83,80,163
11538,2023-01-30,GRIFF,gemGrab,Minecart Madness,48,40,88
11539,2023-01-30,GRIFF,gemGrab,Double Swoosh,93,93,186
11540,2023-01-30,GRIFF,brawlBall,Center Stage,445,418,863
11541,2023-01-30,GRIFF,brawlBall,Backyard Bowl,47,61,108
11542,2023-01-30,GRIFF,bounty,Hideout,3,2,5
11543,2023-01-29,GRIFF,knockout,Belle's Rock,23,9,32
11544,2023-01-29,GRIFF,hotZone,Quarter Pounder,307,399,706
11545,2023-01-29,GRIFF,heist,Bridge Too Far,33,25,58
11546,2023-01-29,GRIFF,gemGrab,Hard Rock Mine,12,10,22
11547,2023-01-29,GRIFF,gemGrab,Double Swoosh,128,115,243
11548,2023-01-29,GRIFF,brawlBall,Super Beach,7,5,12
11549,2023-01-29,GRIFF,brawlBall,Backyard Bowl,395,311,706
11550,2023-01-29,GRIFF,bounty,Canal Grande,22,18,40
11551,2023-01-28,GRIFF,knockout,Flaring Phoenix,19,11,30
11552,2023-01-28,GRIFF,hotZone,Controller Chaos,162,219,381
11553,2023-01-28,GRIFF,heist,Bridge Too Far,69,51,120
11554,2023-01-28,GRIFF,gemGrab,Hard Rock Mine,104,87,191
11555,2023-01-28,GRIFF,gemGrab,Deep Diner,58,57,115
11556,2023-01-28,GRIFF,brawlBall,Super Beach,699,739,1438
11557,2023-01-28,GRIFF,brawlBall,Sneaky Fields,20,21,41
11558,2023-01-28,GRIFF,bounty,Canal Grande,41,25,66
11559,2023-01-27,GRIFF,knockout,Flaring Phoenix,8,6,14
11560,2023-01-27,GRIFF,hotZone,Controller Chaos,41,28,69
11561,2023-01-27,GRIFF,heist,Hot Potato,34,25,59
11562,2023-01-27,GRIFF,gemGrab,Undermine,7,6,13
11563,2023-01-27,GRIFF,gemGrab,Deep Diner,85,89,174
11564,2023-01-27,GRIFF,brawlBall,Sneaky Fields,207,176,383
11565,2023-01-27,GRIFF,brawlBall,Pinhole Punt,5,8,13
11566,2023-01-27,GRIFF,bounty,Temple Ruins,9,1,10
11567,2023-01-26,GRIFF,knockout,Riverside,16,7,23
11568,2023-01-26,GRIFF,hotZone,Open Zone,76,54,130
11569,2023-01-26,GRIFF,heist,Hot Potato,139,155,294
11570,2023-01-26,GRIFF,gemGrab,Undermine,71,83,154
11571,2023-01-26,GRIFF,gemGrab,Gem Fort,43,40,83
11572,2023-01-26,GRIFF,brawlBall,Sunny Soccer,34,41,75
11573,2023-01-26,GRIFF,brawlBall,Pinhole Punt,644,648,1292
11574,2023-01-26,GRIFF,bounty,Temple Ruins,14,9,23
11575,2023-01-25,GRIFF,knockout,Riverside,6,4,10
11576,2023-01-25,GRIFF,hotZone,Open Zone,53,20,73
11577,2023-01-25,GRIFF,heist,Safe Zone,54,87,141
11578,2023-01-25,GRIFF,gemGrab,Gem Fort,39,50,89
11579,2023-01-25,GRIFF,gemGrab,Crystal Arcade,58,50,108
11580,2023-01-25,GRIFF,brawlBall,Sunny Soccer,305,323,628
11581,2023-01-25,GRIFF,brawlBall,Beach Ball,57,62,119
11582,2023-01-25,GRIFF,bounty,Excel,14,6,20
11583,2023-01-24,GRIFF,knockout,New Perspective,17,11,28
11584,2023-01-24,GRIFF,hotZone,Dueling Beetles,137,158,295
11585,2023-01-24,GRIFF,heist,Safe Zone,87,94,181
11586,2023-01-24,GRIFF,gemGrab,Minecart Madness,16,12,28
11587,2023-01-24,GRIFF,gemGrab,Crystal Arcade,114,100,214
11588,2023-01-24,GRIFF,brawlBall,Center Stage,73,113,186
11589,2023-01-24,GRIFF,brawlBall,Beach Ball,594,747,1341
11590,2023-01-24,GRIFF,bounty,Excel,17,4,21
11591,2023-01-23,GRIFF,knockout,New Perspective,37,29,66
11592,2023-01-23,GRIFF,hotZone,Dueling Beetles,261,198,459
11593,2023-01-23,GRIFF,heist,Snaked Assault,227,261,488
11594,2023-01-23,GRIFF,gemGrab,Minecart Madness,74,93,167
11595,2023-01-23,GRIFF,gemGrab,Double Swoosh,73,43,116
11596,2023-01-23,GRIFF,brawlBall,Center Stage,811,881,1692
11597,2023-01-23,GRIFF,brawlBall,Backyard Bowl,21,25,46
11598,2023-01-23,GRIFF,bounty,Layer Cake,13,15,28
11599,2023-01-22,GRIFF,knockout,X Marks the Spot,17,15,32
11600,2023-01-22,GRIFF,hotZone,Ring of Fire,88,99,187
11601,2023-01-22,GRIFF,heist,Snaked Assault,134,166,300
11602,2023-01-22,GRIFF,gemGrab,Hard Rock Mine,29,15,44
11603,2023-01-22,GRIFF,gemGrab,Double Swoosh,69,58,127
11604,2023-01-22,GRIFF,brawlBall,Super Beach,58,60,118
11605,2023-01-22,GRIFF,brawlBall,Backyard Bowl,228,166,394
11606,2023-01-22,GRIFF,bounty,Layer Cake,14,15,29
11607,2023-01-21,GRIFF,knockout,X Marks the Spot,52,25,77
11608,2023-01-21,GRIFF,hotZone,Ring of Fire,165,181,346
11609,2023-01-21,GRIFF,heist,Tornado Ring,165,194,359
11610,2023-01-21,GRIFF,gemGrab,Hard Rock Mine,139,166,305
11611,2023-01-21,GRIFF,gemGrab,Deep Diner,40,60,100
11612,2023-01-21,GRIFF,brawlBall,Super Beach,931,890,1821
11613,2023-01-21,GRIFF,brawlBall,Sneaky Fields,38,35,73
11614,2023-01-21,GRIFF,bounty,Dry Season,12,7,19
11615,2023-01-20,GRIFF,knockout,Out in the Open,37,32,69
11616,2023-01-20,GRIFF,hotZone,Split,80,92,172
11617,2023-01-20,GRIFF,heist,Tornado Ring,121,133,254
11618,2023-01-20,GRIFF,gemGrab,Undermine,45,29,74
11619,2023-01-20,GRIFF,gemGrab,Deep Diner,195,219,414
11620,2023-01-20,GRIFF,brawlBall,Sneaky Fields,697,709,1406
11621,2023-01-20,GRIFF,brawlBall,Pinhole Punt,37,27,64
11622,2023-01-20,GRIFF,bounty,Dry Season,10,4,14
11623,2023-01-19,GRIFF,knockout,Out in the Open,64,31,95
11624,2023-01-19,GRIFF,hotZone,Split,125,92,217
11625,2023-01-19,GRIFF,heist,Kaboom Canyon,63,64,127
11626,2023-01-19,GRIFF,gemGrab,Undermine,82,74,156
11627,2023-01-19,GRIFF,gemGrab,Gem Fort,32,17,49
11628,2023-01-19,GRIFF,brawlBall,Sunny Soccer,14,15,29
11629,2023-01-19,GRIFF,brawlBall,Pinhole Punt,712,737,1449
11630,2023-01-19,GRIFF,bounty,Shooting Star,16,7,23
11631,2023-01-18,GRIFF,knockout,Goldarm Gulch,9,9,18
11632,2023-01-18,GRIFF,hotZone,Parallel Plays,16,26,42
11633,2023-01-18,GRIFF,heist,Kaboom Canyon,13,15,28
11634,2023-01-18,GRIFF,gemGrab,Gem Fort,42,33,75
11635,2023-01-18,GRIFF,gemGrab,Crystal Arcade,4,3,7
11636,2023-01-18,GRIFF,brawlBall,Sunny Soccer,155,174,329
11637,2023-01-18,GRIFF,brawlBall,Beach Ball,6,6,12
11638,2023-01-18,GRIFF,bounty,Shooting Star,3,1,4
11639,2023-01-17,GRIFF,knockout,Goldarm Gulch,1,4,5
11640,2023-01-17,GRIFF,hotZone,Parallel Plays,13,24,37
11641,2023-01-17,GRIFF,heist,Pit Stop,11,13,24
11642,2023-01-17,GRIFF,gemGrab,Crystal Arcade,11,11,22
11643,2023-01-17,GRIFF,brawlBall,Center Stage,2,5,7
11644,2023-01-17,GRIFF,brawlBall,Beach Ball,48,48,96
11645,2023-01-17,GRIFF,bounty,Hideout,1,0,1
11646,2023-01-16,GRIFF,knockout,Belle's Rock,1,0,1
11647,2023-01-16,GRIFF,hotZone,Quarter Pounder,21,17,38
11648,2023-01-16,GRIFF,heist,Pit Stop,40,40,80
11649,2023-01-16,GRIFF,gemGrab,Minecart Madness,8,3,11
11650,2023-01-16,GRIFF,gemGrab,Double Swoosh,6,8,14
11651,2023-01-16,GRIFF,brawlBall,Center Stage,44,51,95
11652,2023-01-16,GRIFF,brawlBall,Backyard Bowl,2,6,8
11653,2023-01-15,GRIFF,knockout,Belle's Rock,0,1,1
11654,2023-01-15,GRIFF,hotZone,Quarter Pounder,73,124,197
11655,2023-01-15,GRIFF,heist,Bridge Too Far,16,16,32
11656,2023-01-15,GRIFF,gemGrab,Hard Rock Mine,5,2,7
11657,2023-01-15,GRIFF,gemGrab,Double Swoosh,14,2,16
11658,2023-01-15,GRIFF,brawlBall,Super Beach,2,6,8
11659,2023-01-15,GRIFF,brawlBall,Backyard Bowl,41,51,92
11660,2023-01-15,GRIFF,bounty,Canal Grande,2,0,2
11661,2023-01-14,GRIFF,knockout,Flaring Phoenix,2,0,2
11662,2023-01-14,GRIFF,hotZone,Controller Chaos,48,83,131
11663,2023-01-14,GRIFF,heist,Bridge Too Far,6,2,8
11664,2023-01-14,GRIFF,gemGrab,Hard Rock Mine,0,2,2
11665,2023-01-14,GRIFF,gemGrab,Deep Diner,6,5,11
11666,2023-01-14,GRIFF,brawlBall,Super Beach,56,95,151
11667,2023-01-14,GRIFF,brawlBall,Sneaky Fields,10,1,11
11668,2023-01-14,GRIFF,bounty,Canal Grande,1,0,1
11669,2023-01-13,GRIFF,knockout,Flaring Phoenix,4,0,4
11670,2023-01-13,GRIFF,hotZone,Controller Chaos,64,87,151
11671,2023-01-13,GRIFF,heist,Hot Potato,3,2,5
11672,2023-01-13,GRIFF,gemGrab,Deep Diner,16,19,35
11673,2023-01-13,GRIFF,brawlBall,Sneaky Fields,47,61,108
11674,2023-01-13,GRIFF,brawlBall,Pinhole Punt,8,12,20
11675,2023-01-12,GRIFF,knockout,Riverside,1,1,2
11676,2023-01-12,GRIFF,hotZone,Open Zone,12,6,18
11677,2023-01-12,GRIFF,heist,Hot Potato,5,0,5
11678,2023-01-12,GRIFF,gemGrab,Undermine,2,7,9
11679,2023-01-12,GRIFF,gemGrab,Gem Fort,0,1,1
11680,2023-01-12,GRIFF,brawlBall,Sunny Soccer,1,0,1
11681,2023-01-12,GRIFF,brawlBall,Pinhole Punt,24,23,47
11682,2023-01-11,GRIFF,hotZone,Open Zone,3,0,3
11683,2023-01-11,GRIFF,heist,Safe Zone,1,0,1
11684,2023-01-11,GRIFF,gemGrab,Gem Fort,2,0,2
11685,2023-01-11,GRIFF,brawlBall,Sunny Soccer,8,5,13
11686,2023-01-10,GRIFF,knockout,New Perspective,3,0,3
11687,2023-01-10,GRIFF,hotZone,Dueling Beetles,22,34,56
11688,2023-01-10,GRIFF,heist,Safe Zone,8,2,10
11689,2023-01-10,GRIFF,gemGrab,Minecart Madness,1,0,1
11690,2023-01-10,GRIFF,gemGrab,Crystal Arcade,15,51,66
11691,2023-01-10,GRIFF,brawlBall,Center Stage,9,0,9
11692,2023-01-10,GRIFF,brawlBall,Beach Ball,31,27,58
11693,2023-01-09,GRIFF,hotZone,Dueling Beetles,14,23,37
11694,2023-01-09,GRIFF,heist,Snaked Assault,31,39,70
11695,2023-01-09,GRIFF,gemGrab,Minecart Madness,6,1,7
11696,2023-01-09,GRIFF,gemGrab,Double Swoosh,6,15,21
11697,2023-01-09,GRIFF,brawlBall,Center Stage,43,29,72
11698,2023-01-09,GRIFF,brawlBall,Backyard Bowl,3,2,5
11699,2023-01-09,GRIFF,bounty,Layer Cake,1,0,1
11700,2023-01-08,GRIFF,hotZone,Ring of Fire,20,27,47
11701,2023-01-08,GRIFF,heist,Snaked Assault,14,8,22
11702,2023-01-08,GRIFF,gemGrab,Hard Rock Mine,3,4,7
11703,2023-01-08,GRIFF,gemGrab,Double Swoosh,2,1,3
11704,2023-01-08,GRIFF,brawlBall,Super Beach,10,8,18
11705,2023-01-08,GRIFF,brawlBall,Backyard Bowl,37,35,72
11706,2023-01-07,GRIFF,hotZone,Ring of Fire,7,19,26
11707,2023-01-07,GRIFF,heist,Tornado Ring,19,4,23
11708,2023-01-07,GRIFF,gemGrab,Hard Rock Mine,8,2,10
11709,2023-01-07,GRIFF,gemGrab,Deep Diner,4,2,6
11710,2023-01-07,GRIFF,brawlBall,Super Beach,22,22,44
11711,2023-01-07,GRIFF,bounty,Dry Season,0,2,2
11712,2023-01-06,GRIFF,knockout,Out in the Open,2,1,3
11713,2023-01-06,GRIFF,hotZone,Split,9,7,16
11714,2023-01-06,GRIFF,heist,Tornado Ring,21,46,67
11715,2023-01-06,GRIFF,gemGrab,Undermine,3,1,4
11716,2023-01-06,GRIFF,gemGrab,Deep Diner,21,26,47
11717,2023-01-06,GRIFF,brawlBall,Sneaky Fields,29,27,56
11718,2023-01-06,GRIFF,brawlBall,Pinhole Punt,2,6,8
11719,2023-01-05,GRIFF,knockout,Out in the Open,6,1,7
11720,2023-01-05,GRIFF,hotZone,Split,43,61,104
11721,2023-01-05,GRIFF,heist,Kaboom Canyon,7,1,8
11722,2023-01-05,GRIFF,gemGrab,Undermine,5,1,6
11723,2023-01-05,GRIFF,gemGrab,Gem Fort,3,2,5
11724,2023-01-05,GRIFF,brawlBall,Sunny Soccer,0,1,1
11725,2023-01-05,GRIFF,brawlBall,Pinhole Punt,75,76,151
11726,2023-01-04,GRIFF,hotZone,Parallel Plays,8,42,50
11727,2023-01-04,GRIFF,heist,Kaboom Canyon,13,7,20
11728,2023-01-04,GRIFF,gemGrab,Gem Fort,11,23,34
11729,2023-01-04,GRIFF,gemGrab,Crystal Arcade,1,0,1
11730,2023-01-04,GRIFF,brawlBall,Sunny Soccer,68,56,124
11731,2023-01-04,GRIFF,brawlBall,Beach Ball,1,0,1
11732,2023-01-04,GRIFF,bounty,Shooting Star,1,0,1
11733,2023-01-03,GRIFF,hotZone,Parallel Plays,28,55,83
11734,2023-01-03,GRIFF,heist,Pit Stop,13,28,41
11735,2023-01-03,GRIFF,gemGrab,Minecart Madness,2,0,2
11736,2023-01-03,GRIFF,gemGrab,Crystal Arcade,30,54,84
11737,2023-01-03,GRIFF,brawlBall,Center Stage,1,2,3
11738,2023-01-03,GRIFF,brawlBall,Beach Ball,34,34,68
11739,2023-01-03,GRIFF,bounty,Hideout,1,0,1
11740,2023-01-02,GRIFF,knockout,Belle's Rock,2,0,2
11741,2023-01-02,GRIFF,hotZone,Quarter Pounder,37,44,81
11742,2023-01-02,GRIFF,hotZone,Controller Chaos,0,2,2
11743,2023-01-02,GRIFF,heist,Pit Stop,35,21,56
11744,2023-01-02,GRIFF,heist,Kaboom Canyon,1,0,1
11745,2023-01-02,GRIFF,gemGrab,Minecart Madness,11,4,15
11746,2023-01-02,GRIFF,gemGrab,Double Swoosh,14,17,31
11747,2023-01-02,GRIFF,brawlBall,Center Stage,39,34,73
11748,2023-01-02,GRIFF,brawlBall,Backyard Bowl,2,1,3
11749,2023-01-02,GRIFF,bounty,Hideout,2,0,2
11750,2023-01-01,GRIFF,hotZone,Quarter Pounder,21,16,37
11751,2023-01-01,GRIFF,hotZone,Controller Chaos,1,0,1
11752,2023-01-01,GRIFF,heist,Bridge Too Far,0,1,1
11753,2023-01-01,GRIFF,gemGrab,Double Swoosh,7,16,23
11754,2023-01-01,GRIFF,brawlBall,Backyard Bowl,16,21,37
11755,2023-01-01,GRIFF,bounty,Canal Grande,2,0,2
11756,2022-12-31,GRIFF,hotZone,Controller Chaos,2,2,4
11757,2022-12-31,GRIFF,heist,Bridge Too Far,2,0,2
11758,2022-12-31,GRIFF,gemGrab,Hard Rock Mine,1,0,1
11759,2022-12-31,GRIFF,gemGrab,Deep Diner,3,1,4
11760,2022-12-31,GRIFF,brawlBall,Super Beach,3,2,5
11761,2022-12-31,GRIFF,brawlBall,Sneaky Fields,0,1,1
11762,2022-12-30,GRIFF,knockout,Flaring Phoenix,2,0,2
11763,2022-12-30,GRIFF,hotZone,Controller Chaos,5,1,6
11764,2022-12-30,GRIFF,heist,Hot Potato,1,0,1
11765,2022-12-30,GRIFF,gemGrab,Undermine,2,13,15
11766,2022-12-30,GRIFF,gemGrab,Deep Diner,4,7,11
11767,2022-12-30,GRIFF,brawlBall,Sneaky Fields,5,10,15
11768,2022-12-29,GRIFF,hotZone,Open Zone,0,1,1
11769,2022-12-29,GRIFF,heist,Kaboom Canyon,1,0,1
11770,2022-12-29,GRIFF,brawlBall,Pinhole Punt,3,1,4
11771,2022-12-27,GRIFF,hotZone,Controller Chaos,1,0,1
11772,2022-12-27,GRIFF,heist,Safe Zone,2,0,2
11773,2022-12-27,GRIFF,heist,Kaboom Canyon,1,1,2
11774,2022-12-27,GRIFF,gemGrab,Minecart Madness,0,1,1
11775,2022-12-27,GRIFF,brawlBall,Beach Ball,0,3,3
11776,2022-12-26,GRIFF,hotZone,Controller Chaos,0,3,3
11777,2022-12-26,GRIFF,heist,Kaboom Canyon,1,0,1
11778,2022-12-26,GRIFF,brawlBall,Center Stage,4,3,7
11779,2022-12-24,GRIFF,brawlBall,Super Beach,1,0,1
11780,2022-12-22,GRIFF,gemGrab,Gem Fort,1,0,1
11781,2022-12-22,GRIFF,brawlBall,Pinhole Punt,3,0,3
11782,2022-12-21,GRIFF,brawlBall,Sunny Soccer,1,0,1
11783,2022-12-20,GRIFF,brawlBall,Beach Ball,1,1,2
11784,2022-12-19,GRIFF,gemGrab,Minecart Madness,2,0,2
11785,2022-12-19,GRIFF,brawlBall,Center Stage,2,1,3
11786,2022-12-16,GRIFF,hotZone,Controller Chaos,0,1,1
11787,2022-12-16,GRIFF,brawlBall,Sneaky Fields,0,1,1
11788,2022-12-13,GRIFF,gemGrab,Crystal Arcade,1,0,1
11789,2022-12-12,GRIFF,brawlBall,Center Stage,2,4,6
11790,2022-12-11,GRIFF,gemGrab,Double Swoosh,0,2,2
11791,2022-12-11,GRIFF,brawlBall,Backyard Bowl,2,4,6
11792,2022-11-18,GRIFF,hotZone,Parallel Plays,2,4,6
11793,2022-11-18,GRIFF,brawlBall,Beach Ball,0,4,4
11794,2022-11-11,GRIFF,brawlBall,Sneaky Fields,6,10,16
11795,2022-10-30,GRIFF,hotZone,Dueling Beetles,1,0,1
11796,2022-10-30,GRIFF,brawlBall,Beach Ball,1,0,1
11797,2022-10-28,GRIFF,knockout,Out in the Open,2,0,2
11798,2022-10-28,GRIFF,bounty,Canal Grande,0,4,4
11799,2022-10-15,GRIFF,hotZone,Ring of Fire,1,2,3
11800,2022-10-15,GRIFF,gemGrab,Hard Rock Mine,0,1,1
11801,2022-09-06,GRIFF,brawlBall,Beach Ball,2,0,2
11802,2023-02-11,GRAY,knockout,Flaring Phoenix,376,548,924
11803,2023-02-11,GRAY,hotZone,Controller Chaos,23,28,51
11804,2023-02-11,GRAY,gemGrab,Deep Diner,63,99,162
11805,2023-02-11,GRAY,brawlBall,Super Beach,84,74,158
11806,2023-02-11,GRAY,brawlBall,Sneaky Fields,21,29,50
11807,2023-02-10,GRAY,knockout,Flaring Phoenix,690,808,1498
11808,2023-02-10,GRAY,hotZone,Controller Chaos,49,39,88
11809,2023-02-10,GRAY,heist,Hot Potato,5,3,8
11810,2023-02-10,GRAY,gemGrab,Undermine,20,29,49
11811,2023-02-10,GRAY,gemGrab,Deep Diner,137,200,337
11812,2023-02-10,GRAY,brawlBall,Sneaky Fields,298,319,617
11813,2023-02-10,GRAY,brawlBall,Pinhole Punt,12,7,19
11814,2023-02-10,GRAY,bounty,Temple Ruins,45,50,95
11815,2023-02-09,GRAY,knockout,Riverside,25,27,52
11816,2023-02-09,GRAY,hotZone,Open Zone,5,15,20
11817,2023-02-09,GRAY,heist,Hot Potato,5,1,6
11818,2023-02-09,GRAY,gemGrab,Undermine,21,37,58
11819,2023-02-09,GRAY,gemGrab,Gem Fort,3,1,4
11820,2023-02-09,GRAY,brawlBall,Sunny Soccer,0,3,3
11821,2023-02-09,GRAY,brawlBall,Pinhole Punt,137,178,315
11822,2023-02-09,GRAY,bounty,Temple Ruins,28,37,65
11823,2023-02-08,GRAY,knockout,Riverside,27,27,54
11824,2023-02-08,GRAY,hotZone,Open Zone,7,12,19
11825,2023-02-08,GRAY,heist,Safe Zone,3,5,8
11826,2023-02-08,GRAY,gemGrab,Gem Fort,11,20,31
11827,2023-02-08,GRAY,gemGrab,Crystal Arcade,1,2,3
11828,2023-02-08,GRAY,brawlBall,Sunny Soccer,60,55,115
11829,2023-02-08,GRAY,brawlBall,Beach Ball,6,10,16
11830,2023-02-08,GRAY,bounty,Excel,11,15,26
11831,2023-02-07,GRAY,knockout,New Perspective,43,99,142
11832,2023-02-07,GRAY,hotZone,Dueling Beetles,10,22,32
11833,2023-02-07,GRAY,heist,Safe Zone,0,1,1
11834,2023-02-07,GRAY,gemGrab,Minecart Madness,10,28,38
11835,2023-02-07,GRAY,gemGrab,Crystal Arcade,9,10,19
11836,2023-02-07,GRAY,brawlBall,Center Stage,2,0,2
11837,2023-02-07,GRAY,brawlBall,Beach Ball,33,41,74
11838,2023-02-07,GRAY,bounty,Excel,9,17,26
11839,2023-02-06,GRAY,knockout,New Perspective,919,1152,2071
11840,2023-02-06,GRAY,knockout,Goldarm Gulch,68,84,152
11841,2023-02-06,GRAY,hotZone,Dueling Beetles,65,104,169
11842,2023-02-06,GRAY,heist,Snaked Assault,11,7,18
11843,2023-02-06,GRAY,heist,Pit Stop,1,0,1
11844,2023-02-06,GRAY,gemGrab,Minecart Madness,195,249,444
11845,2023-02-06,GRAY,gemGrab,Double Swoosh,45,44,89
11846,2023-02-06,GRAY,brawlBall,Sneaky Fields,6,0,6
11847,2023-02-06,GRAY,brawlBall,Center Stage,499,517,1016
11848,2023-02-06,GRAY,brawlBall,Backyard Bowl,87,113,200
11849,2023-02-06,GRAY,bounty,Layer Cake,80,118,198
11850,2023-02-05,GRAY,knockout,X Marks the Spot,482,618,1100
11851,2023-02-05,GRAY,knockout,Goldarm Gulch,248,327,575
11852,2023-02-05,GRAY,hotZone,Ring of Fire,44,40,84
11853,2023-02-05,GRAY,heist,Snaked Assault,8,6,14
11854,2023-02-05,GRAY,heist,Pit Stop,6,1,7
11855,2023-02-05,GRAY,gemGrab,Hard Rock Mine,18,20,38
11856,2023-02-05,GRAY,gemGrab,Double Swoosh,125,121,246
11857,2023-02-05,GRAY,brawlBall,Super Beach,15,9,24
11858,2023-02-05,GRAY,brawlBall,Sneaky Fields,15,8,23
11859,2023-02-05,GRAY,brawlBall,Backyard Bowl,782,1020,1802
11860,2023-02-05,GRAY,bounty,Layer Cake,94,133,227
11861,2023-02-04,GRAY,knockout,X Marks the Spot,164,163,327
11862,2023-02-04,GRAY,knockout,Goldarm Gulch,177,257,434
11863,2023-02-04,GRAY,hotZone,Ring of Fire,6,5,11
11864,2023-02-04,GRAY,heist,Tornado Ring,3,1,4
11865,2023-02-04,GRAY,heist,Pit Stop,6,6,12
11866,2023-02-04,GRAY,gemGrab,Hard Rock Mine,23,40,63
11867,2023-02-04,GRAY,gemGrab,Double Swoosh,13,3,16
11868,2023-02-04,GRAY,gemGrab,Deep Diner,13,16,29
11869,2023-02-04,GRAY,brawlBall,Super Beach,148,190,338
11870,2023-02-04,GRAY,brawlBall,Sneaky Fields,12,9,21
11871,2023-02-04,GRAY,bounty,Dry Season,24,35,59
11872,2023-02-03,GRAY,knockout,Out in the Open,483,658,1141
11873,2023-02-03,GRAY,knockout,Goldarm Gulch,787,1046,1833
11874,2023-02-03,GRAY,hotZone,Split,58,68,126
11875,2023-02-03,GRAY,heist,Tornado Ring,3,10,13
11876,2023-02-03,GRAY,heist,Pit Stop,21,9,30
11877,2023-02-03,GRAY,gemGrab,Undermine,18,17,35
11878,2023-02-03,GRAY,gemGrab,Double Swoosh,83,50,133
11879,2023-02-03,GRAY,gemGrab,Deep Diner,118,147,265
11880,2023-02-03,GRAY,brawlBall,Sneaky Fields,291,348,639
11881,2023-02-03,GRAY,brawlBall,Pinhole Punt,19,23,42
11882,2023-02-03,GRAY,bounty,Dry Season,107,138,245
11883,2023-02-02,GRAY,knockout,Out in the Open,260,322,582
11884,2023-02-02,GRAY,hotZone,Split,25,23,48
11885,2023-02-02,GRAY,heist,Kaboom Canyon,3,1,4
11886,2023-02-02,GRAY,gemGrab,Undermine,21,18,39
11887,2023-02-02,GRAY,gemGrab,Gem Fort,4,1,5
11888,2023-02-02,GRAY,brawlBall,Sunny Soccer,8,3,11
11889,2023-02-02,GRAY,brawlBall,Pinhole Punt,103,152,255
11890,2023-02-02,GRAY,bounty,Shooting Star,30,26,56
11891,2023-02-01,GRAY,knockout,Goldarm Gulch,640,992,1632
11892,2023-02-01,GRAY,hotZone,Parallel Plays,57,136,193
11893,2023-02-01,GRAY,heist,Kaboom Canyon,4,2,6
11894,2023-02-01,GRAY,gemGrab,Gem Fort,63,82,145
11895,2023-02-01,GRAY,gemGrab,Crystal Arcade,35,52,87
11896,2023-02-01,GRAY,brawlBall,Sunny Soccer,367,450,817
11897,2023-02-01,GRAY,brawlBall,Beach Ball,29,27,56
11898,2023-02-01,GRAY,bounty,Shooting Star,46,69,115
11899,2023-01-31,GRAY,knockout,Goldarm Gulch,401,547,948
11900,2023-01-31,GRAY,hotZone,Parallel Plays,22,31,53
11901,2023-01-31,GRAY,heist,Pit Stop,9,6,15
11902,2023-01-31,GRAY,gemGrab,Minecart Madness,15,21,36
11903,2023-01-31,GRAY,gemGrab,Crystal Arcade,57,74,131
11904,2023-01-31,GRAY,brawlBall,Center Stage,2,0,2
11905,2023-01-31,GRAY,brawlBall,Beach Ball,253,321,574
11906,2023-01-31,GRAY,bounty,Hideout,31,42,73
11907,2023-01-30,GRAY,knockout,Belle's Rock,557,812,1369
11908,2023-01-30,GRAY,hotZone,Quarter Pounder,55,98,153
11909,2023-01-30,GRAY,heist,Pit Stop,2,1,3
11910,2023-01-30,GRAY,gemGrab,Minecart Madness,92,106,198
11911,2023-01-30,GRAY,gemGrab,Double Swoosh,46,38,84
11912,2023-01-30,GRAY,brawlBall,Center Stage,282,261,543
11913,2023-01-30,GRAY,brawlBall,Backyard Bowl,65,87,152
11914,2023-01-30,GRAY,bounty,Hideout,36,44,80
11915,2023-01-29,GRAY,knockout,Belle's Rock,653,910,1563
11916,2023-01-29,GRAY,hotZone,Quarter Pounder,39,96,135
11917,2023-01-29,GRAY,heist,Bridge Too Far,13,19,32
11918,2023-01-29,GRAY,gemGrab,Hard Rock Mine,24,30,54
11919,2023-01-29,GRAY,gemGrab,Double Swoosh,70,78,148
11920,2023-01-29,GRAY,brawlBall,Super Beach,9,8,17
11921,2023-01-29,GRAY,brawlBall,Backyard Bowl,677,941,1618
11922,2023-01-29,GRAY,bounty,Canal Grande,38,71,109
11923,2023-01-28,GRAY,knockout,Flaring Phoenix,333,478,811
11924,2023-01-28,GRAY,hotZone,Controller Chaos,39,34,73
11925,2023-01-28,GRAY,heist,Bridge Too Far,31,20,51
11926,2023-01-28,GRAY,gemGrab,Hard Rock Mine,92,109,201
11927,2023-01-28,GRAY,gemGrab,Deep Diner,34,59,93
11928,2023-01-28,GRAY,brawlBall,Super Beach,456,535,991
11929,2023-01-28,GRAY,brawlBall,Sneaky Fields,19,19,38
11930,2023-01-28,GRAY,bounty,Canal Grande,53,58,111
11931,2023-01-27,GRAY,knockout,Flaring Phoenix,191,260,451
11932,2023-01-27,GRAY,hotZone,Controller Chaos,10,9,19
11933,2023-01-27,GRAY,heist,Hot Potato,6,2,8
11934,2023-01-27,GRAY,gemGrab,Undermine,3,7,10
11935,2023-01-27,GRAY,gemGrab,Deep Diner,53,93,146
11936,2023-01-27,GRAY,brawlBall,Sneaky Fields,99,98,197
11937,2023-01-27,GRAY,brawlBall,Pinhole Punt,5,7,12
11938,2023-01-27,GRAY,bounty,Temple Ruins,13,26,39
11939,2023-01-26,GRAY,knockout,Riverside,166,174,340
11940,2023-01-26,GRAY,hotZone,Open Zone,31,52,83
11941,2023-01-26,GRAY,heist,Hot Potato,12,10,22
11942,2023-01-26,GRAY,gemGrab,Undermine,27,35,62
11943,2023-01-26,GRAY,gemGrab,Gem Fort,29,23,52
11944,2023-01-26,GRAY,brawlBall,Sunny Soccer,33,38,71
11945,2023-01-26,GRAY,brawlBall,Pinhole Punt,408,468,876
11946,2023-01-26,GRAY,bounty,Temple Ruins,50,54,104
11947,2023-01-25,GRAY,knockout,Riverside,96,82,178
11948,2023-01-25,GRAY,hotZone,Open Zone,12,30,42
11949,2023-01-25,GRAY,heist,Safe Zone,11,7,18
11950,2023-01-25,GRAY,gemGrab,Gem Fort,33,65,98
11951,2023-01-25,GRAY,gemGrab,Crystal Arcade,41,78,119
11952,2023-01-25,GRAY,brawlBall,Sunny Soccer,269,280,549
11953,2023-01-25,GRAY,brawlBall,Beach Ball,60,59,119
11954,2023-01-25,GRAY,bounty,Excel,33,26,59
11955,2023-01-24,GRAY,knockout,New Perspective,302,398,700
11956,2023-01-24,GRAY,hotZone,Dueling Beetles,34,38,72
11957,2023-01-24,GRAY,heist,Safe Zone,26,33,59
11958,2023-01-24,GRAY,gemGrab,Minecart Madness,37,61,98
11959,2023-01-24,GRAY,gemGrab,Crystal Arcade,80,116,196
11960,2023-01-24,GRAY,brawlBall,Center Stage,43,21,64
11961,2023-01-24,GRAY,brawlBall,Beach Ball,519,593,1112
11962,2023-01-24,GRAY,bounty,Excel,69,94,163
11963,2023-01-23,GRAY,knockout,New Perspective,824,1086,1910
11964,2023-01-23,GRAY,hotZone,Dueling Beetles,70,72,142
11965,2023-01-23,GRAY,heist,Snaked Assault,13,14,27
11966,2023-01-23,GRAY,gemGrab,Minecart Madness,153,237,390
11967,2023-01-23,GRAY,gemGrab,Double Swoosh,29,41,70
11968,2023-01-23,GRAY,brawlBall,Center Stage,455,521,976
11969,2023-01-23,GRAY,brawlBall,Backyard Bowl,27,22,49
11970,2023-01-23,GRAY,bounty,Layer Cake,104,143,247
11971,2023-01-22,GRAY,knockout,X Marks the Spot,371,433,804
11972,2023-01-22,GRAY,hotZone,Ring of Fire,3,5,8
11973,2023-01-22,GRAY,heist,Snaked Assault,7,6,13
11974,2023-01-22,GRAY,gemGrab,Hard Rock Mine,29,29,58
11975,2023-01-22,GRAY,gemGrab,Double Swoosh,44,45,89
11976,2023-01-22,GRAY,brawlBall,Super Beach,39,64,103
11977,2023-01-22,GRAY,brawlBall,Backyard Bowl,316,435,751
11978,2023-01-22,GRAY,bounty,Layer Cake,53,61,114
11979,2023-01-21,GRAY,knockout,X Marks the Spot,1256,1640,2896
11980,2023-01-21,GRAY,hotZone,Ring of Fire,46,74,120
11981,2023-01-21,GRAY,heist,Tornado Ring,17,6,23
11982,2023-01-21,GRAY,gemGrab,Hard Rock Mine,79,98,177
11983,2023-01-21,GRAY,gemGrab,Deep Diner,33,54,87
11984,2023-01-21,GRAY,brawlBall,Super Beach,648,831,1479
11985,2023-01-21,GRAY,brawlBall,Sneaky Fields,15,20,35
11986,2023-01-21,GRAY,bounty,Dry Season,114,119,233
11987,2023-01-20,GRAY,knockout,Out in the Open,555,841,1396
11988,2023-01-20,GRAY,hotZone,Split,61,81,142
11989,2023-01-20,GRAY,heist,Tornado Ring,19,8,27
11990,2023-01-20,GRAY,gemGrab,Undermine,26,20,46
11991,2023-01-20,GRAY,gemGrab,Deep Diner,139,187,326
11992,2023-01-20,GRAY,brawlBall,Sneaky Fields,259,271,530
11993,2023-01-20,GRAY,brawlBall,Pinhole Punt,10,12,22
11994,2023-01-20,GRAY,bounty,Dry Season,93,121,214
11995,2023-01-19,GRAY,knockout,Out in the Open,1044,1511,2555
11996,2023-01-19,GRAY,hotZone,Split,68,57,125
11997,2023-01-19,GRAY,heist,Kaboom Canyon,18,23,41
11998,2023-01-19,GRAY,gemGrab,Undermine,52,77,129
11999,2023-01-19,GRAY,gemGrab,Gem Fort,9,7,16
12000,2023-01-19,GRAY,brawlBall,Sunny Soccer,17,23,40
12001,2023-01-19,GRAY,brawlBall,Pinhole Punt,410,471,881
12002,2023-01-19,GRAY,bounty,Shooting Star,74,94,168
12003,2023-01-18,GRAY,knockout,Goldarm Gulch,109,123,232
12004,2023-01-18,GRAY,hotZone,Parallel Plays,9,7,16
12005,2023-01-18,GRAY,heist,Kaboom Canyon,8,7,15
12006,2023-01-18,GRAY,gemGrab,Gem Fort,20,19,39
12007,2023-01-18,GRAY,gemGrab,Crystal Arcade,2,3,5
12008,2023-01-18,GRAY,brawlBall,Sunny Soccer,160,177,337
12009,2023-01-18,GRAY,brawlBall,Beach Ball,8,10,18
12010,2023-01-18,GRAY,bounty,Shooting Star,48,30,78
12011,2023-01-17,GRAY,knockout,Goldarm Gulch,84,132,216
12012,2023-01-17,GRAY,hotZone,Parallel Plays,4,8,12
12013,2023-01-17,GRAY,gemGrab,Minecart Madness,2,4,6
12014,2023-01-17,GRAY,gemGrab,Crystal Arcade,7,7,14
12015,2023-01-17,GRAY,brawlBall,Center Stage,1,0,1
12016,2023-01-17,GRAY,brawlBall,Beach Ball,30,64,94
12017,2023-01-17,GRAY,bounty,Hideout,4,4,8
12018,2023-01-16,GRAY,knockout,Belle's Rock,44,70,114
12019,2023-01-16,GRAY,hotZone,Quarter Pounder,7,3,10
12020,2023-01-16,GRAY,heist,Pit Stop,2,0,2
12021,2023-01-16,GRAY,gemGrab,Minecart Madness,17,32,49
12022,2023-01-16,GRAY,gemGrab,Double Swoosh,0,1,1
12023,2023-01-16,GRAY,brawlBall,Center Stage,27,32,59
12024,2023-01-16,GRAY,brawlBall,Backyard Bowl,4,1,5
12025,2023-01-16,GRAY,bounty,Hideout,7,6,13
12026,2023-01-15,GRAY,knockout,Belle's Rock,83,98,181
12027,2023-01-15,GRAY,hotZone,Quarter Pounder,21,81,102
12028,2023-01-15,GRAY,heist,Bridge Too Far,3,0,3
12029,2023-01-15,GRAY,gemGrab,Hard Rock Mine,2,4,6
12030,2023-01-15,GRAY,gemGrab,Double Swoosh,9,10,19
12031,2023-01-15,GRAY,brawlBall,Super Beach,3,1,4
12032,2023-01-15,GRAY,brawlBall,Backyard Bowl,49,48,97
12033,2023-01-15,GRAY,bounty,Canal Grande,5,3,8
12034,2023-01-14,GRAY,knockout,Flaring Phoenix,43,61,104
12035,2023-01-14,GRAY,hotZone,Controller Chaos,9,0,9
12036,2023-01-14,GRAY,heist,Bridge Too Far,3,0,3
12037,2023-01-14,GRAY,gemGrab,Hard Rock Mine,3,1,4
12038,2023-01-14,GRAY,gemGrab,Deep Diner,8,6,14
12039,2023-01-14,GRAY,brawlBall,Super Beach,27,27,54
12040,2023-01-14,GRAY,bounty,Canal Grande,5,3,8
12041,2023-01-13,GRAY,knockout,Flaring Phoenix,33,38,71
12042,2023-01-13,GRAY,hotZone,Controller Chaos,3,3,6
12043,2023-01-13,GRAY,gemGrab,Deep Diner,7,22,29
12044,2023-01-13,GRAY,brawlBall,Sneaky Fields,12,41,53
12045,2023-01-13,GRAY,brawlBall,Pinhole Punt,0,1,1
12046,2023-01-13,GRAY,bounty,Temple Ruins,1,1,2
12047,2023-01-12,GRAY,knockout,Riverside,23,16,39
12048,2023-01-12,GRAY,hotZone,Open Zone,8,13,21
12049,2023-01-12,GRAY,heist,Hot Potato,1,0,1
12050,2023-01-12,GRAY,gemGrab,Undermine,7,15,22
12051,2023-01-12,GRAY,gemGrab,Gem Fort,2,8,10
12052,2023-01-12,GRAY,brawlBall,Sunny Soccer,5,6,11
12053,2023-01-12,GRAY,brawlBall,Pinhole Punt,14,14,28
12054,2023-01-11,GRAY,knockout,Riverside,7,8,15
12055,2023-01-11,GRAY,hotZone,Open Zone,2,0,2
12056,2023-01-11,GRAY,heist,Safe Zone,0,3,3
12057,2023-01-11,GRAY,gemGrab,Gem Fort,0,2,2
12058,2023-01-11,GRAY,brawlBall,Sunny Soccer,15,27,42
12059,2023-01-11,GRAY,bounty,Excel,1,0,1
12060,2023-01-10,GRAY,knockout,New Perspective,24,38,62
12061,2023-01-10,GRAY,hotZone,Dueling Beetles,11,28,39
12062,2023-01-10,GRAY,gemGrab,Minecart Madness,1,4,5
12063,2023-01-10,GRAY,gemGrab,Crystal Arcade,13,30,43
12064,2023-01-10,GRAY,brawlBall,Center Stage,4,0,4
12065,2023-01-10,GRAY,brawlBall,Beach Ball,46,55,101
12066,2023-01-10,GRAY,bounty,Excel,4,1,5
12067,2023-01-09,GRAY,knockout,New Perspective,53,61,114
12068,2023-01-09,GRAY,hotZone,Dueling Beetles,9,17,26
12069,2023-01-09,GRAY,gemGrab,Minecart Madness,21,34,55
12070,2023-01-09,GRAY,gemGrab,Double Swoosh,10,32,42
12071,2023-01-09,GRAY,brawlBall,Center Stage,40,30,70
12072,2023-01-09,GRAY,brawlBall,Backyard Bowl,10,34,44
12073,2023-01-09,GRAY,bounty,Layer Cake,11,11,22
12074,2023-01-08,GRAY,knockout,X Marks the Spot,61,98,159
12075,2023-01-08,GRAY,hotZone,Ring of Fire,2,0,2
12076,2023-01-08,GRAY,heist,Snaked Assault,1,12,13
12077,2023-01-08,GRAY,gemGrab,Hard Rock Mine,2,0,2
12078,2023-01-08,GRAY,gemGrab,Double Swoosh,9,15,24
12079,2023-01-08,GRAY,brawlBall,Super Beach,5,2,7
12080,2023-01-08,GRAY,brawlBall,Backyard Bowl,68,77,145
12081,2023-01-08,GRAY,bounty,Layer Cake,4,2,6
12082,2023-01-07,GRAY,knockout,X Marks the Spot,46,88,134
12083,2023-01-07,GRAY,hotZone,Ring of Fire,0,3,3
12084,2023-01-07,GRAY,heist,Tornado Ring,1,0,1
12085,2023-01-07,GRAY,gemGrab,Hard Rock Mine,7,32,39
12086,2023-01-07,GRAY,gemGrab,Deep Diner,9,21,30
12087,2023-01-07,GRAY,brawlBall,Super Beach,38,38,76
12088,2023-01-07,GRAY,brawlBall,Sneaky Fields,0,2,2
12089,2023-01-07,GRAY,bounty,Dry Season,6,4,10
12090,2023-01-06,GRAY,knockout,Out in the Open,89,138,227
12091,2023-01-06,GRAY,hotZone,Split,10,22,32
12092,2023-01-06,GRAY,heist,Tornado Ring,1,0,1
12093,2023-01-06,GRAY,gemGrab,Undermine,9,4,13
12094,2023-01-06,GRAY,gemGrab,Deep Diner,13,22,35
12095,2023-01-06,GRAY,brawlBall,Sneaky Fields,28,22,50
12096,2023-01-06,GRAY,brawlBall,Pinhole Punt,12,8,20
12097,2023-01-06,GRAY,bounty,Dry Season,9,3,12
12098,2023-01-05,GRAY,knockout,Out in the Open,125,199,324
12099,2023-01-05,GRAY,hotZone,Split,45,75,120
12100,2023-01-05,GRAY,heist,Kaboom Canyon,2,0,2
12101,2023-01-05,GRAY,gemGrab,Undermine,12,28,40
12102,2023-01-05,GRAY,gemGrab,Gem Fort,3,0,3
12103,2023-01-05,GRAY,brawlBall,Sunny Soccer,0,2,2
12104,2023-01-05,GRAY,brawlBall,Pinhole Punt,84,131,215
12105,2023-01-05,GRAY,bounty,Shooting Star,6,6,12
12106,2023-01-04,GRAY,knockout,Goldarm Gulch,25,15,40
12107,2023-01-04,GRAY,hotZone,Parallel Plays,2,3,5
12108,2023-01-04,GRAY,heist,Kaboom Canyon,1,4,5
12109,2023-01-04,GRAY,gemGrab,Gem Fort,8,32,40
12110,2023-01-04,GRAY,gemGrab,Crystal Arcade,8,9,17
12111,2023-01-04,GRAY,brawlBall,Sunny Soccer,96,158,254
12112,2023-01-04,GRAY,bounty,Shooting Star,3,4,7
12113,2023-01-03,GRAY,knockout,Goldarm Gulch,15,28,43
12114,2023-01-03,GRAY,hotZone,Parallel Plays,4,0,4
12115,2023-01-03,GRAY,gemGrab,Minecart Madness,3,2,5
12116,2023-01-03,GRAY,gemGrab,Crystal Arcade,13,77,90
12117,2023-01-03,GRAY,brawlBall,Center Stage,7,9,16
12118,2023-01-03,GRAY,brawlBall,Beach Ball,68,120,188
12119,2023-01-03,GRAY,bounty,Hideout,11,9,20
12120,2023-01-02,GRAY,knockout,Belle's Rock,48,48,96
12121,2023-01-02,GRAY,hotZone,Quarter Pounder,16,9,25
12122,2023-01-02,GRAY,heist,Pit Stop,1,0,1
12123,2023-01-02,GRAY,gemGrab,Minecart Madness,13,13,26
12124,2023-01-02,GRAY,gemGrab,Double Swoosh,14,22,36
12125,2023-01-02,GRAY,brawlBall,Center Stage,89,165,254
12126,2023-01-02,GRAY,brawlBall,Backyard Bowl,17,30,47
12127,2023-01-02,GRAY,bounty,Hideout,20,47,67
12128,2023-01-01,GRAY,knockout,Belle's Rock,15,24,39
12129,2023-01-01,GRAY,hotZone,Quarter Pounder,31,42,73
12130,2023-01-01,GRAY,heist,Bridge Too Far,0,1,1
12131,2023-01-01,GRAY,gemGrab,Double Swoosh,8,12,20
12132,2023-01-01,GRAY,brawlBall,Backyard Bowl,44,91,135
12133,2023-01-01,GRAY,bounty,Canal Grande,1,0,1
12134,2022-12-31,GRAY,knockout,Flaring Phoenix,1,1,2
12135,2022-12-31,GRAY,heist,Kaboom Canyon,2,2,4
12136,2022-12-31,GRAY,heist,Bridge Too Far,1,0,1
12137,2022-12-31,GRAY,gemGrab,Hard Rock Mine,9,15,24
12138,2022-12-31,GRAY,gemGrab,Deep Diner,3,4,7
12139,2022-12-31,GRAY,brawlBall,Super Beach,5,5,10
12140,2022-12-31,GRAY,brawlBall,Sneaky Fields,1,0,1
12141,2022-12-31,GRAY,bounty,Canal Grande,0,1,1
12142,2022-12-30,GRAY,knockout,Flaring Phoenix,7,13,20
12143,2022-12-30,GRAY,hotZone,Controller Chaos,2,1,3
12144,2022-12-30,GRAY,heist,Hot Potato,1,0,1
12145,2022-12-30,GRAY,gemGrab,Undermine,1,0,1
12146,2022-12-30,GRAY,gemGrab,Minecart Madness,2,0,2
12147,2022-12-30,GRAY,gemGrab,Deep Diner,7,14,21
12148,2022-12-30,GRAY,brawlBall,Sneaky Fields,19,27,46
12149,2022-12-29,GRAY,hotZone,Open Zone,1,0,1
12150,2022-12-29,GRAY,heist,Kaboom Canyon,0,1,1
12151,2022-12-29,GRAY,gemGrab,Undermine,2,8,10
12152,2022-12-29,GRAY,gemGrab,Minecart Madness,0,1,1
12153,2022-12-29,GRAY,brawlBall,Pinhole Punt,6,7,13
12154,2022-12-28,GRAY,hotZone,Open Zone,2,2,4
12155,2022-12-28,GRAY,hotZone,Controller Chaos,0,2,2
12156,2022-12-27,GRAY,knockout,New Perspective,5,0,5
12157,2022-12-27,GRAY,hotZone,Dueling Beetles,0,1,1
12158,2022-12-27,GRAY,hotZone,Controller Chaos,2,0,2
12159,2022-12-27,GRAY,gemGrab,Minecart Madness,0,3,3
12160,2022-12-27,GRAY,brawlBall,Beach Ball,7,19,26
12161,2022-12-27,GRAY,bounty,Excel,0,1,1
12162,2022-12-26,GRAY,hotZone,Controller Chaos,3,2,5
12163,2022-12-26,GRAY,heist,Kaboom Canyon,0,1,1
12164,2022-12-26,GRAY,gemGrab,Minecart Madness,1,3,4
12165,2022-12-26,GRAY,brawlBall,Center Stage,0,1,1
12166,2022-12-25,GRAY,hotZone,Ring of Fire,1,1,2
12167,2022-12-23,GRAY,knockout,Out in the Open,0,2,2
12168,2022-12-22,GRAY,brawlBall,Pinhole Punt,2,4,6
12169,2022-12-20,GRAY,brawlBall,Beach Ball,3,1,4
12170,2022-12-19,GRAY,gemGrab,Minecart Madness,4,4,8
12171,2022-12-18,GRAY,knockout,Belle's Rock,0,1,1
12172,2022-12-17,GRAY,knockout,Flaring Phoenix,1,0,1
12173,2022-12-13,GRAY,knockout,New Perspective,2,0,2
12174,2022-12-13,GRAY,brawlBall,Beach Ball,2,5,7
12175,2022-12-12,GRAY,brawlBall,Center Stage,0,2,2
12176,2023-02-11,GENE,knockout,Flaring Phoenix,88,112,200
12177,2023-02-11,GENE,hotZone,Controller Chaos,4,0,4
12178,2023-02-11,GENE,gemGrab,Deep Diner,124,99,223
12179,2023-02-11,GENE,brawlBall,Super Beach,29,20,49
12180,2023-02-11,GENE,brawlBall,Sneaky Fields,10,5,15
12181,2023-02-10,GENE,knockout,Flaring Phoenix,199,209,408
12182,2023-02-10,GENE,hotZone,Controller Chaos,11,2,13
12183,2023-02-10,GENE,heist,Hot Potato,7,0,7
12184,2023-02-10,GENE,gemGrab,Undermine,61,43,104
12185,2023-02-10,GENE,gemGrab,Deep Diner,392,373,765
12186,2023-02-10,GENE,brawlBall,Sneaky Fields,98,57,155
12187,2023-02-10,GENE,brawlBall,Pinhole Punt,5,4,9
12188,2023-02-10,GENE,bounty,Temple Ruins,62,54,116
12189,2023-02-09,GENE,knockout,Riverside,37,28,65
12190,2023-02-09,GENE,hotZone,Open Zone,6,1,7
12191,2023-02-09,GENE,heist,Hot Potato,4,1,5
12192,2023-02-09,GENE,gemGrab,Undermine,105,72,177
12193,2023-02-09,GENE,gemGrab,Gem Fort,3,5,8
12194,2023-02-09,GENE,brawlBall,Pinhole Punt,39,37,76
12195,2023-02-09,GENE,bounty,Temple Ruins,30,27,57
12196,2023-02-08,GENE,knockout,Riverside,15,16,31
12197,2023-02-08,GENE,hotZone,Open Zone,1,0,1
12198,2023-02-08,GENE,heist,Safe Zone,1,0,1
12199,2023-02-08,GENE,gemGrab,Gem Fort,23,20,43
12200,2023-02-08,GENE,gemGrab,Crystal Arcade,9,9,18
12201,2023-02-08,GENE,brawlBall,Sunny Soccer,14,11,25
12202,2023-02-08,GENE,brawlBall,Beach Ball,0,1,1
12203,2023-02-08,GENE,bounty,Excel,7,4,11
12204,2023-02-07,GENE,knockout,New Perspective,12,5,17
12205,2023-02-07,GENE,hotZone,Dueling Beetles,0,1,1
12206,2023-02-07,GENE,gemGrab,Minecart Madness,11,12,23
12207,2023-02-07,GENE,gemGrab,Crystal Arcade,12,11,23
12208,2023-02-07,GENE,brawlBall,Beach Ball,17,8,25
12209,2023-02-07,GENE,bounty,Excel,9,4,13
12210,2023-02-06,GENE,knockout,New Perspective,271,265,536
12211,2023-02-06,GENE,knockout,Goldarm Gulch,23,21,44
12212,2023-02-06,GENE,hotZone,Dueling Beetles,8,2,10
12213,2023-02-06,GENE,heist,Snaked Assault,3,0,3
12214,2023-02-06,GENE,gemGrab,Minecart Madness,373,399,772
12215,2023-02-06,GENE,gemGrab,Double Swoosh,332,458,790
12216,2023-02-06,GENE,brawlBall,Sneaky Fields,1,1,2
12217,2023-02-06,GENE,brawlBall,Center Stage,163,175,338
12218,2023-02-06,GENE,brawlBall,Backyard Bowl,40,46,86
12219,2023-02-06,GENE,bounty,Layer Cake,88,189,277
12220,2023-02-05,GENE,knockout,X Marks the Spot,133,206,339
12221,2023-02-05,GENE,knockout,Goldarm Gulch,101,99,200
12222,2023-02-05,GENE,hotZone,Ring of Fire,23,10,33
12223,2023-02-05,GENE,heist,Snaked Assault,1,2,3
12224,2023-02-05,GENE,gemGrab,Hard Rock Mine,127,149,276
12225,2023-02-05,GENE,gemGrab,Double Swoosh,983,1341,2324
12226,2023-02-05,GENE,brawlBall,Super Beach,1,2,3
12227,2023-02-05,GENE,brawlBall,Sneaky Fields,6,1,7
12228,2023-02-05,GENE,brawlBall,Backyard Bowl,526,534,1060
12229,2023-02-05,GENE,bounty,Layer Cake,150,229,379
12230,2023-02-04,GENE,knockout,X Marks the Spot,62,73,135
12231,2023-02-04,GENE,knockout,Goldarm Gulch,68,55,123
12232,2023-02-04,GENE,hotZone,Ring of Fire,6,3,9
12233,2023-02-04,GENE,heist,Tornado Ring,2,0,2
12234,2023-02-04,GENE,gemGrab,Hard Rock Mine,153,112,265
12235,2023-02-04,GENE,gemGrab,Double Swoosh,78,240,318
12236,2023-02-04,GENE,gemGrab,Deep Diner,20,36,56
12237,2023-02-04,GENE,brawlBall,Super Beach,46,28,74
12238,2023-02-04,GENE,brawlBall,Sneaky Fields,4,0,4
12239,2023-02-04,GENE,bounty,Dry Season,42,37,79
12240,2023-02-03,GENE,knockout,Out in the Open,328,337,665
12241,2023-02-03,GENE,knockout,Goldarm Gulch,433,439,872
12242,2023-02-03,GENE,hotZone,Split,5,2,7
12243,2023-02-03,GENE,heist,Tornado Ring,6,2,8
12244,2023-02-03,GENE,heist,Pit Stop,1,0,1
12245,2023-02-03,GENE,gemGrab,Undermine,80,74,154
12246,2023-02-03,GENE,gemGrab,Double Swoosh,454,1311,1765
12247,2023-02-03,GENE,gemGrab,Deep Diner,425,413,838
12248,2023-02-03,GENE,brawlBall,Sneaky Fields,144,105,249
12249,2023-02-03,GENE,brawlBall,Pinhole Punt,9,6,15
12250,2023-02-03,GENE,bounty,Dry Season,295,321,616
12251,2023-02-02,GENE,knockout,Out in the Open,122,146,268
12252,2023-02-02,GENE,hotZone,Split,6,2,8
12253,2023-02-02,GENE,heist,Kaboom Canyon,1,0,1
12254,2023-02-02,GENE,gemGrab,Undermine,80,71,151
12255,2023-02-02,GENE,gemGrab,Gem Fort,13,21,34
12256,2023-02-02,GENE,brawlBall,Sunny Soccer,0,1,1
12257,2023-02-02,GENE,brawlBall,Pinhole Punt,107,69,176
12258,2023-02-02,GENE,bounty,Shooting Star,39,43,82
12259,2023-02-01,GENE,knockout,Goldarm Gulch,284,263,547
12260,2023-02-01,GENE,hotZone,Parallel Plays,12,2,14
12261,2023-02-01,GENE,gemGrab,Gem Fort,150,166,316
12262,2023-02-01,GENE,gemGrab,Crystal Arcade,92,106,198
12263,2023-02-01,GENE,brawlBall,Sunny Soccer,96,100,196
12264,2023-02-01,GENE,brawlBall,Beach Ball,2,2,4
12265,2023-02-01,GENE,bounty,Shooting Star,92,99,191
12266,2023-01-31,GENE,knockout,Goldarm Gulch,120,121,241
12267,2023-01-31,GENE,hotZone,Parallel Plays,5,6,11
12268,2023-01-31,GENE,heist,Pit Stop,5,1,6
12269,2023-01-31,GENE,gemGrab,Minecart Madness,18,24,42
12270,2023-01-31,GENE,gemGrab,Crystal Arcade,151,185,336
12271,2023-01-31,GENE,brawlBall,Center Stage,7,7,14
12272,2023-01-31,GENE,brawlBall,Beach Ball,72,90,162
12273,2023-01-31,GENE,bounty,Hideout,30,21,51
12274,2023-01-30,GENE,knockout,Belle's Rock,212,238,450
12275,2023-01-30,GENE,hotZone,Quarter Pounder,15,2,17
12276,2023-01-30,GENE,heist,Pit Stop,1,0,1
12277,2023-01-30,GENE,gemGrab,Minecart Madness,175,161,336
12278,2023-01-30,GENE,gemGrab,Double Swoosh,260,347,607
12279,2023-01-30,GENE,brawlBall,Center Stage,98,63,161
12280,2023-01-30,GENE,brawlBall,Backyard Bowl,29,35,64
12281,2023-01-30,GENE,bounty,Hideout,66,80,146
12282,2023-01-29,GENE,knockout,Belle's Rock,271,302,573
12283,2023-01-29,GENE,hotZone,Quarter Pounder,10,10,20
12284,2023-01-29,GENE,heist,Bridge Too Far,9,1,10
12285,2023-01-29,GENE,gemGrab,Hard Rock Mine,57,68,125
12286,2023-01-29,GENE,gemGrab,Double Swoosh,497,525,1022
12287,2023-01-29,GENE,brawlBall,Backyard Bowl,365,386,751
12288,2023-01-29,GENE,bounty,Canal Grande,39,34,73
12289,2023-01-28,GENE,knockout,Flaring Phoenix,122,107,229
12290,2023-01-28,GENE,hotZone,Controller Chaos,10,5,15
12291,2023-01-28,GENE,heist,Bridge Too Far,9,4,13
12292,2023-01-28,GENE,gemGrab,Hard Rock Mine,380,365,745
12293,2023-01-28,GENE,gemGrab,Deep Diner,92,122,214
12294,2023-01-28,GENE,brawlBall,Super Beach,129,83,212
12295,2023-01-28,GENE,brawlBall,Sneaky Fields,7,7,14
12296,2023-01-28,GENE,bounty,Canal Grande,79,95,174
12297,2023-01-27,GENE,knockout,Flaring Phoenix,42,57,99
12298,2023-01-27,GENE,hotZone,Controller Chaos,3,5,8
12299,2023-01-27,GENE,heist,Hot Potato,1,0,1
12300,2023-01-27,GENE,gemGrab,Undermine,15,19,34
12301,2023-01-27,GENE,gemGrab,Deep Diner,121,133,254
12302,2023-01-27,GENE,brawlBall,Sneaky Fields,37,21,58
12303,2023-01-27,GENE,brawlBall,Pinhole Punt,1,1,2
12304,2023-01-27,GENE,bounty,Temple Ruins,25,56,81
12305,2023-01-26,GENE,knockout,Riverside,211,237,448
12306,2023-01-26,GENE,hotZone,Open Zone,28,3,31
12307,2023-01-26,GENE,heist,Hot Potato,1,2,3
12308,2023-01-26,GENE,gemGrab,Undermine,203,178,381
12309,2023-01-26,GENE,gemGrab,Gem Fort,74,82,156
12310,2023-01-26,GENE,brawlBall,Sunny Soccer,5,3,8
12311,2023-01-26,GENE,brawlBall,Pinhole Punt,244,210,454
12312,2023-01-26,GENE,bounty,Temple Ruins,70,100,170
12313,2023-01-25,GENE,knockout,Riverside,114,97,211
12314,2023-01-25,GENE,hotZone,Open Zone,12,6,18
12315,2023-01-25,GENE,heist,Safe Zone,3,1,4
12316,2023-01-25,GENE,gemGrab,Gem Fort,91,74,165
12317,2023-01-25,GENE,gemGrab,Crystal Arcade,135,135,270
12318,2023-01-25,GENE,brawlBall,Sunny Soccer,90,72,162
12319,2023-01-25,GENE,brawlBall,Beach Ball,16,12,28
12320,2023-01-25,GENE,bounty,Excel,46,61,107
12321,2023-01-24,GENE,knockout,New Perspective,112,93,205
12322,2023-01-24,GENE,hotZone,Dueling Beetles,5,8,13
12323,2023-01-24,GENE,heist,Safe Zone,7,3,10
12324,2023-01-24,GENE,gemGrab,Minecart Madness,57,64,121
12325,2023-01-24,GENE,gemGrab,Crystal Arcade,350,277,627
12326,2023-01-24,GENE,brawlBall,Center Stage,6,8,14
12327,2023-01-24,GENE,brawlBall,Beach Ball,154,149,303
12328,2023-01-24,GENE,bounty,Excel,96,133,229
12329,2023-01-23,GENE,knockout,New Perspective,166,179,345
12330,2023-01-23,GENE,hotZone,Dueling Beetles,8,1,9
12331,2023-01-23,GENE,heist,Snaked Assault,18,8,26
12332,2023-01-23,GENE,gemGrab,Minecart Madness,329,362,691
12333,2023-01-23,GENE,gemGrab,Double Swoosh,186,161,347
12334,2023-01-23,GENE,brawlBall,Center Stage,154,147,301
12335,2023-01-23,GENE,brawlBall,Backyard Bowl,30,32,62
12336,2023-01-23,GENE,bounty,Layer Cake,82,140,222
12337,2023-01-22,GENE,knockout,X Marks the Spot,150,177,327
12338,2023-01-22,GENE,hotZone,Ring of Fire,8,1,9
12339,2023-01-22,GENE,gemGrab,Hard Rock Mine,91,87,178
12340,2023-01-22,GENE,gemGrab,Double Swoosh,296,309,605
12341,2023-01-22,GENE,brawlBall,Super Beach,12,12,24
12342,2023-01-22,GENE,brawlBall,Backyard Bowl,168,166,334
12343,2023-01-22,GENE,bounty,Layer Cake,78,80,158
12344,2023-01-21,GENE,knockout,X Marks the Spot,446,557,1003
12345,2023-01-21,GENE,hotZone,Ring of Fire,18,3,21
12346,2023-01-21,GENE,heist,Tornado Ring,5,0,5
12347,2023-01-21,GENE,gemGrab,Hard Rock Mine,564,556,1120
12348,2023-01-21,GENE,gemGrab,Deep Diner,56,81,137
12349,2023-01-21,GENE,brawlBall,Super Beach,164,120,284
12350,2023-01-21,GENE,brawlBall,Sneaky Fields,12,4,16
12351,2023-01-21,GENE,bounty,Dry Season,146,239,385
12352,2023-01-20,GENE,knockout,Out in the Open,330,377,707
12353,2023-01-20,GENE,hotZone,Split,9,1,10
12354,2023-01-20,GENE,heist,Tornado Ring,1,0,1
12355,2023-01-20,GENE,gemGrab,Undermine,108,127,235
12356,2023-01-20,GENE,gemGrab,Deep Diner,357,331,688
12357,2023-01-20,GENE,brawlBall,Sneaky Fields,100,102,202
12358,2023-01-20,GENE,brawlBall,Pinhole Punt,5,7,12
12359,2023-01-20,GENE,bounty,Dry Season,150,190,340
12360,2023-01-19,GENE,knockout,Out in the Open,399,353,752
12361,2023-01-19,GENE,hotZone,Split,5,6,11
12362,2023-01-19,GENE,heist,Kaboom Canyon,6,2,8
12363,2023-01-19,GENE,gemGrab,Undermine,255,246,501
12364,2023-01-19,GENE,gemGrab,Gem Fort,39,32,71
12365,2023-01-19,GENE,brawlBall,Sunny Soccer,3,2,5
12366,2023-01-19,GENE,brawlBall,Pinhole Punt,205,187,392
12367,2023-01-19,GENE,bounty,Shooting Star,93,128,221
12368,2023-01-18,GENE,knockout,Goldarm Gulch,31,40,71
12369,2023-01-18,GENE,hotZone,Parallel Plays,2,2,4
12370,2023-01-18,GENE,heist,Kaboom Canyon,1,0,1
12371,2023-01-18,GENE,gemGrab,Gem Fort,50,44,94
12372,2023-01-18,GENE,gemGrab,Crystal Arcade,19,39,58
12373,2023-01-18,GENE,brawlBall,Sunny Soccer,30,58,88
12374,2023-01-18,GENE,brawlBall,Beach Ball,2,1,3
12375,2023-01-18,GENE,bounty,Shooting Star,46,70,116
12376,2023-01-17,GENE,knockout,Goldarm Gulch,34,33,67
12377,2023-01-17,GENE,hotZone,Parallel Plays,0,5,5
12378,2023-01-17,GENE,heist,Pit Stop,0,1,1
12379,2023-01-17,GENE,gemGrab,Minecart Madness,4,2,6
12380,2023-01-17,GENE,gemGrab,Crystal Arcade,23,30,53
12381,2023-01-17,GENE,brawlBall,Beach Ball,20,15,35
12382,2023-01-17,GENE,bounty,Hideout,10,8,18
12383,2023-01-16,GENE,knockout,Belle's Rock,19,20,39
12384,2023-01-16,GENE,gemGrab,Minecart Madness,26,24,50
12385,2023-01-16,GENE,gemGrab,Double Swoosh,23,53,76
12386,2023-01-16,GENE,brawlBall,Center Stage,7,8,15
12387,2023-01-16,GENE,brawlBall,Backyard Bowl,2,2,4
12388,2023-01-16,GENE,bounty,Hideout,10,12,22
12389,2023-01-15,GENE,knockout,Belle's Rock,43,33,76
12390,2023-01-15,GENE,hotZone,Quarter Pounder,3,0,3
12391,2023-01-15,GENE,heist,Bridge Too Far,1,0,1
12392,2023-01-15,GENE,gemGrab,Hard Rock Mine,30,29,59
12393,2023-01-15,GENE,gemGrab,Double Swoosh,87,69,156
12394,2023-01-15,GENE,brawlBall,Backyard Bowl,53,35,88
12395,2023-01-15,GENE,bounty,Canal Grande,11,6,17
12396,2023-01-14,GENE,knockout,Flaring Phoenix,11,22,33
12397,2023-01-14,GENE,hotZone,Controller Chaos,3,0,3
12398,2023-01-14,GENE,heist,Bridge Too Far,2,1,3
12399,2023-01-14,GENE,gemGrab,Hard Rock Mine,26,11,37
12400,2023-01-14,GENE,gemGrab,Deep Diner,24,31,55
12401,2023-01-14,GENE,brawlBall,Super Beach,13,4,17
12402,2023-01-14,GENE,brawlBall,Sneaky Fields,1,12,13
12403,2023-01-14,GENE,bounty,Canal Grande,5,2,7
12404,2023-01-13,GENE,knockout,Flaring Phoenix,19,11,30
12405,2023-01-13,GENE,gemGrab,Deep Diner,23,57,80
12406,2023-01-13,GENE,brawlBall,Sneaky Fields,8,19,27
12407,2023-01-13,GENE,brawlBall,Pinhole Punt,0,1,1
12408,2023-01-13,GENE,bounty,Temple Ruins,7,0,7
12409,2023-01-12,GENE,knockout,Riverside,16,7,23
12410,2023-01-12,GENE,hotZone,Open Zone,8,11,19
12411,2023-01-12,GENE,gemGrab,Undermine,21,19,40
12412,2023-01-12,GENE,gemGrab,Gem Fort,3,2,5
12413,2023-01-12,GENE,brawlBall,Pinhole Punt,7,3,10
12414,2023-01-11,GENE,knockout,Riverside,2,2,4
12415,2023-01-11,GENE,gemGrab,Gem Fort,14,21,35
12416,2023-01-11,GENE,brawlBall,Sunny Soccer,4,1,5
12417,2023-01-11,GENE,bounty,Excel,4,9,13
12418,2023-01-10,GENE,knockout,New Perspective,3,3,6
12419,2023-01-10,GENE,hotZone,Dueling Beetles,1,0,1
12420,2023-01-10,GENE,gemGrab,Minecart Madness,23,1,24
12421,2023-01-10,GENE,gemGrab,Crystal Arcade,18,13,31
12422,2023-01-10,GENE,brawlBall,Beach Ball,9,12,21
12423,2023-01-10,GENE,bounty,Excel,4,7,11
12424,2023-01-09,GENE,knockout,New Perspective,2,16,18
12425,2023-01-09,GENE,hotZone,Dueling Beetles,1,0,1
12426,2023-01-09,GENE,gemGrab,Minecart Madness,32,22,54
12427,2023-01-09,GENE,gemGrab,Double Swoosh,30,27,57
12428,2023-01-09,GENE,brawlBall,Center Stage,6,7,13
12429,2023-01-09,GENE,brawlBall,Backyard Bowl,0,1,1
12430,2023-01-09,GENE,bounty,Layer Cake,15,41,56
12431,2023-01-08,GENE,knockout,X Marks the Spot,24,41,65
12432,2023-01-08,GENE,hotZone,Ring of Fire,0,1,1
12433,2023-01-08,GENE,heist,Snaked Assault,1,0,1
12434,2023-01-08,GENE,gemGrab,Hard Rock Mine,17,12,29
12435,2023-01-08,GENE,gemGrab,Double Swoosh,28,29,57
12436,2023-01-08,GENE,brawlBall,Super Beach,2,0,2
12437,2023-01-08,GENE,brawlBall,Backyard Bowl,29,31,60
12438,2023-01-08,GENE,bounty,Layer Cake,20,28,48
12439,2023-01-07,GENE,knockout,X Marks the Spot,25,26,51
12440,2023-01-07,GENE,heist,Tornado Ring,1,0,1
12441,2023-01-07,GENE,gemGrab,Hard Rock Mine,37,28,65
12442,2023-01-07,GENE,gemGrab,Deep Diner,27,19,46
12443,2023-01-07,GENE,brawlBall,Super Beach,7,1,8
12444,2023-01-07,GENE,brawlBall,Sneaky Fields,1,0,1
12445,2023-01-07,GENE,bounty,Dry Season,25,29,54
12446,2023-01-06,GENE,knockout,Out in the Open,17,10,27
12447,2023-01-06,GENE,hotZone,Split,2,0,2
12448,2023-01-06,GENE,heist,Tornado Ring,2,0,2
12449,2023-01-06,GENE,gemGrab,Undermine,10,8,18
12450,2023-01-06,GENE,gemGrab,Deep Diner,46,32,78
12451,2023-01-06,GENE,brawlBall,Sneaky Fields,2,1,3
12452,2023-01-06,GENE,brawlBall,Pinhole Punt,0,2,2
12453,2023-01-06,GENE,bounty,Dry Season,48,69,117
12454,2023-01-05,GENE,knockout,Out in the Open,66,49,115
12455,2023-01-05,GENE,heist,Kaboom Canyon,1,0,1
12456,2023-01-05,GENE,gemGrab,Undermine,29,25,54
12457,2023-01-05,GENE,gemGrab,Gem Fort,4,1,5
12458,2023-01-05,GENE,brawlBall,Pinhole Punt,18,20,38
12459,2023-01-05,GENE,bounty,Shooting Star,14,8,22
12460,2023-01-04,GENE,knockout,Goldarm Gulch,17,31,48
12461,2023-01-04,GENE,hotZone,Parallel Plays,1,0,1
12462,2023-01-04,GENE,heist,Kaboom Canyon,1,0,1
12463,2023-01-04,GENE,gemGrab,Gem Fort,33,31,64
12464,2023-01-04,GENE,gemGrab,Crystal Arcade,12,3,15
12465,2023-01-04,GENE,brawlBall,Sunny Soccer,8,7,15
12466,2023-01-04,GENE,bounty,Shooting Star,30,17,47
12467,2023-01-03,GENE,knockout,Goldarm Gulch,6,11,17
12468,2023-01-03,GENE,hotZone,Parallel Plays,2,0,2
12469,2023-01-03,GENE,heist,Pit Stop,1,0,1
12470,2023-01-03,GENE,gemGrab,Minecart Madness,12,26,38
12471,2023-01-03,GENE,gemGrab,Crystal Arcade,71,87,158
12472,2023-01-03,GENE,brawlBall,Beach Ball,7,2,9
12473,2023-01-03,GENE,bounty,Hideout,14,16,30
12474,2023-01-02,GENE,knockout,Belle's Rock,36,32,68
12475,2023-01-02,GENE,hotZone,Quarter Pounder,4,5,9
12476,2023-01-02,GENE,heist,Pit Stop,1,0,1
12477,2023-01-02,GENE,gemGrab,Minecart Madness,44,26,70
12478,2023-01-02,GENE,gemGrab,Double Swoosh,69,82,151
12479,2023-01-02,GENE,brawlBall,Center Stage,23,5,28
12480,2023-01-02,GENE,brawlBall,Backyard Bowl,1,0,1
12481,2023-01-02,GENE,bounty,Hideout,32,28,60
12482,2023-01-01,GENE,knockout,Belle's Rock,30,16,46
12483,2023-01-01,GENE,hotZone,Quarter Pounder,4,14,18
12484,2023-01-01,GENE,hotZone,Controller Chaos,0,1,1
12485,2023-01-01,GENE,gemGrab,Hard Rock Mine,0,1,1
12486,2023-01-01,GENE,gemGrab,Double Swoosh,65,38,103
12487,2023-01-01,GENE,brawlBall,Backyard Bowl,10,20,30
12488,2023-01-01,GENE,bounty,Canal Grande,3,3,6
12489,2022-12-31,GENE,gemGrab,Hard Rock Mine,8,9,17
12490,2022-12-31,GENE,gemGrab,Deep Diner,11,4,15
12491,2022-12-31,GENE,brawlBall,Super Beach,2,0,2
12492,2022-12-31,GENE,bounty,Canal Grande,0,2,2
12493,2022-12-30,GENE,knockout,Flaring Phoenix,2,2,4
12494,2022-12-30,GENE,hotZone,Controller Chaos,0,1,1
12495,2022-12-30,GENE,gemGrab,Undermine,1,1,2
12496,2022-12-30,GENE,gemGrab,Deep Diner,7,8,15
12497,2022-12-29,GENE,gemGrab,Undermine,7,7,14
12498,2022-12-29,GENE,brawlBall,Pinhole Punt,1,0,1
12499,2022-12-28,GENE,brawlBall,Beach Ball,2,0,2
12500,2022-12-27,GENE,gemGrab,Minecart Madness,0,3,3
12501,2022-12-26,GENE,gemGrab,Minecart Madness,0,2,2
12502,2022-12-25,GENE,gemGrab,Double Swoosh,1,0,1
12503,2022-12-23,GENE,knockout,Out in the Open,20,24,44
12504,2022-12-23,GENE,gemGrab,Deep Diner,1,0,1
12505,2022-12-22,GENE,gemGrab,Gem Fort,3,0,3
12506,2022-12-22,GENE,brawlBall,Pinhole Punt,2,0,2
12507,2022-12-21,GENE,bounty,Shooting Star,1,2,3
12508,2022-12-20,GENE,brawlBall,Beach Ball,1,0,1
12509,2022-12-19,GENE,brawlBall,Center Stage,0,1,1
12510,2022-12-17,GENE,knockout,Flaring Phoenix,0,1,1
12511,2022-12-13,GENE,gemGrab,Crystal Arcade,1,0,1
12512,2022-12-13,GENE,brawlBall,Beach Ball,0,1,1
12513,2022-12-10,GENE,knockout,X Marks the Spot,0,1,1
12514,2022-12-10,GENE,gemGrab,Hard Rock Mine,2,1,3
12515,2022-11-01,GENE,knockout,New Perspective,2,4,6
12516,2022-10-30,GENE,knockout,Out in the Open,1,2,3
12517,2022-10-30,GENE,bounty,Canal Grande,0,2,2
12518,2022-10-26,GENE,bounty,Shooting Star,0,1,1
12519,2022-10-15,GENE,gemGrab,Hard Rock Mine,0,2,2
12520,2022-10-10,GENE,knockout,Belle's Rock,0,3,3
12521,2022-09-07,GENE,brawlBall,Sunny Soccer,0,2,2
12522,2023-02-11,GALE,knockout,Flaring Phoenix,14,5,19
12523,2023-02-11,GALE,hotZone,Controller Chaos,55,46,101
12524,2023-02-11,GALE,gemGrab,Deep Diner,18,17,35
12525,2023-02-11,GALE,brawlBall,Super Beach,73,98,171
12526,2023-02-11,GALE,brawlBall,Sneaky Fields,45,44,89
12527,2023-02-10,GALE,knockout,Flaring Phoenix,25,20,45
12528,2023-02-10,GALE,hotZone,Controller Chaos,77,96,173
12529,2023-02-10,GALE,heist,Hot Potato,6,2,8
12530,2023-02-10,GALE,gemGrab,Undermine,9,14,23
12531,2023-02-10,GALE,gemGrab,Deep Diner,34,18,52
12532,2023-02-10,GALE,brawlBall,Sneaky Fields,336,316,652
12533,2023-02-10,GALE,brawlBall,Pinhole Punt,7,6,13
12534,2023-02-10,GALE,bounty,Temple Ruins,8,12,20
12535,2023-02-09,GALE,knockout,Riverside,2,1,3
12536,2023-02-09,GALE,hotZone,Open Zone,8,13,21
12537,2023-02-09,GALE,heist,Hot Potato,3,1,4
12538,2023-02-09,GALE,gemGrab,Undermine,6,6,12
12539,2023-02-09,GALE,gemGrab,Gem Fort,1,1,2
12540,2023-02-09,GALE,brawlBall,Sunny Soccer,1,1,2
12541,2023-02-09,GALE,brawlBall,Pinhole Punt,100,72,172
12542,2023-02-09,GALE,bounty,Temple Ruins,3,1,4
12543,2023-02-08,GALE,knockout,Riverside,1,0,1
12544,2023-02-08,GALE,hotZone,Open Zone,6,1,7
12545,2023-02-08,GALE,heist,Safe Zone,0,1,1
12546,2023-02-08,GALE,gemGrab,Gem Fort,8,6,14
12547,2023-02-08,GALE,gemGrab,Crystal Arcade,1,2,3
12548,2023-02-08,GALE,brawlBall,Sunny Soccer,29,36,65
12549,2023-02-08,GALE,brawlBall,Beach Ball,4,9,13
12550,2023-02-08,GALE,bounty,Excel,2,0,2
12551,2023-02-07,GALE,knockout,New Perspective,3,2,5
12552,2023-02-07,GALE,hotZone,Dueling Beetles,9,3,12
12553,2023-02-07,GALE,heist,Safe Zone,1,0,1
12554,2023-02-07,GALE,gemGrab,Minecart Madness,2,2,4
12555,2023-02-07,GALE,gemGrab,Crystal Arcade,3,2,5
12556,2023-02-07,GALE,brawlBall,Center Stage,7,1,8
12557,2023-02-07,GALE,brawlBall,Beach Ball,17,13,30
12558,2023-02-06,GALE,knockout,New Perspective,31,22,53
12559,2023-02-06,GALE,knockout,Goldarm Gulch,2,5,7
12560,2023-02-06,GALE,hotZone,Dueling Beetles,60,26,86
12561,2023-02-06,GALE,heist,Snaked Assault,19,5,24
12562,2023-02-06,GALE,heist,Pit Stop,1,2,3
12563,2023-02-06,GALE,gemGrab,Minecart Madness,46,44,90
12564,2023-02-06,GALE,gemGrab,Double Swoosh,38,27,65
12565,2023-02-06,GALE,brawlBall,Sneaky Fields,40,28,68
12566,2023-02-06,GALE,brawlBall,Center Stage,458,493,951
12567,2023-02-06,GALE,brawlBall,Backyard Bowl,27,15,42
12568,2023-02-06,GALE,bounty,Layer Cake,6,3,9
12569,2023-02-05,GALE,knockout,X Marks the Spot,22,9,31
12570,2023-02-05,GALE,knockout,Goldarm Gulch,13,2,15
12571,2023-02-05,GALE,hotZone,Ring of Fire,38,26,64
12572,2023-02-05,GALE,heist,Snaked Assault,11,3,14
12573,2023-02-05,GALE,heist,Pit Stop,5,6,11
12574,2023-02-05,GALE,gemGrab,Hard Rock Mine,7,5,12
12575,2023-02-05,GALE,gemGrab,Double Swoosh,125,48,173
12576,2023-02-05,GALE,brawlBall,Super Beach,17,11,28
12577,2023-02-05,GALE,brawlBall,Sneaky Fields,143,94,237
12578,2023-02-05,GALE,brawlBall,Backyard Bowl,279,189,468
12579,2023-02-05,GALE,bounty,Layer Cake,6,3,9
12580,2023-02-04,GALE,knockout,X Marks the Spot,7,2,9
12581,2023-02-04,GALE,knockout,Goldarm Gulch,2,9,11
12582,2023-02-04,GALE,hotZone,Ring of Fire,6,8,14
12583,2023-02-04,GALE,heist,Tornado Ring,1,4,5
12584,2023-02-04,GALE,heist,Pit Stop,6,2,8
12585,2023-02-04,GALE,gemGrab,Hard Rock Mine,7,2,9
12586,2023-02-04,GALE,gemGrab,Double Swoosh,40,11,51
12587,2023-02-04,GALE,gemGrab,Deep Diner,1,0,1
12588,2023-02-04,GALE,brawlBall,Super Beach,93,83,176
12589,2023-02-04,GALE,brawlBall,Sneaky Fields,78,45,123
12590,2023-02-04,GALE,bounty,Dry Season,3,2,5
12591,2023-02-03,GALE,knockout,Out in the Open,28,19,47
12592,2023-02-03,GALE,knockout,Goldarm Gulch,16,5,21
12593,2023-02-03,GALE,hotZone,Split,112,195,307
12594,2023-02-03,GALE,heist,Tornado Ring,16,5,21
12595,2023-02-03,GALE,heist,Pit Stop,20,16,36
12596,2023-02-03,GALE,gemGrab,Undermine,10,11,21
12597,2023-02-03,GALE,gemGrab,Double Swoosh,222,47,269
12598,2023-02-03,GALE,gemGrab,Deep Diner,37,28,65
12599,2023-02-03,GALE,brawlBall,Sneaky Fields,735,548,1283
12600,2023-02-03,GALE,brawlBall,Pinhole Punt,16,7,23
12601,2023-02-03,GALE,bounty,Dry Season,11,2,13
12602,2023-02-02,GALE,knockout,Out in the Open,7,10,17
12603,2023-02-02,GALE,hotZone,Split,88,130,218
12604,2023-02-02,GALE,heist,Kaboom Canyon,6,6,12
12605,2023-02-02,GALE,gemGrab,Undermine,6,4,10
12606,2023-02-02,GALE,gemGrab,Gem Fort,3,0,3
12607,2023-02-02,GALE,brawlBall,Sunny Soccer,1,2,3
12608,2023-02-02,GALE,brawlBall,Pinhole Punt,121,124,245
12609,2023-02-02,GALE,bounty,Shooting Star,2,3,5
12610,2023-02-01,GALE,knockout,Goldarm Gulch,30,18,48
12611,2023-02-01,GALE,hotZone,Parallel Plays,108,142,250
12612,2023-02-01,GALE,heist,Kaboom Canyon,13,12,25
12613,2023-02-01,GALE,gemGrab,Gem Fort,43,29,72
12614,2023-02-01,GALE,gemGrab,Crystal Arcade,15,12,27
12615,2023-02-01,GALE,brawlBall,Sunny Soccer,299,270,569
12616,2023-02-01,GALE,brawlBall,Beach Ball,13,17,30
12617,2023-02-01,GALE,bounty,Shooting Star,4,0,4
12618,2023-01-31,GALE,knockout,Goldarm Gulch,14,13,27
12619,2023-01-31,GALE,hotZone,Parallel Plays,53,67,120
12620,2023-01-31,GALE,heist,Pit Stop,4,1,5
12621,2023-01-31,GALE,gemGrab,Minecart Madness,5,0,5
12622,2023-01-31,GALE,gemGrab,Crystal Arcade,17,19,36
12623,2023-01-31,GALE,brawlBall,Center Stage,2,4,6
12624,2023-01-31,GALE,brawlBall,Beach Ball,144,87,231
12625,2023-01-31,GALE,bounty,Hideout,3,2,5
12626,2023-01-30,GALE,knockout,Belle's Rock,24,9,33
12627,2023-01-30,GALE,hotZone,Quarter Pounder,68,64,132
12628,2023-01-30,GALE,heist,Pit Stop,2,1,3
12629,2023-01-30,GALE,gemGrab,Minecart Madness,25,23,48
12630,2023-01-30,GALE,gemGrab,Double Swoosh,23,17,40
12631,2023-01-30,GALE,brawlBall,Center Stage,345,336,681
12632,2023-01-30,GALE,brawlBall,Backyard Bowl,20,13,33
12633,2023-01-30,GALE,bounty,Hideout,2,0,2
12634,2023-01-29,GALE,knockout,Belle's Rock,38,23,61
12635,2023-01-29,GALE,hotZone,Quarter Pounder,53,35,88
12636,2023-01-29,GALE,heist,Bridge Too Far,4,4,8
12637,2023-01-29,GALE,gemGrab,Hard Rock Mine,7,3,10
12638,2023-01-29,GALE,gemGrab,Double Swoosh,39,30,69
12639,2023-01-29,GALE,brawlBall,Super Beach,3,4,7
12640,2023-01-29,GALE,brawlBall,Backyard Bowl,249,193,442
12641,2023-01-29,GALE,bounty,Canal Grande,3,4,7
12642,2023-01-28,GALE,knockout,Flaring Phoenix,17,5,22
12643,2023-01-28,GALE,hotZone,Controller Chaos,76,84,160
12644,2023-01-28,GALE,heist,Bridge Too Far,13,4,17
12645,2023-01-28,GALE,gemGrab,Hard Rock Mine,26,34,60
12646,2023-01-28,GALE,gemGrab,Deep Diner,9,3,12
12647,2023-01-28,GALE,brawlBall,Super Beach,381,351,732
12648,2023-01-28,GALE,brawlBall,Sneaky Fields,20,8,28
12649,2023-01-28,GALE,bounty,Canal Grande,10,9,19
12650,2023-01-27,GALE,knockout,Flaring Phoenix,11,5,16
12651,2023-01-27,GALE,hotZone,Controller Chaos,17,10,27
12652,2023-01-27,GALE,heist,Hot Potato,5,0,5
12653,2023-01-27,GALE,gemGrab,Undermine,2,2,4
12654,2023-01-27,GALE,gemGrab,Deep Diner,15,7,22
12655,2023-01-27,GALE,brawlBall,Sneaky Fields,143,129,272
12656,2023-01-27,GALE,brawlBall,Pinhole Punt,10,7,17
12657,2023-01-27,GALE,bounty,Temple Ruins,5,1,6
12658,2023-01-26,GALE,knockout,Riverside,16,4,20
12659,2023-01-26,GALE,hotZone,Open Zone,36,11,47
12660,2023-01-26,GALE,heist,Hot Potato,14,8,22
12661,2023-01-26,GALE,gemGrab,Undermine,27,43,70
12662,2023-01-26,GALE,gemGrab,Gem Fort,21,18,39
12663,2023-01-26,GALE,brawlBall,Sunny Soccer,21,36,57
12664,2023-01-26,GALE,brawlBall,Pinhole Punt,378,305,683
12665,2023-01-26,GALE,bounty,Temple Ruins,10,16,26
12666,2023-01-25,GALE,knockout,Riverside,5,3,8
12667,2023-01-25,GALE,hotZone,Open Zone,17,9,26
12668,2023-01-25,GALE,heist,Safe Zone,7,5,12
12669,2023-01-25,GALE,gemGrab,Gem Fort,28,16,44
12670,2023-01-25,GALE,gemGrab,Crystal Arcade,18,6,24
12671,2023-01-25,GALE,brawlBall,Sunny Soccer,233,202,435
12672,2023-01-25,GALE,brawlBall,Beach Ball,29,42,71
12673,2023-01-25,GALE,bounty,Excel,3,8,11
12674,2023-01-24,GALE,knockout,New Perspective,30,16,46
12675,2023-01-24,GALE,hotZone,Dueling Beetles,24,18,42
12676,2023-01-24,GALE,heist,Safe Zone,15,4,19
12677,2023-01-24,GALE,gemGrab,Minecart Madness,13,8,21
12678,2023-01-24,GALE,gemGrab,Crystal Arcade,35,27,62
12679,2023-01-24,GALE,brawlBall,Center Stage,49,68,117
12680,2023-01-24,GALE,brawlBall,Beach Ball,353,276,629
12681,2023-01-24,GALE,bounty,Excel,9,10,19
12682,2023-01-23,GALE,knockout,New Perspective,40,27,67
12683,2023-01-23,GALE,hotZone,Dueling Beetles,60,52,112
12684,2023-01-23,GALE,heist,Snaked Assault,10,5,15
12685,2023-01-23,GALE,gemGrab,Minecart Madness,50,30,80
12686,2023-01-23,GALE,gemGrab,Double Swoosh,14,21,35
12687,2023-01-23,GALE,brawlBall,Center Stage,616,701,1317
12688,2023-01-23,GALE,brawlBall,Backyard Bowl,11,6,17
12689,2023-01-23,GALE,bounty,Layer Cake,10,4,14
12690,2023-01-22,GALE,knockout,X Marks the Spot,12,6,18
12691,2023-01-22,GALE,hotZone,Ring of Fire,11,1,12
12692,2023-01-22,GALE,heist,Snaked Assault,7,6,13
12693,2023-01-22,GALE,gemGrab,Hard Rock Mine,9,5,14
12694,2023-01-22,GALE,gemGrab,Double Swoosh,17,16,33
12695,2023-01-22,GALE,brawlBall,Super Beach,36,15,51
12696,2023-01-22,GALE,brawlBall,Backyard Bowl,101,84,185
12697,2023-01-22,GALE,bounty,Layer Cake,2,3,5
12698,2023-01-21,GALE,knockout,X Marks the Spot,49,34,83
12699,2023-01-21,GALE,hotZone,Ring of Fire,35,15,50
12700,2023-01-21,GALE,heist,Tornado Ring,11,0,11
12701,2023-01-21,GALE,gemGrab,Hard Rock Mine,41,58,99
12702,2023-01-21,GALE,gemGrab,Deep Diner,11,7,18
12703,2023-01-21,GALE,brawlBall,Super Beach,478,404,882
12704,2023-01-21,GALE,brawlBall,Sneaky Fields,19,16,35
12705,2023-01-21,GALE,bounty,Dry Season,7,0,7
12706,2023-01-20,GALE,knockout,Out in the Open,36,39,75
12707,2023-01-20,GALE,hotZone,Split,106,226,332
12708,2023-01-20,GALE,heist,Tornado Ring,12,4,16
12709,2023-01-20,GALE,gemGrab,Undermine,21,17,38
12710,2023-01-20,GALE,gemGrab,Deep Diner,35,33,68
12711,2023-01-20,GALE,brawlBall,Sneaky Fields,352,307,659
12712,2023-01-20,GALE,brawlBall,Pinhole Punt,10,10,20
12713,2023-01-20,GALE,bounty,Dry Season,9,2,11
12714,2023-01-19,GALE,knockout,Out in the Open,46,19,65
12715,2023-01-19,GALE,hotZone,Split,153,225,378
12716,2023-01-19,GALE,heist,Kaboom Canyon,23,25,48
12717,2023-01-19,GALE,gemGrab,Undermine,40,27,67
12718,2023-01-19,GALE,gemGrab,Gem Fort,6,5,11
12719,2023-01-19,GALE,brawlBall,Sunny Soccer,13,16,29
12720,2023-01-19,GALE,brawlBall,Pinhole Punt,408,350,758
12721,2023-01-19,GALE,bounty,Shooting Star,10,5,15
12722,2023-01-18,GALE,knockout,Goldarm Gulch,0,6,6
12723,2023-01-18,GALE,hotZone,Parallel Plays,7,5,12
12724,2023-01-18,GALE,heist,Kaboom Canyon,10,12,22
12725,2023-01-18,GALE,gemGrab,Gem Fort,9,8,17
12726,2023-01-18,GALE,gemGrab,Crystal Arcade,8,3,11
12727,2023-01-18,GALE,brawlBall,Sunny Soccer,115,87,202
12728,2023-01-18,GALE,brawlBall,Beach Ball,2,4,6
12729,2023-01-18,GALE,bounty,Shooting Star,3,1,4
12730,2023-01-17,GALE,knockout,Goldarm Gulch,9,2,11
12731,2023-01-17,GALE,hotZone,Parallel Plays,9,7,16
12732,2023-01-17,GALE,heist,Pit Stop,1,0,1
12733,2023-01-17,GALE,gemGrab,Minecart Madness,1,1,2
12734,2023-01-17,GALE,gemGrab,Crystal Arcade,1,1,2
12735,2023-01-17,GALE,brawlBall,Center Stage,3,3,6
12736,2023-01-17,GALE,brawlBall,Beach Ball,31,27,58
12737,2023-01-16,GALE,hotZone,Quarter Pounder,9,1,10
12738,2023-01-16,GALE,heist,Pit Stop,8,1,9
12739,2023-01-16,GALE,gemGrab,Minecart Madness,3,3,6
12740,2023-01-16,GALE,gemGrab,Double Swoosh,2,2,4
12741,2023-01-16,GALE,brawlBall,Center Stage,38,43,81
12742,2023-01-16,GALE,brawlBall,Backyard Bowl,3,2,5
12743,2023-01-15,GALE,knockout,Belle's Rock,5,1,6
12744,2023-01-15,GALE,hotZone,Quarter Pounder,11,12,23
12745,2023-01-15,GALE,heist,Bridge Too Far,1,0,1
12746,2023-01-15,GALE,gemGrab,Hard Rock Mine,3,0,3
12747,2023-01-15,GALE,gemGrab,Double Swoosh,6,4,10
12748,2023-01-15,GALE,brawlBall,Super Beach,4,1,5
12749,2023-01-15,GALE,brawlBall,Backyard Bowl,31,20,51
12750,2023-01-15,GALE,bounty,Canal Grande,1,0,1
12751,2023-01-14,GALE,knockout,Flaring Phoenix,0,2,2
12752,2023-01-14,GALE,hotZone,Controller Chaos,25,11,36
12753,2023-01-14,GALE,heist,Bridge Too Far,2,1,3
12754,2023-01-14,GALE,gemGrab,Hard Rock Mine,1,0,1
12755,2023-01-14,GALE,brawlBall,Super Beach,29,12,41
12756,2023-01-14,GALE,brawlBall,Sneaky Fields,2,15,17
12757,2023-01-14,GALE,bounty,Canal Grande,0,1,1
12758,2023-01-13,GALE,knockout,Flaring Phoenix,3,0,3
12759,2023-01-13,GALE,hotZone,Controller Chaos,20,26,46
12760,2023-01-13,GALE,heist,Hot Potato,0,4,4
12761,2023-01-13,GALE,gemGrab,Deep Diner,6,3,9
12762,2023-01-13,GALE,brawlBall,Sneaky Fields,35,25,60
12763,2023-01-13,GALE,brawlBall,Pinhole Punt,1,0,1
12764,2023-01-12,GALE,knockout,Riverside,1,0,1
12765,2023-01-12,GALE,hotZone,Open Zone,6,10,16
12766,2023-01-12,GALE,heist,Hot Potato,1,0,1
12767,2023-01-12,GALE,gemGrab,Undermine,4,4,8
12768,2023-01-12,GALE,gemGrab,Gem Fort,2,0,2
12769,2023-01-12,GALE,brawlBall,Sunny Soccer,6,2,8
12770,2023-01-12,GALE,brawlBall,Pinhole Punt,10,9,19
12771,2023-01-11,GALE,hotZone,Open Zone,2,7,9
12772,2023-01-11,GALE,brawlBall,Sunny Soccer,10,8,18
12773,2023-01-10,GALE,hotZone,Dueling Beetles,11,0,11
12774,2023-01-10,GALE,gemGrab,Crystal Arcade,5,0,5
12775,2023-01-10,GALE,brawlBall,Center Stage,6,0,6
12776,2023-01-10,GALE,brawlBall,Beach Ball,16,16,32
12777,2023-01-09,GALE,knockout,New Perspective,1,0,1
12778,2023-01-09,GALE,hotZone,Dueling Beetles,5,0,5
12779,2023-01-09,GALE,heist,Snaked Assault,1,0,1
12780,2023-01-09,GALE,gemGrab,Minecart Madness,5,1,6
12781,2023-01-09,GALE,gemGrab,Double Swoosh,5,0,5
12782,2023-01-09,GALE,brawlBall,Center Stage,36,36,72
12783,2023-01-09,GALE,brawlBall,Backyard Bowl,4,3,7
12784,2023-01-09,GALE,bounty,Layer Cake,1,1,2
12785,2023-01-08,GALE,knockout,X Marks the Spot,2,0,2
12786,2023-01-08,GALE,hotZone,Ring of Fire,8,3,11
12787,2023-01-08,GALE,heist,Snaked Assault,0,1,1
12788,2023-01-08,GALE,gemGrab,Double Swoosh,1,0,1
12789,2023-01-08,GALE,brawlBall,Super Beach,2,2,4
12790,2023-01-08,GALE,brawlBall,Backyard Bowl,22,21,43
12791,2023-01-07,GALE,hotZone,Ring of Fire,3,0,3
12792,2023-01-07,GALE,heist,Tornado Ring,2,0,2
12793,2023-01-07,GALE,gemGrab,Hard Rock Mine,1,0,1
12794,2023-01-07,GALE,brawlBall,Super Beach,13,16,29
12795,2023-01-07,GALE,brawlBall,Sneaky Fields,3,2,5
12796,2023-01-06,GALE,knockout,Out in the Open,1,0,1
12797,2023-01-06,GALE,hotZone,Split,22,18,40
12798,2023-01-06,GALE,heist,Tornado Ring,1,0,1
12799,2023-01-06,GALE,gemGrab,Undermine,4,0,4
12800,2023-01-06,GALE,gemGrab,Deep Diner,6,1,7
12801,2023-01-06,GALE,brawlBall,Sneaky Fields,27,11,38
12802,2023-01-06,GALE,brawlBall,Pinhole Punt,1,0,1
12803,2023-01-05,GALE,knockout,Out in the Open,3,3,6
12804,2023-01-05,GALE,hotZone,Split,109,119,228
12805,2023-01-05,GALE,heist,Kaboom Canyon,2,6,8
12806,2023-01-05,GALE,gemGrab,Undermine,7,0,7
12807,2023-01-05,GALE,gemGrab,Gem Fort,3,0,3
12808,2023-01-05,GALE,brawlBall,Pinhole Punt,56,46,102
12809,2023-01-04,GALE,knockout,Goldarm Gulch,1,0,1
12810,2023-01-04,GALE,hotZone,Parallel Plays,8,2,10
12811,2023-01-04,GALE,heist,Kaboom Canyon,6,7,13
12812,2023-01-04,GALE,gemGrab,Gem Fort,2,0,2
12813,2023-01-04,GALE,gemGrab,Crystal Arcade,2,0,2
12814,2023-01-04,GALE,brawlBall,Sunny Soccer,32,22,54
12815,2023-01-04,GALE,bounty,Shooting Star,1,0,1
12816,2023-01-03,GALE,knockout,Goldarm Gulch,3,0,3
12817,2023-01-03,GALE,hotZone,Parallel Plays,18,24,42
12818,2023-01-03,GALE,heist,Pit Stop,4,0,4
12819,2023-01-03,GALE,gemGrab,Minecart Madness,1,0,1
12820,2023-01-03,GALE,gemGrab,Crystal Arcade,2,0,2
12821,2023-01-03,GALE,brawlBall,Center Stage,1,0,1
12822,2023-01-03,GALE,brawlBall,Beach Ball,37,25,62
12823,2023-01-02,GALE,knockout,Belle's Rock,2,0,2
12824,2023-01-02,GALE,hotZone,Quarter Pounder,14,3,17
12825,2023-01-02,GALE,heist,Pit Stop,1,2,3
12826,2023-01-02,GALE,gemGrab,Minecart Madness,8,7,15
12827,2023-01-02,GALE,gemGrab,Double Swoosh,5,14,19
12828,2023-01-02,GALE,brawlBall,Center Stage,55,36,91
12829,2023-01-02,GALE,brawlBall,Backyard Bowl,1,1,2
12830,2023-01-02,GALE,bounty,Hideout,1,1,2
12831,2023-01-01,GALE,hotZone,Quarter Pounder,9,0,9
12832,2023-01-01,GALE,hotZone,Controller Chaos,1,0,1
12833,2023-01-01,GALE,gemGrab,Double Swoosh,2,0,2
12834,2023-01-01,GALE,brawlBall,Backyard Bowl,16,2,18
12835,2022-12-31,GALE,hotZone,Controller Chaos,1,2,3
12836,2022-12-31,GALE,brawlBall,Super Beach,4,1,5
12837,2022-12-31,GALE,bounty,Canal Grande,0,2,2
12838,2022-12-30,GALE,hotZone,Controller Chaos,3,1,4
12839,2022-12-30,GALE,gemGrab,Undermine,1,0,1
12840,2022-12-30,GALE,brawlBall,Sneaky Fields,0,3,3
12841,2022-12-29,GALE,gemGrab,Undermine,1,0,1
12842,2022-12-29,GALE,gemGrab,Gem Fort,0,1,1
12843,2022-12-29,GALE,brawlBall,Pinhole Punt,2,2,4
12844,2022-12-28,GALE,hotZone,Open Zone,1,0,1
12845,2022-12-27,GALE,hotZone,Dueling Beetles,1,0,1
12846,2022-12-27,GALE,gemGrab,Minecart Madness,2,0,2
12847,2022-12-26,GALE,heist,Kaboom Canyon,1,0,1
12848,2022-12-26,GALE,gemGrab,Minecart Madness,2,0,2
12849,2022-12-26,GALE,brawlBall,Center Stage,0,1,1
12850,2022-12-24,GALE,brawlBall,Super Beach,1,1,2
12851,2022-12-23,GALE,brawlBall,Sneaky Fields,2,0,2
12852,2022-12-22,GALE,heist,Kaboom Canyon,1,0,1
12853,2022-12-22,GALE,gemGrab,Gem Fort,1,0,1
12854,2022-12-22,GALE,brawlBall,Pinhole Punt,2,1,3
12855,2022-12-21,GALE,brawlBall,Sunny Soccer,0,1,1
12856,2022-12-20,GALE,brawlBall,Beach Ball,1,0,1
12857,2022-12-19,GALE,brawlBall,Center Stage,1,0,1
12858,2022-12-17,GALE,brawlBall,Super Beach,1,0,1
12859,2022-12-16,GALE,brawlBall,Sneaky Fields,1,0,1
12860,2022-12-13,GALE,knockout,New Perspective,1,0,1
12861,2022-12-13,GALE,brawlBall,Beach Ball,2,0,2
12862,2022-12-11,GALE,brawlBall,Backyard Bowl,4,2,6
12863,2022-11-18,GALE,hotZone,Parallel Plays,2,4,6
12864,2022-11-18,GALE,brawlBall,Beach Ball,2,0,2
12865,2022-11-11,GALE,knockout,New Perspective,2,0,2
12866,2022-11-11,GALE,brawlBall,Sneaky Fields,2,0,2
12867,2022-10-30,GALE,knockout,Out in the Open,0,2,2
12868,2022-10-15,GALE,gemGrab,Hard Rock Mine,2,0,2
12869,2023-02-11,FRANK,knockout,Flaring Phoenix,21,11,32
12870,2023-02-11,FRANK,hotZone,Controller Chaos,93,87,180
12871,2023-02-11,FRANK,gemGrab,Deep Diner,13,8,21
12872,2023-02-11,FRANK,brawlBall,Super Beach,152,148,300
12873,2023-02-11,FRANK,brawlBall,Sneaky Fields,122,113,235
12874,2023-02-10,FRANK,knockout,Flaring Phoenix,28,24,52
12875,2023-02-10,FRANK,hotZone,Controller Chaos,102,83,185
12876,2023-02-10,FRANK,heist,Hot Potato,14,13,27
12877,2023-02-10,FRANK,gemGrab,Undermine,8,7,15
12878,2023-02-10,FRANK,gemGrab,Deep Diner,26,20,46
12879,2023-02-10,FRANK,brawlBall,Sneaky Fields,928,965,1893
12880,2023-02-10,FRANK,brawlBall,Pinhole Punt,8,6,14
12881,2023-02-10,FRANK,bounty,Temple Ruins,7,2,9
12882,2023-02-09,FRANK,knockout,Riverside,3,0,3
12883,2023-02-09,FRANK,hotZone,Open Zone,0,2,2
12884,2023-02-09,FRANK,heist,Hot Potato,11,12,23
12885,2023-02-09,FRANK,gemGrab,Undermine,4,5,9
12886,2023-02-09,FRANK,gemGrab,Gem Fort,1,4,5
12887,2023-02-09,FRANK,brawlBall,Sunny Soccer,4,1,5
12888,2023-02-09,FRANK,brawlBall,Pinhole Punt,161,135,296
12889,2023-02-09,FRANK,bounty,Temple Ruins,2,2,4
12890,2023-02-08,FRANK,knockout,Riverside,0,1,1
12891,2023-02-08,FRANK,hotZone,Open Zone,2,2,4
12892,2023-02-08,FRANK,gemGrab,Gem Fort,5,5,10
12893,2023-02-08,FRANK,gemGrab,Crystal Arcade,0,1,1
12894,2023-02-08,FRANK,brawlBall,Sunny Soccer,50,55,105
12895,2023-02-08,FRANK,brawlBall,Beach Ball,1,4,5
12896,2023-02-08,FRANK,bounty,Excel,0,1,1
12897,2023-02-07,FRANK,knockout,New Perspective,0,2,2
12898,2023-02-07,FRANK,hotZone,Dueling Beetles,12,7,19
12899,2023-02-07,FRANK,heist,Safe Zone,1,0,1
12900,2023-02-07,FRANK,gemGrab,Minecart Madness,1,0,1
12901,2023-02-07,FRANK,gemGrab,Crystal Arcade,2,2,4
12902,2023-02-07,FRANK,brawlBall,Center Stage,16,16,32
12903,2023-02-07,FRANK,brawlBall,Beach Ball,44,59,103
12904,2023-02-07,FRANK,bounty,Excel,1,0,1
12905,2023-02-06,FRANK,knockout,New Perspective,37,40,77
12906,2023-02-06,FRANK,knockout,Goldarm Gulch,3,6,9
12907,2023-02-06,FRANK,hotZone,Dueling Beetles,118,40,158
12908,2023-02-06,FRANK,heist,Snaked Assault,49,49,98
12909,2023-02-06,FRANK,heist,Pit Stop,1,0,1
12910,2023-02-06,FRANK,gemGrab,Minecart Madness,20,15,35
12911,2023-02-06,FRANK,gemGrab,Double Swoosh,50,22,72
12912,2023-02-06,FRANK,brawlBall,Sneaky Fields,45,39,84
12913,2023-02-06,FRANK,brawlBall,Center Stage,1027,976,2003
12914,2023-02-06,FRANK,brawlBall,Backyard Bowl,38,29,67
12915,2023-02-06,FRANK,bounty,Layer Cake,11,7,18
12916,2023-02-05,FRANK,knockout,X Marks the Spot,16,3,19
12917,2023-02-05,FRANK,knockout,Goldarm Gulch,9,13,22
12918,2023-02-05,FRANK,hotZone,Ring of Fire,28,23,51
12919,2023-02-05,FRANK,heist,Snaked Assault,61,63,124
12920,2023-02-05,FRANK,heist,Pit Stop,12,1,13
12921,2023-02-05,FRANK,gemGrab,Hard Rock Mine,14,10,24
12922,2023-02-05,FRANK,gemGrab,Double Swoosh,152,108,260
12923,2023-02-05,FRANK,brawlBall,Super Beach,30,24,54
12924,2023-02-05,FRANK,brawlBall,Sneaky Fields,152,101,253
12925,2023-02-05,FRANK,brawlBall,Backyard Bowl,470,473,943
12926,2023-02-05,FRANK,bounty,Layer Cake,8,5,13
12927,2023-02-04,FRANK,knockout,X Marks the Spot,2,1,3
12928,2023-02-04,FRANK,knockout,Goldarm Gulch,5,9,14
12929,2023-02-04,FRANK,hotZone,Ring of Fire,2,3,5
12930,2023-02-04,FRANK,heist,Tornado Ring,10,7,17
12931,2023-02-04,FRANK,heist,Pit Stop,7,0,7
12932,2023-02-04,FRANK,gemGrab,Hard Rock Mine,7,6,13
12933,2023-02-04,FRANK,gemGrab,Double Swoosh,39,6,45
12934,2023-02-04,FRANK,gemGrab,Deep Diner,3,3,6
12935,2023-02-04,FRANK,brawlBall,Super Beach,208,191,399
12936,2023-02-04,FRANK,brawlBall,Sneaky Fields,105,59,164
12937,2023-02-04,FRANK,bounty,Dry Season,2,5,7
12938,2023-02-03,FRANK,knockout,Out in the Open,13,18,31
12939,2023-02-03,FRANK,knockout,Goldarm Gulch,13,15,28
12940,2023-02-03,FRANK,hotZone,Split,141,196,337
12941,2023-02-03,FRANK,heist,Tornado Ring,64,50,114
12942,2023-02-03,FRANK,heist,Pit Stop,20,18,38
12943,2023-02-03,FRANK,gemGrab,Undermine,8,12,20
12944,2023-02-03,FRANK,gemGrab,Double Swoosh,258,60,318
12945,2023-02-03,FRANK,gemGrab,Deep Diner,32,33,65
12946,2023-02-03,FRANK,brawlBall,Sneaky Fields,1752,1305,3057
12947,2023-02-03,FRANK,brawlBall,Pinhole Punt,27,28,55
12948,2023-02-03,FRANK,bounty,Dry Season,7,4,11
12949,2023-02-02,FRANK,knockout,Out in the Open,10,4,14
12950,2023-02-02,FRANK,hotZone,Split,106,120,226
12951,2023-02-02,FRANK,heist,Kaboom Canyon,4,1,5
12952,2023-02-02,FRANK,gemGrab,Undermine,1,7,8
12953,2023-02-02,FRANK,gemGrab,Gem Fort,3,6,9
12954,2023-02-02,FRANK,brawlBall,Sunny Soccer,6,6,12
12955,2023-02-02,FRANK,brawlBall,Pinhole Punt,157,157,314
12956,2023-02-02,FRANK,bounty,Shooting Star,4,0,4
12957,2023-02-01,FRANK,knockout,Goldarm Gulch,18,11,29
12958,2023-02-01,FRANK,hotZone,Parallel Plays,78,57,135
12959,2023-02-01,FRANK,heist,Kaboom Canyon,6,5,11
12960,2023-02-01,FRANK,gemGrab,Gem Fort,34,34,68
12961,2023-02-01,FRANK,gemGrab,Crystal Arcade,8,4,12
12962,2023-02-01,FRANK,brawlBall,Sunny Soccer,658,559,1217
12963,2023-02-01,FRANK,brawlBall,Beach Ball,20,14,34
12964,2023-02-01,FRANK,bounty,Shooting Star,1,0,1
12965,2023-01-31,FRANK,knockout,Goldarm Gulch,13,11,24
12966,2023-01-31,FRANK,hotZone,Parallel Plays,50,62,112
12967,2023-01-31,FRANK,heist,Pit Stop,14,19,33
12968,2023-01-31,FRANK,gemGrab,Minecart Madness,1,1,2
12969,2023-01-31,FRANK,gemGrab,Crystal Arcade,11,22,33
12970,2023-01-31,FRANK,brawlBall,Center Stage,10,13,23
12971,2023-01-31,FRANK,brawlBall,Beach Ball,263,244,507
12972,2023-01-31,FRANK,bounty,Hideout,3,0,3
12973,2023-01-30,FRANK,knockout,Belle's Rock,25,28,53
12974,2023-01-30,FRANK,hotZone,Quarter Pounder,69,63,132
12975,2023-01-30,FRANK,heist,Pit Stop,58,86,144
12976,2023-01-30,FRANK,gemGrab,Minecart Madness,18,9,27
12977,2023-01-30,FRANK,gemGrab,Double Swoosh,23,15,38
12978,2023-01-30,FRANK,brawlBall,Center Stage,707,662,1369
12979,2023-01-30,FRANK,brawlBall,Backyard Bowl,31,45,76
12980,2023-01-30,FRANK,bounty,Hideout,3,0,3
12981,2023-01-29,FRANK,knockout,Belle's Rock,21,13,34
12982,2023-01-29,FRANK,hotZone,Quarter Pounder,54,33,87
12983,2023-01-29,FRANK,heist,Bridge Too Far,13,7,20
12984,2023-01-29,FRANK,gemGrab,Hard Rock Mine,9,9,18
12985,2023-01-29,FRANK,gemGrab,Double Swoosh,45,36,81
12986,2023-01-29,FRANK,brawlBall,Super Beach,8,8,16
12987,2023-01-29,FRANK,brawlBall,Backyard Bowl,384,313,697
12988,2023-01-29,FRANK,bounty,Canal Grande,4,2,6
12989,2023-01-28,FRANK,knockout,Flaring Phoenix,19,9,28
12990,2023-01-28,FRANK,hotZone,Controller Chaos,92,46,138
12991,2023-01-28,FRANK,heist,Bridge Too Far,21,21,42
12992,2023-01-28,FRANK,gemGrab,Hard Rock Mine,38,18,56
12993,2023-01-28,FRANK,gemGrab,Deep Diner,4,4,8
12994,2023-01-28,FRANK,brawlBall,Super Beach,833,764,1597
12995,2023-01-28,FRANK,brawlBall,Sneaky Fields,38,44,82
12996,2023-01-28,FRANK,bounty,Canal Grande,20,10,30
12997,2023-01-27,FRANK,knockout,Flaring Phoenix,4,4,8
12998,2023-01-27,FRANK,hotZone,Controller Chaos,18,59,77
12999,2023-01-27,FRANK,heist,Hot Potato,10,8,18
13000,2023-01-27,FRANK,gemGrab,Undermine,2,1,3
13001,2023-01-27,FRANK,gemGrab,Deep Diner,10,7,17
13002,2023-01-27,FRANK,brawlBall,Sneaky Fields,277,294,571
13003,2023-01-27,FRANK,brawlBall,Pinhole Punt,5,2,7
13004,2023-01-27,FRANK,bounty,Temple Ruins,1,0,1
13005,2023-01-26,FRANK,knockout,Riverside,7,6,13
13006,2023-01-26,FRANK,hotZone,Open Zone,20,16,36
13007,2023-01-26,FRANK,heist,Hot Potato,22,12,34
13008,2023-01-26,FRANK,gemGrab,Undermine,31,46,77
13009,2023-01-26,FRANK,gemGrab,Gem Fort,12,12,24
13010,2023-01-26,FRANK,brawlBall,Sunny Soccer,46,31,77
13011,2023-01-26,FRANK,brawlBall,Pinhole Punt,572,521,1093
13012,2023-01-26,FRANK,bounty,Temple Ruins,5,7,12
13013,2023-01-25,FRANK,knockout,Riverside,7,3,10
13014,2023-01-25,FRANK,hotZone,Open Zone,9,5,14
13015,2023-01-25,FRANK,heist,Safe Zone,11,1,12
13016,2023-01-25,FRANK,gemGrab,Gem Fort,23,21,44
13017,2023-01-25,FRANK,gemGrab,Crystal Arcade,24,28,52
13018,2023-01-25,FRANK,brawlBall,Sunny Soccer,439,391,830
13019,2023-01-25,FRANK,brawlBall,Beach Ball,61,62,123
13020,2023-01-25,FRANK,bounty,Excel,5,0,5
13021,2023-01-24,FRANK,knockout,New Perspective,14,14,28
13022,2023-01-24,FRANK,hotZone,Dueling Beetles,76,60,136
13023,2023-01-24,FRANK,heist,Safe Zone,14,15,29
13024,2023-01-24,FRANK,gemGrab,Minecart Madness,3,2,5
13025,2023-01-24,FRANK,gemGrab,Crystal Arcade,32,24,56
13026,2023-01-24,FRANK,brawlBall,Center Stage,91,82,173
13027,2023-01-24,FRANK,brawlBall,Beach Ball,717,646,1363
13028,2023-01-24,FRANK,bounty,Excel,12,5,17
13029,2023-01-23,FRANK,knockout,New Perspective,24,24,48
13030,2023-01-23,FRANK,hotZone,Dueling Beetles,83,57,140
13031,2023-01-23,FRANK,heist,Snaked Assault,68,68,136
13032,2023-01-23,FRANK,gemGrab,Minecart Madness,24,13,37
13033,2023-01-23,FRANK,gemGrab,Double Swoosh,17,19,36
13034,2023-01-23,FRANK,brawlBall,Center Stage,1071,1014,2085
13035,2023-01-23,FRANK,brawlBall,Backyard Bowl,24,25,49
13036,2023-01-23,FRANK,bounty,Layer Cake,9,15,24
13037,2023-01-22,FRANK,knockout,X Marks the Spot,11,6,17
13038,2023-01-22,FRANK,hotZone,Ring of Fire,21,24,45
13039,2023-01-22,FRANK,heist,Snaked Assault,18,23,41
13040,2023-01-22,FRANK,gemGrab,Hard Rock Mine,6,6,12
13041,2023-01-22,FRANK,gemGrab,Double Swoosh,41,40,81
13042,2023-01-22,FRANK,brawlBall,Super Beach,84,66,150
13043,2023-01-22,FRANK,brawlBall,Backyard Bowl,161,146,307
13044,2023-01-22,FRANK,bounty,Layer Cake,6,10,16
13045,2023-01-21,FRANK,knockout,X Marks the Spot,37,33,70
13046,2023-01-21,FRANK,hotZone,Ring of Fire,57,68,125
13047,2023-01-21,FRANK,heist,Tornado Ring,49,42,91
13048,2023-01-21,FRANK,gemGrab,Hard Rock Mine,40,27,67
13049,2023-01-21,FRANK,gemGrab,Deep Diner,10,6,16
13050,2023-01-21,FRANK,brawlBall,Super Beach,1086,1025,2111
13051,2023-01-21,FRANK,brawlBall,Sneaky Fields,41,50,91
13052,2023-01-21,FRANK,bounty,Dry Season,6,6,12
13053,2023-01-20,FRANK,knockout,Out in the Open,14,7,21
13054,2023-01-20,FRANK,hotZone,Split,155,241,396
13055,2023-01-20,FRANK,heist,Tornado Ring,48,50,98
13056,2023-01-20,FRANK,gemGrab,Undermine,14,6,20
13057,2023-01-20,FRANK,gemGrab,Deep Diner,22,34,56
13058,2023-01-20,FRANK,brawlBall,Sneaky Fields,988,950,1938
13059,2023-01-20,FRANK,brawlBall,Pinhole Punt,24,26,50
13060,2023-01-20,FRANK,bounty,Dry Season,6,4,10
13061,2023-01-19,FRANK,knockout,Out in the Open,20,12,32
13062,2023-01-19,FRANK,hotZone,Split,179,296,475
13063,2023-01-19,FRANK,heist,Kaboom Canyon,14,4,18
13064,2023-01-19,FRANK,gemGrab,Undermine,47,29,76
13065,2023-01-19,FRANK,gemGrab,Gem Fort,9,8,17
13066,2023-01-19,FRANK,brawlBall,Sunny Soccer,24,18,42
13067,2023-01-19,FRANK,brawlBall,Pinhole Punt,586,500,1086
13068,2023-01-19,FRANK,bounty,Shooting Star,7,14,21
13069,2023-01-18,FRANK,knockout,Goldarm Gulch,6,7,13
13070,2023-01-18,FRANK,hotZone,Parallel Plays,6,2,8
13071,2023-01-18,FRANK,heist,Kaboom Canyon,5,0,5
13072,2023-01-18,FRANK,gemGrab,Gem Fort,15,9,24
13073,2023-01-18,FRANK,gemGrab,Crystal Arcade,0,1,1
13074,2023-01-18,FRANK,brawlBall,Sunny Soccer,196,166,362
13075,2023-01-18,FRANK,brawlBall,Beach Ball,7,7,14
13076,2023-01-18,FRANK,bounty,Shooting Star,4,5,9
13077,2023-01-17,FRANK,knockout,Goldarm Gulch,3,6,9
13078,2023-01-17,FRANK,hotZone,Parallel Plays,5,4,9
13079,2023-01-17,FRANK,heist,Pit Stop,8,17,25
13080,2023-01-17,FRANK,gemGrab,Crystal Arcade,3,1,4
13081,2023-01-17,FRANK,brawlBall,Center Stage,6,4,10
13082,2023-01-17,FRANK,brawlBall,Beach Ball,66,70,136
13083,2023-01-17,FRANK,bounty,Hideout,1,0,1
13084,2023-01-16,FRANK,knockout,Belle's Rock,2,0,2
13085,2023-01-16,FRANK,hotZone,Quarter Pounder,21,17,38
13086,2023-01-16,FRANK,heist,Pit Stop,20,45,65
13087,2023-01-16,FRANK,gemGrab,Minecart Madness,1,0,1
13088,2023-01-16,FRANK,gemGrab,Double Swoosh,1,1,2
13089,2023-01-16,FRANK,brawlBall,Center Stage,56,98,154
13090,2023-01-16,FRANK,brawlBall,Backyard Bowl,5,6,11
13091,2023-01-16,FRANK,bounty,Hideout,2,0,2
13092,2023-01-15,FRANK,knockout,Belle's Rock,3,3,6
13093,2023-01-15,FRANK,hotZone,Quarter Pounder,18,5,23
13094,2023-01-15,FRANK,heist,Bridge Too Far,1,0,1
13095,2023-01-15,FRANK,gemGrab,Hard Rock Mine,5,5,10
13096,2023-01-15,FRANK,gemGrab,Double Swoosh,9,7,16
13097,2023-01-15,FRANK,brawlBall,Super Beach,7,4,11
13098,2023-01-15,FRANK,brawlBall,Backyard Bowl,67,47,114
13099,2023-01-15,FRANK,bounty,Canal Grande,2,5,7
13100,2023-01-14,FRANK,hotZone,Controller Chaos,32,21,53
13101,2023-01-14,FRANK,heist,Bridge Too Far,3,0,3
13102,2023-01-14,FRANK,gemGrab,Hard Rock Mine,2,0,2
13103,2023-01-14,FRANK,gemGrab,Deep Diner,0,1,1
13104,2023-01-14,FRANK,brawlBall,Super Beach,73,65,138
13105,2023-01-14,FRANK,brawlBall,Sneaky Fields,12,2,14
13106,2023-01-14,FRANK,bounty,Canal Grande,2,1,3
13107,2023-01-13,FRANK,knockout,Flaring Phoenix,4,1,5
13108,2023-01-13,FRANK,hotZone,Controller Chaos,27,6,33
13109,2023-01-13,FRANK,heist,Hot Potato,2,0,2
13110,2023-01-13,FRANK,gemGrab,Deep Diner,6,1,7
13111,2023-01-13,FRANK,brawlBall,Sneaky Fields,85,63,148
13112,2023-01-13,FRANK,brawlBall,Pinhole Punt,1,0,1
13113,2023-01-12,FRANK,knockout,Riverside,1,1,2
13114,2023-01-12,FRANK,hotZone,Open Zone,9,0,9
13115,2023-01-12,FRANK,heist,Hot Potato,1,0,1
13116,2023-01-12,FRANK,gemGrab,Undermine,3,2,5
13117,2023-01-12,FRANK,gemGrab,Gem Fort,1,0,1
13118,2023-01-12,FRANK,brawlBall,Sunny Soccer,5,4,9
13119,2023-01-12,FRANK,brawlBall,Pinhole Punt,30,22,52
13120,2023-01-11,FRANK,brawlBall,Sunny Soccer,14,14,28
13121,2023-01-11,FRANK,bounty,Excel,3,3,6
13122,2023-01-10,FRANK,knockout,New Perspective,1,0,1
13123,2023-01-10,FRANK,hotZone,Dueling Beetles,15,5,20
13124,2023-01-10,FRANK,gemGrab,Crystal Arcade,1,0,1
13125,2023-01-10,FRANK,brawlBall,Center Stage,8,24,32
13126,2023-01-10,FRANK,brawlBall,Beach Ball,49,26,75
13127,2023-01-09,FRANK,hotZone,Dueling Beetles,6,2,8
13128,2023-01-09,FRANK,heist,Snaked Assault,9,0,9
13129,2023-01-09,FRANK,gemGrab,Minecart Madness,1,2,3
13130,2023-01-09,FRANK,gemGrab,Double Swoosh,2,1,3
13131,2023-01-09,FRANK,brawlBall,Center Stage,67,71,138
13132,2023-01-09,FRANK,brawlBall,Backyard Bowl,2,7,9
13133,2023-01-09,FRANK,bounty,Layer Cake,2,0,2
13134,2023-01-08,FRANK,knockout,X Marks the Spot,3,0,3
13135,2023-01-08,FRANK,hotZone,Ring of Fire,6,1,7
13136,2023-01-08,FRANK,heist,Snaked Assault,4,0,4
13137,2023-01-08,FRANK,gemGrab,Double Swoosh,7,36,43
13138,2023-01-08,FRANK,brawlBall,Super Beach,2,2,4
13139,2023-01-08,FRANK,brawlBall,Backyard Bowl,18,12,30
13140,2023-01-08,FRANK,bounty,Layer Cake,0,2,2
13141,2023-01-07,FRANK,knockout,X Marks the Spot,1,0,1
13142,2023-01-07,FRANK,hotZone,Ring of Fire,4,1,5
13143,2023-01-07,FRANK,heist,Tornado Ring,10,15,25
13144,2023-01-07,FRANK,gemGrab,Hard Rock Mine,2,0,2
13145,2023-01-07,FRANK,brawlBall,Super Beach,27,33,60
13146,2023-01-07,FRANK,brawlBall,Sneaky Fields,8,16,24
13147,2023-01-07,FRANK,bounty,Dry Season,1,1,2
13148,2023-01-06,FRANK,hotZone,Split,10,5,15
13149,2023-01-06,FRANK,heist,Tornado Ring,19,20,39
13150,2023-01-06,FRANK,gemGrab,Undermine,2,1,3
13151,2023-01-06,FRANK,gemGrab,Deep Diner,5,3,8
13152,2023-01-06,FRANK,brawlBall,Sneaky Fields,53,53,106
13153,2023-01-06,FRANK,brawlBall,Pinhole Punt,2,0,2
13154,2023-01-06,FRANK,bounty,Dry Season,1,0,1
13155,2023-01-05,FRANK,knockout,Out in the Open,1,0,1
13156,2023-01-05,FRANK,hotZone,Split,68,42,110
13157,2023-01-05,FRANK,heist,Kaboom Canyon,4,0,4
13158,2023-01-05,FRANK,gemGrab,Undermine,8,2,10
13159,2023-01-05,FRANK,brawlBall,Sunny Soccer,0,1,1
13160,2023-01-05,FRANK,brawlBall,Pinhole Punt,41,47,88
13161,2023-01-05,FRANK,bounty,Shooting Star,1,1,2
13162,2023-01-04,FRANK,hotZone,Parallel Plays,4,0,4
13163,2023-01-04,FRANK,heist,Kaboom Canyon,2,0,2
13164,2023-01-04,FRANK,gemGrab,Gem Fort,3,3,6
13165,2023-01-04,FRANK,gemGrab,Crystal Arcade,6,12,18
13166,2023-01-04,FRANK,brawlBall,Sunny Soccer,64,38,102
13167,2023-01-04,FRANK,bounty,Shooting Star,1,0,1
13168,2023-01-03,FRANK,knockout,Goldarm Gulch,1,0,1
13169,2023-01-03,FRANK,hotZone,Parallel Plays,7,0,7
13170,2023-01-03,FRANK,heist,Pit Stop,9,0,9
13171,2023-01-03,FRANK,gemGrab,Minecart Madness,1,0,1
13172,2023-01-03,FRANK,gemGrab,Crystal Arcade,1,3,4
13173,2023-01-03,FRANK,brawlBall,Center Stage,4,1,5
13174,2023-01-03,FRANK,brawlBall,Beach Ball,56,18,74
13175,2023-01-02,FRANK,knockout,Belle's Rock,3,0,3
13176,2023-01-02,FRANK,hotZone,Quarter Pounder,17,21,38
13177,2023-01-02,FRANK,hotZone,Controller Chaos,0,2,2
13178,2023-01-02,FRANK,heist,Pit Stop,23,26,49
13179,2023-01-02,FRANK,heist,Kaboom Canyon,1,0,1
13180,2023-01-02,FRANK,gemGrab,Minecart Madness,2,1,3
13181,2023-01-02,FRANK,gemGrab,Double Swoosh,10,9,19
13182,2023-01-02,FRANK,brawlBall,Center Stage,52,21,73
13183,2023-01-02,FRANK,brawlBall,Backyard Bowl,4,3,7
13184,2023-01-02,FRANK,bounty,Hideout,0,1,1
13185,2023-01-01,FRANK,hotZone,Quarter Pounder,6,14,20
13186,2023-01-01,FRANK,heist,Bridge Too Far,1,0,1
13187,2023-01-01,FRANK,gemGrab,Double Swoosh,3,0,3
13188,2023-01-01,FRANK,brawlBall,Backyard Bowl,20,30,50
13189,2022-12-31,FRANK,hotZone,Controller Chaos,1,0,1
13190,2022-12-31,FRANK,heist,Bridge Too Far,1,1,2
13191,2022-12-31,FRANK,gemGrab,Hard Rock Mine,1,1,2
13192,2022-12-31,FRANK,brawlBall,Super Beach,5,3,8
13193,2022-12-31,FRANK,brawlBall,Sneaky Fields,1,0,1
13194,2022-12-30,FRANK,hotZone,Controller Chaos,5,0,5
13195,2022-12-30,FRANK,gemGrab,Deep Diner,2,1,3
13196,2022-12-30,FRANK,brawlBall,Sneaky Fields,11,11,22
13197,2022-12-29,FRANK,gemGrab,Gem Fort,0,1,1
13198,2022-12-29,FRANK,brawlBall,Pinhole Punt,4,5,9
13199,2022-12-28,FRANK,brawlBall,Sunny Soccer,1,0,1
13200,2022-12-27,FRANK,hotZone,Controller Chaos,2,0,2
13201,2022-12-27,FRANK,brawlBall,Beach Ball,0,1,1
13202,2022-12-26,FRANK,hotZone,Controller Chaos,0,1,1
13203,2022-12-26,FRANK,brawlBall,Center Stage,0,1,1
13204,2022-12-24,FRANK,brawlBall,Super Beach,2,0,2
13205,2022-12-22,FRANK,brawlBall,Pinhole Punt,1,0,1
13206,2022-12-21,FRANK,brawlBall,Sunny Soccer,1,0,1
13207,2022-12-20,FRANK,brawlBall,Beach Ball,1,1,2
13208,2022-12-19,FRANK,gemGrab,Minecart Madness,2,0,2
13209,2022-12-19,FRANK,brawlBall,Center Stage,0,3,3
13210,2022-12-16,FRANK,brawlBall,Sneaky Fields,1,0,1
13211,2022-12-13,FRANK,brawlBall,Beach Ball,0,1,1
13212,2022-12-12,FRANK,brawlBall,Center Stage,2,2,4
13213,2022-11-19,FRANK,brawlBall,Sneaky Fields,0,2,2
13214,2022-11-07,FRANK,hotZone,Quarter Pounder,2,0,2
13215,2022-10-28,FRANK,brawlBall,Beach Ball,2,0,2
13216,2022-10-26,FRANK,brawlBall,Sunny Soccer,4,0,4
13217,2022-10-15,FRANK,brawlBall,Super Beach,0,1,1
13218,2023-02-11,FANG,knockout,Flaring Phoenix,97,65,162
13219,2023-02-11,FANG,hotZone,Controller Chaos,49,12,61
13220,2023-02-11,FANG,gemGrab,Deep Diner,92,111,203
13221,2023-02-11,FANG,brawlBall,Super Beach,226,195,421
13222,2023-02-11,FANG,brawlBall,Sneaky Fields,85,72,157
13223,2023-02-10,FANG,knockout,Flaring Phoenix,158,117,275
13224,2023-02-10,FANG,hotZone,Controller Chaos,47,33,80
13225,2023-02-10,FANG,heist,Hot Potato,18,16,34
13226,2023-02-10,FANG,gemGrab,Undermine,38,28,66
13227,2023-02-10,FANG,gemGrab,Deep Diner,171,184,355
13228,2023-02-10,FANG,brawlBall,Sneaky Fields,696,562,1258
13229,2023-02-10,FANG,brawlBall,Pinhole Punt,17,17,34
13230,2023-02-10,FANG,bounty,Temple Ruins,82,94,176
13231,2023-02-09,FANG,knockout,Riverside,35,38,73
13232,2023-02-09,FANG,hotZone,Open Zone,12,8,20
13233,2023-02-09,FANG,heist,Hot Potato,10,2,12
13234,2023-02-09,FANG,gemGrab,Undermine,30,32,62
13235,2023-02-09,FANG,gemGrab,Gem Fort,1,5,6
13236,2023-02-09,FANG,brawlBall,Sunny Soccer,4,0,4
13237,2023-02-09,FANG,brawlBall,Pinhole Punt,256,251,507
13238,2023-02-09,FANG,bounty,Temple Ruins,23,14,37
13239,2023-02-08,FANG,knockout,Riverside,5,9,14
13240,2023-02-08,FANG,hotZone,Open Zone,6,3,9
13241,2023-02-08,FANG,heist,Safe Zone,10,6,16
13242,2023-02-08,FANG,gemGrab,Gem Fort,11,13,24
13243,2023-02-08,FANG,gemGrab,Crystal Arcade,3,6,9
13244,2023-02-08,FANG,brawlBall,Sunny Soccer,63,63,126
13245,2023-02-08,FANG,brawlBall,Beach Ball,5,9,14
13246,2023-02-08,FANG,bounty,Excel,3,5,8
13247,2023-02-07,FANG,knockout,New Perspective,10,5,15
13248,2023-02-07,FANG,hotZone,Dueling Beetles,9,4,13
13249,2023-02-07,FANG,gemGrab,Minecart Madness,9,3,12
13250,2023-02-07,FANG,gemGrab,Crystal Arcade,7,10,17
13251,2023-02-07,FANG,brawlBall,Center Stage,6,14,20
13252,2023-02-07,FANG,brawlBall,Beach Ball,56,49,105
13253,2023-02-07,FANG,bounty,Excel,4,6,10
13254,2023-02-06,FANG,knockout,New Perspective,190,180,370
13255,2023-02-06,FANG,knockout,Goldarm Gulch,12,11,23
13256,2023-02-06,FANG,hotZone,Dueling Beetles,88,43,131
13257,2023-02-06,FANG,heist,Snaked Assault,37,11,48
13258,2023-02-06,FANG,heist,Pit Stop,0,1,1
13259,2023-02-06,FANG,gemGrab,Minecart Madness,144,185,329
13260,2023-02-06,FANG,gemGrab,Double Swoosh,72,49,121
13261,2023-02-06,FANG,brawlBall,Sneaky Fields,4,12,16
13262,2023-02-06,FANG,brawlBall,Center Stage,943,937,1880
13263,2023-02-06,FANG,brawlBall,Backyard Bowl,136,158,294
13264,2023-02-06,FANG,bounty,Layer Cake,98,120,218
13265,2023-02-05,FANG,knockout,X Marks the Spot,182,196,378
13266,2023-02-05,FANG,knockout,Goldarm Gulch,37,38,75
13267,2023-02-05,FANG,hotZone,Ring of Fire,83,53,136
13268,2023-02-05,FANG,heist,Snaked Assault,37,34,71
13269,2023-02-05,FANG,heist,Pit Stop,1,2,3
13270,2023-02-05,FANG,gemGrab,Hard Rock Mine,61,61,122
13271,2023-02-05,FANG,gemGrab,Double Swoosh,236,144,380
13272,2023-02-05,FANG,brawlBall,Super Beach,38,30,68
13273,2023-02-05,FANG,brawlBall,Sneaky Fields,36,22,58
13274,2023-02-05,FANG,brawlBall,Backyard Bowl,1518,1823,3341
13275,2023-02-05,FANG,bounty,Layer Cake,59,100,159
13276,2023-02-04,FANG,knockout,X Marks the Spot,44,29,73
13277,2023-02-04,FANG,knockout,Goldarm Gulch,19,31,50
13278,2023-02-04,FANG,hotZone,Ring of Fire,19,15,34
13279,2023-02-04,FANG,heist,Tornado Ring,0,3,3
13280,2023-02-04,FANG,heist,Pit Stop,0,2,2
13281,2023-02-04,FANG,gemGrab,Hard Rock Mine,54,89,143
13282,2023-02-04,FANG,gemGrab,Double Swoosh,33,6,39
13283,2023-02-04,FANG,gemGrab,Deep Diner,7,6,13
13284,2023-02-04,FANG,brawlBall,Super Beach,240,221,461
13285,2023-02-04,FANG,brawlBall,Sneaky Fields,42,27,69
13286,2023-02-04,FANG,bounty,Dry Season,24,30,54
13287,2023-02-03,FANG,knockout,Out in the Open,197,158,355
13288,2023-02-03,FANG,knockout,Goldarm Gulch,161,181,342
13289,2023-02-03,FANG,hotZone,Split,40,12,52
13290,2023-02-03,FANG,heist,Tornado Ring,31,17,48
13291,2023-02-03,FANG,heist,Pit Stop,5,5,10
13292,2023-02-03,FANG,gemGrab,Undermine,54,57,111
13293,2023-02-03,FANG,gemGrab,Double Swoosh,133,130,263
13294,2023-02-03,FANG,gemGrab,Deep Diner,150,127,277
13295,2023-02-03,FANG,brawlBall,Sneaky Fields,899,840,1739
13296,2023-02-03,FANG,brawlBall,Pinhole Punt,41,32,73
13297,2023-02-03,FANG,bounty,Dry Season,154,188,342
13298,2023-02-02,FANG,knockout,Out in the Open,67,40,107
13299,2023-02-02,FANG,hotZone,Split,12,15,27
13300,2023-02-02,FANG,heist,Kaboom Canyon,12,11,23
13301,2023-02-02,FANG,gemGrab,Undermine,31,22,53
13302,2023-02-02,FANG,gemGrab,Gem Fort,6,9,15
13303,2023-02-02,FANG,brawlBall,Sunny Soccer,13,5,18
13304,2023-02-02,FANG,brawlBall,Pinhole Punt,245,271,516
13305,2023-02-02,FANG,bounty,Shooting Star,25,25,50
13306,2023-02-01,FANG,knockout,Goldarm Gulch,299,274,573
13307,2023-02-01,FANG,hotZone,Parallel Plays,76,40,116
13308,2023-02-01,FANG,heist,Kaboom Canyon,30,10,40
13309,2023-02-01,FANG,gemGrab,Gem Fort,145,116,261
13310,2023-02-01,FANG,gemGrab,Crystal Arcade,77,57,134
13311,2023-02-01,FANG,brawlBall,Sunny Soccer,699,677,1376
13312,2023-02-01,FANG,brawlBall,Beach Ball,23,20,43
13313,2023-02-01,FANG,bounty,Shooting Star,51,74,125
13314,2023-01-31,FANG,knockout,Goldarm Gulch,86,91,177
13315,2023-01-31,FANG,hotZone,Parallel Plays,33,42,75
13316,2023-01-31,FANG,heist,Pit Stop,4,2,6
13317,2023-01-31,FANG,gemGrab,Minecart Madness,14,16,30
13318,2023-01-31,FANG,gemGrab,Crystal Arcade,66,74,140
13319,2023-01-31,FANG,brawlBall,Center Stage,17,12,29
13320,2023-01-31,FANG,brawlBall,Beach Ball,326,386,712
13321,2023-01-31,FANG,bounty,Hideout,40,31,71
13322,2023-01-30,FANG,knockout,Belle's Rock,277,379,656
13323,2023-01-30,FANG,hotZone,Quarter Pounder,69,17,86
13324,2023-01-30,FANG,heist,Pit Stop,18,22,40
13325,2023-01-30,FANG,gemGrab,Minecart Madness,94,138,232
13326,2023-01-30,FANG,gemGrab,Double Swoosh,95,80,175
13327,2023-01-30,FANG,brawlBall,Center Stage,573,534,1107
13328,2023-01-30,FANG,brawlBall,Backyard Bowl,129,127,256
13329,2023-01-30,FANG,bounty,Hideout,50,40,90
13330,2023-01-29,FANG,knockout,Belle's Rock,261,269,530
13331,2023-01-29,FANG,hotZone,Quarter Pounder,44,21,65
13332,2023-01-29,FANG,heist,Bridge Too Far,49,18,67
13333,2023-01-29,FANG,gemGrab,Hard Rock Mine,58,33,91
13334,2023-01-29,FANG,gemGrab,Double Swoosh,158,124,282
13335,2023-01-29,FANG,brawlBall,Super Beach,18,11,29
13336,2023-01-29,FANG,brawlBall,Backyard Bowl,1028,1083,2111
13337,2023-01-29,FANG,bounty,Canal Grande,74,77,151
13338,2023-01-28,FANG,knockout,Flaring Phoenix,135,73,208
13339,2023-01-28,FANG,hotZone,Controller Chaos,58,44,102
13340,2023-01-28,FANG,heist,Bridge Too Far,88,57,145
13341,2023-01-28,FANG,gemGrab,Hard Rock Mine,185,142,327
13342,2023-01-28,FANG,gemGrab,Deep Diner,69,55,124
13343,2023-01-28,FANG,brawlBall,Super Beach,990,949,1939
13344,2023-01-28,FANG,brawlBall,Sneaky Fields,28,24,52
13345,2023-01-28,FANG,bounty,Canal Grande,76,92,168
13346,2023-01-27,FANG,knockout,Flaring Phoenix,48,36,84
13347,2023-01-27,FANG,hotZone,Controller Chaos,23,29,52
13348,2023-01-27,FANG,heist,Hot Potato,12,3,15
13349,2023-01-27,FANG,gemGrab,Undermine,19,19,38
13350,2023-01-27,FANG,gemGrab,Deep Diner,53,51,104
13351,2023-01-27,FANG,brawlBall,Sneaky Fields,254,196,450
13352,2023-01-27,FANG,brawlBall,Pinhole Punt,8,7,15
13353,2023-01-27,FANG,bounty,Temple Ruins,23,19,42
13354,2023-01-26,FANG,knockout,Riverside,212,169,381
13355,2023-01-26,FANG,hotZone,Open Zone,74,31,105
13356,2023-01-26,FANG,heist,Hot Potato,34,27,61
13357,2023-01-26,FANG,gemGrab,Undermine,84,66,150
13358,2023-01-26,FANG,gemGrab,Gem Fort,47,25,72
13359,2023-01-26,FANG,brawlBall,Sunny Soccer,53,54,107
13360,2023-01-26,FANG,brawlBall,Pinhole Punt,855,837,1692
13361,2023-01-26,FANG,bounty,Temple Ruins,38,39,77
13362,2023-01-25,FANG,knockout,Riverside,64,37,101
13363,2023-01-25,FANG,hotZone,Open Zone,33,17,50
13364,2023-01-25,FANG,heist,Safe Zone,56,33,89
13365,2023-01-25,FANG,gemGrab,Gem Fort,55,49,104
13366,2023-01-25,FANG,gemGrab,Crystal Arcade,107,116,223
13367,2023-01-25,FANG,brawlBall,Sunny Soccer,471,518,989
13368,2023-01-25,FANG,brawlBall,Beach Ball,89,77,166
13369,2023-01-25,FANG,bounty,Excel,46,60,106
13370,2023-01-24,FANG,knockout,New Perspective,162,194,356
13371,2023-01-24,FANG,hotZone,Dueling Beetles,60,42,102
13372,2023-01-24,FANG,heist,Safe Zone,45,57,102
13373,2023-01-24,FANG,gemGrab,Minecart Madness,31,25,56
13374,2023-01-24,FANG,gemGrab,Crystal Arcade,149,145,294
13375,2023-01-24,FANG,brawlBall,Center Stage,101,80,181
13376,2023-01-24,FANG,brawlBall,Beach Ball,777,790,1567
13377,2023-01-24,FANG,bounty,Excel,86,138,224
13378,2023-01-23,FANG,knockout,New Perspective,187,179,366
13379,2023-01-23,FANG,hotZone,Dueling Beetles,57,44,101
13380,2023-01-23,FANG,heist,Snaked Assault,17,20,37
13381,2023-01-23,FANG,gemGrab,Minecart Madness,159,213,372
13382,2023-01-23,FANG,gemGrab,Double Swoosh,52,33,85
13383,2023-01-23,FANG,brawlBall,Center Stage,919,855,1774
13384,2023-01-23,FANG,brawlBall,Backyard Bowl,70,72,142
13385,2023-01-23,FANG,bounty,Layer Cake,110,169,279
13386,2023-01-22,FANG,knockout,X Marks the Spot,116,90,206
13387,2023-01-22,FANG,hotZone,Ring of Fire,39,43,82
13388,2023-01-22,FANG,heist,Snaked Assault,19,26,45
13389,2023-01-22,FANG,gemGrab,Hard Rock Mine,28,23,51
13390,2023-01-22,FANG,gemGrab,Double Swoosh,47,36,83
13391,2023-01-22,FANG,brawlBall,Super Beach,87,77,164
13392,2023-01-22,FANG,brawlBall,Backyard Bowl,475,527,1002
13393,2023-01-22,FANG,bounty,Layer Cake,61,76,137
13394,2023-01-21,FANG,knockout,X Marks the Spot,353,325,678
13395,2023-01-21,FANG,hotZone,Ring of Fire,102,61,163
13396,2023-01-21,FANG,heist,Tornado Ring,23,9,32
13397,2023-01-21,FANG,gemGrab,Hard Rock Mine,190,177,367
13398,2023-01-21,FANG,gemGrab,Deep Diner,48,44,92
13399,2023-01-21,FANG,brawlBall,Super Beach,1021,1049,2070
13400,2023-01-21,FANG,brawlBall,Sneaky Fields,46,33,79
13401,2023-01-21,FANG,bounty,Dry Season,111,155,266
13402,2023-01-20,FANG,knockout,Out in the Open,219,192,411
13403,2023-01-20,FANG,hotZone,Split,19,25,44
13404,2023-01-20,FANG,heist,Tornado Ring,20,9,29
13405,2023-01-20,FANG,gemGrab,Undermine,44,34,78
13406,2023-01-20,FANG,gemGrab,Deep Diner,163,158,321
13407,2023-01-20,FANG,brawlBall,Sneaky Fields,721,654,1375
13408,2023-01-20,FANG,brawlBall,Pinhole Punt,61,36,97
13409,2023-01-20,FANG,bounty,Dry Season,78,74,152
13410,2023-01-19,FANG,knockout,Out in the Open,210,135,345
13411,2023-01-19,FANG,hotZone,Split,28,21,49
13412,2023-01-19,FANG,heist,Kaboom Canyon,28,11,39
13413,2023-01-19,FANG,gemGrab,Undermine,106,100,206
13414,2023-01-19,FANG,gemGrab,Gem Fort,30,22,52
13415,2023-01-19,FANG,brawlBall,Sunny Soccer,36,24,60
13416,2023-01-19,FANG,brawlBall,Pinhole Punt,870,868,1738
13417,2023-01-19,FANG,bounty,Shooting Star,78,90,168
13418,2023-01-18,FANG,knockout,Goldarm Gulch,27,22,49
13419,2023-01-18,FANG,hotZone,Parallel Plays,12,14,26
13420,2023-01-18,FANG,heist,Kaboom Canyon,9,8,17
13421,2023-01-18,FANG,gemGrab,Gem Fort,22,29,51
13422,2023-01-18,FANG,gemGrab,Crystal Arcade,15,17,32
13423,2023-01-18,FANG,brawlBall,Sunny Soccer,165,186,351
13424,2023-01-18,FANG,brawlBall,Beach Ball,13,13,26
13425,2023-01-18,FANG,bounty,Shooting Star,36,33,69
13426,2023-01-17,FANG,knockout,Goldarm Gulch,26,24,50
13427,2023-01-17,FANG,hotZone,Parallel Plays,8,1,9
13428,2023-01-17,FANG,heist,Pit Stop,1,0,1
13429,2023-01-17,FANG,gemGrab,Minecart Madness,3,4,7
13430,2023-01-17,FANG,gemGrab,Crystal Arcade,12,10,22
13431,2023-01-17,FANG,brawlBall,Center Stage,2,3,5
13432,2023-01-17,FANG,brawlBall,Beach Ball,65,72,137
13433,2023-01-17,FANG,bounty,Hideout,4,2,6
13434,2023-01-16,FANG,knockout,Belle's Rock,25,14,39
13435,2023-01-16,FANG,hotZone,Quarter Pounder,12,8,20
13436,2023-01-16,FANG,heist,Pit Stop,4,0,4
13437,2023-01-16,FANG,gemGrab,Minecart Madness,6,20,26
13438,2023-01-16,FANG,gemGrab,Double Swoosh,10,2,12
13439,2023-01-16,FANG,brawlBall,Center Stage,54,40,94
13440,2023-01-16,FANG,brawlBall,Backyard Bowl,13,17,30
13441,2023-01-16,FANG,bounty,Hideout,8,6,14
13442,2023-01-15,FANG,knockout,Belle's Rock,35,55,90
13443,2023-01-15,FANG,hotZone,Quarter Pounder,16,4,20
13444,2023-01-15,FANG,heist,Bridge Too Far,3,4,7
13445,2023-01-15,FANG,gemGrab,Hard Rock Mine,10,5,15
13446,2023-01-15,FANG,gemGrab,Double Swoosh,12,13,25
13447,2023-01-15,FANG,brawlBall,Super Beach,12,3,15
13448,2023-01-15,FANG,brawlBall,Backyard Bowl,137,141,278
13449,2023-01-15,FANG,bounty,Canal Grande,13,4,17
13450,2023-01-14,FANG,knockout,Flaring Phoenix,16,6,22
13451,2023-01-14,FANG,hotZone,Controller Chaos,6,4,10
13452,2023-01-14,FANG,heist,Bridge Too Far,8,14,22
13453,2023-01-14,FANG,gemGrab,Hard Rock Mine,9,8,17
13454,2023-01-14,FANG,gemGrab,Deep Diner,9,1,10
13455,2023-01-14,FANG,brawlBall,Super Beach,41,31,72
13456,2023-01-14,FANG,brawlBall,Sneaky Fields,6,2,8
13457,2023-01-14,FANG,bounty,Canal Grande,13,15,28
13458,2023-01-13,FANG,knockout,Flaring Phoenix,6,1,7
13459,2023-01-13,FANG,hotZone,Controller Chaos,12,1,13
13460,2023-01-13,FANG,heist,Hot Potato,1,0,1
13461,2023-01-13,FANG,gemGrab,Deep Diner,13,21,34
13462,2023-01-13,FANG,brawlBall,Sneaky Fields,22,15,37
13463,2023-01-13,FANG,brawlBall,Pinhole Punt,1,0,1
13464,2023-01-13,FANG,bounty,Temple Ruins,5,9,14
13465,2023-01-12,FANG,knockout,Riverside,30,24,54
13466,2023-01-12,FANG,hotZone,Open Zone,10,5,15
13467,2023-01-12,FANG,gemGrab,Undermine,8,2,10
13468,2023-01-12,FANG,gemGrab,Gem Fort,4,1,5
13469,2023-01-12,FANG,brawlBall,Sunny Soccer,2,1,3
13470,2023-01-12,FANG,brawlBall,Pinhole Punt,27,23,50
13471,2023-01-12,FANG,bounty,Temple Ruins,1,0,1
13472,2023-01-11,FANG,knockout,Riverside,3,1,4
13473,2023-01-11,FANG,hotZone,Open Zone,2,0,2
13474,2023-01-11,FANG,heist,Safe Zone,1,0,1
13475,2023-01-11,FANG,gemGrab,Gem Fort,2,10,12
13476,2023-01-11,FANG,brawlBall,Sunny Soccer,15,16,31
13477,2023-01-11,FANG,bounty,Excel,0,5,5
13478,2023-01-10,FANG,knockout,New Perspective,17,18,35
13479,2023-01-10,FANG,hotZone,Dueling Beetles,10,13,23
13480,2023-01-10,FANG,heist,Safe Zone,4,1,5
13481,2023-01-10,FANG,gemGrab,Minecart Madness,5,2,7
13482,2023-01-10,FANG,gemGrab,Crystal Arcade,11,12,23
13483,2023-01-10,FANG,brawlBall,Center Stage,6,3,9
13484,2023-01-10,FANG,brawlBall,Beach Ball,35,40,75
13485,2023-01-10,FANG,bounty,Excel,3,3,6
13486,2023-01-09,FANG,knockout,New Perspective,5,11,16
13487,2023-01-09,FANG,hotZone,Dueling Beetles,7,15,22
13488,2023-01-09,FANG,heist,Snaked Assault,6,3,9
13489,2023-01-09,FANG,gemGrab,Minecart Madness,10,7,17
13490,2023-01-09,FANG,gemGrab,Double Swoosh,8,6,14
13491,2023-01-09,FANG,brawlBall,Center Stage,52,28,80
13492,2023-01-09,FANG,brawlBall,Backyard Bowl,5,14,19
13493,2023-01-09,FANG,bounty,Layer Cake,14,9,23
13494,2023-01-08,FANG,knockout,X Marks the Spot,27,25,52
13495,2023-01-08,FANG,hotZone,Ring of Fire,23,17,40
13496,2023-01-08,FANG,heist,Snaked Assault,7,6,13
13497,2023-01-08,FANG,gemGrab,Hard Rock Mine,2,1,3
13498,2023-01-08,FANG,gemGrab,Double Swoosh,5,1,6
13499,2023-01-08,FANG,brawlBall,Super Beach,5,3,8
13500,2023-01-08,FANG,brawlBall,Backyard Bowl,63,83,146
13501,2023-01-08,FANG,bounty,Layer Cake,3,2,5
13502,2023-01-07,FANG,knockout,X Marks the Spot,10,21,31
13503,2023-01-07,FANG,hotZone,Ring of Fire,6,2,8
13504,2023-01-07,FANG,heist,Tornado Ring,2,0,2
13505,2023-01-07,FANG,gemGrab,Hard Rock Mine,4,1,5
13506,2023-01-07,FANG,gemGrab,Deep Diner,5,1,6
13507,2023-01-07,FANG,brawlBall,Super Beach,31,30,61
13508,2023-01-07,FANG,brawlBall,Sneaky Fields,1,0,1
13509,2023-01-07,FANG,bounty,Dry Season,9,11,20
13510,2023-01-06,FANG,knockout,Out in the Open,7,1,8
13511,2023-01-06,FANG,hotZone,Split,1,5,6
13512,2023-01-06,FANG,heist,Tornado Ring,1,0,1
13513,2023-01-06,FANG,gemGrab,Undermine,1,0,1
13514,2023-01-06,FANG,gemGrab,Deep Diner,11,6,17
13515,2023-01-06,FANG,brawlBall,Sneaky Fields,23,14,37
13516,2023-01-06,FANG,bounty,Dry Season,12,24,36
13517,2023-01-05,FANG,knockout,Out in the Open,22,12,34
13518,2023-01-05,FANG,hotZone,Split,7,0,7
13519,2023-01-05,FANG,heist,Kaboom Canyon,4,0,4
13520,2023-01-05,FANG,gemGrab,Undermine,19,32,51
13521,2023-01-05,FANG,gemGrab,Gem Fort,4,2,6
13522,2023-01-05,FANG,brawlBall,Pinhole Punt,62,22,84
13523,2023-01-05,FANG,bounty,Shooting Star,15,19,34
13524,2023-01-04,FANG,knockout,Goldarm Gulch,14,4,18
13525,2023-01-04,FANG,hotZone,Parallel Plays,1,0,1
13526,2023-01-04,FANG,heist,Kaboom Canyon,7,3,10
13527,2023-01-04,FANG,gemGrab,Gem Fort,9,1,10
13528,2023-01-04,FANG,gemGrab,Crystal Arcade,10,15,25
13529,2023-01-04,FANG,brawlBall,Sunny Soccer,31,52,83
13530,2023-01-04,FANG,bounty,Shooting Star,13,22,35
13531,2023-01-03,FANG,knockout,Goldarm Gulch,13,24,37
13532,2023-01-03,FANG,hotZone,Parallel Plays,4,2,6
13533,2023-01-03,FANG,heist,Pit Stop,1,0,1
13534,2023-01-03,FANG,gemGrab,Minecart Madness,2,0,2
13535,2023-01-03,FANG,gemGrab,Crystal Arcade,13,5,18
13536,2023-01-03,FANG,brawlBall,Center Stage,2,0,2
13537,2023-01-03,FANG,brawlBall,Beach Ball,47,33,80
13538,2023-01-03,FANG,bounty,Hideout,7,5,12
13539,2023-01-02,FANG,knockout,Belle's Rock,17,4,21
13540,2023-01-02,FANG,hotZone,Quarter Pounder,9,4,13
13541,2023-01-02,FANG,heist,Pit Stop,3,0,3
13542,2023-01-02,FANG,gemGrab,Minecart Madness,17,23,40
13543,2023-01-02,FANG,gemGrab,Double Swoosh,7,6,13
13544,2023-01-02,FANG,brawlBall,Center Stage,46,22,68
13545,2023-01-02,FANG,brawlBall,Backyard Bowl,4,1,5
13546,2023-01-02,FANG,bounty,Hideout,12,19,31
13547,2023-01-01,FANG,knockout,Belle's Rock,13,20,33
13548,2023-01-01,FANG,hotZone,Quarter Pounder,2,0,2
13549,2023-01-01,FANG,gemGrab,Hard Rock Mine,2,0,2
13550,2023-01-01,FANG,gemGrab,Double Swoosh,8,1,9
13551,2023-01-01,FANG,brawlBall,Backyard Bowl,35,28,63
13552,2023-01-01,FANG,bounty,Canal Grande,0,1,1
13553,2022-12-31,FANG,gemGrab,Hard Rock Mine,4,1,5
13554,2022-12-31,FANG,gemGrab,Deep Diner,1,2,3
13555,2022-12-31,FANG,brawlBall,Super Beach,5,4,9
13556,2022-12-30,FANG,knockout,Flaring Phoenix,0,2,2
13557,2022-12-30,FANG,hotZone,Controller Chaos,1,0,1
13558,2022-12-30,FANG,gemGrab,Undermine,1,0,1
13559,2022-12-30,FANG,gemGrab,Deep Diner,3,1,4
13560,2022-12-30,FANG,brawlBall,Sneaky Fields,4,2,6
13561,2022-12-29,FANG,hotZone,Open Zone,1,0,1
13562,2022-12-29,FANG,gemGrab,Undermine,1,0,1
13563,2022-12-27,FANG,hotZone,Dueling Beetles,0,1,1
13564,2022-12-26,FANG,hotZone,Controller Chaos,1,0,1
13565,2022-12-24,FANG,bounty,Dry Season,1,1,2
13566,2022-12-23,FANG,knockout,Out in the Open,2,0,2
13567,2022-12-22,FANG,brawlBall,Pinhole Punt,2,5,7
13568,2022-12-21,FANG,brawlBall,Sunny Soccer,0,1,1
13569,2022-12-21,FANG,bounty,Shooting Star,1,0,1
13570,2022-12-20,FANG,brawlBall,Beach Ball,0,1,1
13571,2022-12-19,FANG,gemGrab,Minecart Madness,0,2,2
13572,2022-12-19,FANG,brawlBall,Center Stage,2,2,4
13573,2022-12-16,FANG,gemGrab,Undermine,0,2,2
13574,2022-12-16,FANG,brawlBall,Sneaky Fields,2,3,5
13575,2022-12-13,FANG,heist,Safe Zone,0,1,1
13576,2022-12-13,FANG,brawlBall,Beach Ball,2,5,7
13577,2022-11-11,FANG,knockout,New Perspective,0,4,4
13578,2022-10-28,FANG,hotZone,Dueling Beetles,2,0,2
13579,2022-10-26,FANG,brawlBall,Sunny Soccer,2,4,6
13580,2022-10-15,FANG,hotZone,Ring of Fire,1,0,1
13581,2022-10-15,FANG,gemGrab,Hard Rock Mine,1,0,1
13582,2022-10-15,FANG,bounty,Dry Season,0,2,2
13583,2022-10-10,FANG,knockout,Belle's Rock,2,0,2
13584,2023-02-11,EVE,knockout,Flaring Phoenix,26,26,52
13585,2023-02-11,EVE,hotZone,Controller Chaos,4,3,7
13586,2023-02-11,EVE,gemGrab,Deep Diner,30,28,58
13587,2023-02-11,EVE,brawlBall,Super Beach,8,18,26
13588,2023-02-11,EVE,brawlBall,Sneaky Fields,1,1,2
13589,2023-02-10,EVE,knockout,Flaring Phoenix,37,39,76
13590,2023-02-10,EVE,hotZone,Controller Chaos,9,13,22
13591,2023-02-10,EVE,heist,Hot Potato,9,5,14
13592,2023-02-10,EVE,gemGrab,Undermine,9,18,27
13593,2023-02-10,EVE,gemGrab,Deep Diner,51,60,111
13594,2023-02-10,EVE,brawlBall,Sneaky Fields,27,28,55
13595,2023-02-10,EVE,brawlBall,Pinhole Punt,1,0,1
13596,2023-02-10,EVE,bounty,Temple Ruins,18,13,31
13597,2023-02-09,EVE,knockout,Riverside,82,148,230
13598,2023-02-09,EVE,hotZone,Open Zone,3,2,5
13599,2023-02-09,EVE,heist,Hot Potato,5,8,13
13600,2023-02-09,EVE,gemGrab,Undermine,7,5,12
13601,2023-02-09,EVE,gemGrab,Gem Fort,2,0,2
13602,2023-02-09,EVE,brawlBall,Pinhole Punt,24,27,51
13603,2023-02-09,EVE,bounty,Temple Ruins,10,6,16
13604,2023-02-08,EVE,knockout,Riverside,108,146,254
13605,2023-02-08,EVE,hotZone,Open Zone,5,2,7
13606,2023-02-08,EVE,heist,Safe Zone,11,10,21
13607,2023-02-08,EVE,gemGrab,Gem Fort,5,4,9
13608,2023-02-08,EVE,gemGrab,Crystal Arcade,2,1,3
13609,2023-02-08,EVE,brawlBall,Sunny Soccer,5,13,18
13610,2023-02-08,EVE,brawlBall,Beach Ball,1,0,1
13611,2023-02-08,EVE,bounty,Excel,0,2,2
13612,2023-02-07,EVE,knockout,New Perspective,7,3,10
13613,2023-02-07,EVE,hotZone,Dueling Beetles,5,4,9
13614,2023-02-07,EVE,heist,Safe Zone,3,4,7
13615,2023-02-07,EVE,gemGrab,Minecart Madness,3,4,7
13616,2023-02-07,EVE,gemGrab,Crystal Arcade,2,3,5
13617,2023-02-07,EVE,brawlBall,Beach Ball,1,5,6
13618,2023-02-07,EVE,bounty,Excel,1,0,1
13619,2023-02-06,EVE,knockout,New Perspective,72,47,119
13620,2023-02-06,EVE,knockout,Goldarm Gulch,4,1,5
13621,2023-02-06,EVE,hotZone,Dueling Beetles,21,29,50
13622,2023-02-06,EVE,heist,Snaked Assault,14,2,16
13623,2023-02-06,EVE,gemGrab,Minecart Madness,59,44,103
13624,2023-02-06,EVE,gemGrab,Double Swoosh,26,11,37
13625,2023-02-06,EVE,brawlBall,Center Stage,82,69,151
13626,2023-02-06,EVE,brawlBall,Backyard Bowl,12,22,34
13627,2023-02-06,EVE,bounty,Layer Cake,16,30,46
13628,2023-02-05,EVE,knockout,X Marks the Spot,61,66,127
13629,2023-02-05,EVE,knockout,Goldarm Gulch,16,8,24
13630,2023-02-05,EVE,hotZone,Ring of Fire,40,38,78
13631,2023-02-05,EVE,heist,Snaked Assault,28,10,38
13632,2023-02-05,EVE,heist,Pit Stop,1,0,1
13633,2023-02-05,EVE,gemGrab,Hard Rock Mine,9,9,18
13634,2023-02-05,EVE,gemGrab,Double Swoosh,60,52,112
13635,2023-02-05,EVE,brawlBall,Super Beach,3,0,3
13636,2023-02-05,EVE,brawlBall,Sneaky Fields,1,6,7
13637,2023-02-05,EVE,brawlBall,Backyard Bowl,161,191,352
13638,2023-02-05,EVE,bounty,Layer Cake,23,15,38
13639,2023-02-04,EVE,knockout,X Marks the Spot,23,20,43
13640,2023-02-04,EVE,knockout,Goldarm Gulch,12,10,22
13641,2023-02-04,EVE,hotZone,Ring of Fire,10,16,26
13642,2023-02-04,EVE,heist,Tornado Ring,1,0,1
13643,2023-02-04,EVE,gemGrab,Hard Rock Mine,11,24,35
13644,2023-02-04,EVE,gemGrab,Double Swoosh,11,3,14
13645,2023-02-04,EVE,gemGrab,Deep Diner,4,8,12
13646,2023-02-04,EVE,brawlBall,Super Beach,9,15,24
13647,2023-02-04,EVE,bounty,Dry Season,12,7,19
13648,2023-02-03,EVE,knockout,Out in the Open,210,280,490
13649,2023-02-03,EVE,knockout,Goldarm Gulch,32,31,63
13650,2023-02-03,EVE,hotZone,Split,4,5,9
13651,2023-02-03,EVE,heist,Tornado Ring,15,2,17
13652,2023-02-03,EVE,heist,Pit Stop,7,2,9
13653,2023-02-03,EVE,gemGrab,Undermine,7,7,14
13654,2023-02-03,EVE,gemGrab,Double Swoosh,20,22,42
13655,2023-02-03,EVE,gemGrab,Deep Diner,59,61,120
13656,2023-02-03,EVE,brawlBall,Sneaky Fields,45,60,105
13657,2023-02-03,EVE,brawlBall,Pinhole Punt,1,1,2
13658,2023-02-03,EVE,bounty,Dry Season,33,36,69
13659,2023-02-02,EVE,knockout,Out in the Open,84,82,166
13660,2023-02-02,EVE,hotZone,Split,4,6,10
13661,2023-02-02,EVE,heist,Kaboom Canyon,25,22,47
13662,2023-02-02,EVE,gemGrab,Undermine,10,12,22
13663,2023-02-02,EVE,gemGrab,Gem Fort,3,2,5
13664,2023-02-02,EVE,brawlBall,Pinhole Punt,33,35,68
13665,2023-02-02,EVE,bounty,Shooting Star,17,7,24
13666,2023-02-01,EVE,knockout,Goldarm Gulch,68,55,123
13667,2023-02-01,EVE,hotZone,Parallel Plays,25,10,35
13668,2023-02-01,EVE,heist,Kaboom Canyon,71,88,159
13669,2023-02-01,EVE,gemGrab,Gem Fort,38,31,69
13670,2023-02-01,EVE,gemGrab,Crystal Arcade,32,26,58
13671,2023-02-01,EVE,brawlBall,Sunny Soccer,39,55,94
13672,2023-02-01,EVE,brawlBall,Beach Ball,1,1,2
13673,2023-02-01,EVE,bounty,Shooting Star,19,18,37
13674,2023-01-31,EVE,knockout,Goldarm Gulch,44,36,80
13675,2023-01-31,EVE,hotZone,Parallel Plays,17,30,47
13676,2023-01-31,EVE,heist,Pit Stop,1,0,1
13677,2023-01-31,EVE,gemGrab,Minecart Madness,8,6,14
13678,2023-01-31,EVE,gemGrab,Crystal Arcade,30,28,58
13679,2023-01-31,EVE,brawlBall,Center Stage,0,1,1
13680,2023-01-31,EVE,brawlBall,Beach Ball,22,31,53
13681,2023-01-31,EVE,bounty,Hideout,9,4,13
13682,2023-01-30,EVE,knockout,Belle's Rock,85,81,166
13683,2023-01-30,EVE,hotZone,Quarter Pounder,28,10,38
13684,2023-01-30,EVE,heist,Pit Stop,3,1,4
13685,2023-01-30,EVE,gemGrab,Minecart Madness,21,32,53
13686,2023-01-30,EVE,gemGrab,Double Swoosh,15,17,32
13687,2023-01-30,EVE,brawlBall,Center Stage,36,50,86
13688,2023-01-30,EVE,brawlBall,Backyard Bowl,10,16,26
13689,2023-01-30,EVE,bounty,Hideout,11,17,28
13690,2023-01-29,EVE,knockout,Belle's Rock,53,49,102
13691,2023-01-29,EVE,hotZone,Quarter Pounder,16,9,25
13692,2023-01-29,EVE,heist,Bridge Too Far,174,178,352
13693,2023-01-29,EVE,gemGrab,Hard Rock Mine,10,2,12
13694,2023-01-29,EVE,gemGrab,Double Swoosh,38,46,84
13695,2023-01-29,EVE,brawlBall,Super Beach,1,0,1
13696,2023-01-29,EVE,brawlBall,Backyard Bowl,139,153,292
13697,2023-01-29,EVE,bounty,Canal Grande,175,237,412
13698,2023-01-28,EVE,knockout,Flaring Phoenix,27,23,50
13699,2023-01-28,EVE,hotZone,Controller Chaos,12,7,19
13700,2023-01-28,EVE,heist,Bridge Too Far,429,529,958
13701,2023-01-28,EVE,gemGrab,Hard Rock Mine,25,32,57
13702,2023-01-28,EVE,gemGrab,Deep Diner,14,24,38
13703,2023-01-28,EVE,brawlBall,Super Beach,55,66,121
13704,2023-01-28,EVE,brawlBall,Sneaky Fields,1,0,1
13705,2023-01-28,EVE,bounty,Canal Grande,298,374,672
13706,2023-01-27,EVE,knockout,Flaring Phoenix,17,9,26
13707,2023-01-27,EVE,hotZone,Controller Chaos,5,5,10
13708,2023-01-27,EVE,heist,Hot Potato,1,0,1
13709,2023-01-27,EVE,gemGrab,Undermine,1,3,4
13710,2023-01-27,EVE,gemGrab,Deep Diner,17,11,28
13711,2023-01-27,EVE,brawlBall,Sneaky Fields,20,19,39
13712,2023-01-27,EVE,brawlBall,Pinhole Punt,1,1,2
13713,2023-01-27,EVE,bounty,Temple Ruins,8,2,10
13714,2023-01-26,EVE,knockout,Riverside,745,1126,1871
13715,2023-01-26,EVE,hotZone,Open Zone,29,14,43
13716,2023-01-26,EVE,heist,Hot Potato,7,4,11
13717,2023-01-26,EVE,gemGrab,Undermine,41,56,97
13718,2023-01-26,EVE,gemGrab,Gem Fort,16,10,26
13719,2023-01-26,EVE,brawlBall,Sunny Soccer,3,2,5
13720,2023-01-26,EVE,brawlBall,Pinhole Punt,128,103,231
13721,2023-01-26,EVE,bounty,Temple Ruins,7,19,26
13722,2023-01-25,EVE,knockout,Riverside,522,694,1216
13723,2023-01-25,EVE,hotZone,Open Zone,10,3,13
13724,2023-01-25,EVE,heist,Safe Zone,111,102,213
13725,2023-01-25,EVE,gemGrab,Gem Fort,18,17,35
13726,2023-01-25,EVE,gemGrab,Crystal Arcade,34,25,59
13727,2023-01-25,EVE,brawlBall,Sunny Soccer,34,67,101
13728,2023-01-25,EVE,brawlBall,Beach Ball,13,14,27
13729,2023-01-25,EVE,bounty,Excel,7,6,13
13730,2023-01-24,EVE,knockout,New Perspective,51,56,107
13731,2023-01-24,EVE,hotZone,Dueling Beetles,18,15,33
13732,2023-01-24,EVE,heist,Safe Zone,147,208,355
13733,2023-01-24,EVE,gemGrab,Minecart Madness,14,14,28
13734,2023-01-24,EVE,gemGrab,Crystal Arcade,30,34,64
13735,2023-01-24,EVE,brawlBall,Center Stage,18,16,34
13736,2023-01-24,EVE,brawlBall,Beach Ball,60,72,132
13737,2023-01-24,EVE,bounty,Excel,17,9,26
13738,2023-01-23,EVE,knockout,New Perspective,58,47,105
13739,2023-01-23,EVE,hotZone,Dueling Beetles,16,10,26
13740,2023-01-23,EVE,heist,Snaked Assault,18,10,28
13741,2023-01-23,EVE,gemGrab,Minecart Madness,43,36,79
13742,2023-01-23,EVE,gemGrab,Double Swoosh,21,12,33
13743,2023-01-23,EVE,brawlBall,Center Stage,79,73,152
13744,2023-01-23,EVE,brawlBall,Backyard Bowl,8,4,12
13745,2023-01-23,EVE,bounty,Layer Cake,23,30,53
13746,2023-01-22,EVE,knockout,X Marks the Spot,40,33,73
13747,2023-01-22,EVE,hotZone,Ring of Fire,16,11,27
13748,2023-01-22,EVE,heist,Snaked Assault,6,6,12
13749,2023-01-22,EVE,gemGrab,Hard Rock Mine,20,15,35
13750,2023-01-22,EVE,gemGrab,Double Swoosh,22,13,35
13751,2023-01-22,EVE,brawlBall,Super Beach,5,9,14
13752,2023-01-22,EVE,brawlBall,Backyard Bowl,69,100,169
13753,2023-01-22,EVE,bounty,Layer Cake,10,13,23
13754,2023-01-21,EVE,knockout,X Marks the Spot,128,168,296
13755,2023-01-21,EVE,hotZone,Ring of Fire,42,34,76
13756,2023-01-21,EVE,heist,Tornado Ring,6,6,12
13757,2023-01-21,EVE,gemGrab,Hard Rock Mine,60,60,120
13758,2023-01-21,EVE,gemGrab,Deep Diner,19,11,30
13759,2023-01-21,EVE,brawlBall,Super Beach,65,77,142
13760,2023-01-21,EVE,brawlBall,Sneaky Fields,1,1,2
13761,2023-01-21,EVE,bounty,Dry Season,63,41,104
13762,2023-01-20,EVE,knockout,Out in the Open,282,357,639
13763,2023-01-20,EVE,hotZone,Split,7,4,11
13764,2023-01-20,EVE,heist,Tornado Ring,11,4,15
13765,2023-01-20,EVE,gemGrab,Undermine,13,19,32
13766,2023-01-20,EVE,gemGrab,Deep Diner,64,57,121
13767,2023-01-20,EVE,brawlBall,Sneaky Fields,39,33,72
13768,2023-01-20,EVE,brawlBall,Pinhole Punt,0,6,6
13769,2023-01-20,EVE,bounty,Dry Season,26,37,63
13770,2023-01-19,EVE,knockout,Out in the Open,287,316,603
13771,2023-01-19,EVE,hotZone,Split,7,8,15
13772,2023-01-19,EVE,heist,Kaboom Canyon,58,74,132
13773,2023-01-19,EVE,gemGrab,Undermine,49,34,83
13774,2023-01-19,EVE,gemGrab,Gem Fort,10,7,17
13775,2023-01-19,EVE,brawlBall,Sunny Soccer,1,2,3
13776,2023-01-19,EVE,brawlBall,Pinhole Punt,108,103,211
13777,2023-01-19,EVE,bounty,Shooting Star,57,45,102
13778,2023-01-18,EVE,knockout,Goldarm Gulch,15,14,29
13779,2023-01-18,EVE,hotZone,Parallel Plays,3,3,6
13780,2023-01-18,EVE,heist,Kaboom Canyon,27,17,44
13781,2023-01-18,EVE,gemGrab,Gem Fort,14,7,21
13782,2023-01-18,EVE,gemGrab,Crystal Arcade,5,4,9
13783,2023-01-18,EVE,brawlBall,Sunny Soccer,26,27,53
13784,2023-01-18,EVE,brawlBall,Beach Ball,2,1,3
13785,2023-01-18,EVE,bounty,Shooting Star,18,22,40
13786,2023-01-17,EVE,knockout,Goldarm Gulch,13,8,21
13787,2023-01-17,EVE,hotZone,Parallel Plays,5,4,9
13788,2023-01-17,EVE,gemGrab,Minecart Madness,1,0,1
13789,2023-01-17,EVE,gemGrab,Crystal Arcade,6,5,11
13790,2023-01-17,EVE,brawlBall,Beach Ball,8,5,13
13791,2023-01-17,EVE,bounty,Hideout,3,2,5
13792,2023-01-16,EVE,knockout,Belle's Rock,4,2,6
13793,2023-01-16,EVE,hotZone,Quarter Pounder,3,0,3
13794,2023-01-16,EVE,gemGrab,Minecart Madness,4,11,15
13795,2023-01-16,EVE,gemGrab,Double Swoosh,1,0,1
13796,2023-01-16,EVE,brawlBall,Center Stage,3,1,4
13797,2023-01-16,EVE,brawlBall,Backyard Bowl,2,0,2
13798,2023-01-16,EVE,bounty,Hideout,2,2,4
13799,2023-01-15,EVE,knockout,Belle's Rock,5,2,7
13800,2023-01-15,EVE,hotZone,Quarter Pounder,6,1,7
13801,2023-01-15,EVE,heist,Bridge Too Far,39,44,83
13802,2023-01-15,EVE,gemGrab,Hard Rock Mine,0,2,2
13803,2023-01-15,EVE,gemGrab,Double Swoosh,2,3,5
13804,2023-01-15,EVE,brawlBall,Backyard Bowl,14,9,23
13805,2023-01-15,EVE,bounty,Canal Grande,31,28,59
13806,2023-01-14,EVE,knockout,Flaring Phoenix,7,14,21
13807,2023-01-14,EVE,hotZone,Controller Chaos,5,0,5
13808,2023-01-14,EVE,heist,Bridge Too Far,94,129,223
13809,2023-01-14,EVE,gemGrab,Deep Diner,1,0,1
13810,2023-01-14,EVE,brawlBall,Super Beach,8,17,25
13811,2023-01-14,EVE,bounty,Canal Grande,38,58,96
13812,2023-01-13,EVE,knockout,Flaring Phoenix,4,0,4
13813,2023-01-13,EVE,hotZone,Controller Chaos,5,1,6
13814,2023-01-13,EVE,gemGrab,Deep Diner,3,6,9
13815,2023-01-13,EVE,brawlBall,Sneaky Fields,4,0,4
13816,2023-01-13,EVE,bounty,Temple Ruins,0,1,1
13817,2023-01-12,EVE,knockout,Riverside,136,244,380
13818,2023-01-12,EVE,hotZone,Open Zone,3,0,3
13819,2023-01-12,EVE,gemGrab,Undermine,1,0,1
13820,2023-01-12,EVE,brawlBall,Sunny Soccer,0,1,1
13821,2023-01-12,EVE,brawlBall,Pinhole Punt,4,21,25
13822,2023-01-11,EVE,knockout,Riverside,50,72,122
13823,2023-01-11,EVE,hotZone,Open Zone,1,0,1
13824,2023-01-11,EVE,heist,Safe Zone,1,1,2
13825,2023-01-11,EVE,gemGrab,Gem Fort,2,1,3
13826,2023-01-11,EVE,brawlBall,Sunny Soccer,2,0,2
13827,2023-01-10,EVE,knockout,New Perspective,1,2,3
13828,2023-01-10,EVE,hotZone,Dueling Beetles,1,4,5
13829,2023-01-10,EVE,heist,Safe Zone,20,5,25
13830,2023-01-10,EVE,gemGrab,Minecart Madness,1,0,1
13831,2023-01-10,EVE,gemGrab,Crystal Arcade,3,1,4
13832,2023-01-10,EVE,brawlBall,Beach Ball,6,8,14
13833,2023-01-09,EVE,knockout,New Perspective,1,0,1
13834,2023-01-09,EVE,hotZone,Dueling Beetles,2,0,2
13835,2023-01-09,EVE,heist,Snaked Assault,4,2,6
13836,2023-01-09,EVE,gemGrab,Minecart Madness,3,5,8
13837,2023-01-09,EVE,gemGrab,Double Swoosh,1,0,1
13838,2023-01-09,EVE,brawlBall,Center Stage,9,8,17
13839,2023-01-09,EVE,bounty,Layer Cake,1,1,2
13840,2023-01-08,EVE,knockout,X Marks the Spot,4,2,6
13841,2023-01-08,EVE,hotZone,Ring of Fire,3,5,8
13842,2023-01-08,EVE,heist,Snaked Assault,1,0,1
13843,2023-01-08,EVE,brawlBall,Backyard Bowl,5,1,6
13844,2023-01-08,EVE,bounty,Layer Cake,2,0,2
13845,2023-01-07,EVE,knockout,X Marks the Spot,7,5,12
13846,2023-01-07,EVE,hotZone,Ring of Fire,1,0,1
13847,2023-01-07,EVE,brawlBall,Super Beach,2,0,2
13848,2023-01-07,EVE,brawlBall,Sneaky Fields,1,6,7
13849,2023-01-07,EVE,bounty,Dry Season,3,1,4
13850,2023-01-06,EVE,knockout,Out in the Open,19,15,34
13851,2023-01-06,EVE,hotZone,Split,2,0,2
13852,2023-01-06,EVE,heist,Tornado Ring,5,0,5
13853,2023-01-06,EVE,gemGrab,Undermine,3,0,3
13854,2023-01-06,EVE,gemGrab,Deep Diner,3,0,3
13855,2023-01-06,EVE,brawlBall,Sneaky Fields,3,10,13
13856,2023-01-06,EVE,bounty,Dry Season,3,7,10
13857,2023-01-05,EVE,knockout,Out in the Open,39,30,69
13858,2023-01-05,EVE,hotZone,Split,2,1,3
13859,2023-01-05,EVE,heist,Kaboom Canyon,6,5,11
13860,2023-01-05,EVE,gemGrab,Undermine,2,1,3
13861,2023-01-05,EVE,brawlBall,Pinhole Punt,9,18,27
13862,2023-01-05,EVE,bounty,Shooting Star,0,3,3
13863,2023-01-04,EVE,knockout,Goldarm Gulch,3,1,4
13864,2023-01-04,EVE,hotZone,Parallel Plays,1,0,1
13865,2023-01-04,EVE,heist,Kaboom Canyon,13,17,30
13866,2023-01-04,EVE,gemGrab,Gem Fort,1,6,7
13867,2023-01-04,EVE,gemGrab,Crystal Arcade,3,12,15
13868,2023-01-04,EVE,brawlBall,Sunny Soccer,2,0,2
13869,2023-01-04,EVE,bounty,Shooting Star,8,13,21
13870,2023-01-03,EVE,knockout,Goldarm Gulch,4,6,10
13871,2023-01-03,EVE,hotZone,Parallel Plays,1,0,1
13872,2023-01-03,EVE,heist,Pit Stop,1,0,1
13873,2023-01-03,EVE,heist,Kaboom Canyon,0,1,1
13874,2023-01-03,EVE,gemGrab,Crystal Arcade,7,0,7
13875,2023-01-03,EVE,brawlBall,Center Stage,1,4,5
13876,2023-01-03,EVE,brawlBall,Beach Ball,7,2,9
13877,2023-01-03,EVE,bounty,Hideout,1,1,2
13878,2023-01-02,EVE,knockout,Belle's Rock,10,14,24
13879,2023-01-02,EVE,hotZone,Quarter Pounder,3,2,5
13880,2023-01-02,EVE,gemGrab,Minecart Madness,11,0,11
13881,2023-01-02,EVE,brawlBall,Center Stage,7,2,9
13882,2023-01-02,EVE,brawlBall,Backyard Bowl,0,1,1
13883,2023-01-02,EVE,bounty,Hideout,3,1,4
13884,2023-01-01,EVE,knockout,Belle's Rock,1,0,1
13885,2023-01-01,EVE,hotZone,Quarter Pounder,4,0,4
13886,2023-01-01,EVE,heist,Bridge Too Far,9,11,20
13887,2023-01-01,EVE,gemGrab,Double Swoosh,3,0,3
13888,2023-01-01,EVE,brawlBall,Backyard Bowl,8,51,59
13889,2023-01-01,EVE,bounty,Canal Grande,2,5,7
13890,2022-12-31,EVE,heist,Bridge Too Far,4,6,10
13891,2022-12-31,EVE,gemGrab,Hard Rock Mine,2,0,2
13892,2022-12-31,EVE,bounty,Canal Grande,1,0,1
13893,2022-12-30,EVE,gemGrab,Deep Diner,1,0,1
13894,2022-12-28,EVE,hotZone,Controller Chaos,2,0,2
13895,2022-12-27,EVE,knockout,New Perspective,1,0,1
13896,2022-12-23,EVE,knockout,Out in the Open,0,4,4
13897,2022-12-13,EVE,knockout,New Perspective,1,0,1
13898,2022-12-13,EVE,heist,Safe Zone,1,0,1
13899,2022-12-13,EVE,gemGrab,Crystal Arcade,1,7,8
13900,2022-12-12,EVE,brawlBall,Center Stage,2,2,4
13901,2022-11-11,EVE,brawlBall,Sneaky Fields,2,0,2
13902,2022-10-30,EVE,knockout,Out in the Open,1,0,1
13903,2022-10-28,EVE,knockout,Out in the Open,0,2,2
13904,2022-10-28,EVE,heist,Safe Zone,0,2,2
13905,2022-10-15,EVE,hotZone,Ring of Fire,2,2,4
13906,2023-02-11,EMZ,knockout,Flaring Phoenix,19,7,26
13907,2023-02-11,EMZ,hotZone,Controller Chaos,180,184,364
13908,2023-02-11,EMZ,gemGrab,Deep Diner,39,16,55
13909,2023-02-11,EMZ,brawlBall,Super Beach,102,93,195
13910,2023-02-11,EMZ,brawlBall,Sneaky Fields,80,66,146
13911,2023-02-10,EMZ,knockout,Flaring Phoenix,35,20,55
13912,2023-02-10,EMZ,hotZone,Controller Chaos,259,194,453
13913,2023-02-10,EMZ,heist,Hot Potato,182,228,410
13914,2023-02-10,EMZ,gemGrab,Undermine,28,40,68
13915,2023-02-10,EMZ,gemGrab,Deep Diner,89,70,159
13916,2023-02-10,EMZ,brawlBall,Sneaky Fields,765,919,1684
13917,2023-02-10,EMZ,brawlBall,Pinhole Punt,1,8,9
13918,2023-02-10,EMZ,bounty,Temple Ruins,30,30,60
13919,2023-02-09,EMZ,knockout,Riverside,2,0,2
13920,2023-02-09,EMZ,hotZone,Open Zone,5,6,11
13921,2023-02-09,EMZ,heist,Hot Potato,128,145,273
13922,2023-02-09,EMZ,gemGrab,Undermine,51,68,119
13923,2023-02-09,EMZ,gemGrab,Gem Fort,8,7,15
13924,2023-02-09,EMZ,brawlBall,Sunny Soccer,1,1,2
13925,2023-02-09,EMZ,brawlBall,Pinhole Punt,138,153,291
13926,2023-02-09,EMZ,bounty,Temple Ruins,15,20,35
13927,2023-02-08,EMZ,knockout,Riverside,3,0,3
13928,2023-02-08,EMZ,hotZone,Open Zone,10,9,19
13929,2023-02-08,EMZ,heist,Safe Zone,1,0,1
13930,2023-02-08,EMZ,gemGrab,Gem Fort,22,12,34
13931,2023-02-08,EMZ,gemGrab,Crystal Arcade,5,6,11
13932,2023-02-08,EMZ,brawlBall,Sunny Soccer,32,51,83
13933,2023-02-08,EMZ,brawlBall,Beach Ball,2,9,11
13934,2023-02-08,EMZ,bounty,Excel,1,0,1
13935,2023-02-07,EMZ,knockout,New Perspective,3,2,5
13936,2023-02-07,EMZ,hotZone,Dueling Beetles,35,11,46
13937,2023-02-07,EMZ,heist,Safe Zone,0,1,1
13938,2023-02-07,EMZ,gemGrab,Minecart Madness,4,0,4
13939,2023-02-07,EMZ,gemGrab,Crystal Arcade,8,3,11
13940,2023-02-07,EMZ,brawlBall,Center Stage,6,4,10
13941,2023-02-07,EMZ,brawlBall,Beach Ball,29,32,61
13942,2023-02-07,EMZ,bounty,Excel,1,1,2
13943,2023-02-06,EMZ,knockout,New Perspective,56,26,82
13944,2023-02-06,EMZ,hotZone,Dueling Beetles,313,201,514
13945,2023-02-06,EMZ,heist,Snaked Assault,467,674,1141
13946,2023-02-06,EMZ,heist,Pit Stop,22,21,43
13947,2023-02-06,EMZ,gemGrab,Minecart Madness,110,70,180
13948,2023-02-06,EMZ,gemGrab,Double Swoosh,295,242,537
13949,2023-02-06,EMZ,brawlBall,Sneaky Fields,67,81,148
13950,2023-02-06,EMZ,brawlBall,Center Stage,718,842,1560
13951,2023-02-06,EMZ,brawlBall,Backyard Bowl,20,10,30
13952,2023-02-06,EMZ,bounty,Layer Cake,21,12,33
13953,2023-02-05,EMZ,knockout,X Marks the Spot,27,8,35
13954,2023-02-05,EMZ,knockout,Goldarm Gulch,3,0,3
13955,2023-02-05,EMZ,hotZone,Ring of Fire,106,74,180
13956,2023-02-05,EMZ,heist,Snaked Assault,759,731,1490
13957,2023-02-05,EMZ,heist,Pit Stop,104,118,222
13958,2023-02-05,EMZ,gemGrab,Hard Rock Mine,37,16,53
13959,2023-02-05,EMZ,gemGrab,Double Swoosh,836,756,1592
13960,2023-02-05,EMZ,brawlBall,Super Beach,13,11,24
13961,2023-02-05,EMZ,brawlBall,Sneaky Fields,274,305,579
13962,2023-02-05,EMZ,brawlBall,Backyard Bowl,263,207,470
13963,2023-02-05,EMZ,bounty,Layer Cake,15,14,29
13964,2023-02-04,EMZ,knockout,X Marks the Spot,7,3,10
13965,2023-02-04,EMZ,hotZone,Ring of Fire,29,15,44
13966,2023-02-04,EMZ,heist,Tornado Ring,78,80,158
13967,2023-02-04,EMZ,heist,Pit Stop,76,59,135
13968,2023-02-04,EMZ,gemGrab,Hard Rock Mine,35,16,51
13969,2023-02-04,EMZ,gemGrab,Double Swoosh,174,129,303
13970,2023-02-04,EMZ,gemGrab,Deep Diner,9,2,11
13971,2023-02-04,EMZ,brawlBall,Super Beach,141,109,250
13972,2023-02-04,EMZ,brawlBall,Sneaky Fields,125,124,249
13973,2023-02-04,EMZ,bounty,Dry Season,3,2,5
13974,2023-02-03,EMZ,knockout,Out in the Open,51,17,68
13975,2023-02-03,EMZ,knockout,Goldarm Gulch,5,2,7
13976,2023-02-03,EMZ,hotZone,Split,51,13,64
13977,2023-02-03,EMZ,heist,Tornado Ring,1075,1402,2477
13978,2023-02-03,EMZ,heist,Pit Stop,403,405,808
13979,2023-02-03,EMZ,gemGrab,Undermine,52,51,103
13980,2023-02-03,EMZ,gemGrab,Double Swoosh,789,596,1385
13981,2023-02-03,EMZ,gemGrab,Deep Diner,106,79,185
13982,2023-02-03,EMZ,brawlBall,Sneaky Fields,1466,1588,3054
13983,2023-02-03,EMZ,brawlBall,Pinhole Punt,14,10,24
13984,2023-02-03,EMZ,bounty,Dry Season,24,5,29
13985,2023-02-02,EMZ,knockout,Out in the Open,13,13,26
13986,2023-02-02,EMZ,hotZone,Split,25,14,39
13987,2023-02-02,EMZ,heist,Kaboom Canyon,6,5,11
13988,2023-02-02,EMZ,gemGrab,Undermine,55,71,126
13989,2023-02-02,EMZ,gemGrab,Gem Fort,22,9,31
13990,2023-02-02,EMZ,brawlBall,Sunny Soccer,8,9,17
13991,2023-02-02,EMZ,brawlBall,Pinhole Punt,130,154,284
13992,2023-02-02,EMZ,bounty,Shooting Star,2,1,3
13993,2023-02-01,EMZ,knockout,Goldarm Gulch,30,16,46
13994,2023-02-01,EMZ,hotZone,Parallel Plays,168,146,314
13995,2023-02-01,EMZ,heist,Kaboom Canyon,30,9,39
13996,2023-02-01,EMZ,gemGrab,Gem Fort,182,117,299
13997,2023-02-01,EMZ,gemGrab,Crystal Arcade,75,44,119
13998,2023-02-01,EMZ,brawlBall,Sunny Soccer,367,429,796
13999,2023-02-01,EMZ,brawlBall,Beach Ball,9,7,16
14000,2023-02-01,EMZ,bounty,Shooting Star,4,1,5
14001,2023-01-31,EMZ,knockout,Goldarm Gulch,19,8,27
14002,2023-01-31,EMZ,hotZone,Parallel Plays,79,71,150
14003,2023-01-31,EMZ,heist,Pit Stop,31,36,67
14004,2023-01-31,EMZ,gemGrab,Minecart Madness,5,6,11
14005,2023-01-31,EMZ,gemGrab,Crystal Arcade,85,51,136
14006,2023-01-31,EMZ,brawlBall,Center Stage,6,7,13
14007,2023-01-31,EMZ,brawlBall,Beach Ball,205,189,394
14008,2023-01-31,EMZ,bounty,Hideout,7,2,9
14009,2023-01-30,EMZ,knockout,Belle's Rock,22,16,38
14010,2023-01-30,EMZ,hotZone,Quarter Pounder,215,70,285
14011,2023-01-30,EMZ,heist,Pit Stop,143,160,303
14012,2023-01-30,EMZ,gemGrab,Minecart Madness,76,44,120
14013,2023-01-30,EMZ,gemGrab,Double Swoosh,222,240,462
14014,2023-01-30,EMZ,brawlBall,Center Stage,425,548,973
14015,2023-01-30,EMZ,brawlBall,Backyard Bowl,22,9,31
14016,2023-01-30,EMZ,bounty,Hideout,1,3,4
14017,2023-01-29,EMZ,knockout,Belle's Rock,20,1,21
14018,2023-01-29,EMZ,hotZone,Quarter Pounder,149,69,218
14019,2023-01-29,EMZ,heist,Bridge Too Far,22,6,28
14020,2023-01-29,EMZ,gemGrab,Hard Rock Mine,14,19,33
14021,2023-01-29,EMZ,gemGrab,Double Swoosh,390,383,773
14022,2023-01-29,EMZ,brawlBall,Super Beach,4,5,9
14023,2023-01-29,EMZ,brawlBall,Backyard Bowl,212,130,342
14024,2023-01-29,EMZ,bounty,Canal Grande,21,15,36
14025,2023-01-28,EMZ,knockout,Flaring Phoenix,28,15,43
14026,2023-01-28,EMZ,hotZone,Controller Chaos,249,279,528
14027,2023-01-28,EMZ,heist,Bridge Too Far,36,11,47
14028,2023-01-28,EMZ,gemGrab,Hard Rock Mine,106,69,175
14029,2023-01-28,EMZ,gemGrab,Deep Diner,23,29,52
14030,2023-01-28,EMZ,brawlBall,Super Beach,461,559,1020
14031,2023-01-28,EMZ,brawlBall,Sneaky Fields,43,55,98
14032,2023-01-28,EMZ,bounty,Canal Grande,36,23,59
14033,2023-01-27,EMZ,knockout,Flaring Phoenix,8,4,12
14034,2023-01-27,EMZ,hotZone,Controller Chaos,56,81,137
14035,2023-01-27,EMZ,heist,Hot Potato,40,45,85
14036,2023-01-27,EMZ,gemGrab,Undermine,12,8,20
14037,2023-01-27,EMZ,gemGrab,Deep Diner,36,26,62
14038,2023-01-27,EMZ,brawlBall,Sneaky Fields,204,273,477
14039,2023-01-27,EMZ,brawlBall,Pinhole Punt,6,6,12
14040,2023-01-27,EMZ,bounty,Temple Ruins,7,12,19
14041,2023-01-26,EMZ,knockout,Riverside,22,7,29
14042,2023-01-26,EMZ,hotZone,Open Zone,74,36,110
14043,2023-01-26,EMZ,heist,Hot Potato,471,559,1030
14044,2023-01-26,EMZ,gemGrab,Undermine,152,130,282
14045,2023-01-26,EMZ,gemGrab,Gem Fort,47,50,97
14046,2023-01-26,EMZ,brawlBall,Sunny Soccer,22,11,33
14047,2023-01-26,EMZ,brawlBall,Pinhole Punt,486,501,987
14048,2023-01-26,EMZ,bounty,Temple Ruins,25,21,46
14049,2023-01-25,EMZ,knockout,Riverside,16,2,18
14050,2023-01-25,EMZ,hotZone,Open Zone,33,23,56
14051,2023-01-25,EMZ,heist,Safe Zone,29,9,38
14052,2023-01-25,EMZ,gemGrab,Gem Fort,65,61,126
14053,2023-01-25,EMZ,gemGrab,Crystal Arcade,88,68,156
14054,2023-01-25,EMZ,brawlBall,Sunny Soccer,276,308,584
14055,2023-01-25,EMZ,brawlBall,Beach Ball,29,20,49
14056,2023-01-25,EMZ,bounty,Excel,4,2,6
14057,2023-01-24,EMZ,knockout,New Perspective,30,17,47
14058,2023-01-24,EMZ,hotZone,Dueling Beetles,134,87,221
14059,2023-01-24,EMZ,heist,Safe Zone,46,26,72
14060,2023-01-24,EMZ,gemGrab,Minecart Madness,22,5,27
14061,2023-01-24,EMZ,gemGrab,Crystal Arcade,121,105,226
14062,2023-01-24,EMZ,brawlBall,Center Stage,65,78,143
14063,2023-01-24,EMZ,brawlBall,Beach Ball,385,377,762
14064,2023-01-24,EMZ,bounty,Excel,9,5,14
14065,2023-01-23,EMZ,knockout,New Perspective,44,29,73
14066,2023-01-23,EMZ,hotZone,Dueling Beetles,216,87,303
14067,2023-01-23,EMZ,heist,Snaked Assault,563,786,1349
14068,2023-01-23,EMZ,gemGrab,Minecart Madness,106,51,157
14069,2023-01-23,EMZ,gemGrab,Double Swoosh,176,144,320
14070,2023-01-23,EMZ,brawlBall,Center Stage,601,693,1294
14071,2023-01-23,EMZ,brawlBall,Backyard Bowl,15,5,20
14072,2023-01-23,EMZ,bounty,Layer Cake,25,5,30
14073,2023-01-22,EMZ,knockout,X Marks the Spot,17,8,25
14074,2023-01-22,EMZ,hotZone,Ring of Fire,60,53,113
14075,2023-01-22,EMZ,heist,Snaked Assault,303,420,723
14076,2023-01-22,EMZ,gemGrab,Hard Rock Mine,24,15,39
14077,2023-01-22,EMZ,gemGrab,Double Swoosh,197,206,403
14078,2023-01-22,EMZ,brawlBall,Super Beach,43,48,91
14079,2023-01-22,EMZ,brawlBall,Backyard Bowl,94,57,151
14080,2023-01-22,EMZ,bounty,Layer Cake,6,4,10
14081,2023-01-21,EMZ,knockout,X Marks the Spot,55,22,77
14082,2023-01-21,EMZ,hotZone,Ring of Fire,161,109,270
14083,2023-01-21,EMZ,heist,Tornado Ring,526,762,1288
14084,2023-01-21,EMZ,gemGrab,Hard Rock Mine,140,65,205
14085,2023-01-21,EMZ,gemGrab,Deep Diner,46,22,68
14086,2023-01-21,EMZ,brawlBall,Super Beach,659,673,1332
14087,2023-01-21,EMZ,brawlBall,Sneaky Fields,23,33,56
14088,2023-01-21,EMZ,bounty,Dry Season,9,4,13
14089,2023-01-20,EMZ,knockout,Out in the Open,44,14,58
14090,2023-01-20,EMZ,hotZone,Split,49,34,83
14091,2023-01-20,EMZ,heist,Tornado Ring,682,912,1594
14092,2023-01-20,EMZ,gemGrab,Undermine,48,42,90
14093,2023-01-20,EMZ,gemGrab,Deep Diner,155,98,253
14094,2023-01-20,EMZ,brawlBall,Sneaky Fields,749,974,1723
14095,2023-01-20,EMZ,brawlBall,Pinhole Punt,23,36,59
14096,2023-01-20,EMZ,bounty,Dry Season,5,2,7
14097,2023-01-19,EMZ,knockout,Out in the Open,60,27,87
14098,2023-01-19,EMZ,hotZone,Split,76,44,120
14099,2023-01-19,EMZ,heist,Kaboom Canyon,23,20,43
14100,2023-01-19,EMZ,gemGrab,Undermine,251,266,517
14101,2023-01-19,EMZ,gemGrab,Gem Fort,41,26,67
14102,2023-01-19,EMZ,brawlBall,Sunny Soccer,10,9,19
14103,2023-01-19,EMZ,brawlBall,Pinhole Punt,472,494,966
14104,2023-01-19,EMZ,bounty,Shooting Star,8,4,12
14105,2023-01-18,EMZ,knockout,Goldarm Gulch,5,2,7
14106,2023-01-18,EMZ,hotZone,Parallel Plays,13,8,21
14107,2023-01-18,EMZ,heist,Kaboom Canyon,8,1,9
14108,2023-01-18,EMZ,gemGrab,Gem Fort,40,38,78
14109,2023-01-18,EMZ,gemGrab,Crystal Arcade,12,3,15
14110,2023-01-18,EMZ,brawlBall,Sunny Soccer,124,143,267
14111,2023-01-18,EMZ,brawlBall,Beach Ball,0,4,4
14112,2023-01-18,EMZ,bounty,Shooting Star,5,1,6
14113,2023-01-17,EMZ,knockout,Goldarm Gulch,3,3,6
14114,2023-01-17,EMZ,hotZone,Parallel Plays,13,13,26
14115,2023-01-17,EMZ,heist,Pit Stop,10,7,17
14116,2023-01-17,EMZ,gemGrab,Minecart Madness,1,0,1
14117,2023-01-17,EMZ,gemGrab,Crystal Arcade,13,15,28
14118,2023-01-17,EMZ,brawlBall,Center Stage,1,1,2
14119,2023-01-17,EMZ,brawlBall,Beach Ball,32,24,56
14120,2023-01-17,EMZ,bounty,Hideout,1,0,1
14121,2023-01-16,EMZ,knockout,Belle's Rock,2,0,2
14122,2023-01-16,EMZ,hotZone,Quarter Pounder,18,17,35
14123,2023-01-16,EMZ,heist,Pit Stop,47,67,114
14124,2023-01-16,EMZ,gemGrab,Minecart Madness,3,3,6
14125,2023-01-16,EMZ,gemGrab,Double Swoosh,12,14,26
14126,2023-01-16,EMZ,brawlBall,Center Stage,37,45,82
14127,2023-01-16,EMZ,brawlBall,Backyard Bowl,2,4,6
14128,2023-01-16,EMZ,bounty,Hideout,1,0,1
14129,2023-01-15,EMZ,knockout,Belle's Rock,1,1,2
14130,2023-01-15,EMZ,hotZone,Quarter Pounder,39,20,59
14131,2023-01-15,EMZ,heist,Bridge Too Far,4,0,4
14132,2023-01-15,EMZ,gemGrab,Hard Rock Mine,8,2,10
14133,2023-01-15,EMZ,gemGrab,Double Swoosh,45,38,83
14134,2023-01-15,EMZ,brawlBall,Super Beach,4,3,7
14135,2023-01-15,EMZ,brawlBall,Backyard Bowl,27,5,32
14136,2023-01-15,EMZ,bounty,Canal Grande,4,1,5
14137,2023-01-14,EMZ,knockout,Flaring Phoenix,2,1,3
14138,2023-01-14,EMZ,hotZone,Controller Chaos,76,65,141
14139,2023-01-14,EMZ,heist,Bridge Too Far,3,1,4
14140,2023-01-14,EMZ,gemGrab,Hard Rock Mine,7,1,8
14141,2023-01-14,EMZ,gemGrab,Deep Diner,5,1,6
14142,2023-01-14,EMZ,brawlBall,Super Beach,42,27,69
14143,2023-01-14,EMZ,brawlBall,Sneaky Fields,16,6,22
14144,2023-01-14,EMZ,bounty,Canal Grande,2,2,4
14145,2023-01-13,EMZ,hotZone,Controller Chaos,83,85,168
14146,2023-01-13,EMZ,heist,Hot Potato,17,12,29
14147,2023-01-13,EMZ,gemGrab,Undermine,1,0,1
14148,2023-01-13,EMZ,gemGrab,Deep Diner,9,5,14
14149,2023-01-13,EMZ,brawlBall,Sneaky Fields,63,39,102
14150,2023-01-13,EMZ,bounty,Temple Ruins,2,0,2
14151,2023-01-12,EMZ,knockout,Riverside,1,0,1
14152,2023-01-12,EMZ,hotZone,Open Zone,17,0,17
14153,2023-01-12,EMZ,heist,Hot Potato,17,30,47
14154,2023-01-12,EMZ,gemGrab,Undermine,10,7,17
14155,2023-01-12,EMZ,gemGrab,Gem Fort,2,1,3
14156,2023-01-12,EMZ,brawlBall,Sunny Soccer,6,7,13
14157,2023-01-12,EMZ,brawlBall,Pinhole Punt,22,11,33
14158,2023-01-11,EMZ,hotZone,Open Zone,2,0,2
14159,2023-01-11,EMZ,heist,Safe Zone,1,0,1
14160,2023-01-11,EMZ,gemGrab,Gem Fort,7,9,16
14161,2023-01-11,EMZ,brawlBall,Sunny Soccer,15,19,34
14162,2023-01-10,EMZ,knockout,New Perspective,1,0,1
14163,2023-01-10,EMZ,hotZone,Dueling Beetles,38,8,46
14164,2023-01-10,EMZ,heist,Safe Zone,2,0,2
14165,2023-01-10,EMZ,gemGrab,Minecart Madness,7,6,13
14166,2023-01-10,EMZ,gemGrab,Crystal Arcade,16,4,20
14167,2023-01-10,EMZ,brawlBall,Center Stage,15,53,68
14168,2023-01-10,EMZ,brawlBall,Beach Ball,27,17,44
14169,2023-01-09,EMZ,knockout,New Perspective,4,1,5
14170,2023-01-09,EMZ,hotZone,Dueling Beetles,21,8,29
14171,2023-01-09,EMZ,heist,Snaked Assault,58,75,133
14172,2023-01-09,EMZ,gemGrab,Minecart Madness,9,6,15
14173,2023-01-09,EMZ,gemGrab,Double Swoosh,21,9,30
14174,2023-01-09,EMZ,brawlBall,Center Stage,53,138,191
14175,2023-01-09,EMZ,bounty,Layer Cake,4,0,4
14176,2023-01-08,EMZ,knockout,X Marks the Spot,4,0,4
14177,2023-01-08,EMZ,hotZone,Ring of Fire,11,4,15
14178,2023-01-08,EMZ,heist,Snaked Assault,66,44,110
14179,2023-01-08,EMZ,gemGrab,Hard Rock Mine,5,1,6
14180,2023-01-08,EMZ,gemGrab,Double Swoosh,21,13,34
14181,2023-01-08,EMZ,brawlBall,Super Beach,3,2,5
14182,2023-01-08,EMZ,brawlBall,Backyard Bowl,7,6,13
14183,2023-01-07,EMZ,knockout,X Marks the Spot,1,0,1
14184,2023-01-07,EMZ,hotZone,Ring of Fire,9,1,10
14185,2023-01-07,EMZ,heist,Tornado Ring,70,85,155
14186,2023-01-07,EMZ,gemGrab,Hard Rock Mine,5,1,6
14187,2023-01-07,EMZ,gemGrab,Deep Diner,7,4,11
14188,2023-01-07,EMZ,brawlBall,Super Beach,22,11,33
14189,2023-01-07,EMZ,brawlBall,Sneaky Fields,4,14,18
14190,2023-01-06,EMZ,knockout,Out in the Open,4,4,8
14191,2023-01-06,EMZ,hotZone,Split,4,0,4
14192,2023-01-06,EMZ,heist,Tornado Ring,163,157,320
14193,2023-01-06,EMZ,gemGrab,Undermine,10,10,20
14194,2023-01-06,EMZ,gemGrab,Deep Diner,9,4,13
14195,2023-01-06,EMZ,brawlBall,Sneaky Fields,45,85,130
14196,2023-01-06,EMZ,brawlBall,Pinhole Punt,2,5,7
14197,2023-01-06,EMZ,bounty,Dry Season,1,0,1
14198,2023-01-05,EMZ,knockout,Out in the Open,5,0,5
14199,2023-01-05,EMZ,hotZone,Split,9,0,9
14200,2023-01-05,EMZ,heist,Kaboom Canyon,5,0,5
14201,2023-01-05,EMZ,gemGrab,Undermine,21,24,45
14202,2023-01-05,EMZ,gemGrab,Gem Fort,5,3,8
14203,2023-01-05,EMZ,brawlBall,Sunny Soccer,1,0,1
14204,2023-01-05,EMZ,brawlBall,Pinhole Punt,65,67,132
14205,2023-01-04,EMZ,knockout,Goldarm Gulch,3,0,3
14206,2023-01-04,EMZ,hotZone,Parallel Plays,12,3,15
14207,2023-01-04,EMZ,heist,Kaboom Canyon,14,0,14
14208,2023-01-04,EMZ,gemGrab,Gem Fort,19,16,35
14209,2023-01-04,EMZ,gemGrab,Crystal Arcade,9,5,14
14210,2023-01-04,EMZ,brawlBall,Sunny Soccer,46,96,142
14211,2023-01-04,EMZ,bounty,Shooting Star,1,0,1
14212,2023-01-03,EMZ,knockout,Goldarm Gulch,1,0,1
14213,2023-01-03,EMZ,hotZone,Parallel Plays,21,9,30
14214,2023-01-03,EMZ,heist,Pit Stop,12,21,33
14215,2023-01-03,EMZ,gemGrab,Minecart Madness,2,0,2
14216,2023-01-03,EMZ,gemGrab,Crystal Arcade,14,3,17
14217,2023-01-03,EMZ,brawlBall,Center Stage,4,10,14
14218,2023-01-03,EMZ,brawlBall,Beach Ball,41,45,86
14219,2023-01-03,EMZ,bounty,Hideout,2,2,4
14220,2023-01-02,EMZ,knockout,Belle's Rock,4,0,4
14221,2023-01-02,EMZ,hotZone,Quarter Pounder,42,4,46
14222,2023-01-02,EMZ,hotZone,Controller Chaos,5,1,6
14223,2023-01-02,EMZ,heist,Pit Stop,41,37,78
14224,2023-01-02,EMZ,heist,Kaboom Canyon,0,1,1
14225,2023-01-02,EMZ,gemGrab,Minecart Madness,6,2,8
14226,2023-01-02,EMZ,gemGrab,Double Swoosh,25,29,54
14227,2023-01-02,EMZ,brawlBall,Center Stage,70,69,139
14228,2023-01-02,EMZ,brawlBall,Backyard Bowl,2,3,5
14229,2023-01-02,EMZ,bounty,Hideout,3,0,3
14230,2023-01-01,EMZ,hotZone,Quarter Pounder,9,1,10
14231,2023-01-01,EMZ,heist,Kaboom Canyon,1,0,1
14232,2023-01-01,EMZ,heist,Bridge Too Far,1,0,1
14233,2023-01-01,EMZ,gemGrab,Minecart Madness,2,0,2
14234,2023-01-01,EMZ,gemGrab,Double Swoosh,18,19,37
14235,2023-01-01,EMZ,brawlBall,Backyard Bowl,4,5,9
14236,2023-01-01,EMZ,bounty,Canal Grande,1,0,1
14237,2022-12-31,EMZ,hotZone,Controller Chaos,7,3,10
14238,2022-12-31,EMZ,gemGrab,Hard Rock Mine,4,0,4
14239,2022-12-31,EMZ,gemGrab,Deep Diner,2,0,2
14240,2022-12-31,EMZ,brawlBall,Super Beach,4,5,9
14241,2022-12-30,EMZ,knockout,Flaring Phoenix,0,2,2
14242,2022-12-30,EMZ,hotZone,Controller Chaos,4,2,6
14243,2022-12-30,EMZ,heist,Kaboom Canyon,0,1,1
14244,2022-12-30,EMZ,gemGrab,Undermine,1,0,1
14245,2022-12-30,EMZ,gemGrab,Minecart Madness,0,2,2
14246,2022-12-30,EMZ,gemGrab,Deep Diner,1,0,1
14247,2022-12-30,EMZ,brawlBall,Sneaky Fields,10,12,22
14248,2022-12-29,EMZ,hotZone,Open Zone,1,0,1
14249,2022-12-29,EMZ,hotZone,Controller Chaos,0,1,1
14250,2022-12-29,EMZ,heist,Hot Potato,4,1,5
14251,2022-12-29,EMZ,gemGrab,Undermine,7,4,11
14252,2022-12-29,EMZ,gemGrab,Minecart Madness,0,1,1
14253,2022-12-29,EMZ,brawlBall,Pinhole Punt,1,0,1
14254,2022-12-28,EMZ,hotZone,Controller Chaos,2,2,4
14255,2022-12-27,EMZ,hotZone,Dueling Beetles,0,1,1
14256,2022-12-27,EMZ,hotZone,Controller Chaos,0,3,3
14257,2022-12-27,EMZ,heist,Kaboom Canyon,1,0,1
14258,2022-12-27,EMZ,brawlBall,Beach Ball,1,2,3
14259,2022-12-26,EMZ,hotZone,Controller Chaos,2,0,2
14260,2022-12-26,EMZ,gemGrab,Minecart Madness,2,2,4
14261,2022-12-26,EMZ,brawlBall,Center Stage,1,1,2
14262,2022-12-25,EMZ,hotZone,Ring of Fire,1,0,1
14263,2022-12-25,EMZ,gemGrab,Double Swoosh,1,1,2
14264,2022-12-22,EMZ,gemGrab,Gem Fort,1,0,1
14265,2022-12-22,EMZ,brawlBall,Pinhole Punt,4,2,6
14266,2022-12-20,EMZ,brawlBall,Beach Ball,0,1,1
14267,2022-12-19,EMZ,brawlBall,Center Stage,2,3,5
14268,2022-12-16,EMZ,brawlBall,Sneaky Fields,1,0,1
14269,2022-12-13,EMZ,hotZone,Dueling Beetles,1,0,1
14270,2022-12-13,EMZ,brawlBall,Beach Ball,1,0,1
14271,2022-12-11,EMZ,gemGrab,Double Swoosh,2,2,4
14272,2022-11-18,EMZ,hotZone,Parallel Plays,0,2,2
14273,2022-11-11,EMZ,brawlBall,Sneaky Fields,2,8,10
14274,2022-10-30,EMZ,hotZone,Dueling Beetles,1,0,1
14275,2022-10-30,EMZ,brawlBall,Beach Ball,1,0,1
14276,2022-10-30,EMZ,bounty,Canal Grande,0,1,1
14277,2022-10-28,EMZ,brawlBall,Beach Ball,2,4,6
14278,2022-10-15,EMZ,gemGrab,Hard Rock Mine,3,1,4
14279,2023-02-11,EL PRIMO,knockout,Flaring Phoenix,37,27,64
14280,2023-02-11,EL PRIMO,hotZone,Controller Chaos,60,24,84
14281,2023-02-11,EL PRIMO,gemGrab,Deep Diner,31,16,47
14282,2023-02-11,EL PRIMO,brawlBall,Super Beach,353,301,654
14283,2023-02-11,EL PRIMO,brawlBall,Sneaky Fields,318,300,618
14284,2023-02-10,EL PRIMO,knockout,Flaring Phoenix,49,32,81
14285,2023-02-10,EL PRIMO,hotZone,Controller Chaos,54,36,90
14286,2023-02-10,EL PRIMO,heist,Hot Potato,117,102,219
14287,2023-02-10,EL PRIMO,gemGrab,Undermine,15,10,25
14288,2023-02-10,EL PRIMO,gemGrab,Deep Diner,60,34,94
14289,2023-02-10,EL PRIMO,brawlBall,Sneaky Fields,2336,2089,4425
14290,2023-02-10,EL PRIMO,brawlBall,Pinhole Punt,19,7,26
14291,2023-02-10,EL PRIMO,bounty,Temple Ruins,10,6,16
14292,2023-02-09,EL PRIMO,knockout,Riverside,3,1,4
14293,2023-02-09,EL PRIMO,hotZone,Open Zone,1,1,2
14294,2023-02-09,EL PRIMO,heist,Hot Potato,33,39,72
14295,2023-02-09,EL PRIMO,gemGrab,Undermine,4,10,14
14296,2023-02-09,EL PRIMO,gemGrab,Gem Fort,4,1,5
14297,2023-02-09,EL PRIMO,brawlBall,Sunny Soccer,5,0,5
14298,2023-02-09,EL PRIMO,brawlBall,Pinhole Punt,255,223,478
14299,2023-02-09,EL PRIMO,bounty,Temple Ruins,5,3,8
14300,2023-02-08,EL PRIMO,hotZone,Open Zone,1,0,1
14301,2023-02-08,EL PRIMO,heist,Safe Zone,6,1,7
14302,2023-02-08,EL PRIMO,gemGrab,Gem Fort,7,3,10
14303,2023-02-08,EL PRIMO,gemGrab,Crystal Arcade,0,1,1
14304,2023-02-08,EL PRIMO,brawlBall,Sunny Soccer,95,122,217
14305,2023-02-08,EL PRIMO,brawlBall,Beach Ball,7,6,13
14306,2023-02-08,EL PRIMO,bounty,Excel,2,1,3
14307,2023-02-07,EL PRIMO,knockout,New Perspective,5,1,6
14308,2023-02-07,EL PRIMO,hotZone,Dueling Beetles,6,2,8
14309,2023-02-07,EL PRIMO,heist,Safe Zone,1,1,2
14310,2023-02-07,EL PRIMO,gemGrab,Minecart Madness,5,1,6
14311,2023-02-07,EL PRIMO,gemGrab,Crystal Arcade,4,1,5
14312,2023-02-07,EL PRIMO,brawlBall,Center Stage,12,23,35
14313,2023-02-07,EL PRIMO,brawlBall,Beach Ball,80,64,144
14314,2023-02-07,EL PRIMO,bounty,Excel,1,2,3
14315,2023-02-06,EL PRIMO,knockout,New Perspective,37,40,77
14316,2023-02-06,EL PRIMO,knockout,Goldarm Gulch,1,0,1
14317,2023-02-06,EL PRIMO,hotZone,Dueling Beetles,103,37,140
14318,2023-02-06,EL PRIMO,heist,Snaked Assault,157,127,284
14319,2023-02-06,EL PRIMO,heist,Pit Stop,81,93,174
14320,2023-02-06,EL PRIMO,gemGrab,Minecart Madness,59,50,109
14321,2023-02-06,EL PRIMO,gemGrab,Double Swoosh,37,21,58
14322,2023-02-06,EL PRIMO,brawlBall,Sneaky Fields,79,73,152
14323,2023-02-06,EL PRIMO,brawlBall,Center Stage,2032,1853,3885
14324,2023-02-06,EL PRIMO,brawlBall,Backyard Bowl,62,51,113
14325,2023-02-06,EL PRIMO,bounty,Layer Cake,21,6,27
14326,2023-02-05,EL PRIMO,knockout,X Marks the Spot,13,3,16
14327,2023-02-05,EL PRIMO,knockout,Goldarm Gulch,0,2,2
14328,2023-02-05,EL PRIMO,hotZone,Ring of Fire,24,11,35
14329,2023-02-05,EL PRIMO,heist,Snaked Assault,263,151,414
14330,2023-02-05,EL PRIMO,heist,Pit Stop,162,203,365
14331,2023-02-05,EL PRIMO,gemGrab,Hard Rock Mine,37,29,66
14332,2023-02-05,EL PRIMO,gemGrab,Double Swoosh,155,108,263
14333,2023-02-05,EL PRIMO,brawlBall,Super Beach,45,40,85
14334,2023-02-05,EL PRIMO,brawlBall,Sneaky Fields,181,190,371
14335,2023-02-05,EL PRIMO,brawlBall,Backyard Bowl,752,595,1347
14336,2023-02-05,EL PRIMO,bounty,Layer Cake,32,20,52
14337,2023-02-04,EL PRIMO,knockout,X Marks the Spot,5,3,8
14338,2023-02-04,EL PRIMO,knockout,Goldarm Gulch,3,2,5
14339,2023-02-04,EL PRIMO,hotZone,Ring of Fire,6,4,10
14340,2023-02-04,EL PRIMO,heist,Tornado Ring,19,15,34
14341,2023-02-04,EL PRIMO,heist,Pit Stop,95,133,228
14342,2023-02-04,EL PRIMO,gemGrab,Hard Rock Mine,17,9,26
14343,2023-02-04,EL PRIMO,gemGrab,Double Swoosh,34,4,38
14344,2023-02-04,EL PRIMO,gemGrab,Deep Diner,1,1,2
14345,2023-02-04,EL PRIMO,brawlBall,Super Beach,370,393,763
14346,2023-02-04,EL PRIMO,brawlBall,Sneaky Fields,98,76,174
14347,2023-02-04,EL PRIMO,bounty,Dry Season,2,1,3
14348,2023-02-03,EL PRIMO,knockout,Out in the Open,14,8,22
14349,2023-02-03,EL PRIMO,knockout,Goldarm Gulch,6,5,11
14350,2023-02-03,EL PRIMO,hotZone,Split,69,66,135
14351,2023-02-03,EL PRIMO,heist,Tornado Ring,212,121,333
14352,2023-02-03,EL PRIMO,heist,Pit Stop,450,560,1010
14353,2023-02-03,EL PRIMO,gemGrab,Undermine,13,5,18
14354,2023-02-03,EL PRIMO,gemGrab,Double Swoosh,137,42,179
14355,2023-02-03,EL PRIMO,gemGrab,Deep Diner,42,28,70
14356,2023-02-03,EL PRIMO,brawlBall,Sneaky Fields,2761,2430,5191
14357,2023-02-03,EL PRIMO,brawlBall,Pinhole Punt,48,47,95
14358,2023-02-03,EL PRIMO,bounty,Dry Season,12,3,15
14359,2023-02-02,EL PRIMO,knockout,Out in the Open,9,2,11
14360,2023-02-02,EL PRIMO,hotZone,Split,38,48,86
14361,2023-02-02,EL PRIMO,heist,Kaboom Canyon,17,3,20
14362,2023-02-02,EL PRIMO,gemGrab,Undermine,12,6,18
14363,2023-02-02,EL PRIMO,gemGrab,Gem Fort,5,4,9
14364,2023-02-02,EL PRIMO,brawlBall,Sunny Soccer,26,28,54
14365,2023-02-02,EL PRIMO,brawlBall,Pinhole Punt,271,234,505
14366,2023-02-01,EL PRIMO,knockout,Goldarm Gulch,36,19,55
14367,2023-02-01,EL PRIMO,hotZone,Parallel Plays,58,43,101
14368,2023-02-01,EL PRIMO,heist,Kaboom Canyon,32,27,59
14369,2023-02-01,EL PRIMO,gemGrab,Gem Fort,51,38,89
14370,2023-02-01,EL PRIMO,gemGrab,Crystal Arcade,25,16,41
14371,2023-02-01,EL PRIMO,brawlBall,Sunny Soccer,1151,999,2150
14372,2023-02-01,EL PRIMO,brawlBall,Beach Ball,36,31,67
14373,2023-02-01,EL PRIMO,bounty,Shooting Star,2,0,2
14374,2023-01-31,EL PRIMO,knockout,Goldarm Gulch,18,10,28
14375,2023-01-31,EL PRIMO,hotZone,Parallel Plays,14,14,28
14376,2023-01-31,EL PRIMO,heist,Pit Stop,87,103,190
14377,2023-01-31,EL PRIMO,gemGrab,Minecart Madness,3,0,3
14378,2023-01-31,EL PRIMO,gemGrab,Crystal Arcade,36,16,52
14379,2023-01-31,EL PRIMO,brawlBall,Center Stage,17,19,36
14380,2023-01-31,EL PRIMO,brawlBall,Beach Ball,454,366,820
14381,2023-01-30,EL PRIMO,knockout,Belle's Rock,42,18,60
14382,2023-01-30,EL PRIMO,hotZone,Quarter Pounder,63,15,78
14383,2023-01-30,EL PRIMO,heist,Pit Stop,306,330,636
14384,2023-01-30,EL PRIMO,gemGrab,Minecart Madness,33,16,49
14385,2023-01-30,EL PRIMO,gemGrab,Double Swoosh,58,46,104
14386,2023-01-30,EL PRIMO,brawlBall,Center Stage,1243,1221,2464
14387,2023-01-30,EL PRIMO,brawlBall,Backyard Bowl,58,53,111
14388,2023-01-30,EL PRIMO,bounty,Hideout,3,1,4
14389,2023-01-29,EL PRIMO,knockout,Belle's Rock,31,19,50
14390,2023-01-29,EL PRIMO,hotZone,Quarter Pounder,43,7,50
14391,2023-01-29,EL PRIMO,heist,Bridge Too Far,41,13,54
14392,2023-01-29,EL PRIMO,gemGrab,Hard Rock Mine,9,6,15
14393,2023-01-29,EL PRIMO,gemGrab,Double Swoosh,71,41,112
14394,2023-01-29,EL PRIMO,brawlBall,Super Beach,38,37,75
14395,2023-01-29,EL PRIMO,brawlBall,Backyard Bowl,555,411,966
14396,2023-01-29,EL PRIMO,bounty,Canal Grande,17,7,24
14397,2023-01-28,EL PRIMO,knockout,Flaring Phoenix,32,7,39
14398,2023-01-28,EL PRIMO,hotZone,Controller Chaos,75,30,105
14399,2023-01-28,EL PRIMO,heist,Bridge Too Far,85,32,117
14400,2023-01-28,EL PRIMO,gemGrab,Hard Rock Mine,79,82,161
14401,2023-01-28,EL PRIMO,gemGrab,Deep Diner,12,4,16
14402,2023-01-28,EL PRIMO,brawlBall,Super Beach,1288,1188,2476
14403,2023-01-28,EL PRIMO,brawlBall,Sneaky Fields,102,69,171
14404,2023-01-28,EL PRIMO,bounty,Canal Grande,22,12,34
14405,2023-01-27,EL PRIMO,knockout,Flaring Phoenix,16,7,23
14406,2023-01-27,EL PRIMO,hotZone,Controller Chaos,10,7,17
14407,2023-01-27,EL PRIMO,heist,Hot Potato,50,35,85
14408,2023-01-27,EL PRIMO,gemGrab,Undermine,1,2,3
14409,2023-01-27,EL PRIMO,gemGrab,Deep Diner,18,6,24
14410,2023-01-27,EL PRIMO,brawlBall,Sneaky Fields,636,546,1182
14411,2023-01-27,EL PRIMO,brawlBall,Pinhole Punt,13,14,27
14412,2023-01-27,EL PRIMO,bounty,Temple Ruins,4,0,4
14413,2023-01-26,EL PRIMO,knockout,Riverside,18,7,25
14414,2023-01-26,EL PRIMO,hotZone,Open Zone,19,5,24
14415,2023-01-26,EL PRIMO,heist,Hot Potato,177,148,325
14416,2023-01-26,EL PRIMO,gemGrab,Undermine,33,29,62
14417,2023-01-26,EL PRIMO,gemGrab,Gem Fort,31,16,47
14418,2023-01-26,EL PRIMO,brawlBall,Sunny Soccer,87,81,168
14419,2023-01-26,EL PRIMO,brawlBall,Pinhole Punt,901,697,1598
14420,2023-01-26,EL PRIMO,bounty,Temple Ruins,13,2,15
14421,2023-01-25,EL PRIMO,knockout,Riverside,17,4,21
14422,2023-01-25,EL PRIMO,hotZone,Open Zone,6,1,7
14423,2023-01-25,EL PRIMO,heist,Safe Zone,24,20,44
14424,2023-01-25,EL PRIMO,gemGrab,Gem Fort,41,36,77
14425,2023-01-25,EL PRIMO,gemGrab,Crystal Arcade,25,18,43
14426,2023-01-25,EL PRIMO,brawlBall,Sunny Soccer,757,625,1382
14427,2023-01-25,EL PRIMO,brawlBall,Beach Ball,120,102,222
14428,2023-01-25,EL PRIMO,bounty,Excel,10,10,20
14429,2023-01-24,EL PRIMO,knockout,New Perspective,18,9,27
14430,2023-01-24,EL PRIMO,hotZone,Dueling Beetles,39,8,47
14431,2023-01-24,EL PRIMO,heist,Safe Zone,67,46,113
14432,2023-01-24,EL PRIMO,gemGrab,Minecart Madness,19,22,41
14433,2023-01-24,EL PRIMO,gemGrab,Crystal Arcade,45,36,81
14434,2023-01-24,EL PRIMO,brawlBall,Center Stage,179,152,331
14435,2023-01-24,EL PRIMO,brawlBall,Beach Ball,1141,872,2013
14436,2023-01-24,EL PRIMO,bounty,Excel,6,6,12
14437,2023-01-23,EL PRIMO,knockout,New Perspective,42,21,63
14438,2023-01-23,EL PRIMO,hotZone,Dueling Beetles,59,19,78
14439,2023-01-23,EL PRIMO,heist,Snaked Assault,233,165,398
14440,2023-01-23,EL PRIMO,gemGrab,Minecart Madness,59,33,92
14441,2023-01-23,EL PRIMO,gemGrab,Double Swoosh,39,15,54
14442,2023-01-23,EL PRIMO,brawlBall,Center Stage,2072,1922,3994
14443,2023-01-23,EL PRIMO,brawlBall,Backyard Bowl,37,25,62
14444,2023-01-23,EL PRIMO,bounty,Layer Cake,13,17,30
14445,2023-01-22,EL PRIMO,knockout,X Marks the Spot,9,4,13
14446,2023-01-22,EL PRIMO,hotZone,Ring of Fire,26,23,49
14447,2023-01-22,EL PRIMO,heist,Snaked Assault,96,72,168
14448,2023-01-22,EL PRIMO,gemGrab,Hard Rock Mine,21,25,46
14449,2023-01-22,EL PRIMO,gemGrab,Double Swoosh,56,27,83
14450,2023-01-22,EL PRIMO,brawlBall,Super Beach,145,121,266
14451,2023-01-22,EL PRIMO,brawlBall,Backyard Bowl,262,198,460
14452,2023-01-22,EL PRIMO,bounty,Layer Cake,6,4,10
14453,2023-01-21,EL PRIMO,knockout,X Marks the Spot,40,19,59
14454,2023-01-21,EL PRIMO,hotZone,Ring of Fire,30,47,77
14455,2023-01-21,EL PRIMO,heist,Tornado Ring,213,166,379
14456,2023-01-21,EL PRIMO,gemGrab,Hard Rock Mine,100,75,175
14457,2023-01-21,EL PRIMO,gemGrab,Deep Diner,9,8,17
14458,2023-01-21,EL PRIMO,brawlBall,Super Beach,1608,1397,3005
14459,2023-01-21,EL PRIMO,brawlBall,Sneaky Fields,85,87,172
14460,2023-01-21,EL PRIMO,bounty,Dry Season,12,6,18
14461,2023-01-20,EL PRIMO,knockout,Out in the Open,33,13,46
14462,2023-01-20,EL PRIMO,hotZone,Split,74,59,133
14463,2023-01-20,EL PRIMO,heist,Tornado Ring,144,120,264
14464,2023-01-20,EL PRIMO,gemGrab,Undermine,14,5,19
14465,2023-01-20,EL PRIMO,gemGrab,Deep Diner,56,32,88
14466,2023-01-20,EL PRIMO,brawlBall,Sneaky Fields,1902,1700,3602
14467,2023-01-20,EL PRIMO,brawlBall,Pinhole Punt,38,26,64
14468,2023-01-20,EL PRIMO,bounty,Dry Season,7,4,11
14469,2023-01-19,EL PRIMO,knockout,Out in the Open,28,17,45
14470,2023-01-19,EL PRIMO,hotZone,Split,122,73,195
14471,2023-01-19,EL PRIMO,heist,Kaboom Canyon,47,20,67
14472,2023-01-19,EL PRIMO,gemGrab,Undermine,59,28,87
14473,2023-01-19,EL PRIMO,gemGrab,Gem Fort,15,13,28
14474,2023-01-19,EL PRIMO,brawlBall,Sunny Soccer,64,49,113
14475,2023-01-19,EL PRIMO,brawlBall,Pinhole Punt,900,717,1617
14476,2023-01-19,EL PRIMO,bounty,Shooting Star,3,2,5
14477,2023-01-18,EL PRIMO,knockout,Goldarm Gulch,5,5,10
14478,2023-01-18,EL PRIMO,hotZone,Parallel Plays,3,2,5
14479,2023-01-18,EL PRIMO,heist,Kaboom Canyon,6,3,9
14480,2023-01-18,EL PRIMO,gemGrab,Gem Fort,13,12,25
14481,2023-01-18,EL PRIMO,gemGrab,Crystal Arcade,2,2,4
14482,2023-01-18,EL PRIMO,brawlBall,Sunny Soccer,357,337,694
14483,2023-01-18,EL PRIMO,brawlBall,Beach Ball,12,6,18
14484,2023-01-18,EL PRIMO,bounty,Shooting Star,3,0,3
14485,2023-01-17,EL PRIMO,knockout,Goldarm Gulch,7,5,12
14486,2023-01-17,EL PRIMO,hotZone,Parallel Plays,9,3,12
14487,2023-01-17,EL PRIMO,heist,Pit Stop,23,31,54
14488,2023-01-17,EL PRIMO,gemGrab,Minecart Madness,2,0,2
14489,2023-01-17,EL PRIMO,gemGrab,Crystal Arcade,5,4,9
14490,2023-01-17,EL PRIMO,brawlBall,Center Stage,4,8,12
14491,2023-01-17,EL PRIMO,brawlBall,Beach Ball,85,74,159
14492,2023-01-16,EL PRIMO,knockout,Belle's Rock,4,1,5
14493,2023-01-16,EL PRIMO,hotZone,Quarter Pounder,4,0,4
14494,2023-01-16,EL PRIMO,heist,Pit Stop,97,83,180
14495,2023-01-16,EL PRIMO,gemGrab,Minecart Madness,4,0,4
14496,2023-01-16,EL PRIMO,gemGrab,Double Swoosh,1,0,1
14497,2023-01-16,EL PRIMO,brawlBall,Center Stage,118,99,217
14498,2023-01-16,EL PRIMO,brawlBall,Backyard Bowl,11,4,15
14499,2023-01-15,EL PRIMO,knockout,Belle's Rock,2,4,6
14500,2023-01-15,EL PRIMO,hotZone,Quarter Pounder,18,3,21
14501,2023-01-15,EL PRIMO,heist,Bridge Too Far,6,2,8
14502,2023-01-15,EL PRIMO,gemGrab,Hard Rock Mine,5,1,6
14503,2023-01-15,EL PRIMO,gemGrab,Double Swoosh,12,5,17
14504,2023-01-15,EL PRIMO,brawlBall,Super Beach,15,6,21
14505,2023-01-15,EL PRIMO,brawlBall,Backyard Bowl,77,40,117
14506,2023-01-15,EL PRIMO,bounty,Canal Grande,3,1,4
14507,2023-01-14,EL PRIMO,knockout,Flaring Phoenix,1,2,3
14508,2023-01-14,EL PRIMO,hotZone,Controller Chaos,12,1,13
14509,2023-01-14,EL PRIMO,heist,Bridge Too Far,4,0,4
14510,2023-01-14,EL PRIMO,gemGrab,Hard Rock Mine,4,1,5
14511,2023-01-14,EL PRIMO,gemGrab,Deep Diner,1,1,2
14512,2023-01-14,EL PRIMO,brawlBall,Super Beach,93,54,147
14513,2023-01-14,EL PRIMO,brawlBall,Sneaky Fields,19,22,41
14514,2023-01-14,EL PRIMO,bounty,Canal Grande,6,1,7
14515,2023-01-13,EL PRIMO,knockout,Flaring Phoenix,1,3,4
14516,2023-01-13,EL PRIMO,hotZone,Controller Chaos,14,5,19
14517,2023-01-13,EL PRIMO,heist,Hot Potato,6,1,7
14518,2023-01-13,EL PRIMO,gemGrab,Deep Diner,4,1,5
14519,2023-01-13,EL PRIMO,brawlBall,Sneaky Fields,146,165,311
14520,2023-01-13,EL PRIMO,brawlBall,Pinhole Punt,2,0,2
14521,2023-01-12,EL PRIMO,hotZone,Open Zone,1,0,1
14522,2023-01-12,EL PRIMO,heist,Hot Potato,4,2,6
14523,2023-01-12,EL PRIMO,gemGrab,Undermine,2,4,6
14524,2023-01-12,EL PRIMO,gemGrab,Gem Fort,1,0,1
14525,2023-01-12,EL PRIMO,brawlBall,Sunny Soccer,8,17,25
14526,2023-01-12,EL PRIMO,brawlBall,Pinhole Punt,31,17,48
14527,2023-01-11,EL PRIMO,brawlBall,Sunny Soccer,31,19,50
14528,2023-01-11,EL PRIMO,brawlBall,Beach Ball,0,2,2
14529,2023-01-10,EL PRIMO,knockout,New Perspective,1,1,2
14530,2023-01-10,EL PRIMO,hotZone,Dueling Beetles,8,0,8
14531,2023-01-10,EL PRIMO,heist,Safe Zone,8,1,9
14532,2023-01-10,EL PRIMO,gemGrab,Minecart Madness,4,0,4
14533,2023-01-10,EL PRIMO,gemGrab,Crystal Arcade,6,3,9
14534,2023-01-10,EL PRIMO,brawlBall,Center Stage,10,5,15
14535,2023-01-10,EL PRIMO,brawlBall,Beach Ball,60,30,90
14536,2023-01-09,EL PRIMO,knockout,New Perspective,1,1,2
14537,2023-01-09,EL PRIMO,hotZone,Dueling Beetles,6,0,6
14538,2023-01-09,EL PRIMO,heist,Snaked Assault,47,4,51
14539,2023-01-09,EL PRIMO,gemGrab,Minecart Madness,7,1,8
14540,2023-01-09,EL PRIMO,gemGrab,Double Swoosh,1,0,1
14541,2023-01-09,EL PRIMO,brawlBall,Center Stage,101,92,193
14542,2023-01-09,EL PRIMO,brawlBall,Backyard Bowl,4,0,4
14543,2023-01-09,EL PRIMO,bounty,Layer Cake,2,0,2
14544,2023-01-08,EL PRIMO,knockout,X Marks the Spot,4,0,4
14545,2023-01-08,EL PRIMO,hotZone,Ring of Fire,2,0,2
14546,2023-01-08,EL PRIMO,heist,Snaked Assault,18,24,42
14547,2023-01-08,EL PRIMO,gemGrab,Hard Rock Mine,5,0,5
14548,2023-01-08,EL PRIMO,gemGrab,Double Swoosh,1,1,2
14549,2023-01-08,EL PRIMO,brawlBall,Super Beach,6,2,8
14550,2023-01-08,EL PRIMO,brawlBall,Backyard Bowl,42,10,52
14551,2023-01-07,EL PRIMO,knockout,X Marks the Spot,1,0,1
14552,2023-01-07,EL PRIMO,hotZone,Ring of Fire,2,2,4
14553,2023-01-07,EL PRIMO,heist,Tornado Ring,24,2,26
14554,2023-01-07,EL PRIMO,gemGrab,Hard Rock Mine,4,10,14
14555,2023-01-07,EL PRIMO,gemGrab,Deep Diner,6,7,13
14556,2023-01-07,EL PRIMO,brawlBall,Super Beach,31,30,61
14557,2023-01-07,EL PRIMO,brawlBall,Sneaky Fields,7,0,7
14558,2023-01-06,EL PRIMO,hotZone,Split,12,1,13
14559,2023-01-06,EL PRIMO,heist,Tornado Ring,16,6,22
14560,2023-01-06,EL PRIMO,gemGrab,Undermine,2,0,2
14561,2023-01-06,EL PRIMO,gemGrab,Deep Diner,5,1,6
14562,2023-01-06,EL PRIMO,brawlBall,Sneaky Fields,93,59,152
14563,2023-01-06,EL PRIMO,brawlBall,Pinhole Punt,4,1,5
14564,2023-01-06,EL PRIMO,bounty,Dry Season,1,0,1
14565,2023-01-05,EL PRIMO,knockout,Out in the Open,1,0,1
14566,2023-01-05,EL PRIMO,hotZone,Split,21,6,27
14567,2023-01-05,EL PRIMO,heist,Kaboom Canyon,4,3,7
14568,2023-01-05,EL PRIMO,gemGrab,Undermine,5,1,6
14569,2023-01-05,EL PRIMO,gemGrab,Gem Fort,2,0,2
14570,2023-01-05,EL PRIMO,brawlBall,Sunny Soccer,2,0,2
14571,2023-01-05,EL PRIMO,brawlBall,Pinhole Punt,66,26,92
14572,2023-01-04,EL PRIMO,knockout,Goldarm Gulch,1,0,1
14573,2023-01-04,EL PRIMO,hotZone,Parallel Plays,3,0,3
14574,2023-01-04,EL PRIMO,heist,Kaboom Canyon,8,1,9
14575,2023-01-04,EL PRIMO,gemGrab,Gem Fort,7,5,12
14576,2023-01-04,EL PRIMO,brawlBall,Sunny Soccer,78,64,142
14577,2023-01-04,EL PRIMO,bounty,Shooting Star,1,0,1
14578,2023-01-03,EL PRIMO,knockout,Goldarm Gulch,0,1,1
14579,2023-01-03,EL PRIMO,hotZone,Parallel Plays,8,0,8
14580,2023-01-03,EL PRIMO,heist,Pit Stop,52,74,126
14581,2023-01-03,EL PRIMO,gemGrab,Minecart Madness,2,0,2
14582,2023-01-03,EL PRIMO,gemGrab,Crystal Arcade,3,0,3
14583,2023-01-03,EL PRIMO,brawlBall,Center Stage,2,2,4
14584,2023-01-03,EL PRIMO,brawlBall,Beach Ball,71,33,104
14585,2023-01-03,EL PRIMO,bounty,Hideout,1,0,1
14586,2023-01-02,EL PRIMO,knockout,Belle's Rock,2,0,2
14587,2023-01-02,EL PRIMO,hotZone,Quarter Pounder,9,1,10
14588,2023-01-02,EL PRIMO,hotZone,Controller Chaos,2,1,3
14589,2023-01-02,EL PRIMO,heist,Pit Stop,83,175,258
14590,2023-01-02,EL PRIMO,heist,Kaboom Canyon,1,0,1
14591,2023-01-02,EL PRIMO,gemGrab,Minecart Madness,0,3,3
14592,2023-01-02,EL PRIMO,gemGrab,Double Swoosh,5,1,6
14593,2023-01-02,EL PRIMO,brawlBall,Center Stage,118,82,200
14594,2023-01-02,EL PRIMO,brawlBall,Backyard Bowl,4,0,4
14595,2023-01-02,EL PRIMO,bounty,Hideout,2,0,2
14596,2023-01-01,EL PRIMO,hotZone,Quarter Pounder,2,0,2
14597,2023-01-01,EL PRIMO,heist,Bridge Too Far,1,0,1
14598,2023-01-01,EL PRIMO,gemGrab,Double Swoosh,5,0,5
14599,2023-01-01,EL PRIMO,brawlBall,Backyard Bowl,18,4,22
14600,2022-12-31,EL PRIMO,knockout,Flaring Phoenix,0,1,1
14601,2022-12-31,EL PRIMO,hotZone,Controller Chaos,3,2,5
14602,2022-12-31,EL PRIMO,heist,Bridge Too Far,1,0,1
14603,2022-12-31,EL PRIMO,gemGrab,Minecart Madness,1,1,2
14604,2022-12-31,EL PRIMO,gemGrab,Hard Rock Mine,2,1,3
14605,2022-12-31,EL PRIMO,gemGrab,Deep Diner,1,2,3
14606,2022-12-31,EL PRIMO,brawlBall,Super Beach,11,15,26
14607,2022-12-31,EL PRIMO,brawlBall,Sneaky Fields,2,3,5
14608,2022-12-30,EL PRIMO,knockout,Flaring Phoenix,0,1,1
14609,2022-12-30,EL PRIMO,hotZone,Controller Chaos,1,0,1
14610,2022-12-30,EL PRIMO,gemGrab,Deep Diner,2,1,3
14611,2022-12-30,EL PRIMO,brawlBall,Sneaky Fields,8,8,16
14612,2022-12-29,EL PRIMO,heist,Hot Potato,1,3,4
14613,2022-12-29,EL PRIMO,brawlBall,Pinhole Punt,1,1,2
14614,2022-12-28,EL PRIMO,brawlBall,Sunny Soccer,1,0,1
14615,2022-12-27,EL PRIMO,knockout,New Perspective,2,0,2
14616,2022-12-27,EL PRIMO,brawlBall,Center Stage,1,0,1
14617,2022-12-26,EL PRIMO,heist,Kaboom Canyon,3,0,3
14618,2022-12-26,EL PRIMO,brawlBall,Center Stage,1,0,1
14619,2022-12-23,EL PRIMO,brawlBall,Sneaky Fields,1,2,3
14620,2022-12-22,EL PRIMO,brawlBall,Pinhole Punt,2,0,2
14621,2022-12-21,EL PRIMO,brawlBall,Sunny Soccer,1,0,1
14622,2022-12-20,EL PRIMO,brawlBall,Beach Ball,2,1,3
14623,2022-12-19,EL PRIMO,brawlBall,Center Stage,0,1,1
14624,2022-12-16,EL PRIMO,brawlBall,Sneaky Fields,0,3,3
14625,2022-12-13,EL PRIMO,gemGrab,Crystal Arcade,1,0,1
14626,2022-12-13,EL PRIMO,brawlBall,Beach Ball,1,0,1
14627,2022-12-12,EL PRIMO,brawlBall,Center Stage,0,2,2
14628,2022-12-11,EL PRIMO,brawlBall,Backyard Bowl,0,2,2
14629,2022-11-11,EL PRIMO,brawlBall,Sneaky Fields,2,2,4
14630,2022-10-30,EL PRIMO,hotZone,Dueling Beetles,1,0,1
14631,2022-10-30,EL PRIMO,heist,Safe Zone,1,0,1
14632,2022-10-30,EL PRIMO,bounty,Canal Grande,1,0,1
14633,2022-10-26,EL PRIMO,brawlBall,Sunny Soccer,2,4,6
14634,2022-09-07,EL PRIMO,brawlBall,Pinhole Punt,0,2,2
14635,2023-02-11,EDGAR,knockout,Flaring Phoenix,71,54,125
14636,2023-02-11,EDGAR,hotZone,Controller Chaos,56,15,71
14637,2023-02-11,EDGAR,gemGrab,Deep Diner,15,16,31
14638,2023-02-11,EDGAR,brawlBall,Super Beach,78,51,129
14639,2023-02-11,EDGAR,brawlBall,Sneaky Fields,45,29,74
14640,2023-02-10,EDGAR,knockout,Flaring Phoenix,159,94,253
14641,2023-02-10,EDGAR,hotZone,Controller Chaos,47,15,62
14642,2023-02-10,EDGAR,heist,Hot Potato,89,51,140
14643,2023-02-10,EDGAR,gemGrab,Undermine,10,6,16
14644,2023-02-10,EDGAR,gemGrab,Deep Diner,69,26,95
14645,2023-02-10,EDGAR,brawlBall,Sneaky Fields,364,279,643
14646,2023-02-10,EDGAR,brawlBall,Pinhole Punt,2,4,6
14647,2023-02-10,EDGAR,bounty,Temple Ruins,22,17,39
14648,2023-02-09,EDGAR,knockout,Riverside,11,2,13
14649,2023-02-09,EDGAR,hotZone,Open Zone,1,0,1
14650,2023-02-09,EDGAR,heist,Hot Potato,24,20,44
14651,2023-02-09,EDGAR,gemGrab,Undermine,12,5,17
14652,2023-02-09,EDGAR,gemGrab,Gem Fort,1,1,2
14653,2023-02-09,EDGAR,brawlBall,Sunny Soccer,1,1,2
14654,2023-02-09,EDGAR,brawlBall,Pinhole Punt,55,47,102
14655,2023-02-09,EDGAR,bounty,Temple Ruins,23,11,34
14656,2023-02-08,EDGAR,knockout,Riverside,2,2,4
14657,2023-02-08,EDGAR,hotZone,Open Zone,4,2,6
14658,2023-02-08,EDGAR,heist,Safe Zone,5,5,10
14659,2023-02-08,EDGAR,gemGrab,Gem Fort,11,6,17
14660,2023-02-08,EDGAR,gemGrab,Crystal Arcade,2,1,3
14661,2023-02-08,EDGAR,brawlBall,Sunny Soccer,39,47,86
14662,2023-02-08,EDGAR,brawlBall,Beach Ball,2,1,3
14663,2023-02-08,EDGAR,bounty,Excel,9,4,13
14664,2023-02-07,EDGAR,knockout,New Perspective,10,5,15
14665,2023-02-07,EDGAR,hotZone,Dueling Beetles,4,1,5
14666,2023-02-07,EDGAR,heist,Safe Zone,1,2,3
14667,2023-02-07,EDGAR,gemGrab,Minecart Madness,1,0,1
14668,2023-02-07,EDGAR,gemGrab,Crystal Arcade,5,0,5
14669,2023-02-07,EDGAR,brawlBall,Center Stage,2,1,3
14670,2023-02-07,EDGAR,brawlBall,Beach Ball,33,31,64
14671,2023-02-07,EDGAR,bounty,Excel,2,1,3
14672,2023-02-06,EDGAR,knockout,New Perspective,161,70,231
14673,2023-02-06,EDGAR,knockout,Goldarm Gulch,2,0,2
14674,2023-02-06,EDGAR,hotZone,Dueling Beetles,61,16,77
14675,2023-02-06,EDGAR,heist,Snaked Assault,172,68,240
14676,2023-02-06,EDGAR,heist,Pit Stop,14,9,23
14677,2023-02-06,EDGAR,gemGrab,Minecart Madness,80,36,116
14678,2023-02-06,EDGAR,gemGrab,Double Swoosh,51,16,67
14679,2023-02-06,EDGAR,brawlBall,Sneaky Fields,6,5,11
14680,2023-02-06,EDGAR,brawlBall,Center Stage,478,368,846
14681,2023-02-06,EDGAR,brawlBall,Backyard Bowl,24,13,37
14682,2023-02-06,EDGAR,bounty,Layer Cake,54,28,82
14683,2023-02-05,EDGAR,knockout,X Marks the Spot,65,33,98
14684,2023-02-05,EDGAR,knockout,Goldarm Gulch,4,1,5
14685,2023-02-05,EDGAR,hotZone,Ring of Fire,22,6,28
14686,2023-02-05,EDGAR,heist,Snaked Assault,228,107,335
14687,2023-02-05,EDGAR,heist,Pit Stop,50,54,104
14688,2023-02-05,EDGAR,gemGrab,Hard Rock Mine,19,7,26
14689,2023-02-05,EDGAR,gemGrab,Double Swoosh,211,72,283
14690,2023-02-05,EDGAR,brawlBall,Super Beach,17,17,34
14691,2023-02-05,EDGAR,brawlBall,Sneaky Fields,35,5,40
14692,2023-02-05,EDGAR,brawlBall,Backyard Bowl,229,123,352
14693,2023-02-05,EDGAR,bounty,Layer Cake,61,36,97
14694,2023-02-04,EDGAR,knockout,X Marks the Spot,12,11,23
14695,2023-02-04,EDGAR,knockout,Goldarm Gulch,3,2,5
14696,2023-02-04,EDGAR,hotZone,Ring of Fire,6,2,8
14697,2023-02-04,EDGAR,heist,Tornado Ring,13,11,24
14698,2023-02-04,EDGAR,heist,Pit Stop,25,45,70
14699,2023-02-04,EDGAR,gemGrab,Hard Rock Mine,10,7,17
14700,2023-02-04,EDGAR,gemGrab,Double Swoosh,60,9,69
14701,2023-02-04,EDGAR,gemGrab,Deep Diner,3,0,3
14702,2023-02-04,EDGAR,brawlBall,Super Beach,107,78,185
14703,2023-02-04,EDGAR,brawlBall,Sneaky Fields,35,8,43
14704,2023-02-04,EDGAR,bounty,Dry Season,4,2,6
14705,2023-02-03,EDGAR,knockout,Out in the Open,81,39,120
14706,2023-02-03,EDGAR,knockout,Goldarm Gulch,11,5,16
14707,2023-02-03,EDGAR,hotZone,Split,117,71,188
14708,2023-02-03,EDGAR,heist,Tornado Ring,153,88,241
14709,2023-02-03,EDGAR,heist,Pit Stop,166,175,341
14710,2023-02-03,EDGAR,gemGrab,Undermine,17,4,21
14711,2023-02-03,EDGAR,gemGrab,Double Swoosh,319,24,343
14712,2023-02-03,EDGAR,gemGrab,Deep Diner,67,48,115
14713,2023-02-03,EDGAR,brawlBall,Sneaky Fields,637,424,1061
14714,2023-02-03,EDGAR,brawlBall,Pinhole Punt,10,6,16
14715,2023-02-03,EDGAR,bounty,Dry Season,17,7,24
14716,2023-02-02,EDGAR,knockout,Out in the Open,37,30,67
14717,2023-02-02,EDGAR,hotZone,Split,48,26,74
14718,2023-02-02,EDGAR,heist,Kaboom Canyon,14,9,23
14719,2023-02-02,EDGAR,gemGrab,Undermine,16,13,29
14720,2023-02-02,EDGAR,gemGrab,Gem Fort,3,4,7
14721,2023-02-02,EDGAR,brawlBall,Sunny Soccer,10,9,19
14722,2023-02-02,EDGAR,brawlBall,Pinhole Punt,108,48,156
14723,2023-02-02,EDGAR,bounty,Shooting Star,7,2,9
14724,2023-02-01,EDGAR,knockout,Goldarm Gulch,162,119,281
14725,2023-02-01,EDGAR,hotZone,Parallel Plays,85,23,108
14726,2023-02-01,EDGAR,heist,Kaboom Canyon,32,21,53
14727,2023-02-01,EDGAR,gemGrab,Gem Fort,52,50,102
14728,2023-02-01,EDGAR,gemGrab,Crystal Arcade,21,7,28
14729,2023-02-01,EDGAR,brawlBall,Sunny Soccer,305,255,560
14730,2023-02-01,EDGAR,brawlBall,Beach Ball,11,8,19
14731,2023-02-01,EDGAR,bounty,Shooting Star,5,2,7
14732,2023-01-31,EDGAR,knockout,Goldarm Gulch,77,52,129
14733,2023-01-31,EDGAR,hotZone,Parallel Plays,32,14,46
14734,2023-01-31,EDGAR,heist,Pit Stop,133,149,282
14735,2023-01-31,EDGAR,gemGrab,Minecart Madness,5,4,9
14736,2023-01-31,EDGAR,gemGrab,Crystal Arcade,29,21,50
14737,2023-01-31,EDGAR,brawlBall,Center Stage,5,4,9
14738,2023-01-31,EDGAR,brawlBall,Beach Ball,137,98,235
14739,2023-01-31,EDGAR,bounty,Hideout,11,1,12
14740,2023-01-30,EDGAR,knockout,Belle's Rock,273,169,442
14741,2023-01-30,EDGAR,hotZone,Quarter Pounder,66,12,78
14742,2023-01-30,EDGAR,heist,Pit Stop,409,535,944
14743,2023-01-30,EDGAR,gemGrab,Minecart Madness,46,25,71
14744,2023-01-30,EDGAR,gemGrab,Double Swoosh,24,14,38
14745,2023-01-30,EDGAR,brawlBall,Center Stage,285,187,472
14746,2023-01-30,EDGAR,brawlBall,Backyard Bowl,17,14,31
14747,2023-01-30,EDGAR,bounty,Hideout,14,4,18
14748,2023-01-29,EDGAR,knockout,Belle's Rock,233,146,379
14749,2023-01-29,EDGAR,hotZone,Quarter Pounder,34,10,44
14750,2023-01-29,EDGAR,heist,Bridge Too Far,27,18,45
14751,2023-01-29,EDGAR,gemGrab,Hard Rock Mine,8,6,14
14752,2023-01-29,EDGAR,gemGrab,Double Swoosh,61,46,107
14753,2023-01-29,EDGAR,brawlBall,Super Beach,8,4,12
14754,2023-01-29,EDGAR,brawlBall,Backyard Bowl,178,87,265
14755,2023-01-29,EDGAR,bounty,Canal Grande,26,13,39
14756,2023-01-28,EDGAR,knockout,Flaring Phoenix,119,70,189
14757,2023-01-28,EDGAR,hotZone,Controller Chaos,44,28,72
14758,2023-01-28,EDGAR,heist,Bridge Too Far,56,13,69
14759,2023-01-28,EDGAR,gemGrab,Hard Rock Mine,55,29,84
14760,2023-01-28,EDGAR,gemGrab,Deep Diner,23,26,49
14761,2023-01-28,EDGAR,brawlBall,Super Beach,370,264,634
14762,2023-01-28,EDGAR,brawlBall,Sneaky Fields,26,12,38
14763,2023-01-28,EDGAR,bounty,Canal Grande,59,52,111
14764,2023-01-27,EDGAR,knockout,Flaring Phoenix,46,22,68
14765,2023-01-27,EDGAR,hotZone,Controller Chaos,7,5,12
14766,2023-01-27,EDGAR,heist,Hot Potato,39,53,92
14767,2023-01-27,EDGAR,gemGrab,Undermine,4,3,7
14768,2023-01-27,EDGAR,gemGrab,Deep Diner,30,15,45
14769,2023-01-27,EDGAR,brawlBall,Sneaky Fields,132,111,243
14770,2023-01-27,EDGAR,brawlBall,Pinhole Punt,3,1,4
14771,2023-01-27,EDGAR,bounty,Temple Ruins,6,2,8
14772,2023-01-26,EDGAR,knockout,Riverside,65,20,85
14773,2023-01-26,EDGAR,hotZone,Open Zone,13,7,20
14774,2023-01-26,EDGAR,heist,Hot Potato,184,160,344
14775,2023-01-26,EDGAR,gemGrab,Undermine,37,23,60
14776,2023-01-26,EDGAR,gemGrab,Gem Fort,31,14,45
14777,2023-01-26,EDGAR,brawlBall,Sunny Soccer,31,38,69
14778,2023-01-26,EDGAR,brawlBall,Pinhole Punt,246,171,417
14779,2023-01-26,EDGAR,bounty,Temple Ruins,32,16,48
14780,2023-01-25,EDGAR,knockout,Riverside,31,20,51
14781,2023-01-25,EDGAR,hotZone,Open Zone,4,1,5
14782,2023-01-25,EDGAR,heist,Safe Zone,33,18,51
14783,2023-01-25,EDGAR,gemGrab,Gem Fort,27,15,42
14784,2023-01-25,EDGAR,gemGrab,Crystal Arcade,21,19,40
14785,2023-01-25,EDGAR,brawlBall,Sunny Soccer,193,150,343
14786,2023-01-25,EDGAR,brawlBall,Beach Ball,32,16,48
14787,2023-01-25,EDGAR,bounty,Excel,32,18,50
14788,2023-01-24,EDGAR,knockout,New Perspective,103,57,160
14789,2023-01-24,EDGAR,hotZone,Dueling Beetles,31,13,44
14790,2023-01-24,EDGAR,heist,Safe Zone,51,18,69
14791,2023-01-24,EDGAR,gemGrab,Minecart Madness,7,5,12
14792,2023-01-24,EDGAR,gemGrab,Crystal Arcade,59,48,107
14793,2023-01-24,EDGAR,brawlBall,Center Stage,46,39,85
14794,2023-01-24,EDGAR,brawlBall,Beach Ball,332,200,532
14795,2023-01-24,EDGAR,bounty,Excel,36,20,56
14796,2023-01-23,EDGAR,knockout,New Perspective,121,63,184
14797,2023-01-23,EDGAR,hotZone,Dueling Beetles,35,12,47
14798,2023-01-23,EDGAR,heist,Snaked Assault,173,108,281
14799,2023-01-23,EDGAR,gemGrab,Minecart Madness,73,32,105
14800,2023-01-23,EDGAR,gemGrab,Double Swoosh,30,12,42
14801,2023-01-23,EDGAR,brawlBall,Center Stage,443,362,805
14802,2023-01-23,EDGAR,brawlBall,Backyard Bowl,13,3,16
14803,2023-01-23,EDGAR,bounty,Layer Cake,58,24,82
14804,2023-01-22,EDGAR,knockout,X Marks the Spot,47,25,72
14805,2023-01-22,EDGAR,hotZone,Ring of Fire,11,4,15
14806,2023-01-22,EDGAR,heist,Snaked Assault,84,57,141
14807,2023-01-22,EDGAR,gemGrab,Hard Rock Mine,24,15,39
14808,2023-01-22,EDGAR,gemGrab,Double Swoosh,36,16,52
14809,2023-01-22,EDGAR,brawlBall,Super Beach,34,12,46
14810,2023-01-22,EDGAR,brawlBall,Backyard Bowl,93,46,139
14811,2023-01-22,EDGAR,bounty,Layer Cake,25,10,35
14812,2023-01-21,EDGAR,knockout,X Marks the Spot,153,65,218
14813,2023-01-21,EDGAR,hotZone,Ring of Fire,19,7,26
14814,2023-01-21,EDGAR,heist,Tornado Ring,133,89,222
14815,2023-01-21,EDGAR,gemGrab,Hard Rock Mine,91,47,138
14816,2023-01-21,EDGAR,gemGrab,Deep Diner,14,8,22
14817,2023-01-21,EDGAR,brawlBall,Super Beach,465,302,767
14818,2023-01-21,EDGAR,brawlBall,Sneaky Fields,29,19,48
14819,2023-01-21,EDGAR,bounty,Dry Season,23,13,36
14820,2023-01-20,EDGAR,knockout,Out in the Open,74,44,118
14821,2023-01-20,EDGAR,hotZone,Split,116,96,212
14822,2023-01-20,EDGAR,heist,Tornado Ring,135,102,237
14823,2023-01-20,EDGAR,gemGrab,Undermine,14,19,33
14824,2023-01-20,EDGAR,gemGrab,Deep Diner,68,50,118
14825,2023-01-20,EDGAR,brawlBall,Sneaky Fields,439,324,763
14826,2023-01-20,EDGAR,brawlBall,Pinhole Punt,23,6,29
14827,2023-01-20,EDGAR,bounty,Dry Season,19,10,29
14828,2023-01-19,EDGAR,knockout,Out in the Open,121,61,182
14829,2023-01-19,EDGAR,hotZone,Split,158,120,278
14830,2023-01-19,EDGAR,heist,Kaboom Canyon,57,32,89
14831,2023-01-19,EDGAR,gemGrab,Undermine,55,22,77
14832,2023-01-19,EDGAR,gemGrab,Gem Fort,13,10,23
14833,2023-01-19,EDGAR,brawlBall,Sunny Soccer,7,5,12
14834,2023-01-19,EDGAR,brawlBall,Pinhole Punt,259,143,402
14835,2023-01-19,EDGAR,bounty,Shooting Star,11,8,19
14836,2023-01-18,EDGAR,knockout,Goldarm Gulch,24,8,32
14837,2023-01-18,EDGAR,hotZone,Parallel Plays,11,3,14
14838,2023-01-18,EDGAR,heist,Kaboom Canyon,18,11,29
14839,2023-01-18,EDGAR,gemGrab,Gem Fort,18,13,31
14840,2023-01-18,EDGAR,gemGrab,Crystal Arcade,3,2,5
14841,2023-01-18,EDGAR,brawlBall,Sunny Soccer,102,76,178
14842,2023-01-18,EDGAR,brawlBall,Beach Ball,5,3,8
14843,2023-01-18,EDGAR,bounty,Shooting Star,5,1,6
14844,2023-01-17,EDGAR,knockout,Goldarm Gulch,29,15,44
14845,2023-01-17,EDGAR,hotZone,Parallel Plays,9,2,11
14846,2023-01-17,EDGAR,heist,Pit Stop,52,58,110
14847,2023-01-17,EDGAR,gemGrab,Minecart Madness,1,1,2
14848,2023-01-17,EDGAR,gemGrab,Crystal Arcade,1,1,2
14849,2023-01-17,EDGAR,brawlBall,Center Stage,4,0,4
14850,2023-01-17,EDGAR,brawlBall,Beach Ball,47,17,64
14851,2023-01-17,EDGAR,bounty,Hideout,1,1,2
14852,2023-01-16,EDGAR,knockout,Belle's Rock,14,6,20
14853,2023-01-16,EDGAR,hotZone,Quarter Pounder,5,1,6
14854,2023-01-16,EDGAR,heist,Pit Stop,121,132,253
14855,2023-01-16,EDGAR,gemGrab,Minecart Madness,10,1,11
14856,2023-01-16,EDGAR,gemGrab,Double Swoosh,1,0,1
14857,2023-01-16,EDGAR,brawlBall,Center Stage,26,24,50
14858,2023-01-16,EDGAR,brawlBall,Backyard Bowl,3,1,4
14859,2023-01-16,EDGAR,bounty,Hideout,2,0,2
14860,2023-01-15,EDGAR,knockout,Belle's Rock,29,22,51
14861,2023-01-15,EDGAR,hotZone,Quarter Pounder,16,2,18
14862,2023-01-15,EDGAR,heist,Bridge Too Far,4,1,5
14863,2023-01-15,EDGAR,gemGrab,Hard Rock Mine,1,0,1
14864,2023-01-15,EDGAR,gemGrab,Double Swoosh,2,2,4
14865,2023-01-15,EDGAR,brawlBall,Super Beach,1,0,1
14866,2023-01-15,EDGAR,brawlBall,Backyard Bowl,13,11,24
14867,2023-01-15,EDGAR,bounty,Canal Grande,1,1,2
14868,2023-01-14,EDGAR,knockout,Flaring Phoenix,10,9,19
14869,2023-01-14,EDGAR,hotZone,Controller Chaos,15,0,15
14870,2023-01-14,EDGAR,heist,Bridge Too Far,3,1,4
14871,2023-01-14,EDGAR,gemGrab,Hard Rock Mine,5,0,5
14872,2023-01-14,EDGAR,gemGrab,Deep Diner,2,0,2
14873,2023-01-14,EDGAR,brawlBall,Super Beach,26,26,52
14874,2023-01-14,EDGAR,brawlBall,Sneaky Fields,1,0,1
14875,2023-01-14,EDGAR,bounty,Canal Grande,3,0,3
14876,2023-01-13,EDGAR,knockout,Flaring Phoenix,9,9,18
14877,2023-01-13,EDGAR,hotZone,Controller Chaos,9,0,9
14878,2023-01-13,EDGAR,heist,Hot Potato,8,8,16
14879,2023-01-13,EDGAR,gemGrab,Deep Diner,3,1,4
14880,2023-01-13,EDGAR,brawlBall,Sneaky Fields,25,34,59
14881,2023-01-13,EDGAR,bounty,Temple Ruins,3,0,3
14882,2023-01-12,EDGAR,knockout,Riverside,8,0,8
14883,2023-01-12,EDGAR,hotZone,Open Zone,2,1,3
14884,2023-01-12,EDGAR,heist,Hot Potato,3,2,5
14885,2023-01-12,EDGAR,brawlBall,Pinhole Punt,6,2,8
14886,2023-01-11,EDGAR,hotZone,Open Zone,1,0,1
14887,2023-01-11,EDGAR,heist,Safe Zone,0,1,1
14888,2023-01-11,EDGAR,gemGrab,Gem Fort,2,0,2
14889,2023-01-11,EDGAR,brawlBall,Sunny Soccer,8,3,11
14890,2023-01-11,EDGAR,bounty,Excel,4,6,10
14891,2023-01-10,EDGAR,knockout,New Perspective,5,3,8
14892,2023-01-10,EDGAR,hotZone,Dueling Beetles,6,1,7
14893,2023-01-10,EDGAR,heist,Safe Zone,1,0,1
14894,2023-01-10,EDGAR,gemGrab,Minecart Madness,2,0,2
14895,2023-01-10,EDGAR,gemGrab,Crystal Arcade,4,0,4
14896,2023-01-10,EDGAR,brawlBall,Center Stage,1,0,1
14897,2023-01-10,EDGAR,brawlBall,Beach Ball,8,3,11
14898,2023-01-10,EDGAR,bounty,Excel,0,2,2
14899,2023-01-09,EDGAR,knockout,New Perspective,6,3,9
14900,2023-01-09,EDGAR,hotZone,Dueling Beetles,4,0,4
14901,2023-01-09,EDGAR,heist,Snaked Assault,33,4,37
14902,2023-01-09,EDGAR,gemGrab,Minecart Madness,6,1,7
14903,2023-01-09,EDGAR,gemGrab,Double Swoosh,3,0,3
14904,2023-01-09,EDGAR,brawlBall,Center Stage,30,36,66
14905,2023-01-09,EDGAR,brawlBall,Backyard Bowl,2,0,2
14906,2023-01-09,EDGAR,bounty,Layer Cake,7,1,8
14907,2023-01-08,EDGAR,knockout,X Marks the Spot,6,0,6
14908,2023-01-08,EDGAR,hotZone,Ring of Fire,2,0,2
14909,2023-01-08,EDGAR,heist,Snaked Assault,12,23,35
14910,2023-01-08,EDGAR,gemGrab,Hard Rock Mine,1,0,1
14911,2023-01-08,EDGAR,gemGrab,Double Swoosh,3,1,4
14912,2023-01-08,EDGAR,brawlBall,Super Beach,0,1,1
14913,2023-01-08,EDGAR,brawlBall,Backyard Bowl,6,2,8
14914,2023-01-08,EDGAR,bounty,Layer Cake,2,0,2
14915,2023-01-07,EDGAR,knockout,X Marks the Spot,0,1,1
14916,2023-01-07,EDGAR,hotZone,Ring of Fire,1,0,1
14917,2023-01-07,EDGAR,heist,Tornado Ring,14,4,18
14918,2023-01-07,EDGAR,gemGrab,Hard Rock Mine,6,2,8
14919,2023-01-07,EDGAR,gemGrab,Deep Diner,1,1,2
14920,2023-01-07,EDGAR,brawlBall,Super Beach,5,3,8
14921,2023-01-07,EDGAR,brawlBall,Sneaky Fields,2,0,2
14922,2023-01-06,EDGAR,knockout,Out in the Open,4,2,6
14923,2023-01-06,EDGAR,hotZone,Split,6,1,7
14924,2023-01-06,EDGAR,heist,Tornado Ring,15,13,28
14925,2023-01-06,EDGAR,gemGrab,Deep Diner,5,1,6
14926,2023-01-06,EDGAR,brawlBall,Sneaky Fields,23,14,37
14927,2023-01-06,EDGAR,brawlBall,Pinhole Punt,2,1,3
14928,2023-01-06,EDGAR,bounty,Dry Season,1,0,1
14929,2023-01-05,EDGAR,knockout,Out in the Open,5,1,6
14930,2023-01-05,EDGAR,hotZone,Split,15,16,31
14931,2023-01-05,EDGAR,heist,Kaboom Canyon,10,0,10
14932,2023-01-05,EDGAR,gemGrab,Undermine,3,1,4
14933,2023-01-05,EDGAR,gemGrab,Gem Fort,2,2,4
14934,2023-01-05,EDGAR,brawlBall,Pinhole Punt,14,5,19
14935,2023-01-05,EDGAR,bounty,Shooting Star,1,0,1
14936,2023-01-04,EDGAR,knockout,Goldarm Gulch,1,1,2
14937,2023-01-04,EDGAR,hotZone,Parallel Plays,3,2,5
14938,2023-01-04,EDGAR,heist,Kaboom Canyon,12,0,12
14939,2023-01-04,EDGAR,gemGrab,Gem Fort,9,20,29
14940,2023-01-04,EDGAR,gemGrab,Crystal Arcade,0,2,2
14941,2023-01-04,EDGAR,brawlBall,Sunny Soccer,10,2,12
14942,2023-01-04,EDGAR,bounty,Shooting Star,1,1,2
14943,2023-01-03,EDGAR,knockout,Goldarm Gulch,7,0,7
14944,2023-01-03,EDGAR,hotZone,Parallel Plays,3,1,4
14945,2023-01-03,EDGAR,heist,Pit Stop,45,35,80
14946,2023-01-03,EDGAR,heist,Kaboom Canyon,1,0,1
14947,2023-01-03,EDGAR,gemGrab,Minecart Madness,2,0,2
14948,2023-01-03,EDGAR,gemGrab,Crystal Arcade,4,0,4
14949,2023-01-03,EDGAR,brawlBall,Center Stage,1,0,1
14950,2023-01-03,EDGAR,brawlBall,Beach Ball,9,3,12
14951,2023-01-03,EDGAR,bounty,Hideout,2,0,2
14952,2023-01-02,EDGAR,knockout,Belle's Rock,14,4,18
14953,2023-01-02,EDGAR,hotZone,Quarter Pounder,12,0,12
14954,2023-01-02,EDGAR,heist,Pit Stop,95,141,236
14955,2023-01-02,EDGAR,gemGrab,Minecart Madness,4,2,6
14956,2023-01-02,EDGAR,brawlBall,Center Stage,22,16,38
14957,2023-01-02,EDGAR,bounty,Hideout,2,0,2
14958,2023-01-01,EDGAR,knockout,Belle's Rock,11,7,18
14959,2023-01-01,EDGAR,hotZone,Quarter Pounder,2,0,2
14960,2023-01-01,EDGAR,heist,Kaboom Canyon,1,0,1
14961,2023-01-01,EDGAR,gemGrab,Double Swoosh,3,2,5
14962,2023-01-01,EDGAR,brawlBall,Backyard Bowl,5,2,7
14963,2022-12-31,EDGAR,hotZone,Controller Chaos,0,2,2
14964,2022-12-31,EDGAR,heist,Kaboom Canyon,2,0,2
14965,2022-12-31,EDGAR,gemGrab,Hard Rock Mine,0,1,1
14966,2022-12-31,EDGAR,gemGrab,Deep Diner,1,0,1
14967,2022-12-31,EDGAR,brawlBall,Super Beach,1,0,1
14968,2022-12-30,EDGAR,hotZone,Controller Chaos,0,1,1
14969,2022-12-30,EDGAR,brawlBall,Sneaky Fields,2,0,2
14970,2022-12-29,EDGAR,heist,Kaboom Canyon,0,1,1
14971,2022-12-29,EDGAR,gemGrab,Minecart Madness,1,0,1
14972,2022-12-29,EDGAR,brawlBall,Pinhole Punt,1,0,1
14973,2022-12-28,EDGAR,hotZone,Controller Chaos,2,0,2
14974,2022-12-27,EDGAR,hotZone,Dueling Beetles,0,1,1
14975,2022-12-27,EDGAR,brawlBall,Beach Ball,2,2,4
14976,2022-12-26,EDGAR,hotZone,Controller Chaos,0,1,1
14977,2022-12-26,EDGAR,heist,Kaboom Canyon,2,1,3
14978,2022-12-26,EDGAR,gemGrab,Minecart Madness,0,1,1
14979,2022-12-25,EDGAR,hotZone,Ring of Fire,0,1,1
14980,2022-12-24,EDGAR,brawlBall,Super Beach,0,1,1
14981,2022-12-23,EDGAR,knockout,Out in the Open,2,2,4
14982,2022-12-19,EDGAR,brawlBall,Center Stage,1,0,1
14983,2022-12-13,EDGAR,heist,Safe Zone,1,1,2
14984,2022-12-12,EDGAR,brawlBall,Center Stage,0,2,2
14985,2022-12-10,EDGAR,gemGrab,Hard Rock Mine,0,1,1
14986,2022-11-11,EDGAR,brawlBall,Sneaky Fields,2,0,2
14987,2022-11-03,EDGAR,bounty,Temple Ruins,0,2,2
14988,2022-09-06,EDGAR,brawlBall,Beach Ball,0,2,2
14989,2023-02-11,DYNAMIKE,knockout,Flaring Phoenix,104,50,154
14990,2023-02-11,DYNAMIKE,hotZone,Controller Chaos,235,203,438
14991,2023-02-11,DYNAMIKE,gemGrab,Deep Diner,114,81,195
14992,2023-02-11,DYNAMIKE,brawlBall,Super Beach,408,412,820
14993,2023-02-11,DYNAMIKE,brawlBall,Sneaky Fields,97,49,146
14994,2023-02-10,DYNAMIKE,knockout,Flaring Phoenix,209,151,360
14995,2023-02-10,DYNAMIKE,hotZone,Controller Chaos,418,488,906
14996,2023-02-10,DYNAMIKE,heist,Hot Potato,335,381,716
14997,2023-02-10,DYNAMIKE,gemGrab,Undermine,25,15,40
14998,2023-02-10,DYNAMIKE,gemGrab,Deep Diner,286,308,594
14999,2023-02-10,DYNAMIKE,brawlBall,Sneaky Fields,776,533,1309
15000,2023-02-10,DYNAMIKE,brawlBall,Pinhole Punt,6,4,10
15001,2023-02-10,DYNAMIKE,bounty,Temple Ruins,20,8,28
15002,2023-02-09,DYNAMIKE,knockout,Riverside,7,0,7
15003,2023-02-09,DYNAMIKE,hotZone,Open Zone,2,3,5
15004,2023-02-09,DYNAMIKE,heist,Hot Potato,180,202,382
15005,2023-02-09,DYNAMIKE,gemGrab,Undermine,15,7,22
15006,2023-02-09,DYNAMIKE,gemGrab,Gem Fort,2,3,5
15007,2023-02-09,DYNAMIKE,brawlBall,Sunny Soccer,3,12,15
15008,2023-02-09,DYNAMIKE,brawlBall,Pinhole Punt,156,93,249
15009,2023-02-09,DYNAMIKE,bounty,Temple Ruins,12,5,17
15010,2023-02-08,DYNAMIKE,knockout,Riverside,3,3,6
15011,2023-02-08,DYNAMIKE,hotZone,Open Zone,3,1,4
15012,2023-02-08,DYNAMIKE,heist,Safe Zone,8,8,16
15013,2023-02-08,DYNAMIKE,gemGrab,Gem Fort,6,3,9
15014,2023-02-08,DYNAMIKE,gemGrab,Crystal Arcade,0,1,1
15015,2023-02-08,DYNAMIKE,brawlBall,Sunny Soccer,171,131,302
15016,2023-02-08,DYNAMIKE,brawlBall,Beach Ball,14,6,20
15017,2023-02-08,DYNAMIKE,bounty,Excel,20,8,28
15018,2023-02-07,DYNAMIKE,knockout,New Perspective,12,2,14
15019,2023-02-07,DYNAMIKE,hotZone,Dueling Beetles,19,5,24
15020,2023-02-07,DYNAMIKE,heist,Safe Zone,3,1,4
15021,2023-02-07,DYNAMIKE,gemGrab,Minecart Madness,8,3,11
15022,2023-02-07,DYNAMIKE,gemGrab,Crystal Arcade,3,5,8
15023,2023-02-07,DYNAMIKE,brawlBall,Center Stage,6,2,8
15024,2023-02-07,DYNAMIKE,brawlBall,Beach Ball,113,79,192
15025,2023-02-07,DYNAMIKE,bounty,Excel,4,2,6
15026,2023-02-06,DYNAMIKE,knockout,New Perspective,208,131,339
15027,2023-02-06,DYNAMIKE,knockout,Goldarm Gulch,1,0,1
15028,2023-02-06,DYNAMIKE,hotZone,Dueling Beetles,281,96,377
15029,2023-02-06,DYNAMIKE,heist,Snaked Assault,186,80,266
15030,2023-02-06,DYNAMIKE,heist,Pit Stop,82,81,163
15031,2023-02-06,DYNAMIKE,gemGrab,Minecart Madness,175,111,286
15032,2023-02-06,DYNAMIKE,gemGrab,Double Swoosh,68,27,95
15033,2023-02-06,DYNAMIKE,brawlBall,Sneaky Fields,16,6,22
15034,2023-02-06,DYNAMIKE,brawlBall,Center Stage,721,453,1174
15035,2023-02-06,DYNAMIKE,brawlBall,Backyard Bowl,52,21,73
15036,2023-02-06,DYNAMIKE,bounty,Layer Cake,127,62,189
15037,2023-02-05,DYNAMIKE,knockout,X Marks the Spot,86,43,129
15038,2023-02-05,DYNAMIKE,knockout,Goldarm Gulch,12,2,14
15039,2023-02-05,DYNAMIKE,hotZone,Ring of Fire,74,15,89
15040,2023-02-05,DYNAMIKE,heist,Snaked Assault,266,134,400
15041,2023-02-05,DYNAMIKE,heist,Pit Stop,202,247,449
15042,2023-02-05,DYNAMIKE,gemGrab,Hard Rock Mine,35,9,44
15043,2023-02-05,DYNAMIKE,gemGrab,Double Swoosh,214,82,296
15044,2023-02-05,DYNAMIKE,brawlBall,Super Beach,87,47,134
15045,2023-02-05,DYNAMIKE,brawlBall,Sneaky Fields,50,30,80
15046,2023-02-05,DYNAMIKE,brawlBall,Backyard Bowl,479,276,755
15047,2023-02-05,DYNAMIKE,bounty,Layer Cake,151,94,245
15048,2023-02-04,DYNAMIKE,knockout,X Marks the Spot,40,18,58
15049,2023-02-04,DYNAMIKE,knockout,Goldarm Gulch,7,8,15
15050,2023-02-04,DYNAMIKE,hotZone,Ring of Fire,11,4,15
15051,2023-02-04,DYNAMIKE,heist,Tornado Ring,41,20,61
15052,2023-02-04,DYNAMIKE,heist,Pit Stop,123,128,251
15053,2023-02-04,DYNAMIKE,gemGrab,Hard Rock Mine,26,19,45
15054,2023-02-04,DYNAMIKE,gemGrab,Double Swoosh,50,5,55
15055,2023-02-04,DYNAMIKE,gemGrab,Deep Diner,29,26,55
15056,2023-02-04,DYNAMIKE,brawlBall,Super Beach,617,569,1186
15057,2023-02-04,DYNAMIKE,brawlBall,Sneaky Fields,42,7,49
15058,2023-02-04,DYNAMIKE,bounty,Dry Season,11,2,13
15059,2023-02-03,DYNAMIKE,knockout,Out in the Open,70,29,99
15060,2023-02-03,DYNAMIKE,knockout,Goldarm Gulch,30,18,48
15061,2023-02-03,DYNAMIKE,hotZone,Split,558,483,1041
15062,2023-02-03,DYNAMIKE,heist,Tornado Ring,204,145,349
15063,2023-02-03,DYNAMIKE,heist,Pit Stop,842,853,1695
15064,2023-02-03,DYNAMIKE,gemGrab,Undermine,17,6,23
15065,2023-02-03,DYNAMIKE,gemGrab,Double Swoosh,288,57,345
15066,2023-02-03,DYNAMIKE,gemGrab,Deep Diner,300,374,674
15067,2023-02-03,DYNAMIKE,brawlBall,Sneaky Fields,994,618,1612
15068,2023-02-03,DYNAMIKE,brawlBall,Pinhole Punt,18,9,27
15069,2023-02-03,DYNAMIKE,bounty,Dry Season,65,32,97
15070,2023-02-02,DYNAMIKE,knockout,Out in the Open,34,35,69
15071,2023-02-02,DYNAMIKE,hotZone,Split,281,242,523
15072,2023-02-02,DYNAMIKE,heist,Kaboom Canyon,14,4,18
15073,2023-02-02,DYNAMIKE,gemGrab,Undermine,18,14,32
15074,2023-02-02,DYNAMIKE,gemGrab,Gem Fort,6,7,13
15075,2023-02-02,DYNAMIKE,brawlBall,Sunny Soccer,34,34,68
15076,2023-02-02,DYNAMIKE,brawlBall,Pinhole Punt,133,69,202
15077,2023-02-02,DYNAMIKE,bounty,Shooting Star,7,2,9
15078,2023-02-01,DYNAMIKE,knockout,Goldarm Gulch,132,81,213
15079,2023-02-01,DYNAMIKE,hotZone,Parallel Plays,272,157,429
15080,2023-02-01,DYNAMIKE,heist,Kaboom Canyon,58,26,84
15081,2023-02-01,DYNAMIKE,gemGrab,Gem Fort,55,33,88
15082,2023-02-01,DYNAMIKE,gemGrab,Crystal Arcade,47,25,72
15083,2023-02-01,DYNAMIKE,brawlBall,Sunny Soccer,1571,1327,2898
15084,2023-02-01,DYNAMIKE,brawlBall,Beach Ball,63,52,115
15085,2023-02-01,DYNAMIKE,bounty,Shooting Star,17,11,28
15086,2023-01-31,DYNAMIKE,knockout,Goldarm Gulch,77,42,119
15087,2023-01-31,DYNAMIKE,hotZone,Parallel Plays,91,51,142
15088,2023-01-31,DYNAMIKE,heist,Pit Stop,165,136,301
15089,2023-01-31,DYNAMIKE,gemGrab,Minecart Madness,8,7,15
15090,2023-01-31,DYNAMIKE,gemGrab,Crystal Arcade,37,18,55
15091,2023-01-31,DYNAMIKE,brawlBall,Center Stage,10,12,22
15092,2023-01-31,DYNAMIKE,brawlBall,Beach Ball,771,714,1485
15093,2023-01-31,DYNAMIKE,bounty,Hideout,13,6,19
15094,2023-01-30,DYNAMIKE,knockout,Belle's Rock,366,205,571
15095,2023-01-30,DYNAMIKE,hotZone,Quarter Pounder,381,422,803
15096,2023-01-30,DYNAMIKE,heist,Pit Stop,616,560,1176
15097,2023-01-30,DYNAMIKE,gemGrab,Minecart Madness,78,51,129
15098,2023-01-30,DYNAMIKE,gemGrab,Double Swoosh,51,32,83
15099,2023-01-30,DYNAMIKE,brawlBall,Center Stage,445,251,696
15100,2023-01-30,DYNAMIKE,brawlBall,Backyard Bowl,42,11,53
15101,2023-01-30,DYNAMIKE,bounty,Hideout,38,16,54
15102,2023-01-29,DYNAMIKE,knockout,Belle's Rock,323,175,498
15103,2023-01-29,DYNAMIKE,hotZone,Quarter Pounder,251,244,495
15104,2023-01-29,DYNAMIKE,heist,Bridge Too Far,35,14,49
15105,2023-01-29,DYNAMIKE,gemGrab,Hard Rock Mine,18,10,28
15106,2023-01-29,DYNAMIKE,gemGrab,Double Swoosh,92,57,149
15107,2023-01-29,DYNAMIKE,brawlBall,Super Beach,26,33,59
15108,2023-01-29,DYNAMIKE,brawlBall,Backyard Bowl,360,202,562
15109,2023-01-29,DYNAMIKE,bounty,Canal Grande,86,48,134
15110,2023-01-28,DYNAMIKE,knockout,Flaring Phoenix,121,81,202
15111,2023-01-28,DYNAMIKE,hotZone,Controller Chaos,295,241,536
15112,2023-01-28,DYNAMIKE,heist,Bridge Too Far,55,16,71
15113,2023-01-28,DYNAMIKE,gemGrab,Hard Rock Mine,78,47,125
15114,2023-01-28,DYNAMIKE,gemGrab,Deep Diner,82,81,163
15115,2023-01-28,DYNAMIKE,brawlBall,Super Beach,2077,1962,4039
15116,2023-01-28,DYNAMIKE,brawlBall,Sneaky Fields,31,21,52
15117,2023-01-28,DYNAMIKE,bounty,Canal Grande,112,51,163
15118,2023-01-27,DYNAMIKE,knockout,Flaring Phoenix,53,27,80
15119,2023-01-27,DYNAMIKE,hotZone,Controller Chaos,56,51,107
15120,2023-01-27,DYNAMIKE,heist,Hot Potato,131,98,229
15121,2023-01-27,DYNAMIKE,gemGrab,Undermine,8,6,14
15122,2023-01-27,DYNAMIKE,gemGrab,Deep Diner,112,97,209
15123,2023-01-27,DYNAMIKE,brawlBall,Sneaky Fields,248,161,409
15124,2023-01-27,DYNAMIKE,brawlBall,Pinhole Punt,5,2,7
15125,2023-01-27,DYNAMIKE,bounty,Temple Ruins,9,1,10
15126,2023-01-26,DYNAMIKE,knockout,Riverside,44,30,74
15127,2023-01-26,DYNAMIKE,hotZone,Open Zone,38,14,52
15128,2023-01-26,DYNAMIKE,heist,Hot Potato,654,746,1400
15129,2023-01-26,DYNAMIKE,gemGrab,Undermine,85,41,126
15130,2023-01-26,DYNAMIKE,gemGrab,Gem Fort,20,13,33
15131,2023-01-26,DYNAMIKE,brawlBall,Sunny Soccer,84,82,166
15132,2023-01-26,DYNAMIKE,brawlBall,Pinhole Punt,530,298,828
15133,2023-01-26,DYNAMIKE,bounty,Temple Ruins,18,11,29
15134,2023-01-25,DYNAMIKE,knockout,Riverside,22,5,27
15135,2023-01-25,DYNAMIKE,hotZone,Open Zone,10,0,10
15136,2023-01-25,DYNAMIKE,heist,Safe Zone,54,25,79
15137,2023-01-25,DYNAMIKE,gemGrab,Gem Fort,35,17,52
15138,2023-01-25,DYNAMIKE,gemGrab,Crystal Arcade,68,23,91
15139,2023-01-25,DYNAMIKE,brawlBall,Sunny Soccer,1160,1129,2289
15140,2023-01-25,DYNAMIKE,brawlBall,Beach Ball,157,112,269
15141,2023-01-25,DYNAMIKE,bounty,Excel,58,20,78
15142,2023-01-24,DYNAMIKE,knockout,New Perspective,107,83,190
15143,2023-01-24,DYNAMIKE,hotZone,Dueling Beetles,135,58,193
15144,2023-01-24,DYNAMIKE,heist,Safe Zone,66,23,89
15145,2023-01-24,DYNAMIKE,gemGrab,Minecart Madness,31,22,53
15146,2023-01-24,DYNAMIKE,gemGrab,Crystal Arcade,107,70,177
15147,2023-01-24,DYNAMIKE,brawlBall,Center Stage,60,32,92
15148,2023-01-24,DYNAMIKE,brawlBall,Beach Ball,1590,1406,2996
15149,2023-01-24,DYNAMIKE,bounty,Excel,87,53,140
15150,2023-01-23,DYNAMIKE,knockout,New Perspective,184,102,286
15151,2023-01-23,DYNAMIKE,hotZone,Dueling Beetles,195,76,271
15152,2023-01-23,DYNAMIKE,heist,Snaked Assault,236,99,335
15153,2023-01-23,DYNAMIKE,gemGrab,Minecart Madness,157,97,254
15154,2023-01-23,DYNAMIKE,gemGrab,Double Swoosh,41,12,53
15155,2023-01-23,DYNAMIKE,brawlBall,Center Stage,710,431,1141
15156,2023-01-23,DYNAMIKE,brawlBall,Backyard Bowl,26,5,31
15157,2023-01-23,DYNAMIKE,bounty,Layer Cake,140,98,238
15158,2023-01-22,DYNAMIKE,knockout,X Marks the Spot,62,32,94
15159,2023-01-22,DYNAMIKE,hotZone,Ring of Fire,29,7,36
15160,2023-01-22,DYNAMIKE,heist,Snaked Assault,89,48,137
15161,2023-01-22,DYNAMIKE,gemGrab,Hard Rock Mine,26,10,36
15162,2023-01-22,DYNAMIKE,gemGrab,Double Swoosh,42,48,90
15163,2023-01-22,DYNAMIKE,brawlBall,Super Beach,218,264,482
15164,2023-01-22,DYNAMIKE,brawlBall,Backyard Bowl,182,68,250
15165,2023-01-22,DYNAMIKE,bounty,Layer Cake,59,21,80
15166,2023-01-21,DYNAMIKE,knockout,X Marks the Spot,192,88,280
15167,2023-01-21,DYNAMIKE,hotZone,Ring of Fire,76,15,91
15168,2023-01-21,DYNAMIKE,heist,Tornado Ring,171,86,257
15169,2023-01-21,DYNAMIKE,gemGrab,Hard Rock Mine,112,66,178
15170,2023-01-21,DYNAMIKE,gemGrab,Deep Diner,80,48,128
15171,2023-01-21,DYNAMIKE,brawlBall,Super Beach,2833,2809,5642
15172,2023-01-21,DYNAMIKE,brawlBall,Sneaky Fields,31,21,52
15173,2023-01-21,DYNAMIKE,bounty,Dry Season,44,10,54
15174,2023-01-20,DYNAMIKE,knockout,Out in the Open,90,39,129
15175,2023-01-20,DYNAMIKE,hotZone,Split,558,591,1149
15176,2023-01-20,DYNAMIKE,heist,Tornado Ring,152,97,249
15177,2023-01-20,DYNAMIKE,gemGrab,Undermine,35,13,48
15178,2023-01-20,DYNAMIKE,gemGrab,Deep Diner,275,297,572
15179,2023-01-20,DYNAMIKE,brawlBall,Sneaky Fields,768,526,1294
15180,2023-01-20,DYNAMIKE,brawlBall,Pinhole Punt,27,10,37
15181,2023-01-20,DYNAMIKE,bounty,Dry Season,29,23,52
15182,2023-01-19,DYNAMIKE,knockout,Out in the Open,117,78,195
15183,2023-01-19,DYNAMIKE,hotZone,Split,942,961,1903
15184,2023-01-19,DYNAMIKE,heist,Kaboom Canyon,63,19,82
15185,2023-01-19,DYNAMIKE,gemGrab,Undermine,96,58,154
15186,2023-01-19,DYNAMIKE,gemGrab,Gem Fort,14,2,16
15187,2023-01-19,DYNAMIKE,brawlBall,Sunny Soccer,74,65,139
15188,2023-01-19,DYNAMIKE,brawlBall,Pinhole Punt,556,337,893
15189,2023-01-19,DYNAMIKE,bounty,Shooting Star,28,16,44
15190,2023-01-18,DYNAMIKE,knockout,Goldarm Gulch,19,11,30
15191,2023-01-18,DYNAMIKE,hotZone,Parallel Plays,21,20,41
15192,2023-01-18,DYNAMIKE,heist,Kaboom Canyon,18,9,27
15193,2023-01-18,DYNAMIKE,gemGrab,Gem Fort,12,12,24
15194,2023-01-18,DYNAMIKE,gemGrab,Crystal Arcade,9,10,19
15195,2023-01-18,DYNAMIKE,brawlBall,Sunny Soccer,549,424,973
15196,2023-01-18,DYNAMIKE,brawlBall,Beach Ball,30,15,45
15197,2023-01-18,DYNAMIKE,bounty,Shooting Star,13,2,15
15198,2023-01-17,DYNAMIKE,knockout,Goldarm Gulch,15,5,20
15199,2023-01-17,DYNAMIKE,hotZone,Parallel Plays,7,9,16
15200,2023-01-17,DYNAMIKE,heist,Pit Stop,67,51,118
15201,2023-01-17,DYNAMIKE,gemGrab,Minecart Madness,1,0,1
15202,2023-01-17,DYNAMIKE,gemGrab,Crystal Arcade,4,5,9
15203,2023-01-17,DYNAMIKE,brawlBall,Center Stage,1,1,2
15204,2023-01-17,DYNAMIKE,brawlBall,Beach Ball,152,154,306
15205,2023-01-17,DYNAMIKE,bounty,Hideout,5,1,6
15206,2023-01-16,DYNAMIKE,knockout,Belle's Rock,28,12,40
15207,2023-01-16,DYNAMIKE,hotZone,Quarter Pounder,32,34,66
15208,2023-01-16,DYNAMIKE,heist,Pit Stop,179,102,281
15209,2023-01-16,DYNAMIKE,gemGrab,Minecart Madness,14,6,20
15210,2023-01-16,DYNAMIKE,gemGrab,Double Swoosh,4,1,5
15211,2023-01-16,DYNAMIKE,brawlBall,Center Stage,41,20,61
15212,2023-01-16,DYNAMIKE,brawlBall,Backyard Bowl,8,9,17
15213,2023-01-16,DYNAMIKE,bounty,Hideout,12,4,16
15214,2023-01-15,DYNAMIKE,knockout,Belle's Rock,26,15,41
15215,2023-01-15,DYNAMIKE,hotZone,Quarter Pounder,58,58,116
15216,2023-01-15,DYNAMIKE,heist,Bridge Too Far,5,2,7
15217,2023-01-15,DYNAMIKE,gemGrab,Hard Rock Mine,3,0,3
15218,2023-01-15,DYNAMIKE,gemGrab,Double Swoosh,3,1,4
15219,2023-01-15,DYNAMIKE,brawlBall,Super Beach,33,39,72
15220,2023-01-15,DYNAMIKE,brawlBall,Backyard Bowl,56,19,75
15221,2023-01-15,DYNAMIKE,bounty,Canal Grande,3,1,4
15222,2023-01-14,DYNAMIKE,knockout,Flaring Phoenix,9,6,15
15223,2023-01-14,DYNAMIKE,hotZone,Controller Chaos,64,23,87
15224,2023-01-14,DYNAMIKE,heist,Bridge Too Far,7,0,7
15225,2023-01-14,DYNAMIKE,gemGrab,Hard Rock Mine,7,0,7
15226,2023-01-14,DYNAMIKE,gemGrab,Deep Diner,14,37,51
15227,2023-01-14,DYNAMIKE,brawlBall,Super Beach,204,186,390
15228,2023-01-14,DYNAMIKE,brawlBall,Sneaky Fields,6,1,7
15229,2023-01-14,DYNAMIKE,bounty,Canal Grande,10,0,10
15230,2023-01-13,DYNAMIKE,knockout,Flaring Phoenix,11,7,18
15231,2023-01-13,DYNAMIKE,hotZone,Controller Chaos,62,39,101
15232,2023-01-13,DYNAMIKE,heist,Hot Potato,31,31,62
15233,2023-01-13,DYNAMIKE,gemGrab,Deep Diner,26,37,63
15234,2023-01-13,DYNAMIKE,brawlBall,Sneaky Fields,41,25,66
15235,2023-01-13,DYNAMIKE,bounty,Temple Ruins,0,5,5
15236,2023-01-12,DYNAMIKE,knockout,Riverside,11,4,15
15237,2023-01-12,DYNAMIKE,hotZone,Open Zone,6,0,6
15238,2023-01-12,DYNAMIKE,heist,Hot Potato,21,33,54
15239,2023-01-12,DYNAMIKE,gemGrab,Undermine,4,1,5
15240,2023-01-12,DYNAMIKE,brawlBall,Sunny Soccer,5,1,6
15241,2023-01-12,DYNAMIKE,brawlBall,Pinhole Punt,11,3,14
15242,2023-01-11,DYNAMIKE,hotZone,Open Zone,1,0,1
15243,2023-01-11,DYNAMIKE,gemGrab,Gem Fort,1,0,1
15244,2023-01-11,DYNAMIKE,brawlBall,Sunny Soccer,44,29,73
15245,2023-01-11,DYNAMIKE,brawlBall,Beach Ball,1,0,1
15246,2023-01-11,DYNAMIKE,bounty,Excel,1,8,9
15247,2023-01-10,DYNAMIKE,knockout,New Perspective,13,4,17
15248,2023-01-10,DYNAMIKE,hotZone,Dueling Beetles,25,3,28
15249,2023-01-10,DYNAMIKE,heist,Safe Zone,4,0,4
15250,2023-01-10,DYNAMIKE,gemGrab,Minecart Madness,4,0,4
15251,2023-01-10,DYNAMIKE,gemGrab,Crystal Arcade,5,2,7
15252,2023-01-10,DYNAMIKE,brawlBall,Center Stage,6,0,6
15253,2023-01-10,DYNAMIKE,brawlBall,Beach Ball,85,101,186
15254,2023-01-10,DYNAMIKE,bounty,Excel,8,21,29
15255,2023-01-09,DYNAMIKE,knockout,New Perspective,5,1,6
15256,2023-01-09,DYNAMIKE,hotZone,Dueling Beetles,16,0,16
15257,2023-01-09,DYNAMIKE,heist,Snaked Assault,24,1,25
15258,2023-01-09,DYNAMIKE,gemGrab,Minecart Madness,20,13,33
15259,2023-01-09,DYNAMIKE,gemGrab,Double Swoosh,8,0,8
15260,2023-01-09,DYNAMIKE,brawlBall,Center Stage,23,6,29
15261,2023-01-09,DYNAMIKE,brawlBall,Backyard Bowl,2,1,3
15262,2023-01-09,DYNAMIKE,bounty,Layer Cake,19,9,28
15263,2023-01-08,DYNAMIKE,knockout,X Marks the Spot,17,4,21
15264,2023-01-08,DYNAMIKE,hotZone,Ring of Fire,6,1,7
15265,2023-01-08,DYNAMIKE,heist,Snaked Assault,18,4,22
15266,2023-01-08,DYNAMIKE,gemGrab,Hard Rock Mine,2,0,2
15267,2023-01-08,DYNAMIKE,gemGrab,Double Swoosh,1,1,2
15268,2023-01-08,DYNAMIKE,brawlBall,Super Beach,32,29,61
15269,2023-01-08,DYNAMIKE,brawlBall,Backyard Bowl,18,3,21
15270,2023-01-08,DYNAMIKE,bounty,Layer Cake,4,1,5
15271,2023-01-07,DYNAMIKE,knockout,X Marks the Spot,5,1,6
15272,2023-01-07,DYNAMIKE,heist,Tornado Ring,16,29,45
15273,2023-01-07,DYNAMIKE,gemGrab,Hard Rock Mine,1,3,4
15274,2023-01-07,DYNAMIKE,gemGrab,Deep Diner,21,17,38
15275,2023-01-07,DYNAMIKE,brawlBall,Super Beach,63,55,118
15276,2023-01-07,DYNAMIKE,brawlBall,Sneaky Fields,5,0,5
15277,2023-01-07,DYNAMIKE,bounty,Dry Season,4,0,4
15278,2023-01-06,DYNAMIKE,knockout,Out in the Open,6,0,6
15279,2023-01-06,DYNAMIKE,hotZone,Split,68,48,116
15280,2023-01-06,DYNAMIKE,heist,Tornado Ring,27,6,33
15281,2023-01-06,DYNAMIKE,gemGrab,Undermine,1,0,1
15282,2023-01-06,DYNAMIKE,gemGrab,Deep Diner,32,41,73
15283,2023-01-06,DYNAMIKE,brawlBall,Sneaky Fields,22,8,30
15284,2023-01-06,DYNAMIKE,brawlBall,Pinhole Punt,2,0,2
15285,2023-01-06,DYNAMIKE,bounty,Dry Season,1,0,1
15286,2023-01-05,DYNAMIKE,knockout,Out in the Open,3,3,6
15287,2023-01-05,DYNAMIKE,hotZone,Split,173,150,323
15288,2023-01-05,DYNAMIKE,heist,Kaboom Canyon,13,1,14
15289,2023-01-05,DYNAMIKE,gemGrab,Undermine,7,8,15
15290,2023-01-05,DYNAMIKE,gemGrab,Gem Fort,4,7,11
15291,2023-01-05,DYNAMIKE,brawlBall,Sunny Soccer,3,5,8
15292,2023-01-05,DYNAMIKE,brawlBall,Pinhole Punt,35,15,50
15293,2023-01-05,DYNAMIKE,bounty,Shooting Star,3,0,3
15294,2023-01-04,DYNAMIKE,knockout,Goldarm Gulch,6,2,8
15295,2023-01-04,DYNAMIKE,hotZone,Parallel Plays,15,3,18
15296,2023-01-04,DYNAMIKE,heist,Kaboom Canyon,15,1,16
15297,2023-01-04,DYNAMIKE,gemGrab,Gem Fort,0,1,1
15298,2023-01-04,DYNAMIKE,gemGrab,Crystal Arcade,3,1,4
15299,2023-01-04,DYNAMIKE,brawlBall,Sunny Soccer,161,166,327
15300,2023-01-04,DYNAMIKE,brawlBall,Beach Ball,1,0,1
15301,2023-01-04,DYNAMIKE,bounty,Shooting Star,2,0,2
15302,2023-01-03,DYNAMIKE,knockout,Goldarm Gulch,1,2,3
15303,2023-01-03,DYNAMIKE,hotZone,Parallel Plays,17,1,18
15304,2023-01-03,DYNAMIKE,hotZone,Controller Chaos,1,0,1
15305,2023-01-03,DYNAMIKE,heist,Pit Stop,80,40,120
15306,2023-01-03,DYNAMIKE,gemGrab,Minecart Madness,3,0,3
15307,2023-01-03,DYNAMIKE,gemGrab,Crystal Arcade,9,1,10
15308,2023-01-03,DYNAMIKE,brawlBall,Center Stage,2,0,2
15309,2023-01-03,DYNAMIKE,brawlBall,Beach Ball,111,94,205
15310,2023-01-03,DYNAMIKE,bounty,Hideout,6,0,6
15311,2023-01-02,DYNAMIKE,knockout,Belle's Rock,34,3,37
15312,2023-01-02,DYNAMIKE,hotZone,Quarter Pounder,47,13,60
15313,2023-01-02,DYNAMIKE,hotZone,Controller Chaos,0,2,2
15314,2023-01-02,DYNAMIKE,heist,Pit Stop,128,126,254
15315,2023-01-02,DYNAMIKE,gemGrab,Minecart Madness,14,3,17
15316,2023-01-02,DYNAMIKE,gemGrab,Double Swoosh,2,2,4
15317,2023-01-02,DYNAMIKE,brawlBall,Center Stage,44,29,73
15318,2023-01-02,DYNAMIKE,brawlBall,Backyard Bowl,5,1,6
15319,2023-01-02,DYNAMIKE,bounty,Hideout,8,1,9
15320,2023-01-01,DYNAMIKE,knockout,Belle's Rock,3,0,3
15321,2023-01-01,DYNAMIKE,hotZone,Quarter Pounder,19,3,22
15322,2023-01-01,DYNAMIKE,heist,Bridge Too Far,1,0,1
15323,2023-01-01,DYNAMIKE,gemGrab,Double Swoosh,10,1,11
15324,2023-01-01,DYNAMIKE,brawlBall,Backyard Bowl,12,7,19
15325,2023-01-01,DYNAMIKE,bounty,Canal Grande,2,0,2
15326,2022-12-31,DYNAMIKE,hotZone,Controller Chaos,5,5,10
15327,2022-12-31,DYNAMIKE,gemGrab,Hard Rock Mine,2,0,2
15328,2022-12-31,DYNAMIKE,gemGrab,Deep Diner,2,1,3
15329,2022-12-31,DYNAMIKE,brawlBall,Super Beach,22,27,49
15330,2022-12-30,DYNAMIKE,knockout,Flaring Phoenix,2,0,2
15331,2022-12-30,DYNAMIKE,hotZone,Controller Chaos,3,1,4
15332,2022-12-30,DYNAMIKE,heist,Hot Potato,2,2,4
15333,2022-12-30,DYNAMIKE,gemGrab,Minecart Madness,2,0,2
15334,2022-12-30,DYNAMIKE,gemGrab,Deep Diner,2,4,6
15335,2022-12-30,DYNAMIKE,brawlBall,Sneaky Fields,6,2,8
15336,2022-12-29,DYNAMIKE,hotZone,Controller Chaos,1,0,1
15337,2022-12-29,DYNAMIKE,heist,Hot Potato,2,8,10
15338,2022-12-29,DYNAMIKE,gemGrab,Minecart Madness,1,1,2
15339,2022-12-29,DYNAMIKE,gemGrab,Gem Fort,1,0,1
15340,2022-12-28,DYNAMIKE,gemGrab,Minecart Madness,0,2,2
15341,2022-12-28,DYNAMIKE,brawlBall,Sunny Soccer,2,0,2
15342,2022-12-27,DYNAMIKE,hotZone,Dueling Beetles,0,1,1
15343,2022-12-27,DYNAMIKE,hotZone,Controller Chaos,1,0,1
15344,2022-12-27,DYNAMIKE,gemGrab,Minecart Madness,3,0,3
15345,2022-12-27,DYNAMIKE,brawlBall,Beach Ball,6,3,9
15346,2022-12-27,DYNAMIKE,bounty,Excel,1,0,1
15347,2022-12-26,DYNAMIKE,hotZone,Controller Chaos,2,0,2
15348,2022-12-26,DYNAMIKE,heist,Kaboom Canyon,1,0,1
15349,2022-12-26,DYNAMIKE,gemGrab,Minecart Madness,0,1,1
15350,2022-12-25,DYNAMIKE,brawlBall,Backyard Bowl,1,0,1
15351,2022-12-24,DYNAMIKE,brawlBall,Super Beach,4,2,6
15352,2022-12-23,DYNAMIKE,knockout,Out in the Open,2,0,2
15353,2022-12-22,DYNAMIKE,gemGrab,Gem Fort,0,1,1
15354,2022-12-22,DYNAMIKE,brawlBall,Pinhole Punt,3,0,3
15355,2022-12-21,DYNAMIKE,brawlBall,Sunny Soccer,0,1,1
15356,2022-12-20,DYNAMIKE,brawlBall,Beach Ball,2,1,3
15357,2022-12-16,DYNAMIKE,brawlBall,Sneaky Fields,1,4,5
15358,2022-12-13,DYNAMIKE,knockout,New Perspective,1,0,1
15359,2022-12-13,DYNAMIKE,heist,Safe Zone,0,1,1
15360,2022-12-13,DYNAMIKE,gemGrab,Crystal Arcade,2,0,2
15361,2022-12-13,DYNAMIKE,brawlBall,Beach Ball,1,2,3
15362,2022-12-12,DYNAMIKE,brawlBall,Center Stage,0,2,2
15363,2022-12-10,DYNAMIKE,knockout,X Marks the Spot,0,1,1
15364,2022-12-10,DYNAMIKE,gemGrab,Hard Rock Mine,4,0,4
15365,2022-11-07,DYNAMIKE,hotZone,Quarter Pounder,0,2,2
15366,2022-11-03,DYNAMIKE,brawlBall,Pinhole Punt,2,2,4
15367,2022-11-01,DYNAMIKE,knockout,New Perspective,2,2,4
15368,2022-10-30,DYNAMIKE,bounty,Canal Grande,1,0,1
15369,2022-10-28,DYNAMIKE,bounty,Canal Grande,2,0,2
15370,2022-10-15,DYNAMIKE,gemGrab,Hard Rock Mine,0,1,1
15371,2023-02-11,DARRYL,knockout,Flaring Phoenix,23,16,39
15372,2023-02-11,DARRYL,hotZone,Controller Chaos,31,12,43
15373,2023-02-11,DARRYL,gemGrab,Deep Diner,27,23,50
15374,2023-02-11,DARRYL,brawlBall,Super Beach,117,128,245
15375,2023-02-11,DARRYL,brawlBall,Sneaky Fields,95,91,186
15376,2023-02-10,DARRYL,knockout,Flaring Phoenix,23,8,31
15377,2023-02-10,DARRYL,hotZone,Controller Chaos,51,30,81
15378,2023-02-10,DARRYL,heist,Hot Potato,120,145,265
15379,2023-02-10,DARRYL,gemGrab,Undermine,21,17,38
15380,2023-02-10,DARRYL,gemGrab,Deep Diner,49,44,93
15381,2023-02-10,DARRYL,brawlBall,Sneaky Fields,637,693,1330
15382,2023-02-10,DARRYL,brawlBall,Pinhole Punt,8,5,13
15383,2023-02-10,DARRYL,bounty,Temple Ruins,11,8,19
15384,2023-02-09,DARRYL,knockout,Riverside,5,2,7
15385,2023-02-09,DARRYL,hotZone,Open Zone,1,2,3
15386,2023-02-09,DARRYL,heist,Hot Potato,97,73,170
15387,2023-02-09,DARRYL,gemGrab,Undermine,11,5,16
15388,2023-02-09,DARRYL,gemGrab,Gem Fort,2,3,5
15389,2023-02-09,DARRYL,brawlBall,Pinhole Punt,92,101,193
15390,2023-02-09,DARRYL,bounty,Temple Ruins,10,4,14
15391,2023-02-08,DARRYL,knockout,Riverside,3,1,4
15392,2023-02-08,DARRYL,hotZone,Open Zone,1,1,2
15393,2023-02-08,DARRYL,heist,Safe Zone,8,10,18
15394,2023-02-08,DARRYL,gemGrab,Gem Fort,6,7,13
15395,2023-02-08,DARRYL,brawlBall,Sunny Soccer,42,36,78
15396,2023-02-08,DARRYL,brawlBall,Beach Ball,0,2,2
15397,2023-02-08,DARRYL,bounty,Excel,2,2,4
15398,2023-02-07,DARRYL,knockout,New Perspective,4,0,4
15399,2023-02-07,DARRYL,hotZone,Dueling Beetles,6,0,6
15400,2023-02-07,DARRYL,heist,Safe Zone,10,11,21
15401,2023-02-07,DARRYL,gemGrab,Minecart Madness,4,0,4
15402,2023-02-07,DARRYL,gemGrab,Crystal Arcade,2,1,3
15403,2023-02-07,DARRYL,brawlBall,Center Stage,3,2,5
15404,2023-02-07,DARRYL,brawlBall,Beach Ball,33,24,57
15405,2023-02-07,DARRYL,bounty,Excel,2,1,3
15406,2023-02-06,DARRYL,knockout,New Perspective,35,24,59
15407,2023-02-06,DARRYL,hotZone,Dueling Beetles,45,15,60
15408,2023-02-06,DARRYL,heist,Snaked Assault,216,244,460
15409,2023-02-06,DARRYL,heist,Pit Stop,104,99,203
15410,2023-02-06,DARRYL,gemGrab,Minecart Madness,46,41,87
15411,2023-02-06,DARRYL,gemGrab,Double Swoosh,59,31,90
15412,2023-02-06,DARRYL,brawlBall,Sneaky Fields,33,19,52
15413,2023-02-06,DARRYL,brawlBall,Center Stage,698,744,1442
15414,2023-02-06,DARRYL,brawlBall,Backyard Bowl,29,11,40
15415,2023-02-06,DARRYL,bounty,Layer Cake,32,25,57
15416,2023-02-05,DARRYL,knockout,X Marks the Spot,15,12,27
15417,2023-02-05,DARRYL,knockout,Goldarm Gulch,7,6,13
15418,2023-02-05,DARRYL,hotZone,Ring of Fire,27,12,39
15419,2023-02-05,DARRYL,heist,Snaked Assault,328,377,705
15420,2023-02-05,DARRYL,heist,Pit Stop,290,311,601
15421,2023-02-05,DARRYL,gemGrab,Hard Rock Mine,28,40,68
15422,2023-02-05,DARRYL,gemGrab,Double Swoosh,157,94,251
15423,2023-02-05,DARRYL,brawlBall,Super Beach,20,17,37
15424,2023-02-05,DARRYL,brawlBall,Sneaky Fields,70,56,126
15425,2023-02-05,DARRYL,brawlBall,Backyard Bowl,295,246,541
15426,2023-02-05,DARRYL,bounty,Layer Cake,38,66,104
15427,2023-02-04,DARRYL,knockout,X Marks the Spot,2,2,4
15428,2023-02-04,DARRYL,knockout,Goldarm Gulch,4,1,5
15429,2023-02-04,DARRYL,hotZone,Ring of Fire,4,7,11
15430,2023-02-04,DARRYL,heist,Tornado Ring,37,29,66
15431,2023-02-04,DARRYL,heist,Pit Stop,179,232,411
15432,2023-02-04,DARRYL,gemGrab,Hard Rock Mine,16,19,35
15433,2023-02-04,DARRYL,gemGrab,Double Swoosh,37,6,43
15434,2023-02-04,DARRYL,gemGrab,Deep Diner,5,5,10
15435,2023-02-04,DARRYL,brawlBall,Super Beach,176,119,295
15436,2023-02-04,DARRYL,brawlBall,Sneaky Fields,42,34,76
15437,2023-02-03,DARRYL,knockout,Out in the Open,19,9,28
15438,2023-02-03,DARRYL,knockout,Goldarm Gulch,14,12,26
15439,2023-02-03,DARRYL,hotZone,Split,30,32,62
15440,2023-02-03,DARRYL,heist,Tornado Ring,383,400,783
15441,2023-02-03,DARRYL,heist,Pit Stop,644,801,1445
15442,2023-02-03,DARRYL,gemGrab,Undermine,18,25,43
15443,2023-02-03,DARRYL,gemGrab,Double Swoosh,169,36,205
15444,2023-02-03,DARRYL,gemGrab,Deep Diner,50,50,100
15445,2023-02-03,DARRYL,brawlBall,Sneaky Fields,859,813,1672
15446,2023-02-03,DARRYL,brawlBall,Pinhole Punt,21,19,40
15447,2023-02-03,DARRYL,bounty,Dry Season,6,8,14
15448,2023-02-02,DARRYL,knockout,Out in the Open,3,2,5
15449,2023-02-02,DARRYL,hotZone,Split,14,10,24
15450,2023-02-02,DARRYL,heist,Kaboom Canyon,18,38,56
15451,2023-02-02,DARRYL,gemGrab,Undermine,14,7,21
15452,2023-02-02,DARRYL,gemGrab,Gem Fort,8,7,15
15453,2023-02-02,DARRYL,brawlBall,Sunny Soccer,11,7,18
15454,2023-02-02,DARRYL,brawlBall,Pinhole Punt,137,129,266
15455,2023-02-02,DARRYL,bounty,Shooting Star,2,1,3
15456,2023-02-01,DARRYL,knockout,Goldarm Gulch,58,42,100
15457,2023-02-01,DARRYL,hotZone,Parallel Plays,58,33,91
15458,2023-02-01,DARRYL,heist,Kaboom Canyon,55,59,114
15459,2023-02-01,DARRYL,gemGrab,Gem Fort,72,44,116
15460,2023-02-01,DARRYL,gemGrab,Crystal Arcade,30,30,60
15461,2023-02-01,DARRYL,brawlBall,Sunny Soccer,446,493,939
15462,2023-02-01,DARRYL,brawlBall,Beach Ball,20,22,42
15463,2023-02-01,DARRYL,bounty,Shooting Star,1,3,4
15464,2023-01-31,DARRYL,knockout,Goldarm Gulch,17,9,26
15465,2023-01-31,DARRYL,hotZone,Parallel Plays,23,12,35
15466,2023-01-31,DARRYL,heist,Pit Stop,113,77,190
15467,2023-01-31,DARRYL,gemGrab,Minecart Madness,2,1,3
15468,2023-01-31,DARRYL,gemGrab,Crystal Arcade,30,22,52
15469,2023-01-31,DARRYL,brawlBall,Center Stage,4,6,10
15470,2023-01-31,DARRYL,brawlBall,Beach Ball,168,172,340
15471,2023-01-31,DARRYL,bounty,Hideout,1,1,2
15472,2023-01-30,DARRYL,knockout,Belle's Rock,30,11,41
15473,2023-01-30,DARRYL,hotZone,Quarter Pounder,48,17,65
15474,2023-01-30,DARRYL,heist,Pit Stop,455,556,1011
15475,2023-01-30,DARRYL,gemGrab,Minecart Madness,24,24,48
15476,2023-01-30,DARRYL,gemGrab,Double Swoosh,26,26,52
15477,2023-01-30,DARRYL,brawlBall,Center Stage,425,463,888
15478,2023-01-30,DARRYL,brawlBall,Backyard Bowl,20,13,33
15479,2023-01-30,DARRYL,bounty,Hideout,7,2,9
15480,2023-01-29,DARRYL,knockout,Belle's Rock,40,24,64
15481,2023-01-29,DARRYL,hotZone,Quarter Pounder,32,9,41
15482,2023-01-29,DARRYL,heist,Bridge Too Far,69,95,164
15483,2023-01-29,DARRYL,gemGrab,Hard Rock Mine,9,7,16
15484,2023-01-29,DARRYL,gemGrab,Double Swoosh,57,41,98
15485,2023-01-29,DARRYL,brawlBall,Super Beach,9,5,14
15486,2023-01-29,DARRYL,brawlBall,Backyard Bowl,229,194,423
15487,2023-01-29,DARRYL,bounty,Canal Grande,31,22,53
15488,2023-01-28,DARRYL,knockout,Flaring Phoenix,20,15,35
15489,2023-01-28,DARRYL,hotZone,Controller Chaos,37,23,60
15490,2023-01-28,DARRYL,heist,Bridge Too Far,126,111,237
15491,2023-01-28,DARRYL,gemGrab,Hard Rock Mine,72,57,129
15492,2023-01-28,DARRYL,gemGrab,Deep Diner,11,16,27
15493,2023-01-28,DARRYL,brawlBall,Super Beach,521,543,1064
15494,2023-01-28,DARRYL,brawlBall,Sneaky Fields,29,19,48
15495,2023-01-28,DARRYL,bounty,Canal Grande,36,50,86
15496,2023-01-27,DARRYL,knockout,Flaring Phoenix,16,4,20
15497,2023-01-27,DARRYL,hotZone,Controller Chaos,9,5,14
15498,2023-01-27,DARRYL,heist,Hot Potato,59,88,147
15499,2023-01-27,DARRYL,gemGrab,Undermine,3,1,4
15500,2023-01-27,DARRYL,gemGrab,Deep Diner,25,29,54
15501,2023-01-27,DARRYL,brawlBall,Sneaky Fields,198,206,404
15502,2023-01-27,DARRYL,brawlBall,Pinhole Punt,6,3,9
15503,2023-01-27,DARRYL,bounty,Temple Ruins,8,8,16
15504,2023-01-26,DARRYL,knockout,Riverside,22,6,28
15505,2023-01-26,DARRYL,hotZone,Open Zone,16,8,24
15506,2023-01-26,DARRYL,heist,Hot Potato,361,398,759
15507,2023-01-26,DARRYL,gemGrab,Undermine,44,34,78
15508,2023-01-26,DARRYL,gemGrab,Gem Fort,19,17,36
15509,2023-01-26,DARRYL,brawlBall,Sunny Soccer,34,32,66
15510,2023-01-26,DARRYL,brawlBall,Pinhole Punt,426,396,822
15511,2023-01-26,DARRYL,bounty,Temple Ruins,5,11,16
15512,2023-01-25,DARRYL,knockout,Riverside,13,9,22
15513,2023-01-25,DARRYL,hotZone,Open Zone,4,4,8
15514,2023-01-25,DARRYL,heist,Safe Zone,90,72,162
15515,2023-01-25,DARRYL,gemGrab,Gem Fort,26,15,41
15516,2023-01-25,DARRYL,gemGrab,Crystal Arcade,28,16,44
15517,2023-01-25,DARRYL,brawlBall,Sunny Soccer,383,398,781
15518,2023-01-25,DARRYL,brawlBall,Beach Ball,47,58,105
15519,2023-01-25,DARRYL,bounty,Excel,11,6,17
15520,2023-01-24,DARRYL,knockout,New Perspective,28,26,54
15521,2023-01-24,DARRYL,hotZone,Dueling Beetles,25,7,32
15522,2023-01-24,DARRYL,heist,Safe Zone,96,103,199
15523,2023-01-24,DARRYL,gemGrab,Minecart Madness,5,3,8
15524,2023-01-24,DARRYL,gemGrab,Crystal Arcade,52,41,93
15525,2023-01-24,DARRYL,brawlBall,Center Stage,57,59,116
15526,2023-01-24,DARRYL,brawlBall,Beach Ball,419,470,889
15527,2023-01-24,DARRYL,bounty,Excel,12,7,19
15528,2023-01-23,DARRYL,knockout,New Perspective,39,42,81
15529,2023-01-23,DARRYL,hotZone,Dueling Beetles,30,25,55
15530,2023-01-23,DARRYL,heist,Snaked Assault,236,243,479
15531,2023-01-23,DARRYL,gemGrab,Minecart Madness,47,47,94
15532,2023-01-23,DARRYL,gemGrab,Double Swoosh,28,25,53
15533,2023-01-23,DARRYL,brawlBall,Center Stage,801,854,1655
15534,2023-01-23,DARRYL,brawlBall,Backyard Bowl,22,15,37
15535,2023-01-23,DARRYL,bounty,Layer Cake,23,23,46
15536,2023-01-22,DARRYL,knockout,X Marks the Spot,13,9,22
15537,2023-01-22,DARRYL,hotZone,Ring of Fire,14,16,30
15538,2023-01-22,DARRYL,heist,Snaked Assault,157,217,374
15539,2023-01-22,DARRYL,gemGrab,Hard Rock Mine,16,15,31
15540,2023-01-22,DARRYL,gemGrab,Double Swoosh,35,26,61
15541,2023-01-22,DARRYL,brawlBall,Super Beach,60,81,141
15542,2023-01-22,DARRYL,brawlBall,Backyard Bowl,99,90,189
15543,2023-01-22,DARRYL,bounty,Layer Cake,18,31,49
15544,2023-01-21,DARRYL,knockout,X Marks the Spot,54,27,81
15545,2023-01-21,DARRYL,hotZone,Ring of Fire,37,49,86
15546,2023-01-21,DARRYL,heist,Tornado Ring,176,210,386
15547,2023-01-21,DARRYL,gemGrab,Hard Rock Mine,87,88,175
15548,2023-01-21,DARRYL,gemGrab,Deep Diner,14,17,31
15549,2023-01-21,DARRYL,brawlBall,Super Beach,674,652,1326
15550,2023-01-21,DARRYL,brawlBall,Sneaky Fields,32,28,60
15551,2023-01-21,DARRYL,bounty,Dry Season,10,9,19
15552,2023-01-20,DARRYL,knockout,Out in the Open,34,13,47
15553,2023-01-20,DARRYL,hotZone,Split,44,52,96
15554,2023-01-20,DARRYL,heist,Tornado Ring,225,267,492
15555,2023-01-20,DARRYL,gemGrab,Undermine,28,21,49
15556,2023-01-20,DARRYL,gemGrab,Deep Diner,51,32,83
15557,2023-01-20,DARRYL,brawlBall,Sneaky Fields,626,614,1240
15558,2023-01-20,DARRYL,brawlBall,Pinhole Punt,20,15,35
15559,2023-01-20,DARRYL,bounty,Dry Season,8,4,12
15560,2023-01-19,DARRYL,knockout,Out in the Open,22,9,31
15561,2023-01-19,DARRYL,hotZone,Split,62,110,172
15562,2023-01-19,DARRYL,heist,Kaboom Canyon,69,49,118
15563,2023-01-19,DARRYL,gemGrab,Undermine,55,39,94
15564,2023-01-19,DARRYL,gemGrab,Gem Fort,18,21,39
15565,2023-01-19,DARRYL,brawlBall,Sunny Soccer,25,36,61
15566,2023-01-19,DARRYL,brawlBall,Pinhole Punt,477,493,970
15567,2023-01-19,DARRYL,bounty,Shooting Star,4,2,6
15568,2023-01-18,DARRYL,knockout,Goldarm Gulch,6,7,13
15569,2023-01-18,DARRYL,hotZone,Parallel Plays,5,6,11
15570,2023-01-18,DARRYL,heist,Kaboom Canyon,21,14,35
15571,2023-01-18,DARRYL,gemGrab,Gem Fort,13,6,19
15572,2023-01-18,DARRYL,gemGrab,Crystal Arcade,4,0,4
15573,2023-01-18,DARRYL,brawlBall,Sunny Soccer,168,168,336
15574,2023-01-18,DARRYL,brawlBall,Beach Ball,11,9,20
15575,2023-01-18,DARRYL,bounty,Shooting Star,2,0,2
15576,2023-01-17,DARRYL,knockout,Goldarm Gulch,3,9,12
15577,2023-01-17,DARRYL,hotZone,Parallel Plays,3,1,4
15578,2023-01-17,DARRYL,heist,Pit Stop,37,37,74
15579,2023-01-17,DARRYL,gemGrab,Minecart Madness,2,0,2
15580,2023-01-17,DARRYL,gemGrab,Crystal Arcade,3,1,4
15581,2023-01-17,DARRYL,brawlBall,Center Stage,4,2,6
15582,2023-01-17,DARRYL,brawlBall,Beach Ball,44,60,104
15583,2023-01-16,DARRYL,knockout,Belle's Rock,3,2,5
15584,2023-01-16,DARRYL,hotZone,Quarter Pounder,5,1,6
15585,2023-01-16,DARRYL,heist,Pit Stop,131,165,296
15586,2023-01-16,DARRYL,gemGrab,Minecart Madness,6,2,8
15587,2023-01-16,DARRYL,gemGrab,Double Swoosh,3,1,4
15588,2023-01-16,DARRYL,brawlBall,Center Stage,39,39,78
15589,2023-01-16,DARRYL,brawlBall,Backyard Bowl,2,0,2
15590,2023-01-15,DARRYL,knockout,Belle's Rock,6,2,8
15591,2023-01-15,DARRYL,hotZone,Quarter Pounder,3,2,5
15592,2023-01-15,DARRYL,heist,Bridge Too Far,18,13,31
15593,2023-01-15,DARRYL,gemGrab,Hard Rock Mine,2,0,2
15594,2023-01-15,DARRYL,gemGrab,Double Swoosh,3,19,22
15595,2023-01-15,DARRYL,brawlBall,Super Beach,9,2,11
15596,2023-01-15,DARRYL,brawlBall,Backyard Bowl,31,29,60
15597,2023-01-15,DARRYL,bounty,Canal Grande,3,2,5
15598,2023-01-14,DARRYL,knockout,Flaring Phoenix,5,5,10
15599,2023-01-14,DARRYL,hotZone,Controller Chaos,20,16,36
15600,2023-01-14,DARRYL,heist,Bridge Too Far,23,15,38
15601,2023-01-14,DARRYL,gemGrab,Hard Rock Mine,5,6,11
15602,2023-01-14,DARRYL,gemGrab,Deep Diner,2,0,2
15603,2023-01-14,DARRYL,brawlBall,Super Beach,36,23,59
15604,2023-01-14,DARRYL,brawlBall,Sneaky Fields,8,0,8
15605,2023-01-14,DARRYL,bounty,Canal Grande,4,5,9
15606,2023-01-13,DARRYL,knockout,Flaring Phoenix,2,1,3
15607,2023-01-13,DARRYL,hotZone,Controller Chaos,9,1,10
15608,2023-01-13,DARRYL,heist,Hot Potato,15,22,37
15609,2023-01-13,DARRYL,gemGrab,Deep Diner,2,1,3
15610,2023-01-13,DARRYL,brawlBall,Sneaky Fields,45,30,75
15611,2023-01-12,DARRYL,knockout,Riverside,4,0,4
15612,2023-01-12,DARRYL,hotZone,Open Zone,3,1,4
15613,2023-01-12,DARRYL,heist,Hot Potato,3,6,9
15614,2023-01-12,DARRYL,gemGrab,Undermine,0,1,1
15615,2023-01-12,DARRYL,gemGrab,Gem Fort,2,0,2
15616,2023-01-12,DARRYL,brawlBall,Sunny Soccer,2,0,2
15617,2023-01-12,DARRYL,brawlBall,Pinhole Punt,18,15,33
15618,2023-01-12,DARRYL,bounty,Temple Ruins,0,2,2
15619,2023-01-11,DARRYL,gemGrab,Gem Fort,1,0,1
15620,2023-01-11,DARRYL,brawlBall,Sunny Soccer,15,3,18
15621,2023-01-11,DARRYL,brawlBall,Beach Ball,1,1,2
15622,2023-01-11,DARRYL,bounty,Excel,3,7,10
15623,2023-01-10,DARRYL,knockout,New Perspective,3,5,8
15624,2023-01-10,DARRYL,hotZone,Dueling Beetles,8,1,9
15625,2023-01-10,DARRYL,heist,Safe Zone,6,2,8
15626,2023-01-10,DARRYL,gemGrab,Minecart Madness,1,2,3
15627,2023-01-10,DARRYL,gemGrab,Crystal Arcade,2,0,2
15628,2023-01-10,DARRYL,brawlBall,Center Stage,3,5,8
15629,2023-01-10,DARRYL,brawlBall,Beach Ball,20,23,43
15630,2023-01-09,DARRYL,knockout,New Perspective,1,3,4
15631,2023-01-09,DARRYL,hotZone,Dueling Beetles,11,4,15
15632,2023-01-09,DARRYL,heist,Snaked Assault,36,47,83
15633,2023-01-09,DARRYL,gemGrab,Minecart Madness,4,6,10
15634,2023-01-09,DARRYL,gemGrab,Double Swoosh,2,0,2
15635,2023-01-09,DARRYL,brawlBall,Center Stage,34,24,58
15636,2023-01-09,DARRYL,brawlBall,Backyard Bowl,1,7,8
15637,2023-01-09,DARRYL,bounty,Layer Cake,1,1,2
15638,2023-01-08,DARRYL,knockout,X Marks the Spot,4,1,5
15639,2023-01-08,DARRYL,hotZone,Ring of Fire,5,3,8
15640,2023-01-08,DARRYL,heist,Snaked Assault,29,43,72
15641,2023-01-08,DARRYL,gemGrab,Hard Rock Mine,4,6,10
15642,2023-01-08,DARRYL,gemGrab,Double Swoosh,1,1,2
15643,2023-01-08,DARRYL,brawlBall,Super Beach,2,1,3
15644,2023-01-08,DARRYL,brawlBall,Backyard Bowl,20,3,23
15645,2023-01-08,DARRYL,bounty,Layer Cake,1,1,2
15646,2023-01-07,DARRYL,hotZone,Ring of Fire,1,0,1
15647,2023-01-07,DARRYL,heist,Tornado Ring,44,95,139
15648,2023-01-07,DARRYL,gemGrab,Hard Rock Mine,4,10,14
15649,2023-01-07,DARRYL,gemGrab,Deep Diner,1,1,2
15650,2023-01-07,DARRYL,brawlBall,Super Beach,21,21,42
15651,2023-01-07,DARRYL,brawlBall,Sneaky Fields,1,1,2
15652,2023-01-07,DARRYL,bounty,Dry Season,2,0,2
15653,2023-01-06,DARRYL,knockout,Out in the Open,0,1,1
15654,2023-01-06,DARRYL,hotZone,Split,6,18,24
15655,2023-01-06,DARRYL,heist,Tornado Ring,55,61,116
15656,2023-01-06,DARRYL,gemGrab,Undermine,2,0,2
15657,2023-01-06,DARRYL,gemGrab,Deep Diner,4,2,6
15658,2023-01-06,DARRYL,brawlBall,Sneaky Fields,29,43,72
15659,2023-01-06,DARRYL,brawlBall,Pinhole Punt,7,1,8
15660,2023-01-06,DARRYL,bounty,Dry Season,1,0,1
15661,2023-01-05,DARRYL,knockout,Out in the Open,1,1,2
15662,2023-01-05,DARRYL,hotZone,Split,23,8,31
15663,2023-01-05,DARRYL,heist,Kaboom Canyon,9,12,21
15664,2023-01-05,DARRYL,gemGrab,Undermine,3,1,4
15665,2023-01-05,DARRYL,brawlBall,Pinhole Punt,36,36,72
15666,2023-01-05,DARRYL,bounty,Shooting Star,1,1,2
15667,2023-01-04,DARRYL,knockout,Goldarm Gulch,1,0,1
15668,2023-01-04,DARRYL,hotZone,Parallel Plays,1,0,1
15669,2023-01-04,DARRYL,heist,Kaboom Canyon,8,9,17
15670,2023-01-04,DARRYL,gemGrab,Gem Fort,2,0,2
15671,2023-01-04,DARRYL,gemGrab,Crystal Arcade,4,5,9
15672,2023-01-04,DARRYL,brawlBall,Sunny Soccer,59,63,122
15673,2023-01-04,DARRYL,brawlBall,Beach Ball,0,1,1
15674,2023-01-03,DARRYL,knockout,Goldarm Gulch,2,0,2
15675,2023-01-03,DARRYL,hotZone,Parallel Plays,4,0,4
15676,2023-01-03,DARRYL,heist,Pit Stop,56,77,133
15677,2023-01-03,DARRYL,gemGrab,Minecart Madness,1,0,1
15678,2023-01-03,DARRYL,gemGrab,Crystal Arcade,10,4,14
15679,2023-01-03,DARRYL,brawlBall,Center Stage,2,0,2
15680,2023-01-03,DARRYL,brawlBall,Beach Ball,32,19,51
15681,2023-01-03,DARRYL,bounty,Hideout,2,0,2
15682,2023-01-02,DARRYL,knockout,Belle's Rock,5,2,7
15683,2023-01-02,DARRYL,hotZone,Quarter Pounder,9,2,11
15684,2023-01-02,DARRYL,hotZone,Controller Chaos,0,2,2
15685,2023-01-02,DARRYL,heist,Pit Stop,109,151,260
15686,2023-01-02,DARRYL,gemGrab,Minecart Madness,5,0,5
15687,2023-01-02,DARRYL,gemGrab,Double Swoosh,6,0,6
15688,2023-01-02,DARRYL,brawlBall,Center Stage,48,37,85
15689,2023-01-02,DARRYL,brawlBall,Backyard Bowl,3,1,4
15690,2023-01-02,DARRYL,bounty,Hideout,1,0,1
15691,2023-01-01,DARRYL,hotZone,Quarter Pounder,1,0,1
15692,2023-01-01,DARRYL,heist,Bridge Too Far,4,9,13
15693,2023-01-01,DARRYL,gemGrab,Double Swoosh,4,3,7
15694,2023-01-01,DARRYL,brawlBall,Backyard Bowl,5,3,8
15695,2022-12-31,DARRYL,heist,Kaboom Canyon,0,1,1
15696,2022-12-31,DARRYL,heist,Bridge Too Far,1,1,2
15697,2022-12-31,DARRYL,gemGrab,Hard Rock Mine,1,0,1
15698,2022-12-31,DARRYL,gemGrab,Deep Diner,1,0,1
15699,2022-12-31,DARRYL,brawlBall,Super Beach,3,2,5
15700,2022-12-30,DARRYL,hotZone,Controller Chaos,3,1,4
15701,2022-12-30,DARRYL,heist,Kaboom Canyon,1,0,1
15702,2022-12-30,DARRYL,heist,Hot Potato,0,1,1
15703,2022-12-30,DARRYL,gemGrab,Deep Diner,3,0,3
15704,2022-12-30,DARRYL,brawlBall,Sneaky Fields,3,4,7
15705,2022-12-29,DARRYL,hotZone,Controller Chaos,0,1,1
15706,2022-12-29,DARRYL,heist,Hot Potato,3,0,3
15707,2022-12-29,DARRYL,gemGrab,Gem Fort,0,1,1
15708,2022-12-29,DARRYL,brawlBall,Pinhole Punt,0,12,12
15709,2022-12-27,DARRYL,hotZone,Dueling Beetles,0,1,1
15710,2022-12-27,DARRYL,brawlBall,Beach Ball,0,1,1
15711,2022-12-26,DARRYL,gemGrab,Minecart Madness,1,0,1
15712,2022-12-22,DARRYL,gemGrab,Gem Fort,0,1,1
15713,2022-12-19,DARRYL,gemGrab,Minecart Madness,0,2,2
15714,2022-12-19,DARRYL,brawlBall,Center Stage,1,1,2
15715,2022-12-16,DARRYL,brawlBall,Sneaky Fields,0,1,1
15716,2022-12-13,DARRYL,heist,Safe Zone,1,0,1
15717,2022-12-13,DARRYL,brawlBall,Beach Ball,1,0,1
15718,2022-12-12,DARRYL,brawlBall,Center Stage,0,2,2
15719,2022-11-19,DARRYL,brawlBall,Sneaky Fields,0,2,2
15720,2022-11-11,DARRYL,brawlBall,Sneaky Fields,0,2,2
15721,2022-11-03,DARRYL,brawlBall,Pinhole Punt,2,0,2
15722,2022-10-28,DARRYL,heist,Safe Zone,2,0,2
15723,2022-10-28,DARRYL,bounty,Canal Grande,2,0,2
15724,2022-10-26,DARRYL,brawlBall,Sunny Soccer,2,0,2
15725,2022-10-15,DARRYL,gemGrab,Hard Rock Mine,1,0,1
15726,2022-09-07,DARRYL,brawlBall,Sunny Soccer,2,0,2
15727,2022-09-07,DARRYL,brawlBall,Pinhole Punt,2,0,2
15728,2022-09-06,DARRYL,brawlBall,Beach Ball,0,2,2
15729,2023-02-11,CROW,knockout,Flaring Phoenix,66,35,101
15730,2023-02-11,CROW,hotZone,Controller Chaos,77,71,148
15731,2023-02-11,CROW,gemGrab,Deep Diner,153,95,248
15732,2023-02-11,CROW,brawlBall,Super Beach,196,167,363
15733,2023-02-11,CROW,brawlBall,Sneaky Fields,81,79,160
15734,2023-02-10,CROW,knockout,Flaring Phoenix,213,120,333
15735,2023-02-10,CROW,hotZone,Controller Chaos,134,79,213
15736,2023-02-10,CROW,heist,Hot Potato,23,11,34
15737,2023-02-10,CROW,gemGrab,Undermine,113,94,207
15738,2023-02-10,CROW,gemGrab,Deep Diner,330,267,597
15739,2023-02-10,CROW,brawlBall,Sneaky Fields,712,683,1395
15740,2023-02-10,CROW,brawlBall,Pinhole Punt,35,40,75
15741,2023-02-10,CROW,bounty,Temple Ruins,165,111,276
15742,2023-02-09,CROW,knockout,Riverside,16,7,23
15743,2023-02-09,CROW,hotZone,Open Zone,60,76,136
15744,2023-02-09,CROW,heist,Hot Potato,5,6,11
15745,2023-02-09,CROW,gemGrab,Undermine,113,94,207
15746,2023-02-09,CROW,gemGrab,Gem Fort,18,19,37
15747,2023-02-09,CROW,brawlBall,Sunny Soccer,3,0,3
15748,2023-02-09,CROW,brawlBall,Pinhole Punt,529,538,1067
15749,2023-02-09,CROW,bounty,Temple Ruins,57,63,120
15750,2023-02-08,CROW,knockout,Riverside,16,7,23
15751,2023-02-08,CROW,hotZone,Open Zone,56,59,115
15752,2023-02-08,CROW,heist,Safe Zone,4,5,9
15753,2023-02-08,CROW,gemGrab,Gem Fort,37,39,76
15754,2023-02-08,CROW,gemGrab,Crystal Arcade,13,12,25
15755,2023-02-08,CROW,brawlBall,Sunny Soccer,63,50,113
15756,2023-02-08,CROW,brawlBall,Beach Ball,2,8,10
15757,2023-02-08,CROW,bounty,Excel,5,8,13
15758,2023-02-07,CROW,knockout,New Perspective,17,3,20
15759,2023-02-07,CROW,hotZone,Dueling Beetles,26,26,52
15760,2023-02-07,CROW,heist,Safe Zone,1,0,1
15761,2023-02-07,CROW,gemGrab,Minecart Madness,23,15,38
15762,2023-02-07,CROW,gemGrab,Crystal Arcade,12,8,20
15763,2023-02-07,CROW,brawlBall,Center Stage,15,2,17
15764,2023-02-07,CROW,brawlBall,Beach Ball,63,55,118
15765,2023-02-07,CROW,bounty,Excel,2,1,3
15766,2023-02-06,CROW,knockout,New Perspective,367,197,564
15767,2023-02-06,CROW,knockout,Goldarm Gulch,1,0,1
15768,2023-02-06,CROW,hotZone,Dueling Beetles,305,325,630
15769,2023-02-06,CROW,heist,Snaked Assault,67,71,138
15770,2023-02-06,CROW,heist,Pit Stop,0,1,1
15771,2023-02-06,CROW,gemGrab,Minecart Madness,484,514,998
15772,2023-02-06,CROW,gemGrab,Double Swoosh,347,415,762
15773,2023-02-06,CROW,brawlBall,Sneaky Fields,6,11,17
15774,2023-02-06,CROW,brawlBall,Center Stage,1316,1052,2368
15775,2023-02-06,CROW,brawlBall,Backyard Bowl,269,219,488
15776,2023-02-06,CROW,bounty,Layer Cake,43,36,79
15777,2023-02-05,CROW,knockout,X Marks the Spot,112,60,172
15778,2023-02-05,CROW,knockout,Goldarm Gulch,12,11,23
15779,2023-02-05,CROW,hotZone,Ring of Fire,304,281,585
15780,2023-02-05,CROW,heist,Snaked Assault,115,107,222
15781,2023-02-05,CROW,heist,Pit Stop,1,1,2
15782,2023-02-05,CROW,gemGrab,Hard Rock Mine,83,76,159
15783,2023-02-05,CROW,gemGrab,Double Swoosh,926,1011,1937
15784,2023-02-05,CROW,brawlBall,Super Beach,26,24,50
15785,2023-02-05,CROW,brawlBall,Sneaky Fields,46,39,85
15786,2023-02-05,CROW,brawlBall,Backyard Bowl,2823,2772,5595
15787,2023-02-05,CROW,bounty,Layer Cake,67,22,89
15788,2023-02-04,CROW,knockout,X Marks the Spot,37,29,66
15789,2023-02-04,CROW,knockout,Goldarm Gulch,11,3,14
15790,2023-02-04,CROW,hotZone,Ring of Fire,62,69,131
15791,2023-02-04,CROW,heist,Tornado Ring,10,3,13
15792,2023-02-04,CROW,heist,Pit Stop,2,1,3
15793,2023-02-04,CROW,gemGrab,Hard Rock Mine,89,74,163
15794,2023-02-04,CROW,gemGrab,Double Swoosh,80,138,218
15795,2023-02-04,CROW,gemGrab,Deep Diner,26,22,48
15796,2023-02-04,CROW,brawlBall,Super Beach,257,196,453
15797,2023-02-04,CROW,brawlBall,Sneaky Fields,35,44,79
15798,2023-02-04,CROW,bounty,Dry Season,23,26,49
15799,2023-02-03,CROW,knockout,Out in the Open,267,147,414
15800,2023-02-03,CROW,knockout,Goldarm Gulch,48,24,72
15801,2023-02-03,CROW,hotZone,Split,42,14,56
15802,2023-02-03,CROW,heist,Tornado Ring,149,180,329
15803,2023-02-03,CROW,heist,Pit Stop,9,7,16
15804,2023-02-03,CROW,gemGrab,Undermine,182,140,322
15805,2023-02-03,CROW,gemGrab,Double Swoosh,348,710,1058
15806,2023-02-03,CROW,gemGrab,Deep Diner,404,315,719
15807,2023-02-03,CROW,brawlBall,Sneaky Fields,944,792,1736
15808,2023-02-03,CROW,brawlBall,Pinhole Punt,82,118,200
15809,2023-02-03,CROW,bounty,Dry Season,156,89,245
15810,2023-02-02,CROW,knockout,Out in the Open,115,58,173
15811,2023-02-02,CROW,hotZone,Split,22,4,26
15812,2023-02-02,CROW,heist,Kaboom Canyon,23,20,43
15813,2023-02-02,CROW,gemGrab,Undermine,111,109,220
15814,2023-02-02,CROW,gemGrab,Gem Fort,30,29,59
15815,2023-02-02,CROW,brawlBall,Sunny Soccer,13,26,39
15816,2023-02-02,CROW,brawlBall,Pinhole Punt,549,596,1145
15817,2023-02-02,CROW,bounty,Shooting Star,17,7,24
15818,2023-02-01,CROW,knockout,Goldarm Gulch,239,127,366
15819,2023-02-01,CROW,hotZone,Parallel Plays,130,83,213
15820,2023-02-01,CROW,heist,Kaboom Canyon,123,156,279
15821,2023-02-01,CROW,gemGrab,Gem Fort,375,391,766
15822,2023-02-01,CROW,gemGrab,Crystal Arcade,164,107,271
15823,2023-02-01,CROW,brawlBall,Sunny Soccer,710,581,1291
15824,2023-02-01,CROW,brawlBall,Beach Ball,45,30,75
15825,2023-02-01,CROW,bounty,Shooting Star,54,22,76
15826,2023-01-31,CROW,knockout,Goldarm Gulch,101,60,161
15827,2023-01-31,CROW,hotZone,Parallel Plays,51,31,82
15828,2023-01-31,CROW,heist,Pit Stop,8,6,14
15829,2023-01-31,CROW,gemGrab,Minecart Madness,28,19,47
15830,2023-01-31,CROW,gemGrab,Crystal Arcade,162,117,279
15831,2023-01-31,CROW,brawlBall,Center Stage,9,14,23
15832,2023-01-31,CROW,brawlBall,Beach Ball,430,434,864
15833,2023-01-31,CROW,bounty,Hideout,19,13,32
15834,2023-01-30,CROW,knockout,Belle's Rock,143,50,193
15835,2023-01-30,CROW,hotZone,Quarter Pounder,276,95,371
15836,2023-01-30,CROW,heist,Pit Stop,13,4,17
15837,2023-01-30,CROW,gemGrab,Minecart Madness,309,280,589
15838,2023-01-30,CROW,gemGrab,Double Swoosh,298,339,637
15839,2023-01-30,CROW,brawlBall,Center Stage,772,683,1455
15840,2023-01-30,CROW,brawlBall,Backyard Bowl,169,190,359
15841,2023-01-30,CROW,bounty,Hideout,41,22,63
15842,2023-01-29,CROW,knockout,Belle's Rock,130,56,186
15843,2023-01-29,CROW,hotZone,Quarter Pounder,144,48,192
15844,2023-01-29,CROW,heist,Bridge Too Far,36,9,45
15845,2023-01-29,CROW,gemGrab,Hard Rock Mine,61,32,93
15846,2023-01-29,CROW,gemGrab,Double Swoosh,468,458,926
15847,2023-01-29,CROW,brawlBall,Super Beach,19,10,29
15848,2023-01-29,CROW,brawlBall,Backyard Bowl,1865,1800,3665
15849,2023-01-29,CROW,bounty,Canal Grande,37,22,59
15850,2023-01-28,CROW,knockout,Flaring Phoenix,111,49,160
15851,2023-01-28,CROW,hotZone,Controller Chaos,81,43,124
15852,2023-01-28,CROW,heist,Bridge Too Far,81,44,125
15853,2023-01-28,CROW,gemGrab,Hard Rock Mine,316,227,543
15854,2023-01-28,CROW,gemGrab,Deep Diner,120,60,180
15855,2023-01-28,CROW,brawlBall,Super Beach,807,684,1491
15856,2023-01-28,CROW,brawlBall,Sneaky Fields,28,17,45
15857,2023-01-28,CROW,bounty,Canal Grande,62,48,110
15858,2023-01-27,CROW,knockout,Flaring Phoenix,68,40,108
15859,2023-01-27,CROW,hotZone,Controller Chaos,28,16,44
15860,2023-01-27,CROW,heist,Hot Potato,20,3,23
15861,2023-01-27,CROW,gemGrab,Undermine,32,31,63
15862,2023-01-27,CROW,gemGrab,Deep Diner,155,103,258
15863,2023-01-27,CROW,brawlBall,Sneaky Fields,175,191,366
15864,2023-01-27,CROW,brawlBall,Pinhole Punt,25,28,53
15865,2023-01-27,CROW,bounty,Temple Ruins,38,62,100
15866,2023-01-26,CROW,knockout,Riverside,178,69,247
15867,2023-01-26,CROW,hotZone,Open Zone,479,490,969
15868,2023-01-26,CROW,heist,Hot Potato,28,12,40
15869,2023-01-26,CROW,gemGrab,Undermine,341,299,640
15870,2023-01-26,CROW,gemGrab,Gem Fort,105,132,237
15871,2023-01-26,CROW,brawlBall,Sunny Soccer,46,47,93
15872,2023-01-26,CROW,brawlBall,Pinhole Punt,1776,1898,3674
15873,2023-01-26,CROW,bounty,Temple Ruins,101,100,201
15874,2023-01-25,CROW,knockout,Riverside,74,30,104
15875,2023-01-25,CROW,hotZone,Open Zone,297,328,625
15876,2023-01-25,CROW,heist,Safe Zone,74,56,130
15877,2023-01-25,CROW,gemGrab,Gem Fort,168,194,362
15878,2023-01-25,CROW,gemGrab,Crystal Arcade,189,105,294
15879,2023-01-25,CROW,brawlBall,Sunny Soccer,460,398,858
15880,2023-01-25,CROW,brawlBall,Beach Ball,107,85,192
15881,2023-01-25,CROW,bounty,Excel,27,12,39
15882,2023-01-24,CROW,knockout,New Perspective,173,75,248
15883,2023-01-24,CROW,hotZone,Dueling Beetles,100,74,174
15884,2023-01-24,CROW,heist,Safe Zone,76,39,115
15885,2023-01-24,CROW,gemGrab,Minecart Madness,94,89,183
15886,2023-01-24,CROW,gemGrab,Crystal Arcade,255,159,414
15887,2023-01-24,CROW,brawlBall,Center Stage,123,107,230
15888,2023-01-24,CROW,brawlBall,Beach Ball,913,831,1744
15889,2023-01-24,CROW,bounty,Excel,43,24,67
15890,2023-01-23,CROW,knockout,New Perspective,288,151,439
15891,2023-01-23,CROW,hotZone,Dueling Beetles,170,78,248
15892,2023-01-23,CROW,heist,Snaked Assault,64,32,96
15893,2023-01-23,CROW,gemGrab,Minecart Madness,486,546,1032
15894,2023-01-23,CROW,gemGrab,Double Swoosh,286,303,589
15895,2023-01-23,CROW,brawlBall,Center Stage,1215,1110,2325
15896,2023-01-23,CROW,brawlBall,Backyard Bowl,140,128,268
15897,2023-01-23,CROW,bounty,Layer Cake,41,25,66
15898,2023-01-22,CROW,knockout,X Marks the Spot,78,73,151
15899,2023-01-22,CROW,hotZone,Ring of Fire,175,211,386
15900,2023-01-22,CROW,heist,Snaked Assault,20,7,27
15901,2023-01-22,CROW,gemGrab,Hard Rock Mine,68,46,114
15902,2023-01-22,CROW,gemGrab,Double Swoosh,310,364,674
15903,2023-01-22,CROW,brawlBall,Super Beach,63,47,110
15904,2023-01-22,CROW,brawlBall,Backyard Bowl,978,928,1906
15905,2023-01-22,CROW,bounty,Layer Cake,28,15,43
15906,2023-01-21,CROW,knockout,X Marks the Spot,326,170,496
15907,2023-01-21,CROW,hotZone,Ring of Fire,466,510,976
15908,2023-01-21,CROW,heist,Tornado Ring,64,71,135
15909,2023-01-21,CROW,gemGrab,Hard Rock Mine,372,288,660
15910,2023-01-21,CROW,gemGrab,Deep Diner,120,84,204
15911,2023-01-21,CROW,brawlBall,Super Beach,1161,897,2058
15912,2023-01-21,CROW,brawlBall,Sneaky Fields,45,41,86
15913,2023-01-21,CROW,bounty,Dry Season,91,40,131
15914,2023-01-20,CROW,knockout,Out in the Open,289,159,448
15915,2023-01-20,CROW,hotZone,Split,40,10,50
15916,2023-01-20,CROW,heist,Tornado Ring,73,49,122
15917,2023-01-20,CROW,gemGrab,Undermine,206,191,397
15918,2023-01-20,CROW,gemGrab,Deep Diner,382,236,618
15919,2023-01-20,CROW,brawlBall,Sneaky Fields,727,605,1332
15920,2023-01-20,CROW,brawlBall,Pinhole Punt,75,69,144
15921,2023-01-20,CROW,bounty,Dry Season,98,53,151
15922,2023-01-19,CROW,knockout,Out in the Open,317,166,483
15923,2023-01-19,CROW,hotZone,Split,67,25,92
15924,2023-01-19,CROW,heist,Kaboom Canyon,96,108,204
15925,2023-01-19,CROW,gemGrab,Undermine,482,418,900
15926,2023-01-19,CROW,gemGrab,Gem Fort,86,66,152
15927,2023-01-19,CROW,brawlBall,Sunny Soccer,30,27,57
15928,2023-01-19,CROW,brawlBall,Pinhole Punt,1956,2052,4008
15929,2023-01-19,CROW,bounty,Shooting Star,75,41,116
15930,2023-01-18,CROW,knockout,Goldarm Gulch,29,16,45
15931,2023-01-18,CROW,hotZone,Parallel Plays,12,16,28
15932,2023-01-18,CROW,heist,Kaboom Canyon,63,53,116
15933,2023-01-18,CROW,gemGrab,Gem Fort,96,113,209
15934,2023-01-18,CROW,gemGrab,Crystal Arcade,26,14,40
15935,2023-01-18,CROW,brawlBall,Sunny Soccer,195,169,364
15936,2023-01-18,CROW,brawlBall,Beach Ball,19,16,35
15937,2023-01-18,CROW,bounty,Shooting Star,28,15,43
15938,2023-01-17,CROW,knockout,Goldarm Gulch,25,13,38
15939,2023-01-17,CROW,hotZone,Parallel Plays,5,5,10
15940,2023-01-17,CROW,heist,Pit Stop,4,0,4
15941,2023-01-17,CROW,gemGrab,Minecart Madness,5,3,8
15942,2023-01-17,CROW,gemGrab,Crystal Arcade,24,15,39
15943,2023-01-17,CROW,brawlBall,Center Stage,1,3,4
15944,2023-01-17,CROW,brawlBall,Beach Ball,71,72,143
15945,2023-01-17,CROW,bounty,Hideout,7,1,8
15946,2023-01-16,CROW,knockout,Belle's Rock,10,1,11
15947,2023-01-16,CROW,hotZone,Quarter Pounder,28,7,35
15948,2023-01-16,CROW,heist,Pit Stop,6,0,6
15949,2023-01-16,CROW,gemGrab,Minecart Madness,43,55,98
15950,2023-01-16,CROW,gemGrab,Double Swoosh,22,9,31
15951,2023-01-16,CROW,brawlBall,Center Stage,72,68,140
15952,2023-01-16,CROW,brawlBall,Backyard Bowl,34,25,59
15953,2023-01-16,CROW,bounty,Hideout,15,4,19
15954,2023-01-15,CROW,knockout,Belle's Rock,12,6,18
15955,2023-01-15,CROW,hotZone,Quarter Pounder,62,23,85
15956,2023-01-15,CROW,heist,Bridge Too Far,8,0,8
15957,2023-01-15,CROW,gemGrab,Hard Rock Mine,18,12,30
15958,2023-01-15,CROW,gemGrab,Double Swoosh,68,88,156
15959,2023-01-15,CROW,brawlBall,Super Beach,12,3,15
15960,2023-01-15,CROW,brawlBall,Backyard Bowl,324,374,698
15961,2023-01-15,CROW,bounty,Canal Grande,2,2,4
15962,2023-01-14,CROW,knockout,Flaring Phoenix,5,7,12
15963,2023-01-14,CROW,hotZone,Controller Chaos,33,15,48
15964,2023-01-14,CROW,heist,Bridge Too Far,12,1,13
15965,2023-01-14,CROW,gemGrab,Hard Rock Mine,32,4,36
15966,2023-01-14,CROW,gemGrab,Deep Diner,20,13,33
15967,2023-01-14,CROW,brawlBall,Super Beach,81,48,129
15968,2023-01-14,CROW,brawlBall,Sneaky Fields,6,0,6
15969,2023-01-14,CROW,bounty,Canal Grande,8,3,11
15970,2023-01-13,CROW,knockout,Flaring Phoenix,13,7,20
15971,2023-01-13,CROW,hotZone,Controller Chaos,21,5,26
15972,2023-01-13,CROW,heist,Hot Potato,1,0,1
15973,2023-01-13,CROW,gemGrab,Undermine,1,2,3
15974,2023-01-13,CROW,gemGrab,Deep Diner,51,12,63
15975,2023-01-13,CROW,brawlBall,Sneaky Fields,55,62,117
15976,2023-01-13,CROW,brawlBall,Pinhole Punt,4,9,13
15977,2023-01-13,CROW,bounty,Temple Ruins,4,5,9
15978,2023-01-12,CROW,knockout,Riverside,12,1,13
15979,2023-01-12,CROW,hotZone,Open Zone,68,113,181
15980,2023-01-12,CROW,heist,Hot Potato,0,1,1
15981,2023-01-12,CROW,gemGrab,Undermine,19,32,51
15982,2023-01-12,CROW,gemGrab,Gem Fort,3,1,4
15983,2023-01-12,CROW,brawlBall,Sunny Soccer,1,0,1
15984,2023-01-12,CROW,brawlBall,Pinhole Punt,74,55,129
15985,2023-01-12,CROW,bounty,Temple Ruins,1,0,1
15986,2023-01-11,CROW,hotZone,Open Zone,31,28,59
15987,2023-01-11,CROW,gemGrab,Gem Fort,10,3,13
15988,2023-01-11,CROW,brawlBall,Sunny Soccer,16,9,25
15989,2023-01-11,CROW,brawlBall,Beach Ball,1,0,1
15990,2023-01-11,CROW,bounty,Excel,1,0,1
15991,2023-01-10,CROW,knockout,New Perspective,17,1,18
15992,2023-01-10,CROW,hotZone,Dueling Beetles,36,19,55
15993,2023-01-10,CROW,heist,Safe Zone,5,2,7
15994,2023-01-10,CROW,gemGrab,Minecart Madness,30,24,54
15995,2023-01-10,CROW,gemGrab,Crystal Arcade,49,24,73
15996,2023-01-10,CROW,brawlBall,Center Stage,14,24,38
15997,2023-01-10,CROW,brawlBall,Beach Ball,85,52,137
15998,2023-01-10,CROW,bounty,Excel,4,0,4
15999,2023-01-09,CROW,knockout,New Perspective,9,2,11
16000,2023-01-09,CROW,hotZone,Dueling Beetles,10,9,19
16001,2023-01-09,CROW,heist,Snaked Assault,7,3,10
16002,2023-01-09,CROW,gemGrab,Minecart Madness,45,41,86
16003,2023-01-09,CROW,gemGrab,Double Swoosh,44,35,79
16004,2023-01-09,CROW,brawlBall,Center Stage,57,50,107
16005,2023-01-09,CROW,brawlBall,Backyard Bowl,17,2,19
16006,2023-01-09,CROW,bounty,Layer Cake,8,2,10
16007,2023-01-08,CROW,knockout,X Marks the Spot,18,0,18
16008,2023-01-08,CROW,hotZone,Ring of Fire,37,17,54
16009,2023-01-08,CROW,heist,Snaked Assault,3,3,6
16010,2023-01-08,CROW,gemGrab,Hard Rock Mine,4,7,11
16011,2023-01-08,CROW,gemGrab,Double Swoosh,26,45,71
16012,2023-01-08,CROW,brawlBall,Super Beach,6,5,11
16013,2023-01-08,CROW,brawlBall,Backyard Bowl,202,177,379
16014,2023-01-08,CROW,bounty,Layer Cake,2,1,3
16015,2023-01-07,CROW,knockout,X Marks the Spot,5,1,6
16016,2023-01-07,CROW,hotZone,Ring of Fire,33,17,50
16017,2023-01-07,CROW,heist,Tornado Ring,12,5,17
16018,2023-01-07,CROW,gemGrab,Hard Rock Mine,19,6,25
16019,2023-01-07,CROW,gemGrab,Deep Diner,13,23,36
16020,2023-01-07,CROW,brawlBall,Super Beach,25,13,38
16021,2023-01-07,CROW,brawlBall,Sneaky Fields,3,0,3
16022,2023-01-07,CROW,bounty,Dry Season,3,2,5
16023,2023-01-06,CROW,knockout,Out in the Open,22,9,31
16024,2023-01-06,CROW,hotZone,Split,4,0,4
16025,2023-01-06,CROW,heist,Tornado Ring,11,18,29
16026,2023-01-06,CROW,gemGrab,Undermine,14,7,21
16027,2023-01-06,CROW,gemGrab,Deep Diner,47,23,70
16028,2023-01-06,CROW,brawlBall,Sneaky Fields,46,16,62
16029,2023-01-06,CROW,brawlBall,Pinhole Punt,23,25,48
16030,2023-01-06,CROW,bounty,Dry Season,5,0,5
16031,2023-01-05,CROW,knockout,Out in the Open,29,16,45
16032,2023-01-05,CROW,hotZone,Split,16,5,21
16033,2023-01-05,CROW,heist,Kaboom Canyon,15,2,17
16034,2023-01-05,CROW,gemGrab,Undermine,71,45,116
16035,2023-01-05,CROW,gemGrab,Gem Fort,10,13,23
16036,2023-01-05,CROW,brawlBall,Sunny Soccer,1,1,2
16037,2023-01-05,CROW,brawlBall,Pinhole Punt,267,239,506
16038,2023-01-05,CROW,bounty,Shooting Star,10,3,13
16039,2023-01-04,CROW,knockout,Goldarm Gulch,12,11,23
16040,2023-01-04,CROW,hotZone,Parallel Plays,9,1,10
16041,2023-01-04,CROW,heist,Kaboom Canyon,39,44,83
16042,2023-01-04,CROW,gemGrab,Gem Fort,81,84,165
16043,2023-01-04,CROW,gemGrab,Crystal Arcade,18,15,33
16044,2023-01-04,CROW,brawlBall,Sunny Soccer,56,27,83
16045,2023-01-04,CROW,brawlBall,Beach Ball,1,0,1
16046,2023-01-04,CROW,bounty,Shooting Star,14,2,16
16047,2023-01-03,CROW,knockout,Goldarm Gulch,4,0,4
16048,2023-01-03,CROW,hotZone,Parallel Plays,17,5,22
16049,2023-01-03,CROW,heist,Pit Stop,3,0,3
16050,2023-01-03,CROW,gemGrab,Minecart Madness,17,5,22
16051,2023-01-03,CROW,gemGrab,Crystal Arcade,43,10,53
16052,2023-01-03,CROW,brawlBall,Center Stage,3,1,4
16053,2023-01-03,CROW,brawlBall,Beach Ball,98,71,169
16054,2023-01-03,CROW,bounty,Hideout,6,0,6
16055,2023-01-02,CROW,knockout,Belle's Rock,15,1,16
16056,2023-01-02,CROW,hotZone,Quarter Pounder,43,15,58
16057,2023-01-02,CROW,heist,Pit Stop,1,0,1
16058,2023-01-02,CROW,heist,Kaboom Canyon,0,1,1
16059,2023-01-02,CROW,gemGrab,Minecart Madness,85,90,175
16060,2023-01-02,CROW,gemGrab,Double Swoosh,34,21,55
16061,2023-01-02,CROW,brawlBall,Center Stage,89,86,175
16062,2023-01-02,CROW,brawlBall,Backyard Bowl,11,13,24
16063,2023-01-02,CROW,bounty,Hideout,18,1,19
16064,2023-01-01,CROW,knockout,Belle's Rock,2,2,4
16065,2023-01-01,CROW,hotZone,Quarter Pounder,10,2,12
16066,2023-01-01,CROW,heist,Bridge Too Far,1,0,1
16067,2023-01-01,CROW,gemGrab,Hard Rock Mine,1,0,1
16068,2023-01-01,CROW,gemGrab,Double Swoosh,27,19,46
16069,2023-01-01,CROW,brawlBall,Backyard Bowl,96,91,187
16070,2023-01-01,CROW,bounty,Canal Grande,2,0,2
16071,2022-12-31,CROW,hotZone,Controller Chaos,2,0,2
16072,2022-12-31,CROW,gemGrab,Hard Rock Mine,8,5,13
16073,2022-12-31,CROW,gemGrab,Deep Diner,8,2,10
16074,2022-12-31,CROW,brawlBall,Super Beach,2,3,5
16075,2022-12-31,CROW,brawlBall,Sneaky Fields,0,1,1
16076,2022-12-30,CROW,knockout,Flaring Phoenix,0,2,2
16077,2022-12-30,CROW,hotZone,Controller Chaos,7,0,7
16078,2022-12-30,CROW,gemGrab,Undermine,5,1,6
16079,2022-12-30,CROW,gemGrab,Minecart Madness,0,1,1
16080,2022-12-30,CROW,gemGrab,Deep Diner,4,1,5
16081,2022-12-30,CROW,brawlBall,Sneaky Fields,3,1,4
16082,2022-12-29,CROW,hotZone,Open Zone,1,5,6
16083,2022-12-29,CROW,gemGrab,Undermine,2,0,2
16084,2022-12-29,CROW,gemGrab,Gem Fort,1,1,2
16085,2022-12-29,CROW,brawlBall,Pinhole Punt,8,4,12
16086,2022-12-28,CROW,hotZone,Open Zone,8,5,13
16087,2022-12-28,CROW,brawlBall,Sunny Soccer,0,2,2
16088,2022-12-28,CROW,brawlBall,Beach Ball,2,2,4
16089,2022-12-27,CROW,knockout,New Perspective,2,0,2
16090,2022-12-27,CROW,hotZone,Controller Chaos,2,0,2
16091,2022-12-27,CROW,gemGrab,Minecart Madness,2,0,2
16092,2022-12-27,CROW,brawlBall,Beach Ball,0,4,4
16093,2022-12-26,CROW,gemGrab,Minecart Madness,1,1,2
16094,2022-12-26,CROW,brawlBall,Center Stage,1,0,1
16095,2022-12-25,CROW,gemGrab,Double Swoosh,1,2,3
16096,2022-12-25,CROW,brawlBall,Backyard Bowl,3,0,3
16097,2022-12-24,CROW,brawlBall,Super Beach,1,1,2
16098,2022-12-24,CROW,bounty,Dry Season,0,1,1
16099,2022-12-23,CROW,knockout,Out in the Open,10,0,10
16100,2022-12-22,CROW,heist,Kaboom Canyon,0,1,1
16101,2022-12-22,CROW,gemGrab,Gem Fort,5,0,5
16102,2022-12-22,CROW,brawlBall,Pinhole Punt,4,0,4
16103,2022-12-21,CROW,brawlBall,Sunny Soccer,0,1,1
16104,2022-12-20,CROW,brawlBall,Beach Ball,1,0,1
16105,2022-12-19,CROW,gemGrab,Minecart Madness,4,6,10
16106,2022-12-16,CROW,brawlBall,Sneaky Fields,0,3,3
16107,2022-12-13,CROW,knockout,New Perspective,2,0,2
16108,2022-12-13,CROW,heist,Safe Zone,1,0,1
16109,2022-12-13,CROW,gemGrab,Crystal Arcade,0,2,2
16110,2022-12-13,CROW,brawlBall,Beach Ball,2,1,3
16111,2022-12-11,CROW,gemGrab,Double Swoosh,0,2,2
16112,2022-12-10,CROW,gemGrab,Hard Rock Mine,0,1,1
16113,2022-11-03,CROW,bounty,Temple Ruins,0,2,2
16114,2022-11-01,CROW,knockout,New Perspective,2,0,2
16115,2022-10-30,CROW,knockout,Out in the Open,1,0,1
16116,2022-10-28,CROW,brawlBall,Beach Ball,0,4,4
16117,2022-10-28,CROW,bounty,Canal Grande,2,0,2
16118,2022-10-15,CROW,gemGrab,Hard Rock Mine,0,1,1
16119,2022-09-07,CROW,brawlBall,Sunny Soccer,0,2,2
16120,2023-02-11,COLT,knockout,Flaring Phoenix,58,41,99
16121,2023-02-11,COLT,hotZone,Controller Chaos,47,12,59
16122,2023-02-11,COLT,gemGrab,Deep Diner,56,37,93
16123,2023-02-11,COLT,brawlBall,Super Beach,168,157,325
16124,2023-02-11,COLT,brawlBall,Sneaky Fields,75,45,120
16125,2023-02-10,COLT,knockout,Flaring Phoenix,139,89,228
16126,2023-02-10,COLT,hotZone,Controller Chaos,44,22,66
16127,2023-02-10,COLT,heist,Hot Potato,354,371,725
16128,2023-02-10,COLT,gemGrab,Undermine,35,32,67
16129,2023-02-10,COLT,gemGrab,Deep Diner,141,122,263
16130,2023-02-10,COLT,brawlBall,Sneaky Fields,635,494,1129
16131,2023-02-10,COLT,brawlBall,Pinhole Punt,21,12,33
16132,2023-02-10,COLT,bounty,Temple Ruins,60,54,114
16133,2023-02-09,COLT,knockout,Riverside,48,27,75
16134,2023-02-09,COLT,hotZone,Open Zone,17,10,27
16135,2023-02-09,COLT,heist,Hot Potato,166,185,351
16136,2023-02-09,COLT,gemGrab,Undermine,27,22,49
16137,2023-02-09,COLT,gemGrab,Gem Fort,3,9,12
16138,2023-02-09,COLT,brawlBall,Sunny Soccer,3,0,3
16139,2023-02-09,COLT,brawlBall,Pinhole Punt,291,254,545
16140,2023-02-09,COLT,bounty,Temple Ruins,19,8,27
16141,2023-02-08,COLT,knockout,Riverside,19,16,35
16142,2023-02-08,COLT,hotZone,Open Zone,5,6,11
16143,2023-02-08,COLT,heist,Safe Zone,62,52,114
16144,2023-02-08,COLT,gemGrab,Gem Fort,17,16,33
16145,2023-02-08,COLT,gemGrab,Crystal Arcade,5,1,6
16146,2023-02-08,COLT,brawlBall,Sunny Soccer,60,54,114
16147,2023-02-08,COLT,brawlBall,Beach Ball,6,3,9
16148,2023-02-08,COLT,bounty,Excel,6,6,12
16149,2023-02-07,COLT,knockout,New Perspective,8,7,15
16150,2023-02-07,COLT,hotZone,Dueling Beetles,9,4,13
16151,2023-02-07,COLT,heist,Safe Zone,35,57,92
16152,2023-02-07,COLT,gemGrab,Minecart Madness,7,6,13
16153,2023-02-07,COLT,gemGrab,Crystal Arcade,4,2,6
16154,2023-02-07,COLT,brawlBall,Center Stage,8,4,12
16155,2023-02-07,COLT,brawlBall,Beach Ball,49,40,89
16156,2023-02-07,COLT,bounty,Excel,1,0,1
16157,2023-02-06,COLT,knockout,New Perspective,168,129,297
16158,2023-02-06,COLT,knockout,Goldarm Gulch,8,6,14
16159,2023-02-06,COLT,hotZone,Dueling Beetles,127,93,220
16160,2023-02-06,COLT,heist,Snaked Assault,823,966,1789
16161,2023-02-06,COLT,heist,Pit Stop,23,37,60
16162,2023-02-06,COLT,gemGrab,Minecart Madness,197,131,328
16163,2023-02-06,COLT,gemGrab,Double Swoosh,64,50,114
16164,2023-02-06,COLT,brawlBall,Sneaky Fields,4,7,11
16165,2023-02-06,COLT,brawlBall,Center Stage,1051,869,1920
16166,2023-02-06,COLT,brawlBall,Backyard Bowl,186,158,344
16167,2023-02-06,COLT,bounty,Layer Cake,30,17,47
16168,2023-02-05,COLT,knockout,X Marks the Spot,132,70,202
16169,2023-02-05,COLT,knockout,Goldarm Gulch,18,7,25
16170,2023-02-05,COLT,hotZone,Ring of Fire,46,18,64
16171,2023-02-05,COLT,heist,Snaked Assault,1377,1599,2976
16172,2023-02-05,COLT,heist,Pit Stop,77,93,170
16173,2023-02-05,COLT,gemGrab,Hard Rock Mine,26,11,37
16174,2023-02-05,COLT,gemGrab,Double Swoosh,143,121,264
16175,2023-02-05,COLT,brawlBall,Super Beach,26,28,54
16176,2023-02-05,COLT,brawlBall,Sneaky Fields,16,21,37
16177,2023-02-05,COLT,brawlBall,Backyard Bowl,2210,1880,4090
16178,2023-02-05,COLT,bounty,Layer Cake,33,20,53
16179,2023-02-04,COLT,knockout,X Marks the Spot,51,28,79
16180,2023-02-04,COLT,knockout,Goldarm Gulch,9,4,13
16181,2023-02-04,COLT,hotZone,Ring of Fire,5,8,13
16182,2023-02-04,COLT,heist,Tornado Ring,115,91,206
16183,2023-02-04,COLT,heist,Pit Stop,50,51,101
16184,2023-02-04,COLT,gemGrab,Hard Rock Mine,29,13,42
16185,2023-02-04,COLT,gemGrab,Double Swoosh,21,9,30
16186,2023-02-04,COLT,gemGrab,Deep Diner,12,6,18
16187,2023-02-04,COLT,brawlBall,Super Beach,262,196,458
16188,2023-02-04,COLT,brawlBall,Sneaky Fields,9,7,16
16189,2023-02-04,COLT,bounty,Dry Season,24,9,33
16190,2023-02-03,COLT,knockout,Out in the Open,229,176,405
16191,2023-02-03,COLT,knockout,Goldarm Gulch,38,31,69
16192,2023-02-03,COLT,hotZone,Split,34,41,75
16193,2023-02-03,COLT,heist,Tornado Ring,998,1055,2053
16194,2023-02-03,COLT,heist,Pit Stop,317,296,613
16195,2023-02-03,COLT,gemGrab,Undermine,24,10,34
16196,2023-02-03,COLT,gemGrab,Double Swoosh,89,64,153
16197,2023-02-03,COLT,gemGrab,Deep Diner,159,122,281
16198,2023-02-03,COLT,brawlBall,Sneaky Fields,742,568,1310
16199,2023-02-03,COLT,brawlBall,Pinhole Punt,43,34,77
16200,2023-02-03,COLT,bounty,Dry Season,146,92,238
16201,2023-02-02,COLT,knockout,Out in the Open,77,61,138
16202,2023-02-02,COLT,hotZone,Split,28,17,45
16203,2023-02-02,COLT,heist,Kaboom Canyon,101,127,228
16204,2023-02-02,COLT,gemGrab,Undermine,29,24,53
16205,2023-02-02,COLT,gemGrab,Gem Fort,7,3,10
16206,2023-02-02,COLT,brawlBall,Sunny Soccer,10,7,17
16207,2023-02-02,COLT,brawlBall,Pinhole Punt,333,308,641
16208,2023-02-02,COLT,bounty,Shooting Star,33,29,62
16209,2023-02-01,COLT,knockout,Goldarm Gulch,166,111,277
16210,2023-02-01,COLT,hotZone,Parallel Plays,46,23,69
16211,2023-02-01,COLT,heist,Kaboom Canyon,396,445,841
16212,2023-02-01,COLT,gemGrab,Gem Fort,98,48,146
16213,2023-02-01,COLT,gemGrab,Crystal Arcade,72,53,125
16214,2023-02-01,COLT,brawlBall,Sunny Soccer,672,527,1199
16215,2023-02-01,COLT,brawlBall,Beach Ball,35,36,71
16216,2023-02-01,COLT,bounty,Shooting Star,76,43,119
16217,2023-01-31,COLT,knockout,Goldarm Gulch,70,51,121
16218,2023-01-31,COLT,hotZone,Parallel Plays,28,13,41
16219,2023-01-31,COLT,heist,Pit Stop,104,95,199
16220,2023-01-31,COLT,gemGrab,Minecart Madness,12,14,26
16221,2023-01-31,COLT,gemGrab,Crystal Arcade,37,40,77
16222,2023-01-31,COLT,brawlBall,Center Stage,12,5,17
16223,2023-01-31,COLT,brawlBall,Beach Ball,383,328,711
16224,2023-01-31,COLT,bounty,Hideout,31,32,63
16225,2023-01-30,COLT,knockout,Belle's Rock,208,136,344
16226,2023-01-30,COLT,hotZone,Quarter Pounder,71,39,110
16227,2023-01-30,COLT,heist,Pit Stop,369,326,695
16228,2023-01-30,COLT,gemGrab,Minecart Madness,113,93,206
16229,2023-01-30,COLT,gemGrab,Double Swoosh,50,39,89
16230,2023-01-30,COLT,brawlBall,Center Stage,566,521,1087
16231,2023-01-30,COLT,brawlBall,Backyard Bowl,179,124,303
16232,2023-01-30,COLT,bounty,Hideout,75,49,124
16233,2023-01-29,COLT,knockout,Belle's Rock,208,142,350
16234,2023-01-29,COLT,hotZone,Quarter Pounder,48,35,83
16235,2023-01-29,COLT,heist,Bridge Too Far,986,979,1965
16236,2023-01-29,COLT,gemGrab,Hard Rock Mine,13,3,16
16237,2023-01-29,COLT,gemGrab,Double Swoosh,85,66,151
16238,2023-01-29,COLT,brawlBall,Super Beach,17,16,33
16239,2023-01-29,COLT,brawlBall,Backyard Bowl,1610,1394,3004
16240,2023-01-29,COLT,bounty,Canal Grande,13,11,24
16241,2023-01-28,COLT,knockout,Flaring Phoenix,81,77,158
16242,2023-01-28,COLT,hotZone,Controller Chaos,35,24,59
16243,2023-01-28,COLT,heist,Bridge Too Far,2014,2106,4120
16244,2023-01-28,COLT,gemGrab,Hard Rock Mine,83,44,127
16245,2023-01-28,COLT,gemGrab,Deep Diner,56,32,88
16246,2023-01-28,COLT,brawlBall,Super Beach,864,810,1674
16247,2023-01-28,COLT,brawlBall,Sneaky Fields,24,21,45
16248,2023-01-28,COLT,bounty,Canal Grande,40,18,58
16249,2023-01-27,COLT,knockout,Flaring Phoenix,40,27,67
16250,2023-01-27,COLT,hotZone,Controller Chaos,5,4,9
16251,2023-01-27,COLT,heist,Hot Potato,117,116,233
16252,2023-01-27,COLT,gemGrab,Undermine,9,2,11
16253,2023-01-27,COLT,gemGrab,Deep Diner,67,37,104
16254,2023-01-27,COLT,brawlBall,Sneaky Fields,222,205,427
16255,2023-01-27,COLT,brawlBall,Pinhole Punt,13,11,24
16256,2023-01-27,COLT,bounty,Temple Ruins,17,9,26
16257,2023-01-26,COLT,knockout,Riverside,287,232,519
16258,2023-01-26,COLT,hotZone,Open Zone,69,52,121
16259,2023-01-26,COLT,heist,Hot Potato,672,670,1342
16260,2023-01-26,COLT,gemGrab,Undermine,64,39,103
16261,2023-01-26,COLT,gemGrab,Gem Fort,45,41,86
16262,2023-01-26,COLT,brawlBall,Sunny Soccer,45,39,84
16263,2023-01-26,COLT,brawlBall,Pinhole Punt,992,763,1755
16264,2023-01-26,COLT,bounty,Temple Ruins,39,30,69
16265,2023-01-25,COLT,knockout,Riverside,130,92,222
16266,2023-01-25,COLT,hotZone,Open Zone,37,15,52
16267,2023-01-25,COLT,heist,Safe Zone,526,611,1137
16268,2023-01-25,COLT,gemGrab,Gem Fort,43,38,81
16269,2023-01-25,COLT,gemGrab,Crystal Arcade,75,33,108
16270,2023-01-25,COLT,brawlBall,Sunny Soccer,477,414,891
16271,2023-01-25,COLT,brawlBall,Beach Ball,54,54,108
16272,2023-01-25,COLT,bounty,Excel,26,11,37
16273,2023-01-24,COLT,knockout,New Perspective,103,63,166
16274,2023-01-24,COLT,hotZone,Dueling Beetles,49,53,102
16275,2023-01-24,COLT,heist,Safe Zone,1152,1203,2355
16276,2023-01-24,COLT,gemGrab,Minecart Madness,32,42,74
16277,2023-01-24,COLT,gemGrab,Crystal Arcade,96,69,165
16278,2023-01-24,COLT,brawlBall,Center Stage,108,74,182
16279,2023-01-24,COLT,brawlBall,Beach Ball,838,779,1617
16280,2023-01-24,COLT,bounty,Excel,47,32,79
16281,2023-01-23,COLT,knockout,New Perspective,162,105,267
16282,2023-01-23,COLT,hotZone,Dueling Beetles,66,70,136
16283,2023-01-23,COLT,heist,Snaked Assault,933,1134,2067
16284,2023-01-23,COLT,gemGrab,Minecart Madness,172,112,284
16285,2023-01-23,COLT,gemGrab,Double Swoosh,46,53,99
16286,2023-01-23,COLT,brawlBall,Center Stage,1098,921,2019
16287,2023-01-23,COLT,brawlBall,Backyard Bowl,91,84,175
16288,2023-01-23,COLT,bounty,Layer Cake,47,32,79
16289,2023-01-22,COLT,knockout,X Marks the Spot,88,86,174
16290,2023-01-22,COLT,hotZone,Ring of Fire,27,11,38
16291,2023-01-22,COLT,heist,Snaked Assault,535,569,1104
16292,2023-01-22,COLT,gemGrab,Hard Rock Mine,32,15,47
16293,2023-01-22,COLT,gemGrab,Double Swoosh,30,29,59
16294,2023-01-22,COLT,brawlBall,Super Beach,81,64,145
16295,2023-01-22,COLT,brawlBall,Backyard Bowl,930,773,1703
16296,2023-01-22,COLT,bounty,Layer Cake,18,16,34
16297,2023-01-21,COLT,knockout,X Marks the Spot,311,244,555
16298,2023-01-21,COLT,hotZone,Ring of Fire,71,26,97
16299,2023-01-21,COLT,heist,Tornado Ring,532,548,1080
16300,2023-01-21,COLT,gemGrab,Hard Rock Mine,125,71,196
16301,2023-01-21,COLT,gemGrab,Deep Diner,38,33,71
16302,2023-01-21,COLT,brawlBall,Super Beach,1095,977,2072
16303,2023-01-21,COLT,brawlBall,Sneaky Fields,22,24,46
16304,2023-01-21,COLT,bounty,Dry Season,96,57,153
16305,2023-01-20,COLT,knockout,Out in the Open,214,160,374
16306,2023-01-20,COLT,hotZone,Split,31,26,57
16307,2023-01-20,COLT,heist,Tornado Ring,634,636,1270
16308,2023-01-20,COLT,gemGrab,Undermine,46,21,67
16309,2023-01-20,COLT,gemGrab,Deep Diner,165,136,301
16310,2023-01-20,COLT,brawlBall,Sneaky Fields,603,458,1061
16311,2023-01-20,COLT,brawlBall,Pinhole Punt,46,27,73
16312,2023-01-20,COLT,bounty,Dry Season,81,58,139
16313,2023-01-19,COLT,knockout,Out in the Open,232,214,446
16314,2023-01-19,COLT,hotZone,Split,62,37,99
16315,2023-01-19,COLT,heist,Kaboom Canyon,357,381,738
16316,2023-01-19,COLT,gemGrab,Undermine,80,64,144
16317,2023-01-19,COLT,gemGrab,Gem Fort,33,25,58
16318,2023-01-19,COLT,brawlBall,Sunny Soccer,31,22,53
16319,2023-01-19,COLT,brawlBall,Pinhole Punt,1103,1009,2112
16320,2023-01-19,COLT,bounty,Shooting Star,123,72,195
16321,2023-01-18,COLT,knockout,Goldarm Gulch,33,24,57
16322,2023-01-18,COLT,hotZone,Parallel Plays,4,4,8
16323,2023-01-18,COLT,heist,Kaboom Canyon,176,151,327
16324,2023-01-18,COLT,gemGrab,Gem Fort,30,22,52
16325,2023-01-18,COLT,gemGrab,Crystal Arcade,8,6,14
16326,2023-01-18,COLT,brawlBall,Sunny Soccer,202,226,428
16327,2023-01-18,COLT,brawlBall,Beach Ball,12,12,24
16328,2023-01-18,COLT,bounty,Shooting Star,51,39,90
16329,2023-01-17,COLT,knockout,Goldarm Gulch,20,15,35
16330,2023-01-17,COLT,hotZone,Parallel Plays,6,0,6
16331,2023-01-17,COLT,heist,Pit Stop,45,54,99
16332,2023-01-17,COLT,gemGrab,Minecart Madness,1,2,3
16333,2023-01-17,COLT,gemGrab,Crystal Arcade,8,5,13
16334,2023-01-17,COLT,brawlBall,Center Stage,3,1,4
16335,2023-01-17,COLT,brawlBall,Beach Ball,70,56,126
16336,2023-01-17,COLT,bounty,Hideout,9,5,14
16337,2023-01-16,COLT,knockout,Belle's Rock,10,11,21
16338,2023-01-16,COLT,hotZone,Quarter Pounder,11,1,12
16339,2023-01-16,COLT,heist,Pit Stop,104,92,196
16340,2023-01-16,COLT,gemGrab,Minecart Madness,6,5,11
16341,2023-01-16,COLT,gemGrab,Double Swoosh,2,1,3
16342,2023-01-16,COLT,brawlBall,Center Stage,41,31,72
16343,2023-01-16,COLT,brawlBall,Backyard Bowl,25,11,36
16344,2023-01-16,COLT,bounty,Hideout,13,8,21
16345,2023-01-15,COLT,knockout,Belle's Rock,22,11,33
16346,2023-01-15,COLT,hotZone,Quarter Pounder,10,0,10
16347,2023-01-15,COLT,heist,Bridge Too Far,231,219,450
16348,2023-01-15,COLT,gemGrab,Hard Rock Mine,3,1,4
16349,2023-01-15,COLT,gemGrab,Double Swoosh,6,2,8
16350,2023-01-15,COLT,brawlBall,Super Beach,21,14,35
16351,2023-01-15,COLT,brawlBall,Backyard Bowl,209,131,340
16352,2023-01-15,COLT,bounty,Canal Grande,3,0,3
16353,2023-01-14,COLT,knockout,Flaring Phoenix,10,1,11
16354,2023-01-14,COLT,hotZone,Controller Chaos,6,20,26
16355,2023-01-14,COLT,heist,Bridge Too Far,319,252,571
16356,2023-01-14,COLT,gemGrab,Hard Rock Mine,4,1,5
16357,2023-01-14,COLT,gemGrab,Deep Diner,7,8,15
16358,2023-01-14,COLT,brawlBall,Super Beach,52,35,87
16359,2023-01-14,COLT,brawlBall,Sneaky Fields,9,13,22
16360,2023-01-14,COLT,bounty,Canal Grande,3,1,4
16361,2023-01-13,COLT,knockout,Flaring Phoenix,4,1,5
16362,2023-01-13,COLT,hotZone,Controller Chaos,8,8,16
16363,2023-01-13,COLT,heist,Hot Potato,28,26,54
16364,2023-01-13,COLT,gemGrab,Deep Diner,12,13,25
16365,2023-01-13,COLT,brawlBall,Sneaky Fields,39,52,91
16366,2023-01-13,COLT,brawlBall,Pinhole Punt,3,4,7
16367,2023-01-13,COLT,bounty,Temple Ruins,3,0,3
16368,2023-01-12,COLT,knockout,Riverside,40,11,51
16369,2023-01-12,COLT,hotZone,Open Zone,9,5,14
16370,2023-01-12,COLT,heist,Hot Potato,14,10,24
16371,2023-01-12,COLT,gemGrab,Undermine,3,2,5
16372,2023-01-12,COLT,brawlBall,Sunny Soccer,1,2,3
16373,2023-01-12,COLT,brawlBall,Pinhole Punt,21,15,36
16374,2023-01-11,COLT,knockout,Riverside,4,2,6
16375,2023-01-11,COLT,hotZone,Open Zone,2,1,3
16376,2023-01-11,COLT,heist,Safe Zone,2,3,5
16377,2023-01-11,COLT,gemGrab,Gem Fort,1,0,1
16378,2023-01-11,COLT,brawlBall,Sunny Soccer,18,11,29
16379,2023-01-11,COLT,bounty,Excel,2,5,7
16380,2023-01-10,COLT,knockout,New Perspective,4,2,6
16381,2023-01-10,COLT,hotZone,Dueling Beetles,6,19,25
16382,2023-01-10,COLT,heist,Safe Zone,87,123,210
16383,2023-01-10,COLT,gemGrab,Minecart Madness,5,4,9
16384,2023-01-10,COLT,gemGrab,Crystal Arcade,5,13,18
16385,2023-01-10,COLT,brawlBall,Center Stage,5,3,8
16386,2023-01-10,COLT,brawlBall,Beach Ball,52,22,74
16387,2023-01-10,COLT,bounty,Excel,1,1,2
16388,2023-01-09,COLT,knockout,New Perspective,4,1,5
16389,2023-01-09,COLT,hotZone,Dueling Beetles,6,2,8
16390,2023-01-09,COLT,heist,Snaked Assault,101,102,203
16391,2023-01-09,COLT,gemGrab,Minecart Madness,11,8,19
16392,2023-01-09,COLT,gemGrab,Double Swoosh,3,0,3
16393,2023-01-09,COLT,brawlBall,Center Stage,48,23,71
16394,2023-01-09,COLT,brawlBall,Backyard Bowl,18,8,26
16395,2023-01-09,COLT,bounty,Layer Cake,7,3,10
16396,2023-01-08,COLT,knockout,X Marks the Spot,11,11,22
16397,2023-01-08,COLT,hotZone,Ring of Fire,4,6,10
16398,2023-01-08,COLT,heist,Snaked Assault,92,110,202
16399,2023-01-08,COLT,gemGrab,Hard Rock Mine,1,3,4
16400,2023-01-08,COLT,gemGrab,Double Swoosh,3,0,3
16401,2023-01-08,COLT,brawlBall,Super Beach,8,4,12
16402,2023-01-08,COLT,brawlBall,Backyard Bowl,144,148,292
16403,2023-01-08,COLT,bounty,Layer Cake,1,0,1
16404,2023-01-07,COLT,knockout,X Marks the Spot,6,3,9
16405,2023-01-07,COLT,hotZone,Ring of Fire,2,0,2
16406,2023-01-07,COLT,heist,Tornado Ring,48,24,72
16407,2023-01-07,COLT,gemGrab,Hard Rock Mine,4,0,4
16408,2023-01-07,COLT,gemGrab,Deep Diner,7,3,10
16409,2023-01-07,COLT,brawlBall,Super Beach,19,22,41
16410,2023-01-07,COLT,brawlBall,Sneaky Fields,2,1,3
16411,2023-01-07,COLT,bounty,Dry Season,7,1,8
16412,2023-01-06,COLT,knockout,Out in the Open,17,6,23
16413,2023-01-06,COLT,hotZone,Split,6,32,38
16414,2023-01-06,COLT,heist,Tornado Ring,143,114,257
16415,2023-01-06,COLT,gemGrab,Undermine,6,2,8
16416,2023-01-06,COLT,gemGrab,Deep Diner,12,4,16
16417,2023-01-06,COLT,brawlBall,Sneaky Fields,28,7,35
16418,2023-01-06,COLT,brawlBall,Pinhole Punt,8,6,14
16419,2023-01-06,COLT,bounty,Dry Season,4,4,8
16420,2023-01-05,COLT,knockout,Out in the Open,22,20,42
16421,2023-01-05,COLT,hotZone,Split,13,33,46
16422,2023-01-05,COLT,heist,Kaboom Canyon,52,59,111
16423,2023-01-05,COLT,gemGrab,Undermine,6,1,7
16424,2023-01-05,COLT,gemGrab,Gem Fort,0,3,3
16425,2023-01-05,COLT,brawlBall,Sunny Soccer,1,0,1
16426,2023-01-05,COLT,brawlBall,Pinhole Punt,72,58,130
16427,2023-01-05,COLT,bounty,Shooting Star,6,3,9
16428,2023-01-04,COLT,knockout,Goldarm Gulch,1,0,1
16429,2023-01-04,COLT,hotZone,Parallel Plays,4,0,4
16430,2023-01-04,COLT,heist,Kaboom Canyon,96,68,164
16431,2023-01-04,COLT,gemGrab,Gem Fort,6,7,13
16432,2023-01-04,COLT,gemGrab,Crystal Arcade,6,0,6
16433,2023-01-04,COLT,brawlBall,Sunny Soccer,43,17,60
16434,2023-01-04,COLT,brawlBall,Beach Ball,3,0,3
16435,2023-01-04,COLT,bounty,Shooting Star,24,5,29
16436,2023-01-03,COLT,knockout,Goldarm Gulch,2,2,4
16437,2023-01-03,COLT,heist,Pit Stop,39,55,94
16438,2023-01-03,COLT,heist,Kaboom Canyon,1,2,3
16439,2023-01-03,COLT,gemGrab,Minecart Madness,2,0,2
16440,2023-01-03,COLT,gemGrab,Crystal Arcade,15,1,16
16441,2023-01-03,COLT,brawlBall,Center Stage,4,2,6
16442,2023-01-03,COLT,brawlBall,Beach Ball,75,85,160
16443,2023-01-03,COLT,bounty,Hideout,15,1,16
16444,2023-01-02,COLT,knockout,Belle's Rock,20,17,37
16445,2023-01-02,COLT,hotZone,Quarter Pounder,12,4,16
16446,2023-01-02,COLT,hotZone,Controller Chaos,2,0,2
16447,2023-01-02,COLT,heist,Pit Stop,123,128,251
16448,2023-01-02,COLT,heist,Kaboom Canyon,1,3,4
16449,2023-01-02,COLT,gemGrab,Minecart Madness,16,3,19
16450,2023-01-02,COLT,gemGrab,Double Swoosh,4,1,5
16451,2023-01-02,COLT,brawlBall,Center Stage,62,48,110
16452,2023-01-02,COLT,brawlBall,Backyard Bowl,8,6,14
16453,2023-01-02,COLT,bounty,Hideout,20,8,28
16454,2023-01-01,COLT,knockout,Belle's Rock,7,1,8
16455,2023-01-01,COLT,hotZone,Quarter Pounder,2,2,4
16456,2023-01-01,COLT,heist,Kaboom Canyon,2,2,4
16457,2023-01-01,COLT,heist,Bridge Too Far,35,37,72
16458,2023-01-01,COLT,gemGrab,Double Swoosh,1,2,3
16459,2023-01-01,COLT,brawlBall,Backyard Bowl,48,33,81
16460,2022-12-31,COLT,heist,Kaboom Canyon,1,2,3
16461,2022-12-31,COLT,heist,Bridge Too Far,23,16,39
16462,2022-12-31,COLT,gemGrab,Minecart Madness,0,2,2
16463,2022-12-31,COLT,gemGrab,Deep Diner,4,10,14
16464,2022-12-31,COLT,brawlBall,Super Beach,3,5,8
16465,2022-12-30,COLT,heist,Kaboom Canyon,2,0,2
16466,2022-12-30,COLT,heist,Hot Potato,0,2,2
16467,2022-12-30,COLT,gemGrab,Undermine,1,0,1
16468,2022-12-30,COLT,gemGrab,Minecart Madness,2,0,2
16469,2022-12-30,COLT,gemGrab,Deep Diner,1,0,1
16470,2022-12-30,COLT,brawlBall,Sneaky Fields,9,3,12
16471,2022-12-29,COLT,heist,Kaboom Canyon,3,1,4
16472,2022-12-29,COLT,heist,Hot Potato,4,1,5
16473,2022-12-29,COLT,brawlBall,Pinhole Punt,5,0,5
16474,2022-12-28,COLT,hotZone,Controller Chaos,0,2,2
16475,2022-12-28,COLT,heist,Kaboom Canyon,2,0,2
16476,2022-12-28,COLT,brawlBall,Sunny Soccer,0,1,1
16477,2022-12-27,COLT,knockout,New Perspective,0,2,2
16478,2022-12-27,COLT,heist,Safe Zone,0,2,2
16479,2022-12-27,COLT,heist,Kaboom Canyon,2,2,4
16480,2022-12-27,COLT,gemGrab,Minecart Madness,2,0,2
16481,2022-12-27,COLT,brawlBall,Beach Ball,2,0,2
16482,2022-12-26,COLT,heist,Kaboom Canyon,1,4,5
16483,2022-12-26,COLT,brawlBall,Center Stage,1,0,1
16484,2022-12-25,COLT,brawlBall,Backyard Bowl,4,8,12
16485,2022-12-24,COLT,knockout,X Marks the Spot,1,0,1
16486,2022-12-24,COLT,brawlBall,Super Beach,0,1,1
16487,2022-12-23,COLT,knockout,Out in the Open,2,0,2
16488,2022-12-23,COLT,brawlBall,Sneaky Fields,0,2,2
16489,2022-12-22,COLT,heist,Kaboom Canyon,1,0,1
16490,2022-12-22,COLT,brawlBall,Pinhole Punt,2,0,2
16491,2022-12-19,COLT,brawlBall,Center Stage,1,0,1
16492,2022-12-18,COLT,heist,Bridge Too Far,0,1,1
16493,2022-12-16,COLT,brawlBall,Sneaky Fields,2,1,3
16494,2022-12-16,COLT,bounty,Temple Ruins,2,0,2
16495,2022-12-13,COLT,heist,Safe Zone,4,3,7
16496,2022-12-13,COLT,gemGrab,Crystal Arcade,1,2,3
16497,2022-12-12,COLT,brawlBall,Center Stage,4,0,4
16498,2022-11-11,COLT,knockout,New Perspective,2,0,2
16499,2022-11-03,COLT,brawlBall,Pinhole Punt,2,2,4
16500,2022-11-03,COLT,bounty,Temple Ruins,2,0,2
16501,2022-11-01,COLT,knockout,New Perspective,4,4,8
16502,2022-10-30,COLT,heist,Safe Zone,0,1,1
16503,2022-10-28,COLT,brawlBall,Beach Ball,2,0,2
16504,2022-10-15,COLT,gemGrab,Hard Rock Mine,1,1,2
16505,2023-02-11,COLETTE,knockout,Flaring Phoenix,18,17,35
16506,2023-02-11,COLETTE,hotZone,Controller Chaos,41,54,95
16507,2023-02-11,COLETTE,gemGrab,Deep Diner,18,40,58
16508,2023-02-11,COLETTE,brawlBall,Super Beach,45,49,94
16509,2023-02-11,COLETTE,brawlBall,Sneaky Fields,23,26,49
16510,2023-02-10,COLETTE,knockout,Flaring Phoenix,30,12,42
16511,2023-02-10,COLETTE,hotZone,Controller Chaos,49,45,94
16512,2023-02-10,COLETTE,heist,Hot Potato,95,129,224
16513,2023-02-10,COLETTE,gemGrab,Undermine,13,14,27
16514,2023-02-10,COLETTE,gemGrab,Deep Diner,34,37,71
16515,2023-02-10,COLETTE,brawlBall,Sneaky Fields,300,306,606
16516,2023-02-10,COLETTE,brawlBall,Pinhole Punt,5,7,12
16517,2023-02-10,COLETTE,bounty,Temple Ruins,15,7,22
16518,2023-02-09,COLETTE,knockout,Riverside,3,2,5
16519,2023-02-09,COLETTE,hotZone,Open Zone,5,2,7
16520,2023-02-09,COLETTE,heist,Hot Potato,43,61,104
16521,2023-02-09,COLETTE,gemGrab,Undermine,12,2,14
16522,2023-02-09,COLETTE,gemGrab,Gem Fort,0,1,1
16523,2023-02-09,COLETTE,brawlBall,Sunny Soccer,1,0,1
16524,2023-02-09,COLETTE,brawlBall,Pinhole Punt,93,122,215
16525,2023-02-09,COLETTE,bounty,Temple Ruins,6,8,14
16526,2023-02-08,COLETTE,knockout,Riverside,2,0,2
16527,2023-02-08,COLETTE,hotZone,Open Zone,6,4,10
16528,2023-02-08,COLETTE,heist,Safe Zone,41,49,90
16529,2023-02-08,COLETTE,gemGrab,Gem Fort,2,4,6
16530,2023-02-08,COLETTE,gemGrab,Crystal Arcade,0,1,1
16531,2023-02-08,COLETTE,brawlBall,Sunny Soccer,23,30,53
16532,2023-02-08,COLETTE,brawlBall,Beach Ball,0,2,2
16533,2023-02-08,COLETTE,bounty,Excel,1,2,3
16534,2023-02-07,COLETTE,knockout,New Perspective,4,2,6
16535,2023-02-07,COLETTE,hotZone,Dueling Beetles,3,0,3
16536,2023-02-07,COLETTE,heist,Safe Zone,13,24,37
16537,2023-02-07,COLETTE,gemGrab,Minecart Madness,4,2,6
16538,2023-02-07,COLETTE,gemGrab,Crystal Arcade,6,0,6
16539,2023-02-07,COLETTE,brawlBall,Center Stage,3,3,6
16540,2023-02-07,COLETTE,brawlBall,Beach Ball,8,15,23
16541,2023-02-06,COLETTE,knockout,New Perspective,40,43,83
16542,2023-02-06,COLETTE,knockout,Goldarm Gulch,1,0,1
16543,2023-02-06,COLETTE,hotZone,Dueling Beetles,72,104,176
16544,2023-02-06,COLETTE,heist,Snaked Assault,251,332,583
16545,2023-02-06,COLETTE,heist,Pit Stop,3,0,3
16546,2023-02-06,COLETTE,gemGrab,Minecart Madness,59,60,119
16547,2023-02-06,COLETTE,gemGrab,Double Swoosh,40,19,59
16548,2023-02-06,COLETTE,brawlBall,Sneaky Fields,5,0,5
16549,2023-02-06,COLETTE,brawlBall,Center Stage,420,476,896
16550,2023-02-06,COLETTE,brawlBall,Backyard Bowl,42,48,90
16551,2023-02-06,COLETTE,bounty,Layer Cake,3,3,6
16552,2023-02-05,COLETTE,knockout,X Marks the Spot,22,12,34
16553,2023-02-05,COLETTE,knockout,Goldarm Gulch,2,1,3
16554,2023-02-05,COLETTE,hotZone,Ring of Fire,41,24,65
16555,2023-02-05,COLETTE,heist,Snaked Assault,372,498,870
16556,2023-02-05,COLETTE,heist,Pit Stop,17,8,25
16557,2023-02-05,COLETTE,gemGrab,Hard Rock Mine,13,9,22
16558,2023-02-05,COLETTE,gemGrab,Double Swoosh,80,54,134
16559,2023-02-05,COLETTE,brawlBall,Super Beach,10,5,15
16560,2023-02-05,COLETTE,brawlBall,Sneaky Fields,16,6,22
16561,2023-02-05,COLETTE,brawlBall,Backyard Bowl,490,452,942
16562,2023-02-05,COLETTE,bounty,Layer Cake,9,9,18
16563,2023-02-04,COLETTE,knockout,X Marks the Spot,8,5,13
16564,2023-02-04,COLETTE,knockout,Goldarm Gulch,1,2,3
16565,2023-02-04,COLETTE,hotZone,Ring of Fire,12,10,22
16566,2023-02-04,COLETTE,heist,Tornado Ring,17,23,40
16567,2023-02-04,COLETTE,heist,Pit Stop,14,7,21
16568,2023-02-04,COLETTE,gemGrab,Hard Rock Mine,18,21,39
16569,2023-02-04,COLETTE,gemGrab,Double Swoosh,6,3,9
16570,2023-02-04,COLETTE,gemGrab,Deep Diner,6,2,8
16571,2023-02-04,COLETTE,brawlBall,Super Beach,90,89,179
16572,2023-02-04,COLETTE,brawlBall,Sneaky Fields,13,12,25
16573,2023-02-03,COLETTE,knockout,Out in the Open,48,29,77
16574,2023-02-03,COLETTE,knockout,Goldarm Gulch,15,19,34
16575,2023-02-03,COLETTE,hotZone,Split,7,8,15
16576,2023-02-03,COLETTE,heist,Tornado Ring,186,199,385
16577,2023-02-03,COLETTE,heist,Pit Stop,71,56,127
16578,2023-02-03,COLETTE,gemGrab,Undermine,7,12,19
16579,2023-02-03,COLETTE,gemGrab,Double Swoosh,40,23,63
16580,2023-02-03,COLETTE,gemGrab,Deep Diner,45,29,74
16581,2023-02-03,COLETTE,brawlBall,Sneaky Fields,330,364,694
16582,2023-02-03,COLETTE,brawlBall,Pinhole Punt,9,15,24
16583,2023-02-03,COLETTE,bounty,Dry Season,17,7,24
16584,2023-02-02,COLETTE,knockout,Out in the Open,18,11,29
16585,2023-02-02,COLETTE,hotZone,Split,9,5,14
16586,2023-02-02,COLETTE,heist,Kaboom Canyon,67,107,174
16587,2023-02-02,COLETTE,gemGrab,Undermine,17,12,29
16588,2023-02-02,COLETTE,gemGrab,Gem Fort,4,2,6
16589,2023-02-02,COLETTE,brawlBall,Sunny Soccer,10,10,20
16590,2023-02-02,COLETTE,brawlBall,Pinhole Punt,118,135,253
16591,2023-02-02,COLETTE,bounty,Shooting Star,2,1,3
16592,2023-02-01,COLETTE,knockout,Goldarm Gulch,52,23,75
16593,2023-02-01,COLETTE,hotZone,Parallel Plays,37,33,70
16594,2023-02-01,COLETTE,heist,Kaboom Canyon,277,386,663
16595,2023-02-01,COLETTE,gemGrab,Gem Fort,52,44,96
16596,2023-02-01,COLETTE,gemGrab,Crystal Arcade,20,6,26
16597,2023-02-01,COLETTE,brawlBall,Sunny Soccer,235,261,496
16598,2023-02-01,COLETTE,brawlBall,Beach Ball,11,7,18
16599,2023-02-01,COLETTE,bounty,Shooting Star,3,0,3
16600,2023-01-31,COLETTE,knockout,Goldarm Gulch,28,7,35
16601,2023-01-31,COLETTE,hotZone,Parallel Plays,26,23,49
16602,2023-01-31,COLETTE,heist,Pit Stop,16,23,39
16603,2023-01-31,COLETTE,gemGrab,Minecart Madness,2,2,4
16604,2023-01-31,COLETTE,gemGrab,Crystal Arcade,15,12,27
16605,2023-01-31,COLETTE,brawlBall,Center Stage,6,6,12
16606,2023-01-31,COLETTE,brawlBall,Beach Ball,147,156,303
16607,2023-01-31,COLETTE,bounty,Hideout,2,3,5
16608,2023-01-30,COLETTE,knockout,Belle's Rock,14,11,25
16609,2023-01-30,COLETTE,hotZone,Quarter Pounder,50,24,74
16610,2023-01-30,COLETTE,heist,Pit Stop,30,28,58
16611,2023-01-30,COLETTE,gemGrab,Minecart Madness,32,37,69
16612,2023-01-30,COLETTE,gemGrab,Double Swoosh,22,39,61
16613,2023-01-30,COLETTE,brawlBall,Center Stage,267,312,579
16614,2023-01-30,COLETTE,brawlBall,Backyard Bowl,45,37,82
16615,2023-01-30,COLETTE,bounty,Hideout,3,3,6
16616,2023-01-29,COLETTE,knockout,Belle's Rock,24,13,37
16617,2023-01-29,COLETTE,hotZone,Quarter Pounder,39,55,94
16618,2023-01-29,COLETTE,heist,Bridge Too Far,320,417,737
16619,2023-01-29,COLETTE,gemGrab,Hard Rock Mine,10,4,14
16620,2023-01-29,COLETTE,gemGrab,Double Swoosh,44,27,71
16621,2023-01-29,COLETTE,brawlBall,Super Beach,10,17,27
16622,2023-01-29,COLETTE,brawlBall,Backyard Bowl,428,466,894
16623,2023-01-29,COLETTE,bounty,Canal Grande,14,11,25
16624,2023-01-28,COLETTE,knockout,Flaring Phoenix,22,17,39
16625,2023-01-28,COLETTE,hotZone,Controller Chaos,60,65,125
16626,2023-01-28,COLETTE,heist,Bridge Too Far,756,782,1538
16627,2023-01-28,COLETTE,gemGrab,Hard Rock Mine,47,40,87
16628,2023-01-28,COLETTE,gemGrab,Deep Diner,12,14,26
16629,2023-01-28,COLETTE,brawlBall,Super Beach,291,354,645
16630,2023-01-28,COLETTE,brawlBall,Sneaky Fields,12,15,27
16631,2023-01-28,COLETTE,bounty,Canal Grande,9,6,15
16632,2023-01-27,COLETTE,knockout,Flaring Phoenix,11,6,17
16633,2023-01-27,COLETTE,hotZone,Controller Chaos,12,15,27
16634,2023-01-27,COLETTE,heist,Hot Potato,93,102,195
16635,2023-01-27,COLETTE,gemGrab,Undermine,3,5,8
16636,2023-01-27,COLETTE,gemGrab,Deep Diner,22,19,41
16637,2023-01-27,COLETTE,brawlBall,Sneaky Fields,102,85,187
16638,2023-01-27,COLETTE,brawlBall,Pinhole Punt,2,3,5
16639,2023-01-27,COLETTE,bounty,Temple Ruins,6,4,10
16640,2023-01-26,COLETTE,knockout,Riverside,33,25,58
16641,2023-01-26,COLETTE,hotZone,Open Zone,44,29,73
16642,2023-01-26,COLETTE,heist,Hot Potato,187,187,374
16643,2023-01-26,COLETTE,gemGrab,Undermine,46,52,98
16644,2023-01-26,COLETTE,gemGrab,Gem Fort,10,14,24
16645,2023-01-26,COLETTE,brawlBall,Sunny Soccer,15,10,25
16646,2023-01-26,COLETTE,brawlBall,Pinhole Punt,460,464,924
16647,2023-01-26,COLETTE,bounty,Temple Ruins,18,17,35
16648,2023-01-25,COLETTE,knockout,Riverside,22,12,34
16649,2023-01-25,COLETTE,hotZone,Open Zone,17,22,39
16650,2023-01-25,COLETTE,heist,Safe Zone,299,419,718
16651,2023-01-25,COLETTE,gemGrab,Gem Fort,14,11,25
16652,2023-01-25,COLETTE,gemGrab,Crystal Arcade,23,17,40
16653,2023-01-25,COLETTE,brawlBall,Sunny Soccer,149,207,356
16654,2023-01-25,COLETTE,brawlBall,Beach Ball,26,29,55
16655,2023-01-25,COLETTE,bounty,Excel,2,4,6
16656,2023-01-24,COLETTE,knockout,New Perspective,22,12,34
16657,2023-01-24,COLETTE,hotZone,Dueling Beetles,38,35,73
16658,2023-01-24,COLETTE,heist,Safe Zone,528,699,1227
16659,2023-01-24,COLETTE,gemGrab,Minecart Madness,10,5,15
16660,2023-01-24,COLETTE,gemGrab,Crystal Arcade,44,41,85
16661,2023-01-24,COLETTE,brawlBall,Center Stage,43,52,95
16662,2023-01-24,COLETTE,brawlBall,Beach Ball,277,310,587
16663,2023-01-24,COLETTE,bounty,Excel,5,10,15
16664,2023-01-23,COLETTE,knockout,New Perspective,49,34,83
16665,2023-01-23,COLETTE,hotZone,Dueling Beetles,25,35,60
16666,2023-01-23,COLETTE,heist,Snaked Assault,378,473,851
16667,2023-01-23,COLETTE,gemGrab,Minecart Madness,75,112,187
16668,2023-01-23,COLETTE,gemGrab,Double Swoosh,21,34,55
16669,2023-01-23,COLETTE,brawlBall,Center Stage,414,452,866
16670,2023-01-23,COLETTE,brawlBall,Backyard Bowl,21,35,56
16671,2023-01-23,COLETTE,bounty,Layer Cake,7,1,8
16672,2023-01-22,COLETTE,knockout,X Marks the Spot,13,21,34
16673,2023-01-22,COLETTE,hotZone,Ring of Fire,16,24,40
16674,2023-01-22,COLETTE,heist,Snaked Assault,136,182,318
16675,2023-01-22,COLETTE,gemGrab,Hard Rock Mine,20,13,33
16676,2023-01-22,COLETTE,gemGrab,Double Swoosh,23,16,39
16677,2023-01-22,COLETTE,brawlBall,Super Beach,17,19,36
16678,2023-01-22,COLETTE,brawlBall,Backyard Bowl,254,264,518
16679,2023-01-22,COLETTE,bounty,Layer Cake,2,2,4
16680,2023-01-21,COLETTE,knockout,X Marks the Spot,45,35,80
16681,2023-01-21,COLETTE,hotZone,Ring of Fire,49,79,128
16682,2023-01-21,COLETTE,heist,Tornado Ring,109,119,228
16683,2023-01-21,COLETTE,gemGrab,Hard Rock Mine,43,43,86
16684,2023-01-21,COLETTE,gemGrab,Deep Diner,10,8,18
16685,2023-01-21,COLETTE,brawlBall,Super Beach,373,341,714
16686,2023-01-21,COLETTE,brawlBall,Sneaky Fields,10,12,22
16687,2023-01-21,COLETTE,bounty,Dry Season,20,22,42
16688,2023-01-20,COLETTE,knockout,Out in the Open,49,43,92
16689,2023-01-20,COLETTE,hotZone,Split,9,12,21
16690,2023-01-20,COLETTE,heist,Tornado Ring,138,155,293
16691,2023-01-20,COLETTE,gemGrab,Undermine,17,15,32
16692,2023-01-20,COLETTE,gemGrab,Deep Diner,35,29,64
16693,2023-01-20,COLETTE,brawlBall,Sneaky Fields,253,331,584
16694,2023-01-20,COLETTE,brawlBall,Pinhole Punt,19,26,45
16695,2023-01-20,COLETTE,bounty,Dry Season,13,12,25
16696,2023-01-19,COLETTE,knockout,Out in the Open,71,48,119
16697,2023-01-19,COLETTE,hotZone,Split,25,19,44
16698,2023-01-19,COLETTE,heist,Kaboom Canyon,244,356,600
16699,2023-01-19,COLETTE,gemGrab,Undermine,40,51,91
16700,2023-01-19,COLETTE,gemGrab,Gem Fort,4,7,11
16701,2023-01-19,COLETTE,brawlBall,Sunny Soccer,9,10,19
16702,2023-01-19,COLETTE,brawlBall,Pinhole Punt,440,462,902
16703,2023-01-19,COLETTE,bounty,Shooting Star,22,4,26
16704,2023-01-18,COLETTE,knockout,Goldarm Gulch,6,9,15
16705,2023-01-18,COLETTE,hotZone,Parallel Plays,3,0,3
16706,2023-01-18,COLETTE,heist,Kaboom Canyon,124,176,300
16707,2023-01-18,COLETTE,gemGrab,Gem Fort,9,9,18
16708,2023-01-18,COLETTE,gemGrab,Crystal Arcade,4,4,8
16709,2023-01-18,COLETTE,brawlBall,Sunny Soccer,89,116,205
16710,2023-01-18,COLETTE,brawlBall,Beach Ball,2,5,7
16711,2023-01-18,COLETTE,bounty,Shooting Star,2,6,8
16712,2023-01-17,COLETTE,knockout,Goldarm Gulch,8,6,14
16713,2023-01-17,COLETTE,hotZone,Parallel Plays,3,4,7
16714,2023-01-17,COLETTE,heist,Pit Stop,7,2,9
16715,2023-01-17,COLETTE,gemGrab,Minecart Madness,1,0,1
16716,2023-01-17,COLETTE,gemGrab,Crystal Arcade,3,4,7
16717,2023-01-17,COLETTE,brawlBall,Center Stage,3,5,8
16718,2023-01-17,COLETTE,brawlBall,Beach Ball,24,27,51
16719,2023-01-17,COLETTE,bounty,Hideout,1,1,2
16720,2023-01-16,COLETTE,knockout,Belle's Rock,2,1,3
16721,2023-01-16,COLETTE,hotZone,Quarter Pounder,5,0,5
16722,2023-01-16,COLETTE,heist,Pit Stop,7,5,12
16723,2023-01-16,COLETTE,gemGrab,Minecart Madness,3,1,4
16724,2023-01-16,COLETTE,brawlBall,Center Stage,39,60,99
16725,2023-01-16,COLETTE,brawlBall,Backyard Bowl,6,4,10
16726,2023-01-16,COLETTE,bounty,Hideout,5,3,8
16727,2023-01-15,COLETTE,knockout,Belle's Rock,4,8,12
16728,2023-01-15,COLETTE,hotZone,Quarter Pounder,5,5,10
16729,2023-01-15,COLETTE,heist,Bridge Too Far,68,109,177
16730,2023-01-15,COLETTE,gemGrab,Hard Rock Mine,1,0,1
16731,2023-01-15,COLETTE,gemGrab,Double Swoosh,6,5,11
16732,2023-01-15,COLETTE,brawlBall,Super Beach,2,0,2
16733,2023-01-15,COLETTE,brawlBall,Backyard Bowl,48,40,88
16734,2023-01-15,COLETTE,bounty,Canal Grande,1,8,9
16735,2023-01-14,COLETTE,knockout,Flaring Phoenix,4,1,5
16736,2023-01-14,COLETTE,hotZone,Controller Chaos,6,5,11
16737,2023-01-14,COLETTE,heist,Bridge Too Far,140,194,334
16738,2023-01-14,COLETTE,gemGrab,Hard Rock Mine,2,2,4
16739,2023-01-14,COLETTE,brawlBall,Super Beach,18,16,34
16740,2023-01-14,COLETTE,brawlBall,Sneaky Fields,3,3,6
16741,2023-01-14,COLETTE,bounty,Canal Grande,1,2,3
16742,2023-01-13,COLETTE,knockout,Flaring Phoenix,3,5,8
16743,2023-01-13,COLETTE,hotZone,Controller Chaos,9,4,13
16744,2023-01-13,COLETTE,heist,Hot Potato,12,9,21
16745,2023-01-13,COLETTE,gemGrab,Deep Diner,3,1,4
16746,2023-01-13,COLETTE,brawlBall,Sneaky Fields,13,11,24
16747,2023-01-13,COLETTE,brawlBall,Pinhole Punt,3,0,3
16748,2023-01-13,COLETTE,bounty,Temple Ruins,0,1,1
16749,2023-01-12,COLETTE,knockout,Riverside,1,1,2
16750,2023-01-12,COLETTE,hotZone,Open Zone,2,0,2
16751,2023-01-12,COLETTE,heist,Hot Potato,2,2,4
16752,2023-01-12,COLETTE,gemGrab,Undermine,1,1,2
16753,2023-01-12,COLETTE,gemGrab,Gem Fort,1,0,1
16754,2023-01-12,COLETTE,brawlBall,Pinhole Punt,8,14,22
16755,2023-01-11,COLETTE,hotZone,Open Zone,1,5,6
16756,2023-01-11,COLETTE,heist,Safe Zone,0,2,2
16757,2023-01-11,COLETTE,gemGrab,Gem Fort,2,0,2
16758,2023-01-11,COLETTE,brawlBall,Sunny Soccer,4,0,4
16759,2023-01-10,COLETTE,hotZone,Dueling Beetles,6,5,11
16760,2023-01-10,COLETTE,heist,Safe Zone,41,34,75
16761,2023-01-10,COLETTE,gemGrab,Crystal Arcade,2,0,2
16762,2023-01-10,COLETTE,brawlBall,Center Stage,4,3,7
16763,2023-01-10,COLETTE,brawlBall,Beach Ball,14,5,19
16764,2023-01-09,COLETTE,hotZone,Dueling Beetles,5,19,24
16765,2023-01-09,COLETTE,heist,Snaked Assault,48,52,100
16766,2023-01-09,COLETTE,gemGrab,Minecart Madness,4,6,10
16767,2023-01-09,COLETTE,gemGrab,Double Swoosh,0,3,3
16768,2023-01-09,COLETTE,brawlBall,Center Stage,20,35,55
16769,2023-01-09,COLETTE,brawlBall,Backyard Bowl,1,0,1
16770,2023-01-08,COLETTE,knockout,X Marks the Spot,0,1,1
16771,2023-01-08,COLETTE,hotZone,Ring of Fire,4,17,21
16772,2023-01-08,COLETTE,heist,Snaked Assault,20,9,29
16773,2023-01-08,COLETTE,gemGrab,Hard Rock Mine,0,2,2
16774,2023-01-08,COLETTE,gemGrab,Double Swoosh,0,2,2
16775,2023-01-08,COLETTE,brawlBall,Super Beach,2,0,2
16776,2023-01-08,COLETTE,brawlBall,Backyard Bowl,28,52,80
16777,2023-01-08,COLETTE,bounty,Layer Cake,1,0,1
16778,2023-01-07,COLETTE,knockout,X Marks the Spot,0,2,2
16779,2023-01-07,COLETTE,hotZone,Ring of Fire,2,0,2
16780,2023-01-07,COLETTE,heist,Tornado Ring,19,19,38
16781,2023-01-07,COLETTE,gemGrab,Hard Rock Mine,3,5,8
16782,2023-01-07,COLETTE,gemGrab,Deep Diner,2,0,2
16783,2023-01-07,COLETTE,brawlBall,Super Beach,8,3,11
16784,2023-01-06,COLETTE,heist,Tornado Ring,17,44,61
16785,2023-01-06,COLETTE,gemGrab,Deep Diner,2,2,4
16786,2023-01-06,COLETTE,brawlBall,Sneaky Fields,9,6,15
16787,2023-01-06,COLETTE,brawlBall,Pinhole Punt,2,0,2
16788,2023-01-05,COLETTE,knockout,Out in the Open,2,5,7
16789,2023-01-05,COLETTE,hotZone,Split,11,21,32
16790,2023-01-05,COLETTE,heist,Kaboom Canyon,48,65,113
16791,2023-01-05,COLETTE,gemGrab,Undermine,3,0,3
16792,2023-01-05,COLETTE,brawlBall,Pinhole Punt,19,26,45
16793,2023-01-04,COLETTE,hotZone,Parallel Plays,2,4,6
16794,2023-01-04,COLETTE,heist,Kaboom Canyon,103,174,277
16795,2023-01-04,COLETTE,gemGrab,Gem Fort,3,5,8
16796,2023-01-04,COLETTE,gemGrab,Crystal Arcade,1,0,1
16797,2023-01-04,COLETTE,brawlBall,Sunny Soccer,16,36,52
16798,2023-01-03,COLETTE,knockout,Goldarm Gulch,1,1,2
16799,2023-01-03,COLETTE,hotZone,Parallel Plays,5,7,12
16800,2023-01-03,COLETTE,heist,Pit Stop,9,3,12
16801,2023-01-03,COLETTE,gemGrab,Crystal Arcade,1,2,3
16802,2023-01-03,COLETTE,brawlBall,Center Stage,1,1,2
16803,2023-01-03,COLETTE,brawlBall,Beach Ball,15,44,59
16804,2023-01-03,COLETTE,bounty,Hideout,1,0,1
16805,2023-01-02,COLETTE,knockout,Belle's Rock,1,1,2
16806,2023-01-02,COLETTE,hotZone,Quarter Pounder,6,21,27
16807,2023-01-02,COLETTE,heist,Pit Stop,16,7,23
16808,2023-01-02,COLETTE,heist,Kaboom Canyon,0,1,1
16809,2023-01-02,COLETTE,gemGrab,Minecart Madness,5,6,11
16810,2023-01-02,COLETTE,brawlBall,Center Stage,25,21,46
16811,2023-01-02,COLETTE,brawlBall,Backyard Bowl,1,1,2
16812,2023-01-02,COLETTE,bounty,Hideout,4,1,5
16813,2023-01-01,COLETTE,knockout,Belle's Rock,0,1,1
16814,2023-01-01,COLETTE,hotZone,Quarter Pounder,2,10,12
16815,2023-01-01,COLETTE,heist,Kaboom Canyon,1,0,1
16816,2023-01-01,COLETTE,heist,Bridge Too Far,17,7,24
16817,2023-01-01,COLETTE,gemGrab,Double Swoosh,1,1,2
16818,2023-01-01,COLETTE,brawlBall,Backyard Bowl,16,3,19
16819,2022-12-31,COLETTE,heist,Kaboom Canyon,0,2,2
16820,2022-12-31,COLETTE,heist,Bridge Too Far,7,11,18
16821,2022-12-31,COLETTE,gemGrab,Deep Diner,1,0,1
16822,2022-12-31,COLETTE,brawlBall,Super Beach,3,6,9
16823,2022-12-31,COLETTE,brawlBall,Sneaky Fields,1,0,1
16824,2022-12-30,COLETTE,hotZone,Controller Chaos,2,11,13
16825,2022-12-30,COLETTE,heist,Hot Potato,1,1,2
16826,2022-12-30,COLETTE,gemGrab,Undermine,1,0,1
16827,2022-12-30,COLETTE,gemGrab,Deep Diner,1,0,1
16828,2022-12-30,COLETTE,brawlBall,Sneaky Fields,3,2,5
16829,2022-12-29,COLETTE,heist,Kaboom Canyon,0,1,1
16830,2022-12-29,COLETTE,heist,Hot Potato,1,0,1
16831,2022-12-29,COLETTE,gemGrab,Minecart Madness,1,0,1
16832,2022-12-29,COLETTE,brawlBall,Pinhole Punt,2,1,3
16833,2022-12-27,COLETTE,hotZone,Dueling Beetles,1,0,1
16834,2022-12-27,COLETTE,heist,Kaboom Canyon,0,1,1
16835,2022-12-27,COLETTE,brawlBall,Beach Ball,1,0,1
16836,2022-12-26,COLETTE,heist,Kaboom Canyon,0,2,2
16837,2022-12-25,COLETTE,brawlBall,Backyard Bowl,1,0,1
16838,2022-12-24,COLETTE,brawlBall,Super Beach,1,1,2
16839,2022-12-22,COLETTE,heist,Kaboom Canyon,0,1,1
16840,2022-12-22,COLETTE,brawlBall,Pinhole Punt,1,0,1
16841,2022-12-19,COLETTE,gemGrab,Minecart Madness,2,0,2
16842,2022-12-18,COLETTE,heist,Bridge Too Far,1,2,3
16843,2022-12-16,COLETTE,brawlBall,Sneaky Fields,1,0,1
16844,2022-12-15,COLETTE,heist,Hot Potato,0,2,2
16845,2022-12-13,COLETTE,heist,Safe Zone,0,1,1
16846,2022-10-15,COLETTE,brawlBall,Super Beach,1,0,1
16847,2023-02-11,CHESTER,knockout,Flaring Phoenix,30,22,52
16848,2023-02-11,CHESTER,hotZone,Controller Chaos,58,63,121
16849,2023-02-11,CHESTER,gemGrab,Deep Diner,46,27,73
16850,2023-02-11,CHESTER,brawlBall,Super Beach,75,67,142
16851,2023-02-11,CHESTER,brawlBall,Sneaky Fields,44,49,93
16852,2023-02-10,CHESTER,knockout,Flaring Phoenix,71,66,137
16853,2023-02-10,CHESTER,hotZone,Controller Chaos,68,48,116
16854,2023-02-10,CHESTER,heist,Hot Potato,17,8,25
16855,2023-02-10,CHESTER,gemGrab,Undermine,19,16,35
16856,2023-02-10,CHESTER,gemGrab,Deep Diner,66,64,130
16857,2023-02-10,CHESTER,brawlBall,Sneaky Fields,465,416,881
16858,2023-02-10,CHESTER,brawlBall,Pinhole Punt,9,12,21
16859,2023-02-10,CHESTER,bounty,Temple Ruins,39,58,97
16860,2023-02-09,CHESTER,knockout,Riverside,6,5,11
16861,2023-02-09,CHESTER,hotZone,Open Zone,4,5,9
16862,2023-02-09,CHESTER,heist,Hot Potato,4,8,12
16863,2023-02-09,CHESTER,gemGrab,Undermine,25,34,59
16864,2023-02-09,CHESTER,gemGrab,Gem Fort,6,3,9
16865,2023-02-09,CHESTER,brawlBall,Sunny Soccer,1,4,5
16866,2023-02-09,CHESTER,brawlBall,Pinhole Punt,146,132,278
16867,2023-02-09,CHESTER,bounty,Temple Ruins,18,17,35
16868,2023-02-08,CHESTER,knockout,Riverside,3,1,4
16869,2023-02-08,CHESTER,hotZone,Open Zone,3,8,11
16870,2023-02-08,CHESTER,heist,Safe Zone,1,0,1
16871,2023-02-08,CHESTER,gemGrab,Gem Fort,20,18,38
16872,2023-02-08,CHESTER,gemGrab,Crystal Arcade,1,4,5
16873,2023-02-08,CHESTER,brawlBall,Sunny Soccer,32,42,74
16874,2023-02-08,CHESTER,brawlBall,Beach Ball,1,5,6
16875,2023-02-08,CHESTER,bounty,Excel,3,6,9
16876,2023-02-07,CHESTER,knockout,New Perspective,5,3,8
16877,2023-02-07,CHESTER,hotZone,Dueling Beetles,5,3,8
16878,2023-02-07,CHESTER,heist,Safe Zone,1,0,1
16879,2023-02-07,CHESTER,gemGrab,Minecart Madness,4,3,7
16880,2023-02-07,CHESTER,gemGrab,Crystal Arcade,2,2,4
16881,2023-02-07,CHESTER,brawlBall,Center Stage,3,2,5
16882,2023-02-07,CHESTER,brawlBall,Beach Ball,24,31,55
16883,2023-02-07,CHESTER,bounty,Excel,0,1,1
16884,2023-02-06,CHESTER,knockout,New Perspective,83,69,152
16885,2023-02-06,CHESTER,knockout,Goldarm Gulch,3,0,3
16886,2023-02-06,CHESTER,hotZone,Dueling Beetles,52,30,82
16887,2023-02-06,CHESTER,heist,Snaked Assault,30,55,85
16888,2023-02-06,CHESTER,heist,Pit Stop,1,0,1
16889,2023-02-06,CHESTER,gemGrab,Minecart Madness,73,86,159
16890,2023-02-06,CHESTER,gemGrab,Double Swoosh,89,90,179
16891,2023-02-06,CHESTER,brawlBall,Sneaky Fields,14,7,21
16892,2023-02-06,CHESTER,brawlBall,Center Stage,686,725,1411
16893,2023-02-06,CHESTER,brawlBall,Backyard Bowl,42,25,67
16894,2023-02-06,CHESTER,bounty,Layer Cake,12,9,21
16895,2023-02-05,CHESTER,knockout,X Marks the Spot,44,19,63
16896,2023-02-05,CHESTER,knockout,Goldarm Gulch,11,4,15
16897,2023-02-05,CHESTER,hotZone,Ring of Fire,51,49,100
16898,2023-02-05,CHESTER,heist,Snaked Assault,46,27,73
16899,2023-02-05,CHESTER,heist,Pit Stop,9,3,12
16900,2023-02-05,CHESTER,gemGrab,Hard Rock Mine,22,19,41
16901,2023-02-05,CHESTER,gemGrab,Double Swoosh,240,221,461
16902,2023-02-05,CHESTER,brawlBall,Super Beach,17,9,26
16903,2023-02-05,CHESTER,brawlBall,Sneaky Fields,56,42,98
16904,2023-02-05,CHESTER,brawlBall,Backyard Bowl,412,526,938
16905,2023-02-05,CHESTER,bounty,Layer Cake,13,26,39
16906,2023-02-04,CHESTER,knockout,X Marks the Spot,11,7,18
16907,2023-02-04,CHESTER,knockout,Goldarm Gulch,1,0,1
16908,2023-02-04,CHESTER,hotZone,Ring of Fire,14,22,36
16909,2023-02-04,CHESTER,heist,Tornado Ring,5,4,9
16910,2023-02-04,CHESTER,heist,Pit Stop,2,2,4
16911,2023-02-04,CHESTER,gemGrab,Hard Rock Mine,23,32,55
16912,2023-02-04,CHESTER,gemGrab,Double Swoosh,39,30,69
16913,2023-02-04,CHESTER,gemGrab,Deep Diner,4,2,6
16914,2023-02-04,CHESTER,brawlBall,Super Beach,156,126,282
16915,2023-02-04,CHESTER,brawlBall,Sneaky Fields,31,32,63
16916,2023-02-04,CHESTER,bounty,Dry Season,9,7,16
16917,2023-02-03,CHESTER,knockout,Out in the Open,61,71,132
16918,2023-02-03,CHESTER,knockout,Goldarm Gulch,12,7,19
16919,2023-02-03,CHESTER,hotZone,Split,32,55,87
16920,2023-02-03,CHESTER,heist,Tornado Ring,47,41,88
16921,2023-02-03,CHESTER,heist,Pit Stop,23,8,31
16922,2023-02-03,CHESTER,gemGrab,Undermine,34,30,64
16923,2023-02-03,CHESTER,gemGrab,Double Swoosh,174,115,289
16924,2023-02-03,CHESTER,gemGrab,Deep Diner,100,145,245
16925,2023-02-03,CHESTER,brawlBall,Sneaky Fields,666,608,1274
16926,2023-02-03,CHESTER,brawlBall,Pinhole Punt,19,13,32
16927,2023-02-03,CHESTER,bounty,Dry Season,23,18,41
16928,2023-02-02,CHESTER,knockout,Out in the Open,23,17,40
16929,2023-02-02,CHESTER,hotZone,Split,21,11,32
16930,2023-02-02,CHESTER,heist,Kaboom Canyon,8,4,12
16931,2023-02-02,CHESTER,gemGrab,Undermine,37,28,65
16932,2023-02-02,CHESTER,gemGrab,Gem Fort,5,12,17
16933,2023-02-02,CHESTER,brawlBall,Sunny Soccer,7,2,9
16934,2023-02-02,CHESTER,brawlBall,Pinhole Punt,148,197,345
16935,2023-02-02,CHESTER,bounty,Shooting Star,4,1,5
16936,2023-02-01,CHESTER,knockout,Goldarm Gulch,88,66,154
16937,2023-02-01,CHESTER,hotZone,Parallel Plays,85,70,155
16938,2023-02-01,CHESTER,heist,Kaboom Canyon,10,16,26
16939,2023-02-01,CHESTER,gemGrab,Gem Fort,116,137,253
16940,2023-02-01,CHESTER,gemGrab,Crystal Arcade,48,45,93
16941,2023-02-01,CHESTER,brawlBall,Sunny Soccer,416,435,851
16942,2023-02-01,CHESTER,brawlBall,Beach Ball,29,30,59
16943,2023-02-01,CHESTER,bounty,Shooting Star,8,1,9
16944,2023-01-31,CHESTER,knockout,Goldarm Gulch,47,24,71
16945,2023-01-31,CHESTER,hotZone,Parallel Plays,33,32,65
16946,2023-01-31,CHESTER,heist,Pit Stop,9,14,23
16947,2023-01-31,CHESTER,gemGrab,Minecart Madness,5,3,8
16948,2023-01-31,CHESTER,gemGrab,Crystal Arcade,61,51,112
16949,2023-01-31,CHESTER,brawlBall,Center Stage,8,7,15
16950,2023-01-31,CHESTER,brawlBall,Beach Ball,172,234,406
16951,2023-01-31,CHESTER,bounty,Hideout,4,5,9
16952,2023-01-30,CHESTER,knockout,Belle's Rock,43,46,89
16953,2023-01-30,CHESTER,hotZone,Quarter Pounder,87,53,140
16954,2023-01-30,CHESTER,heist,Pit Stop,26,22,48
16955,2023-01-30,CHESTER,gemGrab,Minecart Madness,36,40,76
16956,2023-01-30,CHESTER,gemGrab,Double Swoosh,63,61,124
16957,2023-01-30,CHESTER,brawlBall,Center Stage,430,481,911
16958,2023-01-30,CHESTER,brawlBall,Backyard Bowl,48,32,80
16959,2023-01-30,CHESTER,bounty,Hideout,7,1,8
16960,2023-01-29,CHESTER,knockout,Belle's Rock,39,22,61
16961,2023-01-29,CHESTER,hotZone,Quarter Pounder,39,36,75
16962,2023-01-29,CHESTER,heist,Bridge Too Far,20,4,24
16963,2023-01-29,CHESTER,gemGrab,Hard Rock Mine,20,22,42
16964,2023-01-29,CHESTER,gemGrab,Double Swoosh,176,195,371
16965,2023-01-29,CHESTER,brawlBall,Super Beach,9,11,20
16966,2023-01-29,CHESTER,brawlBall,Backyard Bowl,374,456,830
16967,2023-01-29,CHESTER,bounty,Canal Grande,33,40,73
16968,2023-01-28,CHESTER,knockout,Flaring Phoenix,46,56,102
16969,2023-01-28,CHESTER,hotZone,Controller Chaos,93,84,177
16970,2023-01-28,CHESTER,heist,Bridge Too Far,31,27,58
16971,2023-01-28,CHESTER,gemGrab,Hard Rock Mine,95,87,182
16972,2023-01-28,CHESTER,gemGrab,Deep Diner,40,42,82
16973,2023-01-28,CHESTER,brawlBall,Super Beach,511,563,1074
16974,2023-01-28,CHESTER,brawlBall,Sneaky Fields,31,29,60
16975,2023-01-28,CHESTER,bounty,Canal Grande,43,44,87
16976,2023-01-27,CHESTER,knockout,Flaring Phoenix,46,30,76
16977,2023-01-27,CHESTER,hotZone,Controller Chaos,21,28,49
16978,2023-01-27,CHESTER,heist,Hot Potato,10,9,19
16979,2023-01-27,CHESTER,gemGrab,Undermine,6,6,12
16980,2023-01-27,CHESTER,gemGrab,Deep Diner,52,57,109
16981,2023-01-27,CHESTER,brawlBall,Sneaky Fields,184,199,383
16982,2023-01-27,CHESTER,brawlBall,Pinhole Punt,2,13,15
16983,2023-01-27,CHESTER,bounty,Temple Ruins,15,14,29
16984,2023-01-26,CHESTER,knockout,Riverside,61,28,89
16985,2023-01-26,CHESTER,hotZone,Open Zone,40,35,75
16986,2023-01-26,CHESTER,heist,Hot Potato,27,18,45
16987,2023-01-26,CHESTER,gemGrab,Undermine,127,131,258
16988,2023-01-26,CHESTER,gemGrab,Gem Fort,67,88,155
16989,2023-01-26,CHESTER,brawlBall,Sunny Soccer,37,29,66
16990,2023-01-26,CHESTER,brawlBall,Pinhole Punt,632,713,1345
16991,2023-01-26,CHESTER,bounty,Temple Ruins,40,53,93
16992,2023-01-25,CHESTER,knockout,Riverside,15,10,25
16993,2023-01-25,CHESTER,hotZone,Open Zone,37,26,63
16994,2023-01-25,CHESTER,heist,Safe Zone,18,9,27
16995,2023-01-25,CHESTER,gemGrab,Gem Fort,54,68,122
16996,2023-01-25,CHESTER,gemGrab,Crystal Arcade,80,110,190
16997,2023-01-25,CHESTER,brawlBall,Sunny Soccer,366,438,804
16998,2023-01-25,CHESTER,brawlBall,Beach Ball,63,79,142
16999,2023-01-25,CHESTER,bounty,Excel,10,11,21
17000,2023-01-24,CHESTER,knockout,New Perspective,71,71,142
17001,2023-01-24,CHESTER,hotZone,Dueling Beetles,43,27,70
17002,2023-01-24,CHESTER,heist,Safe Zone,22,9,31
17003,2023-01-24,CHESTER,gemGrab,Minecart Madness,25,17,42
17004,2023-01-24,CHESTER,gemGrab,Crystal Arcade,118,105,223
17005,2023-01-24,CHESTER,brawlBall,Center Stage,88,69,157
17006,2023-01-24,CHESTER,brawlBall,Beach Ball,577,632,1209
17007,2023-01-24,CHESTER,bounty,Excel,18,12,30
17008,2023-01-23,CHESTER,knockout,New Perspective,126,81,207
17009,2023-01-23,CHESTER,hotZone,Dueling Beetles,77,59,136
17010,2023-01-23,CHESTER,heist,Snaked Assault,49,30,79
17011,2023-01-23,CHESTER,gemGrab,Minecart Madness,120,136,256
17012,2023-01-23,CHESTER,gemGrab,Double Swoosh,73,99,172
17013,2023-01-23,CHESTER,brawlBall,Center Stage,969,1052,2021
17014,2023-01-23,CHESTER,brawlBall,Backyard Bowl,37,31,68
17015,2023-01-23,CHESTER,bounty,Layer Cake,31,27,58
17016,2023-01-22,CHESTER,knockout,X Marks the Spot,38,23,61
17017,2023-01-22,CHESTER,hotZone,Ring of Fire,15,23,38
17018,2023-01-22,CHESTER,heist,Snaked Assault,22,16,38
17019,2023-01-22,CHESTER,gemGrab,Hard Rock Mine,35,26,61
17020,2023-01-22,CHESTER,gemGrab,Double Swoosh,101,125,226
17021,2023-01-22,CHESTER,brawlBall,Super Beach,46,51,97
17022,2023-01-22,CHESTER,brawlBall,Backyard Bowl,246,315,561
17023,2023-01-22,CHESTER,bounty,Layer Cake,12,6,18
17024,2023-01-21,CHESTER,knockout,X Marks the Spot,122,101,223
17025,2023-01-21,CHESTER,hotZone,Ring of Fire,64,44,108
17026,2023-01-21,CHESTER,heist,Tornado Ring,38,49,87
17027,2023-01-21,CHESTER,gemGrab,Hard Rock Mine,151,145,296
17028,2023-01-21,CHESTER,gemGrab,Deep Diner,24,24,48
17029,2023-01-21,CHESTER,brawlBall,Super Beach,846,756,1602
17030,2023-01-21,CHESTER,brawlBall,Sneaky Fields,32,18,50
17031,2023-01-21,CHESTER,bounty,Dry Season,28,24,52
17032,2023-01-20,CHESTER,knockout,Out in the Open,90,112,202
17033,2023-01-20,CHESTER,hotZone,Split,50,58,108
17034,2023-01-20,CHESTER,heist,Tornado Ring,48,51,99
17035,2023-01-20,CHESTER,gemGrab,Undermine,80,72,152
17036,2023-01-20,CHESTER,gemGrab,Deep Diner,155,186,341
17037,2023-01-20,CHESTER,brawlBall,Sneaky Fields,668,596,1264
17038,2023-01-20,CHESTER,brawlBall,Pinhole Punt,23,28,51
17039,2023-01-20,CHESTER,bounty,Dry Season,29,19,48
17040,2023-01-19,CHESTER,knockout,Out in the Open,109,56,165
17041,2023-01-19,CHESTER,hotZone,Split,93,91,184
17042,2023-01-19,CHESTER,heist,Kaboom Canyon,24,21,45
17043,2023-01-19,CHESTER,gemGrab,Undermine,124,132,256
17044,2023-01-19,CHESTER,gemGrab,Gem Fort,30,21,51
17045,2023-01-19,CHESTER,brawlBall,Sunny Soccer,20,13,33
17046,2023-01-19,CHESTER,brawlBall,Pinhole Punt,684,714,1398
17047,2023-01-19,CHESTER,bounty,Shooting Star,8,11,19
17048,2023-01-18,CHESTER,knockout,Goldarm Gulch,28,13,41
17049,2023-01-18,CHESTER,hotZone,Parallel Plays,11,32,43
17050,2023-01-18,CHESTER,heist,Kaboom Canyon,7,5,12
17051,2023-01-18,CHESTER,gemGrab,Gem Fort,39,32,71
17052,2023-01-18,CHESTER,gemGrab,Crystal Arcade,20,10,30
17053,2023-01-18,CHESTER,brawlBall,Sunny Soccer,196,223,419
17054,2023-01-18,CHESTER,brawlBall,Beach Ball,8,4,12
17055,2023-01-18,CHESTER,bounty,Shooting Star,4,6,10
17056,2023-01-17,CHESTER,knockout,Goldarm Gulch,29,24,53
17057,2023-01-17,CHESTER,hotZone,Parallel Plays,5,12,17
17058,2023-01-17,CHESTER,heist,Pit Stop,5,0,5
17059,2023-01-17,CHESTER,gemGrab,Minecart Madness,2,0,2
17060,2023-01-17,CHESTER,gemGrab,Crystal Arcade,8,15,23
17061,2023-01-17,CHESTER,brawlBall,Center Stage,6,8,14
17062,2023-01-17,CHESTER,brawlBall,Beach Ball,79,81,160
17063,2023-01-17,CHESTER,bounty,Hideout,2,0,2
17064,2023-01-16,CHESTER,knockout,Belle's Rock,8,4,12
17065,2023-01-16,CHESTER,hotZone,Quarter Pounder,13,17,30
17066,2023-01-16,CHESTER,heist,Pit Stop,12,5,17
17067,2023-01-16,CHESTER,gemGrab,Minecart Madness,14,11,25
17068,2023-01-16,CHESTER,gemGrab,Double Swoosh,12,10,22
17069,2023-01-16,CHESTER,brawlBall,Center Stage,99,75,174
17070,2023-01-16,CHESTER,brawlBall,Backyard Bowl,8,2,10
17071,2023-01-16,CHESTER,bounty,Hideout,1,14,15
17072,2023-01-15,CHESTER,knockout,Belle's Rock,14,5,19
17073,2023-01-15,CHESTER,hotZone,Quarter Pounder,63,65,128
17074,2023-01-15,CHESTER,heist,Bridge Too Far,6,0,6
17075,2023-01-15,CHESTER,gemGrab,Hard Rock Mine,21,36,57
17076,2023-01-15,CHESTER,gemGrab,Double Swoosh,29,22,51
17077,2023-01-15,CHESTER,brawlBall,Super Beach,18,3,21
17078,2023-01-15,CHESTER,brawlBall,Backyard Bowl,95,114,209
17079,2023-01-15,CHESTER,bounty,Canal Grande,6,9,15
17080,2023-01-14,CHESTER,knockout,Flaring Phoenix,12,3,15
17081,2023-01-14,CHESTER,hotZone,Controller Chaos,40,47,87
17082,2023-01-14,CHESTER,heist,Bridge Too Far,11,1,12
17083,2023-01-14,CHESTER,gemGrab,Hard Rock Mine,15,6,21
17084,2023-01-14,CHESTER,gemGrab,Deep Diner,5,2,7
17085,2023-01-14,CHESTER,brawlBall,Super Beach,73,86,159
17086,2023-01-14,CHESTER,brawlBall,Sneaky Fields,5,4,9
17087,2023-01-14,CHESTER,bounty,Canal Grande,11,26,37
17088,2023-01-13,CHESTER,knockout,Flaring Phoenix,10,6,16
17089,2023-01-13,CHESTER,hotZone,Controller Chaos,33,5,38
17090,2023-01-13,CHESTER,heist,Hot Potato,6,0,6
17091,2023-01-13,CHESTER,gemGrab,Undermine,1,0,1
17092,2023-01-13,CHESTER,gemGrab,Deep Diner,22,5,27
17093,2023-01-13,CHESTER,brawlBall,Sneaky Fields,98,45,143
17094,2023-01-13,CHESTER,brawlBall,Pinhole Punt,3,2,5
17095,2023-01-13,CHESTER,bounty,Temple Ruins,6,1,7
17096,2023-01-12,CHESTER,knockout,Riverside,18,5,23
17097,2023-01-12,CHESTER,hotZone,Open Zone,22,10,32
17098,2023-01-12,CHESTER,heist,Hot Potato,1,0,1
17099,2023-01-12,CHESTER,gemGrab,Undermine,23,21,44
17100,2023-01-12,CHESTER,gemGrab,Gem Fort,2,6,8
17101,2023-01-12,CHESTER,brawlBall,Sunny Soccer,8,18,26
17102,2023-01-12,CHESTER,brawlBall,Pinhole Punt,79,81,160
17103,2023-01-12,CHESTER,bounty,Temple Ruins,2,1,3
17104,2023-01-11,CHESTER,knockout,Riverside,2,0,2
17105,2023-01-11,CHESTER,hotZone,Open Zone,7,2,9
17106,2023-01-11,CHESTER,gemGrab,Gem Fort,19,38,57
17107,2023-01-11,CHESTER,brawlBall,Sunny Soccer,59,51,110
17108,2023-01-11,CHESTER,brawlBall,Beach Ball,4,5,9
17109,2023-01-11,CHESTER,bounty,Excel,1,0,1
17110,2023-01-10,CHESTER,knockout,New Perspective,25,23,48
17111,2023-01-10,CHESTER,hotZone,Dueling Beetles,53,38,91
17112,2023-01-10,CHESTER,heist,Safe Zone,12,3,15
17113,2023-01-10,CHESTER,gemGrab,Minecart Madness,23,22,45
17114,2023-01-10,CHESTER,gemGrab,Crystal Arcade,60,48,108
17115,2023-01-10,CHESTER,brawlBall,Center Stage,30,37,67
17116,2023-01-10,CHESTER,brawlBall,Beach Ball,208,210,418
17117,2023-01-10,CHESTER,bounty,Excel,4,7,11
17118,2023-01-09,CHESTER,knockout,New Perspective,27,19,46
17119,2023-01-09,CHESTER,hotZone,Dueling Beetles,35,21,56
17120,2023-01-09,CHESTER,heist,Snaked Assault,42,45,87
17121,2023-01-09,CHESTER,gemGrab,Minecart Madness,61,98,159
17122,2023-01-09,CHESTER,gemGrab,Double Swoosh,68,53,121
17123,2023-01-09,CHESTER,brawlBall,Center Stage,279,262,541
17124,2023-01-09,CHESTER,brawlBall,Backyard Bowl,15,2,17
17125,2023-01-09,CHESTER,bounty,Layer Cake,15,15,30
17126,2023-01-08,CHESTER,knockout,X Marks the Spot,16,5,21
17127,2023-01-08,CHESTER,hotZone,Ring of Fire,47,72,119
17128,2023-01-08,CHESTER,heist,Snaked Assault,32,65,97
17129,2023-01-08,CHESTER,gemGrab,Hard Rock Mine,22,32,54
17130,2023-01-08,CHESTER,gemGrab,Double Swoosh,43,38,81
17131,2023-01-08,CHESTER,brawlBall,Super Beach,26,20,46
17132,2023-01-08,CHESTER,brawlBall,Backyard Bowl,134,129,263
17133,2023-01-08,CHESTER,bounty,Layer Cake,14,11,25
17134,2023-01-07,CHESTER,knockout,X Marks the Spot,18,18,36
17135,2023-01-07,CHESTER,hotZone,Ring of Fire,25,41,66
17136,2023-01-07,CHESTER,heist,Tornado Ring,29,26,55
17137,2023-01-07,CHESTER,gemGrab,Hard Rock Mine,43,43,86
17138,2023-01-07,CHESTER,gemGrab,Deep Diner,38,47,85
17139,2023-01-07,CHESTER,brawlBall,Super Beach,101,103,204
17140,2023-01-07,CHESTER,brawlBall,Sneaky Fields,31,20,51
17141,2023-01-07,CHESTER,bounty,Dry Season,3,3,6
17142,2023-01-06,CHESTER,knockout,Out in the Open,13,7,20
17143,2023-01-06,CHESTER,hotZone,Split,28,48,76
17144,2023-01-06,CHESTER,heist,Tornado Ring,54,54,108
17145,2023-01-06,CHESTER,gemGrab,Undermine,37,57,94
17146,2023-01-06,CHESTER,gemGrab,Deep Diner,78,95,173
17147,2023-01-06,CHESTER,brawlBall,Sneaky Fields,221,176,397
17148,2023-01-06,CHESTER,brawlBall,Pinhole Punt,30,25,55
17149,2023-01-06,CHESTER,bounty,Dry Season,12,1,13
17150,2023-01-05,CHESTER,knockout,Out in the Open,57,21,78
17151,2023-01-05,CHESTER,hotZone,Split,93,69,162
17152,2023-01-05,CHESTER,heist,Kaboom Canyon,12,13,25
17153,2023-01-05,CHESTER,gemGrab,Undermine,100,99,199
17154,2023-01-05,CHESTER,gemGrab,Gem Fort,14,11,25
17155,2023-01-05,CHESTER,brawlBall,Sunny Soccer,4,1,5
17156,2023-01-05,CHESTER,brawlBall,Pinhole Punt,430,440,870
17157,2023-01-05,CHESTER,bounty,Shooting Star,5,0,5
17158,2023-01-04,CHESTER,knockout,Goldarm Gulch,19,5,24
17159,2023-01-04,CHESTER,hotZone,Parallel Plays,48,69,117
17160,2023-01-04,CHESTER,heist,Kaboom Canyon,29,22,51
17161,2023-01-04,CHESTER,gemGrab,Gem Fort,95,84,179
17162,2023-01-04,CHESTER,gemGrab,Crystal Arcade,22,14,36
17163,2023-01-04,CHESTER,brawlBall,Sunny Soccer,298,366,664
17164,2023-01-04,CHESTER,brawlBall,Beach Ball,1,0,1
17165,2023-01-04,CHESTER,bounty,Shooting Star,12,2,14
17166,2023-01-03,CHESTER,knockout,Goldarm Gulch,21,22,43
17167,2023-01-03,CHESTER,hotZone,Parallel Plays,88,104,192
17168,2023-01-03,CHESTER,hotZone,Controller Chaos,1,1,2
17169,2023-01-03,CHESTER,heist,Pit Stop,32,25,57
17170,2023-01-03,CHESTER,heist,Kaboom Canyon,1,0,1
17171,2023-01-03,CHESTER,gemGrab,Minecart Madness,23,24,47
17172,2023-01-03,CHESTER,gemGrab,Crystal Arcade,114,103,217
17173,2023-01-03,CHESTER,brawlBall,Center Stage,12,13,25
17174,2023-01-03,CHESTER,brawlBall,Beach Ball,256,295,551
17175,2023-01-03,CHESTER,bounty,Hideout,11,10,21
17176,2023-01-02,CHESTER,knockout,Belle's Rock,20,19,39
17177,2023-01-02,CHESTER,hotZone,Quarter Pounder,119,217,336
17178,2023-01-02,CHESTER,hotZone,Controller Chaos,1,1,2
17179,2023-01-02,CHESTER,heist,Pit Stop,26,22,48
17180,2023-01-02,CHESTER,heist,Kaboom Canyon,0,1,1
17181,2023-01-02,CHESTER,gemGrab,Minecart Madness,74,83,157
17182,2023-01-02,CHESTER,gemGrab,Double Swoosh,75,92,167
17183,2023-01-02,CHESTER,brawlBall,Center Stage,340,415,755
17184,2023-01-02,CHESTER,brawlBall,Backyard Bowl,10,21,31
17185,2023-01-02,CHESTER,bounty,Hideout,18,9,27
17186,2023-01-01,CHESTER,knockout,Belle's Rock,8,6,14
17187,2023-01-01,CHESTER,hotZone,Quarter Pounder,69,85,154
17188,2023-01-01,CHESTER,heist,Bridge Too Far,5,0,5
17189,2023-01-01,CHESTER,gemGrab,Hard Rock Mine,1,2,3
17190,2023-01-01,CHESTER,gemGrab,Double Swoosh,53,82,135
17191,2023-01-01,CHESTER,brawlBall,Backyard Bowl,69,105,174
17192,2023-01-01,CHESTER,bounty,Canal Grande,4,14,18
17193,2022-12-31,CHESTER,knockout,Flaring Phoenix,0,1,1
17194,2022-12-31,CHESTER,hotZone,Controller Chaos,9,6,15
17195,2022-12-31,CHESTER,heist,Bridge Too Far,6,1,7
17196,2022-12-31,CHESTER,gemGrab,Hard Rock Mine,10,23,33
17197,2022-12-31,CHESTER,gemGrab,Deep Diner,11,2,13
17198,2022-12-31,CHESTER,brawlBall,Super Beach,22,41,63
17199,2022-12-31,CHESTER,brawlBall,Sneaky Fields,1,2,3
17200,2022-12-31,CHESTER,bounty,Canal Grande,1,0,1
17201,2022-12-30,CHESTER,knockout,Flaring Phoenix,0,2,2
17202,2022-12-30,CHESTER,hotZone,Controller Chaos,16,40,56
17203,2022-12-30,CHESTER,heist,Kaboom Canyon,0,3,3
17204,2022-12-30,CHESTER,heist,Hot Potato,4,1,5
17205,2022-12-30,CHESTER,gemGrab,Undermine,7,2,9
17206,2022-12-30,CHESTER,gemGrab,Minecart Madness,2,4,6
17207,2022-12-30,CHESTER,gemGrab,Deep Diner,21,33,54
17208,2022-12-30,CHESTER,brawlBall,Sneaky Fields,39,41,80
17209,2022-12-29,CHESTER,hotZone,Open Zone,4,2,6
17210,2022-12-29,CHESTER,hotZone,Controller Chaos,0,1,1
17211,2022-12-29,CHESTER,heist,Hot Potato,1,0,1
17212,2022-12-29,CHESTER,gemGrab,Undermine,4,1,5
17213,2022-12-29,CHESTER,gemGrab,Gem Fort,2,1,3
17214,2022-12-29,CHESTER,brawlBall,Pinhole Punt,14,19,33
17215,2022-12-28,CHESTER,hotZone,Open Zone,6,11,17
17216,2022-12-28,CHESTER,hotZone,Controller Chaos,2,4,6
17217,2022-12-28,CHESTER,gemGrab,Crystal Arcade,2,2,4
17218,2022-12-28,CHESTER,brawlBall,Sunny Soccer,3,3,6
17219,2022-12-28,CHESTER,brawlBall,Beach Ball,4,4,8
17220,2022-12-27,CHESTER,hotZone,Controller Chaos,2,2,4
17221,2022-12-27,CHESTER,heist,Safe Zone,0,2,2
17222,2022-12-27,CHESTER,gemGrab,Minecart Madness,1,0,1
17223,2022-12-27,CHESTER,brawlBall,Center Stage,1,2,3
17224,2022-12-27,CHESTER,brawlBall,Beach Ball,14,11,25
17225,2022-12-26,CHESTER,hotZone,Controller Chaos,1,3,4
17226,2022-12-26,CHESTER,gemGrab,Minecart Madness,3,2,5
17227,2022-12-26,CHESTER,brawlBall,Center Stage,4,4,8
17228,2022-12-25,CHESTER,hotZone,Ring of Fire,0,1,1
17229,2022-12-25,CHESTER,gemGrab,Double Swoosh,3,3,6
17230,2022-12-25,CHESTER,brawlBall,Backyard Bowl,3,2,5
17231,2022-12-24,CHESTER,brawlBall,Super Beach,3,3,6
17232,2022-12-24,CHESTER,bounty,Dry Season,0,1,1
17233,2022-12-23,CHESTER,knockout,Out in the Open,4,2,6
17234,2022-12-23,CHESTER,gemGrab,Deep Diner,1,1,2
17235,2022-12-23,CHESTER,brawlBall,Sneaky Fields,2,0,2
17236,2022-12-22,CHESTER,gemGrab,Gem Fort,8,14,22
17237,2022-12-22,CHESTER,brawlBall,Pinhole Punt,0,17,17
17238,2022-12-21,CHESTER,brawlBall,Sunny Soccer,3,4,7
17239,2022-12-20,CHESTER,brawlBall,Beach Ball,2,5,7
17240,2022-12-19,CHESTER,gemGrab,Minecart Madness,6,2,8
17241,2022-12-19,CHESTER,brawlBall,Center Stage,3,9,12
17242,2022-12-17,CHESTER,knockout,Flaring Phoenix,0,1,1
17243,2022-12-17,CHESTER,brawlBall,Super Beach,1,1,2
17244,2022-12-16,CHESTER,hotZone,Controller Chaos,0,1,1
17245,2022-12-16,CHESTER,brawlBall,Sneaky Fields,6,2,8
17246,2022-12-16,CHESTER,bounty,Temple Ruins,1,0,1
17247,2022-12-15,CHESTER,heist,Hot Potato,0,2,2
17248,2022-12-13,CHESTER,knockout,New Perspective,6,0,6
17249,2022-12-13,CHESTER,hotZone,Dueling Beetles,0,1,1
17250,2022-12-13,CHESTER,heist,Safe Zone,1,0,1
17251,2022-12-13,CHESTER,gemGrab,Crystal Arcade,4,8,12
17252,2022-12-13,CHESTER,brawlBall,Beach Ball,3,6,9
17253,2023-02-11,CARL,knockout,Flaring Phoenix,45,28,73
17254,2023-02-11,CARL,hotZone,Controller Chaos,35,55,90
17255,2023-02-11,CARL,gemGrab,Deep Diner,80,108,188
17256,2023-02-11,CARL,brawlBall,Super Beach,62,73,135
17257,2023-02-11,CARL,brawlBall,Sneaky Fields,34,50,84
17258,2023-02-10,CARL,knockout,Flaring Phoenix,77,78,155
17259,2023-02-10,CARL,hotZone,Controller Chaos,52,38,90
17260,2023-02-10,CARL,heist,Hot Potato,33,15,48
17261,2023-02-10,CARL,gemGrab,Undermine,26,48,74
17262,2023-02-10,CARL,gemGrab,Deep Diner,193,230,423
17263,2023-02-10,CARL,brawlBall,Sneaky Fields,313,264,577
17264,2023-02-10,CARL,brawlBall,Pinhole Punt,9,6,15
17265,2023-02-10,CARL,bounty,Temple Ruins,32,35,67
17266,2023-02-09,CARL,knockout,Riverside,7,13,20
17267,2023-02-09,CARL,hotZone,Open Zone,8,4,12
17268,2023-02-09,CARL,heist,Hot Potato,9,6,15
17269,2023-02-09,CARL,gemGrab,Undermine,33,20,53
17270,2023-02-09,CARL,gemGrab,Gem Fort,3,1,4
17271,2023-02-09,CARL,brawlBall,Sunny Soccer,1,0,1
17272,2023-02-09,CARL,brawlBall,Pinhole Punt,156,153,309
17273,2023-02-09,CARL,bounty,Temple Ruins,15,19,34
17274,2023-02-08,CARL,knockout,Riverside,13,14,27
17275,2023-02-08,CARL,hotZone,Open Zone,6,5,11
17276,2023-02-08,CARL,heist,Safe Zone,9,11,20
17277,2023-02-08,CARL,gemGrab,Gem Fort,7,6,13
17278,2023-02-08,CARL,gemGrab,Crystal Arcade,5,4,9
17279,2023-02-08,CARL,brawlBall,Sunny Soccer,38,39,77
17280,2023-02-08,CARL,brawlBall,Beach Ball,3,0,3
17281,2023-02-08,CARL,bounty,Excel,5,9,14
17282,2023-02-07,CARL,knockout,New Perspective,4,3,7
17283,2023-02-07,CARL,hotZone,Dueling Beetles,19,32,51
17284,2023-02-07,CARL,heist,Safe Zone,7,17,24
17285,2023-02-07,CARL,gemGrab,Minecart Madness,13,5,18
17286,2023-02-07,CARL,gemGrab,Crystal Arcade,1,6,7
17287,2023-02-07,CARL,brawlBall,Center Stage,2,0,2
17288,2023-02-07,CARL,brawlBall,Beach Ball,24,31,55
17289,2023-02-07,CARL,bounty,Excel,3,1,4
17290,2023-02-06,CARL,knockout,New Perspective,95,67,162
17291,2023-02-06,CARL,knockout,Goldarm Gulch,16,9,25
17292,2023-02-06,CARL,hotZone,Dueling Beetles,279,321,600
17293,2023-02-06,CARL,heist,Snaked Assault,79,49,128
17294,2023-02-06,CARL,heist,Pit Stop,7,4,11
17295,2023-02-06,CARL,gemGrab,Minecart Madness,236,349,585
17296,2023-02-06,CARL,gemGrab,Double Swoosh,96,116,212
17297,2023-02-06,CARL,brawlBall,Sneaky Fields,3,12,15
17298,2023-02-06,CARL,brawlBall,Center Stage,423,364,787
17299,2023-02-06,CARL,brawlBall,Backyard Bowl,55,65,120
17300,2023-02-06,CARL,bounty,Layer Cake,83,172,255
17301,2023-02-05,CARL,knockout,X Marks the Spot,81,105,186
17302,2023-02-05,CARL,knockout,Goldarm Gulch,48,49,97
17303,2023-02-05,CARL,hotZone,Ring of Fire,57,73,130
17304,2023-02-05,CARL,heist,Snaked Assault,62,47,109
17305,2023-02-05,CARL,heist,Pit Stop,25,29,54
17306,2023-02-05,CARL,gemGrab,Hard Rock Mine,41,66,107
17307,2023-02-05,CARL,gemGrab,Double Swoosh,182,218,400
17308,2023-02-05,CARL,brawlBall,Super Beach,22,13,35
17309,2023-02-05,CARL,brawlBall,Sneaky Fields,21,20,41
17310,2023-02-05,CARL,brawlBall,Backyard Bowl,720,756,1476
17311,2023-02-05,CARL,bounty,Layer Cake,69,85,154
17312,2023-02-04,CARL,knockout,X Marks the Spot,21,20,41
17313,2023-02-04,CARL,knockout,Goldarm Gulch,35,24,59
17314,2023-02-04,CARL,hotZone,Ring of Fire,19,22,41
17315,2023-02-04,CARL,heist,Tornado Ring,8,3,11
17316,2023-02-04,CARL,heist,Pit Stop,21,10,31
17317,2023-02-04,CARL,gemGrab,Hard Rock Mine,54,54,108
17318,2023-02-04,CARL,gemGrab,Double Swoosh,31,35,66
17319,2023-02-04,CARL,gemGrab,Deep Diner,14,19,33
17320,2023-02-04,CARL,brawlBall,Super Beach,132,98,230
17321,2023-02-04,CARL,brawlBall,Sneaky Fields,10,12,22
17322,2023-02-04,CARL,bounty,Dry Season,12,16,28
17323,2023-02-03,CARL,knockout,Out in the Open,151,155,306
17324,2023-02-03,CARL,knockout,Goldarm Gulch,213,165,378
17325,2023-02-03,CARL,hotZone,Split,19,30,49
17326,2023-02-03,CARL,heist,Tornado Ring,44,28,72
17327,2023-02-03,CARL,heist,Pit Stop,123,109,232
17328,2023-02-03,CARL,gemGrab,Undermine,24,29,53
17329,2023-02-03,CARL,gemGrab,Double Swoosh,120,203,323
17330,2023-02-03,CARL,gemGrab,Deep Diner,172,228,400
17331,2023-02-03,CARL,brawlBall,Sneaky Fields,341,370,711
17332,2023-02-03,CARL,brawlBall,Pinhole Punt,25,38,63
17333,2023-02-03,CARL,bounty,Dry Season,88,103,191
17334,2023-02-02,CARL,knockout,Out in the Open,79,72,151
17335,2023-02-02,CARL,hotZone,Split,10,7,17
17336,2023-02-02,CARL,heist,Kaboom Canyon,12,13,25
17337,2023-02-02,CARL,gemGrab,Undermine,23,17,40
17338,2023-02-02,CARL,gemGrab,Gem Fort,8,7,15
17339,2023-02-02,CARL,brawlBall,Sunny Soccer,3,1,4
17340,2023-02-02,CARL,brawlBall,Pinhole Punt,234,206,440
17341,2023-02-02,CARL,bounty,Shooting Star,9,6,15
17342,2023-02-01,CARL,knockout,Goldarm Gulch,120,92,212
17343,2023-02-01,CARL,hotZone,Parallel Plays,47,52,99
17344,2023-02-01,CARL,heist,Kaboom Canyon,62,46,108
17345,2023-02-01,CARL,gemGrab,Gem Fort,48,52,100
17346,2023-02-01,CARL,gemGrab,Crystal Arcade,79,162,241
17347,2023-02-01,CARL,brawlBall,Sunny Soccer,450,433,883
17348,2023-02-01,CARL,brawlBall,Beach Ball,25,35,60
17349,2023-02-01,CARL,bounty,Shooting Star,24,26,50
17350,2023-01-31,CARL,knockout,Goldarm Gulch,55,67,122
17351,2023-01-31,CARL,hotZone,Parallel Plays,29,29,58
17352,2023-01-31,CARL,heist,Pit Stop,18,14,32
17353,2023-01-31,CARL,gemGrab,Minecart Madness,18,24,42
17354,2023-01-31,CARL,gemGrab,Crystal Arcade,79,94,173
17355,2023-01-31,CARL,brawlBall,Center Stage,1,3,4
17356,2023-01-31,CARL,brawlBall,Beach Ball,193,171,364
17357,2023-01-31,CARL,bounty,Hideout,15,5,20
17358,2023-01-30,CARL,knockout,Belle's Rock,210,201,411
17359,2023-01-30,CARL,hotZone,Quarter Pounder,102,110,212
17360,2023-01-30,CARL,heist,Pit Stop,64,31,95
17361,2023-01-30,CARL,gemGrab,Minecart Madness,118,155,273
17362,2023-01-30,CARL,gemGrab,Double Swoosh,49,71,120
17363,2023-01-30,CARL,brawlBall,Center Stage,229,155,384
17364,2023-01-30,CARL,brawlBall,Backyard Bowl,47,51,98
17365,2023-01-30,CARL,bounty,Hideout,17,28,45
17366,2023-01-29,CARL,knockout,Belle's Rock,276,239,515
17367,2023-01-29,CARL,hotZone,Quarter Pounder,107,144,251
17368,2023-01-29,CARL,heist,Bridge Too Far,68,69,137
17369,2023-01-29,CARL,gemGrab,Hard Rock Mine,29,38,67
17370,2023-01-29,CARL,gemGrab,Double Swoosh,70,61,131
17371,2023-01-29,CARL,brawlBall,Super Beach,2,2,4
17372,2023-01-29,CARL,brawlBall,Backyard Bowl,569,513,1082
17373,2023-01-29,CARL,bounty,Canal Grande,51,52,103
17374,2023-01-28,CARL,knockout,Flaring Phoenix,56,51,107
17375,2023-01-28,CARL,hotZone,Controller Chaos,36,40,76
17376,2023-01-28,CARL,heist,Bridge Too Far,193,145,338
17377,2023-01-28,CARL,gemGrab,Hard Rock Mine,179,257,436
17378,2023-01-28,CARL,gemGrab,Deep Diner,72,98,170
17379,2023-01-28,CARL,brawlBall,Super Beach,420,428,848
17380,2023-01-28,CARL,brawlBall,Sneaky Fields,14,19,33
17381,2023-01-28,CARL,bounty,Canal Grande,74,116,190
17382,2023-01-27,CARL,knockout,Flaring Phoenix,24,13,37
17383,2023-01-27,CARL,hotZone,Controller Chaos,22,33,55
17384,2023-01-27,CARL,heist,Hot Potato,20,12,32
17385,2023-01-27,CARL,gemGrab,Undermine,8,10,18
17386,2023-01-27,CARL,gemGrab,Deep Diner,61,97,158
17387,2023-01-27,CARL,brawlBall,Sneaky Fields,100,91,191
17388,2023-01-27,CARL,brawlBall,Pinhole Punt,9,18,27
17389,2023-01-27,CARL,bounty,Temple Ruins,12,13,25
17390,2023-01-26,CARL,knockout,Riverside,117,107,224
17391,2023-01-26,CARL,hotZone,Open Zone,86,91,177
17392,2023-01-26,CARL,heist,Hot Potato,53,89,142
17393,2023-01-26,CARL,gemGrab,Undermine,64,55,119
17394,2023-01-26,CARL,gemGrab,Gem Fort,21,15,36
17395,2023-01-26,CARL,brawlBall,Sunny Soccer,21,41,62
17396,2023-01-26,CARL,brawlBall,Pinhole Punt,544,582,1126
17397,2023-01-26,CARL,bounty,Temple Ruins,28,34,62
17398,2023-01-25,CARL,knockout,Riverside,47,32,79
17399,2023-01-25,CARL,hotZone,Open Zone,43,54,97
17400,2023-01-25,CARL,heist,Safe Zone,96,110,206
17401,2023-01-25,CARL,gemGrab,Gem Fort,26,23,49
17402,2023-01-25,CARL,gemGrab,Crystal Arcade,77,137,214
17403,2023-01-25,CARL,brawlBall,Sunny Soccer,271,263,534
17404,2023-01-25,CARL,brawlBall,Beach Ball,34,52,86
17405,2023-01-25,CARL,bounty,Excel,46,97,143
17406,2023-01-24,CARL,knockout,New Perspective,55,36,91
17407,2023-01-24,CARL,hotZone,Dueling Beetles,73,81,154
17408,2023-01-24,CARL,heist,Safe Zone,161,171,332
17409,2023-01-24,CARL,gemGrab,Minecart Madness,60,81,141
17410,2023-01-24,CARL,gemGrab,Crystal Arcade,145,217,362
17411,2023-01-24,CARL,brawlBall,Center Stage,45,45,90
17412,2023-01-24,CARL,brawlBall,Beach Ball,499,588,1087
17413,2023-01-24,CARL,bounty,Excel,68,109,177
17414,2023-01-23,CARL,knockout,New Perspective,114,123,237
17415,2023-01-23,CARL,hotZone,Dueling Beetles,166,224,390
17416,2023-01-23,CARL,heist,Snaked Assault,66,34,100
17417,2023-01-23,CARL,gemGrab,Minecart Madness,279,367,646
17418,2023-01-23,CARL,gemGrab,Double Swoosh,44,57,101
17419,2023-01-23,CARL,brawlBall,Center Stage,413,420,833
17420,2023-01-23,CARL,brawlBall,Backyard Bowl,40,49,89
17421,2023-01-23,CARL,bounty,Layer Cake,62,63,125
17422,2023-01-22,CARL,knockout,X Marks the Spot,51,56,107
17423,2023-01-22,CARL,hotZone,Ring of Fire,42,66,108
17424,2023-01-22,CARL,heist,Snaked Assault,33,27,60
17425,2023-01-22,CARL,gemGrab,Hard Rock Mine,45,55,100
17426,2023-01-22,CARL,gemGrab,Double Swoosh,43,31,74
17427,2023-01-22,CARL,brawlBall,Super Beach,44,57,101
17428,2023-01-22,CARL,brawlBall,Backyard Bowl,301,346,647
17429,2023-01-22,CARL,bounty,Layer Cake,45,43,88
17430,2023-01-21,CARL,knockout,X Marks the Spot,215,160,375
17431,2023-01-21,CARL,hotZone,Ring of Fire,127,156,283
17432,2023-01-21,CARL,heist,Tornado Ring,36,44,80
17433,2023-01-21,CARL,gemGrab,Hard Rock Mine,178,263,441
17434,2023-01-21,CARL,gemGrab,Deep Diner,45,73,118
17435,2023-01-21,CARL,brawlBall,Super Beach,658,728,1386
17436,2023-01-21,CARL,brawlBall,Sneaky Fields,10,6,16
17437,2023-01-21,CARL,bounty,Dry Season,61,76,137
17438,2023-01-20,CARL,knockout,Out in the Open,171,182,353
17439,2023-01-20,CARL,hotZone,Split,15,22,37
17440,2023-01-20,CARL,heist,Tornado Ring,61,41,102
17441,2023-01-20,CARL,gemGrab,Undermine,29,17,46
17442,2023-01-20,CARL,gemGrab,Deep Diner,167,179,346
17443,2023-01-20,CARL,brawlBall,Sneaky Fields,268,243,511
17444,2023-01-20,CARL,brawlBall,Pinhole Punt,24,19,43
17445,2023-01-20,CARL,bounty,Dry Season,45,69,114
17446,2023-01-19,CARL,knockout,Out in the Open,261,256,517
17447,2023-01-19,CARL,hotZone,Split,26,30,56
17448,2023-01-19,CARL,heist,Kaboom Canyon,69,82,151
17449,2023-01-19,CARL,gemGrab,Undermine,119,114,233
17450,2023-01-19,CARL,gemGrab,Gem Fort,14,13,27
17451,2023-01-19,CARL,brawlBall,Sunny Soccer,20,22,42
17452,2023-01-19,CARL,brawlBall,Pinhole Punt,626,736,1362
17453,2023-01-19,CARL,bounty,Shooting Star,32,25,57
17454,2023-01-18,CARL,knockout,Goldarm Gulch,15,9,24
17455,2023-01-18,CARL,hotZone,Parallel Plays,4,4,8
17456,2023-01-18,CARL,heist,Kaboom Canyon,20,31,51
17457,2023-01-18,CARL,gemGrab,Gem Fort,18,7,25
17458,2023-01-18,CARL,gemGrab,Crystal Arcade,12,4,16
17459,2023-01-18,CARL,brawlBall,Sunny Soccer,128,143,271
17460,2023-01-18,CARL,brawlBall,Beach Ball,3,2,5
17461,2023-01-18,CARL,bounty,Shooting Star,12,21,33
17462,2023-01-17,CARL,knockout,Goldarm Gulch,20,13,33
17463,2023-01-17,CARL,hotZone,Parallel Plays,3,7,10
17464,2023-01-17,CARL,heist,Pit Stop,4,1,5
17465,2023-01-17,CARL,gemGrab,Minecart Madness,4,10,14
17466,2023-01-17,CARL,gemGrab,Crystal Arcade,15,19,34
17467,2023-01-17,CARL,brawlBall,Center Stage,2,1,3
17468,2023-01-17,CARL,brawlBall,Beach Ball,56,54,110
17469,2023-01-17,CARL,bounty,Hideout,5,4,9
17470,2023-01-16,CARL,knockout,Belle's Rock,20,19,39
17471,2023-01-16,CARL,hotZone,Quarter Pounder,6,15,21
17472,2023-01-16,CARL,heist,Pit Stop,18,22,40
17473,2023-01-16,CARL,gemGrab,Minecart Madness,23,41,64
17474,2023-01-16,CARL,gemGrab,Double Swoosh,3,2,5
17475,2023-01-16,CARL,brawlBall,Center Stage,25,20,45
17476,2023-01-16,CARL,brawlBall,Backyard Bowl,4,3,7
17477,2023-01-16,CARL,bounty,Hideout,4,10,14
17478,2023-01-15,CARL,knockout,Belle's Rock,27,24,51
17479,2023-01-15,CARL,hotZone,Quarter Pounder,22,69,91
17480,2023-01-15,CARL,heist,Bridge Too Far,17,23,40
17481,2023-01-15,CARL,gemGrab,Hard Rock Mine,13,11,24
17482,2023-01-15,CARL,gemGrab,Double Swoosh,6,5,11
17483,2023-01-15,CARL,brawlBall,Super Beach,9,18,27
17484,2023-01-15,CARL,brawlBall,Backyard Bowl,61,114,175
17485,2023-01-15,CARL,bounty,Canal Grande,10,26,36
17486,2023-01-14,CARL,knockout,Flaring Phoenix,4,6,10
17487,2023-01-14,CARL,hotZone,Controller Chaos,7,11,18
17488,2023-01-14,CARL,heist,Bridge Too Far,28,13,41
17489,2023-01-14,CARL,gemGrab,Hard Rock Mine,14,42,56
17490,2023-01-14,CARL,gemGrab,Deep Diner,16,14,30
17491,2023-01-14,CARL,brawlBall,Super Beach,41,41,82
17492,2023-01-14,CARL,brawlBall,Sneaky Fields,2,0,2
17493,2023-01-14,CARL,bounty,Canal Grande,9,13,22
17494,2023-01-13,CARL,knockout,Flaring Phoenix,11,28,39
17495,2023-01-13,CARL,hotZone,Controller Chaos,15,15,30
17496,2023-01-13,CARL,heist,Hot Potato,4,1,5
17497,2023-01-13,CARL,gemGrab,Undermine,0,1,1
17498,2023-01-13,CARL,gemGrab,Deep Diner,20,35,55
17499,2023-01-13,CARL,brawlBall,Sneaky Fields,15,11,26
17500,2023-01-13,CARL,brawlBall,Pinhole Punt,1,2,3
17501,2023-01-13,CARL,bounty,Temple Ruins,0,5,5
17502,2023-01-12,CARL,knockout,Riverside,13,13,26
17503,2023-01-12,CARL,hotZone,Open Zone,9,27,36
17504,2023-01-12,CARL,heist,Hot Potato,0,2,2
17505,2023-01-12,CARL,gemGrab,Undermine,4,2,6
17506,2023-01-12,CARL,brawlBall,Pinhole Punt,13,21,34
17507,2023-01-11,CARL,knockout,Riverside,2,0,2
17508,2023-01-11,CARL,hotZone,Open Zone,4,6,10
17509,2023-01-11,CARL,gemGrab,Gem Fort,2,0,2
17510,2023-01-11,CARL,brawlBall,Sunny Soccer,8,10,18
17511,2023-01-11,CARL,bounty,Excel,1,0,1
17512,2023-01-10,CARL,knockout,New Perspective,2,4,6
17513,2023-01-10,CARL,hotZone,Dueling Beetles,29,50,79
17514,2023-01-10,CARL,heist,Safe Zone,15,11,26
17515,2023-01-10,CARL,gemGrab,Minecart Madness,11,19,30
17516,2023-01-10,CARL,gemGrab,Crystal Arcade,11,8,19
17517,2023-01-10,CARL,brawlBall,Center Stage,5,1,6
17518,2023-01-10,CARL,brawlBall,Beach Ball,38,52,90
17519,2023-01-10,CARL,bounty,Excel,3,9,12
17520,2023-01-09,CARL,knockout,New Perspective,3,3,6
17521,2023-01-09,CARL,hotZone,Dueling Beetles,17,24,41
17522,2023-01-09,CARL,heist,Snaked Assault,7,3,10
17523,2023-01-09,CARL,gemGrab,Minecart Madness,34,44,78
17524,2023-01-09,CARL,gemGrab,Double Swoosh,5,3,8
17525,2023-01-09,CARL,brawlBall,Center Stage,17,6,23
17526,2023-01-09,CARL,brawlBall,Backyard Bowl,3,12,15
17527,2023-01-09,CARL,bounty,Layer Cake,12,20,32
17528,2023-01-08,CARL,knockout,X Marks the Spot,20,11,31
17529,2023-01-08,CARL,hotZone,Ring of Fire,6,17,23
17530,2023-01-08,CARL,heist,Snaked Assault,5,2,7
17531,2023-01-08,CARL,gemGrab,Hard Rock Mine,3,2,5
17532,2023-01-08,CARL,gemGrab,Double Swoosh,7,4,11
17533,2023-01-08,CARL,brawlBall,Super Beach,2,6,8
17534,2023-01-08,CARL,brawlBall,Backyard Bowl,55,54,109
17535,2023-01-08,CARL,bounty,Layer Cake,2,1,3
17536,2023-01-07,CARL,knockout,X Marks the Spot,6,8,14
17537,2023-01-07,CARL,hotZone,Ring of Fire,5,1,6
17538,2023-01-07,CARL,heist,Tornado Ring,5,0,5
17539,2023-01-07,CARL,gemGrab,Hard Rock Mine,18,14,32
17540,2023-01-07,CARL,gemGrab,Deep Diner,7,6,13
17541,2023-01-07,CARL,brawlBall,Super Beach,17,14,31
17542,2023-01-07,CARL,brawlBall,Sneaky Fields,1,0,1
17543,2023-01-07,CARL,bounty,Dry Season,14,17,31
17544,2023-01-06,CARL,knockout,Out in the Open,17,6,23
17545,2023-01-06,CARL,hotZone,Split,1,1,2
17546,2023-01-06,CARL,heist,Tornado Ring,1,1,2
17547,2023-01-06,CARL,gemGrab,Undermine,4,5,9
17548,2023-01-06,CARL,gemGrab,Deep Diner,31,44,75
17549,2023-01-06,CARL,brawlBall,Sneaky Fields,12,17,29
17550,2023-01-06,CARL,brawlBall,Pinhole Punt,6,5,11
17551,2023-01-06,CARL,bounty,Dry Season,17,27,44
17552,2023-01-05,CARL,knockout,Out in the Open,39,15,54
17553,2023-01-05,CARL,hotZone,Split,5,1,6
17554,2023-01-05,CARL,heist,Kaboom Canyon,10,27,37
17555,2023-01-05,CARL,gemGrab,Undermine,16,35,51
17556,2023-01-05,CARL,gemGrab,Gem Fort,0,2,2
17557,2023-01-05,CARL,brawlBall,Sunny Soccer,0,1,1
17558,2023-01-05,CARL,brawlBall,Pinhole Punt,100,121,221
17559,2023-01-05,CARL,bounty,Shooting Star,3,3,6
17560,2023-01-04,CARL,knockout,Goldarm Gulch,2,4,6
17561,2023-01-04,CARL,hotZone,Parallel Plays,5,0,5
17562,2023-01-04,CARL,heist,Kaboom Canyon,15,14,29
17563,2023-01-04,CARL,gemGrab,Gem Fort,15,49,64
17564,2023-01-04,CARL,gemGrab,Crystal Arcade,5,24,29
17565,2023-01-04,CARL,brawlBall,Sunny Soccer,68,138,206
17566,2023-01-04,CARL,brawlBall,Beach Ball,0,7,7
17567,2023-01-04,CARL,bounty,Shooting Star,10,2,12
17568,2023-01-03,CARL,knockout,Goldarm Gulch,5,2,7
17569,2023-01-03,CARL,hotZone,Parallel Plays,11,5,16
17570,2023-01-03,CARL,hotZone,Controller Chaos,0,1,1
17571,2023-01-03,CARL,heist,Pit Stop,9,19,28
17572,2023-01-03,CARL,gemGrab,Minecart Madness,3,6,9
17573,2023-01-03,CARL,gemGrab,Crystal Arcade,28,52,80
17574,2023-01-03,CARL,brawlBall,Center Stage,1,6,7
17575,2023-01-03,CARL,brawlBall,Beach Ball,52,71,123
17576,2023-01-03,CARL,bounty,Hideout,9,10,19
17577,2023-01-02,CARL,knockout,Belle's Rock,25,32,57
17578,2023-01-02,CARL,hotZone,Quarter Pounder,18,29,47
17579,2023-01-02,CARL,heist,Pit Stop,14,8,22
17580,2023-01-02,CARL,gemGrab,Minecart Madness,38,30,68
17581,2023-01-02,CARL,gemGrab,Double Swoosh,7,2,9
17582,2023-01-02,CARL,brawlBall,Center Stage,37,27,64
17583,2023-01-02,CARL,brawlBall,Backyard Bowl,1,11,12
17584,2023-01-02,CARL,bounty,Hideout,14,2,16
17585,2023-01-01,CARL,knockout,Belle's Rock,15,6,21
17586,2023-01-01,CARL,hotZone,Quarter Pounder,8,5,13
17587,2023-01-01,CARL,heist,Bridge Too Far,1,2,3
17588,2023-01-01,CARL,gemGrab,Minecart Madness,1,2,3
17589,2023-01-01,CARL,gemGrab,Hard Rock Mine,0,1,1
17590,2023-01-01,CARL,gemGrab,Double Swoosh,12,14,26
17591,2023-01-01,CARL,brawlBall,Backyard Bowl,35,8,43
17592,2023-01-01,CARL,bounty,Canal Grande,4,0,4
17593,2022-12-31,CARL,knockout,Flaring Phoenix,0,1,1
17594,2022-12-31,CARL,hotZone,Controller Chaos,0,2,2
17595,2022-12-31,CARL,heist,Bridge Too Far,1,0,1
17596,2022-12-31,CARL,gemGrab,Hard Rock Mine,7,9,16
17597,2022-12-31,CARL,gemGrab,Deep Diner,2,0,2
17598,2022-12-31,CARL,brawlBall,Super Beach,3,0,3
17599,2022-12-31,CARL,bounty,Canal Grande,0,1,1
17600,2022-12-30,CARL,knockout,Flaring Phoenix,2,0,2
17601,2022-12-30,CARL,gemGrab,Deep Diner,9,11,20
17602,2022-12-30,CARL,brawlBall,Sneaky Fields,1,7,8
17603,2022-12-29,CARL,hotZone,Open Zone,0,1,1
17604,2022-12-29,CARL,hotZone,Controller Chaos,1,0,1
17605,2022-12-29,CARL,gemGrab,Undermine,0,1,1
17606,2022-12-29,CARL,brawlBall,Pinhole Punt,0,3,3
17607,2022-12-28,CARL,hotZone,Open Zone,2,0,2
17608,2022-12-28,CARL,brawlBall,Sunny Soccer,0,2,2
17609,2022-12-27,CARL,hotZone,Dueling Beetles,1,0,1
17610,2022-12-27,CARL,heist,Kaboom Canyon,0,1,1
17611,2022-12-27,CARL,gemGrab,Minecart Madness,1,1,2
17612,2022-12-27,CARL,brawlBall,Center Stage,0,1,1
17613,2022-12-27,CARL,brawlBall,Beach Ball,3,1,4
17614,2022-12-25,CARL,brawlBall,Backyard Bowl,1,0,1
17615,2022-12-25,CARL,bounty,Layer Cake,0,2,2
17616,2022-12-23,CARL,knockout,Out in the Open,10,12,22
17617,2022-12-22,CARL,brawlBall,Pinhole Punt,1,0,1
17618,2022-12-19,CARL,gemGrab,Minecart Madness,2,0,2
17619,2022-12-19,CARL,brawlBall,Center Stage,1,0,1
17620,2022-12-18,CARL,knockout,Belle's Rock,0,1,1
17621,2022-12-13,CARL,knockout,New Perspective,1,0,1
17622,2022-12-13,CARL,gemGrab,Crystal Arcade,1,0,1
17623,2022-12-13,CARL,brawlBall,Beach Ball,1,0,1
17624,2022-12-11,CARL,brawlBall,Backyard Bowl,0,2,2
17625,2022-12-10,CARL,knockout,X Marks the Spot,1,1,2
17626,2022-12-10,CARL,hotZone,Ring of Fire,1,0,1
17627,2022-12-10,CARL,gemGrab,Hard Rock Mine,0,1,1
17628,2022-11-18,CARL,hotZone,Parallel Plays,2,4,6
17629,2022-11-11,CARL,knockout,New Perspective,2,0,2
17630,2022-11-11,CARL,brawlBall,Sneaky Fields,2,0,2
17631,2022-10-28,CARL,knockout,Out in the Open,6,2,8
17632,2022-10-28,CARL,hotZone,Dueling Beetles,0,4,4
17633,2022-10-28,CARL,heist,Safe Zone,0,2,2
17634,2022-10-10,CARL,knockout,Belle's Rock,0,1,1
17635,2022-09-07,CARL,brawlBall,Sunny Soccer,2,0,2
17636,2023-02-11,BYRON,knockout,Flaring Phoenix,48,31,79
17637,2023-02-11,BYRON,hotZone,Controller Chaos,16,5,21
17638,2023-02-11,BYRON,gemGrab,Deep Diner,47,24,71
17639,2023-02-11,BYRON,brawlBall,Super Beach,15,21,36
17640,2023-02-11,BYRON,brawlBall,Sneaky Fields,7,4,11
17641,2023-02-10,BYRON,knockout,Flaring Phoenix,116,98,214
17642,2023-02-10,BYRON,hotZone,Controller Chaos,23,11,34
17643,2023-02-10,BYRON,heist,Hot Potato,4,4,8
17644,2023-02-10,BYRON,gemGrab,Undermine,36,24,60
17645,2023-02-10,BYRON,gemGrab,Deep Diner,105,79,184
17646,2023-02-10,BYRON,brawlBall,Sneaky Fields,97,95,192
17647,2023-02-10,BYRON,brawlBall,Pinhole Punt,11,8,19
17648,2023-02-10,BYRON,bounty,Temple Ruins,32,24,56
17649,2023-02-09,BYRON,knockout,Riverside,49,77,126
17650,2023-02-09,BYRON,hotZone,Open Zone,14,11,25
17651,2023-02-09,BYRON,heist,Hot Potato,3,1,4
17652,2023-02-09,BYRON,gemGrab,Undermine,18,14,32
17653,2023-02-09,BYRON,gemGrab,Gem Fort,3,3,6
17654,2023-02-09,BYRON,brawlBall,Sunny Soccer,1,1,2
17655,2023-02-09,BYRON,brawlBall,Pinhole Punt,63,54,117
17656,2023-02-09,BYRON,bounty,Temple Ruins,20,14,34
17657,2023-02-08,BYRON,knockout,Riverside,34,30,64
17658,2023-02-08,BYRON,hotZone,Open Zone,16,7,23
17659,2023-02-08,BYRON,heist,Safe Zone,8,7,15
17660,2023-02-08,BYRON,gemGrab,Gem Fort,10,5,15
17661,2023-02-08,BYRON,gemGrab,Crystal Arcade,5,9,14
17662,2023-02-08,BYRON,brawlBall,Sunny Soccer,11,7,18
17663,2023-02-08,BYRON,brawlBall,Beach Ball,1,1,2
17664,2023-02-08,BYRON,bounty,Excel,8,8,16
17665,2023-02-07,BYRON,knockout,New Perspective,6,5,11
17666,2023-02-07,BYRON,hotZone,Dueling Beetles,5,0,5
17667,2023-02-07,BYRON,heist,Safe Zone,9,11,20
17668,2023-02-07,BYRON,gemGrab,Minecart Madness,5,8,13
17669,2023-02-07,BYRON,gemGrab,Crystal Arcade,4,7,11
17670,2023-02-07,BYRON,brawlBall,Beach Ball,10,5,15
17671,2023-02-07,BYRON,bounty,Excel,4,5,9
17672,2023-02-06,BYRON,knockout,New Perspective,99,77,176
17673,2023-02-06,BYRON,hotZone,Dueling Beetles,38,46,84
17674,2023-02-06,BYRON,heist,Snaked Assault,17,4,21
17675,2023-02-06,BYRON,gemGrab,Minecart Madness,140,137,277
17676,2023-02-06,BYRON,gemGrab,Double Swoosh,9,12,21
17677,2023-02-06,BYRON,brawlBall,Center Stage,104,53,157
17678,2023-02-06,BYRON,brawlBall,Backyard Bowl,27,27,54
17679,2023-02-06,BYRON,bounty,Layer Cake,32,37,69
17680,2023-02-05,BYRON,knockout,X Marks the Spot,56,60,116
17681,2023-02-05,BYRON,knockout,Goldarm Gulch,1,1,2
17682,2023-02-05,BYRON,hotZone,Ring of Fire,28,14,42
17683,2023-02-05,BYRON,heist,Snaked Assault,12,12,24
17684,2023-02-05,BYRON,heist,Pit Stop,0,1,1
17685,2023-02-05,BYRON,gemGrab,Hard Rock Mine,16,11,27
17686,2023-02-05,BYRON,gemGrab,Double Swoosh,58,37,95
17687,2023-02-05,BYRON,brawlBall,Super Beach,4,6,10
17688,2023-02-05,BYRON,brawlBall,Sneaky Fields,3,8,11
17689,2023-02-05,BYRON,brawlBall,Backyard Bowl,540,573,1113
17690,2023-02-05,BYRON,bounty,Layer Cake,39,34,73
17691,2023-02-04,BYRON,knockout,X Marks the Spot,23,23,46
17692,2023-02-04,BYRON,knockout,Goldarm Gulch,1,3,4
17693,2023-02-04,BYRON,hotZone,Ring of Fire,15,3,18
17694,2023-02-04,BYRON,heist,Tornado Ring,2,1,3
17695,2023-02-04,BYRON,gemGrab,Hard Rock Mine,29,19,48
17696,2023-02-04,BYRON,gemGrab,Double Swoosh,4,5,9
17697,2023-02-04,BYRON,gemGrab,Deep Diner,1,2,3
17698,2023-02-04,BYRON,brawlBall,Super Beach,38,34,72
17699,2023-02-04,BYRON,brawlBall,Sneaky Fields,2,2,4
17700,2023-02-04,BYRON,bounty,Dry Season,21,18,39
17701,2023-02-03,BYRON,knockout,Out in the Open,132,134,266
17702,2023-02-03,BYRON,knockout,Goldarm Gulch,14,14,28
17703,2023-02-03,BYRON,hotZone,Split,8,7,15
17704,2023-02-03,BYRON,heist,Tornado Ring,10,2,12
17705,2023-02-03,BYRON,gemGrab,Undermine,16,15,31
17706,2023-02-03,BYRON,gemGrab,Double Swoosh,11,32,43
17707,2023-02-03,BYRON,gemGrab,Deep Diner,96,84,180
17708,2023-02-03,BYRON,brawlBall,Sneaky Fields,101,93,194
17709,2023-02-03,BYRON,brawlBall,Pinhole Punt,13,8,21
17710,2023-02-03,BYRON,bounty,Dry Season,154,168,322
17711,2023-02-02,BYRON,knockout,Out in the Open,69,50,119
17712,2023-02-02,BYRON,hotZone,Split,8,4,12
17713,2023-02-02,BYRON,heist,Kaboom Canyon,3,3,6
17714,2023-02-02,BYRON,gemGrab,Undermine,12,11,23
17715,2023-02-02,BYRON,gemGrab,Gem Fort,5,3,8
17716,2023-02-02,BYRON,brawlBall,Pinhole Punt,84,91,175
17717,2023-02-02,BYRON,bounty,Shooting Star,31,19,50
17718,2023-02-01,BYRON,knockout,Goldarm Gulch,117,89,206
17719,2023-02-01,BYRON,hotZone,Parallel Plays,32,28,60
17720,2023-02-01,BYRON,heist,Kaboom Canyon,14,13,27
17721,2023-02-01,BYRON,gemGrab,Gem Fort,71,44,115
17722,2023-02-01,BYRON,gemGrab,Crystal Arcade,33,44,77
17723,2023-02-01,BYRON,brawlBall,Sunny Soccer,54,62,116
17724,2023-02-01,BYRON,brawlBall,Beach Ball,3,1,4
17725,2023-02-01,BYRON,bounty,Shooting Star,67,70,137
17726,2023-01-31,BYRON,knockout,Goldarm Gulch,59,48,107
17727,2023-01-31,BYRON,hotZone,Parallel Plays,29,36,65
17728,2023-01-31,BYRON,heist,Pit Stop,5,2,7
17729,2023-01-31,BYRON,gemGrab,Minecart Madness,1,7,8
17730,2023-01-31,BYRON,gemGrab,Crystal Arcade,41,36,77
17731,2023-01-31,BYRON,brawlBall,Center Stage,2,0,2
17732,2023-01-31,BYRON,brawlBall,Beach Ball,46,52,98
17733,2023-01-31,BYRON,bounty,Hideout,37,56,93
17734,2023-01-30,BYRON,knockout,Belle's Rock,118,145,263
17735,2023-01-30,BYRON,hotZone,Quarter Pounder,24,24,48
17736,2023-01-30,BYRON,heist,Pit Stop,1,2,3
17737,2023-01-30,BYRON,gemGrab,Minecart Madness,87,59,146
17738,2023-01-30,BYRON,gemGrab,Double Swoosh,21,22,43
17739,2023-01-30,BYRON,brawlBall,Center Stage,65,29,94
17740,2023-01-30,BYRON,brawlBall,Backyard Bowl,41,44,85
17741,2023-01-30,BYRON,bounty,Hideout,49,57,106
17742,2023-01-29,BYRON,knockout,Belle's Rock,143,139,282
17743,2023-01-29,BYRON,hotZone,Quarter Pounder,14,25,39
17744,2023-01-29,BYRON,heist,Bridge Too Far,80,81,161
17745,2023-01-29,BYRON,gemGrab,Hard Rock Mine,19,20,39
17746,2023-01-29,BYRON,gemGrab,Double Swoosh,38,17,55
17747,2023-01-29,BYRON,brawlBall,Super Beach,1,1,2
17748,2023-01-29,BYRON,brawlBall,Backyard Bowl,379,411,790
17749,2023-01-29,BYRON,bounty,Canal Grande,18,9,27
17750,2023-01-28,BYRON,knockout,Flaring Phoenix,62,43,105
17751,2023-01-28,BYRON,hotZone,Controller Chaos,18,7,25
17752,2023-01-28,BYRON,heist,Bridge Too Far,200,143,343
17753,2023-01-28,BYRON,gemGrab,Hard Rock Mine,71,59,130
17754,2023-01-28,BYRON,gemGrab,Deep Diner,44,48,92
17755,2023-01-28,BYRON,brawlBall,Super Beach,92,88,180
17756,2023-01-28,BYRON,brawlBall,Sneaky Fields,4,5,9
17757,2023-01-28,BYRON,bounty,Canal Grande,29,26,55
17758,2023-01-27,BYRON,knockout,Flaring Phoenix,25,23,48
17759,2023-01-27,BYRON,hotZone,Controller Chaos,11,4,15
17760,2023-01-27,BYRON,heist,Hot Potato,3,0,3
17761,2023-01-27,BYRON,gemGrab,Undermine,2,4,6
17762,2023-01-27,BYRON,gemGrab,Deep Diner,41,37,78
17763,2023-01-27,BYRON,brawlBall,Sneaky Fields,41,36,77
17764,2023-01-27,BYRON,brawlBall,Pinhole Punt,1,2,3
17765,2023-01-27,BYRON,bounty,Temple Ruins,21,18,39
17766,2023-01-26,BYRON,knockout,Riverside,265,261,526
17767,2023-01-26,BYRON,hotZone,Open Zone,56,52,108
17768,2023-01-26,BYRON,heist,Hot Potato,9,4,13
17769,2023-01-26,BYRON,gemGrab,Undermine,57,33,90
17770,2023-01-26,BYRON,gemGrab,Gem Fort,13,10,23
17771,2023-01-26,BYRON,brawlBall,Sunny Soccer,8,10,18
17772,2023-01-26,BYRON,brawlBall,Pinhole Punt,231,194,425
17773,2023-01-26,BYRON,bounty,Temple Ruins,33,36,69
17774,2023-01-25,BYRON,knockout,Riverside,129,132,261
17775,2023-01-25,BYRON,hotZone,Open Zone,24,15,39
17776,2023-01-25,BYRON,heist,Safe Zone,46,40,86
17777,2023-01-25,BYRON,gemGrab,Gem Fort,12,11,23
17778,2023-01-25,BYRON,gemGrab,Crystal Arcade,56,45,101
17779,2023-01-25,BYRON,brawlBall,Sunny Soccer,64,57,121
17780,2023-01-25,BYRON,brawlBall,Beach Ball,17,12,29
17781,2023-01-25,BYRON,bounty,Excel,13,15,28
17782,2023-01-24,BYRON,knockout,New Perspective,84,59,143
17783,2023-01-24,BYRON,hotZone,Dueling Beetles,22,15,37
17784,2023-01-24,BYRON,heist,Safe Zone,72,58,130
17785,2023-01-24,BYRON,gemGrab,Minecart Madness,32,23,55
17786,2023-01-24,BYRON,gemGrab,Crystal Arcade,62,72,134
17787,2023-01-24,BYRON,brawlBall,Center Stage,7,4,11
17788,2023-01-24,BYRON,brawlBall,Beach Ball,105,69,174
17789,2023-01-24,BYRON,bounty,Excel,41,23,64
17790,2023-01-23,BYRON,knockout,New Perspective,120,72,192
17791,2023-01-23,BYRON,hotZone,Dueling Beetles,27,25,52
17792,2023-01-23,BYRON,heist,Snaked Assault,11,6,17
17793,2023-01-23,BYRON,gemGrab,Minecart Madness,135,100,235
17794,2023-01-23,BYRON,gemGrab,Double Swoosh,31,13,44
17795,2023-01-23,BYRON,brawlBall,Center Stage,101,109,210
17796,2023-01-23,BYRON,brawlBall,Backyard Bowl,14,19,33
17797,2023-01-23,BYRON,bounty,Layer Cake,25,20,45
17798,2023-01-22,BYRON,knockout,X Marks the Spot,62,52,114
17799,2023-01-22,BYRON,hotZone,Ring of Fire,17,5,22
17800,2023-01-22,BYRON,heist,Snaked Assault,7,0,7
17801,2023-01-22,BYRON,gemGrab,Hard Rock Mine,17,4,21
17802,2023-01-22,BYRON,gemGrab,Double Swoosh,16,11,27
17803,2023-01-22,BYRON,brawlBall,Super Beach,5,3,8
17804,2023-01-22,BYRON,brawlBall,Backyard Bowl,208,233,441
17805,2023-01-22,BYRON,bounty,Layer Cake,13,10,23
17806,2023-01-21,BYRON,knockout,X Marks the Spot,155,124,279
17807,2023-01-21,BYRON,hotZone,Ring of Fire,59,32,91
17808,2023-01-21,BYRON,heist,Tornado Ring,13,6,19
17809,2023-01-21,BYRON,gemGrab,Hard Rock Mine,74,89,163
17810,2023-01-21,BYRON,gemGrab,Deep Diner,18,17,35
17811,2023-01-21,BYRON,brawlBall,Super Beach,132,137,269
17812,2023-01-21,BYRON,brawlBall,Sneaky Fields,1,2,3
17813,2023-01-21,BYRON,bounty,Dry Season,131,139,270
17814,2023-01-20,BYRON,knockout,Out in the Open,170,112,282
17815,2023-01-20,BYRON,hotZone,Split,12,3,15
17816,2023-01-20,BYRON,heist,Tornado Ring,6,1,7
17817,2023-01-20,BYRON,gemGrab,Undermine,48,21,69
17818,2023-01-20,BYRON,gemGrab,Deep Diner,144,94,238
17819,2023-01-20,BYRON,brawlBall,Sneaky Fields,95,71,166
17820,2023-01-20,BYRON,brawlBall,Pinhole Punt,7,5,12
17821,2023-01-20,BYRON,bounty,Dry Season,98,68,166
17822,2023-01-19,BYRON,knockout,Out in the Open,190,182,372
17823,2023-01-19,BYRON,hotZone,Split,23,14,37
17824,2023-01-19,BYRON,heist,Kaboom Canyon,35,53,88
17825,2023-01-19,BYRON,gemGrab,Undermine,77,51,128
17826,2023-01-19,BYRON,gemGrab,Gem Fort,13,10,23
17827,2023-01-19,BYRON,brawlBall,Sunny Soccer,6,2,8
17828,2023-01-19,BYRON,brawlBall,Pinhole Punt,236,186,422
17829,2023-01-19,BYRON,bounty,Shooting Star,132,114,246
17830,2023-01-18,BYRON,knockout,Goldarm Gulch,16,10,26
17831,2023-01-18,BYRON,hotZone,Parallel Plays,1,3,4
17832,2023-01-18,BYRON,heist,Kaboom Canyon,13,19,32
17833,2023-01-18,BYRON,gemGrab,Gem Fort,14,11,25
17834,2023-01-18,BYRON,gemGrab,Crystal Arcade,11,4,15
17835,2023-01-18,BYRON,brawlBall,Sunny Soccer,27,12,39
17836,2023-01-18,BYRON,brawlBall,Beach Ball,1,1,2
17837,2023-01-18,BYRON,bounty,Shooting Star,47,76,123
17838,2023-01-17,BYRON,knockout,Goldarm Gulch,7,6,13
17839,2023-01-17,BYRON,hotZone,Parallel Plays,7,5,12
17840,2023-01-17,BYRON,heist,Pit Stop,1,0,1
17841,2023-01-17,BYRON,gemGrab,Minecart Madness,4,1,5
17842,2023-01-17,BYRON,gemGrab,Crystal Arcade,5,3,8
17843,2023-01-17,BYRON,brawlBall,Beach Ball,13,4,17
17844,2023-01-17,BYRON,bounty,Hideout,6,2,8
17845,2023-01-16,BYRON,knockout,Belle's Rock,13,29,42
17846,2023-01-16,BYRON,hotZone,Quarter Pounder,7,7,14
17847,2023-01-16,BYRON,gemGrab,Minecart Madness,10,8,18
17848,2023-01-16,BYRON,gemGrab,Double Swoosh,0,1,1
17849,2023-01-16,BYRON,brawlBall,Center Stage,2,4,6
17850,2023-01-16,BYRON,brawlBall,Backyard Bowl,2,14,16
17851,2023-01-16,BYRON,bounty,Hideout,8,10,18
17852,2023-01-15,BYRON,knockout,Belle's Rock,3,8,11
17853,2023-01-15,BYRON,hotZone,Quarter Pounder,3,21,24
17854,2023-01-15,BYRON,heist,Bridge Too Far,10,15,25
17855,2023-01-15,BYRON,gemGrab,Hard Rock Mine,6,17,23
17856,2023-01-15,BYRON,gemGrab,Double Swoosh,2,2,4
17857,2023-01-15,BYRON,brawlBall,Backyard Bowl,36,20,56
17858,2023-01-15,BYRON,bounty,Canal Grande,0,1,1
17859,2023-01-14,BYRON,knockout,Flaring Phoenix,10,4,14
17860,2023-01-14,BYRON,hotZone,Controller Chaos,4,0,4
17861,2023-01-14,BYRON,heist,Bridge Too Far,18,11,29
17862,2023-01-14,BYRON,gemGrab,Hard Rock Mine,4,1,5
17863,2023-01-14,BYRON,gemGrab,Deep Diner,3,0,3
17864,2023-01-14,BYRON,brawlBall,Super Beach,18,7,25
17865,2023-01-14,BYRON,brawlBall,Sneaky Fields,1,0,1
17866,2023-01-13,BYRON,knockout,Flaring Phoenix,6,5,11
17867,2023-01-13,BYRON,hotZone,Controller Chaos,2,1,3
17868,2023-01-13,BYRON,heist,Hot Potato,1,0,1
17869,2023-01-13,BYRON,gemGrab,Deep Diner,4,3,7
17870,2023-01-13,BYRON,brawlBall,Sneaky Fields,14,11,25
17871,2023-01-13,BYRON,bounty,Temple Ruins,2,2,4
17872,2023-01-12,BYRON,knockout,Riverside,24,18,42
17873,2023-01-12,BYRON,hotZone,Open Zone,8,17,25
17874,2023-01-12,BYRON,gemGrab,Undermine,1,5,6
17875,2023-01-12,BYRON,gemGrab,Gem Fort,1,0,1
17876,2023-01-12,BYRON,brawlBall,Sunny Soccer,3,1,4
17877,2023-01-12,BYRON,brawlBall,Pinhole Punt,2,2,4
17878,2023-01-11,BYRON,knockout,Riverside,5,2,7
17879,2023-01-11,BYRON,gemGrab,Gem Fort,2,0,2
17880,2023-01-11,BYRON,brawlBall,Sunny Soccer,2,1,3
17881,2023-01-11,BYRON,bounty,Excel,2,0,2
17882,2023-01-10,BYRON,knockout,New Perspective,9,4,13
17883,2023-01-10,BYRON,hotZone,Dueling Beetles,5,9,14
17884,2023-01-10,BYRON,heist,Safe Zone,2,0,2
17885,2023-01-10,BYRON,gemGrab,Minecart Madness,7,5,12
17886,2023-01-10,BYRON,gemGrab,Crystal Arcade,11,29,40
17887,2023-01-10,BYRON,brawlBall,Center Stage,1,0,1
17888,2023-01-10,BYRON,brawlBall,Beach Ball,10,51,61
17889,2023-01-09,BYRON,knockout,New Perspective,1,1,2
17890,2023-01-09,BYRON,hotZone,Dueling Beetles,2,1,3
17891,2023-01-09,BYRON,gemGrab,Minecart Madness,18,13,31
17892,2023-01-09,BYRON,gemGrab,Double Swoosh,4,1,5
17893,2023-01-09,BYRON,brawlBall,Center Stage,6,3,9
17894,2023-01-09,BYRON,brawlBall,Backyard Bowl,1,1,2
17895,2023-01-09,BYRON,bounty,Layer Cake,6,15,21
17896,2023-01-08,BYRON,knockout,X Marks the Spot,6,14,20
17897,2023-01-08,BYRON,hotZone,Ring of Fire,3,0,3
17898,2023-01-08,BYRON,heist,Snaked Assault,1,0,1
17899,2023-01-08,BYRON,brawlBall,Super Beach,1,5,6
17900,2023-01-08,BYRON,brawlBall,Backyard Bowl,19,27,46
17901,2023-01-08,BYRON,bounty,Layer Cake,1,0,1
17902,2023-01-07,BYRON,knockout,X Marks the Spot,3,12,15
17903,2023-01-07,BYRON,gemGrab,Deep Diner,1,0,1
17904,2023-01-07,BYRON,brawlBall,Super Beach,3,20,23
17905,2023-01-07,BYRON,bounty,Dry Season,5,3,8
17906,2023-01-06,BYRON,knockout,Out in the Open,4,5,9
17907,2023-01-06,BYRON,gemGrab,Undermine,2,0,2
17908,2023-01-06,BYRON,gemGrab,Deep Diner,9,38,47
17909,2023-01-06,BYRON,brawlBall,Sneaky Fields,2,2,4
17910,2023-01-06,BYRON,brawlBall,Pinhole Punt,1,3,4
17911,2023-01-06,BYRON,bounty,Dry Season,11,11,22
17912,2023-01-05,BYRON,knockout,Out in the Open,8,7,15
17913,2023-01-05,BYRON,hotZone,Split,1,1,2
17914,2023-01-05,BYRON,heist,Kaboom Canyon,2,2,4
17915,2023-01-05,BYRON,gemGrab,Undermine,1,1,2
17916,2023-01-05,BYRON,gemGrab,Gem Fort,2,0,2
17917,2023-01-05,BYRON,brawlBall,Pinhole Punt,8,32,40
17918,2023-01-05,BYRON,bounty,Shooting Star,6,3,9
17919,2023-01-04,BYRON,knockout,Goldarm Gulch,2,0,2
17920,2023-01-04,BYRON,heist,Kaboom Canyon,7,12,19
17921,2023-01-04,BYRON,gemGrab,Crystal Arcade,1,0,1
17922,2023-01-04,BYRON,brawlBall,Sunny Soccer,3,7,10
17923,2023-01-04,BYRON,bounty,Shooting Star,18,25,43
17924,2023-01-03,BYRON,hotZone,Parallel Plays,2,10,12
17925,2023-01-03,BYRON,gemGrab,Crystal Arcade,1,0,1
17926,2023-01-03,BYRON,brawlBall,Beach Ball,3,5,8
17927,2023-01-03,BYRON,bounty,Hideout,25,30,55
17928,2023-01-02,BYRON,knockout,Belle's Rock,9,10,19
17929,2023-01-02,BYRON,hotZone,Quarter Pounder,4,12,16
17930,2023-01-02,BYRON,hotZone,Controller Chaos,0,1,1
17931,2023-01-02,BYRON,heist,Kaboom Canyon,0,1,1
17932,2023-01-02,BYRON,gemGrab,Minecart Madness,12,36,48
17933,2023-01-02,BYRON,gemGrab,Double Swoosh,3,0,3
17934,2023-01-02,BYRON,brawlBall,Center Stage,2,3,5
17935,2023-01-02,BYRON,brawlBall,Backyard Bowl,3,4,7
17936,2023-01-02,BYRON,bounty,Hideout,7,3,10
17937,2023-01-01,BYRON,knockout,Belle's Rock,7,2,9
17938,2023-01-01,BYRON,hotZone,Quarter Pounder,2,0,2
17939,2023-01-01,BYRON,heist,Bridge Too Far,6,0,6
17940,2023-01-01,BYRON,gemGrab,Minecart Madness,0,1,1
17941,2023-01-01,BYRON,brawlBall,Backyard Bowl,10,7,17
17942,2022-12-31,BYRON,heist,Bridge Too Far,1,1,2
17943,2022-12-31,BYRON,gemGrab,Minecart Madness,2,0,2
17944,2022-12-31,BYRON,gemGrab,Hard Rock Mine,3,14,17
17945,2022-12-31,BYRON,gemGrab,Deep Diner,0,2,2
17946,2022-12-31,BYRON,brawlBall,Super Beach,1,0,1
17947,2022-12-30,BYRON,gemGrab,Deep Diner,1,0,1
17948,2022-12-29,BYRON,brawlBall,Pinhole Punt,0,1,1
17949,2022-12-28,BYRON,hotZone,Open Zone,0,1,1
17950,2022-12-27,BYRON,hotZone,Dueling Beetles,1,0,1
17951,2022-12-27,BYRON,gemGrab,Minecart Madness,1,0,1
17952,2022-12-26,BYRON,gemGrab,Minecart Madness,0,1,1
17953,2022-12-25,BYRON,brawlBall,Backyard Bowl,0,1,1
17954,2022-12-23,BYRON,knockout,Out in the Open,2,0,2
17955,2022-12-19,BYRON,gemGrab,Minecart Madness,2,4,6
17956,2022-12-13,BYRON,hotZone,Dueling Beetles,1,0,1
17957,2022-12-13,BYRON,heist,Safe Zone,0,1,1
17958,2022-12-10,BYRON,knockout,X Marks the Spot,0,1,1
17959,2022-11-07,BYRON,hotZone,Quarter Pounder,0,2,2
17960,2022-11-01,BYRON,knockout,New Perspective,0,6,6
17961,2022-10-26,BYRON,bounty,Shooting Star,1,0,1
17962,2022-10-15,BYRON,gemGrab,Hard Rock Mine,2,0,2
17963,2022-10-15,BYRON,brawlBall,Super Beach,0,1,1
17964,2022-10-10,BYRON,knockout,Belle's Rock,1,0,1
17965,2023-02-11,BUZZ,knockout,Flaring Phoenix,57,25,82
17966,2023-02-11,BUZZ,hotZone,Controller Chaos,87,60,147
17967,2023-02-11,BUZZ,gemGrab,Deep Diner,54,60,114
17968,2023-02-11,BUZZ,brawlBall,Super Beach,256,241,497
17969,2023-02-11,BUZZ,brawlBall,Sneaky Fields,175,170,345
17970,2023-02-10,BUZZ,knockout,Flaring Phoenix,103,65,168
17971,2023-02-10,BUZZ,hotZone,Controller Chaos,60,41,101
17972,2023-02-10,BUZZ,heist,Hot Potato,104,102,206
17973,2023-02-10,BUZZ,gemGrab,Undermine,42,36,78
17974,2023-02-10,BUZZ,gemGrab,Deep Diner,128,75,203
17975,2023-02-10,BUZZ,brawlBall,Sneaky Fields,1729,1676,3405
17976,2023-02-10,BUZZ,brawlBall,Pinhole Punt,14,10,24
17977,2023-02-10,BUZZ,bounty,Temple Ruins,54,53,107
17978,2023-02-09,BUZZ,knockout,Riverside,5,2,7
17979,2023-02-09,BUZZ,hotZone,Open Zone,4,2,6
17980,2023-02-09,BUZZ,heist,Hot Potato,61,59,120
17981,2023-02-09,BUZZ,gemGrab,Undermine,31,19,50
17982,2023-02-09,BUZZ,gemGrab,Gem Fort,4,3,7
17983,2023-02-09,BUZZ,brawlBall,Sunny Soccer,4,3,7
17984,2023-02-09,BUZZ,brawlBall,Pinhole Punt,238,230,468
17985,2023-02-09,BUZZ,bounty,Temple Ruins,21,27,48
17986,2023-02-08,BUZZ,knockout,Riverside,4,0,4
17987,2023-02-08,BUZZ,hotZone,Open Zone,3,0,3
17988,2023-02-08,BUZZ,heist,Safe Zone,6,7,13
17989,2023-02-08,BUZZ,gemGrab,Gem Fort,17,24,41
17990,2023-02-08,BUZZ,gemGrab,Crystal Arcade,7,10,17
17991,2023-02-08,BUZZ,brawlBall,Sunny Soccer,123,116,239
17992,2023-02-08,BUZZ,brawlBall,Beach Ball,5,2,7
17993,2023-02-08,BUZZ,bounty,Excel,4,6,10
17994,2023-02-07,BUZZ,knockout,New Perspective,6,2,8
17995,2023-02-07,BUZZ,hotZone,Dueling Beetles,8,2,10
17996,2023-02-07,BUZZ,heist,Safe Zone,6,1,7
17997,2023-02-07,BUZZ,gemGrab,Minecart Madness,1,2,3
17998,2023-02-07,BUZZ,gemGrab,Crystal Arcade,3,4,7
17999,2023-02-07,BUZZ,brawlBall,Center Stage,15,17,32
18000,2023-02-07,BUZZ,brawlBall,Beach Ball,74,60,134
18001,2023-02-07,BUZZ,bounty,Excel,3,0,3
18002,2023-02-06,BUZZ,knockout,New Perspective,91,54,145
18003,2023-02-06,BUZZ,knockout,Goldarm Gulch,2,3,5
18004,2023-02-06,BUZZ,hotZone,Dueling Beetles,104,94,198
18005,2023-02-06,BUZZ,heist,Snaked Assault,128,107,235
18006,2023-02-06,BUZZ,heist,Pit Stop,21,53,74
18007,2023-02-06,BUZZ,gemGrab,Minecart Madness,71,56,127
18008,2023-02-06,BUZZ,gemGrab,Double Swoosh,72,66,138
18009,2023-02-06,BUZZ,brawlBall,Sneaky Fields,57,50,107
18010,2023-02-06,BUZZ,brawlBall,Center Stage,2136,2230,4366
18011,2023-02-06,BUZZ,brawlBall,Backyard Bowl,63,46,109
18012,2023-02-06,BUZZ,bounty,Layer Cake,42,54,96
18013,2023-02-05,BUZZ,knockout,X Marks the Spot,51,22,73
18014,2023-02-05,BUZZ,knockout,Goldarm Gulch,8,7,15
18015,2023-02-05,BUZZ,hotZone,Ring of Fire,43,16,59
18016,2023-02-05,BUZZ,heist,Snaked Assault,225,170,395
18017,2023-02-05,BUZZ,heist,Pit Stop,85,137,222
18018,2023-02-05,BUZZ,gemGrab,Hard Rock Mine,44,44,88
18019,2023-02-05,BUZZ,gemGrab,Double Swoosh,288,306,594
18020,2023-02-05,BUZZ,brawlBall,Super Beach,37,32,69
18021,2023-02-05,BUZZ,brawlBall,Sneaky Fields,179,155,334
18022,2023-02-05,BUZZ,brawlBall,Backyard Bowl,787,609,1396
18023,2023-02-05,BUZZ,bounty,Layer Cake,59,70,129
18024,2023-02-04,BUZZ,knockout,X Marks the Spot,21,16,37
18025,2023-02-04,BUZZ,knockout,Goldarm Gulch,5,4,9
18026,2023-02-04,BUZZ,hotZone,Ring of Fire,12,5,17
18027,2023-02-04,BUZZ,heist,Tornado Ring,25,49,74
18028,2023-02-04,BUZZ,heist,Pit Stop,55,84,139
18029,2023-02-04,BUZZ,gemGrab,Hard Rock Mine,48,45,93
18030,2023-02-04,BUZZ,gemGrab,Double Swoosh,38,31,69
18031,2023-02-04,BUZZ,gemGrab,Deep Diner,12,19,31
18032,2023-02-04,BUZZ,brawlBall,Super Beach,378,371,749
18033,2023-02-04,BUZZ,brawlBall,Sneaky Fields,135,111,246
18034,2023-02-04,BUZZ,bounty,Dry Season,6,3,9
18035,2023-02-03,BUZZ,knockout,Out in the Open,66,37,103
18036,2023-02-03,BUZZ,knockout,Goldarm Gulch,49,18,67
18037,2023-02-03,BUZZ,hotZone,Split,71,54,125
18038,2023-02-03,BUZZ,heist,Tornado Ring,235,193,428
18039,2023-02-03,BUZZ,heist,Pit Stop,302,531,833
18040,2023-02-03,BUZZ,gemGrab,Undermine,29,37,66
18041,2023-02-03,BUZZ,gemGrab,Double Swoosh,304,169,473
18042,2023-02-03,BUZZ,gemGrab,Deep Diner,131,105,236
18043,2023-02-03,BUZZ,brawlBall,Sneaky Fields,2268,2011,4279
18044,2023-02-03,BUZZ,brawlBall,Pinhole Punt,36,24,60
18045,2023-02-03,BUZZ,bounty,Dry Season,30,19,49
18046,2023-02-02,BUZZ,knockout,Out in the Open,25,10,35
18047,2023-02-02,BUZZ,hotZone,Split,38,41,79
18048,2023-02-02,BUZZ,heist,Kaboom Canyon,15,3,18
18049,2023-02-02,BUZZ,gemGrab,Undermine,36,15,51
18050,2023-02-02,BUZZ,gemGrab,Gem Fort,12,8,20
18051,2023-02-02,BUZZ,brawlBall,Sunny Soccer,11,16,27
18052,2023-02-02,BUZZ,brawlBall,Pinhole Punt,313,267,580
18053,2023-02-02,BUZZ,bounty,Shooting Star,4,1,5
18054,2023-02-01,BUZZ,knockout,Goldarm Gulch,149,127,276
18055,2023-02-01,BUZZ,hotZone,Parallel Plays,123,84,207
18056,2023-02-01,BUZZ,heist,Kaboom Canyon,36,20,56
18057,2023-02-01,BUZZ,gemGrab,Gem Fort,123,123,246
18058,2023-02-01,BUZZ,gemGrab,Crystal Arcade,55,49,104
18059,2023-02-01,BUZZ,brawlBall,Sunny Soccer,1256,1252,2508
18060,2023-02-01,BUZZ,brawlBall,Beach Ball,41,37,78
18061,2023-02-01,BUZZ,bounty,Shooting Star,5,2,7
18062,2023-01-31,BUZZ,knockout,Goldarm Gulch,60,37,97
18063,2023-01-31,BUZZ,hotZone,Parallel Plays,77,56,133
18064,2023-01-31,BUZZ,heist,Pit Stop,80,88,168
18065,2023-01-31,BUZZ,gemGrab,Minecart Madness,1,9,10
18066,2023-01-31,BUZZ,gemGrab,Crystal Arcade,64,31,95
18067,2023-01-31,BUZZ,brawlBall,Center Stage,20,21,41
18068,2023-01-31,BUZZ,brawlBall,Beach Ball,479,500,979
18069,2023-01-31,BUZZ,bounty,Hideout,10,6,16
18070,2023-01-30,BUZZ,knockout,Belle's Rock,112,82,194
18071,2023-01-30,BUZZ,hotZone,Quarter Pounder,89,86,175
18072,2023-01-30,BUZZ,heist,Pit Stop,340,385,725
18073,2023-01-30,BUZZ,gemGrab,Minecart Madness,60,42,102
18074,2023-01-30,BUZZ,gemGrab,Double Swoosh,68,64,132
18075,2023-01-30,BUZZ,brawlBall,Center Stage,1242,1218,2460
18076,2023-01-30,BUZZ,brawlBall,Backyard Bowl,51,40,91
18077,2023-01-30,BUZZ,bounty,Hideout,11,5,16
18078,2023-01-29,BUZZ,knockout,Belle's Rock,109,59,168
18079,2023-01-29,BUZZ,hotZone,Quarter Pounder,50,27,77
18080,2023-01-29,BUZZ,heist,Bridge Too Far,38,62,100
18081,2023-01-29,BUZZ,gemGrab,Hard Rock Mine,32,61,93
18082,2023-01-29,BUZZ,gemGrab,Double Swoosh,126,101,227
18083,2023-01-29,BUZZ,brawlBall,Super Beach,22,27,49
18084,2023-01-29,BUZZ,brawlBall,Backyard Bowl,591,511,1102
18085,2023-01-29,BUZZ,bounty,Canal Grande,68,65,133
18086,2023-01-28,BUZZ,knockout,Flaring Phoenix,60,46,106
18087,2023-01-28,BUZZ,hotZone,Controller Chaos,67,51,118
18088,2023-01-28,BUZZ,heist,Bridge Too Far,99,107,206
18089,2023-01-28,BUZZ,gemGrab,Hard Rock Mine,172,221,393
18090,2023-01-28,BUZZ,gemGrab,Deep Diner,39,33,72
18091,2023-01-28,BUZZ,brawlBall,Super Beach,1438,1400,2838
18092,2023-01-28,BUZZ,brawlBall,Sneaky Fields,55,55,110
18093,2023-01-28,BUZZ,bounty,Canal Grande,84,77,161
18094,2023-01-27,BUZZ,knockout,Flaring Phoenix,31,27,58
18095,2023-01-27,BUZZ,hotZone,Controller Chaos,20,14,34
18096,2023-01-27,BUZZ,heist,Hot Potato,46,32,78
18097,2023-01-27,BUZZ,gemGrab,Undermine,8,5,13
18098,2023-01-27,BUZZ,gemGrab,Deep Diner,47,46,93
18099,2023-01-27,BUZZ,brawlBall,Sneaky Fields,526,470,996
18100,2023-01-27,BUZZ,brawlBall,Pinhole Punt,8,7,15
18101,2023-01-27,BUZZ,bounty,Temple Ruins,13,6,19
18102,2023-01-26,BUZZ,knockout,Riverside,51,21,72
18103,2023-01-26,BUZZ,hotZone,Open Zone,21,18,39
18104,2023-01-26,BUZZ,heist,Hot Potato,159,206,365
18105,2023-01-26,BUZZ,gemGrab,Undermine,82,97,179
18106,2023-01-26,BUZZ,gemGrab,Gem Fort,55,75,130
18107,2023-01-26,BUZZ,brawlBall,Sunny Soccer,63,69,132
18108,2023-01-26,BUZZ,brawlBall,Pinhole Punt,981,924,1905
18109,2023-01-26,BUZZ,bounty,Temple Ruins,46,31,77
18110,2023-01-25,BUZZ,knockout,Riverside,32,11,43
18111,2023-01-25,BUZZ,hotZone,Open Zone,11,3,14
18112,2023-01-25,BUZZ,heist,Safe Zone,43,54,97
18113,2023-01-25,BUZZ,gemGrab,Gem Fort,49,38,87
18114,2023-01-25,BUZZ,gemGrab,Crystal Arcade,60,59,119
18115,2023-01-25,BUZZ,brawlBall,Sunny Soccer,829,828,1657
18116,2023-01-25,BUZZ,brawlBall,Beach Ball,117,121,238
18117,2023-01-25,BUZZ,bounty,Excel,23,28,51
18118,2023-01-24,BUZZ,knockout,New Perspective,55,47,102
18119,2023-01-24,BUZZ,hotZone,Dueling Beetles,44,37,81
18120,2023-01-24,BUZZ,heist,Safe Zone,98,78,176
18121,2023-01-24,BUZZ,gemGrab,Minecart Madness,16,18,34
18122,2023-01-24,BUZZ,gemGrab,Crystal Arcade,138,142,280
18123,2023-01-24,BUZZ,brawlBall,Center Stage,150,172,322
18124,2023-01-24,BUZZ,brawlBall,Beach Ball,1040,1032,2072
18125,2023-01-24,BUZZ,bounty,Excel,62,90,152
18126,2023-01-23,BUZZ,knockout,New Perspective,107,61,168
18127,2023-01-23,BUZZ,hotZone,Dueling Beetles,73,44,117
18128,2023-01-23,BUZZ,heist,Snaked Assault,126,143,269
18129,2023-01-23,BUZZ,gemGrab,Minecart Madness,77,54,131
18130,2023-01-23,BUZZ,gemGrab,Double Swoosh,71,48,119
18131,2023-01-23,BUZZ,brawlBall,Center Stage,2088,2220,4308
18132,2023-01-23,BUZZ,brawlBall,Backyard Bowl,28,24,52
18133,2023-01-23,BUZZ,bounty,Layer Cake,41,58,99
18134,2023-01-22,BUZZ,knockout,X Marks the Spot,34,25,59
18135,2023-01-22,BUZZ,hotZone,Ring of Fire,19,9,28
18136,2023-01-22,BUZZ,heist,Snaked Assault,79,60,139
18137,2023-01-22,BUZZ,gemGrab,Hard Rock Mine,35,23,58
18138,2023-01-22,BUZZ,gemGrab,Double Swoosh,112,60,172
18139,2023-01-22,BUZZ,brawlBall,Super Beach,134,109,243
18140,2023-01-22,BUZZ,brawlBall,Backyard Bowl,245,215,460
18141,2023-01-22,BUZZ,bounty,Layer Cake,33,30,63
18142,2023-01-21,BUZZ,knockout,X Marks the Spot,116,89,205
18143,2023-01-21,BUZZ,hotZone,Ring of Fire,55,29,84
18144,2023-01-21,BUZZ,heist,Tornado Ring,131,91,222
18145,2023-01-21,BUZZ,gemGrab,Hard Rock Mine,197,151,348
18146,2023-01-21,BUZZ,gemGrab,Deep Diner,31,34,65
18147,2023-01-21,BUZZ,brawlBall,Super Beach,1932,1768,3700
18148,2023-01-21,BUZZ,brawlBall,Sneaky Fields,66,58,124
18149,2023-01-21,BUZZ,bounty,Dry Season,23,28,51
18150,2023-01-20,BUZZ,knockout,Out in the Open,55,35,90
18151,2023-01-20,BUZZ,hotZone,Split,94,64,158
18152,2023-01-20,BUZZ,heist,Tornado Ring,136,180,316
18153,2023-01-20,BUZZ,gemGrab,Undermine,50,39,89
18154,2023-01-20,BUZZ,gemGrab,Deep Diner,145,105,250
18155,2023-01-20,BUZZ,brawlBall,Sneaky Fields,1592,1473,3065
18156,2023-01-20,BUZZ,brawlBall,Pinhole Punt,41,39,80
18157,2023-01-20,BUZZ,bounty,Dry Season,26,18,44
18158,2023-01-19,BUZZ,knockout,Out in the Open,87,67,154
18159,2023-01-19,BUZZ,hotZone,Split,133,110,243
18160,2023-01-19,BUZZ,heist,Kaboom Canyon,28,40,68
18161,2023-01-19,BUZZ,gemGrab,Undermine,123,131,254
18162,2023-01-19,BUZZ,gemGrab,Gem Fort,27,13,40
18163,2023-01-19,BUZZ,brawlBall,Sunny Soccer,36,36,72
18164,2023-01-19,BUZZ,brawlBall,Pinhole Punt,1021,939,1960
18165,2023-01-19,BUZZ,bounty,Shooting Star,16,8,24
18166,2023-01-18,BUZZ,knockout,Goldarm Gulch,13,6,19
18167,2023-01-18,BUZZ,hotZone,Parallel Plays,7,3,10
18168,2023-01-18,BUZZ,heist,Kaboom Canyon,15,14,29
18169,2023-01-18,BUZZ,gemGrab,Gem Fort,31,25,56
18170,2023-01-18,BUZZ,gemGrab,Crystal Arcade,10,5,15
18171,2023-01-18,BUZZ,brawlBall,Sunny Soccer,318,336,654
18172,2023-01-18,BUZZ,brawlBall,Beach Ball,19,24,43
18173,2023-01-18,BUZZ,bounty,Shooting Star,5,2,7
18174,2023-01-17,BUZZ,knockout,Goldarm Gulch,23,20,43
18175,2023-01-17,BUZZ,hotZone,Parallel Plays,19,11,30
18176,2023-01-17,BUZZ,heist,Pit Stop,34,35,69
18177,2023-01-17,BUZZ,gemGrab,Minecart Madness,0,1,1
18178,2023-01-17,BUZZ,gemGrab,Crystal Arcade,13,15,28
18179,2023-01-17,BUZZ,brawlBall,Center Stage,3,6,9
18180,2023-01-17,BUZZ,brawlBall,Beach Ball,107,105,212
18181,2023-01-16,BUZZ,knockout,Belle's Rock,7,5,12
18182,2023-01-16,BUZZ,hotZone,Quarter Pounder,9,10,19
18183,2023-01-16,BUZZ,heist,Pit Stop,117,132,249
18184,2023-01-16,BUZZ,gemGrab,Minecart Madness,4,3,7
18185,2023-01-16,BUZZ,gemGrab,Double Swoosh,14,11,25
18186,2023-01-16,BUZZ,brawlBall,Center Stage,122,104,226
18187,2023-01-16,BUZZ,brawlBall,Backyard Bowl,12,6,18
18188,2023-01-16,BUZZ,bounty,Hideout,3,0,3
18189,2023-01-15,BUZZ,knockout,Belle's Rock,17,7,24
18190,2023-01-15,BUZZ,hotZone,Quarter Pounder,22,19,41
18191,2023-01-15,BUZZ,heist,Bridge Too Far,15,10,25
18192,2023-01-15,BUZZ,gemGrab,Hard Rock Mine,8,10,18
18193,2023-01-15,BUZZ,gemGrab,Double Swoosh,16,12,28
18194,2023-01-15,BUZZ,brawlBall,Super Beach,14,17,31
18195,2023-01-15,BUZZ,brawlBall,Backyard Bowl,69,44,113
18196,2023-01-15,BUZZ,bounty,Canal Grande,9,7,16
18197,2023-01-14,BUZZ,knockout,Flaring Phoenix,0,1,1
18198,2023-01-14,BUZZ,hotZone,Controller Chaos,22,8,30
18199,2023-01-14,BUZZ,heist,Bridge Too Far,19,10,29
18200,2023-01-14,BUZZ,gemGrab,Hard Rock Mine,6,24,30
18201,2023-01-14,BUZZ,gemGrab,Deep Diner,2,3,5
18202,2023-01-14,BUZZ,brawlBall,Super Beach,97,99,196
18203,2023-01-14,BUZZ,brawlBall,Sneaky Fields,13,4,17
18204,2023-01-14,BUZZ,bounty,Canal Grande,11,7,18
18205,2023-01-13,BUZZ,knockout,Flaring Phoenix,11,4,15
18206,2023-01-13,BUZZ,hotZone,Controller Chaos,12,3,15
18207,2023-01-13,BUZZ,heist,Hot Potato,8,16,24
18208,2023-01-13,BUZZ,gemGrab,Deep Diner,23,21,44
18209,2023-01-13,BUZZ,brawlBall,Sneaky Fields,117,108,225
18210,2023-01-13,BUZZ,bounty,Temple Ruins,2,5,7
18211,2023-01-12,BUZZ,knockout,Riverside,2,0,2
18212,2023-01-12,BUZZ,hotZone,Open Zone,2,0,2
18213,2023-01-12,BUZZ,heist,Hot Potato,3,1,4
18214,2023-01-12,BUZZ,gemGrab,Undermine,6,5,11
18215,2023-01-12,BUZZ,gemGrab,Gem Fort,1,0,1
18216,2023-01-12,BUZZ,brawlBall,Sunny Soccer,4,2,6
18217,2023-01-12,BUZZ,brawlBall,Pinhole Punt,38,62,100
18218,2023-01-12,BUZZ,bounty,Temple Ruins,1,0,1
18219,2023-01-11,BUZZ,knockout,Riverside,0,1,1
18220,2023-01-11,BUZZ,hotZone,Open Zone,1,1,2
18221,2023-01-11,BUZZ,gemGrab,Gem Fort,4,2,6
18222,2023-01-11,BUZZ,brawlBall,Sunny Soccer,39,28,67
18223,2023-01-11,BUZZ,brawlBall,Beach Ball,2,0,2
18224,2023-01-11,BUZZ,bounty,Excel,2,0,2
18225,2023-01-10,BUZZ,knockout,New Perspective,1,1,2
18226,2023-01-10,BUZZ,hotZone,Dueling Beetles,12,3,15
18227,2023-01-10,BUZZ,heist,Safe Zone,8,6,14
18228,2023-01-10,BUZZ,gemGrab,Minecart Madness,4,1,5
18229,2023-01-10,BUZZ,gemGrab,Crystal Arcade,14,25,39
18230,2023-01-10,BUZZ,brawlBall,Center Stage,11,2,13
18231,2023-01-10,BUZZ,brawlBall,Beach Ball,58,66,124
18232,2023-01-10,BUZZ,bounty,Excel,1,7,8
18233,2023-01-09,BUZZ,knockout,New Perspective,2,0,2
18234,2023-01-09,BUZZ,hotZone,Dueling Beetles,2,0,2
18235,2023-01-09,BUZZ,heist,Snaked Assault,16,31,47
18236,2023-01-09,BUZZ,gemGrab,Minecart Madness,10,6,16
18237,2023-01-09,BUZZ,gemGrab,Double Swoosh,11,1,12
18238,2023-01-09,BUZZ,brawlBall,Center Stage,149,110,259
18239,2023-01-09,BUZZ,brawlBall,Backyard Bowl,5,20,25
18240,2023-01-09,BUZZ,bounty,Layer Cake,4,6,10
18241,2023-01-08,BUZZ,knockout,X Marks the Spot,5,0,5
18242,2023-01-08,BUZZ,hotZone,Ring of Fire,3,2,5
18243,2023-01-08,BUZZ,heist,Snaked Assault,11,20,31
18244,2023-01-08,BUZZ,gemGrab,Hard Rock Mine,2,1,3
18245,2023-01-08,BUZZ,gemGrab,Double Swoosh,10,2,12
18246,2023-01-08,BUZZ,brawlBall,Super Beach,18,8,26
18247,2023-01-08,BUZZ,brawlBall,Backyard Bowl,36,37,73
18248,2023-01-08,BUZZ,bounty,Layer Cake,1,2,3
18249,2023-01-07,BUZZ,heist,Tornado Ring,20,37,57
18250,2023-01-07,BUZZ,gemGrab,Hard Rock Mine,8,2,10
18251,2023-01-07,BUZZ,gemGrab,Deep Diner,8,9,17
18252,2023-01-07,BUZZ,brawlBall,Super Beach,40,27,67
18253,2023-01-07,BUZZ,brawlBall,Sneaky Fields,3,3,6
18254,2023-01-07,BUZZ,bounty,Dry Season,2,3,5
18255,2023-01-06,BUZZ,knockout,Out in the Open,4,0,4
18256,2023-01-06,BUZZ,hotZone,Split,5,19,24
18257,2023-01-06,BUZZ,heist,Tornado Ring,34,23,57
18258,2023-01-06,BUZZ,gemGrab,Undermine,3,0,3
18259,2023-01-06,BUZZ,gemGrab,Deep Diner,9,7,16
18260,2023-01-06,BUZZ,brawlBall,Sneaky Fields,79,53,132
18261,2023-01-06,BUZZ,brawlBall,Pinhole Punt,4,14,18
18262,2023-01-06,BUZZ,bounty,Dry Season,1,0,1
18263,2023-01-05,BUZZ,knockout,Out in the Open,3,1,4
18264,2023-01-05,BUZZ,hotZone,Split,23,37,60
18265,2023-01-05,BUZZ,heist,Kaboom Canyon,5,0,5
18266,2023-01-05,BUZZ,gemGrab,Undermine,17,12,29
18267,2023-01-05,BUZZ,gemGrab,Gem Fort,1,2,3
18268,2023-01-05,BUZZ,brawlBall,Sunny Soccer,3,1,4
18269,2023-01-05,BUZZ,brawlBall,Pinhole Punt,89,47,136
18270,2023-01-04,BUZZ,knockout,Goldarm Gulch,3,0,3
18271,2023-01-04,BUZZ,hotZone,Parallel Plays,1,2,3
18272,2023-01-04,BUZZ,heist,Kaboom Canyon,10,3,13
18273,2023-01-04,BUZZ,gemGrab,Gem Fort,17,30,47
18274,2023-01-04,BUZZ,gemGrab,Crystal Arcade,6,5,11
18275,2023-01-04,BUZZ,brawlBall,Sunny Soccer,111,136,247
18276,2023-01-04,BUZZ,brawlBall,Beach Ball,1,5,6
18277,2023-01-04,BUZZ,bounty,Shooting Star,1,0,1
18278,2023-01-03,BUZZ,knockout,Goldarm Gulch,1,0,1
18279,2023-01-03,BUZZ,hotZone,Parallel Plays,14,20,34
18280,2023-01-03,BUZZ,hotZone,Controller Chaos,1,0,1
18281,2023-01-03,BUZZ,heist,Pit Stop,50,62,112
18282,2023-01-03,BUZZ,gemGrab,Minecart Madness,2,0,2
18283,2023-01-03,BUZZ,gemGrab,Crystal Arcade,14,20,34
18284,2023-01-03,BUZZ,brawlBall,Center Stage,4,2,6
18285,2023-01-03,BUZZ,brawlBall,Beach Ball,75,56,131
18286,2023-01-02,BUZZ,knockout,Belle's Rock,6,0,6
18287,2023-01-02,BUZZ,hotZone,Quarter Pounder,15,4,19
18288,2023-01-02,BUZZ,heist,Pit Stop,79,155,234
18289,2023-01-02,BUZZ,gemGrab,Minecart Madness,6,3,9
18290,2023-01-02,BUZZ,gemGrab,Double Swoosh,2,2,4
18291,2023-01-02,BUZZ,brawlBall,Center Stage,122,134,256
18292,2023-01-02,BUZZ,brawlBall,Backyard Bowl,3,0,3
18293,2023-01-02,BUZZ,bounty,Hideout,3,0,3
18294,2023-01-01,BUZZ,knockout,Belle's Rock,3,1,4
18295,2023-01-01,BUZZ,hotZone,Quarter Pounder,5,10,15
18296,2023-01-01,BUZZ,heist,Bridge Too Far,3,3,6
18297,2023-01-01,BUZZ,gemGrab,Double Swoosh,6,0,6
18298,2023-01-01,BUZZ,brawlBall,Backyard Bowl,15,1,16
18299,2023-01-01,BUZZ,bounty,Canal Grande,3,0,3
18300,2022-12-31,BUZZ,hotZone,Controller Chaos,4,6,10
18301,2022-12-31,BUZZ,heist,Bridge Too Far,1,1,2
18302,2022-12-31,BUZZ,gemGrab,Hard Rock Mine,5,0,5
18303,2022-12-31,BUZZ,gemGrab,Deep Diner,0,2,2
18304,2022-12-31,BUZZ,brawlBall,Super Beach,14,6,20
18305,2022-12-31,BUZZ,bounty,Canal Grande,1,0,1
18306,2022-12-30,BUZZ,hotZone,Controller Chaos,0,1,1
18307,2022-12-30,BUZZ,gemGrab,Minecart Madness,0,2,2
18308,2022-12-30,BUZZ,gemGrab,Deep Diner,3,2,5
18309,2022-12-30,BUZZ,brawlBall,Sneaky Fields,5,5,10
18310,2022-12-29,BUZZ,heist,Kaboom Canyon,1,0,1
18311,2022-12-29,BUZZ,brawlBall,Pinhole Punt,0,9,9
18312,2022-12-28,BUZZ,brawlBall,Sunny Soccer,2,2,4
18313,2022-12-27,BUZZ,hotZone,Controller Chaos,1,1,2
18314,2022-12-27,BUZZ,brawlBall,Center Stage,0,1,1
18315,2022-12-27,BUZZ,brawlBall,Beach Ball,4,2,6
18316,2022-12-27,BUZZ,bounty,Excel,3,1,4
18317,2022-12-26,BUZZ,hotZone,Controller Chaos,1,0,1
18318,2022-12-26,BUZZ,gemGrab,Minecart Madness,2,0,2
18319,2022-12-26,BUZZ,brawlBall,Center Stage,1,2,3
18320,2022-12-25,BUZZ,gemGrab,Double Swoosh,1,0,1
18321,2022-12-24,BUZZ,brawlBall,Super Beach,2,5,7
18322,2022-12-23,BUZZ,brawlBall,Sneaky Fields,0,2,2
18323,2022-12-22,BUZZ,brawlBall,Pinhole Punt,3,2,5
18324,2022-12-20,BUZZ,brawlBall,Beach Ball,4,4,8
18325,2022-12-19,BUZZ,gemGrab,Minecart Madness,4,0,4
18326,2022-12-19,BUZZ,brawlBall,Center Stage,1,1,2
18327,2022-12-11,BUZZ,brawlBall,Backyard Bowl,2,2,4
18328,2022-11-01,BUZZ,knockout,New Perspective,2,0,2
18329,2022-10-30,BUZZ,brawlBall,Beach Ball,1,0,1
18330,2022-10-15,BUZZ,gemGrab,Hard Rock Mine,1,1,2
18331,2022-10-10,BUZZ,knockout,Belle's Rock,0,1,1
18332,2023-02-11,BUSTER,knockout,Flaring Phoenix,23,7,30
18333,2023-02-11,BUSTER,hotZone,Controller Chaos,53,38,91
18334,2023-02-11,BUSTER,gemGrab,Deep Diner,18,10,28
18335,2023-02-11,BUSTER,brawlBall,Super Beach,31,38,69
18336,2023-02-11,BUSTER,brawlBall,Sneaky Fields,24,37,61
18337,2023-02-10,BUSTER,knockout,Flaring Phoenix,34,34,68
18338,2023-02-10,BUSTER,hotZone,Controller Chaos,40,34,74
18339,2023-02-10,BUSTER,heist,Hot Potato,2,3,5
18340,2023-02-10,BUSTER,gemGrab,Undermine,4,4,8
18341,2023-02-10,BUSTER,gemGrab,Deep Diner,53,57,110
18342,2023-02-10,BUSTER,brawlBall,Sneaky Fields,277,311,588
18343,2023-02-10,BUSTER,brawlBall,Pinhole Punt,2,6,8
18344,2023-02-10,BUSTER,bounty,Temple Ruins,17,36,53
18345,2023-02-09,BUSTER,knockout,Riverside,1,0,1
18346,2023-02-09,BUSTER,hotZone,Open Zone,1,4,5
18347,2023-02-09,BUSTER,heist,Hot Potato,6,3,9
18348,2023-02-09,BUSTER,gemGrab,Undermine,20,40,60
18349,2023-02-09,BUSTER,gemGrab,Gem Fort,2,2,4
18350,2023-02-09,BUSTER,brawlBall,Pinhole Punt,32,47,79
18351,2023-02-09,BUSTER,bounty,Temple Ruins,12,16,28
18352,2023-02-08,BUSTER,knockout,Riverside,3,0,3
18353,2023-02-08,BUSTER,hotZone,Open Zone,1,0,1
18354,2023-02-08,BUSTER,heist,Safe Zone,1,4,5
18355,2023-02-08,BUSTER,gemGrab,Gem Fort,6,3,9
18356,2023-02-08,BUSTER,gemGrab,Crystal Arcade,0,1,1
18357,2023-02-08,BUSTER,brawlBall,Sunny Soccer,24,16,40
18358,2023-02-08,BUSTER,brawlBall,Beach Ball,1,0,1
18359,2023-02-07,BUSTER,knockout,New Perspective,3,1,4
18360,2023-02-07,BUSTER,hotZone,Dueling Beetles,15,3,18
18361,2023-02-07,BUSTER,heist,Safe Zone,1,0,1
18362,2023-02-07,BUSTER,gemGrab,Crystal Arcade,1,2,3
18363,2023-02-07,BUSTER,brawlBall,Center Stage,0,1,1
18364,2023-02-07,BUSTER,brawlBall,Beach Ball,13,10,23
18365,2023-02-06,BUSTER,knockout,New Perspective,40,27,67
18366,2023-02-06,BUSTER,knockout,Goldarm Gulch,1,1,2
18367,2023-02-06,BUSTER,hotZone,Dueling Beetles,57,36,93
18368,2023-02-06,BUSTER,heist,Snaked Assault,3,3,6
18369,2023-02-06,BUSTER,heist,Pit Stop,1,1,2
18370,2023-02-06,BUSTER,gemGrab,Minecart Madness,30,34,64
18371,2023-02-06,BUSTER,gemGrab,Double Swoosh,59,41,100
18372,2023-02-06,BUSTER,brawlBall,Sneaky Fields,21,25,46
18373,2023-02-06,BUSTER,brawlBall,Center Stage,388,461,849
18374,2023-02-06,BUSTER,brawlBall,Backyard Bowl,1,4,5
18375,2023-02-06,BUSTER,bounty,Layer Cake,9,14,23
18376,2023-02-05,BUSTER,knockout,X Marks the Spot,27,20,47
18377,2023-02-05,BUSTER,knockout,Goldarm Gulch,5,3,8
18378,2023-02-05,BUSTER,hotZone,Ring of Fire,35,38,73
18379,2023-02-05,BUSTER,heist,Snaked Assault,11,3,14
18380,2023-02-05,BUSTER,heist,Pit Stop,1,0,1
18381,2023-02-05,BUSTER,gemGrab,Hard Rock Mine,11,10,21
18382,2023-02-05,BUSTER,gemGrab,Double Swoosh,162,258,420
18383,2023-02-05,BUSTER,brawlBall,Super Beach,12,12,24
18384,2023-02-05,BUSTER,brawlBall,Sneaky Fields,55,47,102
18385,2023-02-05,BUSTER,brawlBall,Backyard Bowl,98,94,192
18386,2023-02-05,BUSTER,bounty,Layer Cake,14,16,30
18387,2023-02-04,BUSTER,knockout,X Marks the Spot,8,4,12
18388,2023-02-04,BUSTER,knockout,Goldarm Gulch,3,3,6
18389,2023-02-04,BUSTER,hotZone,Ring of Fire,9,4,13
18390,2023-02-04,BUSTER,heist,Tornado Ring,0,2,2
18391,2023-02-04,BUSTER,heist,Pit Stop,1,0,1
18392,2023-02-04,BUSTER,gemGrab,Hard Rock Mine,15,27,42
18393,2023-02-04,BUSTER,gemGrab,Double Swoosh,14,35,49
18394,2023-02-04,BUSTER,gemGrab,Deep Diner,3,3,6
18395,2023-02-04,BUSTER,brawlBall,Super Beach,103,119,222
18396,2023-02-04,BUSTER,brawlBall,Sneaky Fields,39,36,75
18397,2023-02-04,BUSTER,bounty,Dry Season,1,2,3
18398,2023-02-03,BUSTER,knockout,Out in the Open,24,15,39
18399,2023-02-03,BUSTER,knockout,Goldarm Gulch,19,9,28
18400,2023-02-03,BUSTER,hotZone,Split,27,38,65
18401,2023-02-03,BUSTER,heist,Tornado Ring,11,3,14
18402,2023-02-03,BUSTER,heist,Pit Stop,8,6,14
18403,2023-02-03,BUSTER,gemGrab,Undermine,12,13,25
18404,2023-02-03,BUSTER,gemGrab,Double Swoosh,125,169,294
18405,2023-02-03,BUSTER,gemGrab,Deep Diner,42,39,81
18406,2023-02-03,BUSTER,brawlBall,Sneaky Fields,515,503,1018
18407,2023-02-03,BUSTER,brawlBall,Pinhole Punt,12,23,35
18408,2023-02-03,BUSTER,bounty,Dry Season,7,6,13
18409,2023-02-02,BUSTER,knockout,Out in the Open,8,5,13
18410,2023-02-02,BUSTER,hotZone,Split,15,24,39
18411,2023-02-02,BUSTER,heist,Kaboom Canyon,0,2,2
18412,2023-02-02,BUSTER,gemGrab,Undermine,10,12,22
18413,2023-02-02,BUSTER,gemGrab,Gem Fort,5,3,8
18414,2023-02-02,BUSTER,brawlBall,Sunny Soccer,4,3,7
18415,2023-02-02,BUSTER,brawlBall,Pinhole Punt,76,116,192
18416,2023-02-02,BUSTER,bounty,Shooting Star,1,0,1
18417,2023-02-01,BUSTER,knockout,Goldarm Gulch,56,58,114
18418,2023-02-01,BUSTER,hotZone,Parallel Plays,72,71,143
18419,2023-02-01,BUSTER,heist,Kaboom Canyon,7,2,9
18420,2023-02-01,BUSTER,gemGrab,Gem Fort,43,51,94
18421,2023-02-01,BUSTER,gemGrab,Crystal Arcade,31,31,62
18422,2023-02-01,BUSTER,brawlBall,Sunny Soccer,187,187,374
18423,2023-02-01,BUSTER,brawlBall,Beach Ball,13,13,26
18424,2023-02-01,BUSTER,bounty,Shooting Star,2,0,2
18425,2023-01-31,BUSTER,knockout,Goldarm Gulch,33,54,87
18426,2023-01-31,BUSTER,hotZone,Parallel Plays,31,40,71
18427,2023-01-31,BUSTER,heist,Pit Stop,1,1,2
18428,2023-01-31,BUSTER,gemGrab,Minecart Madness,3,3,6
18429,2023-01-31,BUSTER,gemGrab,Crystal Arcade,27,28,55
18430,2023-01-31,BUSTER,brawlBall,Center Stage,4,4,8
18431,2023-01-31,BUSTER,brawlBall,Beach Ball,87,107,194
18432,2023-01-31,BUSTER,bounty,Hideout,4,2,6
18433,2023-01-30,BUSTER,knockout,Belle's Rock,15,12,27
18434,2023-01-30,BUSTER,hotZone,Quarter Pounder,53,84,137
18435,2023-01-30,BUSTER,heist,Pit Stop,5,1,6
18436,2023-01-30,BUSTER,gemGrab,Minecart Madness,17,26,43
18437,2023-01-30,BUSTER,gemGrab,Double Swoosh,58,63,121
18438,2023-01-30,BUSTER,brawlBall,Center Stage,246,258,504
18439,2023-01-30,BUSTER,brawlBall,Backyard Bowl,6,17,23
18440,2023-01-30,BUSTER,bounty,Hideout,0,1,1
18441,2023-01-29,BUSTER,knockout,Belle's Rock,21,18,39
18442,2023-01-29,BUSTER,hotZone,Quarter Pounder,63,82,145
18443,2023-01-29,BUSTER,heist,Bridge Too Far,2,5,7
18444,2023-01-29,BUSTER,gemGrab,Hard Rock Mine,14,9,23
18445,2023-01-29,BUSTER,gemGrab,Double Swoosh,92,133,225
18446,2023-01-29,BUSTER,brawlBall,Super Beach,8,18,26
18447,2023-01-29,BUSTER,brawlBall,Backyard Bowl,83,87,170
18448,2023-01-29,BUSTER,bounty,Canal Grande,14,15,29
18449,2023-01-28,BUSTER,knockout,Flaring Phoenix,24,31,55
18450,2023-01-28,BUSTER,hotZone,Controller Chaos,77,78,155
18451,2023-01-28,BUSTER,heist,Bridge Too Far,5,0,5
18452,2023-01-28,BUSTER,gemGrab,Hard Rock Mine,51,80,131
18453,2023-01-28,BUSTER,gemGrab,Deep Diner,16,12,28
18454,2023-01-28,BUSTER,brawlBall,Super Beach,321,345,666
18455,2023-01-28,BUSTER,brawlBall,Sneaky Fields,28,20,48
18456,2023-01-28,BUSTER,bounty,Canal Grande,41,47,88
18457,2023-01-27,BUSTER,knockout,Flaring Phoenix,18,16,34
18458,2023-01-27,BUSTER,hotZone,Controller Chaos,12,11,23
18459,2023-01-27,BUSTER,heist,Hot Potato,5,0,5
18460,2023-01-27,BUSTER,gemGrab,Undermine,4,7,11
18461,2023-01-27,BUSTER,gemGrab,Deep Diner,27,19,46
18462,2023-01-27,BUSTER,brawlBall,Sneaky Fields,107,120,227
18463,2023-01-27,BUSTER,brawlBall,Pinhole Punt,1,0,1
18464,2023-01-27,BUSTER,bounty,Temple Ruins,10,25,35
18465,2023-01-26,BUSTER,knockout,Riverside,18,4,22
18466,2023-01-26,BUSTER,hotZone,Open Zone,22,16,38
18467,2023-01-26,BUSTER,heist,Hot Potato,6,4,10
18468,2023-01-26,BUSTER,gemGrab,Undermine,63,62,125
18469,2023-01-26,BUSTER,gemGrab,Gem Fort,21,22,43
18470,2023-01-26,BUSTER,brawlBall,Sunny Soccer,8,5,13
18471,2023-01-26,BUSTER,brawlBall,Pinhole Punt,234,300,534
18472,2023-01-26,BUSTER,bounty,Temple Ruins,12,14,26
18473,2023-01-25,BUSTER,knockout,Riverside,1,4,5
18474,2023-01-25,BUSTER,hotZone,Open Zone,5,8,13
18475,2023-01-25,BUSTER,heist,Safe Zone,3,0,3
18476,2023-01-25,BUSTER,gemGrab,Gem Fort,23,29,52
18477,2023-01-25,BUSTER,gemGrab,Crystal Arcade,35,35,70
18478,2023-01-25,BUSTER,brawlBall,Sunny Soccer,197,240,437
18479,2023-01-25,BUSTER,brawlBall,Beach Ball,30,45,75
18480,2023-01-25,BUSTER,bounty,Excel,2,1,3
18481,2023-01-24,BUSTER,knockout,New Perspective,33,59,92
18482,2023-01-24,BUSTER,hotZone,Dueling Beetles,71,70,141
18483,2023-01-24,BUSTER,heist,Safe Zone,7,3,10
18484,2023-01-24,BUSTER,gemGrab,Minecart Madness,4,3,7
18485,2023-01-24,BUSTER,gemGrab,Crystal Arcade,65,55,120
18486,2023-01-24,BUSTER,brawlBall,Center Stage,61,48,109
18487,2023-01-24,BUSTER,brawlBall,Beach Ball,234,223,457
18488,2023-01-24,BUSTER,bounty,Excel,11,11,22
18489,2023-01-23,BUSTER,knockout,New Perspective,59,67,126
18490,2023-01-23,BUSTER,hotZone,Dueling Beetles,107,66,173
18491,2023-01-23,BUSTER,heist,Snaked Assault,6,1,7
18492,2023-01-23,BUSTER,gemGrab,Minecart Madness,52,34,86
18493,2023-01-23,BUSTER,gemGrab,Double Swoosh,38,34,72
18494,2023-01-23,BUSTER,brawlBall,Center Stage,501,526,1027
18495,2023-01-23,BUSTER,brawlBall,Backyard Bowl,1,4,5
18496,2023-01-23,BUSTER,bounty,Layer Cake,12,15,27
18497,2023-01-22,BUSTER,knockout,X Marks the Spot,24,10,34
18498,2023-01-22,BUSTER,hotZone,Ring of Fire,38,36,74
18499,2023-01-22,BUSTER,heist,Snaked Assault,4,0,4
18500,2023-01-22,BUSTER,gemGrab,Hard Rock Mine,13,13,26
18501,2023-01-22,BUSTER,gemGrab,Double Swoosh,54,52,106
18502,2023-01-22,BUSTER,brawlBall,Super Beach,26,25,51
18503,2023-01-22,BUSTER,brawlBall,Backyard Bowl,48,42,90
18504,2023-01-22,BUSTER,bounty,Layer Cake,6,10,16
18505,2023-01-21,BUSTER,knockout,X Marks the Spot,90,57,147
18506,2023-01-21,BUSTER,hotZone,Ring of Fire,121,96,217
18507,2023-01-21,BUSTER,heist,Tornado Ring,9,9,18
18508,2023-01-21,BUSTER,gemGrab,Hard Rock Mine,93,76,169
18509,2023-01-21,BUSTER,gemGrab,Deep Diner,12,15,27
18510,2023-01-21,BUSTER,brawlBall,Super Beach,509,559,1068
18511,2023-01-21,BUSTER,brawlBall,Sneaky Fields,20,15,35
18512,2023-01-21,BUSTER,bounty,Dry Season,7,5,12
18513,2023-01-20,BUSTER,knockout,Out in the Open,38,24,62
18514,2023-01-20,BUSTER,hotZone,Split,62,55,117
18515,2023-01-20,BUSTER,heist,Tornado Ring,9,2,11
18516,2023-01-20,BUSTER,gemGrab,Undermine,20,13,33
18517,2023-01-20,BUSTER,gemGrab,Deep Diner,71,78,149
18518,2023-01-20,BUSTER,brawlBall,Sneaky Fields,457,459,916
18519,2023-01-20,BUSTER,brawlBall,Pinhole Punt,12,10,22
18520,2023-01-20,BUSTER,bounty,Dry Season,5,6,11
18521,2023-01-19,BUSTER,knockout,Out in the Open,48,62,110
18522,2023-01-19,BUSTER,hotZone,Split,79,88,167
18523,2023-01-19,BUSTER,heist,Kaboom Canyon,4,3,7
18524,2023-01-19,BUSTER,gemGrab,Undermine,73,74,147
18525,2023-01-19,BUSTER,gemGrab,Gem Fort,15,22,37
18526,2023-01-19,BUSTER,brawlBall,Sunny Soccer,8,10,18
18527,2023-01-19,BUSTER,brawlBall,Pinhole Punt,299,365,664
18528,2023-01-19,BUSTER,bounty,Shooting Star,7,5,12
18529,2023-01-18,BUSTER,knockout,Goldarm Gulch,8,10,18
18530,2023-01-18,BUSTER,hotZone,Parallel Plays,12,10,22
18531,2023-01-18,BUSTER,heist,Kaboom Canyon,1,1,2
18532,2023-01-18,BUSTER,gemGrab,Gem Fort,15,45,60
18533,2023-01-18,BUSTER,gemGrab,Crystal Arcade,7,2,9
18534,2023-01-18,BUSTER,brawlBall,Sunny Soccer,83,126,209
18535,2023-01-18,BUSTER,brawlBall,Beach Ball,0,2,2
18536,2023-01-18,BUSTER,bounty,Shooting Star,3,0,3
18537,2023-01-17,BUSTER,knockout,Goldarm Gulch,13,24,37
18538,2023-01-17,BUSTER,hotZone,Parallel Plays,9,17,26
18539,2023-01-17,BUSTER,heist,Pit Stop,0,3,3
18540,2023-01-17,BUSTER,gemGrab,Minecart Madness,1,2,3
18541,2023-01-17,BUSTER,gemGrab,Crystal Arcade,11,13,24
18542,2023-01-17,BUSTER,brawlBall,Center Stage,3,9,12
18543,2023-01-17,BUSTER,brawlBall,Beach Ball,25,43,68
18544,2023-01-16,BUSTER,knockout,Belle's Rock,2,0,2
18545,2023-01-16,BUSTER,hotZone,Quarter Pounder,10,7,17
18546,2023-01-16,BUSTER,heist,Pit Stop,1,0,1
18547,2023-01-16,BUSTER,gemGrab,Minecart Madness,3,2,5
18548,2023-01-16,BUSTER,gemGrab,Double Swoosh,5,2,7
18549,2023-01-16,BUSTER,brawlBall,Center Stage,39,30,69
18550,2023-01-16,BUSTER,brawlBall,Backyard Bowl,2,1,3
18551,2023-01-16,BUSTER,bounty,Hideout,1,1,2
18552,2023-01-15,BUSTER,knockout,Belle's Rock,5,6,11
18553,2023-01-15,BUSTER,hotZone,Quarter Pounder,36,7,43
18554,2023-01-15,BUSTER,heist,Bridge Too Far,1,0,1
18555,2023-01-15,BUSTER,gemGrab,Hard Rock Mine,3,4,7
18556,2023-01-15,BUSTER,gemGrab,Double Swoosh,27,31,58
18557,2023-01-15,BUSTER,brawlBall,Super Beach,5,31,36
18558,2023-01-15,BUSTER,brawlBall,Backyard Bowl,27,29,56
18559,2023-01-15,BUSTER,bounty,Canal Grande,7,2,9
18560,2023-01-14,BUSTER,knockout,Flaring Phoenix,7,2,9
18561,2023-01-14,BUSTER,hotZone,Controller Chaos,45,22,67
18562,2023-01-14,BUSTER,heist,Bridge Too Far,2,0,2
18563,2023-01-14,BUSTER,gemGrab,Hard Rock Mine,6,8,14
18564,2023-01-14,BUSTER,gemGrab,Deep Diner,4,3,7
18565,2023-01-14,BUSTER,brawlBall,Super Beach,48,28,76
18566,2023-01-14,BUSTER,brawlBall,Sneaky Fields,15,19,34
18567,2023-01-14,BUSTER,bounty,Canal Grande,7,5,12
18568,2023-01-13,BUSTER,knockout,Flaring Phoenix,7,4,11
18569,2023-01-13,BUSTER,hotZone,Controller Chaos,53,104,157
18570,2023-01-13,BUSTER,gemGrab,Undermine,0,2,2
18571,2023-01-13,BUSTER,gemGrab,Deep Diner,6,12,18
18572,2023-01-13,BUSTER,brawlBall,Sneaky Fields,74,100,174
18573,2023-01-13,BUSTER,brawlBall,Pinhole Punt,2,2,4
18574,2023-01-13,BUSTER,bounty,Temple Ruins,1,2,3
18575,2023-01-12,BUSTER,knockout,Riverside,2,0,2
18576,2023-01-12,BUSTER,hotZone,Open Zone,9,6,15
18577,2023-01-12,BUSTER,gemGrab,Undermine,10,4,14
18578,2023-01-12,BUSTER,gemGrab,Gem Fort,7,9,16
18579,2023-01-12,BUSTER,brawlBall,Sunny Soccer,4,2,6
18580,2023-01-12,BUSTER,brawlBall,Pinhole Punt,32,34,66
18581,2023-01-12,BUSTER,bounty,Temple Ruins,1,0,1
18582,2023-01-11,BUSTER,hotZone,Open Zone,1,0,1
18583,2023-01-11,BUSTER,gemGrab,Gem Fort,19,6,25
18584,2023-01-11,BUSTER,brawlBall,Sunny Soccer,41,37,78
18585,2023-01-11,BUSTER,brawlBall,Beach Ball,1,0,1
18586,2023-01-11,BUSTER,bounty,Excel,1,1,2
18587,2023-01-10,BUSTER,knockout,New Perspective,4,1,5
18588,2023-01-10,BUSTER,hotZone,Dueling Beetles,50,63,113
18589,2023-01-10,BUSTER,heist,Safe Zone,2,0,2
18590,2023-01-10,BUSTER,gemGrab,Minecart Madness,5,4,9
18591,2023-01-10,BUSTER,gemGrab,Crystal Arcade,38,36,74
18592,2023-01-10,BUSTER,brawlBall,Center Stage,18,18,36
18593,2023-01-10,BUSTER,brawlBall,Beach Ball,102,99,201
18594,2023-01-10,BUSTER,bounty,Excel,4,1,5
18595,2023-01-09,BUSTER,knockout,New Perspective,17,2,19
18596,2023-01-09,BUSTER,hotZone,Dueling Beetles,40,35,75
18597,2023-01-09,BUSTER,heist,Snaked Assault,4,0,4
18598,2023-01-09,BUSTER,gemGrab,Minecart Madness,19,48,67
18599,2023-01-09,BUSTER,gemGrab,Double Swoosh,26,30,56
18600,2023-01-09,BUSTER,brawlBall,Center Stage,158,166,324
18601,2023-01-09,BUSTER,brawlBall,Backyard Bowl,1,0,1
18602,2023-01-09,BUSTER,bounty,Layer Cake,8,4,12
18603,2023-01-08,BUSTER,knockout,X Marks the Spot,20,26,46
18604,2023-01-08,BUSTER,hotZone,Ring of Fire,53,31,84
18605,2023-01-08,BUSTER,heist,Snaked Assault,0,1,1
18606,2023-01-08,BUSTER,gemGrab,Hard Rock Mine,8,6,14
18607,2023-01-08,BUSTER,gemGrab,Double Swoosh,26,5,31
18608,2023-01-08,BUSTER,brawlBall,Super Beach,12,24,36
18609,2023-01-08,BUSTER,brawlBall,Backyard Bowl,28,27,55
18610,2023-01-08,BUSTER,bounty,Layer Cake,2,2,4
18611,2023-01-07,BUSTER,knockout,X Marks the Spot,7,7,14
18612,2023-01-07,BUSTER,hotZone,Ring of Fire,34,33,67
18613,2023-01-07,BUSTER,heist,Tornado Ring,3,0,3
18614,2023-01-07,BUSTER,gemGrab,Hard Rock Mine,29,5,34
18615,2023-01-07,BUSTER,gemGrab,Deep Diner,14,9,23
18616,2023-01-07,BUSTER,brawlBall,Super Beach,57,65,122
18617,2023-01-07,BUSTER,brawlBall,Sneaky Fields,10,28,38
18618,2023-01-07,BUSTER,bounty,Dry Season,0,1,1
18619,2023-01-06,BUSTER,knockout,Out in the Open,10,5,15
18620,2023-01-06,BUSTER,hotZone,Split,37,66,103
18621,2023-01-06,BUSTER,heist,Tornado Ring,6,1,7
18622,2023-01-06,BUSTER,gemGrab,Undermine,18,8,26
18623,2023-01-06,BUSTER,gemGrab,Deep Diner,42,74,116
18624,2023-01-06,BUSTER,brawlBall,Sneaky Fields,146,103,249
18625,2023-01-06,BUSTER,brawlBall,Pinhole Punt,12,14,26
18626,2023-01-06,BUSTER,bounty,Dry Season,5,3,8
18627,2023-01-05,BUSTER,knockout,Out in the Open,23,8,31
18628,2023-01-05,BUSTER,hotZone,Split,90,103,193
18629,2023-01-05,BUSTER,heist,Kaboom Canyon,2,0,2
18630,2023-01-05,BUSTER,gemGrab,Undermine,50,26,76
18631,2023-01-05,BUSTER,gemGrab,Gem Fort,10,3,13
18632,2023-01-05,BUSTER,brawlBall,Sunny Soccer,2,4,6
18633,2023-01-05,BUSTER,brawlBall,Pinhole Punt,198,194,392
18634,2023-01-05,BUSTER,bounty,Shooting Star,1,0,1
18635,2023-01-04,BUSTER,knockout,Goldarm Gulch,5,9,14
18636,2023-01-04,BUSTER,hotZone,Parallel Plays,38,51,89
18637,2023-01-04,BUSTER,heist,Kaboom Canyon,4,1,5
18638,2023-01-04,BUSTER,gemGrab,Gem Fort,62,58,120
18639,2023-01-04,BUSTER,gemGrab,Crystal Arcade,9,2,11
18640,2023-01-04,BUSTER,brawlBall,Sunny Soccer,166,105,271
18641,2023-01-04,BUSTER,brawlBall,Beach Ball,3,0,3
18642,2023-01-04,BUSTER,bounty,Shooting Star,2,1,3
18643,2023-01-03,BUSTER,knockout,Goldarm Gulch,13,9,22
18644,2023-01-03,BUSTER,hotZone,Parallel Plays,66,39,105
18645,2023-01-03,BUSTER,hotZone,Controller Chaos,0,1,1
18646,2023-01-03,BUSTER,gemGrab,Minecart Madness,7,3,10
18647,2023-01-03,BUSTER,gemGrab,Crystal Arcade,71,100,171
18648,2023-01-03,BUSTER,brawlBall,Center Stage,9,0,9
18649,2023-01-03,BUSTER,brawlBall,Beach Ball,124,96,220
18650,2023-01-03,BUSTER,bounty,Hideout,3,3,6
18651,2023-01-02,BUSTER,knockout,Belle's Rock,5,0,5
18652,2023-01-02,BUSTER,hotZone,Quarter Pounder,52,85,137
18653,2023-01-02,BUSTER,hotZone,Controller Chaos,2,3,5
18654,2023-01-02,BUSTER,heist,Pit Stop,4,0,4
18655,2023-01-02,BUSTER,gemGrab,Minecart Madness,26,27,53
18656,2023-01-02,BUSTER,gemGrab,Double Swoosh,54,45,99
18657,2023-01-02,BUSTER,brawlBall,Center Stage,219,278,497
18658,2023-01-02,BUSTER,brawlBall,Backyard Bowl,3,2,5
18659,2023-01-02,BUSTER,bounty,Hideout,1,3,4
18660,2023-01-01,BUSTER,knockout,Belle's Rock,5,2,7
18661,2023-01-01,BUSTER,hotZone,Quarter Pounder,27,10,37
18662,2023-01-01,BUSTER,hotZone,Controller Chaos,1,0,1
18663,2023-01-01,BUSTER,heist,Bridge Too Far,1,4,5
18664,2023-01-01,BUSTER,gemGrab,Hard Rock Mine,1,1,2
18665,2023-01-01,BUSTER,gemGrab,Double Swoosh,39,61,100
18666,2023-01-01,BUSTER,brawlBall,Backyard Bowl,18,12,30
18667,2023-01-01,BUSTER,bounty,Canal Grande,5,9,14
18668,2022-12-31,BUSTER,knockout,Flaring Phoenix,0,1,1
18669,2022-12-31,BUSTER,hotZone,Controller Chaos,10,23,33
18670,2022-12-31,BUSTER,heist,Kaboom Canyon,0,1,1
18671,2022-12-31,BUSTER,gemGrab,Hard Rock Mine,7,14,21
18672,2022-12-31,BUSTER,gemGrab,Deep Diner,4,2,6
18673,2022-12-31,BUSTER,brawlBall,Super Beach,10,16,26
18674,2022-12-31,BUSTER,brawlBall,Sneaky Fields,1,1,2
18675,2022-12-30,BUSTER,knockout,Flaring Phoenix,1,1,2
18676,2022-12-30,BUSTER,hotZone,Controller Chaos,7,15,22
18677,2022-12-30,BUSTER,gemGrab,Undermine,5,0,5
18678,2022-12-30,BUSTER,gemGrab,Deep Diner,7,9,16
18679,2022-12-30,BUSTER,brawlBall,Sneaky Fields,6,12,18
18680,2022-12-29,BUSTER,hotZone,Open Zone,1,1,2
18681,2022-12-29,BUSTER,hotZone,Controller Chaos,0,1,1
18682,2022-12-29,BUSTER,gemGrab,Undermine,4,2,6
18683,2022-12-29,BUSTER,gemGrab,Gem Fort,1,1,2
18684,2022-12-29,BUSTER,brawlBall,Pinhole Punt,3,4,7
18685,2022-12-28,BUSTER,hotZone,Open Zone,1,0,1
18686,2022-12-28,BUSTER,brawlBall,Sunny Soccer,2,4,6
18687,2022-12-28,BUSTER,brawlBall,Beach Ball,0,2,2
18688,2022-12-27,BUSTER,heist,Kaboom Canyon,2,0,2
18689,2022-12-27,BUSTER,gemGrab,Minecart Madness,0,1,1
18690,2022-12-27,BUSTER,brawlBall,Center Stage,2,2,4
18691,2022-12-27,BUSTER,brawlBall,Beach Ball,7,22,29
18692,2022-12-26,BUSTER,brawlBall,Center Stage,3,4,7
18693,2022-12-25,BUSTER,hotZone,Ring of Fire,0,2,2
18694,2022-12-25,BUSTER,bounty,Layer Cake,2,2,4
18695,2022-12-24,BUSTER,brawlBall,Super Beach,2,2,4
18696,2022-12-23,BUSTER,knockout,Out in the Open,6,0,6
18697,2022-12-23,BUSTER,gemGrab,Deep Diner,0,1,1
18698,2022-12-23,BUSTER,brawlBall,Sneaky Fields,2,0,2
18699,2022-12-22,BUSTER,gemGrab,Gem Fort,1,0,1
18700,2022-12-22,BUSTER,brawlBall,Pinhole Punt,2,8,10
18701,2022-12-21,BUSTER,brawlBall,Sunny Soccer,1,5,6
18702,2022-12-20,BUSTER,brawlBall,Beach Ball,0,1,1
18703,2022-12-19,BUSTER,gemGrab,Minecart Madness,6,18,24
18704,2022-12-19,BUSTER,brawlBall,Center Stage,1,2,3
18705,2022-12-16,BUSTER,hotZone,Controller Chaos,0,1,1
18706,2022-12-16,BUSTER,brawlBall,Sneaky Fields,9,9,18
18707,2022-12-16,BUSTER,bounty,Temple Ruins,0,6,6
18708,2022-12-13,BUSTER,knockout,New Perspective,2,0,2
18709,2022-12-13,BUSTER,hotZone,Dueling Beetles,0,1,1
18710,2022-12-13,BUSTER,gemGrab,Crystal Arcade,3,8,11
18711,2022-12-11,BUSTER,brawlBall,Backyard Bowl,6,4,10
18712,2022-12-10,BUSTER,gemGrab,Hard Rock Mine,1,1,2
18713,2022-11-19,BUSTER,brawlBall,Sneaky Fields,2,0,2
18714,2022-11-18,BUSTER,hotZone,Parallel Plays,4,4,8
18715,2022-11-18,BUSTER,brawlBall,Beach Ball,0,4,4
18716,2022-11-11,BUSTER,brawlBall,Sneaky Fields,2,0,2
18717,2022-11-07,BUSTER,hotZone,Quarter Pounder,0,2,2
18718,2023-02-11,BULL,knockout,Flaring Phoenix,14,7,21
18719,2023-02-11,BULL,hotZone,Controller Chaos,24,3,27
18720,2023-02-11,BULL,gemGrab,Deep Diner,17,7,24
18721,2023-02-11,BULL,brawlBall,Super Beach,101,109,210
18722,2023-02-11,BULL,brawlBall,Sneaky Fields,128,131,259
18723,2023-02-10,BULL,knockout,Flaring Phoenix,24,12,36
18724,2023-02-10,BULL,hotZone,Controller Chaos,24,15,39
18725,2023-02-10,BULL,heist,Hot Potato,184,184,368
18726,2023-02-10,BULL,gemGrab,Undermine,8,2,10
18727,2023-02-10,BULL,gemGrab,Deep Diner,30,21,51
18728,2023-02-10,BULL,brawlBall,Sneaky Fields,1089,1116,2205
18729,2023-02-10,BULL,brawlBall,Pinhole Punt,6,9,15
18730,2023-02-10,BULL,bounty,Temple Ruins,14,14,28
18731,2023-02-09,BULL,hotZone,Open Zone,6,3,9
18732,2023-02-09,BULL,heist,Hot Potato,83,105,188
18733,2023-02-09,BULL,gemGrab,Undermine,13,1,14
18734,2023-02-09,BULL,gemGrab,Gem Fort,1,5,6
18735,2023-02-09,BULL,brawlBall,Sunny Soccer,2,0,2
18736,2023-02-09,BULL,brawlBall,Pinhole Punt,89,71,160
18737,2023-02-09,BULL,bounty,Temple Ruins,4,3,7
18738,2023-02-08,BULL,hotZone,Open Zone,1,1,2
18739,2023-02-08,BULL,heist,Safe Zone,7,5,12
18740,2023-02-08,BULL,gemGrab,Gem Fort,6,7,13
18741,2023-02-08,BULL,gemGrab,Crystal Arcade,1,1,2
18742,2023-02-08,BULL,brawlBall,Sunny Soccer,37,36,73
18743,2023-02-08,BULL,brawlBall,Beach Ball,2,2,4
18744,2023-02-07,BULL,knockout,New Perspective,2,0,2
18745,2023-02-07,BULL,hotZone,Dueling Beetles,3,2,5
18746,2023-02-07,BULL,heist,Safe Zone,1,0,1
18747,2023-02-07,BULL,gemGrab,Minecart Madness,4,0,4
18748,2023-02-07,BULL,gemGrab,Crystal Arcade,0,1,1
18749,2023-02-07,BULL,brawlBall,Center Stage,15,9,24
18750,2023-02-07,BULL,brawlBall,Beach Ball,26,26,52
18751,2023-02-07,BULL,bounty,Excel,3,1,4
18752,2023-02-06,BULL,knockout,New Perspective,16,12,28
18753,2023-02-06,BULL,hotZone,Dueling Beetles,41,19,60
18754,2023-02-06,BULL,heist,Snaked Assault,311,208,519
18755,2023-02-06,BULL,heist,Pit Stop,159,170,329
18756,2023-02-06,BULL,gemGrab,Minecart Madness,35,18,53
18757,2023-02-06,BULL,gemGrab,Double Swoosh,37,23,60
18758,2023-02-06,BULL,brawlBall,Sneaky Fields,10,15,25
18759,2023-02-06,BULL,brawlBall,Center Stage,1201,1294,2495
18760,2023-02-06,BULL,brawlBall,Backyard Bowl,16,13,29
18761,2023-02-06,BULL,bounty,Layer Cake,9,5,14
18762,2023-02-05,BULL,knockout,X Marks the Spot,6,6,12
18763,2023-02-05,BULL,knockout,Goldarm Gulch,0,1,1
18764,2023-02-05,BULL,hotZone,Ring of Fire,26,15,41
18765,2023-02-05,BULL,heist,Snaked Assault,426,353,779
18766,2023-02-05,BULL,heist,Pit Stop,431,527,958
18767,2023-02-05,BULL,gemGrab,Hard Rock Mine,28,17,45
18768,2023-02-05,BULL,gemGrab,Double Swoosh,98,75,173
18769,2023-02-05,BULL,brawlBall,Super Beach,23,32,55
18770,2023-02-05,BULL,brawlBall,Sneaky Fields,51,56,107
18771,2023-02-05,BULL,brawlBall,Backyard Bowl,229,235,464
18772,2023-02-05,BULL,bounty,Layer Cake,13,5,18
18773,2023-02-04,BULL,knockout,X Marks the Spot,4,2,6
18774,2023-02-04,BULL,hotZone,Ring of Fire,1,0,1
18775,2023-02-04,BULL,heist,Tornado Ring,47,34,81
18776,2023-02-04,BULL,heist,Pit Stop,264,336,600
18777,2023-02-04,BULL,gemGrab,Hard Rock Mine,25,10,35
18778,2023-02-04,BULL,gemGrab,Double Swoosh,16,14,30
18779,2023-02-04,BULL,brawlBall,Super Beach,120,158,278
18780,2023-02-04,BULL,brawlBall,Sneaky Fields,43,62,105
18781,2023-02-03,BULL,knockout,Out in the Open,6,6,12
18782,2023-02-03,BULL,knockout,Goldarm Gulch,5,2,7
18783,2023-02-03,BULL,hotZone,Split,46,42,88
18784,2023-02-03,BULL,heist,Tornado Ring,539,568,1107
18785,2023-02-03,BULL,heist,Pit Stop,1250,1501,2751
18786,2023-02-03,BULL,gemGrab,Undermine,14,21,35
18787,2023-02-03,BULL,gemGrab,Double Swoosh,70,66,136
18788,2023-02-03,BULL,gemGrab,Deep Diner,40,31,71
18789,2023-02-03,BULL,brawlBall,Sneaky Fields,1276,1389,2665
18790,2023-02-03,BULL,brawlBall,Pinhole Punt,21,14,35
18791,2023-02-03,BULL,bounty,Dry Season,2,3,5
18792,2023-02-02,BULL,knockout,Out in the Open,1,1,2
18793,2023-02-02,BULL,hotZone,Split,38,41,79
18794,2023-02-02,BULL,heist,Kaboom Canyon,14,10,24
18795,2023-02-02,BULL,gemGrab,Undermine,10,8,18
18796,2023-02-02,BULL,gemGrab,Gem Fort,1,5,6
18797,2023-02-02,BULL,brawlBall,Sunny Soccer,10,9,19
18798,2023-02-02,BULL,brawlBall,Pinhole Punt,100,91,191
18799,2023-02-02,BULL,bounty,Shooting Star,0,1,1
18800,2023-02-01,BULL,knockout,Goldarm Gulch,27,15,42
18801,2023-02-01,BULL,hotZone,Parallel Plays,35,18,53
18802,2023-02-01,BULL,heist,Kaboom Canyon,30,14,44
18803,2023-02-01,BULL,gemGrab,Gem Fort,85,87,172
18804,2023-02-01,BULL,gemGrab,Crystal Arcade,17,11,28
18805,2023-02-01,BULL,brawlBall,Sunny Soccer,434,560,994
18806,2023-02-01,BULL,brawlBall,Beach Ball,16,26,42
18807,2023-02-01,BULL,bounty,Shooting Star,1,0,1
18808,2023-01-31,BULL,knockout,Goldarm Gulch,11,5,16
18809,2023-01-31,BULL,hotZone,Parallel Plays,22,9,31
18810,2023-01-31,BULL,heist,Pit Stop,162,214,376
18811,2023-01-31,BULL,gemGrab,Minecart Madness,0,11,11
18812,2023-01-31,BULL,gemGrab,Crystal Arcade,20,6,26
18813,2023-01-31,BULL,brawlBall,Center Stage,19,12,31
18814,2023-01-31,BULL,brawlBall,Beach Ball,206,194,400
18815,2023-01-31,BULL,bounty,Hideout,1,1,2
18816,2023-01-30,BULL,knockout,Belle's Rock,15,9,24
18817,2023-01-30,BULL,hotZone,Quarter Pounder,14,5,19
18818,2023-01-30,BULL,heist,Pit Stop,788,911,1699
18819,2023-01-30,BULL,gemGrab,Minecart Madness,26,18,44
18820,2023-01-30,BULL,gemGrab,Double Swoosh,30,10,40
18821,2023-01-30,BULL,brawlBall,Center Stage,680,700,1380
18822,2023-01-30,BULL,brawlBall,Backyard Bowl,33,31,64
18823,2023-01-30,BULL,bounty,Hideout,4,2,6
18824,2023-01-29,BULL,knockout,Belle's Rock,17,19,36
18825,2023-01-29,BULL,hotZone,Quarter Pounder,13,6,19
18826,2023-01-29,BULL,heist,Bridge Too Far,23,19,42
18827,2023-01-29,BULL,gemGrab,Hard Rock Mine,19,20,39
18828,2023-01-29,BULL,gemGrab,Double Swoosh,62,46,108
18829,2023-01-29,BULL,brawlBall,Super Beach,15,6,21
18830,2023-01-29,BULL,brawlBall,Backyard Bowl,206,195,401
18831,2023-01-29,BULL,bounty,Canal Grande,9,18,27
18832,2023-01-28,BULL,knockout,Flaring Phoenix,9,14,23
18833,2023-01-28,BULL,hotZone,Controller Chaos,15,9,24
18834,2023-01-28,BULL,heist,Bridge Too Far,39,46,85
18835,2023-01-28,BULL,gemGrab,Hard Rock Mine,76,68,144
18836,2023-01-28,BULL,gemGrab,Deep Diner,7,5,12
18837,2023-01-28,BULL,brawlBall,Super Beach,685,725,1410
18838,2023-01-28,BULL,brawlBall,Sneaky Fields,43,40,83
18839,2023-01-28,BULL,bounty,Canal Grande,21,20,41
18840,2023-01-27,BULL,knockout,Flaring Phoenix,6,3,9
18841,2023-01-27,BULL,hotZone,Controller Chaos,4,6,10
18842,2023-01-27,BULL,heist,Hot Potato,72,76,148
18843,2023-01-27,BULL,gemGrab,Undermine,1,0,1
18844,2023-01-27,BULL,gemGrab,Deep Diner,20,6,26
18845,2023-01-27,BULL,brawlBall,Sneaky Fields,373,356,729
18846,2023-01-27,BULL,brawlBall,Pinhole Punt,1,3,4
18847,2023-01-27,BULL,bounty,Temple Ruins,3,1,4
18848,2023-01-26,BULL,knockout,Riverside,9,4,13
18849,2023-01-26,BULL,hotZone,Open Zone,9,8,17
18850,2023-01-26,BULL,heist,Hot Potato,508,506,1014
18851,2023-01-26,BULL,gemGrab,Undermine,58,58,116
18852,2023-01-26,BULL,gemGrab,Gem Fort,26,18,44
18853,2023-01-26,BULL,brawlBall,Sunny Soccer,33,28,61
18854,2023-01-26,BULL,brawlBall,Pinhole Punt,414,458,872
18855,2023-01-26,BULL,bounty,Temple Ruins,7,5,12
18856,2023-01-25,BULL,knockout,Riverside,13,5,18
18857,2023-01-25,BULL,hotZone,Open Zone,5,1,6
18858,2023-01-25,BULL,heist,Safe Zone,38,31,69
18859,2023-01-25,BULL,gemGrab,Gem Fort,29,38,67
18860,2023-01-25,BULL,gemGrab,Crystal Arcade,16,9,25
18861,2023-01-25,BULL,brawlBall,Sunny Soccer,347,323,670
18862,2023-01-25,BULL,brawlBall,Beach Ball,50,67,117
18863,2023-01-25,BULL,bounty,Excel,2,14,16
18864,2023-01-24,BULL,knockout,New Perspective,13,14,27
18865,2023-01-24,BULL,hotZone,Dueling Beetles,10,2,12
18866,2023-01-24,BULL,heist,Safe Zone,56,64,120
18867,2023-01-24,BULL,gemGrab,Minecart Madness,7,4,11
18868,2023-01-24,BULL,gemGrab,Crystal Arcade,45,36,81
18869,2023-01-24,BULL,brawlBall,Center Stage,142,170,312
18870,2023-01-24,BULL,brawlBall,Beach Ball,482,454,936
18871,2023-01-24,BULL,bounty,Excel,8,8,16
18872,2023-01-23,BULL,knockout,New Perspective,24,5,29
18873,2023-01-23,BULL,hotZone,Dueling Beetles,15,2,17
18874,2023-01-23,BULL,heist,Snaked Assault,328,341,669
18875,2023-01-23,BULL,gemGrab,Minecart Madness,43,23,66
18876,2023-01-23,BULL,gemGrab,Double Swoosh,20,19,39
18877,2023-01-23,BULL,brawlBall,Center Stage,1456,1616,3072
18878,2023-01-23,BULL,brawlBall,Backyard Bowl,17,7,24
18879,2023-01-23,BULL,bounty,Layer Cake,8,2,10
18880,2023-01-22,BULL,knockout,X Marks the Spot,2,1,3
18881,2023-01-22,BULL,hotZone,Ring of Fire,6,5,11
18882,2023-01-22,BULL,heist,Snaked Assault,217,171,388
18883,2023-01-22,BULL,gemGrab,Hard Rock Mine,33,35,68
18884,2023-01-22,BULL,gemGrab,Double Swoosh,45,39,84
18885,2023-01-22,BULL,brawlBall,Super Beach,56,57,113
18886,2023-01-22,BULL,brawlBall,Backyard Bowl,91,75,166
18887,2023-01-22,BULL,bounty,Layer Cake,12,15,27
18888,2023-01-21,BULL,knockout,X Marks the Spot,17,13,30
18889,2023-01-21,BULL,hotZone,Ring of Fire,14,5,19
18890,2023-01-21,BULL,heist,Tornado Ring,410,489,899
18891,2023-01-21,BULL,gemGrab,Hard Rock Mine,125,124,249
18892,2023-01-21,BULL,gemGrab,Deep Diner,17,21,38
18893,2023-01-21,BULL,brawlBall,Super Beach,936,935,1871
18894,2023-01-21,BULL,brawlBall,Sneaky Fields,82,84,166
18895,2023-01-21,BULL,bounty,Dry Season,2,1,3
18896,2023-01-20,BULL,knockout,Out in the Open,18,3,21
18897,2023-01-20,BULL,hotZone,Split,39,40,79
18898,2023-01-20,BULL,heist,Tornado Ring,414,435,849
18899,2023-01-20,BULL,gemGrab,Undermine,24,16,40
18900,2023-01-20,BULL,gemGrab,Deep Diner,43,47,90
18901,2023-01-20,BULL,brawlBall,Sneaky Fields,1215,1269,2484
18902,2023-01-20,BULL,brawlBall,Pinhole Punt,17,25,42
18903,2023-01-20,BULL,bounty,Dry Season,4,5,9
18904,2023-01-19,BULL,knockout,Out in the Open,27,22,49
18905,2023-01-19,BULL,hotZone,Split,84,49,133
18906,2023-01-19,BULL,heist,Kaboom Canyon,45,37,82
18907,2023-01-19,BULL,gemGrab,Undermine,93,80,173
18908,2023-01-19,BULL,gemGrab,Gem Fort,22,29,51
18909,2023-01-19,BULL,brawlBall,Sunny Soccer,29,40,69
18910,2023-01-19,BULL,brawlBall,Pinhole Punt,522,525,1047
18911,2023-01-19,BULL,bounty,Shooting Star,3,2,5
18912,2023-01-18,BULL,knockout,Goldarm Gulch,5,3,8
18913,2023-01-18,BULL,hotZone,Parallel Plays,3,2,5
18914,2023-01-18,BULL,heist,Kaboom Canyon,13,8,21
18915,2023-01-18,BULL,gemGrab,Gem Fort,24,18,42
18916,2023-01-18,BULL,gemGrab,Crystal Arcade,3,8,11
18917,2023-01-18,BULL,brawlBall,Sunny Soccer,198,210,408
18918,2023-01-18,BULL,brawlBall,Beach Ball,6,6,12
18919,2023-01-18,BULL,bounty,Shooting Star,1,4,5
18920,2023-01-17,BULL,knockout,Goldarm Gulch,6,2,8
18921,2023-01-17,BULL,hotZone,Parallel Plays,1,2,3
18922,2023-01-17,BULL,heist,Pit Stop,55,60,115
18923,2023-01-17,BULL,gemGrab,Crystal Arcade,1,3,4
18924,2023-01-17,BULL,brawlBall,Center Stage,11,6,17
18925,2023-01-17,BULL,brawlBall,Beach Ball,64,77,141
18926,2023-01-17,BULL,bounty,Hideout,2,2,4
18927,2023-01-16,BULL,knockout,Belle's Rock,0,2,2
18928,2023-01-16,BULL,hotZone,Quarter Pounder,3,0,3
18929,2023-01-16,BULL,heist,Pit Stop,287,256,543
18930,2023-01-16,BULL,gemGrab,Minecart Madness,2,4,6
18931,2023-01-16,BULL,gemGrab,Double Swoosh,2,1,3
18932,2023-01-16,BULL,brawlBall,Center Stage,102,110,212
18933,2023-01-16,BULL,brawlBall,Backyard Bowl,1,1,2
18934,2023-01-15,BULL,knockout,Belle's Rock,1,0,1
18935,2023-01-15,BULL,hotZone,Quarter Pounder,5,13,18
18936,2023-01-15,BULL,heist,Bridge Too Far,6,0,6
18937,2023-01-15,BULL,gemGrab,Hard Rock Mine,5,0,5
18938,2023-01-15,BULL,gemGrab,Double Swoosh,8,9,17
18939,2023-01-15,BULL,brawlBall,Super Beach,9,5,14
18940,2023-01-15,BULL,brawlBall,Backyard Bowl,22,20,42
18941,2023-01-15,BULL,bounty,Canal Grande,2,2,4
18942,2023-01-14,BULL,knockout,Flaring Phoenix,3,0,3
18943,2023-01-14,BULL,hotZone,Controller Chaos,6,1,7
18944,2023-01-14,BULL,heist,Bridge Too Far,6,1,7
18945,2023-01-14,BULL,gemGrab,Hard Rock Mine,2,1,3
18946,2023-01-14,BULL,gemGrab,Deep Diner,1,0,1
18947,2023-01-14,BULL,brawlBall,Super Beach,32,45,77
18948,2023-01-14,BULL,brawlBall,Sneaky Fields,12,3,15
18949,2023-01-13,BULL,hotZone,Controller Chaos,1,1,2
18950,2023-01-13,BULL,heist,Hot Potato,7,19,26
18951,2023-01-13,BULL,gemGrab,Deep Diner,2,8,10
18952,2023-01-13,BULL,brawlBall,Sneaky Fields,83,55,138
18953,2023-01-12,BULL,knockout,Riverside,3,4,7
18954,2023-01-12,BULL,hotZone,Open Zone,1,0,1
18955,2023-01-12,BULL,heist,Hot Potato,8,7,15
18956,2023-01-12,BULL,gemGrab,Undermine,0,1,1
18957,2023-01-12,BULL,gemGrab,Gem Fort,1,0,1
18958,2023-01-12,BULL,brawlBall,Sunny Soccer,1,0,1
18959,2023-01-12,BULL,brawlBall,Pinhole Punt,12,11,23
18960,2023-01-11,BULL,heist,Safe Zone,1,0,1
18961,2023-01-11,BULL,gemGrab,Gem Fort,2,0,2
18962,2023-01-11,BULL,brawlBall,Sunny Soccer,7,5,12
18963,2023-01-11,BULL,bounty,Excel,1,0,1
18964,2023-01-10,BULL,hotZone,Dueling Beetles,1,0,1
18965,2023-01-10,BULL,heist,Safe Zone,3,2,5
18966,2023-01-10,BULL,gemGrab,Minecart Madness,1,0,1
18967,2023-01-10,BULL,gemGrab,Crystal Arcade,5,2,7
18968,2023-01-10,BULL,brawlBall,Center Stage,5,4,9
18969,2023-01-10,BULL,brawlBall,Beach Ball,23,6,29
18970,2023-01-10,BULL,bounty,Excel,2,0,2
18971,2023-01-09,BULL,hotZone,Dueling Beetles,5,1,6
18972,2023-01-09,BULL,heist,Snaked Assault,40,39,79
18973,2023-01-09,BULL,gemGrab,Minecart Madness,2,0,2
18974,2023-01-09,BULL,gemGrab,Double Swoosh,3,0,3
18975,2023-01-09,BULL,brawlBall,Center Stage,47,49,96
18976,2023-01-09,BULL,brawlBall,Backyard Bowl,1,0,1
18977,2023-01-09,BULL,bounty,Layer Cake,2,2,4
18978,2023-01-08,BULL,knockout,X Marks the Spot,1,1,2
18979,2023-01-08,BULL,hotZone,Ring of Fire,2,0,2
18980,2023-01-08,BULL,heist,Snaked Assault,30,36,66
18981,2023-01-08,BULL,gemGrab,Hard Rock Mine,2,1,3
18982,2023-01-08,BULL,gemGrab,Double Swoosh,2,1,3
18983,2023-01-08,BULL,brawlBall,Super Beach,3,0,3
18984,2023-01-08,BULL,brawlBall,Backyard Bowl,13,5,18
18985,2023-01-08,BULL,bounty,Layer Cake,1,1,2
18986,2023-01-07,BULL,hotZone,Ring of Fire,1,0,1
18987,2023-01-07,BULL,heist,Tornado Ring,37,35,72
18988,2023-01-07,BULL,gemGrab,Hard Rock Mine,6,2,8
18989,2023-01-07,BULL,gemGrab,Deep Diner,2,0,2
18990,2023-01-07,BULL,brawlBall,Super Beach,11,5,16
18991,2023-01-07,BULL,brawlBall,Sneaky Fields,2,3,5
18992,2023-01-06,BULL,hotZone,Split,6,3,9
18993,2023-01-06,BULL,heist,Tornado Ring,77,113,190
18994,2023-01-06,BULL,gemGrab,Undermine,1,0,1
18995,2023-01-06,BULL,gemGrab,Deep Diner,3,0,3
18996,2023-01-06,BULL,brawlBall,Sneaky Fields,56,79,135
18997,2023-01-06,BULL,brawlBall,Pinhole Punt,3,6,9
18998,2023-01-06,BULL,bounty,Dry Season,1,0,1
18999,2023-01-05,BULL,knockout,Out in the Open,1,0,1
19000,2023-01-05,BULL,hotZone,Split,18,10,28
19001,2023-01-05,BULL,heist,Kaboom Canyon,2,2,4
19002,2023-01-05,BULL,gemGrab,Undermine,0,2,2
19003,2023-01-05,BULL,gemGrab,Gem Fort,4,6,10
19004,2023-01-05,BULL,brawlBall,Sunny Soccer,1,2,3
19005,2023-01-05,BULL,brawlBall,Pinhole Punt,35,16,51
19006,2023-01-05,BULL,bounty,Shooting Star,1,0,1
19007,2023-01-04,BULL,hotZone,Parallel Plays,2,3,5
19008,2023-01-04,BULL,heist,Kaboom Canyon,12,11,23
19009,2023-01-04,BULL,gemGrab,Gem Fort,3,0,3
19010,2023-01-04,BULL,gemGrab,Crystal Arcade,1,1,2
19011,2023-01-04,BULL,brawlBall,Sunny Soccer,33,16,49
19012,2023-01-03,BULL,hotZone,Parallel Plays,1,0,1
19013,2023-01-03,BULL,heist,Pit Stop,139,150,289
19014,2023-01-03,BULL,gemGrab,Minecart Madness,1,1,2
19015,2023-01-03,BULL,gemGrab,Crystal Arcade,4,0,4
19016,2023-01-03,BULL,brawlBall,Center Stage,2,1,3
19017,2023-01-03,BULL,brawlBall,Beach Ball,9,18,27
19018,2023-01-03,BULL,bounty,Hideout,2,0,2
19019,2023-01-02,BULL,knockout,Belle's Rock,1,0,1
19020,2023-01-02,BULL,hotZone,Quarter Pounder,2,0,2
19021,2023-01-02,BULL,heist,Pit Stop,184,164,348
19022,2023-01-02,BULL,gemGrab,Minecart Madness,5,3,8
19023,2023-01-02,BULL,gemGrab,Double Swoosh,4,1,5
19024,2023-01-02,BULL,brawlBall,Center Stage,80,61,141
19025,2023-01-02,BULL,brawlBall,Backyard Bowl,3,2,5
19026,2023-01-02,BULL,bounty,Hideout,0,1,1
19027,2023-01-01,BULL,hotZone,Quarter Pounder,1,1,2
19028,2023-01-01,BULL,heist,Bridge Too Far,2,0,2
19029,2023-01-01,BULL,gemGrab,Double Swoosh,3,1,4
19030,2023-01-01,BULL,brawlBall,Backyard Bowl,5,3,8
19031,2023-01-01,BULL,bounty,Canal Grande,0,1,1
19032,2022-12-31,BULL,hotZone,Controller Chaos,1,0,1
19033,2022-12-31,BULL,heist,Bridge Too Far,0,1,1
19034,2022-12-31,BULL,brawlBall,Super Beach,5,2,7
19035,2022-12-31,BULL,brawlBall,Sneaky Fields,4,3,7
19036,2022-12-30,BULL,heist,Hot Potato,0,2,2
19037,2022-12-30,BULL,gemGrab,Undermine,1,0,1
19038,2022-12-30,BULL,brawlBall,Sneaky Fields,2,3,5
19039,2022-12-29,BULL,heist,Hot Potato,5,9,14
19040,2022-12-29,BULL,gemGrab,Gem Fort,0,1,1
19041,2022-12-28,BULL,brawlBall,Beach Ball,2,0,2
19042,2022-12-27,BULL,gemGrab,Minecart Madness,1,0,1
19043,2022-12-27,BULL,brawlBall,Beach Ball,2,2,4
19044,2022-12-26,BULL,hotZone,Controller Chaos,0,1,1
19045,2022-12-23,BULL,knockout,Out in the Open,0,2,2
19046,2022-12-23,BULL,brawlBall,Sneaky Fields,0,1,1
19047,2022-12-22,BULL,brawlBall,Pinhole Punt,0,1,1
19048,2022-12-19,BULL,gemGrab,Minecart Madness,2,0,2
19049,2022-12-19,BULL,brawlBall,Center Stage,1,1,2
19050,2022-12-13,BULL,hotZone,Dueling Beetles,1,0,1
19051,2022-10-30,BULL,heist,Safe Zone,0,1,1
19052,2022-10-30,BULL,brawlBall,Beach Ball,0,2,2
19053,2022-10-28,BULL,hotZone,Dueling Beetles,2,0,2
19054,2022-10-15,BULL,gemGrab,Hard Rock Mine,0,1,1
19055,2022-10-15,BULL,brawlBall,Super Beach,0,1,1
19056,2023-02-11,BROCK,knockout,Flaring Phoenix,195,128,323
19057,2023-02-11,BROCK,hotZone,Controller Chaos,26,7,33
19058,2023-02-11,BROCK,gemGrab,Deep Diner,68,55,123
19059,2023-02-11,BROCK,brawlBall,Super Beach,56,29,85
19060,2023-02-11,BROCK,brawlBall,Sneaky Fields,16,15,31
19061,2023-02-10,BROCK,knockout,Flaring Phoenix,391,270,661
19062,2023-02-10,BROCK,hotZone,Controller Chaos,27,14,41
19063,2023-02-10,BROCK,heist,Hot Potato,96,77,173
19064,2023-02-10,BROCK,gemGrab,Undermine,41,28,69
19065,2023-02-10,BROCK,gemGrab,Deep Diner,177,122,299
19066,2023-02-10,BROCK,brawlBall,Sneaky Fields,178,100,278
19067,2023-02-10,BROCK,brawlBall,Pinhole Punt,9,5,14
19068,2023-02-10,BROCK,bounty,Temple Ruins,119,83,202
19069,2023-02-09,BROCK,knockout,Riverside,110,87,197
19070,2023-02-09,BROCK,hotZone,Open Zone,10,3,13
19071,2023-02-09,BROCK,heist,Hot Potato,46,26,72
19072,2023-02-09,BROCK,gemGrab,Undermine,30,21,51
19073,2023-02-09,BROCK,gemGrab,Gem Fort,7,2,9
19074,2023-02-09,BROCK,brawlBall,Sunny Soccer,1,0,1
19075,2023-02-09,BROCK,brawlBall,Pinhole Punt,88,76,164
19076,2023-02-09,BROCK,bounty,Temple Ruins,47,35,82
19077,2023-02-08,BROCK,knockout,Riverside,66,52,118
19078,2023-02-08,BROCK,hotZone,Open Zone,4,2,6
19079,2023-02-08,BROCK,heist,Safe Zone,60,58,118
19080,2023-02-08,BROCK,gemGrab,Gem Fort,13,5,18
19081,2023-02-08,BROCK,gemGrab,Crystal Arcade,3,4,7
19082,2023-02-08,BROCK,brawlBall,Sunny Soccer,17,15,32
19083,2023-02-08,BROCK,brawlBall,Beach Ball,0,1,1
19084,2023-02-08,BROCK,bounty,Excel,21,10,31
19085,2023-02-07,BROCK,knockout,New Perspective,21,9,30
19086,2023-02-07,BROCK,hotZone,Dueling Beetles,15,6,21
19087,2023-02-07,BROCK,heist,Safe Zone,27,29,56
19088,2023-02-07,BROCK,gemGrab,Minecart Madness,14,5,19
19089,2023-02-07,BROCK,gemGrab,Crystal Arcade,2,2,4
19090,2023-02-07,BROCK,brawlBall,Center Stage,1,0,1
19091,2023-02-07,BROCK,brawlBall,Beach Ball,16,8,24
19092,2023-02-07,BROCK,bounty,Excel,14,0,14
19093,2023-02-06,BROCK,knockout,New Perspective,446,354,800
19094,2023-02-06,BROCK,knockout,Goldarm Gulch,36,36,72
19095,2023-02-06,BROCK,hotZone,Dueling Beetles,100,51,151
19096,2023-02-06,BROCK,heist,Snaked Assault,203,153,356
19097,2023-02-06,BROCK,heist,Pit Stop,22,7,29
19098,2023-02-06,BROCK,gemGrab,Minecart Madness,292,262,554
19099,2023-02-06,BROCK,gemGrab,Double Swoosh,93,62,155
19100,2023-02-06,BROCK,brawlBall,Sneaky Fields,3,4,7
19101,2023-02-06,BROCK,brawlBall,Center Stage,455,350,805
19102,2023-02-06,BROCK,brawlBall,Backyard Bowl,139,128,267
19103,2023-02-06,BROCK,bounty,Layer Cake,192,148,340
19104,2023-02-05,BROCK,knockout,X Marks the Spot,372,305,677
19105,2023-02-05,BROCK,knockout,Goldarm Gulch,168,145,313
19106,2023-02-05,BROCK,hotZone,Ring of Fire,67,24,91
19107,2023-02-05,BROCK,heist,Snaked Assault,183,154,337
19108,2023-02-05,BROCK,heist,Pit Stop,90,16,106
19109,2023-02-05,BROCK,gemGrab,Hard Rock Mine,42,20,62
19110,2023-02-05,BROCK,gemGrab,Double Swoosh,210,123,333
19111,2023-02-05,BROCK,brawlBall,Super Beach,11,17,28
19112,2023-02-05,BROCK,brawlBall,Sneaky Fields,10,10,20
19113,2023-02-05,BROCK,brawlBall,Backyard Bowl,1522,1381,2903
19114,2023-02-05,BROCK,bounty,Layer Cake,244,207,451
19115,2023-02-04,BROCK,knockout,X Marks the Spot,149,159,308
19116,2023-02-04,BROCK,knockout,Goldarm Gulch,96,59,155
19117,2023-02-04,BROCK,hotZone,Ring of Fire,7,6,13
19118,2023-02-04,BROCK,heist,Tornado Ring,25,27,52
19119,2023-02-04,BROCK,heist,Pit Stop,48,19,67
19120,2023-02-04,BROCK,gemGrab,Hard Rock Mine,28,20,48
19121,2023-02-04,BROCK,gemGrab,Double Swoosh,36,9,45
19122,2023-02-04,BROCK,gemGrab,Deep Diner,8,7,15
19123,2023-02-04,BROCK,brawlBall,Super Beach,98,75,173
19124,2023-02-04,BROCK,brawlBall,Sneaky Fields,18,2,20
19125,2023-02-04,BROCK,bounty,Dry Season,61,62,123
19126,2023-02-03,BROCK,knockout,Out in the Open,645,595,1240
19127,2023-02-03,BROCK,knockout,Goldarm Gulch,442,341,783
19128,2023-02-03,BROCK,hotZone,Split,35,25,60
19129,2023-02-03,BROCK,heist,Tornado Ring,128,71,199
19130,2023-02-03,BROCK,heist,Pit Stop,252,79,331
19131,2023-02-03,BROCK,gemGrab,Undermine,30,14,44
19132,2023-02-03,BROCK,gemGrab,Double Swoosh,151,45,196
19133,2023-02-03,BROCK,gemGrab,Deep Diner,208,124,332
19134,2023-02-03,BROCK,brawlBall,Sneaky Fields,234,152,386
19135,2023-02-03,BROCK,brawlBall,Pinhole Punt,13,8,21
19136,2023-02-03,BROCK,bounty,Dry Season,496,406,902
19137,2023-02-02,BROCK,knockout,Out in the Open,316,220,536
19138,2023-02-02,BROCK,hotZone,Split,10,7,17
19139,2023-02-02,BROCK,heist,Kaboom Canyon,39,48,87
19140,2023-02-02,BROCK,gemGrab,Undermine,33,35,68
19141,2023-02-02,BROCK,gemGrab,Gem Fort,6,8,14
19142,2023-02-02,BROCK,brawlBall,Sunny Soccer,4,2,6
19143,2023-02-02,BROCK,brawlBall,Pinhole Punt,113,80,193
19144,2023-02-02,BROCK,bounty,Shooting Star,106,76,182
19145,2023-02-01,BROCK,knockout,Goldarm Gulch,430,347,777
19146,2023-02-01,BROCK,hotZone,Parallel Plays,50,25,75
19147,2023-02-01,BROCK,heist,Kaboom Canyon,210,139,349
19148,2023-02-01,BROCK,gemGrab,Gem Fort,84,55,139
19149,2023-02-01,BROCK,gemGrab,Crystal Arcade,69,48,117
19150,2023-02-01,BROCK,brawlBall,Sunny Soccer,240,206,446
19151,2023-02-01,BROCK,brawlBall,Beach Ball,8,4,12
19152,2023-02-01,BROCK,bounty,Shooting Star,188,177,365
19153,2023-01-31,BROCK,knockout,Goldarm Gulch,191,156,347
19154,2023-01-31,BROCK,hotZone,Parallel Plays,25,9,34
19155,2023-01-31,BROCK,heist,Pit Stop,42,22,64
19156,2023-01-31,BROCK,gemGrab,Minecart Madness,23,14,37
19157,2023-01-31,BROCK,gemGrab,Crystal Arcade,67,57,124
19158,2023-01-31,BROCK,brawlBall,Center Stage,5,4,9
19159,2023-01-31,BROCK,brawlBall,Beach Ball,128,129,257
19160,2023-01-31,BROCK,bounty,Hideout,98,104,202
19161,2023-01-30,BROCK,knockout,Belle's Rock,709,668,1377
19162,2023-01-30,BROCK,hotZone,Quarter Pounder,73,18,91
19163,2023-01-30,BROCK,heist,Pit Stop,74,27,101
19164,2023-01-30,BROCK,gemGrab,Minecart Madness,183,105,288
19165,2023-01-30,BROCK,gemGrab,Double Swoosh,92,58,150
19166,2023-01-30,BROCK,brawlBall,Center Stage,253,198,451
19167,2023-01-30,BROCK,brawlBall,Backyard Bowl,99,117,216
19168,2023-01-30,BROCK,bounty,Hideout,173,130,303
19169,2023-01-29,BROCK,knockout,Belle's Rock,670,582,1252
19170,2023-01-29,BROCK,hotZone,Quarter Pounder,52,33,85
19171,2023-01-29,BROCK,heist,Bridge Too Far,433,341,774
19172,2023-01-29,BROCK,gemGrab,Hard Rock Mine,13,9,22
19173,2023-01-29,BROCK,gemGrab,Double Swoosh,112,88,200
19174,2023-01-29,BROCK,brawlBall,Super Beach,3,3,6
19175,2023-01-29,BROCK,brawlBall,Backyard Bowl,970,943,1913
19176,2023-01-29,BROCK,bounty,Canal Grande,94,92,186
19177,2023-01-28,BROCK,knockout,Flaring Phoenix,242,192,434
19178,2023-01-28,BROCK,hotZone,Controller Chaos,27,5,32
19179,2023-01-28,BROCK,heist,Bridge Too Far,861,731,1592
19180,2023-01-28,BROCK,gemGrab,Hard Rock Mine,101,55,156
19181,2023-01-28,BROCK,gemGrab,Deep Diner,45,23,68
19182,2023-01-28,BROCK,brawlBall,Super Beach,279,209,488
19183,2023-01-28,BROCK,brawlBall,Sneaky Fields,5,4,9
19184,2023-01-28,BROCK,bounty,Canal Grande,149,125,274
19185,2023-01-27,BROCK,knockout,Flaring Phoenix,97,72,169
19186,2023-01-27,BROCK,hotZone,Controller Chaos,11,4,15
19187,2023-01-27,BROCK,heist,Hot Potato,78,35,113
19188,2023-01-27,BROCK,gemGrab,Undermine,9,7,16
19189,2023-01-27,BROCK,gemGrab,Deep Diner,71,41,112
19190,2023-01-27,BROCK,brawlBall,Sneaky Fields,54,36,90
19191,2023-01-27,BROCK,brawlBall,Pinhole Punt,2,1,3
19192,2023-01-27,BROCK,bounty,Temple Ruins,34,21,55
19193,2023-01-26,BROCK,knockout,Riverside,614,408,1022
19194,2023-01-26,BROCK,hotZone,Open Zone,52,24,76
19195,2023-01-26,BROCK,heist,Hot Potato,127,87,214
19196,2023-01-26,BROCK,gemGrab,Undermine,89,48,137
19197,2023-01-26,BROCK,gemGrab,Gem Fort,17,27,44
19198,2023-01-26,BROCK,brawlBall,Sunny Soccer,5,2,7
19199,2023-01-26,BROCK,brawlBall,Pinhole Punt,337,247,584
19200,2023-01-26,BROCK,bounty,Temple Ruins,83,55,138
19201,2023-01-25,BROCK,knockout,Riverside,319,240,559
19202,2023-01-25,BROCK,hotZone,Open Zone,28,8,36
19203,2023-01-25,BROCK,heist,Safe Zone,473,445,918
19204,2023-01-25,BROCK,gemGrab,Gem Fort,29,34,63
19205,2023-01-25,BROCK,gemGrab,Crystal Arcade,50,29,79
19206,2023-01-25,BROCK,brawlBall,Sunny Soccer,126,120,246
19207,2023-01-25,BROCK,brawlBall,Beach Ball,31,29,60
19208,2023-01-25,BROCK,bounty,Excel,98,74,172
19209,2023-01-24,BROCK,knockout,New Perspective,235,165,400
19210,2023-01-24,BROCK,hotZone,Dueling Beetles,52,29,81
19211,2023-01-24,BROCK,heist,Safe Zone,726,639,1365
19212,2023-01-24,BROCK,gemGrab,Minecart Madness,61,44,105
19213,2023-01-24,BROCK,gemGrab,Crystal Arcade,112,59,171
19214,2023-01-24,BROCK,brawlBall,Center Stage,37,26,63
19215,2023-01-24,BROCK,brawlBall,Beach Ball,274,212,486
19216,2023-01-24,BROCK,bounty,Excel,171,116,287
19217,2023-01-23,BROCK,knockout,New Perspective,422,324,746
19218,2023-01-23,BROCK,hotZone,Dueling Beetles,64,19,83
19219,2023-01-23,BROCK,heist,Snaked Assault,189,94,283
19220,2023-01-23,BROCK,gemGrab,Minecart Madness,277,222,499
19221,2023-01-23,BROCK,gemGrab,Double Swoosh,66,77,143
19222,2023-01-23,BROCK,brawlBall,Center Stage,434,288,722
19223,2023-01-23,BROCK,brawlBall,Backyard Bowl,59,65,124
19224,2023-01-23,BROCK,bounty,Layer Cake,205,142,347
19225,2023-01-22,BROCK,knockout,X Marks the Spot,295,253,548
19226,2023-01-22,BROCK,hotZone,Ring of Fire,24,6,30
19227,2023-01-22,BROCK,heist,Snaked Assault,108,53,161
19228,2023-01-22,BROCK,gemGrab,Hard Rock Mine,23,15,38
19229,2023-01-22,BROCK,gemGrab,Double Swoosh,50,30,80
19230,2023-01-22,BROCK,brawlBall,Super Beach,34,29,63
19231,2023-01-22,BROCK,brawlBall,Backyard Bowl,509,476,985
19232,2023-01-22,BROCK,bounty,Layer Cake,115,94,209
19233,2023-01-21,BROCK,knockout,X Marks the Spot,1000,830,1830
19234,2023-01-21,BROCK,hotZone,Ring of Fire,84,26,110
19235,2023-01-21,BROCK,heist,Tornado Ring,107,82,189
19236,2023-01-21,BROCK,gemGrab,Hard Rock Mine,122,76,198
19237,2023-01-21,BROCK,gemGrab,Deep Diner,32,17,49
19238,2023-01-21,BROCK,brawlBall,Super Beach,277,222,499
19239,2023-01-21,BROCK,brawlBall,Sneaky Fields,5,1,6
19240,2023-01-21,BROCK,bounty,Dry Season,360,322,682
19241,2023-01-20,BROCK,knockout,Out in the Open,667,594,1261
19242,2023-01-20,BROCK,hotZone,Split,33,14,47
19243,2023-01-20,BROCK,heist,Tornado Ring,99,48,147
19244,2023-01-20,BROCK,gemGrab,Undermine,49,28,77
19245,2023-01-20,BROCK,gemGrab,Deep Diner,179,106,285
19246,2023-01-20,BROCK,brawlBall,Sneaky Fields,157,130,287
19247,2023-01-20,BROCK,brawlBall,Pinhole Punt,23,17,40
19248,2023-01-20,BROCK,bounty,Dry Season,275,198,473
19249,2023-01-19,BROCK,knockout,Out in the Open,839,760,1599
19250,2023-01-19,BROCK,hotZone,Split,47,20,67
19251,2023-01-19,BROCK,heist,Kaboom Canyon,245,201,446
19252,2023-01-19,BROCK,gemGrab,Undermine,128,106,234
19253,2023-01-19,BROCK,gemGrab,Gem Fort,16,23,39
19254,2023-01-19,BROCK,brawlBall,Sunny Soccer,9,3,12
19255,2023-01-19,BROCK,brawlBall,Pinhole Punt,325,270,595
19256,2023-01-19,BROCK,bounty,Shooting Star,277,225,502
19257,2023-01-18,BROCK,knockout,Goldarm Gulch,70,40,110
19258,2023-01-18,BROCK,hotZone,Parallel Plays,10,6,16
19259,2023-01-18,BROCK,heist,Kaboom Canyon,93,115,208
19260,2023-01-18,BROCK,gemGrab,Gem Fort,21,21,42
19261,2023-01-18,BROCK,gemGrab,Crystal Arcade,9,3,12
19262,2023-01-18,BROCK,brawlBall,Sunny Soccer,64,50,114
19263,2023-01-18,BROCK,brawlBall,Beach Ball,3,5,8
19264,2023-01-18,BROCK,bounty,Shooting Star,114,90,204
19265,2023-01-17,BROCK,knockout,Goldarm Gulch,54,32,86
19266,2023-01-17,BROCK,hotZone,Parallel Plays,4,1,5
19267,2023-01-17,BROCK,heist,Pit Stop,6,8,14
19268,2023-01-17,BROCK,gemGrab,Minecart Madness,6,2,8
19269,2023-01-17,BROCK,gemGrab,Crystal Arcade,11,5,16
19270,2023-01-17,BROCK,brawlBall,Center Stage,1,1,2
19271,2023-01-17,BROCK,brawlBall,Beach Ball,21,21,42
19272,2023-01-17,BROCK,bounty,Hideout,13,18,31
19273,2023-01-16,BROCK,knockout,Belle's Rock,54,31,85
19274,2023-01-16,BROCK,hotZone,Quarter Pounder,4,2,6
19275,2023-01-16,BROCK,heist,Pit Stop,9,8,17
19276,2023-01-16,BROCK,gemGrab,Minecart Madness,19,12,31
19277,2023-01-16,BROCK,gemGrab,Double Swoosh,3,5,8
19278,2023-01-16,BROCK,brawlBall,Center Stage,22,25,47
19279,2023-01-16,BROCK,brawlBall,Backyard Bowl,10,7,17
19280,2023-01-16,BROCK,bounty,Hideout,35,28,63
19281,2023-01-15,BROCK,knockout,Belle's Rock,97,82,179
19282,2023-01-15,BROCK,hotZone,Quarter Pounder,18,2,20
19283,2023-01-15,BROCK,heist,Bridge Too Far,107,72,179
19284,2023-01-15,BROCK,gemGrab,Hard Rock Mine,3,1,4
19285,2023-01-15,BROCK,gemGrab,Double Swoosh,8,2,10
19286,2023-01-15,BROCK,brawlBall,Super Beach,2,0,2
19287,2023-01-15,BROCK,brawlBall,Backyard Bowl,100,132,232
19288,2023-01-15,BROCK,bounty,Canal Grande,17,5,22
19289,2023-01-14,BROCK,knockout,Flaring Phoenix,18,10,28
19290,2023-01-14,BROCK,hotZone,Controller Chaos,13,1,14
19291,2023-01-14,BROCK,heist,Bridge Too Far,128,90,218
19292,2023-01-14,BROCK,gemGrab,Hard Rock Mine,10,2,12
19293,2023-01-14,BROCK,gemGrab,Deep Diner,7,2,9
19294,2023-01-14,BROCK,brawlBall,Super Beach,20,8,28
19295,2023-01-14,BROCK,brawlBall,Sneaky Fields,1,1,2
19296,2023-01-14,BROCK,bounty,Canal Grande,23,27,50
19297,2023-01-13,BROCK,knockout,Flaring Phoenix,20,21,41
19298,2023-01-13,BROCK,hotZone,Controller Chaos,6,0,6
19299,2023-01-13,BROCK,heist,Hot Potato,3,1,4
19300,2023-01-13,BROCK,gemGrab,Deep Diner,13,2,15
19301,2023-01-13,BROCK,brawlBall,Sneaky Fields,8,2,10
19302,2023-01-13,BROCK,brawlBall,Pinhole Punt,1,3,4
19303,2023-01-13,BROCK,bounty,Temple Ruins,4,3,7
19304,2023-01-12,BROCK,knockout,Riverside,102,66,168
19305,2023-01-12,BROCK,hotZone,Open Zone,7,0,7
19306,2023-01-12,BROCK,gemGrab,Undermine,3,1,4
19307,2023-01-12,BROCK,brawlBall,Sunny Soccer,1,0,1
19308,2023-01-12,BROCK,brawlBall,Pinhole Punt,9,7,16
19309,2023-01-12,BROCK,bounty,Temple Ruins,1,0,1
19310,2023-01-11,BROCK,knockout,Riverside,15,5,20
19311,2023-01-11,BROCK,hotZone,Open Zone,1,0,1
19312,2023-01-11,BROCK,heist,Safe Zone,2,1,3
19313,2023-01-11,BROCK,gemGrab,Gem Fort,0,1,1
19314,2023-01-11,BROCK,brawlBall,Sunny Soccer,9,0,9
19315,2023-01-11,BROCK,brawlBall,Beach Ball,0,1,1
19316,2023-01-11,BROCK,bounty,Excel,2,0,2
19317,2023-01-10,BROCK,knockout,New Perspective,28,22,50
19318,2023-01-10,BROCK,hotZone,Dueling Beetles,10,16,26
19319,2023-01-10,BROCK,heist,Safe Zone,60,54,114
19320,2023-01-10,BROCK,gemGrab,Minecart Madness,15,8,23
19321,2023-01-10,BROCK,gemGrab,Crystal Arcade,9,9,18
19322,2023-01-10,BROCK,brawlBall,Center Stage,6,2,8
19323,2023-01-10,BROCK,brawlBall,Beach Ball,13,11,24
19324,2023-01-10,BROCK,bounty,Excel,6,1,7
19325,2023-01-09,BROCK,knockout,New Perspective,16,4,20
19326,2023-01-09,BROCK,hotZone,Dueling Beetles,5,0,5
19327,2023-01-09,BROCK,heist,Snaked Assault,18,18,36
19328,2023-01-09,BROCK,gemGrab,Minecart Madness,19,7,26
19329,2023-01-09,BROCK,gemGrab,Double Swoosh,12,4,16
19330,2023-01-09,BROCK,brawlBall,Center Stage,14,11,25
19331,2023-01-09,BROCK,brawlBall,Backyard Bowl,8,2,10
19332,2023-01-09,BROCK,bounty,Layer Cake,22,18,40
19333,2023-01-08,BROCK,knockout,X Marks the Spot,66,55,121
19334,2023-01-08,BROCK,hotZone,Ring of Fire,12,16,28
19335,2023-01-08,BROCK,heist,Snaked Assault,14,9,23
19336,2023-01-08,BROCK,gemGrab,Hard Rock Mine,1,0,1
19337,2023-01-08,BROCK,gemGrab,Double Swoosh,1,3,4
19338,2023-01-08,BROCK,brawlBall,Super Beach,3,5,8
19339,2023-01-08,BROCK,brawlBall,Backyard Bowl,87,81,168
19340,2023-01-08,BROCK,bounty,Layer Cake,8,5,13
19341,2023-01-07,BROCK,knockout,X Marks the Spot,43,23,66
19342,2023-01-07,BROCK,hotZone,Ring of Fire,2,0,2
19343,2023-01-07,BROCK,heist,Tornado Ring,9,5,14
19344,2023-01-07,BROCK,gemGrab,Hard Rock Mine,6,1,7
19345,2023-01-07,BROCK,gemGrab,Deep Diner,6,5,11
19346,2023-01-07,BROCK,brawlBall,Super Beach,4,2,6
19347,2023-01-07,BROCK,brawlBall,Sneaky Fields,1,0,1
19348,2023-01-07,BROCK,bounty,Dry Season,27,40,67
19349,2023-01-06,BROCK,knockout,Out in the Open,45,32,77
19350,2023-01-06,BROCK,hotZone,Split,4,0,4
19351,2023-01-06,BROCK,heist,Tornado Ring,15,2,17
19352,2023-01-06,BROCK,gemGrab,Undermine,2,3,5
19353,2023-01-06,BROCK,gemGrab,Deep Diner,9,5,14
19354,2023-01-06,BROCK,brawlBall,Sneaky Fields,5,5,10
19355,2023-01-06,BROCK,brawlBall,Pinhole Punt,0,1,1
19356,2023-01-06,BROCK,bounty,Dry Season,48,21,69
19357,2023-01-05,BROCK,knockout,Out in the Open,114,99,213
19358,2023-01-05,BROCK,hotZone,Split,9,0,9
19359,2023-01-05,BROCK,heist,Kaboom Canyon,45,32,77
19360,2023-01-05,BROCK,gemGrab,Undermine,5,3,8
19361,2023-01-05,BROCK,gemGrab,Gem Fort,10,2,12
19362,2023-01-05,BROCK,brawlBall,Sunny Soccer,1,0,1
19363,2023-01-05,BROCK,brawlBall,Pinhole Punt,18,10,28
19364,2023-01-05,BROCK,bounty,Shooting Star,38,34,72
19365,2023-01-04,BROCK,knockout,Goldarm Gulch,17,29,46
19366,2023-01-04,BROCK,hotZone,Parallel Plays,0,2,2
19367,2023-01-04,BROCK,heist,Kaboom Canyon,82,138,220
19368,2023-01-04,BROCK,gemGrab,Gem Fort,6,5,11
19369,2023-01-04,BROCK,gemGrab,Crystal Arcade,3,0,3
19370,2023-01-04,BROCK,brawlBall,Sunny Soccer,11,18,29
19371,2023-01-04,BROCK,bounty,Shooting Star,87,79,166
19372,2023-01-03,BROCK,knockout,Goldarm Gulch,14,13,27
19373,2023-01-03,BROCK,hotZone,Parallel Plays,3,0,3
19374,2023-01-03,BROCK,heist,Pit Stop,7,1,8
19375,2023-01-03,BROCK,heist,Kaboom Canyon,2,1,3
19376,2023-01-03,BROCK,gemGrab,Minecart Madness,0,1,1
19377,2023-01-03,BROCK,gemGrab,Crystal Arcade,15,37,52
19378,2023-01-03,BROCK,brawlBall,Center Stage,1,0,1
19379,2023-01-03,BROCK,brawlBall,Beach Ball,22,30,52
19380,2023-01-03,BROCK,bounty,Hideout,36,17,53
19381,2023-01-02,BROCK,knockout,Belle's Rock,55,57,112
19382,2023-01-02,BROCK,hotZone,Quarter Pounder,9,0,9
19383,2023-01-02,BROCK,heist,Pit Stop,8,0,8
19384,2023-01-02,BROCK,heist,Kaboom Canyon,0,2,2
19385,2023-01-02,BROCK,gemGrab,Minecart Madness,24,6,30
19386,2023-01-02,BROCK,gemGrab,Double Swoosh,9,4,13
19387,2023-01-02,BROCK,brawlBall,Center Stage,22,18,40
19388,2023-01-02,BROCK,brawlBall,Backyard Bowl,4,2,6
19389,2023-01-02,BROCK,bounty,Hideout,82,57,139
19390,2023-01-01,BROCK,knockout,Belle's Rock,33,15,48
19391,2023-01-01,BROCK,hotZone,Quarter Pounder,3,1,4
19392,2023-01-01,BROCK,heist,Kaboom Canyon,1,1,2
19393,2023-01-01,BROCK,heist,Bridge Too Far,15,9,24
19394,2023-01-01,BROCK,gemGrab,Double Swoosh,5,0,5
19395,2023-01-01,BROCK,brawlBall,Backyard Bowl,43,32,75
19396,2023-01-01,BROCK,bounty,Canal Grande,6,4,10
19397,2022-12-31,BROCK,knockout,Flaring Phoenix,1,0,1
19398,2022-12-31,BROCK,heist,Bridge Too Far,13,18,31
19399,2022-12-31,BROCK,gemGrab,Hard Rock Mine,1,0,1
19400,2022-12-31,BROCK,gemGrab,Deep Diner,6,12,18
19401,2022-12-31,BROCK,brawlBall,Super Beach,2,3,5
19402,2022-12-30,BROCK,knockout,Flaring Phoenix,6,4,10
19403,2022-12-30,BROCK,heist,Kaboom Canyon,0,2,2
19404,2022-12-30,BROCK,gemGrab,Deep Diner,2,0,2
19405,2022-12-30,BROCK,brawlBall,Sneaky Fields,0,3,3
19406,2022-12-29,BROCK,heist,Kaboom Canyon,1,1,2
19407,2022-12-27,BROCK,knockout,New Perspective,4,6,10
19408,2022-12-27,BROCK,hotZone,Dueling Beetles,0,1,1
19409,2022-12-27,BROCK,heist,Safe Zone,2,2,4
19410,2022-12-27,BROCK,heist,Kaboom Canyon,1,0,1
19411,2022-12-27,BROCK,bounty,Excel,0,1,1
19412,2022-12-26,BROCK,heist,Kaboom Canyon,1,0,1
19413,2022-12-26,BROCK,gemGrab,Minecart Madness,3,0,3
19414,2022-12-25,BROCK,hotZone,Ring of Fire,1,0,1
19415,2022-12-25,BROCK,gemGrab,Double Swoosh,1,1,2
19416,2022-12-25,BROCK,brawlBall,Backyard Bowl,2,10,12
19417,2022-12-24,BROCK,knockout,X Marks the Spot,0,1,1
19418,2022-12-23,BROCK,knockout,Out in the Open,10,18,28
19419,2022-12-22,BROCK,heist,Kaboom Canyon,0,1,1
19420,2022-12-22,BROCK,brawlBall,Pinhole Punt,2,0,2
19421,2022-12-20,BROCK,brawlBall,Beach Ball,4,2,6
19422,2022-12-19,BROCK,brawlBall,Center Stage,1,1,2
19423,2022-12-18,BROCK,heist,Bridge Too Far,1,0,1
19424,2022-12-16,BROCK,bounty,Temple Ruins,3,0,3
19425,2022-12-13,BROCK,heist,Safe Zone,3,2,5
19426,2022-12-13,BROCK,gemGrab,Crystal Arcade,3,2,5
19427,2022-12-12,BROCK,brawlBall,Center Stage,2,0,2
19428,2022-12-10,BROCK,knockout,X Marks the Spot,1,1,2
19429,2022-11-11,BROCK,knockout,New Perspective,0,4,4
19430,2022-11-03,BROCK,brawlBall,Pinhole Punt,2,0,2
19431,2022-11-03,BROCK,bounty,Temple Ruins,2,0,2
19432,2022-11-01,BROCK,knockout,New Perspective,8,8,16
19433,2022-10-28,BROCK,knockout,Out in the Open,2,0,2
19434,2022-10-28,BROCK,heist,Safe Zone,2,2,4
19435,2022-10-28,BROCK,bounty,Canal Grande,0,4,4
19436,2022-10-26,BROCK,bounty,Shooting Star,1,0,1
19437,2022-10-15,BROCK,gemGrab,Hard Rock Mine,1,0,1
19438,2022-10-15,BROCK,brawlBall,Super Beach,1,0,1
19439,2022-10-10,BROCK,knockout,Belle's Rock,3,2,5
19440,2023-02-11,BONNIE,knockout,Flaring Phoenix,31,23,54
19441,2023-02-11,BONNIE,hotZone,Controller Chaos,10,12,22
19442,2023-02-11,BONNIE,gemGrab,Deep Diner,11,15,26
19443,2023-02-11,BONNIE,brawlBall,Super Beach,8,11,19
19444,2023-02-11,BONNIE,brawlBall,Sneaky Fields,6,3,9
19445,2023-02-10,BONNIE,knockout,Flaring Phoenix,76,79,155
19446,2023-02-10,BONNIE,hotZone,Controller Chaos,5,0,5
19447,2023-02-10,BONNIE,heist,Hot Potato,19,6,25
19448,2023-02-10,BONNIE,gemGrab,Undermine,6,7,13
19449,2023-02-10,BONNIE,gemGrab,Deep Diner,54,60,114
19450,2023-02-10,BONNIE,brawlBall,Sneaky Fields,56,52,108
19451,2023-02-10,BONNIE,brawlBall,Pinhole Punt,5,4,9
19452,2023-02-10,BONNIE,bounty,Temple Ruins,17,19,36
19453,2023-02-09,BONNIE,knockout,Riverside,19,17,36
19454,2023-02-09,BONNIE,hotZone,Open Zone,4,6,10
19455,2023-02-09,BONNIE,heist,Hot Potato,5,5,10
19456,2023-02-09,BONNIE,gemGrab,Undermine,11,8,19
19457,2023-02-09,BONNIE,brawlBall,Sunny Soccer,1,1,2
19458,2023-02-09,BONNIE,brawlBall,Pinhole Punt,38,49,87
19459,2023-02-09,BONNIE,bounty,Temple Ruins,11,13,24
19460,2023-02-08,BONNIE,knockout,Riverside,15,10,25
19461,2023-02-08,BONNIE,hotZone,Open Zone,1,7,8
19462,2023-02-08,BONNIE,heist,Safe Zone,13,6,19
19463,2023-02-08,BONNIE,gemGrab,Gem Fort,4,6,10
19464,2023-02-08,BONNIE,gemGrab,Crystal Arcade,0,2,2
19465,2023-02-08,BONNIE,brawlBall,Sunny Soccer,12,12,24
19466,2023-02-08,BONNIE,bounty,Excel,1,2,3
19467,2023-02-07,BONNIE,knockout,New Perspective,3,1,4
19468,2023-02-07,BONNIE,hotZone,Dueling Beetles,1,0,1
19469,2023-02-07,BONNIE,heist,Safe Zone,2,3,5
19470,2023-02-07,BONNIE,gemGrab,Minecart Madness,11,18,29
19471,2023-02-07,BONNIE,gemGrab,Crystal Arcade,1,2,3
19472,2023-02-07,BONNIE,brawlBall,Beach Ball,8,5,13
19473,2023-02-07,BONNIE,bounty,Excel,1,1,2
19474,2023-02-06,BONNIE,knockout,New Perspective,76,88,164
19475,2023-02-06,BONNIE,knockout,Goldarm Gulch,1,2,3
19476,2023-02-06,BONNIE,hotZone,Dueling Beetles,26,40,66
19477,2023-02-06,BONNIE,heist,Snaked Assault,9,22,31
19478,2023-02-06,BONNIE,heist,Pit Stop,2,1,3
19479,2023-02-06,BONNIE,gemGrab,Minecart Madness,101,159,260
19480,2023-02-06,BONNIE,gemGrab,Double Swoosh,3,5,8
19481,2023-02-06,BONNIE,brawlBall,Sneaky Fields,2,1,3
19482,2023-02-06,BONNIE,brawlBall,Center Stage,67,81,148
19483,2023-02-06,BONNIE,brawlBall,Backyard Bowl,28,56,84
19484,2023-02-06,BONNIE,bounty,Layer Cake,26,39,65
19485,2023-02-05,BONNIE,knockout,X Marks the Spot,78,59,137
19486,2023-02-05,BONNIE,knockout,Goldarm Gulch,16,13,29
19487,2023-02-05,BONNIE,hotZone,Ring of Fire,22,7,29
19488,2023-02-05,BONNIE,heist,Snaked Assault,20,12,32
19489,2023-02-05,BONNIE,heist,Pit Stop,7,3,10
19490,2023-02-05,BONNIE,gemGrab,Hard Rock Mine,4,2,6
19491,2023-02-05,BONNIE,gemGrab,Double Swoosh,43,22,65
19492,2023-02-05,BONNIE,brawlBall,Super Beach,2,14,16
19493,2023-02-05,BONNIE,brawlBall,Backyard Bowl,439,537,976
19494,2023-02-05,BONNIE,bounty,Layer Cake,30,30,60
19495,2023-02-04,BONNIE,knockout,X Marks the Spot,22,19,41
19496,2023-02-04,BONNIE,knockout,Goldarm Gulch,12,10,22
19497,2023-02-04,BONNIE,hotZone,Ring of Fire,7,11,18
19498,2023-02-04,BONNIE,heist,Tornado Ring,0,1,1
19499,2023-02-04,BONNIE,heist,Pit Stop,3,0,3
19500,2023-02-04,BONNIE,gemGrab,Hard Rock Mine,5,0,5
19501,2023-02-04,BONNIE,gemGrab,Double Swoosh,3,4,7
19502,2023-02-04,BONNIE,gemGrab,Deep Diner,3,2,5
19503,2023-02-04,BONNIE,brawlBall,Super Beach,26,42,68
19504,2023-02-04,BONNIE,brawlBall,Sneaky Fields,1,5,6
19505,2023-02-04,BONNIE,bounty,Dry Season,14,11,25
19506,2023-02-03,BONNIE,knockout,Out in the Open,98,102,200
19507,2023-02-03,BONNIE,knockout,Goldarm Gulch,75,60,135
19508,2023-02-03,BONNIE,hotZone,Split,7,4,11
19509,2023-02-03,BONNIE,heist,Tornado Ring,12,17,29
19510,2023-02-03,BONNIE,heist,Pit Stop,28,15,43
19511,2023-02-03,BONNIE,gemGrab,Undermine,17,13,30
19512,2023-02-03,BONNIE,gemGrab,Double Swoosh,38,23,61
19513,2023-02-03,BONNIE,gemGrab,Deep Diner,39,17,56
19514,2023-02-03,BONNIE,brawlBall,Sneaky Fields,54,68,122
19515,2023-02-03,BONNIE,brawlBall,Pinhole Punt,3,9,12
19516,2023-02-03,BONNIE,bounty,Dry Season,64,64,128
19517,2023-02-02,BONNIE,knockout,Out in the Open,47,52,99
19518,2023-02-02,BONNIE,hotZone,Split,1,2,3
19519,2023-02-02,BONNIE,heist,Kaboom Canyon,6,6,12
19520,2023-02-02,BONNIE,gemGrab,Undermine,4,6,10
19521,2023-02-02,BONNIE,gemGrab,Gem Fort,2,3,5
19522,2023-02-02,BONNIE,brawlBall,Sunny Soccer,3,6,9
19523,2023-02-02,BONNIE,brawlBall,Pinhole Punt,39,49,88
19524,2023-02-02,BONNIE,bounty,Shooting Star,16,17,33
19525,2023-02-01,BONNIE,knockout,Goldarm Gulch,77,95,172
19526,2023-02-01,BONNIE,hotZone,Parallel Plays,14,8,22
19527,2023-02-01,BONNIE,heist,Kaboom Canyon,63,85,148
19528,2023-02-01,BONNIE,gemGrab,Gem Fort,22,24,46
19529,2023-02-01,BONNIE,gemGrab,Crystal Arcade,17,25,42
19530,2023-02-01,BONNIE,brawlBall,Sunny Soccer,48,74,122
19531,2023-02-01,BONNIE,brawlBall,Beach Ball,1,4,5
19532,2023-02-01,BONNIE,bounty,Shooting Star,14,16,30
19533,2023-01-31,BONNIE,knockout,Goldarm Gulch,41,44,85
19534,2023-01-31,BONNIE,hotZone,Parallel Plays,6,5,11
19535,2023-01-31,BONNIE,heist,Pit Stop,3,1,4
19536,2023-01-31,BONNIE,gemGrab,Minecart Madness,3,2,5
19537,2023-01-31,BONNIE,gemGrab,Crystal Arcade,9,9,18
19538,2023-01-31,BONNIE,brawlBall,Center Stage,2,2,4
19539,2023-01-31,BONNIE,brawlBall,Beach Ball,42,55,97
19540,2023-01-31,BONNIE,bounty,Hideout,16,26,42
19541,2023-01-30,BONNIE,knockout,Belle's Rock,136,174,310
19542,2023-01-30,BONNIE,hotZone,Quarter Pounder,17,28,45
19543,2023-01-30,BONNIE,heist,Pit Stop,5,6,11
19544,2023-01-30,BONNIE,gemGrab,Minecart Madness,52,70,122
19545,2023-01-30,BONNIE,gemGrab,Double Swoosh,15,10,25
19546,2023-01-30,BONNIE,brawlBall,Center Stage,50,27,77
19547,2023-01-30,BONNIE,brawlBall,Backyard Bowl,31,42,73
19548,2023-01-30,BONNIE,bounty,Hideout,23,14,37
19549,2023-01-29,BONNIE,knockout,Belle's Rock,162,234,396
19550,2023-01-29,BONNIE,hotZone,Quarter Pounder,11,4,15
19551,2023-01-29,BONNIE,heist,Bridge Too Far,92,86,178
19552,2023-01-29,BONNIE,gemGrab,Hard Rock Mine,2,12,14
19553,2023-01-29,BONNIE,gemGrab,Double Swoosh,15,13,28
19554,2023-01-29,BONNIE,brawlBall,Super Beach,0,4,4
19555,2023-01-29,BONNIE,brawlBall,Backyard Bowl,298,443,741
19556,2023-01-29,BONNIE,bounty,Canal Grande,7,9,16
19557,2023-01-28,BONNIE,knockout,Flaring Phoenix,49,44,93
19558,2023-01-28,BONNIE,hotZone,Controller Chaos,11,8,19
19559,2023-01-28,BONNIE,heist,Bridge Too Far,255,325,580
19560,2023-01-28,BONNIE,gemGrab,Hard Rock Mine,47,74,121
19561,2023-01-28,BONNIE,gemGrab,Deep Diner,7,9,16
19562,2023-01-28,BONNIE,brawlBall,Super Beach,89,88,177
19563,2023-01-28,BONNIE,brawlBall,Sneaky Fields,0,1,1
19564,2023-01-28,BONNIE,bounty,Canal Grande,7,5,12
19565,2023-01-27,BONNIE,knockout,Flaring Phoenix,24,11,35
19566,2023-01-27,BONNIE,hotZone,Controller Chaos,3,3,6
19567,2023-01-27,BONNIE,heist,Hot Potato,6,1,7
19568,2023-01-27,BONNIE,gemGrab,Undermine,5,2,7
19569,2023-01-27,BONNIE,gemGrab,Deep Diner,14,14,28
19570,2023-01-27,BONNIE,brawlBall,Sneaky Fields,28,35,63
19571,2023-01-27,BONNIE,bounty,Temple Ruins,8,14,22
19572,2023-01-26,BONNIE,knockout,Riverside,123,161,284
19573,2023-01-26,BONNIE,hotZone,Open Zone,41,51,92
19574,2023-01-26,BONNIE,heist,Hot Potato,15,16,31
19575,2023-01-26,BONNIE,gemGrab,Undermine,26,27,53
19576,2023-01-26,BONNIE,gemGrab,Gem Fort,7,6,13
19577,2023-01-26,BONNIE,brawlBall,Sunny Soccer,2,15,17
19578,2023-01-26,BONNIE,brawlBall,Pinhole Punt,166,221,387
19579,2023-01-26,BONNIE,bounty,Temple Ruins,15,13,28
19580,2023-01-25,BONNIE,knockout,Riverside,57,58,115
19581,2023-01-25,BONNIE,hotZone,Open Zone,28,37,65
19582,2023-01-25,BONNIE,heist,Safe Zone,81,111,192
19583,2023-01-25,BONNIE,gemGrab,Gem Fort,8,3,11
19584,2023-01-25,BONNIE,gemGrab,Crystal Arcade,9,17,26
19585,2023-01-25,BONNIE,brawlBall,Sunny Soccer,49,44,93
19586,2023-01-25,BONNIE,brawlBall,Beach Ball,15,6,21
19587,2023-01-25,BONNIE,bounty,Excel,13,52,65
19588,2023-01-24,BONNIE,knockout,New Perspective,59,84,143
19589,2023-01-24,BONNIE,hotZone,Dueling Beetles,10,13,23
19590,2023-01-24,BONNIE,heist,Safe Zone,113,241,354
19591,2023-01-24,BONNIE,gemGrab,Minecart Madness,13,21,34
19592,2023-01-24,BONNIE,gemGrab,Crystal Arcade,25,33,58
19593,2023-01-24,BONNIE,brawlBall,Center Stage,12,15,27
19594,2023-01-24,BONNIE,brawlBall,Beach Ball,113,137,250
19595,2023-01-24,BONNIE,bounty,Excel,17,22,39
19596,2023-01-23,BONNIE,knockout,New Perspective,87,95,182
19597,2023-01-23,BONNIE,hotZone,Dueling Beetles,29,60,89
19598,2023-01-23,BONNIE,heist,Snaked Assault,11,14,25
19599,2023-01-23,BONNIE,gemGrab,Minecart Madness,87,153,240
19600,2023-01-23,BONNIE,gemGrab,Double Swoosh,4,3,7
19601,2023-01-23,BONNIE,brawlBall,Center Stage,78,75,153
19602,2023-01-23,BONNIE,brawlBall,Backyard Bowl,30,31,61
19603,2023-01-23,BONNIE,bounty,Layer Cake,30,34,64
19604,2023-01-22,BONNIE,knockout,X Marks the Spot,35,26,61
19605,2023-01-22,BONNIE,hotZone,Ring of Fire,7,6,13
19606,2023-01-22,BONNIE,heist,Snaked Assault,10,8,18
19607,2023-01-22,BONNIE,gemGrab,Hard Rock Mine,16,5,21
19608,2023-01-22,BONNIE,gemGrab,Double Swoosh,13,8,21
19609,2023-01-22,BONNIE,brawlBall,Super Beach,8,22,30
19610,2023-01-22,BONNIE,brawlBall,Backyard Bowl,126,206,332
19611,2023-01-22,BONNIE,bounty,Layer Cake,14,19,33
19612,2023-01-21,BONNIE,knockout,X Marks the Spot,148,157,305
19613,2023-01-21,BONNIE,hotZone,Ring of Fire,19,18,37
19614,2023-01-21,BONNIE,heist,Tornado Ring,11,7,18
19615,2023-01-21,BONNIE,gemGrab,Hard Rock Mine,48,40,88
19616,2023-01-21,BONNIE,gemGrab,Deep Diner,18,16,34
19617,2023-01-21,BONNIE,brawlBall,Super Beach,127,167,294
19618,2023-01-21,BONNIE,brawlBall,Sneaky Fields,2,17,19
19619,2023-01-21,BONNIE,bounty,Dry Season,37,73,110
19620,2023-01-20,BONNIE,knockout,Out in the Open,101,127,228
19621,2023-01-20,BONNIE,hotZone,Split,1,4,5
19622,2023-01-20,BONNIE,heist,Tornado Ring,16,3,19
19623,2023-01-20,BONNIE,gemGrab,Undermine,17,16,33
19624,2023-01-20,BONNIE,gemGrab,Deep Diner,47,75,122
19625,2023-01-20,BONNIE,brawlBall,Sneaky Fields,64,57,121
19626,2023-01-20,BONNIE,brawlBall,Pinhole Punt,9,5,14
19627,2023-01-20,BONNIE,bounty,Dry Season,44,54,98
19628,2023-01-19,BONNIE,knockout,Out in the Open,148,142,290
19629,2023-01-19,BONNIE,hotZone,Split,10,9,19
19630,2023-01-19,BONNIE,heist,Kaboom Canyon,36,48,84
19631,2023-01-19,BONNIE,gemGrab,Undermine,24,30,54
19632,2023-01-19,BONNIE,gemGrab,Gem Fort,2,1,3
19633,2023-01-19,BONNIE,brawlBall,Sunny Soccer,3,0,3
19634,2023-01-19,BONNIE,brawlBall,Pinhole Punt,134,189,323
19635,2023-01-19,BONNIE,bounty,Shooting Star,35,51,86
19636,2023-01-18,BONNIE,knockout,Goldarm Gulch,15,21,36
19637,2023-01-18,BONNIE,hotZone,Parallel Plays,2,0,2
19638,2023-01-18,BONNIE,heist,Kaboom Canyon,11,30,41
19639,2023-01-18,BONNIE,gemGrab,Gem Fort,1,3,4
19640,2023-01-18,BONNIE,gemGrab,Crystal Arcade,5,3,8
19641,2023-01-18,BONNIE,brawlBall,Sunny Soccer,14,18,32
19642,2023-01-18,BONNIE,brawlBall,Beach Ball,1,3,4
19643,2023-01-18,BONNIE,bounty,Shooting Star,15,16,31
19644,2023-01-17,BONNIE,knockout,Goldarm Gulch,6,7,13
19645,2023-01-17,BONNIE,hotZone,Parallel Plays,1,1,2
19646,2023-01-17,BONNIE,heist,Pit Stop,3,2,5
19647,2023-01-17,BONNIE,gemGrab,Crystal Arcade,5,1,6
19648,2023-01-17,BONNIE,brawlBall,Beach Ball,11,16,27
19649,2023-01-17,BONNIE,bounty,Hideout,2,2,4
19650,2023-01-16,BONNIE,knockout,Belle's Rock,11,3,14
19651,2023-01-16,BONNIE,hotZone,Quarter Pounder,2,0,2
19652,2023-01-16,BONNIE,heist,Pit Stop,2,0,2
19653,2023-01-16,BONNIE,gemGrab,Minecart Madness,1,9,10
19654,2023-01-16,BONNIE,gemGrab,Double Swoosh,1,1,2
19655,2023-01-16,BONNIE,brawlBall,Center Stage,2,2,4
19656,2023-01-16,BONNIE,brawlBall,Backyard Bowl,0,4,4
19657,2023-01-15,BONNIE,knockout,Belle's Rock,30,53,83
19658,2023-01-15,BONNIE,hotZone,Quarter Pounder,5,3,8
19659,2023-01-15,BONNIE,heist,Bridge Too Far,33,42,75
19660,2023-01-15,BONNIE,gemGrab,Double Swoosh,3,4,7
19661,2023-01-15,BONNIE,brawlBall,Super Beach,4,13,17
19662,2023-01-15,BONNIE,brawlBall,Backyard Bowl,40,41,81
19663,2023-01-15,BONNIE,bounty,Canal Grande,2,1,3
19664,2023-01-14,BONNIE,knockout,Flaring Phoenix,3,4,7
19665,2023-01-14,BONNIE,hotZone,Controller Chaos,4,3,7
19666,2023-01-14,BONNIE,heist,Bridge Too Far,56,88,144
19667,2023-01-14,BONNIE,gemGrab,Hard Rock Mine,2,0,2
19668,2023-01-14,BONNIE,gemGrab,Deep Diner,3,4,7
19669,2023-01-14,BONNIE,brawlBall,Super Beach,12,7,19
19670,2023-01-13,BONNIE,knockout,Flaring Phoenix,6,2,8
19671,2023-01-13,BONNIE,hotZone,Controller Chaos,2,1,3
19672,2023-01-13,BONNIE,gemGrab,Deep Diner,1,0,1
19673,2023-01-13,BONNIE,brawlBall,Sneaky Fields,15,14,29
19674,2023-01-13,BONNIE,brawlBall,Pinhole Punt,1,0,1
19675,2023-01-12,BONNIE,knockout,Riverside,28,46,74
19676,2023-01-12,BONNIE,hotZone,Open Zone,8,1,9
19677,2023-01-12,BONNIE,brawlBall,Pinhole Punt,4,4,8
19678,2023-01-11,BONNIE,knockout,Riverside,2,0,2
19679,2023-01-11,BONNIE,hotZone,Open Zone,2,0,2
19680,2023-01-11,BONNIE,gemGrab,Gem Fort,1,0,1
19681,2023-01-11,BONNIE,brawlBall,Sunny Soccer,1,0,1
19682,2023-01-11,BONNIE,bounty,Excel,0,2,2
19683,2023-01-10,BONNIE,knockout,New Perspective,2,2,4
19684,2023-01-10,BONNIE,hotZone,Dueling Beetles,2,1,3
19685,2023-01-10,BONNIE,heist,Safe Zone,9,53,62
19686,2023-01-10,BONNIE,gemGrab,Minecart Madness,1,1,2
19687,2023-01-10,BONNIE,gemGrab,Crystal Arcade,3,2,5
19688,2023-01-10,BONNIE,brawlBall,Beach Ball,3,3,6
19689,2023-01-09,BONNIE,knockout,New Perspective,3,9,12
19690,2023-01-09,BONNIE,hotZone,Dueling Beetles,2,7,9
19691,2023-01-09,BONNIE,gemGrab,Minecart Madness,2,23,25
19692,2023-01-09,BONNIE,gemGrab,Double Swoosh,5,4,9
19693,2023-01-09,BONNIE,brawlBall,Center Stage,4,2,6
19694,2023-01-09,BONNIE,brawlBall,Backyard Bowl,1,0,1
19695,2023-01-09,BONNIE,bounty,Layer Cake,4,0,4
19696,2023-01-08,BONNIE,knockout,X Marks the Spot,7,7,14
19697,2023-01-08,BONNIE,hotZone,Ring of Fire,2,3,5
19698,2023-01-08,BONNIE,heist,Snaked Assault,6,2,8
19699,2023-01-08,BONNIE,gemGrab,Double Swoosh,1,0,1
19700,2023-01-08,BONNIE,brawlBall,Super Beach,0,2,2
19701,2023-01-08,BONNIE,brawlBall,Backyard Bowl,19,28,47
19702,2023-01-08,BONNIE,bounty,Layer Cake,7,1,8
19703,2023-01-07,BONNIE,knockout,X Marks the Spot,4,7,11
19704,2023-01-07,BONNIE,hotZone,Ring of Fire,0,1,1
19705,2023-01-07,BONNIE,heist,Tornado Ring,0,2,2
19706,2023-01-07,BONNIE,gemGrab,Hard Rock Mine,1,0,1
19707,2023-01-07,BONNIE,brawlBall,Super Beach,3,4,7
19708,2023-01-07,BONNIE,bounty,Dry Season,2,7,9
19709,2023-01-06,BONNIE,knockout,Out in the Open,4,0,4
19710,2023-01-06,BONNIE,hotZone,Split,1,0,1
19711,2023-01-06,BONNIE,heist,Tornado Ring,3,2,5
19712,2023-01-06,BONNIE,gemGrab,Undermine,1,6,7
19713,2023-01-06,BONNIE,gemGrab,Deep Diner,2,0,2
19714,2023-01-06,BONNIE,brawlBall,Sneaky Fields,4,8,12
19715,2023-01-06,BONNIE,brawlBall,Pinhole Punt,3,4,7
19716,2023-01-06,BONNIE,bounty,Dry Season,3,7,10
19717,2023-01-05,BONNIE,knockout,Out in the Open,18,27,45
19718,2023-01-05,BONNIE,hotZone,Split,2,0,2
19719,2023-01-05,BONNIE,heist,Kaboom Canyon,6,5,11
19720,2023-01-05,BONNIE,gemGrab,Undermine,0,2,2
19721,2023-01-05,BONNIE,gemGrab,Gem Fort,1,0,1
19722,2023-01-05,BONNIE,brawlBall,Pinhole Punt,16,28,44
19723,2023-01-05,BONNIE,bounty,Shooting Star,5,4,9
19724,2023-01-04,BONNIE,knockout,Goldarm Gulch,4,3,7
19725,2023-01-04,BONNIE,hotZone,Parallel Plays,1,0,1
19726,2023-01-04,BONNIE,heist,Kaboom Canyon,6,5,11
19727,2023-01-04,BONNIE,gemGrab,Gem Fort,1,0,1
19728,2023-01-04,BONNIE,gemGrab,Crystal Arcade,1,0,1
19729,2023-01-04,BONNIE,brawlBall,Sunny Soccer,0,4,4
19730,2023-01-04,BONNIE,bounty,Shooting Star,13,9,22
19731,2023-01-03,BONNIE,knockout,Goldarm Gulch,1,1,2
19732,2023-01-03,BONNIE,hotZone,Parallel Plays,3,0,3
19733,2023-01-03,BONNIE,gemGrab,Minecart Madness,1,0,1
19734,2023-01-03,BONNIE,gemGrab,Crystal Arcade,6,6,12
19735,2023-01-03,BONNIE,brawlBall,Beach Ball,6,12,18
19736,2023-01-03,BONNIE,bounty,Hideout,9,29,38
19737,2023-01-02,BONNIE,knockout,Belle's Rock,17,34,51
19738,2023-01-02,BONNIE,hotZone,Quarter Pounder,6,0,6
19739,2023-01-02,BONNIE,heist,Pit Stop,3,1,4
19740,2023-01-02,BONNIE,gemGrab,Minecart Madness,12,35,47
19741,2023-01-02,BONNIE,gemGrab,Double Swoosh,1,0,1
19742,2023-01-02,BONNIE,brawlBall,Center Stage,6,2,8
19743,2023-01-02,BONNIE,brawlBall,Backyard Bowl,7,13,20
19744,2023-01-02,BONNIE,bounty,Hideout,11,23,34
19745,2023-01-01,BONNIE,knockout,Belle's Rock,4,5,9
19746,2023-01-01,BONNIE,hotZone,Quarter Pounder,1,0,1
19747,2023-01-01,BONNIE,heist,Bridge Too Far,3,9,12
19748,2023-01-01,BONNIE,gemGrab,Hard Rock Mine,0,1,1
19749,2023-01-01,BONNIE,brawlBall,Backyard Bowl,11,8,19
19750,2022-12-31,BONNIE,hotZone,Controller Chaos,2,0,2
19751,2022-12-31,BONNIE,heist,Bridge Too Far,2,6,8
19752,2022-12-31,BONNIE,gemGrab,Hard Rock Mine,1,4,5
19753,2022-12-31,BONNIE,brawlBall,Super Beach,2,0,2
19754,2022-12-30,BONNIE,gemGrab,Minecart Madness,1,0,1
19755,2022-12-30,BONNIE,brawlBall,Sneaky Fields,2,0,2
19756,2022-12-29,BONNIE,gemGrab,Minecart Madness,1,1,2
19757,2022-12-26,BONNIE,heist,Kaboom Canyon,0,2,2
19758,2022-12-26,BONNIE,gemGrab,Minecart Madness,1,0,1
19759,2022-12-25,BONNIE,brawlBall,Backyard Bowl,1,0,1
19760,2022-12-24,BONNIE,knockout,X Marks the Spot,1,1,2
19761,2022-12-24,BONNIE,brawlBall,Super Beach,0,1,1
19762,2022-12-23,BONNIE,knockout,Out in the Open,0,2,2
19763,2022-12-19,BONNIE,gemGrab,Minecart Madness,2,2,4
19764,2022-12-19,BONNIE,brawlBall,Center Stage,0,1,1
19765,2022-12-13,BONNIE,brawlBall,Beach Ball,1,0,1
19766,2022-12-11,BONNIE,brawlBall,Backyard Bowl,2,0,2
19767,2022-11-03,BONNIE,brawlBall,Pinhole Punt,2,2,4
19768,2022-10-15,BONNIE,hotZone,Ring of Fire,0,1,1
19769,2022-10-15,BONNIE,bounty,Dry Season,2,0,2
19770,2022-10-10,BONNIE,knockout,Belle's Rock,0,3,3
19771,2023-02-11,BO,knockout,Flaring Phoenix,591,822,1413
19772,2023-02-11,BO,hotZone,Controller Chaos,154,67,221
19773,2023-02-11,BO,gemGrab,Deep Diner,149,108,257
19774,2023-02-11,BO,brawlBall,Super Beach,59,41,100
19775,2023-02-11,BO,brawlBall,Sneaky Fields,26,30,56
19776,2023-02-10,BO,knockout,Flaring Phoenix,1639,1992,3631
19777,2023-02-10,BO,hotZone,Controller Chaos,163,83,246
19778,2023-02-10,BO,heist,Hot Potato,39,13,52
19779,2023-02-10,BO,gemGrab,Undermine,56,54,110
19780,2023-02-10,BO,gemGrab,Deep Diner,322,241,563
19781,2023-02-10,BO,brawlBall,Sneaky Fields,297,257,554
19782,2023-02-10,BO,brawlBall,Pinhole Punt,8,8,16
19783,2023-02-10,BO,bounty,Temple Ruins,97,79,176
19784,2023-02-09,BO,knockout,Riverside,27,13,40
19785,2023-02-09,BO,hotZone,Open Zone,35,29,64
19786,2023-02-09,BO,heist,Hot Potato,13,4,17
19787,2023-02-09,BO,gemGrab,Undermine,65,62,127
19788,2023-02-09,BO,gemGrab,Gem Fort,14,8,22
19789,2023-02-09,BO,brawlBall,Sunny Soccer,3,0,3
19790,2023-02-09,BO,brawlBall,Pinhole Punt,104,83,187
19791,2023-02-09,BO,bounty,Temple Ruins,49,42,91
19792,2023-02-08,BO,knockout,Riverside,17,10,27
19793,2023-02-08,BO,hotZone,Open Zone,32,16,48
19794,2023-02-08,BO,heist,Safe Zone,10,11,21
19795,2023-02-08,BO,gemGrab,Gem Fort,17,24,41
19796,2023-02-08,BO,gemGrab,Crystal Arcade,12,7,19
19797,2023-02-08,BO,brawlBall,Sunny Soccer,23,13,36
19798,2023-02-08,BO,brawlBall,Beach Ball,1,0,1
19799,2023-02-08,BO,bounty,Excel,8,13,21
19800,2023-02-07,BO,knockout,New Perspective,57,93,150
19801,2023-02-07,BO,hotZone,Dueling Beetles,45,19,64
19802,2023-02-07,BO,heist,Safe Zone,4,3,7
19803,2023-02-07,BO,gemGrab,Minecart Madness,31,8,39
19804,2023-02-07,BO,gemGrab,Crystal Arcade,11,4,15
19805,2023-02-07,BO,brawlBall,Center Stage,1,0,1
19806,2023-02-07,BO,brawlBall,Beach Ball,14,18,32
19807,2023-02-07,BO,bounty,Excel,9,21,30
19808,2023-02-06,BO,knockout,New Perspective,1457,1849,3306
19809,2023-02-06,BO,knockout,Goldarm Gulch,77,89,166
19810,2023-02-06,BO,hotZone,Dueling Beetles,493,289,782
19811,2023-02-06,BO,heist,Snaked Assault,54,25,79
19812,2023-02-06,BO,heist,Pit Stop,2,1,3
19813,2023-02-06,BO,gemGrab,Minecart Madness,660,469,1129
19814,2023-02-06,BO,gemGrab,Double Swoosh,359,325,684
19815,2023-02-06,BO,brawlBall,Sneaky Fields,33,15,48
19816,2023-02-06,BO,brawlBall,Center Stage,396,370,766
19817,2023-02-06,BO,brawlBall,Backyard Bowl,57,54,111
19818,2023-02-06,BO,bounty,Layer Cake,120,99,219
19819,2023-02-05,BO,knockout,X Marks the Spot,535,669,1204
19820,2023-02-05,BO,knockout,Goldarm Gulch,292,372,664
19821,2023-02-05,BO,hotZone,Ring of Fire,402,241,643
19822,2023-02-05,BO,heist,Snaked Assault,64,31,95
19823,2023-02-05,BO,heist,Pit Stop,12,13,25
19824,2023-02-05,BO,gemGrab,Hard Rock Mine,79,66,145
19825,2023-02-05,BO,gemGrab,Double Swoosh,942,954,1896
19826,2023-02-05,BO,brawlBall,Super Beach,3,10,13
19827,2023-02-05,BO,brawlBall,Sneaky Fields,67,44,111
19828,2023-02-05,BO,brawlBall,Backyard Bowl,574,566,1140
19829,2023-02-05,BO,bounty,Layer Cake,159,140,299
19830,2023-02-04,BO,knockout,X Marks the Spot,209,232,441
19831,2023-02-04,BO,knockout,Goldarm Gulch,198,242,440
19832,2023-02-04,BO,hotZone,Ring of Fire,97,81,178
19833,2023-02-04,BO,heist,Tornado Ring,6,5,11
19834,2023-02-04,BO,heist,Pit Stop,3,1,4
19835,2023-02-04,BO,gemGrab,Hard Rock Mine,81,66,147
19836,2023-02-04,BO,gemGrab,Double Swoosh,156,178,334
19837,2023-02-04,BO,gemGrab,Deep Diner,34,23,57
19838,2023-02-04,BO,brawlBall,Super Beach,82,48,130
19839,2023-02-04,BO,brawlBall,Sneaky Fields,42,34,76
19840,2023-02-04,BO,bounty,Dry Season,28,21,49
19841,2023-02-03,BO,knockout,Out in the Open,488,662,1150
19842,2023-02-03,BO,knockout,Goldarm Gulch,792,1076,1868
19843,2023-02-03,BO,hotZone,Split,59,23,82
19844,2023-02-03,BO,heist,Tornado Ring,52,20,72
19845,2023-02-03,BO,heist,Pit Stop,27,7,34
19846,2023-02-03,BO,gemGrab,Undermine,65,66,131
19847,2023-02-03,BO,gemGrab,Double Swoosh,757,707,1464
19848,2023-02-03,BO,gemGrab,Deep Diner,330,230,560
19849,2023-02-03,BO,brawlBall,Sneaky Fields,564,482,1046
19850,2023-02-03,BO,brawlBall,Pinhole Punt,13,18,31
19851,2023-02-03,BO,bounty,Dry Season,172,134,306
19852,2023-02-02,BO,knockout,Out in the Open,282,365,647
19853,2023-02-02,BO,hotZone,Split,22,16,38
19854,2023-02-02,BO,heist,Kaboom Canyon,9,11,20
19855,2023-02-02,BO,gemGrab,Undermine,50,53,103
19856,2023-02-02,BO,gemGrab,Gem Fort,12,16,28
19857,2023-02-02,BO,brawlBall,Sunny Soccer,3,1,4
19858,2023-02-02,BO,brawlBall,Pinhole Punt,112,93,205
19859,2023-02-02,BO,bounty,Shooting Star,27,13,40
19860,2023-02-01,BO,knockout,Goldarm Gulch,707,999,1706
19861,2023-02-01,BO,hotZone,Parallel Plays,134,51,185
19862,2023-02-01,BO,heist,Kaboom Canyon,35,23,58
19863,2023-02-01,BO,gemGrab,Gem Fort,199,183,382
19864,2023-02-01,BO,gemGrab,Crystal Arcade,143,129,272
19865,2023-02-01,BO,brawlBall,Sunny Soccer,190,202,392
19866,2023-02-01,BO,brawlBall,Beach Ball,8,7,15
19867,2023-02-01,BO,bounty,Shooting Star,67,37,104
19868,2023-01-31,BO,knockout,Goldarm Gulch,450,587,1037
19869,2023-01-31,BO,hotZone,Parallel Plays,47,39,86
19870,2023-01-31,BO,heist,Pit Stop,6,4,10
19871,2023-01-31,BO,gemGrab,Minecart Madness,41,34,75
19872,2023-01-31,BO,gemGrab,Crystal Arcade,130,68,198
19873,2023-01-31,BO,brawlBall,Center Stage,8,5,13
19874,2023-01-31,BO,brawlBall,Beach Ball,106,93,199
19875,2023-01-31,BO,bounty,Hideout,25,21,46
19876,2023-01-30,BO,knockout,Belle's Rock,282,347,629
19877,2023-01-30,BO,hotZone,Quarter Pounder,281,163,444
19878,2023-01-30,BO,heist,Pit Stop,19,22,41
19879,2023-01-30,BO,gemGrab,Minecart Madness,381,272,653
19880,2023-01-30,BO,gemGrab,Double Swoosh,239,214,453
19881,2023-01-30,BO,brawlBall,Center Stage,256,236,492
19882,2023-01-30,BO,brawlBall,Backyard Bowl,45,30,75
19883,2023-01-30,BO,bounty,Hideout,49,41,90
19884,2023-01-29,BO,knockout,Belle's Rock,566,687,1253
19885,2023-01-29,BO,hotZone,Quarter Pounder,253,139,392
19886,2023-01-29,BO,heist,Bridge Too Far,76,61,137
19887,2023-01-29,BO,gemGrab,Hard Rock Mine,33,42,75
19888,2023-01-29,BO,gemGrab,Double Swoosh,369,373,742
19889,2023-01-29,BO,brawlBall,Super Beach,5,7,12
19890,2023-01-29,BO,brawlBall,Backyard Bowl,483,444,927
19891,2023-01-29,BO,bounty,Canal Grande,55,39,94
19892,2023-01-28,BO,knockout,Flaring Phoenix,691,948,1639
19893,2023-01-28,BO,hotZone,Controller Chaos,122,34,156
19894,2023-01-28,BO,heist,Bridge Too Far,157,100,257
19895,2023-01-28,BO,gemGrab,Hard Rock Mine,267,208,475
19896,2023-01-28,BO,gemGrab,Deep Diner,111,71,182
19897,2023-01-28,BO,brawlBall,Super Beach,287,210,497
19898,2023-01-28,BO,brawlBall,Sneaky Fields,13,13,26
19899,2023-01-28,BO,bounty,Canal Grande,111,65,176
19900,2023-01-27,BO,knockout,Flaring Phoenix,382,470,852
19901,2023-01-27,BO,hotZone,Controller Chaos,37,35,72
19902,2023-01-27,BO,heist,Hot Potato,14,13,27
19903,2023-01-27,BO,gemGrab,Undermine,21,11,32
19904,2023-01-27,BO,gemGrab,Deep Diner,127,89,216
19905,2023-01-27,BO,brawlBall,Sneaky Fields,105,100,205
19906,2023-01-27,BO,brawlBall,Pinhole Punt,6,9,15
19907,2023-01-27,BO,bounty,Temple Ruins,24,12,36
19908,2023-01-26,BO,knockout,Riverside,128,81,209
19909,2023-01-26,BO,hotZone,Open Zone,282,183,465
19910,2023-01-26,BO,heist,Hot Potato,47,18,65
19911,2023-01-26,BO,gemGrab,Undermine,146,138,284
19912,2023-01-26,BO,gemGrab,Gem Fort,103,77,180
19913,2023-01-26,BO,brawlBall,Sunny Soccer,7,9,16
19914,2023-01-26,BO,brawlBall,Pinhole Punt,335,316,651
19915,2023-01-26,BO,bounty,Temple Ruins,77,61,138
19916,2023-01-25,BO,knockout,Riverside,63,46,109
19917,2023-01-25,BO,hotZone,Open Zone,137,95,232
19918,2023-01-25,BO,heist,Safe Zone,85,37,122
19919,2023-01-25,BO,gemGrab,Gem Fort,102,99,201
19920,2023-01-25,BO,gemGrab,Crystal Arcade,121,79,200
19921,2023-01-25,BO,brawlBall,Sunny Soccer,175,136,311
19922,2023-01-25,BO,brawlBall,Beach Ball,24,24,48
19923,2023-01-25,BO,bounty,Excel,39,21,60
19924,2023-01-24,BO,knockout,New Perspective,305,427,732
19925,2023-01-24,BO,hotZone,Dueling Beetles,274,161,435
19926,2023-01-24,BO,heist,Safe Zone,141,82,223
19927,2023-01-24,BO,gemGrab,Minecart Madness,143,95,238
19928,2023-01-24,BO,gemGrab,Crystal Arcade,300,259,559
19929,2023-01-24,BO,brawlBall,Center Stage,58,33,91
19930,2023-01-24,BO,brawlBall,Beach Ball,226,185,411
19931,2023-01-24,BO,bounty,Excel,78,75,153
19932,2023-01-23,BO,knockout,New Perspective,1138,1512,2650
19933,2023-01-23,BO,hotZone,Dueling Beetles,372,248,620
19934,2023-01-23,BO,heist,Snaked Assault,47,23,70
19935,2023-01-23,BO,gemGrab,Minecart Madness,610,516,1126
19936,2023-01-23,BO,gemGrab,Double Swoosh,190,239,429
19937,2023-01-23,BO,brawlBall,Center Stage,427,297,724
19938,2023-01-23,BO,brawlBall,Backyard Bowl,22,48,70
19939,2023-01-23,BO,bounty,Layer Cake,121,104,225
19940,2023-01-22,BO,knockout,X Marks the Spot,382,472,854
19941,2023-01-22,BO,hotZone,Ring of Fire,239,158,397
19942,2023-01-22,BO,heist,Snaked Assault,22,13,35
19943,2023-01-22,BO,gemGrab,Hard Rock Mine,81,70,151
19944,2023-01-22,BO,gemGrab,Double Swoosh,232,226,458
19945,2023-01-22,BO,brawlBall,Super Beach,35,27,62
19946,2023-01-22,BO,brawlBall,Backyard Bowl,220,188,408
19947,2023-01-22,BO,bounty,Layer Cake,80,90,170
19948,2023-01-21,BO,knockout,X Marks the Spot,1365,1679,3044
19949,2023-01-21,BO,hotZone,Ring of Fire,531,450,981
19950,2023-01-21,BO,heist,Tornado Ring,44,17,61
19951,2023-01-21,BO,gemGrab,Hard Rock Mine,394,298,692
19952,2023-01-21,BO,gemGrab,Deep Diner,105,87,192
19953,2023-01-21,BO,brawlBall,Super Beach,396,323,719
19954,2023-01-21,BO,brawlBall,Sneaky Fields,10,16,26
19955,2023-01-21,BO,bounty,Dry Season,166,106,272
19956,2023-01-20,BO,knockout,Out in the Open,588,811,1399
19957,2023-01-20,BO,hotZone,Split,78,32,110
19958,2023-01-20,BO,heist,Tornado Ring,47,26,73
19959,2023-01-20,BO,gemGrab,Undermine,107,116,223
19960,2023-01-20,BO,gemGrab,Deep Diner,356,276,632
19961,2023-01-20,BO,brawlBall,Sneaky Fields,235,198,433
19962,2023-01-20,BO,brawlBall,Pinhole Punt,21,21,42
19963,2023-01-20,BO,bounty,Dry Season,109,62,171
19964,2023-01-19,BO,knockout,Out in the Open,1220,1530,2750
19965,2023-01-19,BO,hotZone,Split,79,25,104
19966,2023-01-19,BO,heist,Kaboom Canyon,57,28,85
19967,2023-01-19,BO,gemGrab,Undermine,275,216,491
19968,2023-01-19,BO,gemGrab,Gem Fort,54,59,113
19969,2023-01-19,BO,brawlBall,Sunny Soccer,5,6,11
19970,2023-01-19,BO,brawlBall,Pinhole Punt,366,346,712
19971,2023-01-19,BO,bounty,Shooting Star,103,69,172
19972,2023-01-18,BO,knockout,Goldarm Gulch,100,132,232
19973,2023-01-18,BO,hotZone,Parallel Plays,22,24,46
19974,2023-01-18,BO,heist,Kaboom Canyon,22,4,26
19975,2023-01-18,BO,gemGrab,Gem Fort,43,40,83
19976,2023-01-18,BO,gemGrab,Crystal Arcade,19,11,30
19977,2023-01-18,BO,brawlBall,Sunny Soccer,55,49,104
19978,2023-01-18,BO,brawlBall,Beach Ball,4,7,11
19979,2023-01-18,BO,bounty,Shooting Star,34,33,67
19980,2023-01-17,BO,knockout,Goldarm Gulch,96,127,223
19981,2023-01-17,BO,hotZone,Parallel Plays,9,4,13
19982,2023-01-17,BO,heist,Pit Stop,6,0,6
19983,2023-01-17,BO,gemGrab,Minecart Madness,3,3,6
19984,2023-01-17,BO,gemGrab,Crystal Arcade,27,28,55
19985,2023-01-17,BO,brawlBall,Center Stage,4,1,5
19986,2023-01-17,BO,brawlBall,Beach Ball,13,13,26
19987,2023-01-17,BO,bounty,Hideout,3,0,3
19988,2023-01-16,BO,knockout,Belle's Rock,23,55,78
19989,2023-01-16,BO,hotZone,Quarter Pounder,48,32,80
19990,2023-01-16,BO,heist,Pit Stop,4,0,4
19991,2023-01-16,BO,gemGrab,Minecart Madness,41,27,68
19992,2023-01-16,BO,gemGrab,Double Swoosh,24,16,40
19993,2023-01-16,BO,brawlBall,Center Stage,17,20,37
19994,2023-01-16,BO,brawlBall,Backyard Bowl,5,3,8
19995,2023-01-16,BO,bounty,Hideout,15,8,23
19996,2023-01-15,BO,knockout,Belle's Rock,71,66,137
19997,2023-01-15,BO,hotZone,Quarter Pounder,56,25,81
19998,2023-01-15,BO,heist,Bridge Too Far,20,6,26
19999,2023-01-15,BO,gemGrab,Hard Rock Mine,13,10,23
20000,2023-01-15,BO,gemGrab,Double Swoosh,49,46,95
20001,2023-01-15,BO,brawlBall,Super Beach,10,25,35
20002,2023-01-15,BO,brawlBall,Backyard Bowl,61,59,120
20003,2023-01-15,BO,bounty,Canal Grande,10,10,20
20004,2023-01-14,BO,knockout,Flaring Phoenix,58,101,159
20005,2023-01-14,BO,hotZone,Controller Chaos,28,3,31
20006,2023-01-14,BO,heist,Bridge Too Far,25,24,49
20007,2023-01-14,BO,gemGrab,Hard Rock Mine,22,9,31
20008,2023-01-14,BO,gemGrab,Deep Diner,16,3,19
20009,2023-01-14,BO,brawlBall,Super Beach,22,31,53
20010,2023-01-14,BO,brawlBall,Sneaky Fields,3,0,3
20011,2023-01-14,BO,bounty,Canal Grande,12,9,21
20012,2023-01-13,BO,knockout,Flaring Phoenix,68,76,144
20013,2023-01-13,BO,hotZone,Controller Chaos,23,3,26
20014,2023-01-13,BO,heist,Hot Potato,4,1,5
20015,2023-01-13,BO,gemGrab,Deep Diner,32,18,50
20016,2023-01-13,BO,brawlBall,Sneaky Fields,29,21,50
20017,2023-01-13,BO,bounty,Temple Ruins,5,2,7
20018,2023-01-12,BO,knockout,Riverside,12,5,17
20019,2023-01-12,BO,hotZone,Open Zone,46,9,55
20020,2023-01-12,BO,heist,Hot Potato,3,0,3
20021,2023-01-12,BO,gemGrab,Undermine,12,2,14
20022,2023-01-12,BO,gemGrab,Gem Fort,3,1,4
20023,2023-01-12,BO,brawlBall,Pinhole Punt,13,3,16
20024,2023-01-12,BO,bounty,Temple Ruins,1,0,1
20025,2023-01-11,BO,knockout,Riverside,1,0,1
20026,2023-01-11,BO,hotZone,Open Zone,13,17,30
20027,2023-01-11,BO,heist,Safe Zone,1,2,3
20028,2023-01-11,BO,gemGrab,Gem Fort,10,22,32
20029,2023-01-11,BO,brawlBall,Sunny Soccer,7,3,10
20030,2023-01-11,BO,brawlBall,Beach Ball,0,1,1
20031,2023-01-11,BO,bounty,Excel,2,0,2
20032,2023-01-10,BO,knockout,New Perspective,15,35,50
20033,2023-01-10,BO,hotZone,Dueling Beetles,59,29,88
20034,2023-01-10,BO,heist,Safe Zone,13,25,38
20035,2023-01-10,BO,gemGrab,Minecart Madness,35,7,42
20036,2023-01-10,BO,gemGrab,Crystal Arcade,25,12,37
20037,2023-01-10,BO,brawlBall,Center Stage,1,0,1
20038,2023-01-10,BO,brawlBall,Beach Ball,17,2,19
20039,2023-01-10,BO,bounty,Excel,7,1,8
20040,2023-01-09,BO,knockout,New Perspective,64,81,145
20041,2023-01-09,BO,hotZone,Dueling Beetles,40,31,71
20042,2023-01-09,BO,heist,Snaked Assault,10,0,10
20043,2023-01-09,BO,gemGrab,Minecart Madness,69,44,113
20044,2023-01-09,BO,gemGrab,Double Swoosh,30,26,56
20045,2023-01-09,BO,brawlBall,Center Stage,12,11,23
20046,2023-01-09,BO,brawlBall,Backyard Bowl,1,0,1
20047,2023-01-09,BO,bounty,Layer Cake,19,22,41
20048,2023-01-08,BO,knockout,X Marks the Spot,59,99,158
20049,2023-01-08,BO,hotZone,Ring of Fire,63,45,108
20050,2023-01-08,BO,heist,Snaked Assault,4,0,4
20051,2023-01-08,BO,gemGrab,Hard Rock Mine,5,5,10
20052,2023-01-08,BO,gemGrab,Double Swoosh,16,7,23
20053,2023-01-08,BO,brawlBall,Super Beach,4,0,4
20054,2023-01-08,BO,brawlBall,Backyard Bowl,30,38,68
20055,2023-01-08,BO,bounty,Layer Cake,6,5,11
20056,2023-01-07,BO,knockout,X Marks the Spot,43,42,85
20057,2023-01-07,BO,hotZone,Ring of Fire,36,27,63
20058,2023-01-07,BO,heist,Tornado Ring,8,8,16
20059,2023-01-07,BO,gemGrab,Hard Rock Mine,14,24,38
20060,2023-01-07,BO,gemGrab,Deep Diner,20,24,44
20061,2023-01-07,BO,brawlBall,Super Beach,10,11,21
20062,2023-01-07,BO,brawlBall,Sneaky Fields,1,0,1
20063,2023-01-07,BO,bounty,Dry Season,16,7,23
20064,2023-01-06,BO,knockout,Out in the Open,72,120,192
20065,2023-01-06,BO,hotZone,Split,5,1,6
20066,2023-01-06,BO,heist,Tornado Ring,6,3,9
20067,2023-01-06,BO,gemGrab,Undermine,20,18,38
20068,2023-01-06,BO,gemGrab,Deep Diner,45,29,74
20069,2023-01-06,BO,brawlBall,Sneaky Fields,13,6,19
20070,2023-01-06,BO,brawlBall,Pinhole Punt,4,3,7
20071,2023-01-06,BO,bounty,Dry Season,12,11,23
20072,2023-01-05,BO,knockout,Out in the Open,134,159,293
20073,2023-01-05,BO,hotZone,Split,15,0,15
20074,2023-01-05,BO,heist,Kaboom Canyon,10,0,10
20075,2023-01-05,BO,gemGrab,Undermine,47,59,106
20076,2023-01-05,BO,gemGrab,Gem Fort,2,0,2
20077,2023-01-05,BO,brawlBall,Pinhole Punt,52,66,118
20078,2023-01-05,BO,bounty,Shooting Star,8,2,10
20079,2023-01-04,BO,knockout,Goldarm Gulch,26,40,66
20080,2023-01-04,BO,hotZone,Parallel Plays,12,2,14
20081,2023-01-04,BO,heist,Kaboom Canyon,15,1,16
20082,2023-01-04,BO,gemGrab,Gem Fort,23,10,33
20083,2023-01-04,BO,gemGrab,Crystal Arcade,11,11,22
20084,2023-01-04,BO,brawlBall,Sunny Soccer,6,4,10
20085,2023-01-04,BO,bounty,Shooting Star,17,2,19
20086,2023-01-03,BO,knockout,Goldarm Gulch,25,36,61
20087,2023-01-03,BO,hotZone,Parallel Plays,9,0,9
20088,2023-01-03,BO,hotZone,Controller Chaos,1,0,1
20089,2023-01-03,BO,heist,Pit Stop,5,0,5
20090,2023-01-03,BO,gemGrab,Minecart Madness,18,5,23
20091,2023-01-03,BO,gemGrab,Crystal Arcade,34,8,42
20092,2023-01-03,BO,brawlBall,Beach Ball,21,20,41
20093,2023-01-03,BO,bounty,Hideout,7,0,7
20094,2023-01-02,BO,knockout,Belle's Rock,25,29,54
20095,2023-01-02,BO,hotZone,Quarter Pounder,51,8,59
20096,2023-01-02,BO,hotZone,Controller Chaos,3,0,3
20097,2023-01-02,BO,heist,Pit Stop,1,1,2
20098,2023-01-02,BO,heist,Kaboom Canyon,1,0,1
20099,2023-01-02,BO,gemGrab,Minecart Madness,67,77,144
20100,2023-01-02,BO,gemGrab,Double Swoosh,45,36,81
20101,2023-01-02,BO,brawlBall,Center Stage,20,10,30
20102,2023-01-02,BO,brawlBall,Backyard Bowl,3,0,3
20103,2023-01-02,BO,bounty,Hideout,22,8,30
20104,2023-01-01,BO,knockout,Belle's Rock,9,21,30
20105,2023-01-01,BO,hotZone,Quarter Pounder,14,1,15
20106,2023-01-01,BO,heist,Bridge Too Far,1,0,1
20107,2023-01-01,BO,gemGrab,Hard Rock Mine,0,1,1
20108,2023-01-01,BO,gemGrab,Double Swoosh,14,15,29
20109,2023-01-01,BO,brawlBall,Backyard Bowl,18,15,33
20110,2022-12-31,BO,knockout,Flaring Phoenix,2,2,4
20111,2022-12-31,BO,hotZone,Controller Chaos,2,1,3
20112,2022-12-31,BO,heist,Bridge Too Far,3,1,4
20113,2022-12-31,BO,gemGrab,Minecart Madness,2,0,2
20114,2022-12-31,BO,gemGrab,Hard Rock Mine,7,2,9
20115,2022-12-31,BO,gemGrab,Deep Diner,10,0,10
20116,2022-12-31,BO,brawlBall,Super Beach,0,1,1
20117,2022-12-31,BO,brawlBall,Sneaky Fields,1,0,1
20118,2022-12-30,BO,knockout,Flaring Phoenix,3,4,7
20119,2022-12-30,BO,hotZone,Controller Chaos,3,1,4
20120,2022-12-30,BO,gemGrab,Undermine,2,0,2
20121,2022-12-30,BO,gemGrab,Minecart Madness,0,2,2
20122,2022-12-30,BO,gemGrab,Deep Diner,5,2,7
20123,2022-12-30,BO,brawlBall,Sneaky Fields,2,1,3
20124,2022-12-29,BO,hotZone,Open Zone,5,2,7
20125,2022-12-29,BO,heist,Hot Potato,1,0,1
20126,2022-12-29,BO,gemGrab,Undermine,2,1,3
20127,2022-12-29,BO,gemGrab,Minecart Madness,1,0,1
20128,2022-12-29,BO,gemGrab,Gem Fort,2,2,4
20129,2022-12-29,BO,brawlBall,Pinhole Punt,4,11,15
20130,2022-12-28,BO,hotZone,Open Zone,1,0,1
20131,2022-12-28,BO,hotZone,Controller Chaos,2,0,2
20132,2022-12-28,BO,heist,Kaboom Canyon,0,2,2
20133,2022-12-28,BO,gemGrab,Minecart Madness,2,0,2
20134,2022-12-28,BO,gemGrab,Crystal Arcade,0,2,2
20135,2022-12-28,BO,brawlBall,Sunny Soccer,0,1,1
20136,2022-12-28,BO,brawlBall,Beach Ball,2,6,8
20137,2022-12-27,BO,knockout,New Perspective,4,6,10
20138,2022-12-27,BO,hotZone,Dueling Beetles,0,1,1
20139,2022-12-27,BO,hotZone,Controller Chaos,1,0,1
20140,2022-12-27,BO,heist,Safe Zone,0,2,2
20141,2022-12-27,BO,heist,Kaboom Canyon,1,0,1
20142,2022-12-27,BO,gemGrab,Minecart Madness,0,2,2
20143,2022-12-27,BO,bounty,Excel,0,1,1
20144,2022-12-26,BO,heist,Kaboom Canyon,2,0,2
20145,2022-12-25,BO,gemGrab,Double Swoosh,1,0,1
20146,2022-12-25,BO,brawlBall,Backyard Bowl,1,0,1
20147,2022-12-24,BO,bounty,Dry Season,1,0,1
20148,2022-12-23,BO,knockout,Out in the Open,0,2,2
20149,2022-12-22,BO,gemGrab,Gem Fort,1,1,2
20150,2022-12-20,BO,brawlBall,Beach Ball,1,0,1
20151,2022-12-19,BO,gemGrab,Minecart Madness,2,0,2
20152,2022-12-17,BO,knockout,Flaring Phoenix,2,4,6
20153,2022-12-16,BO,bounty,Temple Ruins,1,0,1
20154,2022-12-13,BO,knockout,New Perspective,2,1,3
20155,2022-12-13,BO,gemGrab,Crystal Arcade,4,2,6
20156,2022-12-12,BO,brawlBall,Center Stage,0,2,2
20157,2022-12-10,BO,gemGrab,Hard Rock Mine,0,1,1
20158,2022-10-28,BO,bounty,Canal Grande,2,0,2
20159,2022-10-26,BO,bounty,Shooting Star,1,0,1
20160,2022-10-15,BO,gemGrab,Hard Rock Mine,1,2,3
20161,2023-02-11,BIBI,knockout,Flaring Phoenix,25,9,34
20162,2023-02-11,BIBI,hotZone,Controller Chaos,150,138,288
20163,2023-02-11,BIBI,gemGrab,Deep Diner,28,37,65
20164,2023-02-11,BIBI,brawlBall,Super Beach,296,324,620
20165,2023-02-11,BIBI,brawlBall,Sneaky Fields,192,149,341
20166,2023-02-10,BIBI,knockout,Flaring Phoenix,36,28,64
20167,2023-02-10,BIBI,hotZone,Controller Chaos,158,97,255
20168,2023-02-10,BIBI,heist,Hot Potato,297,411,708
20169,2023-02-10,BIBI,gemGrab,Undermine,21,18,39
20170,2023-02-10,BIBI,gemGrab,Deep Diner,86,88,174
20171,2023-02-10,BIBI,brawlBall,Sneaky Fields,1618,1439,3057
20172,2023-02-10,BIBI,brawlBall,Pinhole Punt,16,22,38
20173,2023-02-10,BIBI,bounty,Temple Ruins,19,13,32
20174,2023-02-09,BIBI,knockout,Riverside,4,0,4
20175,2023-02-09,BIBI,hotZone,Open Zone,2,1,3
20176,2023-02-09,BIBI,heist,Hot Potato,176,187,363
20177,2023-02-09,BIBI,gemGrab,Undermine,15,15,30
20178,2023-02-09,BIBI,gemGrab,Gem Fort,2,5,7
20179,2023-02-09,BIBI,brawlBall,Sunny Soccer,1,1,2
20180,2023-02-09,BIBI,brawlBall,Pinhole Punt,278,260,538
20181,2023-02-09,BIBI,bounty,Temple Ruins,5,12,17
20182,2023-02-08,BIBI,knockout,Riverside,1,0,1
20183,2023-02-08,BIBI,hotZone,Open Zone,2,4,6
20184,2023-02-08,BIBI,heist,Safe Zone,9,4,13
20185,2023-02-08,BIBI,gemGrab,Gem Fort,15,15,30
20186,2023-02-08,BIBI,gemGrab,Crystal Arcade,2,2,4
20187,2023-02-08,BIBI,brawlBall,Sunny Soccer,127,136,263
20188,2023-02-08,BIBI,brawlBall,Beach Ball,5,3,8
20189,2023-02-08,BIBI,bounty,Excel,9,3,12
20190,2023-02-07,BIBI,knockout,New Perspective,1,0,1
20191,2023-02-07,BIBI,hotZone,Dueling Beetles,19,8,27
20192,2023-02-07,BIBI,heist,Safe Zone,2,2,4
20193,2023-02-07,BIBI,gemGrab,Minecart Madness,5,0,5
20194,2023-02-07,BIBI,gemGrab,Crystal Arcade,3,1,4
20195,2023-02-07,BIBI,brawlBall,Center Stage,11,9,20
20196,2023-02-07,BIBI,brawlBall,Beach Ball,79,84,163
20197,2023-02-07,BIBI,bounty,Excel,3,3,6
20198,2023-02-06,BIBI,knockout,New Perspective,49,30,79
20199,2023-02-06,BIBI,hotZone,Dueling Beetles,193,118,311
20200,2023-02-06,BIBI,heist,Snaked Assault,404,346,750
20201,2023-02-06,BIBI,heist,Pit Stop,101,108,209
20202,2023-02-06,BIBI,gemGrab,Minecart Madness,105,73,178
20203,2023-02-06,BIBI,gemGrab,Double Swoosh,66,37,103
20204,2023-02-06,BIBI,brawlBall,Sneaky Fields,50,21,71
20205,2023-02-06,BIBI,brawlBall,Center Stage,1580,1328,2908
20206,2023-02-06,BIBI,brawlBall,Backyard Bowl,77,56,133
20207,2023-02-06,BIBI,bounty,Layer Cake,30,28,58
20208,2023-02-05,BIBI,knockout,X Marks the Spot,29,10,39
20209,2023-02-05,BIBI,knockout,Goldarm Gulch,0,2,2
20210,2023-02-05,BIBI,hotZone,Ring of Fire,44,23,67
20211,2023-02-05,BIBI,heist,Snaked Assault,707,694,1401
20212,2023-02-05,BIBI,heist,Pit Stop,287,387,674
20213,2023-02-05,BIBI,gemGrab,Hard Rock Mine,34,33,67
20214,2023-02-05,BIBI,gemGrab,Double Swoosh,231,141,372
20215,2023-02-05,BIBI,brawlBall,Super Beach,48,51,99
20216,2023-02-05,BIBI,brawlBall,Sneaky Fields,126,79,205
20217,2023-02-05,BIBI,brawlBall,Backyard Bowl,740,650,1390
20218,2023-02-05,BIBI,bounty,Layer Cake,24,41,65
20219,2023-02-04,BIBI,knockout,X Marks the Spot,9,5,14
20220,2023-02-04,BIBI,hotZone,Ring of Fire,5,6,11
20221,2023-02-04,BIBI,heist,Tornado Ring,113,82,195
20222,2023-02-04,BIBI,heist,Pit Stop,155,182,337
20223,2023-02-04,BIBI,gemGrab,Hard Rock Mine,32,15,47
20224,2023-02-04,BIBI,gemGrab,Double Swoosh,29,16,45
20225,2023-02-04,BIBI,gemGrab,Deep Diner,11,5,16
20226,2023-02-04,BIBI,brawlBall,Super Beach,458,460,918
20227,2023-02-04,BIBI,brawlBall,Sneaky Fields,82,53,135
20228,2023-02-04,BIBI,bounty,Dry Season,6,3,9
20229,2023-02-03,BIBI,knockout,Out in the Open,35,17,52
20230,2023-02-03,BIBI,knockout,Goldarm Gulch,3,3,6
20231,2023-02-03,BIBI,hotZone,Split,158,169,327
20232,2023-02-03,BIBI,heist,Tornado Ring,1004,1087,2091
20233,2023-02-03,BIBI,heist,Pit Stop,682,1117,1799
20234,2023-02-03,BIBI,gemGrab,Undermine,28,15,43
20235,2023-02-03,BIBI,gemGrab,Double Swoosh,142,51,193
20236,2023-02-03,BIBI,gemGrab,Deep Diner,75,94,169
20237,2023-02-03,BIBI,brawlBall,Sneaky Fields,2342,1844,4186
20238,2023-02-03,BIBI,brawlBall,Pinhole Punt,52,34,86
20239,2023-02-03,BIBI,bounty,Dry Season,17,7,24
20240,2023-02-02,BIBI,knockout,Out in the Open,12,5,17
20241,2023-02-02,BIBI,hotZone,Split,98,123,221
20242,2023-02-02,BIBI,heist,Kaboom Canyon,10,5,15
20243,2023-02-02,BIBI,gemGrab,Undermine,20,14,34
20244,2023-02-02,BIBI,gemGrab,Gem Fort,3,9,12
20245,2023-02-02,BIBI,brawlBall,Sunny Soccer,16,8,24
20246,2023-02-02,BIBI,brawlBall,Pinhole Punt,314,287,601
20247,2023-02-02,BIBI,bounty,Shooting Star,4,0,4
20248,2023-02-01,BIBI,knockout,Goldarm Gulch,71,33,104
20249,2023-02-01,BIBI,hotZone,Parallel Plays,255,234,489
20250,2023-02-01,BIBI,heist,Kaboom Canyon,62,79,141
20251,2023-02-01,BIBI,gemGrab,Gem Fort,82,106,188
20252,2023-02-01,BIBI,gemGrab,Crystal Arcade,40,20,60
20253,2023-02-01,BIBI,brawlBall,Sunny Soccer,1280,1275,2555
20254,2023-02-01,BIBI,brawlBall,Beach Ball,37,29,66
20255,2023-02-01,BIBI,bounty,Shooting Star,4,3,7
20256,2023-01-31,BIBI,knockout,Goldarm Gulch,25,21,46
20257,2023-01-31,BIBI,hotZone,Parallel Plays,122,102,224
20258,2023-01-31,BIBI,heist,Pit Stop,183,221,404
20259,2023-01-31,BIBI,gemGrab,Minecart Madness,10,5,15
20260,2023-01-31,BIBI,gemGrab,Crystal Arcade,63,52,115
20261,2023-01-31,BIBI,brawlBall,Center Stage,9,7,16
20262,2023-01-31,BIBI,brawlBall,Beach Ball,480,412,892
20263,2023-01-31,BIBI,bounty,Hideout,3,3,6
20264,2023-01-30,BIBI,knockout,Belle's Rock,57,26,83
20265,2023-01-30,BIBI,hotZone,Quarter Pounder,150,104,254
20266,2023-01-30,BIBI,heist,Pit Stop,761,929,1690
20267,2023-01-30,BIBI,gemGrab,Minecart Madness,54,44,98
20268,2023-01-30,BIBI,gemGrab,Double Swoosh,56,41,97
20269,2023-01-30,BIBI,brawlBall,Center Stage,899,793,1692
20270,2023-01-30,BIBI,brawlBall,Backyard Bowl,63,60,123
20271,2023-01-30,BIBI,bounty,Hideout,2,5,7
20272,2023-01-29,BIBI,knockout,Belle's Rock,51,34,85
20273,2023-01-29,BIBI,hotZone,Quarter Pounder,77,63,140
20274,2023-01-29,BIBI,heist,Bridge Too Far,34,45,79
20275,2023-01-29,BIBI,gemGrab,Hard Rock Mine,28,22,50
20276,2023-01-29,BIBI,gemGrab,Double Swoosh,98,71,169
20277,2023-01-29,BIBI,brawlBall,Super Beach,23,28,51
20278,2023-01-29,BIBI,brawlBall,Backyard Bowl,609,460,1069
20279,2023-01-29,BIBI,bounty,Canal Grande,39,20,59
20280,2023-01-28,BIBI,knockout,Flaring Phoenix,25,18,43
20281,2023-01-28,BIBI,hotZone,Controller Chaos,163,109,272
20282,2023-01-28,BIBI,heist,Bridge Too Far,73,52,125
20283,2023-01-28,BIBI,gemGrab,Hard Rock Mine,107,118,225
20284,2023-01-28,BIBI,gemGrab,Deep Diner,23,13,36
20285,2023-01-28,BIBI,brawlBall,Super Beach,1671,1547,3218
20286,2023-01-28,BIBI,brawlBall,Sneaky Fields,57,40,97
20287,2023-01-28,BIBI,bounty,Canal Grande,48,25,73
20288,2023-01-27,BIBI,knockout,Flaring Phoenix,9,4,13
20289,2023-01-27,BIBI,hotZone,Controller Chaos,36,39,75
20290,2023-01-27,BIBI,heist,Hot Potato,117,154,271
20291,2023-01-27,BIBI,gemGrab,Undermine,5,4,9
20292,2023-01-27,BIBI,gemGrab,Deep Diner,28,20,48
20293,2023-01-27,BIBI,brawlBall,Sneaky Fields,455,433,888
20294,2023-01-27,BIBI,brawlBall,Pinhole Punt,9,8,17
20295,2023-01-27,BIBI,bounty,Temple Ruins,6,7,13
20296,2023-01-26,BIBI,knockout,Riverside,13,6,19
20297,2023-01-26,BIBI,hotZone,Open Zone,35,20,55
20298,2023-01-26,BIBI,heist,Hot Potato,685,714,1399
20299,2023-01-26,BIBI,gemGrab,Undermine,58,51,109
20300,2023-01-26,BIBI,gemGrab,Gem Fort,29,21,50
20301,2023-01-26,BIBI,brawlBall,Sunny Soccer,74,61,135
20302,2023-01-26,BIBI,brawlBall,Pinhole Punt,1006,915,1921
20303,2023-01-26,BIBI,bounty,Temple Ruins,14,6,20
20304,2023-01-25,BIBI,knockout,Riverside,10,6,16
20305,2023-01-25,BIBI,hotZone,Open Zone,13,8,21
20306,2023-01-25,BIBI,heist,Safe Zone,70,111,181
20307,2023-01-25,BIBI,gemGrab,Gem Fort,38,45,83
20308,2023-01-25,BIBI,gemGrab,Crystal Arcade,56,57,113
20309,2023-01-25,BIBI,brawlBall,Sunny Soccer,867,747,1614
20310,2023-01-25,BIBI,brawlBall,Beach Ball,92,80,172
20311,2023-01-25,BIBI,bounty,Excel,15,27,42
20312,2023-01-24,BIBI,knockout,New Perspective,24,10,34
20313,2023-01-24,BIBI,hotZone,Dueling Beetles,83,44,127
20314,2023-01-24,BIBI,heist,Safe Zone,159,181,340
20315,2023-01-24,BIBI,gemGrab,Minecart Madness,16,19,35
20316,2023-01-24,BIBI,gemGrab,Crystal Arcade,78,69,147
20317,2023-01-24,BIBI,brawlBall,Center Stage,124,81,205
20318,2023-01-24,BIBI,brawlBall,Beach Ball,1198,1025,2223
20319,2023-01-24,BIBI,bounty,Excel,29,29,58
20320,2023-01-23,BIBI,knockout,New Perspective,42,27,69
20321,2023-01-23,BIBI,hotZone,Dueling Beetles,100,122,222
20322,2023-01-23,BIBI,heist,Snaked Assault,474,548,1022
20323,2023-01-23,BIBI,gemGrab,Minecart Madness,111,65,176
20324,2023-01-23,BIBI,gemGrab,Double Swoosh,34,23,57
20325,2023-01-23,BIBI,brawlBall,Center Stage,1597,1331,2928
20326,2023-01-23,BIBI,brawlBall,Backyard Bowl,38,23,61
20327,2023-01-23,BIBI,bounty,Layer Cake,36,26,62
20328,2023-01-22,BIBI,knockout,X Marks the Spot,17,8,25
20329,2023-01-22,BIBI,hotZone,Ring of Fire,16,11,27
20330,2023-01-22,BIBI,heist,Snaked Assault,285,276,561
20331,2023-01-22,BIBI,gemGrab,Hard Rock Mine,33,19,52
20332,2023-01-22,BIBI,gemGrab,Double Swoosh,52,38,90
20333,2023-01-22,BIBI,brawlBall,Super Beach,163,156,319
20334,2023-01-22,BIBI,brawlBall,Backyard Bowl,280,260,540
20335,2023-01-22,BIBI,bounty,Layer Cake,13,23,36
20336,2023-01-21,BIBI,knockout,X Marks the Spot,63,32,95
20337,2023-01-21,BIBI,hotZone,Ring of Fire,38,33,71
20338,2023-01-21,BIBI,heist,Tornado Ring,522,604,1126
20339,2023-01-21,BIBI,gemGrab,Hard Rock Mine,127,113,240
20340,2023-01-21,BIBI,gemGrab,Deep Diner,25,10,35
20341,2023-01-21,BIBI,brawlBall,Super Beach,2119,2024,4143
20342,2023-01-21,BIBI,brawlBall,Sneaky Fields,71,65,136
20343,2023-01-21,BIBI,bounty,Dry Season,15,13,28
20344,2023-01-20,BIBI,knockout,Out in the Open,32,19,51
20345,2023-01-20,BIBI,hotZone,Split,174,190,364
20346,2023-01-20,BIBI,heist,Tornado Ring,696,806,1502
20347,2023-01-20,BIBI,gemGrab,Undermine,25,14,39
20348,2023-01-20,BIBI,gemGrab,Deep Diner,98,90,188
20349,2023-01-20,BIBI,brawlBall,Sneaky Fields,1671,1489,3160
20350,2023-01-20,BIBI,brawlBall,Pinhole Punt,37,46,83
20351,2023-01-20,BIBI,bounty,Dry Season,10,10,20
20352,2023-01-19,BIBI,knockout,Out in the Open,35,24,59
20353,2023-01-19,BIBI,hotZone,Split,293,287,580
20354,2023-01-19,BIBI,heist,Kaboom Canyon,69,60,129
20355,2023-01-19,BIBI,gemGrab,Undermine,89,81,170
20356,2023-01-19,BIBI,gemGrab,Gem Fort,19,10,29
20357,2023-01-19,BIBI,brawlBall,Sunny Soccer,54,43,97
20358,2023-01-19,BIBI,brawlBall,Pinhole Punt,1128,954,2082
20359,2023-01-19,BIBI,bounty,Shooting Star,9,4,13
20360,2023-01-18,BIBI,knockout,Goldarm Gulch,4,2,6
20361,2023-01-18,BIBI,hotZone,Parallel Plays,12,11,23
20362,2023-01-18,BIBI,heist,Kaboom Canyon,22,15,37
20363,2023-01-18,BIBI,gemGrab,Gem Fort,15,12,27
20364,2023-01-18,BIBI,gemGrab,Crystal Arcade,5,1,6
20365,2023-01-18,BIBI,brawlBall,Sunny Soccer,393,388,781
20366,2023-01-18,BIBI,brawlBall,Beach Ball,16,15,31
20367,2023-01-18,BIBI,bounty,Shooting Star,4,3,7
20368,2023-01-17,BIBI,knockout,Goldarm Gulch,3,7,10
20369,2023-01-17,BIBI,hotZone,Parallel Plays,11,10,21
20370,2023-01-17,BIBI,heist,Pit Stop,53,74,127
20371,2023-01-17,BIBI,gemGrab,Minecart Madness,1,1,2
20372,2023-01-17,BIBI,gemGrab,Crystal Arcade,11,5,16
20373,2023-01-17,BIBI,brawlBall,Center Stage,7,2,9
20374,2023-01-17,BIBI,brawlBall,Beach Ball,124,105,229
20375,2023-01-17,BIBI,bounty,Hideout,2,2,4
20376,2023-01-16,BIBI,knockout,Belle's Rock,1,3,4
20377,2023-01-16,BIBI,hotZone,Quarter Pounder,13,10,23
20378,2023-01-16,BIBI,heist,Pit Stop,245,292,537
20379,2023-01-16,BIBI,gemGrab,Minecart Madness,12,7,19
20380,2023-01-16,BIBI,gemGrab,Double Swoosh,3,0,3
20381,2023-01-16,BIBI,brawlBall,Center Stage,103,89,192
20382,2023-01-16,BIBI,brawlBall,Backyard Bowl,8,5,13
20383,2023-01-16,BIBI,bounty,Hideout,4,2,6
20384,2023-01-15,BIBI,knockout,Belle's Rock,10,2,12
20385,2023-01-15,BIBI,hotZone,Quarter Pounder,40,7,47
20386,2023-01-15,BIBI,heist,Bridge Too Far,14,15,29
20387,2023-01-15,BIBI,gemGrab,Hard Rock Mine,6,0,6
20388,2023-01-15,BIBI,gemGrab,Double Swoosh,14,4,18
20389,2023-01-15,BIBI,brawlBall,Super Beach,22,22,44
20390,2023-01-15,BIBI,brawlBall,Backyard Bowl,78,38,116
20391,2023-01-15,BIBI,bounty,Canal Grande,3,2,5
20392,2023-01-14,BIBI,hotZone,Controller Chaos,34,37,71
20393,2023-01-14,BIBI,heist,Bridge Too Far,18,17,35
20394,2023-01-14,BIBI,gemGrab,Hard Rock Mine,4,0,4
20395,2023-01-14,BIBI,gemGrab,Deep Diner,2,1,3
20396,2023-01-14,BIBI,brawlBall,Super Beach,132,99,231
20397,2023-01-14,BIBI,brawlBall,Sneaky Fields,12,13,25
20398,2023-01-14,BIBI,bounty,Canal Grande,6,4,10
20399,2023-01-13,BIBI,knockout,Flaring Phoenix,1,1,2
20400,2023-01-13,BIBI,hotZone,Controller Chaos,21,18,39
20401,2023-01-13,BIBI,heist,Hot Potato,25,22,47
20402,2023-01-13,BIBI,gemGrab,Undermine,1,0,1
20403,2023-01-13,BIBI,gemGrab,Deep Diner,11,1,12
20404,2023-01-13,BIBI,brawlBall,Sneaky Fields,85,55,140
20405,2023-01-13,BIBI,brawlBall,Pinhole Punt,3,0,3
20406,2023-01-13,BIBI,bounty,Temple Ruins,2,0,2
20407,2023-01-12,BIBI,knockout,Riverside,1,0,1
20408,2023-01-12,BIBI,hotZone,Open Zone,2,0,2
20409,2023-01-12,BIBI,heist,Hot Potato,19,5,24
20410,2023-01-12,BIBI,gemGrab,Undermine,0,1,1
20411,2023-01-12,BIBI,brawlBall,Sunny Soccer,2,2,4
20412,2023-01-12,BIBI,brawlBall,Pinhole Punt,34,33,67
20413,2023-01-11,BIBI,hotZone,Open Zone,2,0,2
20414,2023-01-11,BIBI,gemGrab,Gem Fort,2,0,2
20415,2023-01-11,BIBI,brawlBall,Sunny Soccer,34,28,62
20416,2023-01-11,BIBI,brawlBall,Beach Ball,0,1,1
20417,2023-01-11,BIBI,bounty,Excel,2,0,2
20418,2023-01-10,BIBI,hotZone,Dueling Beetles,19,5,24
20419,2023-01-10,BIBI,heist,Safe Zone,9,3,12
20420,2023-01-10,BIBI,gemGrab,Minecart Madness,5,0,5
20421,2023-01-10,BIBI,gemGrab,Crystal Arcade,10,7,17
20422,2023-01-10,BIBI,brawlBall,Center Stage,10,0,10
20423,2023-01-10,BIBI,brawlBall,Beach Ball,68,35,103
20424,2023-01-10,BIBI,bounty,Excel,2,0,2
20425,2023-01-09,BIBI,knockout,New Perspective,3,0,3
20426,2023-01-09,BIBI,hotZone,Dueling Beetles,14,3,17
20427,2023-01-09,BIBI,heist,Snaked Assault,44,128,172
20428,2023-01-09,BIBI,gemGrab,Minecart Madness,7,1,8
20429,2023-01-09,BIBI,gemGrab,Double Swoosh,2,1,3
20430,2023-01-09,BIBI,brawlBall,Center Stage,94,59,153
20431,2023-01-09,BIBI,brawlBall,Backyard Bowl,3,3,6
20432,2023-01-09,BIBI,bounty,Layer Cake,1,0,1
20433,2023-01-08,BIBI,knockout,X Marks the Spot,7,0,7
20434,2023-01-08,BIBI,hotZone,Ring of Fire,4,2,6
20435,2023-01-08,BIBI,heist,Snaked Assault,58,51,109
20436,2023-01-08,BIBI,gemGrab,Hard Rock Mine,3,1,4
20437,2023-01-08,BIBI,gemGrab,Double Swoosh,1,0,1
20438,2023-01-08,BIBI,brawlBall,Super Beach,18,17,35
20439,2023-01-08,BIBI,brawlBall,Backyard Bowl,41,18,59
20440,2023-01-08,BIBI,bounty,Layer Cake,2,0,2
20441,2023-01-07,BIBI,hotZone,Ring of Fire,1,0,1
20442,2023-01-07,BIBI,heist,Tornado Ring,48,68,116
20443,2023-01-07,BIBI,gemGrab,Hard Rock Mine,4,3,7
20444,2023-01-07,BIBI,gemGrab,Deep Diner,1,1,2
20445,2023-01-07,BIBI,brawlBall,Super Beach,45,42,87
20446,2023-01-07,BIBI,brawlBall,Sneaky Fields,3,1,4
20447,2023-01-06,BIBI,hotZone,Split,20,26,46
20448,2023-01-06,BIBI,heist,Tornado Ring,130,130,260
20449,2023-01-06,BIBI,gemGrab,Deep Diner,11,1,12
20450,2023-01-06,BIBI,brawlBall,Sneaky Fields,73,31,104
20451,2023-01-06,BIBI,brawlBall,Pinhole Punt,9,4,13
20452,2023-01-06,BIBI,bounty,Dry Season,2,0,2
20453,2023-01-05,BIBI,knockout,Out in the Open,1,0,1
20454,2023-01-05,BIBI,hotZone,Split,68,58,126
20455,2023-01-05,BIBI,heist,Kaboom Canyon,16,4,20
20456,2023-01-05,BIBI,gemGrab,Undermine,9,3,12
20457,2023-01-05,BIBI,gemGrab,Gem Fort,0,1,1
20458,2023-01-05,BIBI,brawlBall,Sunny Soccer,2,1,3
20459,2023-01-05,BIBI,brawlBall,Pinhole Punt,100,58,158
20460,2023-01-04,BIBI,knockout,Goldarm Gulch,5,2,7
20461,2023-01-04,BIBI,hotZone,Parallel Plays,11,9,20
20462,2023-01-04,BIBI,heist,Kaboom Canyon,12,3,15
20463,2023-01-04,BIBI,gemGrab,Gem Fort,5,1,6
20464,2023-01-04,BIBI,gemGrab,Crystal Arcade,4,1,5
20465,2023-01-04,BIBI,brawlBall,Sunny Soccer,116,56,172
20466,2023-01-04,BIBI,brawlBall,Beach Ball,1,0,1
20467,2023-01-04,BIBI,bounty,Shooting Star,3,1,4
20468,2023-01-03,BIBI,knockout,Goldarm Gulch,3,0,3
20469,2023-01-03,BIBI,hotZone,Parallel Plays,26,6,32
20470,2023-01-03,BIBI,heist,Pit Stop,122,104,226
20471,2023-01-03,BIBI,gemGrab,Minecart Madness,3,0,3
20472,2023-01-03,BIBI,gemGrab,Crystal Arcade,5,3,8
20473,2023-01-03,BIBI,brawlBall,Center Stage,3,1,4
20474,2023-01-03,BIBI,brawlBall,Beach Ball,97,70,167
20475,2023-01-03,BIBI,bounty,Hideout,1,2,3
20476,2023-01-02,BIBI,knockout,Belle's Rock,5,1,6
20477,2023-01-02,BIBI,hotZone,Quarter Pounder,14,3,17
20478,2023-01-02,BIBI,heist,Pit Stop,221,176,397
20479,2023-01-02,BIBI,gemGrab,Minecart Madness,13,0,13
20480,2023-01-02,BIBI,gemGrab,Double Swoosh,2,2,4
20481,2023-01-02,BIBI,brawlBall,Center Stage,72,57,129
20482,2023-01-02,BIBI,brawlBall,Backyard Bowl,6,6,12
20483,2023-01-02,BIBI,bounty,Hideout,4,0,4
20484,2023-01-01,BIBI,knockout,Belle's Rock,4,11,15
20485,2023-01-01,BIBI,hotZone,Quarter Pounder,9,10,19
20486,2023-01-01,BIBI,hotZone,Controller Chaos,0,1,1
20487,2023-01-01,BIBI,heist,Kaboom Canyon,0,1,1
20488,2023-01-01,BIBI,heist,Bridge Too Far,3,0,3
20489,2023-01-01,BIBI,gemGrab,Double Swoosh,1,4,5
20490,2023-01-01,BIBI,brawlBall,Backyard Bowl,14,15,29
20491,2023-01-01,BIBI,bounty,Canal Grande,3,0,3
20492,2022-12-31,BIBI,hotZone,Controller Chaos,3,2,5
20493,2022-12-31,BIBI,heist,Bridge Too Far,1,0,1
20494,2022-12-31,BIBI,gemGrab,Hard Rock Mine,1,0,1
20495,2022-12-31,BIBI,gemGrab,Deep Diner,5,1,6
20496,2022-12-31,BIBI,brawlBall,Super Beach,7,4,11
20497,2022-12-31,BIBI,brawlBall,Sneaky Fields,1,0,1
20498,2022-12-30,BIBI,hotZone,Controller Chaos,3,0,3
20499,2022-12-30,BIBI,heist,Hot Potato,1,2,3
20500,2022-12-30,BIBI,gemGrab,Deep Diner,1,1,2
20501,2022-12-30,BIBI,brawlBall,Sneaky Fields,14,11,25
20502,2022-12-29,BIBI,heist,Hot Potato,6,0,6
20503,2022-12-29,BIBI,brawlBall,Pinhole Punt,3,4,7
20504,2022-12-28,BIBI,brawlBall,Sunny Soccer,6,0,6
20505,2022-12-28,BIBI,brawlBall,Beach Ball,2,6,8
20506,2022-12-27,BIBI,heist,Safe Zone,0,2,2
20507,2022-12-27,BIBI,brawlBall,Beach Ball,4,7,11
20508,2022-12-26,BIBI,hotZone,Controller Chaos,2,0,2
20509,2022-12-26,BIBI,heist,Kaboom Canyon,1,0,1
20510,2022-12-25,BIBI,brawlBall,Backyard Bowl,1,0,1
20511,2022-12-24,BIBI,brawlBall,Super Beach,0,2,2
20512,2022-12-22,BIBI,heist,Kaboom Canyon,1,0,1
20513,2022-12-21,BIBI,brawlBall,Sunny Soccer,1,0,1
20514,2022-12-20,BIBI,brawlBall,Beach Ball,2,3,5
20515,2022-12-19,BIBI,brawlBall,Center Stage,2,0,2
20516,2022-12-13,BIBI,heist,Safe Zone,0,1,1
20517,2022-12-13,BIBI,gemGrab,Crystal Arcade,1,2,3
20518,2022-12-13,BIBI,brawlBall,Beach Ball,1,0,1
20519,2022-11-19,BIBI,brawlBall,Sneaky Fields,2,0,2
20520,2022-11-11,BIBI,brawlBall,Sneaky Fields,4,0,4
20521,2022-10-28,BIBI,brawlBall,Beach Ball,2,0,2
20522,2022-10-26,BIBI,brawlBall,Sunny Soccer,0,2,2
20523,2023-02-11,BELLE,knockout,Flaring Phoenix,65,45,110
20524,2023-02-11,BELLE,hotZone,Controller Chaos,8,3,11
20525,2023-02-11,BELLE,gemGrab,Deep Diner,18,38,56
20526,2023-02-11,BELLE,brawlBall,Super Beach,20,21,41
20527,2023-02-11,BELLE,brawlBall,Sneaky Fields,9,6,15
20528,2023-02-10,BELLE,knockout,Flaring Phoenix,128,114,242
20529,2023-02-10,BELLE,hotZone,Controller Chaos,12,3,15
20530,2023-02-10,BELLE,heist,Hot Potato,6,3,9
20531,2023-02-10,BELLE,gemGrab,Undermine,17,28,45
20532,2023-02-10,BELLE,gemGrab,Deep Diner,80,92,172
20533,2023-02-10,BELLE,brawlBall,Sneaky Fields,93,94,187
20534,2023-02-10,BELLE,brawlBall,Pinhole Punt,2,4,6
20535,2023-02-10,BELLE,bounty,Temple Ruins,35,32,67
20536,2023-02-09,BELLE,knockout,Riverside,42,49,91
20537,2023-02-09,BELLE,hotZone,Open Zone,6,8,14
20538,2023-02-09,BELLE,heist,Hot Potato,5,2,7
20539,2023-02-09,BELLE,gemGrab,Undermine,22,22,44
20540,2023-02-09,BELLE,gemGrab,Gem Fort,2,0,2
20541,2023-02-09,BELLE,brawlBall,Sunny Soccer,0,1,1
20542,2023-02-09,BELLE,brawlBall,Pinhole Punt,69,76,145
20543,2023-02-09,BELLE,bounty,Temple Ruins,10,7,17
20544,2023-02-08,BELLE,knockout,Riverside,43,39,82
20545,2023-02-08,BELLE,hotZone,Open Zone,16,16,32
20546,2023-02-08,BELLE,heist,Safe Zone,17,39,56
20547,2023-02-08,BELLE,gemGrab,Gem Fort,0,2,2
20548,2023-02-08,BELLE,gemGrab,Crystal Arcade,3,2,5
20549,2023-02-08,BELLE,brawlBall,Sunny Soccer,4,2,6
20550,2023-02-08,BELLE,bounty,Excel,3,5,8
20551,2023-02-07,BELLE,knockout,New Perspective,0,5,5
20552,2023-02-07,BELLE,hotZone,Dueling Beetles,11,3,14
20553,2023-02-07,BELLE,heist,Safe Zone,16,11,27
20554,2023-02-07,BELLE,gemGrab,Minecart Madness,6,7,13
20555,2023-02-07,BELLE,gemGrab,Crystal Arcade,6,5,11
20556,2023-02-07,BELLE,brawlBall,Beach Ball,3,2,5
20557,2023-02-07,BELLE,bounty,Excel,2,1,3
20558,2023-02-06,BELLE,knockout,New Perspective,128,142,270
20559,2023-02-06,BELLE,knockout,Goldarm Gulch,11,7,18
20560,2023-02-06,BELLE,hotZone,Dueling Beetles,90,117,207
20561,2023-02-06,BELLE,heist,Snaked Assault,23,20,43
20562,2023-02-06,BELLE,heist,Pit Stop,0,2,2
20563,2023-02-06,BELLE,gemGrab,Minecart Madness,183,232,415
20564,2023-02-06,BELLE,gemGrab,Double Swoosh,6,8,14
20565,2023-02-06,BELLE,brawlBall,Sneaky Fields,1,0,1
20566,2023-02-06,BELLE,brawlBall,Center Stage,93,78,171
20567,2023-02-06,BELLE,brawlBall,Backyard Bowl,50,62,112
20568,2023-02-06,BELLE,bounty,Layer Cake,35,76,111
20569,2023-02-05,BELLE,knockout,X Marks the Spot,101,112,213
20570,2023-02-05,BELLE,knockout,Goldarm Gulch,45,37,82
20571,2023-02-05,BELLE,hotZone,Ring of Fire,85,54,139
20572,2023-02-05,BELLE,heist,Snaked Assault,15,25,40
20573,2023-02-05,BELLE,heist,Pit Stop,1,0,1
20574,2023-02-05,BELLE,gemGrab,Hard Rock Mine,42,69,111
20575,2023-02-05,BELLE,gemGrab,Double Swoosh,40,32,72
20576,2023-02-05,BELLE,brawlBall,Super Beach,6,8,14
20577,2023-02-05,BELLE,brawlBall,Sneaky Fields,2,4,6
20578,2023-02-05,BELLE,brawlBall,Backyard Bowl,880,1015,1895
20579,2023-02-05,BELLE,bounty,Layer Cake,56,66,122
20580,2023-02-04,BELLE,knockout,X Marks the Spot,48,33,81
20581,2023-02-04,BELLE,knockout,Goldarm Gulch,25,21,46
20582,2023-02-04,BELLE,hotZone,Ring of Fire,16,12,28
20583,2023-02-04,BELLE,heist,Tornado Ring,2,0,2
20584,2023-02-04,BELLE,heist,Pit Stop,3,2,5
20585,2023-02-04,BELLE,gemGrab,Hard Rock Mine,28,61,89
20586,2023-02-04,BELLE,gemGrab,Double Swoosh,10,4,14
20587,2023-02-04,BELLE,gemGrab,Deep Diner,3,0,3
20588,2023-02-04,BELLE,brawlBall,Super Beach,39,46,85
20589,2023-02-04,BELLE,brawlBall,Sneaky Fields,1,4,5
20590,2023-02-04,BELLE,bounty,Dry Season,31,35,66
20591,2023-02-03,BELLE,knockout,Out in the Open,215,238,453
20592,2023-02-03,BELLE,knockout,Goldarm Gulch,153,107,260
20593,2023-02-03,BELLE,hotZone,Split,7,2,9
20594,2023-02-03,BELLE,heist,Tornado Ring,11,3,14
20595,2023-02-03,BELLE,heist,Pit Stop,1,1,2
20596,2023-02-03,BELLE,gemGrab,Undermine,15,5,20
20597,2023-02-03,BELLE,gemGrab,Double Swoosh,16,21,37
20598,2023-02-03,BELLE,gemGrab,Deep Diner,83,77,160
20599,2023-02-03,BELLE,brawlBall,Sneaky Fields,90,115,205
20600,2023-02-03,BELLE,brawlBall,Pinhole Punt,5,13,18
20601,2023-02-03,BELLE,bounty,Dry Season,180,189,369
20602,2023-02-02,BELLE,knockout,Out in the Open,83,89,172
20603,2023-02-02,BELLE,hotZone,Split,5,4,9
20604,2023-02-02,BELLE,heist,Kaboom Canyon,13,11,24
20605,2023-02-02,BELLE,gemGrab,Undermine,17,14,31
20606,2023-02-02,BELLE,gemGrab,Gem Fort,2,2,4
20607,2023-02-02,BELLE,brawlBall,Sunny Soccer,1,1,2
20608,2023-02-02,BELLE,brawlBall,Pinhole Punt,72,73,145
20609,2023-02-02,BELLE,bounty,Shooting Star,61,42,103
20610,2023-02-01,BELLE,knockout,Goldarm Gulch,184,174,358
20611,2023-02-01,BELLE,hotZone,Parallel Plays,25,23,48
20612,2023-02-01,BELLE,heist,Kaboom Canyon,51,44,95
20613,2023-02-01,BELLE,gemGrab,Gem Fort,35,25,60
20614,2023-02-01,BELLE,gemGrab,Crystal Arcade,37,34,71
20615,2023-02-01,BELLE,brawlBall,Sunny Soccer,51,51,102
20616,2023-02-01,BELLE,brawlBall,Beach Ball,3,0,3
20617,2023-02-01,BELLE,bounty,Shooting Star,136,121,257
20618,2023-01-31,BELLE,knockout,Goldarm Gulch,78,59,137
20619,2023-01-31,BELLE,hotZone,Parallel Plays,11,7,18
20620,2023-01-31,BELLE,heist,Pit Stop,1,2,3
20621,2023-01-31,BELLE,gemGrab,Minecart Madness,6,15,21
20622,2023-01-31,BELLE,gemGrab,Crystal Arcade,37,31,68
20623,2023-01-31,BELLE,brawlBall,Center Stage,0,1,1
20624,2023-01-31,BELLE,brawlBall,Beach Ball,50,53,103
20625,2023-01-31,BELLE,bounty,Hideout,35,40,75
20626,2023-01-30,BELLE,knockout,Belle's Rock,290,299,589
20627,2023-01-30,BELLE,hotZone,Quarter Pounder,48,116,164
20628,2023-01-30,BELLE,heist,Pit Stop,4,0,4
20629,2023-01-30,BELLE,gemGrab,Minecart Madness,122,191,313
20630,2023-01-30,BELLE,gemGrab,Double Swoosh,18,14,32
20631,2023-01-30,BELLE,brawlBall,Center Stage,43,45,88
20632,2023-01-30,BELLE,brawlBall,Backyard Bowl,40,47,87
20633,2023-01-30,BELLE,bounty,Hideout,74,104,178
20634,2023-01-29,BELLE,knockout,Belle's Rock,316,364,680
20635,2023-01-29,BELLE,hotZone,Quarter Pounder,33,27,60
20636,2023-01-29,BELLE,heist,Bridge Too Far,253,242,495
20637,2023-01-29,BELLE,gemGrab,Hard Rock Mine,13,13,26
20638,2023-01-29,BELLE,gemGrab,Double Swoosh,42,32,74
20639,2023-01-29,BELLE,brawlBall,Super Beach,2,0,2
20640,2023-01-29,BELLE,brawlBall,Backyard Bowl,581,705,1286
20641,2023-01-29,BELLE,bounty,Canal Grande,10,9,19
20642,2023-01-28,BELLE,knockout,Flaring Phoenix,91,83,174
20643,2023-01-28,BELLE,hotZone,Controller Chaos,9,7,16
20644,2023-01-28,BELLE,heist,Bridge Too Far,632,602,1234
20645,2023-01-28,BELLE,gemGrab,Hard Rock Mine,122,140,262
20646,2023-01-28,BELLE,gemGrab,Deep Diner,42,68,110
20647,2023-01-28,BELLE,brawlBall,Super Beach,166,184,350
20648,2023-01-28,BELLE,brawlBall,Sneaky Fields,4,0,4
20649,2023-01-28,BELLE,bounty,Canal Grande,24,30,54
20650,2023-01-27,BELLE,knockout,Flaring Phoenix,31,31,62
20651,2023-01-27,BELLE,hotZone,Controller Chaos,1,4,5
20652,2023-01-27,BELLE,heist,Hot Potato,9,8,17
20653,2023-01-27,BELLE,gemGrab,Undermine,5,1,6
20654,2023-01-27,BELLE,gemGrab,Deep Diner,41,43,84
20655,2023-01-27,BELLE,brawlBall,Sneaky Fields,37,41,78
20656,2023-01-27,BELLE,brawlBall,Pinhole Punt,6,1,7
20657,2023-01-27,BELLE,bounty,Temple Ruins,12,3,15
20658,2023-01-26,BELLE,knockout,Riverside,430,440,870
20659,2023-01-26,BELLE,hotZone,Open Zone,95,134,229
20660,2023-01-26,BELLE,heist,Hot Potato,6,4,10
20661,2023-01-26,BELLE,gemGrab,Undermine,46,56,102
20662,2023-01-26,BELLE,gemGrab,Gem Fort,9,4,13
20663,2023-01-26,BELLE,brawlBall,Sunny Soccer,6,4,10
20664,2023-01-26,BELLE,brawlBall,Pinhole Punt,162,192,354
20665,2023-01-26,BELLE,bounty,Temple Ruins,27,40,67
20666,2023-01-25,BELLE,knockout,Riverside,218,198,416
20667,2023-01-25,BELLE,hotZone,Open Zone,53,62,115
20668,2023-01-25,BELLE,heist,Safe Zone,158,163,321
20669,2023-01-25,BELLE,gemGrab,Gem Fort,12,11,23
20670,2023-01-25,BELLE,gemGrab,Crystal Arcade,57,45,102
20671,2023-01-25,BELLE,brawlBall,Sunny Soccer,35,46,81
20672,2023-01-25,BELLE,brawlBall,Beach Ball,7,7,14
20673,2023-01-25,BELLE,bounty,Excel,23,56,79
20674,2023-01-24,BELLE,knockout,New Perspective,101,116,217
20675,2023-01-24,BELLE,hotZone,Dueling Beetles,40,60,100
20676,2023-01-24,BELLE,heist,Safe Zone,242,256,498
20677,2023-01-24,BELLE,gemGrab,Minecart Madness,42,53,95
20678,2023-01-24,BELLE,gemGrab,Crystal Arcade,88,89,177
20679,2023-01-24,BELLE,brawlBall,Center Stage,7,6,13
20680,2023-01-24,BELLE,brawlBall,Beach Ball,87,85,172
20681,2023-01-24,BELLE,bounty,Excel,37,63,100
20682,2023-01-23,BELLE,knockout,New Perspective,156,168,324
20683,2023-01-23,BELLE,hotZone,Dueling Beetles,71,87,158
20684,2023-01-23,BELLE,heist,Snaked Assault,13,5,18
20685,2023-01-23,BELLE,gemGrab,Minecart Madness,178,225,403
20686,2023-01-23,BELLE,gemGrab,Double Swoosh,11,12,23
20687,2023-01-23,BELLE,brawlBall,Center Stage,82,67,149
20688,2023-01-23,BELLE,brawlBall,Backyard Bowl,57,50,107
20689,2023-01-23,BELLE,bounty,Layer Cake,39,57,96
20690,2023-01-22,BELLE,knockout,X Marks the Spot,102,108,210
20691,2023-01-22,BELLE,hotZone,Ring of Fire,31,35,66
20692,2023-01-22,BELLE,heist,Snaked Assault,13,4,17
20693,2023-01-22,BELLE,gemGrab,Hard Rock Mine,28,11,39
20694,2023-01-22,BELLE,gemGrab,Double Swoosh,14,17,31
20695,2023-01-22,BELLE,brawlBall,Super Beach,24,14,38
20696,2023-01-22,BELLE,brawlBall,Backyard Bowl,310,344,654
20697,2023-01-22,BELLE,bounty,Layer Cake,27,20,47
20698,2023-01-21,BELLE,knockout,X Marks the Spot,362,381,743
20699,2023-01-21,BELLE,hotZone,Ring of Fire,104,93,197
20700,2023-01-21,BELLE,heist,Tornado Ring,10,2,12
20701,2023-01-21,BELLE,gemGrab,Hard Rock Mine,172,191,363
20702,2023-01-21,BELLE,gemGrab,Deep Diner,15,18,33
20703,2023-01-21,BELLE,brawlBall,Super Beach,202,247,449
20704,2023-01-21,BELLE,brawlBall,Sneaky Fields,4,2,6
20705,2023-01-21,BELLE,bounty,Dry Season,161,129,290
20706,2023-01-20,BELLE,knockout,Out in the Open,274,269,543
20707,2023-01-20,BELLE,hotZone,Split,3,5,8
20708,2023-01-20,BELLE,heist,Tornado Ring,6,8,14
20709,2023-01-20,BELLE,gemGrab,Undermine,20,29,49
20710,2023-01-20,BELLE,gemGrab,Deep Diner,89,119,208
20711,2023-01-20,BELLE,brawlBall,Sneaky Fields,73,66,139
20712,2023-01-20,BELLE,brawlBall,Pinhole Punt,16,25,41
20713,2023-01-20,BELLE,bounty,Dry Season,133,142,275
20714,2023-01-19,BELLE,knockout,Out in the Open,316,301,617
20715,2023-01-19,BELLE,hotZone,Split,8,3,11
20716,2023-01-19,BELLE,heist,Kaboom Canyon,69,60,129
20717,2023-01-19,BELLE,gemGrab,Undermine,74,78,152
20718,2023-01-19,BELLE,gemGrab,Gem Fort,8,6,14
20719,2023-01-19,BELLE,brawlBall,Sunny Soccer,3,8,11
20720,2023-01-19,BELLE,brawlBall,Pinhole Punt,205,222,427
20721,2023-01-19,BELLE,bounty,Shooting Star,163,178,341
20722,2023-01-18,BELLE,knockout,Goldarm Gulch,23,38,61
20723,2023-01-18,BELLE,hotZone,Parallel Plays,2,0,2
20724,2023-01-18,BELLE,heist,Kaboom Canyon,36,33,69
20725,2023-01-18,BELLE,gemGrab,Gem Fort,6,8,14
20726,2023-01-18,BELLE,gemGrab,Crystal Arcade,6,7,13
20727,2023-01-18,BELLE,brawlBall,Sunny Soccer,12,17,29
20728,2023-01-18,BELLE,bounty,Shooting Star,81,70,151
20729,2023-01-17,BELLE,knockout,Goldarm Gulch,20,37,57
20730,2023-01-17,BELLE,hotZone,Parallel Plays,5,3,8
20731,2023-01-17,BELLE,gemGrab,Minecart Madness,1,5,6
20732,2023-01-17,BELLE,gemGrab,Crystal Arcade,9,10,19
20733,2023-01-17,BELLE,brawlBall,Beach Ball,8,5,13
20734,2023-01-17,BELLE,bounty,Hideout,4,32,36
20735,2023-01-16,BELLE,knockout,Belle's Rock,35,31,66
20736,2023-01-16,BELLE,hotZone,Quarter Pounder,4,11,15
20737,2023-01-16,BELLE,gemGrab,Minecart Madness,15,25,40
20738,2023-01-16,BELLE,gemGrab,Double Swoosh,0,1,1
20739,2023-01-16,BELLE,brawlBall,Center Stage,4,0,4
20740,2023-01-16,BELLE,brawlBall,Backyard Bowl,10,14,24
20741,2023-01-16,BELLE,bounty,Hideout,22,34,56
20742,2023-01-15,BELLE,knockout,Belle's Rock,42,45,87
20743,2023-01-15,BELLE,hotZone,Quarter Pounder,15,44,59
20744,2023-01-15,BELLE,heist,Bridge Too Far,70,49,119
20745,2023-01-15,BELLE,gemGrab,Hard Rock Mine,7,1,8
20746,2023-01-15,BELLE,gemGrab,Double Swoosh,6,5,11
20747,2023-01-15,BELLE,brawlBall,Super Beach,1,1,2
20748,2023-01-15,BELLE,brawlBall,Backyard Bowl,101,118,219
20749,2023-01-15,BELLE,bounty,Canal Grande,4,4,8
20750,2023-01-14,BELLE,knockout,Flaring Phoenix,6,2,8
20751,2023-01-14,BELLE,hotZone,Controller Chaos,2,2,4
20752,2023-01-14,BELLE,heist,Bridge Too Far,60,93,153
20753,2023-01-14,BELLE,gemGrab,Hard Rock Mine,16,20,36
20754,2023-01-14,BELLE,gemGrab,Deep Diner,2,2,4
20755,2023-01-14,BELLE,brawlBall,Super Beach,2,13,15
20756,2023-01-14,BELLE,brawlBall,Sneaky Fields,3,0,3
20757,2023-01-14,BELLE,bounty,Canal Grande,4,0,4
20758,2023-01-13,BELLE,knockout,Flaring Phoenix,9,1,10
20759,2023-01-13,BELLE,hotZone,Controller Chaos,0,2,2
20760,2023-01-13,BELLE,gemGrab,Deep Diner,3,5,8
20761,2023-01-13,BELLE,brawlBall,Sneaky Fields,7,1,8
20762,2023-01-13,BELLE,bounty,Temple Ruins,0,1,1
20763,2023-01-12,BELLE,knockout,Riverside,43,73,116
20764,2023-01-12,BELLE,hotZone,Open Zone,10,6,16
20765,2023-01-12,BELLE,gemGrab,Undermine,0,1,1
20766,2023-01-12,BELLE,gemGrab,Gem Fort,0,1,1
20767,2023-01-12,BELLE,brawlBall,Pinhole Punt,11,16,27
20768,2023-01-11,BELLE,knockout,Riverside,6,1,7
20769,2023-01-11,BELLE,hotZone,Open Zone,2,1,3
20770,2023-01-11,BELLE,heist,Safe Zone,0,3,3
20771,2023-01-11,BELLE,gemGrab,Gem Fort,1,5,6
20772,2023-01-11,BELLE,brawlBall,Beach Ball,0,1,1
20773,2023-01-11,BELLE,bounty,Excel,1,0,1
20774,2023-01-10,BELLE,knockout,New Perspective,6,21,27
20775,2023-01-10,BELLE,hotZone,Dueling Beetles,12,9,21
20776,2023-01-10,BELLE,heist,Safe Zone,26,23,49
20777,2023-01-10,BELLE,gemGrab,Minecart Madness,7,2,9
20778,2023-01-10,BELLE,gemGrab,Crystal Arcade,20,15,35
20779,2023-01-10,BELLE,brawlBall,Center Stage,0,3,3
20780,2023-01-10,BELLE,brawlBall,Beach Ball,7,3,10
20781,2023-01-09,BELLE,knockout,New Perspective,3,13,16
20782,2023-01-09,BELLE,hotZone,Dueling Beetles,7,20,27
20783,2023-01-09,BELLE,heist,Snaked Assault,2,0,2
20784,2023-01-09,BELLE,gemGrab,Minecart Madness,30,19,49
20785,2023-01-09,BELLE,gemGrab,Double Swoosh,1,6,7
20786,2023-01-09,BELLE,brawlBall,Center Stage,1,8,9
20787,2023-01-09,BELLE,brawlBall,Backyard Bowl,6,3,9
20788,2023-01-09,BELLE,bounty,Layer Cake,14,10,24
20789,2023-01-08,BELLE,knockout,X Marks the Spot,16,30,46
20790,2023-01-08,BELLE,hotZone,Ring of Fire,10,23,33
20791,2023-01-08,BELLE,heist,Snaked Assault,1,0,1
20792,2023-01-08,BELLE,gemGrab,Hard Rock Mine,6,2,8
20793,2023-01-08,BELLE,brawlBall,Super Beach,3,12,15
20794,2023-01-08,BELLE,brawlBall,Backyard Bowl,54,62,116
20795,2023-01-08,BELLE,bounty,Layer Cake,3,5,8
20796,2023-01-07,BELLE,knockout,X Marks the Spot,22,23,45
20797,2023-01-07,BELLE,hotZone,Ring of Fire,5,13,18
20798,2023-01-07,BELLE,gemGrab,Hard Rock Mine,8,11,19
20799,2023-01-07,BELLE,gemGrab,Deep Diner,4,5,9
20800,2023-01-07,BELLE,brawlBall,Super Beach,8,4,12
20801,2023-01-07,BELLE,bounty,Dry Season,16,25,41
20802,2023-01-06,BELLE,knockout,Out in the Open,25,22,47
20803,2023-01-06,BELLE,hotZone,Split,2,0,2
20804,2023-01-06,BELLE,heist,Tornado Ring,2,11,13
20805,2023-01-06,BELLE,gemGrab,Undermine,4,10,14
20806,2023-01-06,BELLE,gemGrab,Deep Diner,11,7,18
20807,2023-01-06,BELLE,brawlBall,Sneaky Fields,4,2,6
20808,2023-01-06,BELLE,bounty,Dry Season,26,33,59
20809,2023-01-05,BELLE,knockout,Out in the Open,46,66,112
20810,2023-01-05,BELLE,hotZone,Split,1,0,1
20811,2023-01-05,BELLE,heist,Kaboom Canyon,2,3,5
20812,2023-01-05,BELLE,gemGrab,Undermine,8,14,22
20813,2023-01-05,BELLE,brawlBall,Pinhole Punt,36,41,77
20814,2023-01-05,BELLE,bounty,Shooting Star,17,31,48
20815,2023-01-04,BELLE,knockout,Goldarm Gulch,9,4,13
20816,2023-01-04,BELLE,heist,Kaboom Canyon,15,20,35
20817,2023-01-04,BELLE,gemGrab,Gem Fort,5,1,6
20818,2023-01-04,BELLE,gemGrab,Crystal Arcade,2,0,2
20819,2023-01-04,BELLE,brawlBall,Sunny Soccer,5,1,6
20820,2023-01-04,BELLE,brawlBall,Beach Ball,1,0,1
20821,2023-01-04,BELLE,bounty,Shooting Star,50,46,96
20822,2023-01-03,BELLE,knockout,Goldarm Gulch,4,1,5
20823,2023-01-03,BELLE,hotZone,Parallel Plays,4,1,5
20824,2023-01-03,BELLE,gemGrab,Minecart Madness,8,8,16
20825,2023-01-03,BELLE,gemGrab,Crystal Arcade,14,1,15
20826,2023-01-03,BELLE,brawlBall,Beach Ball,11,6,17
20827,2023-01-03,BELLE,bounty,Hideout,19,30,49
20828,2023-01-02,BELLE,knockout,Belle's Rock,39,64,103
20829,2023-01-02,BELLE,hotZone,Quarter Pounder,4,7,11
20830,2023-01-02,BELLE,gemGrab,Minecart Madness,15,19,34
20831,2023-01-02,BELLE,gemGrab,Double Swoosh,1,0,1
20832,2023-01-02,BELLE,brawlBall,Center Stage,8,1,9
20833,2023-01-02,BELLE,brawlBall,Backyard Bowl,5,10,15
20834,2023-01-02,BELLE,bounty,Hideout,45,50,95
20835,2023-01-01,BELLE,knockout,Belle's Rock,10,7,17
20836,2023-01-01,BELLE,hotZone,Quarter Pounder,9,1,10
20837,2023-01-01,BELLE,heist,Kaboom Canyon,0,2,2
20838,2023-01-01,BELLE,heist,Bridge Too Far,16,26,42
20839,2023-01-01,BELLE,gemGrab,Minecart Madness,0,2,2
20840,2023-01-01,BELLE,gemGrab,Double Swoosh,1,0,1
20841,2023-01-01,BELLE,brawlBall,Backyard Bowl,28,37,65
20842,2022-12-31,BELLE,heist,Kaboom Canyon,0,1,1
20843,2022-12-31,BELLE,heist,Bridge Too Far,6,17,23
20844,2022-12-31,BELLE,gemGrab,Minecart Madness,1,0,1
20845,2022-12-31,BELLE,gemGrab,Hard Rock Mine,2,0,2
20846,2022-12-31,BELLE,gemGrab,Deep Diner,1,0,1
20847,2022-12-30,BELLE,heist,Kaboom Canyon,1,1,2
20848,2022-12-30,BELLE,gemGrab,Undermine,1,0,1
20849,2022-12-30,BELLE,gemGrab,Deep Diner,5,16,21
20850,2022-12-30,BELLE,brawlBall,Sneaky Fields,1,0,1
20851,2022-12-29,BELLE,heist,Kaboom Canyon,0,1,1
20852,2022-12-28,BELLE,hotZone,Open Zone,1,1,2
20853,2022-12-27,BELLE,knockout,New Perspective,2,0,2
20854,2022-12-27,BELLE,heist,Kaboom Canyon,0,1,1
20855,2022-12-27,BELLE,brawlBall,Beach Ball,1,0,1
20856,2022-12-26,BELLE,gemGrab,Minecart Madness,0,2,2
20857,2022-12-25,BELLE,brawlBall,Backyard Bowl,2,0,2
20858,2022-12-23,BELLE,knockout,Out in the Open,0,2,2
20859,2022-12-19,BELLE,gemGrab,Minecart Madness,0,4,4
20860,2022-12-19,BELLE,brawlBall,Center Stage,1,0,1
20861,2022-12-18,BELLE,heist,Bridge Too Far,1,0,1
20862,2022-12-16,BELLE,brawlBall,Sneaky Fields,0,1,1
20863,2022-12-13,BELLE,heist,Safe Zone,0,2,2
20864,2022-12-11,BELLE,brawlBall,Backyard Bowl,0,2,2
20865,2022-12-10,BELLE,hotZone,Ring of Fire,1,0,1
20866,2022-11-07,BELLE,hotZone,Quarter Pounder,0,2,2
20867,2022-11-01,BELLE,knockout,New Perspective,8,4,12
20868,2022-10-30,BELLE,knockout,Out in the Open,1,0,1
20869,2022-10-28,BELLE,knockout,Out in the Open,2,4,6
20870,2022-10-15,BELLE,gemGrab,Hard Rock Mine,2,2,4
20871,2022-10-10,BELLE,knockout,Belle's Rock,4,1,5
20872,2023-02-11,BEA,knockout,Flaring Phoenix,47,23,70
20873,2023-02-11,BEA,hotZone,Controller Chaos,99,174,273
20874,2023-02-11,BEA,gemGrab,Deep Diner,55,31,86
20875,2023-02-11,BEA,brawlBall,Super Beach,262,281,543
20876,2023-02-11,BEA,brawlBall,Sneaky Fields,160,229,389
20877,2023-02-10,BEA,knockout,Flaring Phoenix,114,67,181
20878,2023-02-10,BEA,hotZone,Controller Chaos,194,214,408
20879,2023-02-10,BEA,heist,Hot Potato,41,107,148
20880,2023-02-10,BEA,gemGrab,Undermine,30,12,42
20881,2023-02-10,BEA,gemGrab,Deep Diner,212,202,414
20882,2023-02-10,BEA,brawlBall,Sneaky Fields,1386,1673,3059
20883,2023-02-10,BEA,brawlBall,Pinhole Punt,21,22,43
20884,2023-02-10,BEA,bounty,Temple Ruins,61,51,112
20885,2023-02-09,BEA,knockout,Riverside,53,50,103
20886,2023-02-09,BEA,hotZone,Open Zone,42,40,82
20887,2023-02-09,BEA,heist,Hot Potato,18,29,47
20888,2023-02-09,BEA,gemGrab,Undermine,15,16,31
20889,2023-02-09,BEA,gemGrab,Gem Fort,3,1,4
20890,2023-02-09,BEA,brawlBall,Pinhole Punt,397,401,798
20891,2023-02-09,BEA,bounty,Temple Ruins,25,20,45
20892,2023-02-08,BEA,knockout,Riverside,33,22,55
20893,2023-02-08,BEA,hotZone,Open Zone,55,60,115
20894,2023-02-08,BEA,heist,Safe Zone,7,6,13
20895,2023-02-08,BEA,gemGrab,Gem Fort,8,8,16
20896,2023-02-08,BEA,gemGrab,Crystal Arcade,3,4,7
20897,2023-02-08,BEA,brawlBall,Sunny Soccer,45,53,98
20898,2023-02-08,BEA,brawlBall,Beach Ball,2,3,5
20899,2023-02-08,BEA,bounty,Excel,6,1,7
20900,2023-02-07,BEA,knockout,New Perspective,10,3,13
20901,2023-02-07,BEA,hotZone,Dueling Beetles,32,29,61
20902,2023-02-07,BEA,heist,Safe Zone,4,3,7
20903,2023-02-07,BEA,gemGrab,Minecart Madness,15,0,15
20904,2023-02-07,BEA,gemGrab,Crystal Arcade,10,7,17
20905,2023-02-07,BEA,brawlBall,Center Stage,3,2,5
20906,2023-02-07,BEA,brawlBall,Beach Ball,52,41,93
20907,2023-02-07,BEA,bounty,Excel,2,2,4
20908,2023-02-06,BEA,knockout,New Perspective,260,168,428
20909,2023-02-06,BEA,knockout,Goldarm Gulch,5,9,14
20910,2023-02-06,BEA,hotZone,Dueling Beetles,396,461,857
20911,2023-02-06,BEA,heist,Snaked Assault,189,390,579
20912,2023-02-06,BEA,gemGrab,Minecart Madness,196,209,405
20913,2023-02-06,BEA,gemGrab,Double Swoosh,60,72,132
20914,2023-02-06,BEA,brawlBall,Sneaky Fields,58,132,190
20915,2023-02-06,BEA,brawlBall,Center Stage,584,503,1087
20916,2023-02-06,BEA,brawlBall,Backyard Bowl,215,169,384
20917,2023-02-06,BEA,bounty,Layer Cake,44,34,78
20918,2023-02-05,BEA,knockout,X Marks the Spot,97,75,172
20919,2023-02-05,BEA,knockout,Goldarm Gulch,27,10,37
20920,2023-02-05,BEA,hotZone,Ring of Fire,225,314,539
20921,2023-02-05,BEA,heist,Snaked Assault,518,922,1440
20922,2023-02-05,BEA,heist,Pit Stop,2,1,3
20923,2023-02-05,BEA,gemGrab,Hard Rock Mine,32,43,75
20924,2023-02-05,BEA,gemGrab,Double Swoosh,139,91,230
20925,2023-02-05,BEA,brawlBall,Super Beach,41,61,102
20926,2023-02-05,BEA,brawlBall,Sneaky Fields,145,292,437
20927,2023-02-05,BEA,brawlBall,Backyard Bowl,3009,2878,5887
20928,2023-02-05,BEA,bounty,Layer Cake,53,46,99
20929,2023-02-04,BEA,knockout,X Marks the Spot,62,47,109
20930,2023-02-04,BEA,knockout,Goldarm Gulch,9,9,18
20931,2023-02-04,BEA,hotZone,Ring of Fire,59,67,126
20932,2023-02-04,BEA,heist,Tornado Ring,31,46,77
20933,2023-02-04,BEA,heist,Pit Stop,4,0,4
20934,2023-02-04,BEA,gemGrab,Hard Rock Mine,87,46,133
20935,2023-02-04,BEA,gemGrab,Double Swoosh,30,16,46
20936,2023-02-04,BEA,gemGrab,Deep Diner,10,4,14
20937,2023-02-04,BEA,brawlBall,Super Beach,400,497,897
20938,2023-02-04,BEA,brawlBall,Sneaky Fields,98,173,271
20939,2023-02-04,BEA,bounty,Dry Season,18,28,46
20940,2023-02-03,BEA,knockout,Out in the Open,236,156,392
20941,2023-02-03,BEA,knockout,Goldarm Gulch,73,73,146
20942,2023-02-03,BEA,hotZone,Split,13,9,22
20943,2023-02-03,BEA,heist,Tornado Ring,301,367,668
20944,2023-02-03,BEA,heist,Pit Stop,13,18,31
20945,2023-02-03,BEA,gemGrab,Undermine,31,23,54
20946,2023-02-03,BEA,gemGrab,Double Swoosh,130,107,237
20947,2023-02-03,BEA,gemGrab,Deep Diner,192,234,426
20948,2023-02-03,BEA,brawlBall,Sneaky Fields,1720,2677,4397
20949,2023-02-03,BEA,brawlBall,Pinhole Punt,92,86,178
20950,2023-02-03,BEA,bounty,Dry Season,179,136,315
20951,2023-02-02,BEA,knockout,Out in the Open,81,40,121
20952,2023-02-02,BEA,hotZone,Split,15,7,22
20953,2023-02-02,BEA,heist,Kaboom Canyon,10,12,22
20954,2023-02-02,BEA,gemGrab,Undermine,29,34,63
20955,2023-02-02,BEA,gemGrab,Gem Fort,4,2,6
20956,2023-02-02,BEA,brawlBall,Sunny Soccer,9,19,28
20957,2023-02-02,BEA,brawlBall,Pinhole Punt,497,492,989
20958,2023-02-02,BEA,bounty,Shooting Star,45,38,83
20959,2023-02-01,BEA,knockout,Goldarm Gulch,144,82,226
20960,2023-02-01,BEA,hotZone,Parallel Plays,174,353,527
20961,2023-02-01,BEA,heist,Kaboom Canyon,100,130,230
20962,2023-02-01,BEA,gemGrab,Gem Fort,58,75,133
20963,2023-02-01,BEA,gemGrab,Crystal Arcade,79,74,153
20964,2023-02-01,BEA,brawlBall,Sunny Soccer,491,607,1098
20965,2023-02-01,BEA,brawlBall,Beach Ball,27,28,55
20966,2023-02-01,BEA,bounty,Shooting Star,136,101,237
20967,2023-01-31,BEA,knockout,Goldarm Gulch,71,39,110
20968,2023-01-31,BEA,hotZone,Parallel Plays,88,97,185
20969,2023-01-31,BEA,heist,Pit Stop,5,5,10
20970,2023-01-31,BEA,gemGrab,Minecart Madness,5,10,15
20971,2023-01-31,BEA,gemGrab,Crystal Arcade,63,101,164
20972,2023-01-31,BEA,brawlBall,Center Stage,7,5,12
20973,2023-01-31,BEA,brawlBall,Beach Ball,358,423,781
20974,2023-01-31,BEA,bounty,Hideout,24,37,61
20975,2023-01-30,BEA,knockout,Belle's Rock,152,112,264
20976,2023-01-30,BEA,hotZone,Quarter Pounder,362,696,1058
20977,2023-01-30,BEA,heist,Pit Stop,29,36,65
20978,2023-01-30,BEA,gemGrab,Minecart Madness,129,143,272
20979,2023-01-30,BEA,gemGrab,Double Swoosh,37,32,69
20980,2023-01-30,BEA,brawlBall,Center Stage,341,280,621
20981,2023-01-30,BEA,brawlBall,Backyard Bowl,167,189,356
20982,2023-01-30,BEA,bounty,Hideout,64,49,113
20983,2023-01-29,BEA,knockout,Belle's Rock,155,80,235
20984,2023-01-29,BEA,hotZone,Quarter Pounder,439,515,954
20985,2023-01-29,BEA,heist,Bridge Too Far,168,129,297
20986,2023-01-29,BEA,gemGrab,Hard Rock Mine,17,32,49
20987,2023-01-29,BEA,gemGrab,Double Swoosh,54,64,118
20988,2023-01-29,BEA,brawlBall,Super Beach,34,35,69
20989,2023-01-29,BEA,brawlBall,Backyard Bowl,2154,2063,4217
20990,2023-01-29,BEA,bounty,Canal Grande,15,26,41
20991,2023-01-28,BEA,knockout,Flaring Phoenix,74,28,102
20992,2023-01-28,BEA,hotZone,Controller Chaos,117,231,348
20993,2023-01-28,BEA,heist,Bridge Too Far,435,401,836
20994,2023-01-28,BEA,gemGrab,Hard Rock Mine,137,125,262
20995,2023-01-28,BEA,gemGrab,Deep Diner,35,21,56
20996,2023-01-28,BEA,brawlBall,Super Beach,1570,1901,3471
20997,2023-01-28,BEA,brawlBall,Sneaky Fields,90,123,213
20998,2023-01-28,BEA,bounty,Canal Grande,32,32,64
20999,2023-01-27,BEA,knockout,Flaring Phoenix,22,16,38
21000,2023-01-27,BEA,hotZone,Controller Chaos,46,48,94
21001,2023-01-27,BEA,heist,Hot Potato,9,8,17
21002,2023-01-27,BEA,gemGrab,Undermine,6,1,7
21003,2023-01-27,BEA,gemGrab,Deep Diner,57,71,128
21004,2023-01-27,BEA,brawlBall,Sneaky Fields,402,510,912
21005,2023-01-27,BEA,brawlBall,Pinhole Punt,20,14,34
21006,2023-01-27,BEA,bounty,Temple Ruins,15,8,23
21007,2023-01-26,BEA,knockout,Riverside,403,256,659
21008,2023-01-26,BEA,hotZone,Open Zone,351,395,746
21009,2023-01-26,BEA,heist,Hot Potato,78,106,184
21010,2023-01-26,BEA,gemGrab,Undermine,114,115,229
21011,2023-01-26,BEA,gemGrab,Gem Fort,30,15,45
21012,2023-01-26,BEA,brawlBall,Sunny Soccer,24,17,41
21013,2023-01-26,BEA,brawlBall,Pinhole Punt,1378,1530,2908
21014,2023-01-26,BEA,bounty,Temple Ruins,34,29,63
21015,2023-01-25,BEA,knockout,Riverside,231,124,355
21016,2023-01-25,BEA,hotZone,Open Zone,234,259,493
21017,2023-01-25,BEA,heist,Safe Zone,64,94,158
21018,2023-01-25,BEA,gemGrab,Gem Fort,28,20,48
21019,2023-01-25,BEA,gemGrab,Crystal Arcade,72,56,128
21020,2023-01-25,BEA,brawlBall,Sunny Soccer,319,365,684
21021,2023-01-25,BEA,brawlBall,Beach Ball,74,92,166
21022,2023-01-25,BEA,bounty,Excel,23,20,43
21023,2023-01-24,BEA,knockout,New Perspective,153,91,244
21024,2023-01-24,BEA,hotZone,Dueling Beetles,104,158,262
21025,2023-01-24,BEA,heist,Safe Zone,190,148,338
21026,2023-01-24,BEA,gemGrab,Minecart Madness,53,66,119
21027,2023-01-24,BEA,gemGrab,Crystal Arcade,134,150,284
21028,2023-01-24,BEA,brawlBall,Center Stage,49,78,127
21029,2023-01-24,BEA,brawlBall,Beach Ball,742,858,1600
21030,2023-01-24,BEA,bounty,Excel,35,15,50
21031,2023-01-23,BEA,knockout,New Perspective,226,154,380
21032,2023-01-23,BEA,hotZone,Dueling Beetles,342,393,735
21033,2023-01-23,BEA,heist,Snaked Assault,221,460,681
21034,2023-01-23,BEA,gemGrab,Minecart Madness,233,193,426
21035,2023-01-23,BEA,gemGrab,Double Swoosh,42,42,84
21036,2023-01-23,BEA,brawlBall,Center Stage,541,458,999
21037,2023-01-23,BEA,brawlBall,Backyard Bowl,116,91,207
21038,2023-01-23,BEA,bounty,Layer Cake,39,40,79
21039,2023-01-22,BEA,knockout,X Marks the Spot,74,51,125
21040,2023-01-22,BEA,hotZone,Ring of Fire,143,173,316
21041,2023-01-22,BEA,heist,Snaked Assault,178,240,418
21042,2023-01-22,BEA,gemGrab,Hard Rock Mine,47,31,78
21043,2023-01-22,BEA,gemGrab,Double Swoosh,47,51,98
21044,2023-01-22,BEA,brawlBall,Super Beach,161,138,299
21045,2023-01-22,BEA,brawlBall,Backyard Bowl,1122,1077,2199
21046,2023-01-22,BEA,bounty,Layer Cake,17,8,25
21047,2023-01-21,BEA,knockout,X Marks the Spot,287,190,477
21048,2023-01-21,BEA,hotZone,Ring of Fire,457,543,1000
21049,2023-01-21,BEA,heist,Tornado Ring,121,161,282
21050,2023-01-21,BEA,gemGrab,Hard Rock Mine,197,193,390
21051,2023-01-21,BEA,gemGrab,Deep Diner,39,36,75
21052,2023-01-21,BEA,brawlBall,Super Beach,2106,2411,4517
21053,2023-01-21,BEA,brawlBall,Sneaky Fields,75,110,185
21054,2023-01-21,BEA,bounty,Dry Season,149,116,265
21055,2023-01-20,BEA,knockout,Out in the Open,268,168,436
21056,2023-01-20,BEA,hotZone,Split,10,4,14
21057,2023-01-20,BEA,heist,Tornado Ring,149,211,360
21058,2023-01-20,BEA,gemGrab,Undermine,54,51,105
21059,2023-01-20,BEA,gemGrab,Deep Diner,191,193,384
21060,2023-01-20,BEA,brawlBall,Sneaky Fields,1023,1416,2439
21061,2023-01-20,BEA,brawlBall,Pinhole Punt,46,52,98
21062,2023-01-20,BEA,bounty,Dry Season,131,84,215
21063,2023-01-19,BEA,knockout,Out in the Open,343,259,602
21064,2023-01-19,BEA,hotZone,Split,20,19,39
21065,2023-01-19,BEA,heist,Kaboom Canyon,82,108,190
21066,2023-01-19,BEA,gemGrab,Undermine,126,128,254
21067,2023-01-19,BEA,gemGrab,Gem Fort,18,23,41
21068,2023-01-19,BEA,brawlBall,Sunny Soccer,18,26,44
21069,2023-01-19,BEA,brawlBall,Pinhole Punt,1605,1779,3384
21070,2023-01-19,BEA,bounty,Shooting Star,181,137,318
21071,2023-01-18,BEA,knockout,Goldarm Gulch,18,12,30
21072,2023-01-18,BEA,hotZone,Parallel Plays,5,5,10
21073,2023-01-18,BEA,heist,Kaboom Canyon,31,34,65
21074,2023-01-18,BEA,gemGrab,Gem Fort,12,14,26
21075,2023-01-18,BEA,gemGrab,Crystal Arcade,6,10,16
21076,2023-01-18,BEA,brawlBall,Sunny Soccer,162,156,318
21077,2023-01-18,BEA,brawlBall,Beach Ball,12,8,20
21078,2023-01-18,BEA,bounty,Shooting Star,79,63,142
21079,2023-01-17,BEA,knockout,Goldarm Gulch,15,7,22
21080,2023-01-17,BEA,hotZone,Parallel Plays,12,16,28
21081,2023-01-17,BEA,gemGrab,Minecart Madness,2,6,8
21082,2023-01-17,BEA,gemGrab,Crystal Arcade,19,19,38
21083,2023-01-17,BEA,brawlBall,Center Stage,2,4,6
21084,2023-01-17,BEA,brawlBall,Beach Ball,69,90,159
21085,2023-01-17,BEA,bounty,Hideout,8,2,10
21086,2023-01-16,BEA,knockout,Belle's Rock,15,14,29
21087,2023-01-16,BEA,hotZone,Quarter Pounder,28,82,110
21088,2023-01-16,BEA,heist,Pit Stop,1,1,2
21089,2023-01-16,BEA,gemGrab,Minecart Madness,13,13,26
21090,2023-01-16,BEA,gemGrab,Double Swoosh,3,2,5
21091,2023-01-16,BEA,brawlBall,Center Stage,32,26,58
21092,2023-01-16,BEA,brawlBall,Backyard Bowl,27,40,67
21093,2023-01-16,BEA,bounty,Hideout,18,11,29
21094,2023-01-15,BEA,knockout,Belle's Rock,28,12,40
21095,2023-01-15,BEA,hotZone,Quarter Pounder,137,131,268
21096,2023-01-15,BEA,heist,Bridge Too Far,49,31,80
21097,2023-01-15,BEA,gemGrab,Hard Rock Mine,5,0,5
21098,2023-01-15,BEA,gemGrab,Double Swoosh,6,14,20
21099,2023-01-15,BEA,brawlBall,Super Beach,26,51,77
21100,2023-01-15,BEA,brawlBall,Backyard Bowl,342,321,663
21101,2023-01-15,BEA,bounty,Canal Grande,3,1,4
21102,2023-01-14,BEA,knockout,Flaring Phoenix,6,2,8
21103,2023-01-14,BEA,hotZone,Controller Chaos,43,89,132
21104,2023-01-14,BEA,heist,Bridge Too Far,96,75,171
21105,2023-01-14,BEA,gemGrab,Hard Rock Mine,11,12,23
21106,2023-01-14,BEA,gemGrab,Deep Diner,10,18,28
21107,2023-01-14,BEA,brawlBall,Super Beach,164,190,354
21108,2023-01-14,BEA,brawlBall,Sneaky Fields,35,37,72
21109,2023-01-14,BEA,bounty,Canal Grande,4,0,4
21110,2023-01-13,BEA,knockout,Flaring Phoenix,10,0,10
21111,2023-01-13,BEA,hotZone,Controller Chaos,74,117,191
21112,2023-01-13,BEA,heist,Hot Potato,1,1,2
21113,2023-01-13,BEA,gemGrab,Deep Diner,13,7,20
21114,2023-01-13,BEA,brawlBall,Sneaky Fields,176,179,355
21115,2023-01-13,BEA,brawlBall,Pinhole Punt,8,2,10
21116,2023-01-13,BEA,bounty,Temple Ruins,2,3,5
21117,2023-01-12,BEA,knockout,Riverside,52,25,77
21118,2023-01-12,BEA,hotZone,Open Zone,51,71,122
21119,2023-01-12,BEA,heist,Hot Potato,1,0,1
21120,2023-01-12,BEA,gemGrab,Undermine,7,5,12
21121,2023-01-12,BEA,gemGrab,Gem Fort,3,11,14
21122,2023-01-12,BEA,brawlBall,Sunny Soccer,3,1,4
21123,2023-01-12,BEA,brawlBall,Pinhole Punt,56,71,127
21124,2023-01-12,BEA,bounty,Temple Ruins,0,1,1
21125,2023-01-11,BEA,knockout,Riverside,15,24,39
21126,2023-01-11,BEA,hotZone,Open Zone,26,23,49
21127,2023-01-11,BEA,heist,Safe Zone,1,0,1
21128,2023-01-11,BEA,gemGrab,Gem Fort,1,0,1
21129,2023-01-11,BEA,brawlBall,Sunny Soccer,27,30,57
21130,2023-01-11,BEA,brawlBall,Beach Ball,1,1,2
21131,2023-01-10,BEA,knockout,New Perspective,7,4,11
21132,2023-01-10,BEA,hotZone,Dueling Beetles,43,28,71
21133,2023-01-10,BEA,heist,Safe Zone,17,20,37
21134,2023-01-10,BEA,gemGrab,Minecart Madness,11,36,47
21135,2023-01-10,BEA,gemGrab,Crystal Arcade,31,45,76
21136,2023-01-10,BEA,brawlBall,Center Stage,5,0,5
21137,2023-01-10,BEA,brawlBall,Beach Ball,82,73,155
21138,2023-01-10,BEA,bounty,Excel,3,13,16
21139,2023-01-09,BEA,knockout,New Perspective,7,4,11
21140,2023-01-09,BEA,hotZone,Dueling Beetles,30,49,79
21141,2023-01-09,BEA,heist,Snaked Assault,16,46,62
21142,2023-01-09,BEA,gemGrab,Minecart Madness,23,26,49
21143,2023-01-09,BEA,gemGrab,Double Swoosh,7,32,39
21144,2023-01-09,BEA,brawlBall,Center Stage,36,20,56
21145,2023-01-09,BEA,brawlBall,Backyard Bowl,25,11,36
21146,2023-01-09,BEA,bounty,Layer Cake,6,2,8
21147,2023-01-08,BEA,knockout,X Marks the Spot,19,18,37
21148,2023-01-08,BEA,hotZone,Ring of Fire,43,69,112
21149,2023-01-08,BEA,heist,Snaked Assault,25,66,91
21150,2023-01-08,BEA,gemGrab,Hard Rock Mine,9,11,20
21151,2023-01-08,BEA,gemGrab,Double Swoosh,3,8,11
21152,2023-01-08,BEA,brawlBall,Super Beach,30,21,51
21153,2023-01-08,BEA,brawlBall,Backyard Bowl,192,264,456
21154,2023-01-08,BEA,bounty,Layer Cake,3,2,5
21155,2023-01-07,BEA,knockout,X Marks the Spot,8,4,12
21156,2023-01-07,BEA,hotZone,Ring of Fire,15,12,27
21157,2023-01-07,BEA,heist,Tornado Ring,4,10,14
21158,2023-01-07,BEA,gemGrab,Hard Rock Mine,13,5,18
21159,2023-01-07,BEA,gemGrab,Deep Diner,13,24,37
21160,2023-01-07,BEA,brawlBall,Super Beach,76,105,181
21161,2023-01-07,BEA,brawlBall,Sneaky Fields,14,15,29
21162,2023-01-07,BEA,bounty,Dry Season,14,2,16
21163,2023-01-06,BEA,knockout,Out in the Open,20,9,29
21164,2023-01-06,BEA,hotZone,Split,2,10,12
21165,2023-01-06,BEA,heist,Tornado Ring,32,81,113
21166,2023-01-06,BEA,gemGrab,Undermine,8,10,18
21167,2023-01-06,BEA,gemGrab,Deep Diner,27,22,49
21168,2023-01-06,BEA,brawlBall,Sneaky Fields,135,216,351
21169,2023-01-06,BEA,brawlBall,Pinhole Punt,18,16,34
21170,2023-01-06,BEA,bounty,Dry Season,12,13,25
21171,2023-01-05,BEA,knockout,Out in the Open,44,52,96
21172,2023-01-05,BEA,hotZone,Split,27,40,67
21173,2023-01-05,BEA,heist,Kaboom Canyon,18,36,54
21174,2023-01-05,BEA,gemGrab,Undermine,28,22,50
21175,2023-01-05,BEA,gemGrab,Gem Fort,2,2,4
21176,2023-01-05,BEA,brawlBall,Sunny Soccer,1,4,5
21177,2023-01-05,BEA,brawlBall,Pinhole Punt,281,284,565
21178,2023-01-05,BEA,bounty,Shooting Star,18,4,22
21179,2023-01-04,BEA,knockout,Goldarm Gulch,3,0,3
21180,2023-01-04,BEA,hotZone,Parallel Plays,12,12,24
21181,2023-01-04,BEA,heist,Kaboom Canyon,30,31,61
21182,2023-01-04,BEA,gemGrab,Gem Fort,16,11,27
21183,2023-01-04,BEA,gemGrab,Crystal Arcade,12,8,20
21184,2023-01-04,BEA,brawlBall,Sunny Soccer,88,92,180
21185,2023-01-04,BEA,brawlBall,Beach Ball,0,4,4
21186,2023-01-04,BEA,bounty,Shooting Star,38,18,56
21187,2023-01-03,BEA,knockout,Goldarm Gulch,1,0,1
21188,2023-01-03,BEA,hotZone,Parallel Plays,22,29,51
21189,2023-01-03,BEA,heist,Pit Stop,1,15,16
21190,2023-01-03,BEA,gemGrab,Minecart Madness,8,0,8
21191,2023-01-03,BEA,gemGrab,Crystal Arcade,31,50,81
21192,2023-01-03,BEA,brawlBall,Center Stage,1,4,5
21193,2023-01-03,BEA,brawlBall,Beach Ball,103,141,244
21194,2023-01-03,BEA,bounty,Hideout,23,5,28
21195,2023-01-02,BEA,knockout,Belle's Rock,14,10,24
21196,2023-01-02,BEA,hotZone,Quarter Pounder,72,120,192
21197,2023-01-02,BEA,heist,Pit Stop,15,40,55
21198,2023-01-02,BEA,gemGrab,Minecart Madness,20,27,47
21199,2023-01-02,BEA,gemGrab,Double Swoosh,10,22,32
21200,2023-01-02,BEA,brawlBall,Center Stage,46,55,101
21201,2023-01-02,BEA,brawlBall,Backyard Bowl,24,12,36
21202,2023-01-02,BEA,bounty,Hideout,24,14,38
21203,2023-01-01,BEA,knockout,Belle's Rock,4,1,5
21204,2023-01-01,BEA,hotZone,Quarter Pounder,70,95,165
21205,2023-01-01,BEA,hotZone,Controller Chaos,2,0,2
21206,2023-01-01,BEA,heist,Bridge Too Far,5,5,10
21207,2023-01-01,BEA,gemGrab,Double Swoosh,6,5,11
21208,2023-01-01,BEA,brawlBall,Backyard Bowl,109,125,234
21209,2023-01-01,BEA,bounty,Canal Grande,2,0,2
21210,2022-12-31,BEA,hotZone,Controller Chaos,4,5,9
21211,2022-12-31,BEA,heist,Bridge Too Far,10,3,13
21212,2022-12-31,BEA,gemGrab,Hard Rock Mine,5,1,6
21213,2022-12-31,BEA,gemGrab,Deep Diner,2,1,3
21214,2022-12-31,BEA,brawlBall,Super Beach,12,9,21
21215,2022-12-31,BEA,bounty,Canal Grande,0,1,1
21216,2022-12-30,BEA,knockout,Flaring Phoenix,0,2,2
21217,2022-12-30,BEA,hotZone,Controller Chaos,2,2,4
21218,2022-12-30,BEA,gemGrab,Undermine,1,1,2
21219,2022-12-30,BEA,gemGrab,Deep Diner,9,16,25
21220,2022-12-30,BEA,brawlBall,Sneaky Fields,11,9,20
21221,2022-12-29,BEA,hotZone,Open Zone,3,2,5
21222,2022-12-29,BEA,gemGrab,Undermine,1,0,1
21223,2022-12-29,BEA,brawlBall,Pinhole Punt,16,5,21
21224,2022-12-28,BEA,hotZone,Open Zone,9,1,10
21225,2022-12-27,BEA,knockout,New Perspective,0,2,2
21226,2022-12-27,BEA,gemGrab,Minecart Madness,0,1,1
21227,2022-12-27,BEA,brawlBall,Center Stage,4,1,5
21228,2022-12-27,BEA,brawlBall,Beach Ball,1,1,2
21229,2022-12-26,BEA,heist,Kaboom Canyon,0,1,1
21230,2022-12-26,BEA,gemGrab,Minecart Madness,1,1,2
21231,2022-12-26,BEA,brawlBall,Center Stage,1,0,1
21232,2022-12-25,BEA,brawlBall,Backyard Bowl,3,1,4
21233,2022-12-25,BEA,bounty,Layer Cake,2,2,4
21234,2022-12-24,BEA,knockout,X Marks the Spot,0,1,1
21235,2022-12-24,BEA,brawlBall,Super Beach,5,9,14
21236,2022-12-24,BEA,bounty,Dry Season,0,1,1
21237,2022-12-23,BEA,knockout,Out in the Open,0,2,2
21238,2022-12-23,BEA,brawlBall,Sneaky Fields,1,0,1
21239,2022-12-22,BEA,brawlBall,Pinhole Punt,4,0,4
21240,2022-12-21,BEA,brawlBall,Sunny Soccer,2,2,4
21241,2022-12-20,BEA,brawlBall,Beach Ball,1,2,3
21242,2022-12-19,BEA,brawlBall,Center Stage,2,0,2
21243,2022-12-18,BEA,heist,Bridge Too Far,1,0,1
21244,2022-12-17,BEA,knockout,Flaring Phoenix,1,0,1
21245,2022-12-16,BEA,brawlBall,Sneaky Fields,1,1,2
21246,2022-12-13,BEA,knockout,New Perspective,3,13,16
21247,2022-12-13,BEA,heist,Safe Zone,0,1,1
21248,2022-12-13,BEA,gemGrab,Crystal Arcade,0,2,2
21249,2022-11-18,BEA,hotZone,Parallel Plays,2,0,2
21250,2022-11-18,BEA,brawlBall,Beach Ball,4,0,4
21251,2022-11-03,BEA,bounty,Temple Ruins,2,0,2
21252,2022-11-01,BEA,knockout,New Perspective,0,2,2
21253,2022-10-28,BEA,bounty,Canal Grande,2,0,2
21254,2022-10-15,BEA,hotZone,Ring of Fire,1,0,1
21255,2022-10-15,BEA,gemGrab,Hard Rock Mine,2,0,2
21256,2023-02-11,BARLEY,knockout,Flaring Phoenix,8,7,15
21257,2023-02-11,BARLEY,hotZone,Controller Chaos,35,40,75
21258,2023-02-11,BARLEY,gemGrab,Deep Diner,60,58,118
21259,2023-02-11,BARLEY,brawlBall,Super Beach,76,101,177
21260,2023-02-11,BARLEY,brawlBall,Sneaky Fields,7,11,18
21261,2023-02-10,BARLEY,knockout,Flaring Phoenix,32,34,66
21262,2023-02-10,BARLEY,hotZone,Controller Chaos,90,79,169
21263,2023-02-10,BARLEY,heist,Hot Potato,141,189,330
21264,2023-02-10,BARLEY,gemGrab,Undermine,3,6,9
21265,2023-02-10,BARLEY,gemGrab,Deep Diner,158,188,346
21266,2023-02-10,BARLEY,brawlBall,Sneaky Fields,56,49,105
21267,2023-02-10,BARLEY,brawlBall,Pinhole Punt,0,1,1
21268,2023-02-10,BARLEY,bounty,Temple Ruins,2,5,7
21269,2023-02-09,BARLEY,knockout,Riverside,4,0,4
21270,2023-02-09,BARLEY,hotZone,Open Zone,1,2,3
21271,2023-02-09,BARLEY,heist,Hot Potato,71,73,144
21272,2023-02-09,BARLEY,gemGrab,Undermine,2,4,6
21273,2023-02-09,BARLEY,gemGrab,Gem Fort,1,0,1
21274,2023-02-09,BARLEY,brawlBall,Pinhole Punt,10,8,18
21275,2023-02-08,BARLEY,knockout,Riverside,2,0,2
21276,2023-02-08,BARLEY,hotZone,Open Zone,1,1,2
21277,2023-02-08,BARLEY,heist,Safe Zone,1,1,2
21278,2023-02-08,BARLEY,gemGrab,Gem Fort,5,4,9
21279,2023-02-08,BARLEY,gemGrab,Crystal Arcade,1,1,2
21280,2023-02-08,BARLEY,brawlBall,Sunny Soccer,28,45,73
21281,2023-02-08,BARLEY,brawlBall,Beach Ball,2,0,2
21282,2023-02-08,BARLEY,bounty,Excel,5,1,6
21283,2023-02-07,BARLEY,knockout,New Perspective,1,2,3
21284,2023-02-07,BARLEY,hotZone,Dueling Beetles,2,4,6
21285,2023-02-07,BARLEY,heist,Safe Zone,0,2,2
21286,2023-02-07,BARLEY,gemGrab,Minecart Madness,3,0,3
21287,2023-02-07,BARLEY,gemGrab,Crystal Arcade,1,1,2
21288,2023-02-07,BARLEY,brawlBall,Beach Ball,9,15,24
21289,2023-02-06,BARLEY,knockout,New Perspective,30,21,51
21290,2023-02-06,BARLEY,hotZone,Dueling Beetles,110,63,173
21291,2023-02-06,BARLEY,heist,Snaked Assault,48,58,106
21292,2023-02-06,BARLEY,heist,Pit Stop,97,100,197
21293,2023-02-06,BARLEY,gemGrab,Minecart Madness,48,43,91
21294,2023-02-06,BARLEY,gemGrab,Double Swoosh,16,6,22
21295,2023-02-06,BARLEY,brawlBall,Sneaky Fields,0,3,3
21296,2023-02-06,BARLEY,brawlBall,Center Stage,61,24,85
21297,2023-02-06,BARLEY,brawlBall,Backyard Bowl,1,0,1
21298,2023-02-06,BARLEY,bounty,Layer Cake,26,16,42
21299,2023-02-05,BARLEY,knockout,X Marks the Spot,18,13,31
21300,2023-02-05,BARLEY,hotZone,Ring of Fire,25,8,33
21301,2023-02-05,BARLEY,heist,Snaked Assault,47,30,77
21302,2023-02-05,BARLEY,heist,Pit Stop,277,181,458
21303,2023-02-05,BARLEY,gemGrab,Hard Rock Mine,6,4,10
21304,2023-02-05,BARLEY,gemGrab,Double Swoosh,51,15,66
21305,2023-02-05,BARLEY,brawlBall,Super Beach,8,4,12
21306,2023-02-05,BARLEY,brawlBall,Sneaky Fields,4,1,5
21307,2023-02-05,BARLEY,brawlBall,Backyard Bowl,37,17,54
21308,2023-02-05,BARLEY,bounty,Layer Cake,26,31,57
21309,2023-02-04,BARLEY,knockout,X Marks the Spot,4,1,5
21310,2023-02-04,BARLEY,hotZone,Ring of Fire,4,1,5
21311,2023-02-04,BARLEY,heist,Tornado Ring,8,5,13
21312,2023-02-04,BARLEY,heist,Pit Stop,174,160,334
21313,2023-02-04,BARLEY,gemGrab,Hard Rock Mine,5,5,10
21314,2023-02-04,BARLEY,gemGrab,Double Swoosh,6,1,7
21315,2023-02-04,BARLEY,gemGrab,Deep Diner,4,3,7
21316,2023-02-04,BARLEY,brawlBall,Super Beach,143,165,308
21317,2023-02-04,BARLEY,brawlBall,Sneaky Fields,6,2,8
21318,2023-02-04,BARLEY,bounty,Dry Season,2,0,2
21319,2023-02-03,BARLEY,knockout,Out in the Open,10,7,17
21320,2023-02-03,BARLEY,knockout,Goldarm Gulch,6,1,7
21321,2023-02-03,BARLEY,hotZone,Split,115,150,265
21322,2023-02-03,BARLEY,heist,Tornado Ring,68,59,127
21323,2023-02-03,BARLEY,heist,Pit Stop,745,596,1341
21324,2023-02-03,BARLEY,gemGrab,Undermine,4,0,4
21325,2023-02-03,BARLEY,gemGrab,Double Swoosh,52,8,60
21326,2023-02-03,BARLEY,gemGrab,Deep Diner,181,284,465
21327,2023-02-03,BARLEY,brawlBall,Sneaky Fields,92,81,173
21328,2023-02-03,BARLEY,brawlBall,Pinhole Punt,2,0,2
21329,2023-02-03,BARLEY,bounty,Dry Season,7,5,12
21330,2023-02-02,BARLEY,knockout,Out in the Open,6,3,9
21331,2023-02-02,BARLEY,hotZone,Split,73,67,140
21332,2023-02-02,BARLEY,heist,Kaboom Canyon,3,5,8
21333,2023-02-02,BARLEY,gemGrab,Undermine,3,4,7
21334,2023-02-02,BARLEY,gemGrab,Gem Fort,1,0,1
21335,2023-02-02,BARLEY,brawlBall,Sunny Soccer,5,1,6
21336,2023-02-02,BARLEY,brawlBall,Pinhole Punt,17,9,26
21337,2023-02-02,BARLEY,bounty,Shooting Star,2,0,2
21338,2023-02-01,BARLEY,knockout,Goldarm Gulch,19,19,38
21339,2023-02-01,BARLEY,hotZone,Parallel Plays,219,308,527
21340,2023-02-01,BARLEY,heist,Kaboom Canyon,5,6,11
21341,2023-02-01,BARLEY,gemGrab,Gem Fort,12,13,25
21342,2023-02-01,BARLEY,gemGrab,Crystal Arcade,15,9,24
21343,2023-02-01,BARLEY,brawlBall,Sunny Soccer,205,306,511
21344,2023-02-01,BARLEY,brawlBall,Beach Ball,7,4,11
21345,2023-02-01,BARLEY,bounty,Shooting Star,5,0,5
21346,2023-01-31,BARLEY,knockout,Goldarm Gulch,16,6,22
21347,2023-01-31,BARLEY,hotZone,Parallel Plays,123,158,281
21348,2023-01-31,BARLEY,heist,Pit Stop,83,85,168
21349,2023-01-31,BARLEY,gemGrab,Minecart Madness,2,4,6
21350,2023-01-31,BARLEY,gemGrab,Crystal Arcade,9,9,18
21351,2023-01-31,BARLEY,brawlBall,Beach Ball,74,61,135
21352,2023-01-31,BARLEY,bounty,Hideout,1,2,3
21353,2023-01-30,BARLEY,knockout,Belle's Rock,65,44,109
21354,2023-01-30,BARLEY,hotZone,Quarter Pounder,165,396,561
21355,2023-01-30,BARLEY,heist,Pit Stop,286,258,544
21356,2023-01-30,BARLEY,gemGrab,Minecart Madness,31,20,51
21357,2023-01-30,BARLEY,gemGrab,Double Swoosh,6,6,12
21358,2023-01-30,BARLEY,brawlBall,Center Stage,27,20,47
21359,2023-01-30,BARLEY,brawlBall,Backyard Bowl,2,1,3
21360,2023-01-30,BARLEY,bounty,Hideout,3,5,8
21361,2023-01-29,BARLEY,knockout,Belle's Rock,62,38,100
21362,2023-01-29,BARLEY,hotZone,Quarter Pounder,295,450,745
21363,2023-01-29,BARLEY,heist,Bridge Too Far,14,7,21
21364,2023-01-29,BARLEY,gemGrab,Hard Rock Mine,5,3,8
21365,2023-01-29,BARLEY,gemGrab,Double Swoosh,18,9,27
21366,2023-01-29,BARLEY,brawlBall,Super Beach,18,15,33
21367,2023-01-29,BARLEY,brawlBall,Backyard Bowl,25,9,34
21368,2023-01-29,BARLEY,bounty,Canal Grande,17,7,24
21369,2023-01-28,BARLEY,knockout,Flaring Phoenix,34,24,58
21370,2023-01-28,BARLEY,hotZone,Controller Chaos,49,57,106
21371,2023-01-28,BARLEY,heist,Bridge Too Far,21,14,35
21372,2023-01-28,BARLEY,gemGrab,Hard Rock Mine,16,19,35
21373,2023-01-28,BARLEY,gemGrab,Deep Diner,30,49,79
21374,2023-01-28,BARLEY,brawlBall,Super Beach,437,575,1012
21375,2023-01-28,BARLEY,brawlBall,Sneaky Fields,1,3,4
21376,2023-01-28,BARLEY,bounty,Canal Grande,26,23,49
21377,2023-01-27,BARLEY,knockout,Flaring Phoenix,10,5,15
21378,2023-01-27,BARLEY,hotZone,Controller Chaos,40,18,58
21379,2023-01-27,BARLEY,heist,Hot Potato,63,112,175
21380,2023-01-27,BARLEY,gemGrab,Undermine,4,0,4
21381,2023-01-27,BARLEY,gemGrab,Deep Diner,78,91,169
21382,2023-01-27,BARLEY,brawlBall,Sneaky Fields,45,47,92
21383,2023-01-27,BARLEY,bounty,Temple Ruins,1,1,2
21384,2023-01-26,BARLEY,knockout,Riverside,16,2,18
21385,2023-01-26,BARLEY,hotZone,Open Zone,18,7,25
21386,2023-01-26,BARLEY,heist,Hot Potato,281,361,642
21387,2023-01-26,BARLEY,gemGrab,Undermine,3,10,13
21388,2023-01-26,BARLEY,gemGrab,Gem Fort,3,1,4
21389,2023-01-26,BARLEY,brawlBall,Sunny Soccer,5,4,9
21390,2023-01-26,BARLEY,brawlBall,Pinhole Punt,66,40,106
21391,2023-01-26,BARLEY,bounty,Temple Ruins,5,7,12
21392,2023-01-25,BARLEY,knockout,Riverside,4,3,7
21393,2023-01-25,BARLEY,hotZone,Open Zone,3,0,3
21394,2023-01-25,BARLEY,heist,Safe Zone,21,6,27
21395,2023-01-25,BARLEY,gemGrab,Gem Fort,4,5,9
21396,2023-01-25,BARLEY,gemGrab,Crystal Arcade,2,9,11
21397,2023-01-25,BARLEY,brawlBall,Sunny Soccer,137,136,273
21398,2023-01-25,BARLEY,brawlBall,Beach Ball,13,10,23
21399,2023-01-25,BARLEY,bounty,Excel,13,14,27
21400,2023-01-24,BARLEY,knockout,New Perspective,19,10,29
21401,2023-01-24,BARLEY,hotZone,Dueling Beetles,51,20,71
21402,2023-01-24,BARLEY,heist,Safe Zone,32,16,48
21403,2023-01-24,BARLEY,gemGrab,Minecart Madness,6,13,19
21404,2023-01-24,BARLEY,gemGrab,Crystal Arcade,22,10,32
21405,2023-01-24,BARLEY,brawlBall,Center Stage,6,3,9
21406,2023-01-24,BARLEY,brawlBall,Beach Ball,152,162,314
21407,2023-01-24,BARLEY,bounty,Excel,24,19,43
21408,2023-01-23,BARLEY,knockout,New Perspective,23,7,30
21409,2023-01-23,BARLEY,hotZone,Dueling Beetles,75,81,156
21410,2023-01-23,BARLEY,heist,Snaked Assault,55,25,80
21411,2023-01-23,BARLEY,gemGrab,Minecart Madness,32,25,57
21412,2023-01-23,BARLEY,gemGrab,Double Swoosh,4,2,6
21413,2023-01-23,BARLEY,brawlBall,Center Stage,72,54,126
21414,2023-01-23,BARLEY,bounty,Layer Cake,23,7,30
21415,2023-01-22,BARLEY,knockout,X Marks the Spot,14,7,21
21416,2023-01-22,BARLEY,hotZone,Ring of Fire,5,0,5
21417,2023-01-22,BARLEY,heist,Snaked Assault,35,22,57
21418,2023-01-22,BARLEY,gemGrab,Hard Rock Mine,7,1,8
21419,2023-01-22,BARLEY,gemGrab,Double Swoosh,10,14,24
21420,2023-01-22,BARLEY,brawlBall,Super Beach,33,34,67
21421,2023-01-22,BARLEY,brawlBall,Backyard Bowl,15,5,20
21422,2023-01-22,BARLEY,bounty,Layer Cake,8,3,11
21423,2023-01-21,BARLEY,knockout,X Marks the Spot,17,16,33
21424,2023-01-21,BARLEY,hotZone,Ring of Fire,26,7,33
21425,2023-01-21,BARLEY,heist,Tornado Ring,57,34,91
21426,2023-01-21,BARLEY,gemGrab,Hard Rock Mine,26,13,39
21427,2023-01-21,BARLEY,gemGrab,Deep Diner,44,56,100
21428,2023-01-21,BARLEY,brawlBall,Super Beach,536,867,1403
21429,2023-01-21,BARLEY,brawlBall,Sneaky Fields,7,4,11
21430,2023-01-21,BARLEY,bounty,Dry Season,12,8,20
21431,2023-01-20,BARLEY,knockout,Out in the Open,21,10,31
21432,2023-01-20,BARLEY,hotZone,Split,129,186,315
21433,2023-01-20,BARLEY,heist,Tornado Ring,39,33,72
21434,2023-01-20,BARLEY,gemGrab,Undermine,8,1,9
21435,2023-01-20,BARLEY,gemGrab,Deep Diner,155,223,378
21436,2023-01-20,BARLEY,brawlBall,Sneaky Fields,85,64,149
21437,2023-01-20,BARLEY,brawlBall,Pinhole Punt,4,4,8
21438,2023-01-20,BARLEY,bounty,Dry Season,11,9,20
21439,2023-01-19,BARLEY,knockout,Out in the Open,16,24,40
21440,2023-01-19,BARLEY,hotZone,Split,210,311,521
21441,2023-01-19,BARLEY,heist,Kaboom Canyon,23,14,37
21442,2023-01-19,BARLEY,gemGrab,Undermine,14,5,19
21443,2023-01-19,BARLEY,gemGrab,Gem Fort,1,0,1
21444,2023-01-19,BARLEY,brawlBall,Sunny Soccer,9,3,12
21445,2023-01-19,BARLEY,brawlBall,Pinhole Punt,35,18,53
21446,2023-01-19,BARLEY,bounty,Shooting Star,8,5,13
21447,2023-01-18,BARLEY,knockout,Goldarm Gulch,2,1,3
21448,2023-01-18,BARLEY,hotZone,Parallel Plays,26,55,81
21449,2023-01-18,BARLEY,heist,Kaboom Canyon,9,3,12
21450,2023-01-18,BARLEY,gemGrab,Gem Fort,1,3,4
21451,2023-01-18,BARLEY,gemGrab,Crystal Arcade,1,2,3
21452,2023-01-18,BARLEY,brawlBall,Sunny Soccer,74,64,138
21453,2023-01-18,BARLEY,brawlBall,Beach Ball,2,2,4
21454,2023-01-18,BARLEY,bounty,Shooting Star,0,2,2
21455,2023-01-17,BARLEY,knockout,Goldarm Gulch,2,10,12
21456,2023-01-17,BARLEY,hotZone,Parallel Plays,25,31,56
21457,2023-01-17,BARLEY,heist,Pit Stop,24,20,44
21458,2023-01-17,BARLEY,gemGrab,Minecart Madness,2,0,2
21459,2023-01-17,BARLEY,gemGrab,Crystal Arcade,4,11,15
21460,2023-01-17,BARLEY,brawlBall,Beach Ball,23,10,33
21461,2023-01-16,BARLEY,knockout,Belle's Rock,3,3,6
21462,2023-01-16,BARLEY,hotZone,Quarter Pounder,10,15,25
21463,2023-01-16,BARLEY,heist,Pit Stop,73,109,182
21464,2023-01-16,BARLEY,gemGrab,Minecart Madness,1,2,3
21465,2023-01-16,BARLEY,gemGrab,Double Swoosh,1,0,1
21466,2023-01-16,BARLEY,brawlBall,Center Stage,3,2,5
21467,2023-01-15,BARLEY,knockout,Belle's Rock,4,6,10
21468,2023-01-15,BARLEY,hotZone,Quarter Pounder,47,81,128
21469,2023-01-15,BARLEY,heist,Bridge Too Far,1,0,1
21470,2023-01-15,BARLEY,gemGrab,Double Swoosh,2,2,4
21471,2023-01-15,BARLEY,brawlBall,Super Beach,4,13,17
21472,2023-01-15,BARLEY,brawlBall,Backyard Bowl,2,0,2
21473,2023-01-15,BARLEY,bounty,Canal Grande,1,0,1
21474,2023-01-14,BARLEY,hotZone,Controller Chaos,11,0,11
21475,2023-01-14,BARLEY,heist,Bridge Too Far,1,0,1
21476,2023-01-14,BARLEY,gemGrab,Deep Diner,8,2,10
21477,2023-01-14,BARLEY,brawlBall,Super Beach,24,61,85
21478,2023-01-14,BARLEY,bounty,Canal Grande,3,0,3
21479,2023-01-13,BARLEY,hotZone,Controller Chaos,18,36,54
21480,2023-01-13,BARLEY,heist,Hot Potato,11,4,15
21481,2023-01-13,BARLEY,gemGrab,Deep Diner,10,15,25
21482,2023-01-13,BARLEY,brawlBall,Sneaky Fields,7,17,24
21483,2023-01-12,BARLEY,knockout,Riverside,1,0,1
21484,2023-01-12,BARLEY,hotZone,Open Zone,1,0,1
21485,2023-01-12,BARLEY,heist,Hot Potato,5,4,9
21486,2023-01-11,BARLEY,heist,Safe Zone,0,1,1
21487,2023-01-11,BARLEY,brawlBall,Sunny Soccer,3,7,10
21488,2023-01-10,BARLEY,hotZone,Dueling Beetles,10,16,26
21489,2023-01-10,BARLEY,brawlBall,Beach Ball,5,8,13
21490,2023-01-09,BARLEY,knockout,New Perspective,2,2,4
21491,2023-01-09,BARLEY,hotZone,Dueling Beetles,6,4,10
21492,2023-01-09,BARLEY,heist,Snaked Assault,5,0,5
21493,2023-01-09,BARLEY,gemGrab,Minecart Madness,1,2,3
21494,2023-01-09,BARLEY,bounty,Layer Cake,1,0,1
21495,2023-01-08,BARLEY,hotZone,Ring of Fire,1,0,1
21496,2023-01-08,BARLEY,heist,Snaked Assault,2,3,5
21497,2023-01-08,BARLEY,gemGrab,Hard Rock Mine,1,0,1
21498,2023-01-08,BARLEY,brawlBall,Super Beach,9,12,21
21499,2023-01-08,BARLEY,brawlBall,Backyard Bowl,1,1,2
21500,2023-01-08,BARLEY,bounty,Layer Cake,1,0,1
21501,2023-01-07,BARLEY,hotZone,Ring of Fire,1,0,1
21502,2023-01-07,BARLEY,heist,Tornado Ring,7,0,7
21503,2023-01-07,BARLEY,gemGrab,Deep Diner,11,34,45
21504,2023-01-07,BARLEY,brawlBall,Super Beach,17,40,57
21505,2023-01-06,BARLEY,hotZone,Split,12,21,33
21506,2023-01-06,BARLEY,heist,Tornado Ring,6,2,8
21507,2023-01-06,BARLEY,gemGrab,Deep Diner,19,53,72
21508,2023-01-06,BARLEY,brawlBall,Sneaky Fields,1,0,1
21509,2023-01-06,BARLEY,bounty,Dry Season,1,0,1
21510,2023-01-05,BARLEY,hotZone,Split,35,36,71
21511,2023-01-05,BARLEY,gemGrab,Undermine,1,0,1
21512,2023-01-05,BARLEY,gemGrab,Gem Fort,2,0,2
21513,2023-01-05,BARLEY,brawlBall,Pinhole Punt,2,0,2
21514,2023-01-04,BARLEY,hotZone,Parallel Plays,25,34,59
21515,2023-01-04,BARLEY,heist,Kaboom Canyon,2,0,2
21516,2023-01-04,BARLEY,brawlBall,Sunny Soccer,26,53,79
21517,2023-01-03,BARLEY,hotZone,Parallel Plays,26,76,102
21518,2023-01-03,BARLEY,heist,Pit Stop,28,65,93
21519,2023-01-03,BARLEY,gemGrab,Crystal Arcade,1,0,1
21520,2023-01-03,BARLEY,brawlBall,Beach Ball,10,6,16
21521,2023-01-03,BARLEY,bounty,Hideout,1,0,1
21522,2023-01-02,BARLEY,knockout,Belle's Rock,4,0,4
21523,2023-01-02,BARLEY,hotZone,Quarter Pounder,45,82,127
21524,2023-01-02,BARLEY,heist,Pit Stop,44,60,104
21525,2023-01-02,BARLEY,gemGrab,Minecart Madness,1,0,1
21526,2023-01-02,BARLEY,brawlBall,Center Stage,1,0,1
21527,2023-01-02,BARLEY,bounty,Hideout,2,0,2
21528,2023-01-01,BARLEY,hotZone,Quarter Pounder,31,48,79
21529,2023-01-01,BARLEY,hotZone,Controller Chaos,2,0,2
21530,2023-01-01,BARLEY,gemGrab,Double Swoosh,1,0,1
21531,2023-01-01,BARLEY,brawlBall,Backyard Bowl,1,0,1
21532,2022-12-31,BARLEY,hotZone,Controller Chaos,1,0,1
21533,2022-12-31,BARLEY,gemGrab,Minecart Madness,0,4,4
21534,2022-12-31,BARLEY,gemGrab,Hard Rock Mine,1,0,1
21535,2022-12-31,BARLEY,gemGrab,Deep Diner,1,10,11
21536,2022-12-31,BARLEY,brawlBall,Super Beach,1,5,6
21537,2022-12-30,BARLEY,hotZone,Controller Chaos,1,0,1
21538,2022-12-30,BARLEY,heist,Hot Potato,1,0,1
21539,2022-12-30,BARLEY,gemGrab,Minecart Madness,1,0,1
21540,2022-12-30,BARLEY,gemGrab,Deep Diner,3,10,13
21541,2022-12-30,BARLEY,brawlBall,Sneaky Fields,2,0,2
21542,2022-12-29,BARLEY,heist,Hot Potato,2,0,2
21543,2022-12-28,BARLEY,hotZone,Controller Chaos,0,2,2
21544,2022-12-28,BARLEY,heist,Kaboom Canyon,2,0,2
21545,2022-12-25,BARLEY,hotZone,Ring of Fire,1,0,1
21546,2022-12-24,BARLEY,brawlBall,Super Beach,1,0,1
21547,2022-12-21,BARLEY,brawlBall,Sunny Soccer,2,0,2
21548,2022-12-13,BARLEY,brawlBall,Beach Ball,1,0,1
21549,2022-11-18,BARLEY,hotZone,Parallel Plays,4,0,4
21550,2022-11-07,BARLEY,hotZone,Quarter Pounder,0,2,2
21551,2022-11-01,BARLEY,knockout,New Perspective,0,2,2
21552,2023-02-11,ASH,knockout,Flaring Phoenix,8,3,11
21553,2023-02-11,ASH,hotZone,Controller Chaos,121,150,271
21554,2023-02-11,ASH,gemGrab,Deep Diner,35,27,62
21555,2023-02-11,ASH,brawlBall,Super Beach,122,158,280
21556,2023-02-11,ASH,brawlBall,Sneaky Fields,139,193,332
21557,2023-02-10,ASH,knockout,Flaring Phoenix,23,23,46
21558,2023-02-10,ASH,hotZone,Controller Chaos,228,352,580
21559,2023-02-10,ASH,heist,Hot Potato,5,9,14
21560,2023-02-10,ASH,gemGrab,Undermine,32,43,75
21561,2023-02-10,ASH,gemGrab,Deep Diner,64,92,156
21562,2023-02-10,ASH,brawlBall,Sneaky Fields,1197,1444,2641
21563,2023-02-10,ASH,brawlBall,Pinhole Punt,7,10,17
21564,2023-02-10,ASH,bounty,Temple Ruins,30,48,78
21565,2023-02-09,ASH,knockout,Riverside,1,0,1
21566,2023-02-09,ASH,hotZone,Open Zone,1,3,4
21567,2023-02-09,ASH,heist,Hot Potato,0,5,5
21568,2023-02-09,ASH,gemGrab,Undermine,47,101,148
21569,2023-02-09,ASH,gemGrab,Gem Fort,9,6,15
21570,2023-02-09,ASH,brawlBall,Sunny Soccer,1,0,1
21571,2023-02-09,ASH,brawlBall,Pinhole Punt,104,175,279
21572,2023-02-09,ASH,bounty,Temple Ruins,24,31,55
21573,2023-02-08,ASH,knockout,Riverside,1,0,1
21574,2023-02-08,ASH,heist,Safe Zone,0,1,1
21575,2023-02-08,ASH,gemGrab,Gem Fort,5,18,23
21576,2023-02-08,ASH,gemGrab,Crystal Arcade,4,5,9
21577,2023-02-08,ASH,brawlBall,Sunny Soccer,39,59,98
21578,2023-02-08,ASH,brawlBall,Beach Ball,0,11,11
21579,2023-02-08,ASH,bounty,Excel,0,1,1
21580,2023-02-07,ASH,hotZone,Dueling Beetles,7,1,8
21581,2023-02-07,ASH,gemGrab,Minecart Madness,2,0,2
21582,2023-02-07,ASH,gemGrab,Crystal Arcade,6,24,30
21583,2023-02-07,ASH,brawlBall,Center Stage,7,4,11
21584,2023-02-07,ASH,brawlBall,Beach Ball,15,20,35
21585,2023-02-07,ASH,bounty,Excel,0,1,1
21586,2023-02-06,ASH,knockout,New Perspective,10,19,29
21587,2023-02-06,ASH,knockout,Goldarm Gulch,1,0,1
21588,2023-02-06,ASH,hotZone,Dueling Beetles,80,77,157
21589,2023-02-06,ASH,heist,Snaked Assault,16,9,25
21590,2023-02-06,ASH,heist,Pit Stop,2,4,6
21591,2023-02-06,ASH,gemGrab,Minecart Madness,23,26,49
21592,2023-02-06,ASH,gemGrab,Double Swoosh,174,299,473
21593,2023-02-06,ASH,brawlBall,Sneaky Fields,124,147,271
21594,2023-02-06,ASH,brawlBall,Center Stage,727,994,1721
21595,2023-02-06,ASH,brawlBall,Backyard Bowl,6,3,9
21596,2023-02-06,ASH,bounty,Layer Cake,9,29,38
21597,2023-02-05,ASH,knockout,X Marks the Spot,9,5,14
21598,2023-02-05,ASH,hotZone,Ring of Fire,66,124,190
21599,2023-02-05,ASH,heist,Snaked Assault,35,22,57
21600,2023-02-05,ASH,heist,Pit Stop,2,2,4
21601,2023-02-05,ASH,gemGrab,Hard Rock Mine,69,98,167
21602,2023-02-05,ASH,gemGrab,Double Swoosh,491,721,1212
21603,2023-02-05,ASH,brawlBall,Super Beach,26,46,72
21604,2023-02-05,ASH,brawlBall,Sneaky Fields,259,407,666
21605,2023-02-05,ASH,brawlBall,Backyard Bowl,89,85,174
21606,2023-02-05,ASH,bounty,Layer Cake,23,57,80
21607,2023-02-04,ASH,knockout,X Marks the Spot,2,2,4
21608,2023-02-04,ASH,knockout,Goldarm Gulch,2,4,6
21609,2023-02-04,ASH,hotZone,Ring of Fire,22,22,44
21610,2023-02-04,ASH,heist,Tornado Ring,4,0,4
21611,2023-02-04,ASH,heist,Pit Stop,7,6,13
21612,2023-02-04,ASH,gemGrab,Hard Rock Mine,82,93,175
21613,2023-02-04,ASH,gemGrab,Double Swoosh,44,112,156
21614,2023-02-04,ASH,gemGrab,Deep Diner,1,6,7
21615,2023-02-04,ASH,brawlBall,Super Beach,192,236,428
21616,2023-02-04,ASH,brawlBall,Sneaky Fields,181,241,422
21617,2023-02-04,ASH,bounty,Dry Season,3,1,4
21618,2023-02-03,ASH,knockout,Out in the Open,12,12,24
21619,2023-02-03,ASH,knockout,Goldarm Gulch,6,8,14
21620,2023-02-03,ASH,hotZone,Split,51,96,147
21621,2023-02-03,ASH,heist,Tornado Ring,16,15,31
21622,2023-02-03,ASH,heist,Pit Stop,21,16,37
21623,2023-02-03,ASH,gemGrab,Undermine,35,35,70
21624,2023-02-03,ASH,gemGrab,Double Swoosh,176,682,858
21625,2023-02-03,ASH,gemGrab,Deep Diner,72,104,176
21626,2023-02-03,ASH,brawlBall,Sneaky Fields,1654,2349,4003
21627,2023-02-03,ASH,brawlBall,Pinhole Punt,21,31,52
21628,2023-02-03,ASH,bounty,Dry Season,3,3,6
21629,2023-02-02,ASH,knockout,Out in the Open,2,0,2
21630,2023-02-02,ASH,hotZone,Split,29,41,70
21631,2023-02-02,ASH,heist,Kaboom Canyon,1,0,1
21632,2023-02-02,ASH,gemGrab,Undermine,36,55,91
21633,2023-02-02,ASH,gemGrab,Gem Fort,15,20,35
21634,2023-02-02,ASH,brawlBall,Sunny Soccer,8,13,21
21635,2023-02-02,ASH,brawlBall,Pinhole Punt,129,155,284
21636,2023-02-02,ASH,bounty,Shooting Star,3,0,3
21637,2023-02-01,ASH,knockout,Goldarm Gulch,24,18,42
21638,2023-02-01,ASH,hotZone,Parallel Plays,163,313,476
21639,2023-02-01,ASH,heist,Kaboom Canyon,6,0,6
21640,2023-02-01,ASH,gemGrab,Gem Fort,145,194,339
21641,2023-02-01,ASH,gemGrab,Crystal Arcade,109,187,296
21642,2023-02-01,ASH,brawlBall,Sunny Soccer,466,650,1116
21643,2023-02-01,ASH,brawlBall,Beach Ball,18,23,41
21644,2023-02-01,ASH,bounty,Shooting Star,2,1,3
21645,2023-01-31,ASH,knockout,Goldarm Gulch,15,15,30
21646,2023-01-31,ASH,hotZone,Parallel Plays,93,134,227
21647,2023-01-31,ASH,heist,Pit Stop,10,4,14
21648,2023-01-31,ASH,gemGrab,Minecart Madness,0,1,1
21649,2023-01-31,ASH,gemGrab,Crystal Arcade,106,165,271
21650,2023-01-31,ASH,brawlBall,Center Stage,5,8,13
21651,2023-01-31,ASH,brawlBall,Beach Ball,169,260,429
21652,2023-01-31,ASH,bounty,Hideout,1,1,2
21653,2023-01-30,ASH,knockout,Belle's Rock,10,9,19
21654,2023-01-30,ASH,hotZone,Quarter Pounder,37,27,64
21655,2023-01-30,ASH,heist,Pit Stop,8,3,11
21656,2023-01-30,ASH,gemGrab,Minecart Madness,9,20,29
21657,2023-01-30,ASH,gemGrab,Double Swoosh,172,226,398
21658,2023-01-30,ASH,brawlBall,Center Stage,421,565,986
21659,2023-01-30,ASH,brawlBall,Backyard Bowl,5,5,10
21660,2023-01-30,ASH,bounty,Hideout,2,0,2
21661,2023-01-29,ASH,knockout,Belle's Rock,12,16,28
21662,2023-01-29,ASH,hotZone,Quarter Pounder,31,21,52
21663,2023-01-29,ASH,heist,Bridge Too Far,1,0,1
21664,2023-01-29,ASH,gemGrab,Hard Rock Mine,55,83,138
21665,2023-01-29,ASH,gemGrab,Double Swoosh,229,337,566
21666,2023-01-29,ASH,brawlBall,Super Beach,9,16,25
21667,2023-01-29,ASH,brawlBall,Backyard Bowl,65,79,144
21668,2023-01-29,ASH,bounty,Canal Grande,48,64,112
21669,2023-01-28,ASH,knockout,Flaring Phoenix,11,15,26
21670,2023-01-28,ASH,hotZone,Controller Chaos,113,174,287
21671,2023-01-28,ASH,heist,Bridge Too Far,6,2,8
21672,2023-01-28,ASH,gemGrab,Hard Rock Mine,263,347,610
21673,2023-01-28,ASH,gemGrab,Deep Diner,27,46,73
21674,2023-01-28,ASH,brawlBall,Super Beach,628,873,1501
21675,2023-01-28,ASH,brawlBall,Sneaky Fields,66,95,161
21676,2023-01-28,ASH,bounty,Canal Grande,69,112,181
21677,2023-01-27,ASH,knockout,Flaring Phoenix,8,2,10
21678,2023-01-27,ASH,hotZone,Controller Chaos,39,55,94
21679,2023-01-27,ASH,heist,Hot Potato,7,17,24
21680,2023-01-27,ASH,gemGrab,Undermine,13,9,22
21681,2023-01-27,ASH,gemGrab,Deep Diner,22,26,48
21682,2023-01-27,ASH,brawlBall,Sneaky Fields,326,392,718
21683,2023-01-27,ASH,brawlBall,Pinhole Punt,2,1,3
21684,2023-01-27,ASH,bounty,Temple Ruins,7,3,10
21685,2023-01-26,ASH,knockout,Riverside,1,0,1
21686,2023-01-26,ASH,hotZone,Open Zone,9,7,16
21687,2023-01-26,ASH,heist,Hot Potato,4,3,7
21688,2023-01-26,ASH,gemGrab,Undermine,79,111,190
21689,2023-01-26,ASH,gemGrab,Gem Fort,67,120,187
21690,2023-01-26,ASH,brawlBall,Sunny Soccer,34,48,82
21691,2023-01-26,ASH,brawlBall,Pinhole Punt,330,474,804
21692,2023-01-26,ASH,bounty,Temple Ruins,30,46,76
21693,2023-01-25,ASH,knockout,Riverside,3,4,7
21694,2023-01-25,ASH,hotZone,Open Zone,4,1,5
21695,2023-01-25,ASH,heist,Safe Zone,1,1,2
21696,2023-01-25,ASH,gemGrab,Gem Fort,69,132,201
21697,2023-01-25,ASH,gemGrab,Crystal Arcade,116,193,309
21698,2023-01-25,ASH,brawlBall,Sunny Soccer,278,355,633
21699,2023-01-25,ASH,brawlBall,Beach Ball,45,66,111
21700,2023-01-25,ASH,bounty,Excel,5,3,8
21701,2023-01-24,ASH,knockout,New Perspective,6,10,16
21702,2023-01-24,ASH,hotZone,Dueling Beetles,38,27,65
21703,2023-01-24,ASH,heist,Safe Zone,2,2,4
21704,2023-01-24,ASH,gemGrab,Minecart Madness,3,2,5
21705,2023-01-24,ASH,gemGrab,Crystal Arcade,196,280,476
21706,2023-01-24,ASH,brawlBall,Center Stage,81,102,183
21707,2023-01-24,ASH,brawlBall,Beach Ball,384,495,879
21708,2023-01-24,ASH,bounty,Excel,6,14,20
21709,2023-01-23,ASH,knockout,New Perspective,11,15,26
21710,2023-01-23,ASH,hotZone,Dueling Beetles,37,46,83
21711,2023-01-23,ASH,heist,Snaked Assault,24,14,38
21712,2023-01-23,ASH,gemGrab,Minecart Madness,20,19,39
21713,2023-01-23,ASH,gemGrab,Double Swoosh,104,116,220
21714,2023-01-23,ASH,brawlBall,Center Stage,831,1202,2033
21715,2023-01-23,ASH,brawlBall,Backyard Bowl,2,0,2
21716,2023-01-23,ASH,bounty,Layer Cake,27,34,61
21717,2023-01-22,ASH,knockout,X Marks the Spot,4,3,7
21718,2023-01-22,ASH,hotZone,Ring of Fire,39,71,110
21719,2023-01-22,ASH,heist,Snaked Assault,11,10,21
21720,2023-01-22,ASH,gemGrab,Hard Rock Mine,84,120,204
21721,2023-01-22,ASH,gemGrab,Double Swoosh,118,154,272
21722,2023-01-22,ASH,brawlBall,Super Beach,35,55,90
21723,2023-01-22,ASH,brawlBall,Backyard Bowl,26,22,48
21724,2023-01-22,ASH,bounty,Layer Cake,10,30,40
21725,2023-01-21,ASH,knockout,X Marks the Spot,29,35,64
21726,2023-01-21,ASH,hotZone,Ring of Fire,90,115,205
21727,2023-01-21,ASH,heist,Tornado Ring,16,8,24
21728,2023-01-21,ASH,gemGrab,Hard Rock Mine,313,445,758
21729,2023-01-21,ASH,gemGrab,Deep Diner,19,46,65
21730,2023-01-21,ASH,brawlBall,Super Beach,834,1104,1938
21731,2023-01-21,ASH,brawlBall,Sneaky Fields,58,73,131
21732,2023-01-21,ASH,bounty,Dry Season,7,3,10
21733,2023-01-20,ASH,knockout,Out in the Open,8,5,13
21734,2023-01-20,ASH,hotZone,Split,52,84,136
21735,2023-01-20,ASH,heist,Tornado Ring,19,21,40
21736,2023-01-20,ASH,gemGrab,Undermine,78,135,213
21737,2023-01-20,ASH,gemGrab,Deep Diner,78,95,173
21738,2023-01-20,ASH,brawlBall,Sneaky Fields,897,1300,2197
21739,2023-01-20,ASH,brawlBall,Pinhole Punt,10,25,35
21740,2023-01-20,ASH,bounty,Dry Season,3,2,5
21741,2023-01-19,ASH,knockout,Out in the Open,9,20,29
21742,2023-01-19,ASH,hotZone,Split,112,263,375
21743,2023-01-19,ASH,heist,Kaboom Canyon,7,3,10
21744,2023-01-19,ASH,gemGrab,Undermine,156,175,331
21745,2023-01-19,ASH,gemGrab,Gem Fort,49,102,151
21746,2023-01-19,ASH,brawlBall,Sunny Soccer,15,46,61
21747,2023-01-19,ASH,brawlBall,Pinhole Punt,353,528,881
21748,2023-01-19,ASH,bounty,Shooting Star,4,14,18
21749,2023-01-18,ASH,knockout,Goldarm Gulch,1,3,4
21750,2023-01-18,ASH,hotZone,Parallel Plays,13,22,35
21751,2023-01-18,ASH,heist,Kaboom Canyon,2,0,2
21752,2023-01-18,ASH,gemGrab,Gem Fort,29,38,67
21753,2023-01-18,ASH,gemGrab,Crystal Arcade,14,28,42
21754,2023-01-18,ASH,brawlBall,Sunny Soccer,145,186,331
21755,2023-01-18,ASH,brawlBall,Beach Ball,2,4,6
21756,2023-01-17,ASH,knockout,Goldarm Gulch,2,0,2
21757,2023-01-17,ASH,hotZone,Parallel Plays,21,26,47
21758,2023-01-17,ASH,heist,Pit Stop,2,0,2
21759,2023-01-17,ASH,gemGrab,Minecart Madness,0,2,2
21760,2023-01-17,ASH,gemGrab,Crystal Arcade,22,25,47
21761,2023-01-17,ASH,brawlBall,Center Stage,3,6,9
21762,2023-01-17,ASH,brawlBall,Beach Ball,23,32,55
21763,2023-01-16,ASH,knockout,Belle's Rock,1,0,1
21764,2023-01-16,ASH,hotZone,Quarter Pounder,11,11,22
21765,2023-01-16,ASH,heist,Pit Stop,2,1,3
21766,2023-01-16,ASH,gemGrab,Minecart Madness,2,1,3
21767,2023-01-16,ASH,gemGrab,Double Swoosh,8,12,20
21768,2023-01-16,ASH,brawlBall,Center Stage,58,64,122
21769,2023-01-16,ASH,brawlBall,Backyard Bowl,1,2,3
21770,2023-01-16,ASH,bounty,Hideout,1,0,1
21771,2023-01-15,ASH,hotZone,Quarter Pounder,18,14,32
21772,2023-01-15,ASH,heist,Bridge Too Far,2,0,2
21773,2023-01-15,ASH,gemGrab,Hard Rock Mine,17,18,35
21774,2023-01-15,ASH,gemGrab,Double Swoosh,19,9,28
21775,2023-01-15,ASH,brawlBall,Super Beach,12,28,40
21776,2023-01-15,ASH,brawlBall,Backyard Bowl,10,11,21
21777,2023-01-15,ASH,bounty,Canal Grande,8,28,36
21778,2023-01-14,ASH,knockout,Flaring Phoenix,3,10,13
21779,2023-01-14,ASH,hotZone,Controller Chaos,36,66,102
21780,2023-01-14,ASH,heist,Bridge Too Far,1,0,1
21781,2023-01-14,ASH,gemGrab,Hard Rock Mine,25,29,54
21782,2023-01-14,ASH,gemGrab,Deep Diner,8,3,11
21783,2023-01-14,ASH,brawlBall,Super Beach,67,100,167
21784,2023-01-14,ASH,brawlBall,Sneaky Fields,16,19,35
21785,2023-01-14,ASH,bounty,Canal Grande,4,9,13
21786,2023-01-13,ASH,knockout,Flaring Phoenix,2,0,2
21787,2023-01-13,ASH,hotZone,Controller Chaos,32,57,89
21788,2023-01-13,ASH,gemGrab,Deep Diner,10,7,17
21789,2023-01-13,ASH,brawlBall,Sneaky Fields,106,177,283
21790,2023-01-13,ASH,brawlBall,Pinhole Punt,2,1,3
21791,2023-01-13,ASH,bounty,Temple Ruins,2,1,3
21792,2023-01-12,ASH,hotZone,Open Zone,0,1,1
21793,2023-01-12,ASH,gemGrab,Undermine,14,22,36
21794,2023-01-12,ASH,gemGrab,Gem Fort,5,7,12
21795,2023-01-12,ASH,brawlBall,Sunny Soccer,3,2,5
21796,2023-01-12,ASH,brawlBall,Pinhole Punt,16,26,42
21797,2023-01-11,ASH,gemGrab,Gem Fort,6,13,19
21798,2023-01-11,ASH,brawlBall,Sunny Soccer,14,10,24
21799,2023-01-11,ASH,brawlBall,Beach Ball,0,2,2
21800,2023-01-10,ASH,hotZone,Dueling Beetles,9,5,14
21801,2023-01-10,ASH,gemGrab,Minecart Madness,3,0,3
21802,2023-01-10,ASH,gemGrab,Crystal Arcade,21,51,72
21803,2023-01-10,ASH,brawlBall,Center Stage,10,14,24
21804,2023-01-10,ASH,brawlBall,Beach Ball,24,81,105
21805,2023-01-09,ASH,hotZone,Dueling Beetles,8,1,9
21806,2023-01-09,ASH,heist,Snaked Assault,5,1,6
21807,2023-01-09,ASH,gemGrab,Minecart Madness,5,19,24
21808,2023-01-09,ASH,gemGrab,Double Swoosh,31,60,91
21809,2023-01-09,ASH,brawlBall,Center Stage,34,76,110
21810,2023-01-09,ASH,bounty,Layer Cake,2,11,13
21811,2023-01-08,ASH,knockout,X Marks the Spot,0,4,4
21812,2023-01-08,ASH,hotZone,Ring of Fire,8,6,14
21813,2023-01-08,ASH,heist,Snaked Assault,1,0,1
21814,2023-01-08,ASH,gemGrab,Hard Rock Mine,4,4,8
21815,2023-01-08,ASH,gemGrab,Double Swoosh,6,1,7
21816,2023-01-08,ASH,brawlBall,Super Beach,4,2,6
21817,2023-01-08,ASH,brawlBall,Backyard Bowl,7,5,12
21818,2023-01-08,ASH,bounty,Layer Cake,1,2,3
21819,2023-01-07,ASH,hotZone,Ring of Fire,2,0,2
21820,2023-01-07,ASH,heist,Tornado Ring,1,0,1
21821,2023-01-07,ASH,gemGrab,Hard Rock Mine,12,25,37
21822,2023-01-07,ASH,gemGrab,Deep Diner,4,1,5
21823,2023-01-07,ASH,brawlBall,Super Beach,13,34,47
21824,2023-01-07,ASH,brawlBall,Sneaky Fields,14,30,44
21825,2023-01-06,ASH,hotZone,Split,10,8,18
21826,2023-01-06,ASH,heist,Tornado Ring,2,5,7
21827,2023-01-06,ASH,gemGrab,Undermine,6,3,9
21828,2023-01-06,ASH,gemGrab,Deep Diner,7,13,20
21829,2023-01-06,ASH,brawlBall,Sneaky Fields,97,142,239
21830,2023-01-06,ASH,bounty,Dry Season,0,2,2
21831,2023-01-05,ASH,knockout,Out in the Open,1,0,1
21832,2023-01-05,ASH,hotZone,Split,18,41,59
21833,2023-01-05,ASH,gemGrab,Undermine,22,27,49
21834,2023-01-05,ASH,gemGrab,Gem Fort,4,1,5
21835,2023-01-05,ASH,brawlBall,Sunny Soccer,0,1,1
21836,2023-01-05,ASH,brawlBall,Pinhole Punt,64,61,125
21837,2023-01-04,ASH,knockout,Goldarm Gulch,1,0,1
21838,2023-01-04,ASH,hotZone,Parallel Plays,12,9,21
21839,2023-01-04,ASH,heist,Kaboom Canyon,2,1,3
21840,2023-01-04,ASH,gemGrab,Gem Fort,27,39,66
21841,2023-01-04,ASH,gemGrab,Crystal Arcade,11,37,48
21842,2023-01-04,ASH,brawlBall,Sunny Soccer,47,54,101
21843,2023-01-04,ASH,bounty,Shooting Star,2,1,3
21844,2023-01-03,ASH,knockout,Goldarm Gulch,0,1,1
21845,2023-01-03,ASH,hotZone,Parallel Plays,14,6,20
21846,2023-01-03,ASH,heist,Pit Stop,2,1,3
21847,2023-01-03,ASH,gemGrab,Crystal Arcade,18,28,46
21848,2023-01-03,ASH,brawlBall,Center Stage,1,0,1
21849,2023-01-03,ASH,brawlBall,Beach Ball,19,17,36
21850,2023-01-02,ASH,knockout,Belle's Rock,0,5,5
21851,2023-01-02,ASH,hotZone,Quarter Pounder,10,4,14
21852,2023-01-02,ASH,heist,Pit Stop,0,1,1
21853,2023-01-02,ASH,gemGrab,Minecart Madness,3,0,3
21854,2023-01-02,ASH,gemGrab,Double Swoosh,7,12,19
21855,2023-01-02,ASH,brawlBall,Center Stage,60,77,137
21856,2023-01-02,ASH,bounty,Hideout,1,0,1
21857,2023-01-01,ASH,hotZone,Quarter Pounder,2,0,2
21858,2023-01-01,ASH,gemGrab,Hard Rock Mine,4,4,8
21859,2023-01-01,ASH,gemGrab,Double Swoosh,13,20,33
21860,2023-01-01,ASH,brawlBall,Backyard Bowl,0,1,1
21861,2022-12-31,ASH,hotZone,Controller Chaos,1,0,1
21862,2022-12-31,ASH,gemGrab,Hard Rock Mine,2,0,2
21863,2022-12-31,ASH,gemGrab,Deep Diner,1,0,1
21864,2022-12-31,ASH,brawlBall,Super Beach,4,4,8
21865,2022-12-31,ASH,brawlBall,Sneaky Fields,1,1,2
21866,2022-12-30,ASH,hotZone,Controller Chaos,4,3,7
21867,2022-12-30,ASH,gemGrab,Undermine,1,1,2
21868,2022-12-30,ASH,gemGrab,Minecart Madness,1,0,1
21869,2022-12-30,ASH,gemGrab,Deep Diner,1,0,1
21870,2022-12-30,ASH,brawlBall,Sneaky Fields,4,5,9
21871,2022-12-29,ASH,heist,Kaboom Canyon,1,0,1
21872,2022-12-29,ASH,gemGrab,Undermine,0,1,1
21873,2022-12-29,ASH,brawlBall,Pinhole Punt,2,4,6
21874,2022-12-24,ASH,brawlBall,Super Beach,1,0,1
21875,2022-12-22,ASH,gemGrab,Gem Fort,0,1,1
21876,2022-12-21,ASH,brawlBall,Sunny Soccer,1,0,1
21877,2022-12-19,ASH,brawlBall,Center Stage,3,2,5
21878,2022-12-16,ASH,brawlBall,Sneaky Fields,2,5,7
21879,2022-12-13,ASH,gemGrab,Crystal Arcade,0,2,2
21880,2022-12-10,ASH,gemGrab,Hard Rock Mine,1,0,1
21881,2022-11-18,ASH,hotZone,Parallel Plays,2,4,6
21882,2022-11-01,ASH,knockout,New Perspective,2,0,2
21883,2023-02-11,AMBER,knockout,Flaring Phoenix,10,8,18
21884,2023-02-11,AMBER,hotZone,Controller Chaos,65,60,125
21885,2023-02-11,AMBER,gemGrab,Deep Diner,11,11,22
21886,2023-02-11,AMBER,brawlBall,Super Beach,16,15,31
21887,2023-02-11,AMBER,brawlBall,Sneaky Fields,5,3,8
21888,2023-02-10,AMBER,knockout,Flaring Phoenix,25,21,46
21889,2023-02-10,AMBER,hotZone,Controller Chaos,105,115,220
21890,2023-02-10,AMBER,heist,Hot Potato,19,18,37
21891,2023-02-10,AMBER,gemGrab,Undermine,20,21,41
21892,2023-02-10,AMBER,gemGrab,Deep Diner,39,39,78
21893,2023-02-10,AMBER,brawlBall,Sneaky Fields,107,155,262
21894,2023-02-10,AMBER,brawlBall,Pinhole Punt,4,4,8
21895,2023-02-10,AMBER,bounty,Temple Ruins,7,30,37
21896,2023-02-09,AMBER,knockout,Riverside,4,1,5
21897,2023-02-09,AMBER,hotZone,Open Zone,12,20,32
21898,2023-02-09,AMBER,heist,Hot Potato,8,6,14
21899,2023-02-09,AMBER,gemGrab,Undermine,13,12,25
21900,2023-02-09,AMBER,gemGrab,Gem Fort,1,0,1
21901,2023-02-09,AMBER,brawlBall,Pinhole Punt,73,76,149
21902,2023-02-09,AMBER,bounty,Temple Ruins,5,6,11
21903,2023-02-08,AMBER,knockout,Riverside,1,1,2
21904,2023-02-08,AMBER,hotZone,Open Zone,12,17,29
21905,2023-02-08,AMBER,heist,Safe Zone,9,9,18
21906,2023-02-08,AMBER,gemGrab,Gem Fort,9,10,19
21907,2023-02-08,AMBER,gemGrab,Crystal Arcade,2,0,2
21908,2023-02-08,AMBER,brawlBall,Sunny Soccer,7,9,16
21909,2023-02-08,AMBER,brawlBall,Beach Ball,1,0,1
21910,2023-02-08,AMBER,bounty,Excel,1,1,2
21911,2023-02-07,AMBER,knockout,New Perspective,0,1,1
21912,2023-02-07,AMBER,hotZone,Dueling Beetles,21,35,56
21913,2023-02-07,AMBER,heist,Safe Zone,3,1,4
21914,2023-02-07,AMBER,gemGrab,Minecart Madness,3,1,4
21915,2023-02-07,AMBER,gemGrab,Crystal Arcade,0,2,2
21916,2023-02-07,AMBER,brawlBall,Beach Ball,9,3,12
21917,2023-02-07,AMBER,bounty,Excel,2,0,2
21918,2023-02-06,AMBER,knockout,New Perspective,20,15,35
21919,2023-02-06,AMBER,hotZone,Dueling Beetles,177,203,380
21920,2023-02-06,AMBER,heist,Snaked Assault,51,70,121
21921,2023-02-06,AMBER,gemGrab,Minecart Madness,74,60,134
21922,2023-02-06,AMBER,gemGrab,Double Swoosh,122,229,351
21923,2023-02-06,AMBER,brawlBall,Sneaky Fields,3,0,3
21924,2023-02-06,AMBER,brawlBall,Center Stage,185,245,430
21925,2023-02-06,AMBER,brawlBall,Backyard Bowl,22,32,54
21926,2023-02-06,AMBER,bounty,Layer Cake,5,3,8
21927,2023-02-05,AMBER,knockout,X Marks the Spot,16,13,29
21928,2023-02-05,AMBER,knockout,Goldarm Gulch,1,2,3
21929,2023-02-05,AMBER,hotZone,Ring of Fire,79,79,158
21930,2023-02-05,AMBER,heist,Snaked Assault,125,173,298
21931,2023-02-05,AMBER,heist,Pit Stop,5,3,8
21932,2023-02-05,AMBER,gemGrab,Hard Rock Mine,6,1,7
21933,2023-02-05,AMBER,gemGrab,Double Swoosh,327,474,801
21934,2023-02-05,AMBER,brawlBall,Super Beach,1,2,3
21935,2023-02-05,AMBER,brawlBall,Sneaky Fields,4,4,8
21936,2023-02-05,AMBER,brawlBall,Backyard Bowl,273,331,604
21937,2023-02-05,AMBER,bounty,Layer Cake,13,7,20
21938,2023-02-04,AMBER,knockout,X Marks the Spot,5,4,9
21939,2023-02-04,AMBER,hotZone,Ring of Fire,17,20,37
21940,2023-02-04,AMBER,heist,Tornado Ring,15,27,42
21941,2023-02-04,AMBER,heist,Pit Stop,5,2,7
21942,2023-02-04,AMBER,gemGrab,Hard Rock Mine,21,14,35
21943,2023-02-04,AMBER,gemGrab,Double Swoosh,53,67,120
21944,2023-02-04,AMBER,gemGrab,Deep Diner,2,0,2
21945,2023-02-04,AMBER,brawlBall,Super Beach,33,29,62
21946,2023-02-04,AMBER,brawlBall,Sneaky Fields,6,3,9
21947,2023-02-04,AMBER,bounty,Dry Season,2,3,5
21948,2023-02-03,AMBER,knockout,Out in the Open,24,26,50
21949,2023-02-03,AMBER,knockout,Goldarm Gulch,8,6,14
21950,2023-02-03,AMBER,hotZone,Split,14,9,23
21951,2023-02-03,AMBER,heist,Tornado Ring,52,32,84
21952,2023-02-03,AMBER,heist,Pit Stop,17,7,24
21953,2023-02-03,AMBER,gemGrab,Undermine,33,45,78
21954,2023-02-03,AMBER,gemGrab,Double Swoosh,136,338,474
21955,2023-02-03,AMBER,gemGrab,Deep Diner,32,32,64
21956,2023-02-03,AMBER,brawlBall,Sneaky Fields,126,120,246
21957,2023-02-03,AMBER,brawlBall,Pinhole Punt,7,15,22
21958,2023-02-03,AMBER,bounty,Dry Season,31,19,50
21959,2023-02-02,AMBER,knockout,Out in the Open,7,14,21
21960,2023-02-02,AMBER,hotZone,Split,6,4,10
21961,2023-02-02,AMBER,heist,Kaboom Canyon,9,13,22
21962,2023-02-02,AMBER,gemGrab,Undermine,27,41,68
21963,2023-02-02,AMBER,gemGrab,Gem Fort,6,6,12
21964,2023-02-02,AMBER,brawlBall,Sunny Soccer,1,1,2
21965,2023-02-02,AMBER,brawlBall,Pinhole Punt,62,48,110
21966,2023-02-02,AMBER,bounty,Shooting Star,1,1,2
21967,2023-02-01,AMBER,knockout,Goldarm Gulch,21,24,45
21968,2023-02-01,AMBER,hotZone,Parallel Plays,48,44,92
21969,2023-02-01,AMBER,heist,Kaboom Canyon,68,91,159
21970,2023-02-01,AMBER,gemGrab,Gem Fort,47,58,105
21971,2023-02-01,AMBER,gemGrab,Crystal Arcade,23,29,52
21972,2023-02-01,AMBER,brawlBall,Sunny Soccer,85,90,175
21973,2023-02-01,AMBER,brawlBall,Beach Ball,3,2,5
21974,2023-02-01,AMBER,bounty,Shooting Star,7,1,8
21975,2023-01-31,AMBER,knockout,Goldarm Gulch,16,10,26
21976,2023-01-31,AMBER,hotZone,Parallel Plays,22,41,63
21977,2023-01-31,AMBER,heist,Pit Stop,1,1,2
21978,2023-01-31,AMBER,gemGrab,Minecart Madness,10,7,17
21979,2023-01-31,AMBER,gemGrab,Crystal Arcade,17,14,31
21980,2023-01-31,AMBER,brawlBall,Beach Ball,53,71,124
21981,2023-01-31,AMBER,bounty,Hideout,1,4,5
21982,2023-01-30,AMBER,knockout,Belle's Rock,19,17,36
21983,2023-01-30,AMBER,hotZone,Quarter Pounder,72,74,146
21984,2023-01-30,AMBER,heist,Pit Stop,13,5,18
21985,2023-01-30,AMBER,gemGrab,Minecart Madness,41,48,89
21986,2023-01-30,AMBER,gemGrab,Double Swoosh,95,103,198
21987,2023-01-30,AMBER,brawlBall,Center Stage,119,140,259
21988,2023-01-30,AMBER,brawlBall,Backyard Bowl,27,35,62
21989,2023-01-30,AMBER,bounty,Hideout,1,7,8
21990,2023-01-29,AMBER,knockout,Belle's Rock,15,9,24
21991,2023-01-29,AMBER,hotZone,Quarter Pounder,38,35,73
21992,2023-01-29,AMBER,heist,Bridge Too Far,75,69,144
21993,2023-01-29,AMBER,gemGrab,Hard Rock Mine,8,3,11
21994,2023-01-29,AMBER,gemGrab,Double Swoosh,175,218,393
21995,2023-01-29,AMBER,brawlBall,Super Beach,0,1,1
21996,2023-01-29,AMBER,brawlBall,Backyard Bowl,232,262,494
21997,2023-01-29,AMBER,bounty,Canal Grande,6,3,9
21998,2023-01-28,AMBER,knockout,Flaring Phoenix,9,8,17
21999,2023-01-28,AMBER,hotZone,Controller Chaos,54,90,144
22000,2023-01-28,AMBER,heist,Bridge Too Far,145,163,308
22001,2023-01-28,AMBER,gemGrab,Hard Rock Mine,19,13,32
22002,2023-01-28,AMBER,gemGrab,Deep Diner,4,5,9
22003,2023-01-28,AMBER,brawlBall,Super Beach,119,134,253
22004,2023-01-28,AMBER,brawlBall,Sneaky Fields,4,1,5
22005,2023-01-28,AMBER,bounty,Canal Grande,5,7,12
22006,2023-01-27,AMBER,knockout,Flaring Phoenix,6,3,9
22007,2023-01-27,AMBER,hotZone,Controller Chaos,17,17,34
22008,2023-01-27,AMBER,heist,Hot Potato,12,10,22
22009,2023-01-27,AMBER,gemGrab,Undermine,8,10,18
22010,2023-01-27,AMBER,gemGrab,Deep Diner,20,21,41
22011,2023-01-27,AMBER,brawlBall,Sneaky Fields,41,62,103
22012,2023-01-27,AMBER,brawlBall,Pinhole Punt,1,3,4
22013,2023-01-27,AMBER,bounty,Temple Ruins,6,16,22
22014,2023-01-26,AMBER,knockout,Riverside,24,13,37
22015,2023-01-26,AMBER,hotZone,Open Zone,118,220,338
22016,2023-01-26,AMBER,heist,Hot Potato,33,31,64
22017,2023-01-26,AMBER,gemGrab,Undermine,54,75,129
22018,2023-01-26,AMBER,gemGrab,Gem Fort,10,8,18
22019,2023-01-26,AMBER,brawlBall,Sunny Soccer,6,3,9
22020,2023-01-26,AMBER,brawlBall,Pinhole Punt,185,247,432
22021,2023-01-26,AMBER,bounty,Temple Ruins,13,31,44
22022,2023-01-25,AMBER,knockout,Riverside,14,7,21
22023,2023-01-25,AMBER,hotZone,Open Zone,68,81,149
22024,2023-01-25,AMBER,heist,Safe Zone,21,20,41
22025,2023-01-25,AMBER,gemGrab,Gem Fort,28,38,66
22026,2023-01-25,AMBER,gemGrab,Crystal Arcade,14,13,27
22027,2023-01-25,AMBER,brawlBall,Sunny Soccer,72,86,158
22028,2023-01-25,AMBER,brawlBall,Beach Ball,14,9,23
22029,2023-01-25,AMBER,bounty,Excel,5,0,5
22030,2023-01-24,AMBER,knockout,New Perspective,20,18,38
22031,2023-01-24,AMBER,hotZone,Dueling Beetles,53,59,112
22032,2023-01-24,AMBER,heist,Safe Zone,66,55,121
22033,2023-01-24,AMBER,gemGrab,Minecart Madness,17,16,33
22034,2023-01-24,AMBER,gemGrab,Crystal Arcade,53,53,106
22035,2023-01-24,AMBER,brawlBall,Center Stage,14,22,36
22036,2023-01-24,AMBER,brawlBall,Beach Ball,115,110,225
22037,2023-01-24,AMBER,bounty,Excel,11,8,19
22038,2023-01-23,AMBER,knockout,New Perspective,40,26,66
22039,2023-01-23,AMBER,hotZone,Dueling Beetles,90,112,202
22040,2023-01-23,AMBER,heist,Snaked Assault,107,83,190
22041,2023-01-23,AMBER,gemGrab,Minecart Madness,87,103,190
22042,2023-01-23,AMBER,gemGrab,Double Swoosh,80,140,220
22043,2023-01-23,AMBER,brawlBall,Center Stage,175,174,349
22044,2023-01-23,AMBER,brawlBall,Backyard Bowl,7,38,45
22045,2023-01-23,AMBER,bounty,Layer Cake,6,4,10
22046,2023-01-22,AMBER,knockout,X Marks the Spot,8,3,11
22047,2023-01-22,AMBER,hotZone,Ring of Fire,56,86,142
22048,2023-01-22,AMBER,heist,Snaked Assault,46,37,83
22049,2023-01-22,AMBER,gemGrab,Hard Rock Mine,11,9,20
22050,2023-01-22,AMBER,gemGrab,Double Swoosh,83,133,216
22051,2023-01-22,AMBER,brawlBall,Super Beach,12,7,19
22052,2023-01-22,AMBER,brawlBall,Backyard Bowl,101,126,227
22053,2023-01-22,AMBER,bounty,Layer Cake,4,4,8
22054,2023-01-21,AMBER,knockout,X Marks the Spot,34,21,55
22055,2023-01-21,AMBER,hotZone,Ring of Fire,135,205,340
22056,2023-01-21,AMBER,heist,Tornado Ring,32,19,51
22057,2023-01-21,AMBER,gemGrab,Hard Rock Mine,56,39,95
22058,2023-01-21,AMBER,gemGrab,Deep Diner,24,12,36
22059,2023-01-21,AMBER,brawlBall,Super Beach,109,115,224
22060,2023-01-21,AMBER,brawlBall,Sneaky Fields,2,0,2
22061,2023-01-21,AMBER,bounty,Dry Season,14,11,25
22062,2023-01-20,AMBER,knockout,Out in the Open,35,21,56
22063,2023-01-20,AMBER,hotZone,Split,19,9,28
22064,2023-01-20,AMBER,heist,Tornado Ring,34,35,69
22065,2023-01-20,AMBER,gemGrab,Undermine,24,47,71
22066,2023-01-20,AMBER,gemGrab,Deep Diner,55,37,92
22067,2023-01-20,AMBER,brawlBall,Sneaky Fields,111,100,211
22068,2023-01-20,AMBER,brawlBall,Pinhole Punt,3,4,7
22069,2023-01-20,AMBER,bounty,Dry Season,6,9,15
22070,2023-01-19,AMBER,knockout,Out in the Open,33,19,52
22071,2023-01-19,AMBER,hotZone,Split,19,13,32
22072,2023-01-19,AMBER,heist,Kaboom Canyon,39,70,109
22073,2023-01-19,AMBER,gemGrab,Undermine,92,133,225
22074,2023-01-19,AMBER,gemGrab,Gem Fort,8,21,29
22075,2023-01-19,AMBER,brawlBall,Sunny Soccer,3,3,6
22076,2023-01-19,AMBER,brawlBall,Pinhole Punt,202,254,456
22077,2023-01-19,AMBER,bounty,Shooting Star,10,7,17
22078,2023-01-18,AMBER,knockout,Goldarm Gulch,3,2,5
22079,2023-01-18,AMBER,hotZone,Parallel Plays,5,10,15
22080,2023-01-18,AMBER,heist,Kaboom Canyon,24,39,63
22081,2023-01-18,AMBER,gemGrab,Gem Fort,14,13,27
22082,2023-01-18,AMBER,gemGrab,Crystal Arcade,3,3,6
22083,2023-01-18,AMBER,brawlBall,Sunny Soccer,34,31,65
22084,2023-01-18,AMBER,brawlBall,Beach Ball,1,0,1
22085,2023-01-18,AMBER,bounty,Shooting Star,6,8,14
22086,2023-01-17,AMBER,knockout,Goldarm Gulch,3,5,8
22087,2023-01-17,AMBER,hotZone,Parallel Plays,5,6,11
22088,2023-01-17,AMBER,heist,Pit Stop,1,1,2
22089,2023-01-17,AMBER,gemGrab,Crystal Arcade,4,3,7
22090,2023-01-17,AMBER,brawlBall,Center Stage,0,1,1
22091,2023-01-17,AMBER,brawlBall,Beach Ball,13,11,24
22092,2023-01-17,AMBER,bounty,Hideout,1,0,1
22093,2023-01-16,AMBER,knockout,Belle's Rock,1,1,2
22094,2023-01-16,AMBER,hotZone,Quarter Pounder,12,12,24
22095,2023-01-16,AMBER,heist,Pit Stop,0,2,2
22096,2023-01-16,AMBER,gemGrab,Minecart Madness,2,2,4
22097,2023-01-16,AMBER,gemGrab,Double Swoosh,9,17,26
22098,2023-01-16,AMBER,brawlBall,Center Stage,5,6,11
22099,2023-01-16,AMBER,brawlBall,Backyard Bowl,1,2,3
22100,2023-01-15,AMBER,knockout,Belle's Rock,2,1,3
22101,2023-01-15,AMBER,hotZone,Quarter Pounder,11,6,17
22102,2023-01-15,AMBER,heist,Bridge Too Far,18,42,60
22103,2023-01-15,AMBER,gemGrab,Hard Rock Mine,0,2,2
22104,2023-01-15,AMBER,gemGrab,Double Swoosh,20,36,56
22105,2023-01-15,AMBER,brawlBall,Super Beach,1,1,2
22106,2023-01-15,AMBER,brawlBall,Backyard Bowl,30,28,58
22107,2023-01-14,AMBER,hotZone,Controller Chaos,17,26,43
22108,2023-01-14,AMBER,heist,Bridge Too Far,27,29,56
22109,2023-01-14,AMBER,gemGrab,Hard Rock Mine,1,1,2
22110,2023-01-14,AMBER,gemGrab,Deep Diner,1,2,3
22111,2023-01-14,AMBER,brawlBall,Super Beach,10,2,12
22112,2023-01-14,AMBER,bounty,Canal Grande,1,0,1
22113,2023-01-13,AMBER,knockout,Flaring Phoenix,2,1,3
22114,2023-01-13,AMBER,hotZone,Controller Chaos,18,12,30
22115,2023-01-13,AMBER,heist,Hot Potato,2,0,2
22116,2023-01-13,AMBER,gemGrab,Deep Diner,5,1,6
22117,2023-01-13,AMBER,brawlBall,Sneaky Fields,5,7,12
22118,2023-01-13,AMBER,brawlBall,Pinhole Punt,1,5,6
22119,2023-01-13,AMBER,bounty,Temple Ruins,4,2,6
22120,2023-01-12,AMBER,knockout,Riverside,16,22,38
22121,2023-01-12,AMBER,hotZone,Open Zone,15,35,50
22122,2023-01-12,AMBER,heist,Hot Potato,2,0,2
22123,2023-01-12,AMBER,gemGrab,Undermine,11,14,25
22124,2023-01-12,AMBER,gemGrab,Gem Fort,0,4,4
22125,2023-01-12,AMBER,brawlBall,Pinhole Punt,6,6,12
22126,2023-01-11,AMBER,knockout,Riverside,2,0,2
22127,2023-01-11,AMBER,hotZone,Open Zone,8,13,21
22128,2023-01-11,AMBER,gemGrab,Gem Fort,3,1,4
22129,2023-01-11,AMBER,brawlBall,Sunny Soccer,1,0,1
22130,2023-01-10,AMBER,hotZone,Dueling Beetles,9,9,18
22131,2023-01-10,AMBER,heist,Safe Zone,2,1,3
22132,2023-01-10,AMBER,gemGrab,Minecart Madness,4,6,10
22133,2023-01-10,AMBER,gemGrab,Crystal Arcade,4,0,4
22134,2023-01-10,AMBER,brawlBall,Center Stage,2,2,4
22135,2023-01-10,AMBER,brawlBall,Beach Ball,2,6,8
22136,2023-01-09,AMBER,knockout,New Perspective,0,1,1
22137,2023-01-09,AMBER,hotZone,Dueling Beetles,12,7,19
22138,2023-01-09,AMBER,heist,Snaked Assault,6,6,12
22139,2023-01-09,AMBER,gemGrab,Minecart Madness,5,3,8
22140,2023-01-09,AMBER,gemGrab,Double Swoosh,11,34,45
22141,2023-01-09,AMBER,brawlBall,Center Stage,17,29,46
22142,2023-01-09,AMBER,brawlBall,Backyard Bowl,2,0,2
22143,2023-01-09,AMBER,bounty,Layer Cake,2,0,2
22144,2023-01-08,AMBER,hotZone,Ring of Fire,17,20,37
22145,2023-01-08,AMBER,heist,Snaked Assault,11,6,17
22146,2023-01-08,AMBER,gemGrab,Double Swoosh,4,6,10
22147,2023-01-08,AMBER,brawlBall,Backyard Bowl,27,69,96
22148,2023-01-08,AMBER,bounty,Layer Cake,1,9,10
22149,2023-01-07,AMBER,knockout,X Marks the Spot,2,0,2
22150,2023-01-07,AMBER,hotZone,Ring of Fire,0,2,2
22151,2023-01-07,AMBER,heist,Tornado Ring,3,0,3
22152,2023-01-07,AMBER,gemGrab,Hard Rock Mine,1,1,2
22153,2023-01-07,AMBER,brawlBall,Super Beach,0,2,2
22154,2023-01-07,AMBER,bounty,Dry Season,0,4,4
22155,2023-01-06,AMBER,knockout,Out in the Open,1,0,1
22156,2023-01-06,AMBER,hotZone,Split,1,8,9
22157,2023-01-06,AMBER,heist,Tornado Ring,2,1,3
22158,2023-01-06,AMBER,gemGrab,Undermine,4,12,16
22159,2023-01-06,AMBER,gemGrab,Deep Diner,3,1,4
22160,2023-01-06,AMBER,brawlBall,Sneaky Fields,5,8,13
22161,2023-01-06,AMBER,brawlBall,Pinhole Punt,1,0,1
22162,2023-01-05,AMBER,knockout,Out in the Open,1,2,3
22163,2023-01-05,AMBER,hotZone,Split,4,15,19
22164,2023-01-05,AMBER,heist,Kaboom Canyon,11,28,39
22165,2023-01-05,AMBER,gemGrab,Undermine,16,21,37
22166,2023-01-05,AMBER,brawlBall,Pinhole Punt,6,37,43
22167,2023-01-05,AMBER,bounty,Shooting Star,2,0,2
22168,2023-01-04,AMBER,hotZone,Parallel Plays,6,9,15
22169,2023-01-04,AMBER,heist,Kaboom Canyon,23,17,40
22170,2023-01-04,AMBER,gemGrab,Gem Fort,6,3,9
22171,2023-01-04,AMBER,brawlBall,Sunny Soccer,4,5,9
22172,2023-01-04,AMBER,bounty,Shooting Star,2,0,2
22173,2023-01-03,AMBER,hotZone,Parallel Plays,5,10,15
22174,2023-01-03,AMBER,heist,Pit Stop,2,0,2
22175,2023-01-03,AMBER,gemGrab,Minecart Madness,2,0,2
22176,2023-01-03,AMBER,gemGrab,Crystal Arcade,3,2,5
22177,2023-01-03,AMBER,brawlBall,Center Stage,1,0,1
22178,2023-01-03,AMBER,brawlBall,Beach Ball,13,10,23
22179,2023-01-03,AMBER,bounty,Hideout,0,1,1
22180,2023-01-02,AMBER,knockout,Belle's Rock,2,1,3
22181,2023-01-02,AMBER,hotZone,Quarter Pounder,12,2,14
22182,2023-01-02,AMBER,hotZone,Controller Chaos,1,0,1
22183,2023-01-02,AMBER,gemGrab,Minecart Madness,10,1,11
22184,2023-01-02,AMBER,gemGrab,Double Swoosh,22,37,59
22185,2023-01-02,AMBER,brawlBall,Center Stage,16,23,39
22186,2023-01-02,AMBER,bounty,Hideout,2,0,2
22187,2023-01-01,AMBER,knockout,Belle's Rock,0,1,1
22188,2023-01-01,AMBER,hotZone,Quarter Pounder,4,11,15
22189,2023-01-01,AMBER,heist,Bridge Too Far,5,5,10
22190,2023-01-01,AMBER,gemGrab,Double Swoosh,17,20,37
22191,2023-01-01,AMBER,brawlBall,Backyard Bowl,15,13,28
22192,2022-12-31,AMBER,hotZone,Controller Chaos,1,0,1
22193,2022-12-31,AMBER,heist,Bridge Too Far,2,1,3
22194,2022-12-31,AMBER,gemGrab,Hard Rock Mine,2,0,2
22195,2022-12-31,AMBER,gemGrab,Deep Diner,4,10,14
22196,2022-12-30,AMBER,hotZone,Controller Chaos,1,0,1
22197,2022-12-30,AMBER,brawlBall,Sneaky Fields,2,0,2
22198,2022-12-29,AMBER,hotZone,Open Zone,0,2,2
22199,2022-12-29,AMBER,gemGrab,Undermine,6,13,19
22200,2022-12-29,AMBER,gemGrab,Gem Fort,1,0,1
22201,2022-12-29,AMBER,brawlBall,Pinhole Punt,1,1,2
22202,2022-12-28,AMBER,hotZone,Open Zone,2,3,5
22203,2022-12-28,AMBER,brawlBall,Beach Ball,2,0,2
22204,2022-12-27,AMBER,hotZone,Controller Chaos,2,0,2
22205,2022-12-27,AMBER,brawlBall,Beach Ball,2,0,2
22206,2022-12-26,AMBER,gemGrab,Minecart Madness,0,1,1
22207,2022-12-25,AMBER,hotZone,Ring of Fire,1,0,1
22208,2022-12-25,AMBER,brawlBall,Backyard Bowl,3,2,5
22209,2022-12-24,AMBER,brawlBall,Super Beach,2,1,3
22210,2022-12-19,AMBER,gemGrab,Minecart Madness,2,0,2
22211,2022-12-18,AMBER,heist,Bridge Too Far,0,1,1
22212,2022-12-16,AMBER,brawlBall,Sneaky Fields,1,0,1
22213,2022-12-15,AMBER,heist,Hot Potato,2,0,2
22214,2022-12-10,AMBER,hotZone,Ring of Fire,0,1,1
22215,2023-02-11,8-BIT,knockout,Flaring Phoenix,22,47,69
22216,2023-02-11,8-BIT,hotZone,Controller Chaos,11,31,42
22217,2023-02-11,8-BIT,gemGrab,Deep Diner,20,25,45
22218,2023-02-11,8-BIT,brawlBall,Super Beach,7,6,13
22219,2023-02-11,8-BIT,brawlBall,Sneaky Fields,2,4,6
22220,2023-02-10,8-BIT,knockout,Flaring Phoenix,178,261,439
22221,2023-02-10,8-BIT,hotZone,Controller Chaos,14,7,21
22222,2023-02-10,8-BIT,heist,Hot Potato,34,35,69
22223,2023-02-10,8-BIT,gemGrab,Undermine,22,16,38
22224,2023-02-10,8-BIT,gemGrab,Deep Diner,100,189,289
22225,2023-02-10,8-BIT,brawlBall,Sneaky Fields,44,56,100
22226,2023-02-10,8-BIT,brawlBall,Pinhole Punt,8,3,11
22227,2023-02-10,8-BIT,bounty,Temple Ruins,19,5,24
22228,2023-02-09,8-BIT,knockout,Riverside,8,10,18
22229,2023-02-09,8-BIT,hotZone,Open Zone,3,3,6
22230,2023-02-09,8-BIT,heist,Hot Potato,19,14,33
22231,2023-02-09,8-BIT,gemGrab,Undermine,11,31,42
22232,2023-02-09,8-BIT,gemGrab,Gem Fort,2,2,4
22233,2023-02-09,8-BIT,brawlBall,Pinhole Punt,17,36,53
22234,2023-02-09,8-BIT,bounty,Temple Ruins,16,13,29
22235,2023-02-08,8-BIT,hotZone,Open Zone,2,2,4
22236,2023-02-08,8-BIT,heist,Safe Zone,17,23,40
22237,2023-02-08,8-BIT,gemGrab,Gem Fort,2,1,3
22238,2023-02-08,8-BIT,gemGrab,Crystal Arcade,2,5,7
22239,2023-02-08,8-BIT,brawlBall,Sunny Soccer,3,3,6
22240,2023-02-08,8-BIT,bounty,Excel,0,1,1
22241,2023-02-07,8-BIT,knockout,New Perspective,4,3,7
22242,2023-02-07,8-BIT,hotZone,Dueling Beetles,2,1,3
22243,2023-02-07,8-BIT,heist,Safe Zone,2,2,4
22244,2023-02-07,8-BIT,gemGrab,Minecart Madness,1,4,5
22245,2023-02-07,8-BIT,gemGrab,Crystal Arcade,2,3,5
22246,2023-02-07,8-BIT,brawlBall,Beach Ball,1,1,2
22247,2023-02-06,8-BIT,knockout,New Perspective,87,180,267
22248,2023-02-06,8-BIT,knockout,Goldarm Gulch,1,1,2
22249,2023-02-06,8-BIT,hotZone,Dueling Beetles,24,26,50
22250,2023-02-06,8-BIT,heist,Snaked Assault,114,140,254
22251,2023-02-06,8-BIT,gemGrab,Minecart Madness,103,185,288
22252,2023-02-06,8-BIT,gemGrab,Double Swoosh,34,43,77
22253,2023-02-06,8-BIT,brawlBall,Sneaky Fields,2,2,4
22254,2023-02-06,8-BIT,brawlBall,Center Stage,46,92,138
22255,2023-02-06,8-BIT,brawlBall,Backyard Bowl,28,26,54
22256,2023-02-06,8-BIT,bounty,Layer Cake,4,4,8
22257,2023-02-05,8-BIT,knockout,X Marks the Spot,74,114,188
22258,2023-02-05,8-BIT,hotZone,Ring of Fire,30,10,40
22259,2023-02-05,8-BIT,heist,Snaked Assault,203,266,469
22260,2023-02-05,8-BIT,heist,Pit Stop,6,4,10
22261,2023-02-05,8-BIT,gemGrab,Hard Rock Mine,28,39,67
22262,2023-02-05,8-BIT,gemGrab,Double Swoosh,89,62,151
22263,2023-02-05,8-BIT,brawlBall,Super Beach,2,0,2
22264,2023-02-05,8-BIT,brawlBall,Sneaky Fields,5,1,6
22265,2023-02-05,8-BIT,brawlBall,Backyard Bowl,313,433,746
22266,2023-02-05,8-BIT,bounty,Layer Cake,5,4,9
22267,2023-02-04,8-BIT,knockout,X Marks the Spot,48,72,120
22268,2023-02-04,8-BIT,hotZone,Ring of Fire,13,5,18
22269,2023-02-04,8-BIT,heist,Tornado Ring,5,10,15
22270,2023-02-04,8-BIT,heist,Pit Stop,1,0,1
22271,2023-02-04,8-BIT,gemGrab,Hard Rock Mine,49,109,158
22272,2023-02-04,8-BIT,gemGrab,Double Swoosh,22,5,27
22273,2023-02-04,8-BIT,gemGrab,Deep Diner,4,3,7
22274,2023-02-04,8-BIT,brawlBall,Super Beach,13,8,21
22275,2023-02-04,8-BIT,brawlBall,Sneaky Fields,6,0,6
22276,2023-02-04,8-BIT,bounty,Dry Season,1,6,7
22277,2023-02-03,8-BIT,knockout,Out in the Open,37,41,78
22278,2023-02-03,8-BIT,knockout,Goldarm Gulch,6,12,18
22279,2023-02-03,8-BIT,hotZone,Split,10,4,14
22280,2023-02-03,8-BIT,heist,Tornado Ring,32,18,50
22281,2023-02-03,8-BIT,heist,Pit Stop,16,5,21
22282,2023-02-03,8-BIT,gemGrab,Undermine,18,18,36
22283,2023-02-03,8-BIT,gemGrab,Double Swoosh,121,31,152
22284,2023-02-03,8-BIT,gemGrab,Deep Diner,49,49,98
22285,2023-02-03,8-BIT,brawlBall,Sneaky Fields,53,40,93
22286,2023-02-03,8-BIT,brawlBall,Pinhole Punt,10,6,16
22287,2023-02-03,8-BIT,bounty,Dry Season,30,45,75
22288,2023-02-02,8-BIT,knockout,Out in the Open,21,20,41
22289,2023-02-02,8-BIT,hotZone,Split,3,1,4
22290,2023-02-02,8-BIT,heist,Kaboom Canyon,15,23,38
22291,2023-02-02,8-BIT,gemGrab,Undermine,16,28,44
22292,2023-02-02,8-BIT,gemGrab,Gem Fort,2,7,9
22293,2023-02-02,8-BIT,brawlBall,Sunny Soccer,1,0,1
22294,2023-02-02,8-BIT,brawlBall,Pinhole Punt,33,56,89
22295,2023-02-02,8-BIT,bounty,Shooting Star,7,3,10
22296,2023-02-01,8-BIT,knockout,Goldarm Gulch,28,28,56
22297,2023-02-01,8-BIT,hotZone,Parallel Plays,7,4,11
22298,2023-02-01,8-BIT,heist,Kaboom Canyon,73,73,146
22299,2023-02-01,8-BIT,gemGrab,Gem Fort,32,73,105
22300,2023-02-01,8-BIT,gemGrab,Crystal Arcade,30,36,66
22301,2023-02-01,8-BIT,brawlBall,Sunny Soccer,24,43,67
22302,2023-02-01,8-BIT,brawlBall,Beach Ball,0,3,3
22303,2023-02-01,8-BIT,bounty,Shooting Star,13,18,31
22304,2023-01-31,8-BIT,knockout,Goldarm Gulch,15,11,26
22305,2023-01-31,8-BIT,hotZone,Parallel Plays,5,3,8
22306,2023-01-31,8-BIT,heist,Pit Stop,6,12,18
22307,2023-01-31,8-BIT,gemGrab,Minecart Madness,8,6,14
22308,2023-01-31,8-BIT,gemGrab,Crystal Arcade,44,56,100
22309,2023-01-31,8-BIT,brawlBall,Center Stage,2,0,2
22310,2023-01-31,8-BIT,brawlBall,Beach Ball,22,21,43
22311,2023-01-31,8-BIT,bounty,Hideout,2,5,7
22312,2023-01-30,8-BIT,knockout,Belle's Rock,11,11,22
22313,2023-01-30,8-BIT,hotZone,Quarter Pounder,37,28,65
22314,2023-01-30,8-BIT,heist,Pit Stop,4,6,10
22315,2023-01-30,8-BIT,gemGrab,Minecart Madness,17,52,69
22316,2023-01-30,8-BIT,gemGrab,Double Swoosh,31,32,63
22317,2023-01-30,8-BIT,brawlBall,Center Stage,40,36,76
22318,2023-01-30,8-BIT,brawlBall,Backyard Bowl,30,43,73
22319,2023-01-30,8-BIT,bounty,Hideout,2,2,4
22320,2023-01-29,8-BIT,knockout,Belle's Rock,13,8,21
22321,2023-01-29,8-BIT,hotZone,Quarter Pounder,19,11,30
22322,2023-01-29,8-BIT,heist,Bridge Too Far,268,271,539
22323,2023-01-29,8-BIT,gemGrab,Hard Rock Mine,21,22,43
22324,2023-01-29,8-BIT,gemGrab,Double Swoosh,33,39,72
22325,2023-01-29,8-BIT,brawlBall,Super Beach,2,1,3
22326,2023-01-29,8-BIT,brawlBall,Backyard Bowl,217,350,567
22327,2023-01-28,8-BIT,knockout,Flaring Phoenix,37,60,97
22328,2023-01-28,8-BIT,hotZone,Controller Chaos,7,3,10
22329,2023-01-28,8-BIT,heist,Bridge Too Far,602,732,1334
22330,2023-01-28,8-BIT,gemGrab,Hard Rock Mine,163,262,425
22331,2023-01-28,8-BIT,gemGrab,Deep Diner,26,29,55
22332,2023-01-28,8-BIT,brawlBall,Super Beach,36,45,81
22333,2023-01-28,8-BIT,brawlBall,Sneaky Fields,0,4,4
22334,2023-01-28,8-BIT,bounty,Canal Grande,6,3,9
22335,2023-01-27,8-BIT,knockout,Flaring Phoenix,21,27,48
22336,2023-01-27,8-BIT,hotZone,Controller Chaos,3,1,4
22337,2023-01-27,8-BIT,heist,Hot Potato,20,9,29
22338,2023-01-27,8-BIT,gemGrab,Undermine,6,20,26
22339,2023-01-27,8-BIT,gemGrab,Deep Diner,20,38,58
22340,2023-01-27,8-BIT,brawlBall,Sneaky Fields,16,18,34
22341,2023-01-27,8-BIT,brawlBall,Pinhole Punt,2,0,2
22342,2023-01-27,8-BIT,bounty,Temple Ruins,8,13,21
22343,2023-01-26,8-BIT,knockout,Riverside,55,52,107
22344,2023-01-26,8-BIT,hotZone,Open Zone,32,30,62
22345,2023-01-26,8-BIT,heist,Hot Potato,68,61,129
22346,2023-01-26,8-BIT,gemGrab,Undermine,48,56,104
22347,2023-01-26,8-BIT,gemGrab,Gem Fort,22,27,49
22348,2023-01-26,8-BIT,brawlBall,Sunny Soccer,2,2,4
22349,2023-01-26,8-BIT,brawlBall,Pinhole Punt,102,163,265
22350,2023-01-26,8-BIT,bounty,Temple Ruins,11,5,16
22351,2023-01-25,8-BIT,knockout,Riverside,20,27,47
22352,2023-01-25,8-BIT,hotZone,Open Zone,32,30,62
22353,2023-01-25,8-BIT,heist,Safe Zone,101,125,226
22354,2023-01-25,8-BIT,gemGrab,Gem Fort,16,18,34
22355,2023-01-25,8-BIT,gemGrab,Crystal Arcade,27,46,73
22356,2023-01-25,8-BIT,brawlBall,Sunny Soccer,15,33,48
22357,2023-01-25,8-BIT,brawlBall,Beach Ball,4,3,7
22358,2023-01-25,8-BIT,bounty,Excel,3,4,7
22359,2023-01-24,8-BIT,knockout,New Perspective,17,12,29
22360,2023-01-24,8-BIT,hotZone,Dueling Beetles,16,7,23
22361,2023-01-24,8-BIT,heist,Safe Zone,166,248,414
22362,2023-01-24,8-BIT,gemGrab,Minecart Madness,20,14,34
22363,2023-01-24,8-BIT,gemGrab,Crystal Arcade,51,100,151
22364,2023-01-24,8-BIT,brawlBall,Center Stage,2,3,5
22365,2023-01-24,8-BIT,brawlBall,Beach Ball,53,42,95
22366,2023-01-24,8-BIT,bounty,Excel,3,8,11
22367,2023-01-23,8-BIT,knockout,New Perspective,40,60,100
22368,2023-01-23,8-BIT,hotZone,Dueling Beetles,14,9,23
22369,2023-01-23,8-BIT,heist,Snaked Assault,117,114,231
22370,2023-01-23,8-BIT,gemGrab,Minecart Madness,120,149,269
22371,2023-01-23,8-BIT,gemGrab,Double Swoosh,14,13,27
22372,2023-01-23,8-BIT,brawlBall,Center Stage,69,55,124
22373,2023-01-23,8-BIT,brawlBall,Backyard Bowl,10,7,17
22374,2023-01-23,8-BIT,bounty,Layer Cake,6,3,9
22375,2023-01-22,8-BIT,knockout,X Marks the Spot,47,79,126
22376,2023-01-22,8-BIT,hotZone,Ring of Fire,13,8,21
22377,2023-01-22,8-BIT,heist,Snaked Assault,52,92,144
22378,2023-01-22,8-BIT,gemGrab,Hard Rock Mine,28,63,91
22379,2023-01-22,8-BIT,gemGrab,Double Swoosh,19,10,29
22380,2023-01-22,8-BIT,brawlBall,Super Beach,2,2,4
22381,2023-01-22,8-BIT,brawlBall,Backyard Bowl,116,130,246
22382,2023-01-22,8-BIT,bounty,Layer Cake,3,5,8
22383,2023-01-21,8-BIT,knockout,X Marks the Spot,159,250,409
22384,2023-01-21,8-BIT,hotZone,Ring of Fire,53,40,93
22385,2023-01-21,8-BIT,heist,Tornado Ring,44,28,72
22386,2023-01-21,8-BIT,gemGrab,Hard Rock Mine,207,397,604
22387,2023-01-21,8-BIT,gemGrab,Deep Diner,10,17,27
22388,2023-01-21,8-BIT,brawlBall,Super Beach,76,120,196
22389,2023-01-21,8-BIT,brawlBall,Sneaky Fields,2,0,2
22390,2023-01-21,8-BIT,bounty,Dry Season,18,18,36
22391,2023-01-20,8-BIT,knockout,Out in the Open,30,42,72
22392,2023-01-20,8-BIT,hotZone,Split,3,5,8
22393,2023-01-20,8-BIT,heist,Tornado Ring,60,39,99
22394,2023-01-20,8-BIT,gemGrab,Undermine,21,58,79
22395,2023-01-20,8-BIT,gemGrab,Deep Diner,60,56,116
22396,2023-01-20,8-BIT,brawlBall,Sneaky Fields,43,51,94
22397,2023-01-20,8-BIT,brawlBall,Pinhole Punt,2,2,4
22398,2023-01-20,8-BIT,bounty,Dry Season,16,29,45
22399,2023-01-19,8-BIT,knockout,Out in the Open,42,61,103
22400,2023-01-19,8-BIT,hotZone,Split,9,4,13
22401,2023-01-19,8-BIT,heist,Kaboom Canyon,83,79,162
22402,2023-01-19,8-BIT,gemGrab,Undermine,67,119,186
22403,2023-01-19,8-BIT,gemGrab,Gem Fort,17,27,44
22404,2023-01-19,8-BIT,brawlBall,Sunny Soccer,0,2,2
22405,2023-01-19,8-BIT,brawlBall,Pinhole Punt,93,98,191
22406,2023-01-19,8-BIT,bounty,Shooting Star,11,13,24
22407,2023-01-18,8-BIT,knockout,Goldarm Gulch,3,17,20
22408,2023-01-18,8-BIT,hotZone,Parallel Plays,1,1,2
22409,2023-01-18,8-BIT,heist,Kaboom Canyon,42,34,76
22410,2023-01-18,8-BIT,gemGrab,Gem Fort,5,8,13
22411,2023-01-18,8-BIT,gemGrab,Crystal Arcade,10,25,35
22412,2023-01-18,8-BIT,brawlBall,Sunny Soccer,7,7,14
22413,2023-01-18,8-BIT,bounty,Shooting Star,17,13,30
22414,2023-01-17,8-BIT,knockout,Goldarm Gulch,2,0,2
22415,2023-01-17,8-BIT,hotZone,Parallel Plays,1,1,2
22416,2023-01-17,8-BIT,gemGrab,Minecart Madness,1,1,2
22417,2023-01-17,8-BIT,gemGrab,Crystal Arcade,3,7,10
22418,2023-01-17,8-BIT,brawlBall,Center Stage,1,0,1
22419,2023-01-17,8-BIT,brawlBall,Beach Ball,5,1,6
22420,2023-01-16,8-BIT,knockout,Belle's Rock,3,1,4
22421,2023-01-16,8-BIT,hotZone,Quarter Pounder,3,3,6
22422,2023-01-16,8-BIT,gemGrab,Minecart Madness,8,5,13
22423,2023-01-16,8-BIT,gemGrab,Double Swoosh,1,0,1
22424,2023-01-16,8-BIT,brawlBall,Center Stage,7,5,12
22425,2023-01-16,8-BIT,brawlBall,Backyard Bowl,3,2,5
22426,2023-01-15,8-BIT,hotZone,Quarter Pounder,8,3,11
22427,2023-01-15,8-BIT,heist,Bridge Too Far,78,102,180
22428,2023-01-15,8-BIT,gemGrab,Hard Rock Mine,6,14,20
22429,2023-01-15,8-BIT,gemGrab,Double Swoosh,2,0,2
22430,2023-01-15,8-BIT,brawlBall,Backyard Bowl,30,35,65
22431,2023-01-15,8-BIT,bounty,Canal Grande,2,0,2
22432,2023-01-14,8-BIT,knockout,Flaring Phoenix,0,2,2
22433,2023-01-14,8-BIT,hotZone,Controller Chaos,1,0,1
22434,2023-01-14,8-BIT,heist,Bridge Too Far,101,184,285
22435,2023-01-14,8-BIT,gemGrab,Hard Rock Mine,17,54,71
22436,2023-01-14,8-BIT,gemGrab,Deep Diner,5,5,10
22437,2023-01-14,8-BIT,brawlBall,Super Beach,2,0,2
22438,2023-01-14,8-BIT,bounty,Canal Grande,1,0,1
22439,2023-01-13,8-BIT,heist,Hot Potato,1,0,1
22440,2023-01-13,8-BIT,gemGrab,Deep Diner,5,48,53
22441,2023-01-13,8-BIT,brawlBall,Sneaky Fields,2,0,2
22442,2023-01-13,8-BIT,bounty,Temple Ruins,0,1,1
22443,2023-01-12,8-BIT,knockout,Riverside,8,2,10
22444,2023-01-12,8-BIT,hotZone,Open Zone,4,0,4
22445,2023-01-12,8-BIT,gemGrab,Undermine,1,0,1
22446,2023-01-12,8-BIT,gemGrab,Gem Fort,1,3,4
22447,2023-01-12,8-BIT,brawlBall,Pinhole Punt,2,3,5
22448,2023-01-11,8-BIT,knockout,Riverside,3,0,3
22449,2023-01-11,8-BIT,heist,Safe Zone,1,1,2
22450,2023-01-10,8-BIT,knockout,New Perspective,0,1,1
22451,2023-01-10,8-BIT,hotZone,Dueling Beetles,2,1,3
22452,2023-01-10,8-BIT,heist,Safe Zone,10,3,13
22453,2023-01-10,8-BIT,gemGrab,Minecart Madness,2,11,13
22454,2023-01-10,8-BIT,gemGrab,Crystal Arcade,1,1,2
22455,2023-01-10,8-BIT,brawlBall,Beach Ball,2,5,7
22456,2023-01-09,8-BIT,knockout,New Perspective,0,3,3
22457,2023-01-09,8-BIT,heist,Snaked Assault,14,61,75
22458,2023-01-09,8-BIT,gemGrab,Minecart Madness,5,39,44
22459,2023-01-09,8-BIT,gemGrab,Double Swoosh,2,0,2
22460,2023-01-09,8-BIT,brawlBall,Center Stage,2,2,4
22461,2023-01-09,8-BIT,brawlBall,Backyard Bowl,2,0,2
22462,2023-01-09,8-BIT,bounty,Layer Cake,2,0,2
22463,2023-01-08,8-BIT,knockout,X Marks the Spot,3,0,3
22464,2023-01-08,8-BIT,hotZone,Ring of Fire,1,0,1
22465,2023-01-08,8-BIT,heist,Snaked Assault,6,4,10
22466,2023-01-08,8-BIT,gemGrab,Hard Rock Mine,2,8,10
22467,2023-01-08,8-BIT,brawlBall,Backyard Bowl,10,41,51
22468,2023-01-08,8-BIT,bounty,Layer Cake,1,0,1
22469,2023-01-07,8-BIT,knockout,X Marks the Spot,6,3,9
22470,2023-01-07,8-BIT,hotZone,Ring of Fire,1,3,4
22471,2023-01-07,8-BIT,heist,Tornado Ring,5,22,27
22472,2023-01-07,8-BIT,gemGrab,Hard Rock Mine,9,24,33
22473,2023-01-07,8-BIT,gemGrab,Deep Diner,2,23,25
22474,2023-01-06,8-BIT,heist,Tornado Ring,14,23,37
22475,2023-01-06,8-BIT,gemGrab,Undermine,1,0,1
22476,2023-01-06,8-BIT,gemGrab,Deep Diner,10,39,49
22477,2023-01-06,8-BIT,brawlBall,Sneaky Fields,2,1,3
22478,2023-01-06,8-BIT,brawlBall,Pinhole Punt,1,0,1
22479,2023-01-06,8-BIT,bounty,Dry Season,2,0,2
22480,2023-01-05,8-BIT,knockout,Out in the Open,1,2,3
22481,2023-01-05,8-BIT,heist,Kaboom Canyon,10,31,41
22482,2023-01-05,8-BIT,gemGrab,Undermine,3,5,8
22483,2023-01-05,8-BIT,brawlBall,Pinhole Punt,1,2,3
22484,2023-01-05,8-BIT,bounty,Shooting Star,2,0,2
22485,2023-01-04,8-BIT,knockout,Goldarm Gulch,2,10,12
22486,2023-01-04,8-BIT,hotZone,Parallel Plays,2,0,2
22487,2023-01-04,8-BIT,heist,Kaboom Canyon,10,10,20
22488,2023-01-04,8-BIT,gemGrab,Gem Fort,1,1,2
22489,2023-01-04,8-BIT,gemGrab,Crystal Arcade,1,1,2
22490,2023-01-04,8-BIT,brawlBall,Sunny Soccer,4,9,13
22491,2023-01-04,8-BIT,bounty,Shooting Star,1,0,1
22492,2023-01-03,8-BIT,heist,Pit Stop,4,1,5
22493,2023-01-03,8-BIT,gemGrab,Crystal Arcade,11,24,35
22494,2023-01-03,8-BIT,brawlBall,Beach Ball,2,0,2
22495,2023-01-03,8-BIT,bounty,Hideout,1,0,1
22496,2023-01-02,8-BIT,hotZone,Quarter Pounder,3,1,4
22497,2023-01-02,8-BIT,heist,Pit Stop,2,0,2
22498,2023-01-02,8-BIT,heist,Kaboom Canyon,1,0,1
22499,2023-01-02,8-BIT,gemGrab,Minecart Madness,11,12,23
22500,2023-01-02,8-BIT,gemGrab,Double Swoosh,8,22,30
22501,2023-01-02,8-BIT,brawlBall,Center Stage,2,3,5
22502,2023-01-02,8-BIT,bounty,Hideout,1,2,3
22503,2023-01-01,8-BIT,knockout,Belle's Rock,0,1,1
22504,2023-01-01,8-BIT,hotZone,Controller Chaos,2,0,2
22505,2023-01-01,8-BIT,heist,Bridge Too Far,17,26,43
22506,2023-01-01,8-BIT,gemGrab,Hard Rock Mine,5,3,8
22507,2023-01-01,8-BIT,gemGrab,Double Swoosh,5,12,17
22508,2023-01-01,8-BIT,brawlBall,Backyard Bowl,7,15,22
22509,2022-12-31,8-BIT,heist,Bridge Too Far,4,7,11
22510,2022-12-31,8-BIT,gemGrab,Hard Rock Mine,4,9,13
22511,2022-12-30,8-BIT,hotZone,Controller Chaos,0,1,1
22512,2022-12-30,8-BIT,heist,Kaboom Canyon,3,0,3
22513,2022-12-30,8-BIT,gemGrab,Undermine,0,1,1
22514,2022-12-30,8-BIT,gemGrab,Minecart Madness,1,1,2
22515,2022-12-30,8-BIT,gemGrab,Deep Diner,2,7,9
22516,2022-12-30,8-BIT,brawlBall,Sneaky Fields,1,0,1
22517,2022-12-29,8-BIT,gemGrab,Undermine,1,0,1
22518,2022-12-28,8-BIT,hotZone,Controller Chaos,0,2,2
22519,2022-12-28,8-BIT,heist,Kaboom Canyon,0,2,2
22520,2022-12-28,8-BIT,gemGrab,Minecart Madness,2,0,2
22521,2022-12-27,8-BIT,heist,Kaboom Canyon,1,0,1
22522,2022-12-27,8-BIT,gemGrab,Minecart Madness,2,0,2
22523,2022-12-26,8-BIT,gemGrab,Minecart Madness,2,0,2
22524,2022-10-30,8-BIT,heist,Safe Zone,1,0,1
22525,2022-10-15,8-BIT,gemGrab,Hard Rock Mine,0,2,2
22526,2022-10-15,8-BIT,brawlBall,Super Beach,1,0,1
