,battleTime,brawlername,event.mode,event.map,d,n,y,total_games
0,2023-01-30,TICK,knockout,Belle's Rock,1,1037,910,1948
1,2023-01-30,TICK,hotZone,Quarter Pounder,3,513,144,660
2,2023-01-30,TICK,heist,Pit Stop,0,19,7,26
3,2023-01-30,TICK,gemGrab,Minecart Madness,0,583,372,955
4,2023-01-30,TICK,gemGrab,Double Swoosh,0,73,31,104
5,2023-01-30,TICK,brawlBall,Center Stage,10,348,247,605
6,2023-01-30,TICK,brawlBall,Backyard Bowl,0,37,20,57
7,2023-01-30,TICK,bounty,Hideout,0,211,136,347
8,2023-01-29,TICK,knockout,Belle's Rock,0,947,849,1796
9,2023-01-29,TICK,hotZone,Quarter Pounder,2,304,62,368
10,2023-01-29,TICK,heist,Bridge Too Far,0,16,5,21
11,2023-01-29,TICK,gemGrab,Hard Rock Mine,0,23,9,32
12,2023-01-29,TICK,gemGrab,Double Swoosh,0,144,85,229
13,2023-01-29,TICK,brawlBall,Super Beach,0,10,2,12
14,2023-01-29,TICK,brawlBall,Backyard Bowl,7,318,160,485
15,2023-01-29,TICK,bounty,Canal Grande,0,363,207,570
16,2023-01-28,TICK,knockout,Flaring Phoenix,2,318,232,552
17,2023-01-28,TICK,hotZone,Controller Chaos,0,211,46,257
18,2023-01-28,TICK,heist,Bridge Too Far,0,31,11,42
19,2023-01-28,TICK,gemGrab,Hard Rock Mine,0,153,74,227
20,2023-01-28,TICK,gemGrab,Deep Diner,0,95,58,153
21,2023-01-28,TICK,brawlBall,Super Beach,13,517,353,883
22,2023-01-28,TICK,brawlBall,Sneaky Fields,0,19,8,27
23,2023-01-28,TICK,bounty,Canal Grande,0,580,370,950
24,2023-01-27,TICK,knockout,Flaring Phoenix,0,132,94,226
25,2023-01-27,TICK,hotZone,Controller Chaos,0,60,20,80
26,2023-01-27,TICK,heist,Hot Potato,0,8,1,9
27,2023-01-27,TICK,gemGrab,Undermine,0,9,5,14
28,2023-01-27,TICK,gemGrab,Deep Diner,0,123,71,194
29,2023-01-27,TICK,brawlBall,Sneaky Fields,4,110,84,198
30,2023-01-27,TICK,brawlBall,Pinhole Punt,0,5,3,8
31,2023-01-27,TICK,bounty,Temple Ruins,0,46,20,66
32,2023-01-26,TICK,knockout,Riverside,0,305,186,491
33,2023-01-26,TICK,hotZone,Open Zone,0,212,58,270
34,2023-01-26,TICK,heist,Hot Potato,0,17,5,22
35,2023-01-26,TICK,gemGrab,Undermine,0,71,35,106
36,2023-01-26,TICK,gemGrab,Gem Fort,0,23,16,39
37,2023-01-26,TICK,brawlBall,Sunny Soccer,0,36,20,56
38,2023-01-26,TICK,brawlBall,Pinhole Punt,12,410,235,657
39,2023-01-26,TICK,bounty,Temple Ruins,0,146,97,243
40,2023-01-25,TICK,knockout,Riverside,0,123,102,225
41,2023-01-25,TICK,hotZone,Open Zone,0,84,40,124
42,2023-01-25,TICK,heist,Safe Zone,0,28,5,33
43,2023-01-25,TICK,gemGrab,Gem Fort,0,43,26,69
44,2023-01-25,TICK,gemGrab,Crystal Arcade,0,101,29,130
45,2023-01-25,TICK,brawlBall,Sunny Soccer,9,375,276,660
46,2023-01-25,TICK,brawlBall,Beach Ball,1,63,46,110
47,2023-01-25,TICK,bounty,Excel,0,496,305,801
48,2023-01-24,TICK,knockout,New Perspective,0,194,177,371
49,2023-01-24,TICK,hotZone,Dueling Beetles,0,388,144,532
50,2023-01-24,TICK,heist,Safe Zone,0,80,23,103
51,2023-01-24,TICK,gemGrab,Minecart Madness,0,213,118,331
52,2023-01-24,TICK,gemGrab,Crystal Arcade,0,148,69,217
53,2023-01-24,TICK,brawlBall,Center Stage,2,41,39,82
54,2023-01-24,TICK,brawlBall,Beach Ball,13,554,345,912
55,2023-01-24,TICK,bounty,Excel,0,816,558,1374
56,2023-01-23,TICK,knockout,New Perspective,1,339,229,569
57,2023-01-23,TICK,hotZone,Dueling Beetles,3,548,175,726
58,2023-01-23,TICK,heist,Snaked Assault,0,24,2,26
59,2023-01-23,TICK,gemGrab,Minecart Madness,0,889,518,1407
60,2023-01-23,TICK,gemGrab,Double Swoosh,0,51,27,78
61,2023-01-23,TICK,brawlBall,Center Stage,15,564,409,988
62,2023-01-23,TICK,brawlBall,Backyard Bowl,1,27,15,43
63,2023-01-23,TICK,bounty,Layer Cake,0,845,599,1444
64,2023-01-22,TICK,knockout,X Marks the Spot,0,204,146,350
65,2023-01-22,TICK,hotZone,Ring of Fire,2,186,55,243
66,2023-01-22,TICK,heist,Snaked Assault,0,15,2,17
67,2023-01-22,TICK,gemGrab,Hard Rock Mine,0,36,16,52
68,2023-01-22,TICK,gemGrab,Double Swoosh,0,67,39,106
69,2023-01-22,TICK,brawlBall,Super Beach,0,55,29,84
70,2023-01-22,TICK,brawlBall,Backyard Bowl,1,169,96,266
71,2023-01-22,TICK,bounty,Layer Cake,0,397,322,719
72,2023-01-21,TICK,knockout,X Marks the Spot,2,737,571,1310
73,2023-01-21,TICK,hotZone,Ring of Fire,2,513,206,721
74,2023-01-21,TICK,heist,Tornado Ring,0,14,9,23
75,2023-01-21,TICK,gemGrab,Hard Rock Mine,0,213,98,311
76,2023-01-21,TICK,gemGrab,Deep Diner,0,68,63,131
77,2023-01-21,TICK,brawlBall,Super Beach,19,666,417,1102
78,2023-01-21,TICK,brawlBall,Sneaky Fields,0,19,18,37
79,2023-01-21,TICK,bounty,Dry Season,0,739,603,1342
80,2023-01-20,TICK,knockout,Out in the Open,0,376,298,674
81,2023-01-20,TICK,hotZone,Split,0,459,190,649
82,2023-01-20,TICK,heist,Tornado Ring,0,12,1,13
83,2023-01-20,TICK,gemGrab,Undermine,0,51,23,74
84,2023-01-20,TICK,gemGrab,Deep Diner,0,428,258,686
85,2023-01-20,TICK,brawlBall,Sneaky Fields,11,389,226,626
86,2023-01-20,TICK,brawlBall,Pinhole Punt,0,28,15,43
87,2023-01-20,TICK,bounty,Dry Season,0,506,470,976
88,2023-01-19,TICK,knockout,Out in the Open,1,482,420,903
89,2023-01-19,TICK,hotZone,Split,0,596,297,893
90,2023-01-19,TICK,heist,Kaboom Canyon,0,25,6,31
91,2023-01-19,TICK,gemGrab,Undermine,0,158,70,228
92,2023-01-19,TICK,gemGrab,Gem Fort,0,26,14,40
93,2023-01-19,TICK,brawlBall,Sunny Soccer,0,27,21,48
94,2023-01-19,TICK,brawlBall,Pinhole Punt,12,440,310,762
95,2023-01-19,TICK,bounty,Shooting Star,0,520,361,881
96,2023-01-18,TICK,knockout,Goldarm Gulch,0,46,46,92
97,2023-01-18,TICK,hotZone,Parallel Plays,0,49,16,65
98,2023-01-18,TICK,heist,Kaboom Canyon,0,5,0,5
99,2023-01-18,TICK,gemGrab,Gem Fort,0,22,17,39
100,2023-01-18,TICK,gemGrab,Crystal Arcade,0,5,3,8
101,2023-01-18,TICK,brawlBall,Sunny Soccer,5,185,136,326
102,2023-01-18,TICK,brawlBall,Beach Ball,0,5,7,12
103,2023-01-18,TICK,bounty,Shooting Star,0,213,176,389
104,2023-01-17,TICK,knockout,Goldarm Gulch,0,29,12,41
105,2023-01-17,TICK,hotZone,Parallel Plays,0,7,7,14
106,2023-01-17,TICK,heist,Pit Stop,0,1,1,2
107,2023-01-17,TICK,gemGrab,Minecart Madness,0,9,4,13
108,2023-01-17,TICK,gemGrab,Crystal Arcade,0,13,4,17
109,2023-01-17,TICK,brawlBall,Center Stage,0,1,1,2
110,2023-01-17,TICK,brawlBall,Beach Ball,1,45,24,70
111,2023-01-17,TICK,bounty,Hideout,0,26,27,53
112,2023-01-16,TICK,knockout,Belle's Rock,0,61,44,105
113,2023-01-16,TICK,hotZone,Quarter Pounder,0,59,2,61
114,2023-01-16,TICK,heist,Pit Stop,0,0,1,1
115,2023-01-16,TICK,gemGrab,Minecart Madness,0,66,38,104
116,2023-01-16,TICK,gemGrab,Double Swoosh,0,3,1,4
117,2023-01-16,TICK,brawlBall,Center Stage,0,24,19,43
118,2023-01-16,TICK,brawlBall,Backyard Bowl,0,6,1,7
119,2023-01-16,TICK,bounty,Hideout,0,79,55,134
120,2023-01-15,TICK,knockout,Belle's Rock,0,118,79,197
121,2023-01-15,TICK,hotZone,Quarter Pounder,0,85,4,89
122,2023-01-15,TICK,heist,Bridge Too Far,0,4,1,5
123,2023-01-15,TICK,gemGrab,Hard Rock Mine,0,3,1,4
124,2023-01-15,TICK,gemGrab,Double Swoosh,0,12,6,18
125,2023-01-15,TICK,brawlBall,Super Beach,0,6,2,8
126,2023-01-15,TICK,brawlBall,Backyard Bowl,1,39,13,53
127,2023-01-15,TICK,bounty,Canal Grande,0,39,11,50
128,2023-01-14,TICK,knockout,Flaring Phoenix,0,23,12,35
129,2023-01-14,TICK,hotZone,Controller Chaos,0,61,7,68
130,2023-01-14,TICK,heist,Bridge Too Far,0,4,1,5
131,2023-01-14,TICK,gemGrab,Hard Rock Mine,0,6,0,6
132,2023-01-14,TICK,gemGrab,Deep Diner,0,14,4,18
133,2023-01-14,TICK,brawlBall,Super Beach,1,39,22,62
134,2023-01-14,TICK,brawlBall,Sneaky Fields,0,4,1,5
135,2023-01-14,TICK,bounty,Canal Grande,0,41,12,53
136,2023-01-13,TICK,knockout,Flaring Phoenix,0,28,9,37
137,2023-01-13,TICK,hotZone,Controller Chaos,0,43,15,58
138,2023-01-13,TICK,heist,Hot Potato,0,1,0,1
139,2023-01-13,TICK,gemGrab,Deep Diner,0,28,6,34
140,2023-01-13,TICK,brawlBall,Sneaky Fields,1,15,6,22
141,2023-01-13,TICK,bounty,Temple Ruins,0,8,5,13
142,2023-01-12,TICK,knockout,Riverside,0,25,13,38
143,2023-01-12,TICK,hotZone,Open Zone,0,23,0,23
144,2023-01-12,TICK,gemGrab,Undermine,0,5,2,7
145,2023-01-12,TICK,brawlBall,Sunny Soccer,0,1,0,1
146,2023-01-12,TICK,brawlBall,Pinhole Punt,0,13,2,15
147,2023-01-11,TICK,knockout,Riverside,0,2,2,4
148,2023-01-11,TICK,hotZone,Open Zone,0,6,1,7
149,2023-01-11,TICK,heist,Safe Zone,0,1,0,1
150,2023-01-11,TICK,gemGrab,Gem Fort,0,2,0,2
151,2023-01-11,TICK,brawlBall,Sunny Soccer,0,14,9,23
152,2023-01-11,TICK,brawlBall,Beach Ball,0,2,0,2
153,2023-01-11,TICK,bounty,Excel,0,33,9,42
154,2023-01-10,TICK,knockout,New Perspective,0,9,3,12
155,2023-01-10,TICK,hotZone,Dueling Beetles,0,63,11,74
156,2023-01-10,TICK,heist,Safe Zone,0,2,0,2
157,2023-01-10,TICK,gemGrab,Minecart Madness,0,31,5,36
158,2023-01-10,TICK,gemGrab,Crystal Arcade,0,15,1,16
159,2023-01-10,TICK,brawlBall,Center Stage,0,7,1,8
160,2023-01-10,TICK,brawlBall,Beach Ball,1,16,8,25
161,2023-01-10,TICK,bounty,Excel,0,19,4,23
162,2023-01-09,TICK,knockout,New Perspective,0,17,1,18
163,2023-01-09,TICK,hotZone,Dueling Beetles,0,35,11,46
164,2023-01-09,TICK,gemGrab,Minecart Madness,0,58,14,72
165,2023-01-09,TICK,gemGrab,Double Swoosh,0,5,0,5
166,2023-01-09,TICK,brawlBall,Center Stage,1,36,27,64
167,2023-01-09,TICK,brawlBall,Backyard Bowl,0,2,0,2
168,2023-01-09,TICK,bounty,Layer Cake,0,99,42,141
169,2023-01-08,TICK,knockout,X Marks the Spot,0,42,9,51
170,2023-01-08,TICK,hotZone,Ring of Fire,0,49,1,50
171,2023-01-08,TICK,heist,Snaked Assault,0,1,0,1
172,2023-01-08,TICK,gemGrab,Hard Rock Mine,0,2,0,2
173,2023-01-08,TICK,gemGrab,Double Swoosh,0,5,0,5
174,2023-01-08,TICK,brawlBall,Super Beach,0,4,2,6
175,2023-01-08,TICK,brawlBall,Backyard Bowl,0,18,4,22
176,2023-01-08,TICK,bounty,Layer Cake,0,21,6,27
177,2023-01-07,TICK,knockout,X Marks the Spot,0,27,9,36
178,2023-01-07,TICK,hotZone,Ring of Fire,0,16,4,20
179,2023-01-07,TICK,gemGrab,Hard Rock Mine,0,6,1,7
180,2023-01-07,TICK,gemGrab,Deep Diner,0,6,1,7
181,2023-01-07,TICK,brawlBall,Super Beach,0,11,3,14
182,2023-01-07,TICK,brawlBall,Sneaky Fields,0,3,0,3
183,2023-01-07,TICK,bounty,Dry Season,0,47,17,64
184,2023-01-06,TICK,knockout,Out in the Open,0,25,4,29
185,2023-01-06,TICK,hotZone,Split,0,40,4,44
186,2023-01-06,TICK,heist,Tornado Ring,0,2,1,3
187,2023-01-06,TICK,gemGrab,Undermine,0,1,2,3
188,2023-01-06,TICK,gemGrab,Deep Diner,0,32,1,33
189,2023-01-06,TICK,brawlBall,Sneaky Fields,0,10,7,17
190,2023-01-06,TICK,bounty,Dry Season,0,59,43,102
191,2023-01-05,TICK,knockout,Out in the Open,0,44,24,68
192,2023-01-05,TICK,hotZone,Split,1,83,10,94
193,2023-01-05,TICK,heist,Kaboom Canyon,0,1,0,1
194,2023-01-05,TICK,gemGrab,Undermine,0,5,1,6
195,2023-01-05,TICK,brawlBall,Sunny Soccer,0,3,0,3
196,2023-01-05,TICK,brawlBall,Pinhole Punt,0,20,3,23
197,2023-01-05,TICK,bounty,Shooting Star,0,49,23,72
198,2023-01-04,TICK,knockout,Goldarm Gulch,0,13,5,18
199,2023-01-04,TICK,hotZone,Parallel Plays,0,19,0,19
200,2023-01-04,TICK,gemGrab,Gem Fort,0,4,1,5
201,2023-01-04,TICK,gemGrab,Crystal Arcade,0,3,0,3
202,2023-01-04,TICK,brawlBall,Sunny Soccer,2,29,7,38
203,2023-01-04,TICK,brawlBall,Beach Ball,0,2,0,2
204,2023-01-04,TICK,bounty,Shooting Star,0,131,188,319
205,2023-01-03,TICK,knockout,Goldarm Gulch,0,10,15,25
206,2023-01-03,TICK,hotZone,Parallel Plays,0,24,1,25
207,2023-01-03,TICK,heist,Kaboom Canyon,0,1,0,1
208,2023-01-03,TICK,gemGrab,Minecart Madness,0,16,1,17
209,2023-01-03,TICK,gemGrab,Crystal Arcade,0,14,4,18
210,2023-01-03,TICK,brawlBall,Center Stage,1,1,1,3
211,2023-01-03,TICK,brawlBall,Beach Ball,0,28,5,33
212,2023-01-03,TICK,bounty,Hideout,0,72,55,127
213,2023-01-02,TICK,knockout,Belle's Rock,0,76,56,132
214,2023-01-02,TICK,hotZone,Quarter Pounder,0,72,2,74
215,2023-01-02,TICK,heist,Pit Stop,0,1,0,1
216,2023-01-02,TICK,gemGrab,Minecart Madness,0,61,7,68
217,2023-01-02,TICK,gemGrab,Double Swoosh,0,2,1,3
218,2023-01-02,TICK,brawlBall,Center Stage,0,11,6,17
219,2023-01-02,TICK,brawlBall,Backyard Bowl,0,2,1,3
220,2023-01-02,TICK,bounty,Hideout,0,96,80,176
221,2023-01-01,TICK,knockout,Belle's Rock,0,18,19,37
222,2023-01-01,TICK,hotZone,Quarter Pounder,0,22,1,23
223,2023-01-01,TICK,hotZone,Controller Chaos,0,1,0,1
224,2023-01-01,TICK,heist,Bridge Too Far,0,1,0,1
225,2023-01-01,TICK,gemGrab,Minecart Madness,0,0,1,1
226,2023-01-01,TICK,gemGrab,Double Swoosh,0,3,1,4
227,2023-01-01,TICK,brawlBall,Backyard Bowl,0,6,4,10
228,2023-01-01,TICK,bounty,Canal Grande,0,7,5,12
229,2022-12-31,TICK,hotZone,Controller Chaos,0,5,0,5
230,2022-12-31,TICK,gemGrab,Minecart Madness,0,1,0,1
231,2022-12-31,TICK,gemGrab,Hard Rock Mine,0,2,1,3
232,2022-12-31,TICK,gemGrab,Deep Diner,0,8,2,10
233,2022-12-31,TICK,brawlBall,Super Beach,0,1,0,1
234,2022-12-31,TICK,bounty,Canal Grande,0,3,1,4
235,2022-12-30,TICK,knockout,Flaring Phoenix,0,1,2,3
236,2022-12-30,TICK,hotZone,Controller Chaos,0,5,0,5
237,2022-12-30,TICK,gemGrab,Deep Diner,0,7,1,8
238,2022-12-30,TICK,brawlBall,Sneaky Fields,0,1,1,2
239,2022-12-29,TICK,gemGrab,Minecart Madness,0,1,1,2
240,2022-12-29,TICK,brawlBall,Pinhole Punt,0,2,6,8
241,2022-12-27,TICK,hotZone,Dueling Beetles,0,1,1,2
242,2022-12-27,TICK,gemGrab,Minecart Madness,0,0,2,2
243,2022-12-27,TICK,brawlBall,Beach Ball,0,1,1,2
244,2022-12-27,TICK,bounty,Excel,0,2,2,4
245,2022-12-26,TICK,hotZone,Controller Chaos,0,1,0,1
246,2022-12-26,TICK,gemGrab,Minecart Madness,0,1,0,1
247,2022-12-25,TICK,bounty,Layer Cake,0,1,0,1
248,2022-12-23,TICK,knockout,Out in the Open,0,2,1,3
249,2022-12-22,TICK,brawlBall,Pinhole Punt,0,0,1,1
250,2022-12-21,TICK,brawlBall,Sunny Soccer,0,1,1,2
251,2022-12-20,TICK,brawlBall,Beach Ball,0,0,2,2
252,2022-12-19,TICK,brawlBall,Center Stage,0,0,1,1
253,2022-12-18,TICK,knockout,Belle's Rock,0,1,1,2
254,2022-12-16,TICK,brawlBall,Sneaky Fields,0,0,1,1
255,2022-12-16,TICK,bounty,Temple Ruins,0,2,0,2
256,2022-12-13,TICK,knockout,New Perspective,0,1,0,1
257,2022-12-13,TICK,heist,Safe Zone,0,1,0,1
258,2022-12-11,TICK,gemGrab,Double Swoosh,0,2,0,2
259,2022-12-10,TICK,hotZone,Ring of Fire,0,1,0,1
260,2022-11-11,TICK,knockout,New Perspective,0,2,0,2
261,2022-11-11,TICK,brawlBall,Sneaky Fields,0,1,0,1
262,2022-11-01,TICK,knockout,New Perspective,0,2,0,2
263,2022-10-30,TICK,hotZone,Dueling Beetles,0,1,2,3
264,2022-10-28,TICK,knockout,Out in the Open,0,0,2,2
265,2022-10-28,TICK,hotZone,Dueling Beetles,0,0,2,2
266,2022-10-28,TICK,heist,Safe Zone,0,1,0,1
267,2022-10-26,TICK,brawlBall,Sunny Soccer,0,0,1,1
268,2022-10-26,TICK,bounty,Shooting Star,0,1,1,2
269,2022-10-15,TICK,hotZone,Ring of Fire,0,2,0,2
270,2022-10-15,TICK,gemGrab,Hard Rock Mine,0,2,0,2
271,2022-10-10,TICK,knockout,Belle's Rock,0,1,3,4
272,2023-01-30,TARA,knockout,Belle's Rock,0,28,10,38
273,2023-01-30,TARA,hotZone,Quarter Pounder,0,67,19,86
274,2023-01-30,TARA,heist,Pit Stop,0,34,34,68
275,2023-01-30,TARA,gemGrab,Minecart Madness,0,43,25,68
276,2023-01-30,TARA,gemGrab,Double Swoosh,0,295,286,581
277,2023-01-30,TARA,brawlBall,Center Stage,11,537,535,1083
278,2023-01-30,TARA,brawlBall,Backyard Bowl,0,20,14,34
279,2023-01-30,TARA,bounty,Hideout,0,2,4,6
280,2023-01-29,TARA,knockout,Belle's Rock,0,10,5,15
281,2023-01-29,TARA,hotZone,Quarter Pounder,0,38,14,52
282,2023-01-29,TARA,heist,Bridge Too Far,0,5,4,9
283,2023-01-29,TARA,gemGrab,Hard Rock Mine,0,48,54,102
284,2023-01-29,TARA,gemGrab,Double Swoosh,0,507,548,1055
285,2023-01-29,TARA,brawlBall,Super Beach,0,7,2,9
286,2023-01-29,TARA,brawlBall,Backyard Bowl,11,242,206,459
287,2023-01-29,TARA,bounty,Canal Grande,0,20,5,25
288,2023-01-28,TARA,knockout,Flaring Phoenix,2,333,365,700
289,2023-01-28,TARA,hotZone,Controller Chaos,0,65,42,107
290,2023-01-28,TARA,heist,Bridge Too Far,0,10,13,23
291,2023-01-28,TARA,gemGrab,Hard Rock Mine,0,309,254,563
292,2023-01-28,TARA,gemGrab,Deep Diner,0,43,38,81
293,2023-01-28,TARA,brawlBall,Super Beach,14,605,529,1148
294,2023-01-28,TARA,brawlBall,Sneaky Fields,1,24,26,51
295,2023-01-28,TARA,bounty,Canal Grande,0,68,72,140
296,2023-01-27,TARA,knockout,Flaring Phoenix,1,160,204,365
297,2023-01-27,TARA,hotZone,Controller Chaos,0,14,8,22
298,2023-01-27,TARA,heist,Hot Potato,0,17,17,34
299,2023-01-27,TARA,gemGrab,Undermine,0,17,42,59
300,2023-01-27,TARA,gemGrab,Deep Diner,0,49,49,98
301,2023-01-27,TARA,brawlBall,Sneaky Fields,7,239,231,477
302,2023-01-27,TARA,brawlBall,Pinhole Punt,0,4,6,10
303,2023-01-27,TARA,bounty,Temple Ruins,0,14,15,29
304,2023-01-26,TARA,knockout,Riverside,0,12,9,21
305,2023-01-26,TARA,hotZone,Open Zone,0,38,14,52
306,2023-01-26,TARA,heist,Hot Potato,0,72,58,130
307,2023-01-26,TARA,gemGrab,Undermine,0,281,276,557
308,2023-01-26,TARA,gemGrab,Gem Fort,0,135,172,307
309,2023-01-26,TARA,brawlBall,Sunny Soccer,0,28,37,65
310,2023-01-26,TARA,brawlBall,Pinhole Punt,18,557,592,1167
311,2023-01-26,TARA,bounty,Temple Ruins,0,74,82,156
312,2023-01-25,TARA,knockout,Riverside,0,7,6,13
313,2023-01-25,TARA,hotZone,Open Zone,0,17,8,25
314,2023-01-25,TARA,heist,Safe Zone,0,11,9,20
315,2023-01-25,TARA,gemGrab,Gem Fort,0,155,162,317
316,2023-01-25,TARA,gemGrab,Crystal Arcade,0,124,138,262
317,2023-01-25,TARA,brawlBall,Sunny Soccer,10,321,317,648
318,2023-01-25,TARA,brawlBall,Beach Ball,0,39,30,69
319,2023-01-25,TARA,bounty,Excel,0,7,1,8
320,2023-01-24,TARA,knockout,New Perspective,0,72,134,206
321,2023-01-24,TARA,hotZone,Dueling Beetles,0,54,14,68
322,2023-01-24,TARA,heist,Safe Zone,0,14,8,22
323,2023-01-24,TARA,gemGrab,Minecart Madness,0,9,9,18
324,2023-01-24,TARA,gemGrab,Crystal Arcade,0,277,242,519
325,2023-01-24,TARA,brawlBall,Center Stage,1,95,100,196
326,2023-01-24,TARA,brawlBall,Beach Ball,11,525,456,992
327,2023-01-24,TARA,bounty,Excel,0,16,3,19
328,2023-01-23,TARA,knockout,New Perspective,3,360,524,887
329,2023-01-23,TARA,hotZone,Dueling Beetles,0,52,19,71
330,2023-01-23,TARA,heist,Snaked Assault,1,110,143,254
331,2023-01-23,TARA,gemGrab,Minecart Madness,0,88,46,134
332,2023-01-23,TARA,gemGrab,Double Swoosh,0,228,324,552
333,2023-01-23,TARA,brawlBall,Center Stage,34,1139,1158,2331
334,2023-01-23,TARA,brawlBall,Backyard Bowl,0,20,10,30
335,2023-01-23,TARA,bounty,Layer Cake,0,25,20,45
336,2023-01-22,TARA,knockout,X Marks the Spot,0,14,17,31
337,2023-01-22,TARA,hotZone,Ring of Fire,0,29,17,46
338,2023-01-22,TARA,heist,Snaked Assault,1,78,89,168
339,2023-01-22,TARA,gemGrab,Hard Rock Mine,0,75,51,126
340,2023-01-22,TARA,gemGrab,Double Swoosh,0,320,318,638
341,2023-01-22,TARA,brawlBall,Super Beach,1,57,34,92
342,2023-01-22,TARA,brawlBall,Backyard Bowl,5,124,106,235
343,2023-01-22,TARA,bounty,Layer Cake,0,22,33,55
344,2023-01-21,TARA,knockout,X Marks the Spot,0,72,38,110
345,2023-01-21,TARA,hotZone,Ring of Fire,0,73,30,103
346,2023-01-21,TARA,heist,Tornado Ring,1,98,127,226
347,2023-01-21,TARA,gemGrab,Hard Rock Mine,0,372,320,692
348,2023-01-21,TARA,gemGrab,Deep Diner,0,43,39,82
349,2023-01-21,TARA,brawlBall,Super Beach,18,747,688,1453
350,2023-01-21,TARA,brawlBall,Sneaky Fields,0,22,29,51
351,2023-01-21,TARA,bounty,Dry Season,0,8,3,11
352,2023-01-20,TARA,knockout,Out in the Open,0,72,71,143
353,2023-01-20,TARA,hotZone,Split,0,19,9,28
354,2023-01-20,TARA,heist,Tornado Ring,3,86,65,154
355,2023-01-20,TARA,gemGrab,Undermine,0,100,96,196
356,2023-01-20,TARA,gemGrab,Deep Diner,0,207,161,368
357,2023-01-20,TARA,brawlBall,Sneaky Fields,21,799,775,1595
358,2023-01-20,TARA,brawlBall,Pinhole Punt,0,14,17,31
359,2023-01-20,TARA,bounty,Dry Season,0,13,7,20
360,2023-01-19,TARA,knockout,Out in the Open,1,171,166,338
361,2023-01-19,TARA,hotZone,Split,0,37,20,57
362,2023-01-19,TARA,heist,Kaboom Canyon,0,18,15,33
363,2023-01-19,TARA,gemGrab,Undermine,0,399,471,870
364,2023-01-19,TARA,gemGrab,Gem Fort,0,103,81,184
365,2023-01-19,TARA,brawlBall,Sunny Soccer,0,19,17,36
366,2023-01-19,TARA,brawlBall,Pinhole Punt,12,536,582,1130
367,2023-01-19,TARA,bounty,Shooting Star,0,9,2,11
368,2023-01-18,TARA,knockout,Goldarm Gulch,0,11,6,17
369,2023-01-18,TARA,hotZone,Parallel Plays,0,5,4,9
370,2023-01-18,TARA,heist,Kaboom Canyon,0,3,0,3
371,2023-01-18,TARA,gemGrab,Gem Fort,0,69,109,178
372,2023-01-18,TARA,gemGrab,Crystal Arcade,0,13,8,21
373,2023-01-18,TARA,brawlBall,Sunny Soccer,3,142,128,273
374,2023-01-18,TARA,brawlBall,Beach Ball,0,2,8,10
375,2023-01-18,TARA,bounty,Shooting Star,0,1,1,2
376,2023-01-17,TARA,knockout,Goldarm Gulch,0,18,6,24
377,2023-01-17,TARA,hotZone,Parallel Plays,0,2,2,4
378,2023-01-17,TARA,heist,Pit Stop,0,8,8,16
379,2023-01-17,TARA,gemGrab,Crystal Arcade,0,24,32,56
380,2023-01-17,TARA,brawlBall,Center Stage,0,2,2,4
381,2023-01-17,TARA,brawlBall,Beach Ball,1,34,40,75
382,2023-01-17,TARA,bounty,Hideout,0,1,0,1
383,2023-01-16,TARA,knockout,Belle's Rock,0,0,3,3
384,2023-01-16,TARA,hotZone,Quarter Pounder,0,6,3,9
385,2023-01-16,TARA,heist,Pit Stop,0,16,12,28
386,2023-01-16,TARA,gemGrab,Minecart Madness,0,5,5,10
387,2023-01-16,TARA,gemGrab,Double Swoosh,0,30,47,77
388,2023-01-16,TARA,brawlBall,Center Stage,2,65,75,142
389,2023-01-16,TARA,brawlBall,Backyard Bowl,0,5,0,5
390,2023-01-16,TARA,bounty,Hideout,0,1,0,1
391,2023-01-15,TARA,knockout,Belle's Rock,0,5,2,7
392,2023-01-15,TARA,hotZone,Quarter Pounder,0,21,2,23
393,2023-01-15,TARA,heist,Bridge Too Far,0,3,1,4
394,2023-01-15,TARA,gemGrab,Hard Rock Mine,0,19,8,27
395,2023-01-15,TARA,gemGrab,Double Swoosh,0,95,66,161
396,2023-01-15,TARA,brawlBall,Super Beach,0,12,0,12
397,2023-01-15,TARA,brawlBall,Backyard Bowl,1,30,20,51
398,2023-01-15,TARA,bounty,Canal Grande,0,4,2,6
399,2023-01-14,TARA,knockout,Flaring Phoenix,0,18,27,45
400,2023-01-14,TARA,hotZone,Controller Chaos,0,26,2,28
401,2023-01-14,TARA,heist,Bridge Too Far,0,4,1,5
402,2023-01-14,TARA,gemGrab,Hard Rock Mine,0,23,7,30
403,2023-01-14,TARA,gemGrab,Deep Diner,0,17,6,23
404,2023-01-14,TARA,brawlBall,Super Beach,2,44,21,67
405,2023-01-14,TARA,brawlBall,Sneaky Fields,0,11,8,19
406,2023-01-14,TARA,bounty,Canal Grande,0,7,17,24
407,2023-01-13,TARA,knockout,Flaring Phoenix,0,21,31,52
408,2023-01-13,TARA,hotZone,Controller Chaos,0,9,5,14
409,2023-01-13,TARA,heist,Hot Potato,0,3,0,3
410,2023-01-13,TARA,gemGrab,Undermine,0,1,0,1
411,2023-01-13,TARA,gemGrab,Deep Diner,0,16,10,26
412,2023-01-13,TARA,brawlBall,Sneaky Fields,1,52,20,73
413,2023-01-13,TARA,brawlBall,Pinhole Punt,0,4,0,4
414,2023-01-13,TARA,bounty,Temple Ruins,0,5,0,5
415,2023-01-12,TARA,knockout,Riverside,0,1,0,1
416,2023-01-12,TARA,hotZone,Open Zone,0,7,1,8
417,2023-01-12,TARA,heist,Hot Potato,0,1,1,2
418,2023-01-12,TARA,gemGrab,Undermine,0,24,17,41
419,2023-01-12,TARA,gemGrab,Gem Fort,0,6,1,7
420,2023-01-12,TARA,brawlBall,Sunny Soccer,0,1,0,1
421,2023-01-12,TARA,brawlBall,Pinhole Punt,0,20,4,24
422,2023-01-12,TARA,bounty,Temple Ruins,0,0,2,2
423,2023-01-11,TARA,hotZone,Open Zone,0,1,0,1
424,2023-01-11,TARA,gemGrab,Gem Fort,0,18,13,31
425,2023-01-11,TARA,brawlBall,Sunny Soccer,0,6,10,16
426,2023-01-10,TARA,knockout,New Perspective,0,4,1,5
427,2023-01-10,TARA,hotZone,Dueling Beetles,0,7,0,7
428,2023-01-10,TARA,heist,Safe Zone,0,1,0,1
429,2023-01-10,TARA,gemGrab,Minecart Madness,0,3,2,5
430,2023-01-10,TARA,gemGrab,Crystal Arcade,0,43,39,82
431,2023-01-10,TARA,brawlBall,Center Stage,0,6,1,7
432,2023-01-10,TARA,brawlBall,Beach Ball,0,24,14,38
433,2023-01-10,TARA,bounty,Excel,0,1,0,1
434,2023-01-09,TARA,knockout,New Perspective,0,24,26,50
435,2023-01-09,TARA,hotZone,Dueling Beetles,0,1,0,1
436,2023-01-09,TARA,heist,Snaked Assault,0,10,7,17
437,2023-01-09,TARA,gemGrab,Minecart Madness,0,7,1,8
438,2023-01-09,TARA,gemGrab,Double Swoosh,0,43,55,98
439,2023-01-09,TARA,brawlBall,Center Stage,3,70,60,133
440,2023-01-09,TARA,brawlBall,Backyard Bowl,0,4,0,4
441,2023-01-09,TARA,bounty,Layer Cake,0,0,1,1
442,2023-01-08,TARA,knockout,X Marks the Spot,0,1,0,1
443,2023-01-08,TARA,hotZone,Ring of Fire,0,7,23,30
444,2023-01-08,TARA,heist,Snaked Assault,0,12,14,26
445,2023-01-08,TARA,gemGrab,Hard Rock Mine,0,12,9,21
446,2023-01-08,TARA,gemGrab,Double Swoosh,0,39,18,57
447,2023-01-08,TARA,brawlBall,Super Beach,0,8,2,10
448,2023-01-08,TARA,brawlBall,Backyard Bowl,0,15,4,19
449,2023-01-08,TARA,bounty,Layer Cake,0,0,2,2
450,2023-01-07,TARA,knockout,X Marks the Spot,0,0,1,1
451,2023-01-07,TARA,hotZone,Ring of Fire,0,6,11,17
452,2023-01-07,TARA,heist,Tornado Ring,0,11,12,23
453,2023-01-07,TARA,gemGrab,Hard Rock Mine,0,32,36,68
454,2023-01-07,TARA,gemGrab,Deep Diner,0,21,3,24
455,2023-01-07,TARA,brawlBall,Super Beach,1,18,15,34
456,2023-01-07,TARA,brawlBall,Sneaky Fields,0,5,1,6
457,2023-01-07,TARA,bounty,Dry Season,0,2,1,3
458,2023-01-06,TARA,knockout,Out in the Open,0,9,23,32
459,2023-01-06,TARA,heist,Tornado Ring,0,11,4,15
460,2023-01-06,TARA,gemGrab,Undermine,0,19,14,33
461,2023-01-06,TARA,gemGrab,Deep Diner,0,29,7,36
462,2023-01-06,TARA,brawlBall,Sneaky Fields,1,48,36,85
463,2023-01-06,TARA,brawlBall,Pinhole Punt,0,5,1,6
464,2023-01-06,TARA,bounty,Dry Season,0,0,1,1
465,2023-01-05,TARA,knockout,Out in the Open,1,23,9,33
466,2023-01-05,TARA,hotZone,Split,0,12,0,12
467,2023-01-05,TARA,heist,Kaboom Canyon,0,3,0,3
468,2023-01-05,TARA,gemGrab,Undermine,0,66,52,118
469,2023-01-05,TARA,gemGrab,Gem Fort,0,12,7,19
470,2023-01-05,TARA,brawlBall,Sunny Soccer,0,0,1,1
471,2023-01-05,TARA,brawlBall,Pinhole Punt,1,65,31,97
472,2023-01-04,TARA,knockout,Goldarm Gulch,0,3,0,3
473,2023-01-04,TARA,hotZone,Parallel Plays,0,1,0,1
474,2023-01-04,TARA,heist,Kaboom Canyon,0,1,1,2
475,2023-01-04,TARA,gemGrab,Gem Fort,0,85,62,147
476,2023-01-04,TARA,gemGrab,Crystal Arcade,0,16,2,18
477,2023-01-04,TARA,brawlBall,Sunny Soccer,0,45,27,72
478,2023-01-04,TARA,bounty,Shooting Star,0,1,0,1
479,2023-01-03,TARA,knockout,Goldarm Gulch,0,8,1,9
480,2023-01-03,TARA,hotZone,Parallel Plays,0,2,1,3
481,2023-01-03,TARA,heist,Pit Stop,1,4,0,5
482,2023-01-03,TARA,gemGrab,Crystal Arcade,0,63,19,82
483,2023-01-03,TARA,brawlBall,Center Stage,0,2,0,2
484,2023-01-03,TARA,brawlBall,Beach Ball,1,56,45,102
485,2023-01-03,TARA,bounty,Hideout,0,1,0,1
486,2023-01-02,TARA,knockout,Belle's Rock,0,4,0,4
487,2023-01-02,TARA,hotZone,Quarter Pounder,0,10,2,12
488,2023-01-02,TARA,heist,Pit Stop,0,7,1,8
489,2023-01-02,TARA,gemGrab,Minecart Madness,0,14,4,18
490,2023-01-02,TARA,gemGrab,Double Swoosh,0,39,14,53
491,2023-01-02,TARA,brawlBall,Center Stage,5,95,71,171
492,2023-01-02,TARA,brawlBall,Backyard Bowl,0,1,1,2
493,2023-01-02,TARA,bounty,Hideout,0,3,0,3
494,2023-01-01,TARA,hotZone,Quarter Pounder,0,3,1,4
495,2023-01-01,TARA,heist,Bridge Too Far,0,0,1,1
496,2023-01-01,TARA,gemGrab,Minecart Madness,0,1,0,1
497,2023-01-01,TARA,gemGrab,Hard Rock Mine,0,1,2,3
498,2023-01-01,TARA,gemGrab,Double Swoosh,0,36,41,77
499,2023-01-01,TARA,brawlBall,Backyard Bowl,0,8,3,11
500,2022-12-31,TARA,knockout,Flaring Phoenix,0,2,0,2
501,2022-12-31,TARA,hotZone,Controller Chaos,0,1,0,1
502,2022-12-31,TARA,gemGrab,Hard Rock Mine,0,9,6,15
503,2022-12-31,TARA,gemGrab,Deep Diner,0,3,2,5
504,2022-12-31,TARA,brawlBall,Super Beach,1,2,3,6
505,2022-12-30,TARA,knockout,Flaring Phoenix,0,3,2,5
506,2022-12-30,TARA,hotZone,Controller Chaos,0,2,1,3
507,2022-12-30,TARA,heist,Kaboom Canyon,0,0,1,1
508,2022-12-30,TARA,heist,Hot Potato,0,1,0,1
509,2022-12-30,TARA,gemGrab,Undermine,0,3,0,3
510,2022-12-30,TARA,gemGrab,Deep Diner,0,2,1,3
511,2022-12-30,TARA,brawlBall,Sneaky Fields,0,4,10,14
512,2022-12-29,TARA,hotZone,Controller Chaos,0,1,0,1
513,2022-12-29,TARA,gemGrab,Undermine,0,1,0,1
514,2022-12-29,TARA,gemGrab,Gem Fort,0,0,1,1
515,2022-12-29,TARA,brawlBall,Pinhole Punt,0,3,2,5
516,2022-12-28,TARA,brawlBall,Sunny Soccer,0,0,1,1
517,2022-12-28,TARA,brawlBall,Beach Ball,0,0,1,1
518,2022-12-27,TARA,knockout,New Perspective,0,2,3,5
519,2022-12-27,TARA,brawlBall,Beach Ball,0,0,2,2
520,2022-12-26,TARA,gemGrab,Minecart Madness,0,0,1,1
521,2022-12-26,TARA,brawlBall,Center Stage,0,1,2,3
522,2022-12-23,TARA,knockout,Out in the Open,0,1,0,1
523,2022-12-22,TARA,gemGrab,Gem Fort,0,7,12,19
524,2022-12-22,TARA,brawlBall,Pinhole Punt,0,4,2,6
525,2022-12-20,TARA,brawlBall,Beach Ball,0,1,2,3
526,2022-12-19,TARA,brawlBall,Center Stage,0,0,1,1
527,2022-12-17,TARA,knockout,Flaring Phoenix,0,2,4,6
528,2022-12-16,TARA,brawlBall,Sneaky Fields,0,0,1,1
529,2022-12-13,TARA,knockout,New Perspective,0,2,1,3
530,2022-12-13,TARA,gemGrab,Crystal Arcade,0,1,0,1
531,2022-12-10,TARA,gemGrab,Hard Rock Mine,0,0,1,1
532,2022-11-11,TARA,brawlBall,Sneaky Fields,0,1,3,4
533,2022-10-28,TARA,hotZone,Dueling Beetles,0,1,0,1
534,2022-10-15,TARA,hotZone,Ring of Fire,0,1,0,1
535,2023-01-30,SURGE,knockout,Belle's Rock,0,51,18,69
536,2023-01-30,SURGE,hotZone,Quarter Pounder,1,193,108,302
537,2023-01-30,SURGE,heist,Pit Stop,1,109,84,194
538,2023-01-30,SURGE,gemGrab,Minecart Madness,0,52,35,87
539,2023-01-30,SURGE,gemGrab,Double Swoosh,0,246,240,486
540,2023-01-30,SURGE,brawlBall,Center Stage,26,908,877,1811
541,2023-01-30,SURGE,brawlBall,Backyard Bowl,2,58,45,105
542,2023-01-30,SURGE,bounty,Hideout,0,10,2,12
543,2023-01-29,SURGE,knockout,Belle's Rock,0,49,21,70
544,2023-01-29,SURGE,hotZone,Quarter Pounder,1,121,67,189
545,2023-01-29,SURGE,heist,Bridge Too Far,0,5,1,6
546,2023-01-29,SURGE,gemGrab,Hard Rock Mine,0,68,69,137
547,2023-01-29,SURGE,gemGrab,Double Swoosh,0,374,313,687
548,2023-01-29,SURGE,brawlBall,Super Beach,1,48,49,98
549,2023-01-29,SURGE,brawlBall,Backyard Bowl,21,544,383,948
550,2023-01-29,SURGE,bounty,Canal Grande,0,166,155,321
551,2023-01-28,SURGE,knockout,Flaring Phoenix,0,60,40,100
552,2023-01-28,SURGE,hotZone,Controller Chaos,0,210,201,411
553,2023-01-28,SURGE,heist,Bridge Too Far,0,17,6,23
554,2023-01-28,SURGE,gemGrab,Hard Rock Mine,0,320,297,617
555,2023-01-28,SURGE,gemGrab,Deep Diner,0,92,91,183
556,2023-01-28,SURGE,brawlBall,Super Beach,68,2001,1928,3997
557,2023-01-28,SURGE,brawlBall,Sneaky Fields,2,117,159,278
558,2023-01-28,SURGE,bounty,Canal Grande,0,266,274,540
559,2023-01-27,SURGE,knockout,Flaring Phoenix,1,19,9,29
560,2023-01-27,SURGE,hotZone,Controller Chaos,0,75,91,166
561,2023-01-27,SURGE,heist,Hot Potato,0,10,6,16
562,2023-01-27,SURGE,gemGrab,Undermine,0,12,24,36
563,2023-01-27,SURGE,gemGrab,Deep Diner,0,103,84,187
564,2023-01-27,SURGE,brawlBall,Sneaky Fields,16,610,636,1262
565,2023-01-27,SURGE,brawlBall,Pinhole Punt,0,14,16,30
566,2023-01-27,SURGE,bounty,Temple Ruins,0,21,20,41
567,2023-01-26,SURGE,knockout,Riverside,1,24,5,30
568,2023-01-26,SURGE,hotZone,Open Zone,0,34,15,49
569,2023-01-26,SURGE,heist,Hot Potato,0,72,76,148
570,2023-01-26,SURGE,gemGrab,Undermine,0,191,137,328
571,2023-01-26,SURGE,gemGrab,Gem Fort,0,109,103,212
572,2023-01-26,SURGE,brawlBall,Sunny Soccer,0,108,129,237
573,2023-01-26,SURGE,brawlBall,Pinhole Punt,28,1034,866,1928
574,2023-01-26,SURGE,bounty,Temple Ruins,0,87,88,175
575,2023-01-25,SURGE,knockout,Riverside,0,11,3,14
576,2023-01-25,SURGE,hotZone,Open Zone,0,12,5,17
577,2023-01-25,SURGE,heist,Safe Zone,0,7,1,8
578,2023-01-25,SURGE,gemGrab,Gem Fort,0,118,78,196
579,2023-01-25,SURGE,gemGrab,Crystal Arcade,0,198,258,456
580,2023-01-25,SURGE,brawlBall,Sunny Soccer,36,1003,1024,2063
581,2023-01-25,SURGE,brawlBall,Beach Ball,6,128,143,277
582,2023-01-25,SURGE,bounty,Excel,0,34,68,102
583,2023-01-24,SURGE,knockout,New Perspective,0,51,28,79
584,2023-01-24,SURGE,hotZone,Dueling Beetles,0,79,32,111
585,2023-01-24,SURGE,heist,Safe Zone,0,13,7,20
586,2023-01-24,SURGE,gemGrab,Minecart Madness,0,24,16,40
587,2023-01-24,SURGE,gemGrab,Crystal Arcade,0,300,330,630
588,2023-01-24,SURGE,brawlBall,Center Stage,4,162,164,330
589,2023-01-24,SURGE,brawlBall,Beach Ball,57,1375,1472,2904
590,2023-01-24,SURGE,bounty,Excel,0,42,13,55
591,2023-01-23,SURGE,knockout,New Perspective,0,85,48,133
592,2023-01-23,SURGE,hotZone,Dueling Beetles,0,93,47,140
593,2023-01-23,SURGE,heist,Snaked Assault,0,66,32,98
594,2023-01-23,SURGE,gemGrab,Minecart Madness,0,103,62,165
595,2023-01-23,SURGE,gemGrab,Double Swoosh,0,200,168,368
596,2023-01-23,SURGE,brawlBall,Center Stage,57,1653,1518,3228
597,2023-01-23,SURGE,brawlBall,Backyard Bowl,0,33,21,54
598,2023-01-23,SURGE,bounty,Layer Cake,0,113,86,199
599,2023-01-22,SURGE,knockout,X Marks the Spot,0,29,14,43
600,2023-01-22,SURGE,hotZone,Ring of Fire,0,56,46,102
601,2023-01-22,SURGE,heist,Snaked Assault,0,28,16,44
602,2023-01-22,SURGE,gemGrab,Hard Rock Mine,0,92,128,220
603,2023-01-22,SURGE,gemGrab,Double Swoosh,0,193,146,339
604,2023-01-22,SURGE,brawlBall,Super Beach,5,178,149,332
605,2023-01-22,SURGE,brawlBall,Backyard Bowl,8,233,192,433
606,2023-01-22,SURGE,bounty,Layer Cake,0,46,39,85
607,2023-01-21,SURGE,knockout,X Marks the Spot,0,102,71,173
608,2023-01-21,SURGE,hotZone,Ring of Fire,0,63,34,97
609,2023-01-21,SURGE,heist,Tornado Ring,1,43,27,71
610,2023-01-21,SURGE,gemGrab,Hard Rock Mine,0,444,424,868
611,2023-01-21,SURGE,gemGrab,Deep Diner,0,62,65,127
612,2023-01-21,SURGE,brawlBall,Super Beach,73,2533,2464,5070
613,2023-01-21,SURGE,brawlBall,Sneaky Fields,3,115,104,222
614,2023-01-21,SURGE,bounty,Dry Season,0,28,9,37
615,2023-01-20,SURGE,knockout,Out in the Open,0,63,29,92
616,2023-01-20,SURGE,hotZone,Split,0,208,214,422
617,2023-01-20,SURGE,heist,Tornado Ring,0,56,45,101
618,2023-01-20,SURGE,gemGrab,Undermine,0,106,115,221
619,2023-01-20,SURGE,gemGrab,Deep Diner,0,286,338,624
620,2023-01-20,SURGE,brawlBall,Sneaky Fields,60,1845,1848,3753
621,2023-01-20,SURGE,brawlBall,Pinhole Punt,0,40,24,64
622,2023-01-20,SURGE,bounty,Dry Season,0,19,11,30
623,2023-01-19,SURGE,knockout,Out in the Open,0,83,38,121
624,2023-01-19,SURGE,hotZone,Split,0,422,489,911
625,2023-01-19,SURGE,heist,Kaboom Canyon,1,13,14,28
626,2023-01-19,SURGE,gemGrab,Undermine,0,208,166,374
627,2023-01-19,SURGE,gemGrab,Gem Fort,0,55,63,118
628,2023-01-19,SURGE,brawlBall,Sunny Soccer,1,57,47,105
629,2023-01-19,SURGE,brawlBall,Pinhole Punt,27,1179,989,2195
630,2023-01-19,SURGE,bounty,Shooting Star,0,19,10,29
631,2023-01-18,SURGE,knockout,Goldarm Gulch,0,12,6,18
632,2023-01-18,SURGE,hotZone,Parallel Plays,0,31,16,47
633,2023-01-18,SURGE,heist,Kaboom Canyon,0,2,1,3
634,2023-01-18,SURGE,gemGrab,Gem Fort,0,48,39,87
635,2023-01-18,SURGE,gemGrab,Crystal Arcade,0,26,38,64
636,2023-01-18,SURGE,brawlBall,Sunny Soccer,16,420,473,909
637,2023-01-18,SURGE,brawlBall,Beach Ball,0,12,17,29
638,2023-01-18,SURGE,bounty,Shooting Star,0,4,3,7
639,2023-01-17,SURGE,knockout,Goldarm Gulch,0,12,4,16
640,2023-01-17,SURGE,hotZone,Parallel Plays,0,34,41,75
641,2023-01-17,SURGE,heist,Pit Stop,0,10,15,25
642,2023-01-17,SURGE,gemGrab,Minecart Madness,0,1,0,1
643,2023-01-17,SURGE,gemGrab,Crystal Arcade,0,29,30,59
644,2023-01-17,SURGE,brawlBall,Center Stage,0,6,6,12
645,2023-01-17,SURGE,brawlBall,Beach Ball,1,131,126,258
646,2023-01-17,SURGE,bounty,Hideout,0,0,1,1
647,2023-01-16,SURGE,knockout,Belle's Rock,0,1,1,2
648,2023-01-16,SURGE,hotZone,Quarter Pounder,0,21,21,42
649,2023-01-16,SURGE,heist,Pit Stop,0,26,63,89
650,2023-01-16,SURGE,gemGrab,Minecart Madness,0,9,2,11
651,2023-01-16,SURGE,gemGrab,Double Swoosh,0,23,21,44
652,2023-01-16,SURGE,brawlBall,Center Stage,2,107,100,209
653,2023-01-16,SURGE,brawlBall,Backyard Bowl,0,9,4,13
654,2023-01-16,SURGE,bounty,Hideout,0,5,2,7
655,2023-01-15,SURGE,knockout,Belle's Rock,0,3,0,3
656,2023-01-15,SURGE,hotZone,Quarter Pounder,0,52,8,60
657,2023-01-15,SURGE,heist,Bridge Too Far,0,1,0,1
658,2023-01-15,SURGE,gemGrab,Hard Rock Mine,0,23,27,50
659,2023-01-15,SURGE,gemGrab,Double Swoosh,0,55,48,103
660,2023-01-15,SURGE,brawlBall,Super Beach,1,41,36,78
661,2023-01-15,SURGE,brawlBall,Backyard Bowl,1,66,41,108
662,2023-01-15,SURGE,bounty,Canal Grande,0,25,8,33
663,2023-01-14,SURGE,knockout,Flaring Phoenix,0,1,3,4
664,2023-01-14,SURGE,hotZone,Controller Chaos,0,76,62,138
665,2023-01-14,SURGE,gemGrab,Hard Rock Mine,0,28,23,51
666,2023-01-14,SURGE,gemGrab,Deep Diner,0,20,14,34
667,2023-01-14,SURGE,brawlBall,Super Beach,7,186,169,362
668,2023-01-14,SURGE,brawlBall,Sneaky Fields,2,37,24,63
669,2023-01-14,SURGE,bounty,Canal Grande,0,21,17,38
670,2023-01-13,SURGE,knockout,Flaring Phoenix,0,2,2,4
671,2023-01-13,SURGE,hotZone,Controller Chaos,0,87,75,162
672,2023-01-13,SURGE,heist,Hot Potato,0,5,2,7
673,2023-01-13,SURGE,gemGrab,Deep Diner,0,24,66,90
674,2023-01-13,SURGE,brawlBall,Sneaky Fields,5,201,151,357
675,2023-01-13,SURGE,brawlBall,Pinhole Punt,0,1,6,7
676,2023-01-13,SURGE,bounty,Temple Ruins,0,4,2,6
677,2023-01-12,SURGE,knockout,Riverside,0,3,0,3
678,2023-01-12,SURGE,hotZone,Open Zone,0,10,0,10
679,2023-01-12,SURGE,heist,Hot Potato,0,3,0,3
680,2023-01-12,SURGE,gemGrab,Undermine,0,6,6,12
681,2023-01-12,SURGE,gemGrab,Gem Fort,0,2,0,2
682,2023-01-12,SURGE,brawlBall,Sunny Soccer,0,4,0,4
683,2023-01-12,SURGE,brawlBall,Pinhole Punt,0,22,18,40
684,2023-01-11,SURGE,gemGrab,Gem Fort,0,8,3,11
685,2023-01-11,SURGE,brawlBall,Sunny Soccer,1,43,57,101
686,2023-01-11,SURGE,brawlBall,Beach Ball,0,1,0,1
687,2023-01-11,SURGE,bounty,Excel,0,1,0,1
688,2023-01-10,SURGE,knockout,New Perspective,0,2,0,2
689,2023-01-10,SURGE,hotZone,Dueling Beetles,0,17,7,24
690,2023-01-10,SURGE,heist,Safe Zone,0,0,1,1
691,2023-01-10,SURGE,gemGrab,Minecart Madness,0,4,5,9
692,2023-01-10,SURGE,gemGrab,Crystal Arcade,0,34,44,78
693,2023-01-10,SURGE,brawlBall,Center Stage,0,9,11,20
694,2023-01-10,SURGE,brawlBall,Beach Ball,2,89,84,175
695,2023-01-09,SURGE,knockout,New Perspective,0,3,0,3
696,2023-01-09,SURGE,hotZone,Dueling Beetles,0,7,0,7
697,2023-01-09,SURGE,heist,Snaked Assault,0,8,9,17
698,2023-01-09,SURGE,gemGrab,Minecart Madness,0,9,3,12
699,2023-01-09,SURGE,gemGrab,Double Swoosh,0,33,12,45
700,2023-01-09,SURGE,brawlBall,Center Stage,6,83,78,167
701,2023-01-09,SURGE,brawlBall,Backyard Bowl,2,3,1,6
702,2023-01-09,SURGE,bounty,Layer Cake,0,11,2,13
703,2023-01-08,SURGE,knockout,X Marks the Spot,0,3,0,3
704,2023-01-08,SURGE,hotZone,Ring of Fire,0,7,1,8
705,2023-01-08,SURGE,heist,Snaked Assault,0,2,2,4
706,2023-01-08,SURGE,gemGrab,Hard Rock Mine,0,11,19,30
707,2023-01-08,SURGE,gemGrab,Double Swoosh,0,17,4,21
708,2023-01-08,SURGE,brawlBall,Super Beach,1,20,14,35
709,2023-01-08,SURGE,brawlBall,Backyard Bowl,1,19,4,24
710,2023-01-08,SURGE,bounty,Layer Cake,0,4,0,4
711,2023-01-07,SURGE,hotZone,Ring of Fire,0,3,2,5
712,2023-01-07,SURGE,heist,Tornado Ring,0,5,0,5
713,2023-01-07,SURGE,gemGrab,Hard Rock Mine,0,16,10,26
714,2023-01-07,SURGE,gemGrab,Deep Diner,0,10,30,40
715,2023-01-07,SURGE,brawlBall,Super Beach,0,61,99,160
716,2023-01-07,SURGE,brawlBall,Sneaky Fields,0,7,10,17
717,2023-01-07,SURGE,bounty,Dry Season,0,1,0,1
718,2023-01-06,SURGE,hotZone,Split,0,31,33,64
719,2023-01-06,SURGE,heist,Tornado Ring,0,14,4,18
720,2023-01-06,SURGE,gemGrab,Undermine,0,4,7,11
721,2023-01-06,SURGE,gemGrab,Deep Diner,0,30,46,76
722,2023-01-06,SURGE,brawlBall,Sneaky Fields,3,109,100,212
723,2023-01-06,SURGE,brawlBall,Pinhole Punt,0,3,7,10
724,2023-01-06,SURGE,bounty,Dry Season,0,1,0,1
725,2023-01-05,SURGE,knockout,Out in the Open,0,4,1,5
726,2023-01-05,SURGE,hotZone,Split,0,106,98,204
727,2023-01-05,SURGE,heist,Kaboom Canyon,0,1,0,1
728,2023-01-05,SURGE,gemGrab,Undermine,0,21,45,66
729,2023-01-05,SURGE,gemGrab,Gem Fort,0,2,10,12
730,2023-01-05,SURGE,brawlBall,Sunny Soccer,0,3,4,7
731,2023-01-05,SURGE,brawlBall,Pinhole Punt,3,87,105,195
732,2023-01-04,SURGE,hotZone,Parallel Plays,0,18,14,32
733,2023-01-04,SURGE,heist,Kaboom Canyon,0,4,0,4
734,2023-01-04,SURGE,gemGrab,Gem Fort,0,32,9,41
735,2023-01-04,SURGE,gemGrab,Crystal Arcade,0,16,6,22
736,2023-01-04,SURGE,brawlBall,Sunny Soccer,8,149,111,268
737,2023-01-04,SURGE,brawlBall,Beach Ball,0,1,1,2
738,2023-01-04,SURGE,bounty,Shooting Star,0,3,0,3
739,2023-01-03,SURGE,knockout,Goldarm Gulch,0,2,0,2
740,2023-01-03,SURGE,hotZone,Parallel Plays,1,34,38,73
741,2023-01-03,SURGE,heist,Pit Stop,0,16,10,26
742,2023-01-03,SURGE,heist,Kaboom Canyon,0,0,1,1
743,2023-01-03,SURGE,gemGrab,Minecart Madness,0,7,0,7
744,2023-01-03,SURGE,gemGrab,Crystal Arcade,0,44,26,70
745,2023-01-03,SURGE,brawlBall,Center Stage,0,1,5,6
746,2023-01-03,SURGE,brawlBall,Beach Ball,0,104,100,204
747,2023-01-03,SURGE,bounty,Hideout,0,2,1,3
748,2023-01-02,SURGE,knockout,Belle's Rock,0,2,0,2
749,2023-01-02,SURGE,hotZone,Quarter Pounder,0,30,7,37
750,2023-01-02,SURGE,heist,Pit Stop,0,23,12,35
751,2023-01-02,SURGE,gemGrab,Minecart Madness,0,12,0,12
752,2023-01-02,SURGE,gemGrab,Double Swoosh,0,42,43,85
753,2023-01-02,SURGE,brawlBall,Center Stage,2,130,111,243
754,2023-01-02,SURGE,brawlBall,Backyard Bowl,0,5,0,5
755,2023-01-02,SURGE,bounty,Hideout,0,1,3,4
756,2023-01-01,SURGE,knockout,Belle's Rock,0,1,0,1
757,2023-01-01,SURGE,hotZone,Quarter Pounder,0,9,4,13
758,2023-01-01,SURGE,hotZone,Controller Chaos,0,1,1,2
759,2023-01-01,SURGE,gemGrab,Double Swoosh,0,24,27,51
760,2023-01-01,SURGE,brawlBall,Backyard Bowl,0,11,3,14
761,2023-01-01,SURGE,bounty,Canal Grande,0,3,0,3
762,2022-12-31,SURGE,hotZone,Controller Chaos,0,4,4,8
763,2022-12-31,SURGE,gemGrab,Hard Rock Mine,0,9,4,13
764,2022-12-31,SURGE,gemGrab,Deep Diner,0,3,2,5
765,2022-12-31,SURGE,brawlBall,Super Beach,1,16,25,42
766,2022-12-31,SURGE,brawlBall,Sneaky Fields,0,2,0,2
767,2022-12-31,SURGE,bounty,Canal Grande,0,0,1,1
768,2022-12-30,SURGE,hotZone,Controller Chaos,0,2,2,4
769,2022-12-30,SURGE,gemGrab,Undermine,0,2,0,2
770,2022-12-30,SURGE,gemGrab,Deep Diner,0,3,2,5
771,2022-12-30,SURGE,brawlBall,Sneaky Fields,0,6,4,10
772,2022-12-29,SURGE,heist,Hot Potato,0,0,2,2
773,2022-12-29,SURGE,gemGrab,Undermine,0,1,0,1
774,2022-12-29,SURGE,brawlBall,Pinhole Punt,0,4,0,4
775,2022-12-28,SURGE,brawlBall,Sunny Soccer,0,0,2,2
776,2022-12-27,SURGE,hotZone,Dueling Beetles,0,0,1,1
777,2022-12-27,SURGE,hotZone,Controller Chaos,0,0,1,1
778,2022-12-27,SURGE,gemGrab,Minecart Madness,0,1,0,1
779,2022-12-27,SURGE,brawlBall,Center Stage,0,0,1,1
780,2022-12-27,SURGE,brawlBall,Beach Ball,0,1,1,2
781,2022-12-26,SURGE,hotZone,Controller Chaos,0,0,1,1
782,2022-12-26,SURGE,heist,Kaboom Canyon,0,1,0,1
783,2022-12-26,SURGE,brawlBall,Center Stage,0,0,1,1
784,2022-12-25,SURGE,gemGrab,Double Swoosh,0,0,1,1
785,2022-12-24,SURGE,brawlBall,Super Beach,0,0,1,1
786,2022-12-21,SURGE,brawlBall,Sunny Soccer,0,3,1,4
787,2022-12-20,SURGE,brawlBall,Beach Ball,0,0,1,1
788,2022-12-19,SURGE,brawlBall,Center Stage,0,1,1,2
789,2022-12-16,SURGE,hotZone,Controller Chaos,0,1,0,1
790,2022-12-16,SURGE,brawlBall,Sneaky Fields,0,0,2,2
791,2022-12-16,SURGE,bounty,Temple Ruins,0,1,0,1
792,2022-12-13,SURGE,brawlBall,Beach Ball,0,1,0,1
793,2022-12-11,SURGE,gemGrab,Double Swoosh,0,1,0,1
794,2022-11-11,SURGE,brawlBall,Sneaky Fields,0,0,1,1
795,2022-10-30,SURGE,brawlBall,Beach Ball,0,0,2,2
796,2022-10-26,SURGE,brawlBall,Sunny Soccer,0,1,0,1
797,2022-10-15,SURGE,gemGrab,Hard Rock Mine,0,1,0,1
798,2022-10-15,SURGE,brawlBall,Super Beach,0,0,1,1
799,2023-01-30,STU,knockout,Belle's Rock,1,130,84,215
800,2023-01-30,STU,hotZone,Quarter Pounder,1,252,433,686
801,2023-01-30,STU,heist,Pit Stop,1,18,9,28
802,2023-01-30,STU,gemGrab,Minecart Madness,0,101,116,217
803,2023-01-30,STU,gemGrab,Double Swoosh,0,55,69,124
804,2023-01-30,STU,brawlBall,Center Stage,12,411,341,764
805,2023-01-30,STU,brawlBall,Backyard Bowl,5,117,116,238
806,2023-01-30,STU,bounty,Hideout,0,23,6,29
807,2023-01-29,STU,knockout,Belle's Rock,0,95,74,169
808,2023-01-29,STU,hotZone,Quarter Pounder,2,296,395,693
809,2023-01-29,STU,heist,Bridge Too Far,0,8,2,10
810,2023-01-29,STU,gemGrab,Hard Rock Mine,0,26,30,56
811,2023-01-29,STU,gemGrab,Double Swoosh,0,87,67,154
812,2023-01-29,STU,brawlBall,Super Beach,0,30,24,54
813,2023-01-29,STU,brawlBall,Backyard Bowl,70,1557,1647,3274
814,2023-01-29,STU,bounty,Canal Grande,0,27,34,61
815,2023-01-28,STU,knockout,Flaring Phoenix,0,43,40,83
816,2023-01-28,STU,hotZone,Controller Chaos,0,208,308,516
817,2023-01-28,STU,heist,Bridge Too Far,0,17,4,21
818,2023-01-28,STU,gemGrab,Hard Rock Mine,0,163,160,323
819,2023-01-28,STU,gemGrab,Deep Diner,0,99,153,252
820,2023-01-28,STU,brawlBall,Super Beach,42,1392,1454,2888
821,2023-01-28,STU,brawlBall,Sneaky Fields,0,24,14,38
822,2023-01-28,STU,bounty,Canal Grande,0,47,65,112
823,2023-01-27,STU,knockout,Flaring Phoenix,0,35,21,56
824,2023-01-27,STU,hotZone,Controller Chaos,0,46,72,118
825,2023-01-27,STU,heist,Hot Potato,0,9,5,14
826,2023-01-27,STU,gemGrab,Undermine,0,9,7,16
827,2023-01-27,STU,gemGrab,Deep Diner,0,128,172,300
828,2023-01-27,STU,brawlBall,Sneaky Fields,5,163,125,293
829,2023-01-27,STU,brawlBall,Pinhole Punt,0,12,15,27
830,2023-01-27,STU,bounty,Temple Ruins,0,17,8,25
831,2023-01-26,STU,knockout,Riverside,0,47,19,66
832,2023-01-26,STU,hotZone,Open Zone,0,200,245,445
833,2023-01-26,STU,heist,Hot Potato,0,16,12,28
834,2023-01-26,STU,gemGrab,Undermine,0,62,56,118
835,2023-01-26,STU,gemGrab,Gem Fort,0,28,13,41
836,2023-01-26,STU,brawlBall,Sunny Soccer,0,51,46,97
837,2023-01-26,STU,brawlBall,Pinhole Punt,39,1114,1118,2271
838,2023-01-26,STU,bounty,Temple Ruins,0,25,21,46
839,2023-01-25,STU,knockout,Riverside,0,10,2,12
840,2023-01-25,STU,hotZone,Open Zone,0,123,111,234
841,2023-01-25,STU,heist,Safe Zone,0,6,10,16
842,2023-01-25,STU,gemGrab,Gem Fort,0,36,30,66
843,2023-01-25,STU,gemGrab,Crystal Arcade,0,102,106,208
844,2023-01-25,STU,brawlBall,Sunny Soccer,23,713,717,1453
845,2023-01-25,STU,brawlBall,Beach Ball,8,108,121,237
846,2023-01-25,STU,bounty,Excel,0,36,42,78
847,2023-01-24,STU,knockout,New Perspective,0,99,77,176
848,2023-01-24,STU,hotZone,Dueling Beetles,0,114,161,275
849,2023-01-24,STU,heist,Safe Zone,0,24,11,35
850,2023-01-24,STU,gemGrab,Minecart Madness,0,35,44,79
851,2023-01-24,STU,gemGrab,Crystal Arcade,0,171,126,297
852,2023-01-24,STU,brawlBall,Center Stage,0,54,35,89
853,2023-01-24,STU,brawlBall,Beach Ball,40,1256,1453,2749
854,2023-01-24,STU,bounty,Excel,0,53,55,108
855,2023-01-23,STU,knockout,New Perspective,0,143,85,228
856,2023-01-23,STU,hotZone,Dueling Beetles,0,264,264,528
857,2023-01-23,STU,heist,Snaked Assault,0,13,3,16
858,2023-01-23,STU,gemGrab,Minecart Madness,0,166,205,371
859,2023-01-23,STU,gemGrab,Double Swoosh,0,35,25,60
860,2023-01-23,STU,brawlBall,Center Stage,28,716,614,1358
861,2023-01-23,STU,brawlBall,Backyard Bowl,3,100,81,184
862,2023-01-23,STU,bounty,Layer Cake,0,86,47,133
863,2023-01-22,STU,knockout,X Marks the Spot,0,41,13,54
864,2023-01-22,STU,hotZone,Ring of Fire,0,31,61,92
865,2023-01-22,STU,heist,Snaked Assault,0,3,3,6
866,2023-01-22,STU,gemGrab,Hard Rock Mine,0,48,58,106
867,2023-01-22,STU,gemGrab,Double Swoosh,0,46,50,96
868,2023-01-22,STU,brawlBall,Super Beach,5,124,158,287
869,2023-01-22,STU,brawlBall,Backyard Bowl,45,784,792,1621
870,2023-01-22,STU,bounty,Layer Cake,0,45,33,78
871,2023-01-21,STU,knockout,X Marks the Spot,0,112,45,157
872,2023-01-21,STU,hotZone,Ring of Fire,1,120,143,264
873,2023-01-21,STU,heist,Tornado Ring,0,11,9,20
874,2023-01-21,STU,gemGrab,Hard Rock Mine,0,257,302,559
875,2023-01-21,STU,gemGrab,Deep Diner,0,71,83,154
876,2023-01-21,STU,brawlBall,Super Beach,53,1780,1884,3717
877,2023-01-21,STU,brawlBall,Sneaky Fields,0,29,28,57
878,2023-01-21,STU,bounty,Dry Season,0,81,107,188
879,2023-01-20,STU,knockout,Out in the Open,0,106,63,169
880,2023-01-20,STU,hotZone,Split,0,207,316,523
881,2023-01-20,STU,heist,Tornado Ring,0,6,8,14
882,2023-01-20,STU,gemGrab,Undermine,0,25,40,65
883,2023-01-20,STU,gemGrab,Deep Diner,0,364,506,870
884,2023-01-20,STU,brawlBall,Sneaky Fields,11,504,424,939
885,2023-01-20,STU,brawlBall,Pinhole Punt,0,66,72,138
886,2023-01-20,STU,bounty,Dry Season,0,61,29,90
887,2023-01-19,STU,knockout,Out in the Open,0,114,66,180
888,2023-01-19,STU,hotZone,Split,0,348,541,889
889,2023-01-19,STU,heist,Kaboom Canyon,0,18,20,38
890,2023-01-19,STU,gemGrab,Undermine,0,88,66,154
891,2023-01-19,STU,gemGrab,Gem Fort,0,19,14,33
892,2023-01-19,STU,brawlBall,Sunny Soccer,2,40,51,93
893,2023-01-19,STU,brawlBall,Pinhole Punt,43,1198,1166,2407
894,2023-01-19,STU,bounty,Shooting Star,0,30,16,46
895,2023-01-18,STU,knockout,Goldarm Gulch,0,12,10,22
896,2023-01-18,STU,hotZone,Parallel Plays,0,28,29,57
897,2023-01-18,STU,heist,Kaboom Canyon,0,3,0,3
898,2023-01-18,STU,gemGrab,Gem Fort,0,17,35,52
899,2023-01-18,STU,gemGrab,Crystal Arcade,0,10,40,50
900,2023-01-18,STU,brawlBall,Sunny Soccer,7,288,264,559
901,2023-01-18,STU,brawlBall,Beach Ball,0,10,15,25
902,2023-01-18,STU,bounty,Shooting Star,0,11,10,21
903,2023-01-17,STU,knockout,Goldarm Gulch,0,7,8,15
904,2023-01-17,STU,hotZone,Parallel Plays,0,31,40,71
905,2023-01-17,STU,heist,Pit Stop,0,3,0,3
906,2023-01-17,STU,gemGrab,Minecart Madness,0,2,0,2
907,2023-01-17,STU,gemGrab,Crystal Arcade,0,26,21,47
908,2023-01-17,STU,brawlBall,Center Stage,0,2,0,2
909,2023-01-17,STU,brawlBall,Beach Ball,5,106,98,209
910,2023-01-17,STU,bounty,Hideout,0,3,1,4
911,2023-01-16,STU,knockout,Belle's Rock,0,13,9,22
912,2023-01-16,STU,hotZone,Quarter Pounder,0,32,90,122
913,2023-01-16,STU,heist,Pit Stop,0,4,0,4
914,2023-01-16,STU,gemGrab,Minecart Madness,0,20,14,34
915,2023-01-16,STU,gemGrab,Double Swoosh,0,5,1,6
916,2023-01-16,STU,brawlBall,Center Stage,1,43,37,81
917,2023-01-16,STU,brawlBall,Backyard Bowl,0,24,34,58
918,2023-01-16,STU,bounty,Hideout,0,10,2,12
919,2023-01-15,STU,knockout,Belle's Rock,0,17,5,22
920,2023-01-15,STU,hotZone,Quarter Pounder,0,64,143,207
921,2023-01-15,STU,gemGrab,Hard Rock Mine,0,16,8,24
922,2023-01-15,STU,gemGrab,Double Swoosh,0,8,1,9
923,2023-01-15,STU,brawlBall,Super Beach,1,18,14,33
924,2023-01-15,STU,brawlBall,Backyard Bowl,16,235,280,531
925,2023-01-15,STU,bounty,Canal Grande,0,7,9,16
926,2023-01-14,STU,knockout,Flaring Phoenix,0,5,1,6
927,2023-01-14,STU,hotZone,Controller Chaos,0,39,62,101
928,2023-01-14,STU,gemGrab,Hard Rock Mine,0,23,21,44
929,2023-01-14,STU,gemGrab,Deep Diner,0,13,13,26
930,2023-01-14,STU,brawlBall,Super Beach,4,107,89,200
931,2023-01-14,STU,brawlBall,Sneaky Fields,0,11,7,18
932,2023-01-14,STU,bounty,Canal Grande,0,2,0,2
933,2023-01-13,STU,knockout,Flaring Phoenix,0,10,0,10
934,2023-01-13,STU,hotZone,Controller Chaos,0,41,55,96
935,2023-01-13,STU,gemGrab,Deep Diner,0,37,24,61
936,2023-01-13,STU,brawlBall,Sneaky Fields,0,24,14,38
937,2023-01-13,STU,brawlBall,Pinhole Punt,0,3,3,6
938,2023-01-13,STU,bounty,Temple Ruins,0,2,0,2
939,2023-01-12,STU,knockout,Riverside,0,1,0,1
940,2023-01-12,STU,hotZone,Open Zone,0,32,17,49
941,2023-01-12,STU,gemGrab,Undermine,0,3,3,6
942,2023-01-12,STU,brawlBall,Sunny Soccer,0,4,0,4
943,2023-01-12,STU,brawlBall,Pinhole Punt,1,42,40,83
944,2023-01-11,STU,knockout,Riverside,0,1,0,1
945,2023-01-11,STU,hotZone,Open Zone,0,8,12,20
946,2023-01-11,STU,gemGrab,Gem Fort,0,2,3,5
947,2023-01-11,STU,brawlBall,Sunny Soccer,1,32,43,76
948,2023-01-11,STU,bounty,Excel,0,3,7,10
949,2023-01-10,STU,knockout,New Perspective,0,8,1,9
950,2023-01-10,STU,hotZone,Dueling Beetles,0,27,10,37
951,2023-01-10,STU,heist,Safe Zone,0,0,2,2
952,2023-01-10,STU,gemGrab,Minecart Madness,0,5,4,9
953,2023-01-10,STU,gemGrab,Crystal Arcade,0,24,12,36
954,2023-01-10,STU,brawlBall,Center Stage,0,5,0,5
955,2023-01-10,STU,brawlBall,Beach Ball,2,99,97,198
956,2023-01-10,STU,bounty,Excel,0,1,1,2
957,2023-01-09,STU,knockout,New Perspective,0,3,1,4
958,2023-01-09,STU,hotZone,Dueling Beetles,0,16,25,41
959,2023-01-09,STU,heist,Snaked Assault,0,1,0,1
960,2023-01-09,STU,gemGrab,Minecart Madness,0,20,12,32
961,2023-01-09,STU,gemGrab,Double Swoosh,0,10,9,19
962,2023-01-09,STU,brawlBall,Center Stage,2,35,14,51
963,2023-01-09,STU,brawlBall,Backyard Bowl,0,3,5,8
964,2023-01-09,STU,bounty,Layer Cake,0,7,20,27
965,2023-01-08,STU,knockout,X Marks the Spot,0,3,2,5
966,2023-01-08,STU,hotZone,Ring of Fire,0,7,17,24
967,2023-01-08,STU,heist,Snaked Assault,0,2,0,2
968,2023-01-08,STU,gemGrab,Hard Rock Mine,0,5,7,12
969,2023-01-08,STU,gemGrab,Double Swoosh,0,3,5,8
970,2023-01-08,STU,brawlBall,Super Beach,0,7,8,15
971,2023-01-08,STU,brawlBall,Backyard Bowl,6,99,94,199
972,2023-01-08,STU,bounty,Layer Cake,0,1,3,4
973,2023-01-07,STU,knockout,X Marks the Spot,0,2,0,2
974,2023-01-07,STU,hotZone,Ring of Fire,0,5,19,24
975,2023-01-07,STU,gemGrab,Hard Rock Mine,0,13,38,51
976,2023-01-07,STU,gemGrab,Deep Diner,0,13,1,14
977,2023-01-07,STU,brawlBall,Super Beach,0,38,35,73
978,2023-01-07,STU,brawlBall,Sneaky Fields,0,2,7,9
979,2023-01-07,STU,bounty,Dry Season,0,3,0,3
980,2023-01-06,STU,knockout,Out in the Open,0,5,4,9
981,2023-01-06,STU,hotZone,Split,0,24,67,91
982,2023-01-06,STU,heist,Tornado Ring,0,1,0,1
983,2023-01-06,STU,gemGrab,Undermine,0,2,1,3
984,2023-01-06,STU,gemGrab,Deep Diner,0,49,42,91
985,2023-01-06,STU,brawlBall,Sneaky Fields,2,32,22,56
986,2023-01-06,STU,brawlBall,Pinhole Punt,0,5,6,11
987,2023-01-06,STU,bounty,Dry Season,0,6,2,8
988,2023-01-05,STU,knockout,Out in the Open,0,10,4,14
989,2023-01-05,STU,hotZone,Split,0,75,111,186
990,2023-01-05,STU,heist,Kaboom Canyon,0,1,0,1
991,2023-01-05,STU,gemGrab,Undermine,0,10,4,14
992,2023-01-05,STU,gemGrab,Gem Fort,0,1,1,2
993,2023-01-05,STU,brawlBall,Sunny Soccer,0,1,6,7
994,2023-01-05,STU,brawlBall,Pinhole Punt,5,116,143,264
995,2023-01-04,STU,knockout,Goldarm Gulch,0,0,2,2
996,2023-01-04,STU,hotZone,Parallel Plays,0,18,29,47
997,2023-01-04,STU,heist,Kaboom Canyon,0,4,1,5
998,2023-01-04,STU,gemGrab,Gem Fort,0,10,5,15
999,2023-01-04,STU,gemGrab,Crystal Arcade,0,7,12,19
1000,2023-01-04,STU,brawlBall,Sunny Soccer,2,109,134,245
1001,2023-01-04,STU,brawlBall,Beach Ball,0,1,1,2
1002,2023-01-04,STU,bounty,Shooting Star,0,3,2,5
1003,2023-01-03,STU,knockout,Goldarm Gulch,0,4,0,4
1004,2023-01-03,STU,hotZone,Parallel Plays,0,29,22,51
1005,2023-01-03,STU,heist,Pit Stop,0,1,0,1
1006,2023-01-03,STU,gemGrab,Minecart Madness,0,3,6,9
1007,2023-01-03,STU,gemGrab,Crystal Arcade,0,29,78,107
1008,2023-01-03,STU,brawlBall,Center Stage,0,2,11,13
1009,2023-01-03,STU,brawlBall,Beach Ball,2,150,178,330
1010,2023-01-03,STU,bounty,Hideout,0,9,1,10
1011,2023-01-02,STU,knockout,Belle's Rock,0,8,1,9
1012,2023-01-02,STU,hotZone,Quarter Pounder,2,52,65,119
1013,2023-01-02,STU,heist,Pit Stop,0,2,0,2
1014,2023-01-02,STU,gemGrab,Minecart Madness,0,25,28,53
1015,2023-01-02,STU,gemGrab,Double Swoosh,0,7,2,9
1016,2023-01-02,STU,brawlBall,Center Stage,0,46,37,83
1017,2023-01-02,STU,brawlBall,Backyard Bowl,3,17,12,32
1018,2023-01-02,STU,bounty,Hideout,0,7,9,16
1019,2023-01-01,STU,knockout,Belle's Rock,0,3,0,3
1020,2023-01-01,STU,hotZone,Quarter Pounder,0,20,17,37
1021,2023-01-01,STU,hotZone,Controller Chaos,0,0,1,1
1022,2023-01-01,STU,heist,Kaboom Canyon,0,0,1,1
1023,2023-01-01,STU,heist,Bridge Too Far,0,0,1,1
1024,2023-01-01,STU,gemGrab,Minecart Madness,0,0,1,1
1025,2023-01-01,STU,gemGrab,Double Swoosh,0,5,4,9
1026,2023-01-01,STU,brawlBall,Backyard Bowl,0,55,91,146
1027,2023-01-01,STU,bounty,Canal Grande,0,1,0,1
1028,2022-12-31,STU,knockout,Flaring Phoenix,0,1,0,1
1029,2022-12-31,STU,hotZone,Controller Chaos,0,2,1,3
1030,2022-12-31,STU,gemGrab,Minecart Madness,0,1,0,1
1031,2022-12-31,STU,gemGrab,Hard Rock Mine,0,8,23,31
1032,2022-12-31,STU,gemGrab,Deep Diner,0,5,8,13
1033,2022-12-31,STU,brawlBall,Super Beach,0,13,9,22
1034,2022-12-31,STU,brawlBall,Sneaky Fields,0,1,0,1
1035,2022-12-30,STU,knockout,Flaring Phoenix,0,1,0,1
1036,2022-12-30,STU,hotZone,Controller Chaos,0,4,1,5
1037,2022-12-30,STU,gemGrab,Undermine,0,0,1,1
1038,2022-12-30,STU,gemGrab,Minecart Madness,0,1,0,1
1039,2022-12-30,STU,gemGrab,Deep Diner,0,10,7,17
1040,2022-12-30,STU,brawlBall,Sneaky Fields,0,6,2,8
1041,2022-12-29,STU,hotZone,Open Zone,0,1,1,2
1042,2022-12-29,STU,gemGrab,Minecart Madness,0,0,1,1
1043,2022-12-29,STU,brawlBall,Pinhole Punt,0,6,1,7
1044,2022-12-28,STU,hotZone,Open Zone,0,4,0,4
1045,2022-12-27,STU,hotZone,Controller Chaos,0,0,2,2
1046,2022-12-27,STU,brawlBall,Center Stage,0,1,0,1
1047,2022-12-27,STU,brawlBall,Beach Ball,0,3,3,6
1048,2022-12-26,STU,hotZone,Controller Chaos,0,1,1,2
1049,2022-12-26,STU,brawlBall,Center Stage,0,1,0,1
1050,2022-12-25,STU,hotZone,Ring of Fire,0,1,0,1
1051,2022-12-25,STU,brawlBall,Backyard Bowl,0,2,0,2
1052,2022-12-24,STU,brawlBall,Super Beach,0,1,0,1
1053,2022-12-23,STU,knockout,Out in the Open,0,2,1,3
1054,2022-12-22,STU,brawlBall,Pinhole Punt,0,3,2,5
1055,2022-12-21,STU,brawlBall,Sunny Soccer,0,0,1,1
1056,2022-12-19,STU,brawlBall,Center Stage,0,1,1,2
1057,2022-12-16,STU,brawlBall,Sneaky Fields,0,0,2,2
1058,2022-12-13,STU,brawlBall,Beach Ball,0,0,1,1
1059,2022-11-03,STU,brawlBall,Pinhole Punt,0,0,1,1
1060,2022-10-30,STU,brawlBall,Beach Ball,0,0,2,2
1061,2022-10-15,STU,gemGrab,Hard Rock Mine,0,4,2,6
1062,2022-10-10,STU,knockout,Belle's Rock,0,1,0,1
1063,2023-01-30,SQUEAK,knockout,Belle's Rock,0,155,153,308
1064,2023-01-30,SQUEAK,hotZone,Quarter Pounder,0,100,134,234
1065,2023-01-30,SQUEAK,heist,Pit Stop,0,4,2,6
1066,2023-01-30,SQUEAK,gemGrab,Minecart Madness,0,109,117,226
1067,2023-01-30,SQUEAK,gemGrab,Double Swoosh,0,43,66,109
1068,2023-01-30,SQUEAK,brawlBall,Center Stage,6,142,154,302
1069,2023-01-30,SQUEAK,brawlBall,Backyard Bowl,1,15,7,23
1070,2023-01-30,SQUEAK,bounty,Hideout,0,15,19,34
1071,2023-01-29,SQUEAK,knockout,Belle's Rock,0,125,137,262
1072,2023-01-29,SQUEAK,hotZone,Quarter Pounder,0,62,74,136
1073,2023-01-29,SQUEAK,heist,Bridge Too Far,0,29,16,45
1074,2023-01-29,SQUEAK,gemGrab,Hard Rock Mine,0,17,7,24
1075,2023-01-29,SQUEAK,gemGrab,Double Swoosh,0,96,102,198
1076,2023-01-29,SQUEAK,brawlBall,Super Beach,0,1,1,2
1077,2023-01-29,SQUEAK,brawlBall,Backyard Bowl,7,129,176,312
1078,2023-01-29,SQUEAK,bounty,Canal Grande,0,48,83,131
1079,2023-01-28,SQUEAK,knockout,Flaring Phoenix,1,37,24,62
1080,2023-01-28,SQUEAK,hotZone,Controller Chaos,0,119,196,315
1081,2023-01-28,SQUEAK,heist,Bridge Too Far,1,64,52,117
1082,2023-01-28,SQUEAK,gemGrab,Hard Rock Mine,0,42,37,79
1083,2023-01-28,SQUEAK,gemGrab,Deep Diner,0,47,53,100
1084,2023-01-28,SQUEAK,brawlBall,Super Beach,4,190,232,426
1085,2023-01-28,SQUEAK,brawlBall,Sneaky Fields,1,4,8,13
1086,2023-01-28,SQUEAK,bounty,Canal Grande,0,65,112,177
1087,2023-01-27,SQUEAK,knockout,Flaring Phoenix,0,14,16,30
1088,2023-01-27,SQUEAK,hotZone,Controller Chaos,0,28,15,43
1089,2023-01-27,SQUEAK,heist,Hot Potato,0,11,6,17
1090,2023-01-27,SQUEAK,gemGrab,Undermine,0,4,2,6
1091,2023-01-27,SQUEAK,gemGrab,Deep Diner,0,42,25,67
1092,2023-01-27,SQUEAK,brawlBall,Sneaky Fields,0,72,75,147
1093,2023-01-27,SQUEAK,brawlBall,Pinhole Punt,0,2,2,4
1094,2023-01-27,SQUEAK,bounty,Temple Ruins,0,9,5,14
1095,2023-01-26,SQUEAK,knockout,Riverside,0,64,53,117
1096,2023-01-26,SQUEAK,hotZone,Open Zone,0,36,37,73
1097,2023-01-26,SQUEAK,heist,Hot Potato,0,21,13,34
1098,2023-01-26,SQUEAK,gemGrab,Undermine,0,40,15,55
1099,2023-01-26,SQUEAK,gemGrab,Gem Fort,0,16,14,30
1100,2023-01-26,SQUEAK,brawlBall,Sunny Soccer,0,17,16,33
1101,2023-01-26,SQUEAK,brawlBall,Pinhole Punt,4,212,243,459
1102,2023-01-26,SQUEAK,bounty,Temple Ruins,0,16,10,26
1103,2023-01-25,SQUEAK,knockout,Riverside,0,26,24,50
1104,2023-01-25,SQUEAK,hotZone,Open Zone,0,10,12,22
1105,2023-01-25,SQUEAK,heist,Safe Zone,0,30,21,51
1106,2023-01-25,SQUEAK,gemGrab,Gem Fort,0,20,16,36
1107,2023-01-25,SQUEAK,gemGrab,Crystal Arcade,0,43,31,74
1108,2023-01-25,SQUEAK,brawlBall,Sunny Soccer,4,125,151,280
1109,2023-01-25,SQUEAK,brawlBall,Beach Ball,1,13,12,26
1110,2023-01-25,SQUEAK,bounty,Excel,0,27,20,47
1111,2023-01-24,SQUEAK,knockout,New Perspective,0,47,38,85
1112,2023-01-24,SQUEAK,hotZone,Dueling Beetles,0,204,313,517
1113,2023-01-24,SQUEAK,heist,Safe Zone,0,49,44,93
1114,2023-01-24,SQUEAK,gemGrab,Minecart Madness,0,39,52,91
1115,2023-01-24,SQUEAK,gemGrab,Crystal Arcade,0,79,93,172
1116,2023-01-24,SQUEAK,brawlBall,Center Stage,1,25,33,59
1117,2023-01-24,SQUEAK,brawlBall,Beach Ball,5,232,238,475
1118,2023-01-24,SQUEAK,bounty,Excel,0,35,43,78
1119,2023-01-23,SQUEAK,knockout,New Perspective,0,67,76,143
1120,2023-01-23,SQUEAK,hotZone,Dueling Beetles,1,361,547,909
1121,2023-01-23,SQUEAK,heist,Snaked Assault,0,25,26,51
1122,2023-01-23,SQUEAK,gemGrab,Minecart Madness,0,196,210,406
1123,2023-01-23,SQUEAK,gemGrab,Double Swoosh,0,41,30,71
1124,2023-01-23,SQUEAK,brawlBall,Center Stage,5,350,412,767
1125,2023-01-23,SQUEAK,brawlBall,Backyard Bowl,1,5,5,11
1126,2023-01-23,SQUEAK,bounty,Layer Cake,0,58,64,122
1127,2023-01-22,SQUEAK,knockout,X Marks the Spot,0,36,38,74
1128,2023-01-22,SQUEAK,hotZone,Ring of Fire,0,33,24,57
1129,2023-01-22,SQUEAK,heist,Snaked Assault,0,8,2,10
1130,2023-01-22,SQUEAK,gemGrab,Hard Rock Mine,0,18,10,28
1131,2023-01-22,SQUEAK,gemGrab,Double Swoosh,0,51,58,109
1132,2023-01-22,SQUEAK,brawlBall,Super Beach,0,18,15,33
1133,2023-01-22,SQUEAK,brawlBall,Backyard Bowl,2,56,27,85
1134,2023-01-22,SQUEAK,bounty,Layer Cake,0,36,45,81
1135,2023-01-21,SQUEAK,knockout,X Marks the Spot,0,127,97,224
1136,2023-01-21,SQUEAK,hotZone,Ring of Fire,0,119,122,241
1137,2023-01-21,SQUEAK,heist,Tornado Ring,0,22,7,29
1138,2023-01-21,SQUEAK,gemGrab,Hard Rock Mine,0,95,59,154
1139,2023-01-21,SQUEAK,gemGrab,Deep Diner,0,24,34,58
1140,2023-01-21,SQUEAK,brawlBall,Super Beach,6,312,289,607
1141,2023-01-21,SQUEAK,brawlBall,Sneaky Fields,0,10,7,17
1142,2023-01-21,SQUEAK,bounty,Dry Season,0,42,58,100
1143,2023-01-20,SQUEAK,knockout,Out in the Open,1,123,148,272
1144,2023-01-20,SQUEAK,hotZone,Split,0,47,53,100
1145,2023-01-20,SQUEAK,heist,Tornado Ring,0,12,13,25
1146,2023-01-20,SQUEAK,gemGrab,Undermine,0,28,21,49
1147,2023-01-20,SQUEAK,gemGrab,Deep Diner,0,122,181,303
1148,2023-01-20,SQUEAK,brawlBall,Sneaky Fields,10,260,249,519
1149,2023-01-20,SQUEAK,brawlBall,Pinhole Punt,0,11,14,25
1150,2023-01-20,SQUEAK,bounty,Dry Season,0,49,61,110
1151,2023-01-19,SQUEAK,knockout,Out in the Open,0,136,120,256
1152,2023-01-19,SQUEAK,hotZone,Split,0,44,21,65
1153,2023-01-19,SQUEAK,heist,Kaboom Canyon,0,19,13,32
1154,2023-01-19,SQUEAK,gemGrab,Undermine,0,60,58,118
1155,2023-01-19,SQUEAK,gemGrab,Gem Fort,0,14,4,18
1156,2023-01-19,SQUEAK,brawlBall,Sunny Soccer,0,7,13,20
1157,2023-01-19,SQUEAK,brawlBall,Pinhole Punt,5,195,202,402
1158,2023-01-19,SQUEAK,bounty,Shooting Star,0,24,19,43
1159,2023-01-18,SQUEAK,knockout,Goldarm Gulch,0,7,12,19
1160,2023-01-18,SQUEAK,hotZone,Parallel Plays,0,4,5,9
1161,2023-01-18,SQUEAK,heist,Kaboom Canyon,0,5,9,14
1162,2023-01-18,SQUEAK,gemGrab,Gem Fort,0,12,5,17
1163,2023-01-18,SQUEAK,gemGrab,Crystal Arcade,0,6,0,6
1164,2023-01-18,SQUEAK,brawlBall,Sunny Soccer,1,99,87,187
1165,2023-01-18,SQUEAK,brawlBall,Beach Ball,0,3,1,4
1166,2023-01-18,SQUEAK,bounty,Shooting Star,0,11,8,19
1167,2023-01-17,SQUEAK,knockout,Goldarm Gulch,0,7,7,14
1168,2023-01-17,SQUEAK,hotZone,Parallel Plays,0,9,4,13
1169,2023-01-17,SQUEAK,heist,Pit Stop,0,3,1,4
1170,2023-01-17,SQUEAK,gemGrab,Minecart Madness,0,1,3,4
1171,2023-01-17,SQUEAK,gemGrab,Crystal Arcade,0,6,9,15
1172,2023-01-17,SQUEAK,brawlBall,Beach Ball,1,31,18,50
1173,2023-01-17,SQUEAK,bounty,Hideout,0,2,0,2
1174,2023-01-16,SQUEAK,knockout,Belle's Rock,0,5,3,8
1175,2023-01-16,SQUEAK,hotZone,Quarter Pounder,0,9,0,9
1176,2023-01-16,SQUEAK,heist,Pit Stop,0,3,0,3
1177,2023-01-16,SQUEAK,gemGrab,Minecart Madness,0,15,16,31
1178,2023-01-16,SQUEAK,gemGrab,Double Swoosh,0,3,12,15
1179,2023-01-16,SQUEAK,brawlBall,Center Stage,0,27,44,71
1180,2023-01-16,SQUEAK,brawlBall,Backyard Bowl,0,2,7,9
1181,2023-01-16,SQUEAK,bounty,Hideout,0,5,3,8
1182,2023-01-15,SQUEAK,knockout,Belle's Rock,0,8,3,11
1183,2023-01-15,SQUEAK,hotZone,Quarter Pounder,0,16,38,54
1184,2023-01-15,SQUEAK,heist,Bridge Too Far,0,8,3,11
1185,2023-01-15,SQUEAK,gemGrab,Hard Rock Mine,0,4,0,4
1186,2023-01-15,SQUEAK,gemGrab,Double Swoosh,0,4,4,8
1187,2023-01-15,SQUEAK,brawlBall,Super Beach,0,3,4,7
1188,2023-01-15,SQUEAK,brawlBall,Backyard Bowl,0,11,9,20
1189,2023-01-15,SQUEAK,bounty,Canal Grande,0,4,8,12
1190,2023-01-14,SQUEAK,knockout,Flaring Phoenix,0,5,0,5
1191,2023-01-14,SQUEAK,hotZone,Controller Chaos,0,17,35,52
1192,2023-01-14,SQUEAK,heist,Bridge Too Far,0,6,6,12
1193,2023-01-14,SQUEAK,gemGrab,Hard Rock Mine,0,2,0,2
1194,2023-01-14,SQUEAK,gemGrab,Deep Diner,0,2,0,2
1195,2023-01-14,SQUEAK,brawlBall,Super Beach,0,11,20,31
1196,2023-01-14,SQUEAK,brawlBall,Sneaky Fields,0,4,4,8
1197,2023-01-14,SQUEAK,bounty,Canal Grande,0,5,0,5
1198,2023-01-13,SQUEAK,knockout,Flaring Phoenix,0,3,1,4
1199,2023-01-13,SQUEAK,hotZone,Controller Chaos,0,32,74,106
1200,2023-01-13,SQUEAK,heist,Hot Potato,0,1,1,2
1201,2023-01-13,SQUEAK,gemGrab,Deep Diner,0,11,34,45
1202,2023-01-13,SQUEAK,brawlBall,Sneaky Fields,1,11,9,21
1203,2023-01-13,SQUEAK,bounty,Temple Ruins,0,0,1,1
1204,2023-01-12,SQUEAK,knockout,Riverside,0,6,0,6
1205,2023-01-12,SQUEAK,hotZone,Open Zone,0,8,5,13
1206,2023-01-12,SQUEAK,heist,Hot Potato,0,1,1,2
1207,2023-01-12,SQUEAK,gemGrab,Undermine,0,1,0,1
1208,2023-01-12,SQUEAK,brawlBall,Pinhole Punt,0,4,3,7
1209,2023-01-11,SQUEAK,brawlBall,Sunny Soccer,0,3,3,6
1210,2023-01-11,SQUEAK,bounty,Excel,0,3,14,17
1211,2023-01-10,SQUEAK,knockout,New Perspective,0,6,0,6
1212,2023-01-10,SQUEAK,hotZone,Dueling Beetles,0,29,53,82
1213,2023-01-10,SQUEAK,gemGrab,Minecart Madness,0,5,2,7
1214,2023-01-10,SQUEAK,gemGrab,Crystal Arcade,0,3,0,3
1215,2023-01-10,SQUEAK,brawlBall,Center Stage,0,2,7,9
1216,2023-01-10,SQUEAK,brawlBall,Beach Ball,0,17,44,61
1217,2023-01-10,SQUEAK,bounty,Excel,0,1,0,1
1218,2023-01-09,SQUEAK,knockout,New Perspective,0,1,0,1
1219,2023-01-09,SQUEAK,hotZone,Dueling Beetles,0,33,66,99
1220,2023-01-09,SQUEAK,heist,Snaked Assault,0,2,2,4
1221,2023-01-09,SQUEAK,gemGrab,Minecart Madness,0,6,4,10
1222,2023-01-09,SQUEAK,gemGrab,Double Swoosh,0,8,8,16
1223,2023-01-09,SQUEAK,brawlBall,Center Stage,0,9,7,16
1224,2023-01-09,SQUEAK,brawlBall,Backyard Bowl,0,2,2,4
1225,2023-01-09,SQUEAK,bounty,Layer Cake,0,2,1,3
1226,2023-01-08,SQUEAK,knockout,X Marks the Spot,0,5,1,6
1227,2023-01-08,SQUEAK,hotZone,Ring of Fire,0,14,5,19
1228,2023-01-08,SQUEAK,heist,Snaked Assault,0,2,1,3
1229,2023-01-08,SQUEAK,gemGrab,Hard Rock Mine,0,3,0,3
1230,2023-01-08,SQUEAK,gemGrab,Double Swoosh,0,4,2,6
1231,2023-01-08,SQUEAK,brawlBall,Super Beach,0,5,3,8
1232,2023-01-08,SQUEAK,brawlBall,Backyard Bowl,0,10,2,12
1233,2023-01-08,SQUEAK,bounty,Layer Cake,0,6,8,14
1234,2023-01-07,SQUEAK,knockout,X Marks the Spot,0,1,0,1
1235,2023-01-07,SQUEAK,hotZone,Ring of Fire,0,2,1,3
1236,2023-01-07,SQUEAK,gemGrab,Deep Diner,0,2,2,4
1237,2023-01-07,SQUEAK,brawlBall,Super Beach,0,7,9,16
1238,2023-01-07,SQUEAK,bounty,Dry Season,0,6,0,6
1239,2023-01-06,SQUEAK,knockout,Out in the Open,0,4,2,6
1240,2023-01-06,SQUEAK,heist,Tornado Ring,0,2,0,2
1241,2023-01-06,SQUEAK,gemGrab,Undermine,0,2,14,16
1242,2023-01-06,SQUEAK,gemGrab,Deep Diner,0,9,15,24
1243,2023-01-06,SQUEAK,brawlBall,Sneaky Fields,0,13,12,25
1244,2023-01-06,SQUEAK,brawlBall,Pinhole Punt,0,0,2,2
1245,2023-01-06,SQUEAK,bounty,Dry Season,0,1,2,3
1246,2023-01-05,SQUEAK,knockout,Out in the Open,0,6,2,8
1247,2023-01-05,SQUEAK,hotZone,Split,0,11,19,30
1248,2023-01-05,SQUEAK,heist,Kaboom Canyon,0,2,1,3
1249,2023-01-05,SQUEAK,gemGrab,Undermine,0,4,10,14
1250,2023-01-05,SQUEAK,gemGrab,Gem Fort,0,1,0,1
1251,2023-01-05,SQUEAK,brawlBall,Pinhole Punt,0,16,15,31
1252,2023-01-04,SQUEAK,hotZone,Parallel Plays,0,4,1,5
1253,2023-01-04,SQUEAK,heist,Kaboom Canyon,0,3,0,3
1254,2023-01-04,SQUEAK,gemGrab,Gem Fort,0,1,0,1
1255,2023-01-04,SQUEAK,gemGrab,Crystal Arcade,0,1,0,1
1256,2023-01-04,SQUEAK,brawlBall,Sunny Soccer,0,22,26,48
1257,2023-01-04,SQUEAK,bounty,Shooting Star,0,1,1,2
1258,2023-01-03,SQUEAK,knockout,Goldarm Gulch,0,0,2,2
1259,2023-01-03,SQUEAK,hotZone,Parallel Plays,0,4,1,5
1260,2023-01-03,SQUEAK,heist,Pit Stop,0,4,17,21
1261,2023-01-03,SQUEAK,gemGrab,Minecart Madness,0,4,11,15
1262,2023-01-03,SQUEAK,gemGrab,Crystal Arcade,0,7,5,12
1263,2023-01-03,SQUEAK,brawlBall,Center Stage,0,0,1,1
1264,2023-01-03,SQUEAK,brawlBall,Beach Ball,2,8,25,35
1265,2023-01-03,SQUEAK,bounty,Hideout,0,2,1,3
1266,2023-01-02,SQUEAK,knockout,Belle's Rock,0,4,3,7
1267,2023-01-02,SQUEAK,hotZone,Quarter Pounder,0,11,19,30
1268,2023-01-02,SQUEAK,heist,Pit Stop,0,5,0,5
1269,2023-01-02,SQUEAK,heist,Kaboom Canyon,0,1,0,1
1270,2023-01-02,SQUEAK,gemGrab,Minecart Madness,0,16,10,26
1271,2023-01-02,SQUEAK,gemGrab,Double Swoosh,0,3,2,5
1272,2023-01-02,SQUEAK,brawlBall,Center Stage,1,19,12,32
1273,2023-01-02,SQUEAK,brawlBall,Backyard Bowl,0,0,1,1
1274,2023-01-02,SQUEAK,bounty,Hideout,0,6,0,6
1275,2023-01-01,SQUEAK,knockout,Belle's Rock,0,1,2,3
1276,2023-01-01,SQUEAK,hotZone,Quarter Pounder,0,8,14,22
1277,2023-01-01,SQUEAK,heist,Bridge Too Far,0,1,0,1
1278,2023-01-01,SQUEAK,gemGrab,Minecart Madness,0,1,0,1
1279,2023-01-01,SQUEAK,gemGrab,Double Swoosh,0,2,5,7
1280,2023-01-01,SQUEAK,brawlBall,Backyard Bowl,0,2,0,2
1281,2023-01-01,SQUEAK,bounty,Canal Grande,0,0,1,1
1282,2022-12-31,SQUEAK,heist,Bridge Too Far,0,1,0,1
1283,2022-12-31,SQUEAK,gemGrab,Minecart Madness,0,1,0,1
1284,2022-12-31,SQUEAK,gemGrab,Hard Rock Mine,0,2,0,2
1285,2022-12-31,SQUEAK,gemGrab,Deep Diner,0,1,5,6
1286,2022-12-31,SQUEAK,brawlBall,Super Beach,0,5,0,5
1287,2022-12-30,SQUEAK,hotZone,Controller Chaos,0,2,1,3
1288,2022-12-30,SQUEAK,gemGrab,Undermine,0,4,14,18
1289,2022-12-30,SQUEAK,gemGrab,Deep Diner,0,4,0,4
1290,2022-12-30,SQUEAK,brawlBall,Sneaky Fields,0,3,0,3
1291,2022-12-29,SQUEAK,hotZone,Open Zone,0,0,1,1
1292,2022-12-29,SQUEAK,gemGrab,Minecart Madness,0,0,1,1
1293,2022-12-27,SQUEAK,hotZone,Dueling Beetles,0,1,1,2
1294,2022-12-27,SQUEAK,hotZone,Controller Chaos,0,0,1,1
1295,2022-12-27,SQUEAK,heist,Kaboom Canyon,0,0,1,1
1296,2022-12-27,SQUEAK,brawlBall,Beach Ball,0,1,0,1
1297,2022-12-26,SQUEAK,hotZone,Controller Chaos,0,0,1,1
1298,2022-12-26,SQUEAK,heist,Kaboom Canyon,0,0,1,1
1299,2022-12-26,SQUEAK,gemGrab,Minecart Madness,0,1,0,1
1300,2022-12-23,SQUEAK,knockout,Out in the Open,0,1,0,1
1301,2022-12-21,SQUEAK,brawlBall,Sunny Soccer,0,1,0,1
1302,2022-12-20,SQUEAK,brawlBall,Beach Ball,1,1,0,2
1303,2022-12-16,SQUEAK,hotZone,Controller Chaos,0,1,0,1
1304,2022-12-13,SQUEAK,gemGrab,Crystal Arcade,0,1,0,1
1305,2022-12-11,SQUEAK,brawlBall,Backyard Bowl,0,1,0,1
1306,2022-11-07,SQUEAK,hotZone,Quarter Pounder,0,2,2,4
1307,2022-10-15,SQUEAK,gemGrab,Hard Rock Mine,0,1,0,1
1308,2023-01-30,SPROUT,knockout,Belle's Rock,0,430,485,915
1309,2023-01-30,SPROUT,hotZone,Quarter Pounder,0,35,39,74
1310,2023-01-30,SPROUT,heist,Pit Stop,0,2,0,2
1311,2023-01-30,SPROUT,gemGrab,Minecart Madness,0,65,57,122
1312,2023-01-30,SPROUT,gemGrab,Double Swoosh,0,4,2,6
1313,2023-01-30,SPROUT,brawlBall,Center Stage,2,53,22,77
1314,2023-01-30,SPROUT,brawlBall,Backyard Bowl,1,8,3,12
1315,2023-01-30,SPROUT,bounty,Hideout,0,33,24,57
1316,2023-01-29,SPROUT,knockout,Belle's Rock,0,427,495,922
1317,2023-01-29,SPROUT,hotZone,Quarter Pounder,0,22,20,42
1318,2023-01-29,SPROUT,heist,Bridge Too Far,0,23,18,41
1319,2023-01-29,SPROUT,gemGrab,Hard Rock Mine,0,5,3,8
1320,2023-01-29,SPROUT,gemGrab,Double Swoosh,0,16,4,20
1321,2023-01-29,SPROUT,brawlBall,Super Beach,0,0,3,3
1322,2023-01-29,SPROUT,brawlBall,Backyard Bowl,8,75,76,159
1323,2023-01-29,SPROUT,bounty,Canal Grande,0,30,42,72
1324,2023-01-28,SPROUT,knockout,Flaring Phoenix,2,98,114,214
1325,2023-01-28,SPROUT,hotZone,Controller Chaos,0,25,21,46
1326,2023-01-28,SPROUT,heist,Bridge Too Far,0,24,8,32
1327,2023-01-28,SPROUT,gemGrab,Hard Rock Mine,0,33,23,56
1328,2023-01-28,SPROUT,gemGrab,Deep Diner,0,18,20,38
1329,2023-01-28,SPROUT,brawlBall,Super Beach,1,91,44,136
1330,2023-01-28,SPROUT,brawlBall,Sneaky Fields,0,2,0,2
1331,2023-01-28,SPROUT,bounty,Canal Grande,0,54,57,111
1332,2023-01-27,SPROUT,knockout,Flaring Phoenix,0,36,39,75
1333,2023-01-27,SPROUT,hotZone,Controller Chaos,0,8,4,12
1334,2023-01-27,SPROUT,heist,Hot Potato,0,2,1,3
1335,2023-01-27,SPROUT,gemGrab,Undermine,0,1,0,1
1336,2023-01-27,SPROUT,gemGrab,Deep Diner,0,23,29,52
1337,2023-01-27,SPROUT,brawlBall,Sneaky Fields,1,40,24,65
1338,2023-01-27,SPROUT,brawlBall,Pinhole Punt,0,1,0,1
1339,2023-01-27,SPROUT,bounty,Temple Ruins,0,4,7,11
1340,2023-01-26,SPROUT,knockout,Riverside,0,60,69,129
1341,2023-01-26,SPROUT,hotZone,Open Zone,0,7,3,10
1342,2023-01-26,SPROUT,heist,Hot Potato,0,6,3,9
1343,2023-01-26,SPROUT,gemGrab,Undermine,0,17,13,30
1344,2023-01-26,SPROUT,gemGrab,Gem Fort,0,7,2,9
1345,2023-01-26,SPROUT,brawlBall,Sunny Soccer,0,7,4,11
1346,2023-01-26,SPROUT,brawlBall,Pinhole Punt,1,52,45,98
1347,2023-01-26,SPROUT,bounty,Temple Ruins,0,5,10,15
1348,2023-01-25,SPROUT,knockout,Riverside,0,30,40,70
1349,2023-01-25,SPROUT,hotZone,Open Zone,0,3,0,3
1350,2023-01-25,SPROUT,heist,Safe Zone,0,10,8,18
1351,2023-01-25,SPROUT,gemGrab,Gem Fort,0,9,13,22
1352,2023-01-25,SPROUT,gemGrab,Crystal Arcade,0,18,12,30
1353,2023-01-25,SPROUT,brawlBall,Sunny Soccer,4,64,56,124
1354,2023-01-25,SPROUT,brawlBall,Beach Ball,1,10,13,24
1355,2023-01-25,SPROUT,bounty,Excel,0,43,44,87
1356,2023-01-24,SPROUT,knockout,New Perspective,0,50,56,106
1357,2023-01-24,SPROUT,hotZone,Dueling Beetles,0,76,76,152
1358,2023-01-24,SPROUT,heist,Safe Zone,0,17,3,20
1359,2023-01-24,SPROUT,gemGrab,Minecart Madness,0,24,29,53
1360,2023-01-24,SPROUT,gemGrab,Crystal Arcade,0,20,2,22
1361,2023-01-24,SPROUT,brawlBall,Center Stage,1,1,4,6
1362,2023-01-24,SPROUT,brawlBall,Beach Ball,1,94,87,182
1363,2023-01-24,SPROUT,bounty,Excel,0,106,108,214
1364,2023-01-23,SPROUT,knockout,New Perspective,0,77,76,153
1365,2023-01-23,SPROUT,hotZone,Dueling Beetles,1,112,135,248
1366,2023-01-23,SPROUT,heist,Snaked Assault,0,2,0,2
1367,2023-01-23,SPROUT,gemGrab,Minecart Madness,0,83,87,170
1368,2023-01-23,SPROUT,gemGrab,Double Swoosh,0,3,1,4
1369,2023-01-23,SPROUT,brawlBall,Center Stage,3,89,65,157
1370,2023-01-23,SPROUT,brawlBall,Backyard Bowl,0,11,29,40
1371,2023-01-23,SPROUT,bounty,Layer Cake,0,106,155,261
1372,2023-01-22,SPROUT,knockout,X Marks the Spot,0,49,57,106
1373,2023-01-22,SPROUT,hotZone,Ring of Fire,0,10,3,13
1374,2023-01-22,SPROUT,heist,Snaked Assault,0,0,1,1
1375,2023-01-22,SPROUT,gemGrab,Hard Rock Mine,0,5,1,6
1376,2023-01-22,SPROUT,gemGrab,Double Swoosh,0,3,4,7
1377,2023-01-22,SPROUT,brawlBall,Super Beach,0,10,14,24
1378,2023-01-22,SPROUT,brawlBall,Backyard Bowl,2,36,32,70
1379,2023-01-22,SPROUT,bounty,Layer Cake,0,67,64,131
1380,2023-01-21,SPROUT,knockout,X Marks the Spot,1,165,180,346
1381,2023-01-21,SPROUT,hotZone,Ring of Fire,0,24,9,33
1382,2023-01-21,SPROUT,heist,Tornado Ring,0,1,3,4
1383,2023-01-21,SPROUT,gemGrab,Hard Rock Mine,0,34,11,45
1384,2023-01-21,SPROUT,gemGrab,Deep Diner,0,14,11,25
1385,2023-01-21,SPROUT,brawlBall,Super Beach,2,94,68,164
1386,2023-01-21,SPROUT,brawlBall,Sneaky Fields,0,4,3,7
1387,2023-01-21,SPROUT,bounty,Dry Season,0,139,187,326
1388,2023-01-20,SPROUT,knockout,Out in the Open,0,89,113,202
1389,2023-01-20,SPROUT,hotZone,Split,0,80,51,131
1390,2023-01-20,SPROUT,heist,Tornado Ring,0,5,2,7
1391,2023-01-20,SPROUT,gemGrab,Undermine,0,8,8,16
1392,2023-01-20,SPROUT,gemGrab,Deep Diner,0,43,23,66
1393,2023-01-20,SPROUT,brawlBall,Sneaky Fields,2,65,58,125
1394,2023-01-20,SPROUT,brawlBall,Pinhole Punt,0,1,0,1
1395,2023-01-20,SPROUT,bounty,Dry Season,0,108,101,209
1396,2023-01-19,SPROUT,knockout,Out in the Open,0,110,136,246
1397,2023-01-19,SPROUT,hotZone,Split,0,120,138,258
1398,2023-01-19,SPROUT,heist,Kaboom Canyon,0,4,7,11
1399,2023-01-19,SPROUT,gemGrab,Undermine,0,10,16,26
1400,2023-01-19,SPROUT,gemGrab,Gem Fort,0,3,1,4
1401,2023-01-19,SPROUT,brawlBall,Sunny Soccer,0,3,5,8
1402,2023-01-19,SPROUT,brawlBall,Pinhole Punt,1,55,56,112
1403,2023-01-19,SPROUT,bounty,Shooting Star,0,99,132,231
1404,2023-01-18,SPROUT,knockout,Goldarm Gulch,0,17,22,39
1405,2023-01-18,SPROUT,hotZone,Parallel Plays,0,3,2,5
1406,2023-01-18,SPROUT,heist,Kaboom Canyon,0,2,3,5
1407,2023-01-18,SPROUT,gemGrab,Gem Fort,0,2,0,2
1408,2023-01-18,SPROUT,gemGrab,Crystal Arcade,0,1,1,2
1409,2023-01-18,SPROUT,brawlBall,Sunny Soccer,1,17,25,43
1410,2023-01-18,SPROUT,brawlBall,Beach Ball,0,4,3,7
1411,2023-01-18,SPROUT,bounty,Shooting Star,0,60,70,130
1412,2023-01-17,SPROUT,knockout,Goldarm Gulch,0,17,18,35
1413,2023-01-17,SPROUT,gemGrab,Minecart Madness,0,0,1,1
1414,2023-01-17,SPROUT,gemGrab,Crystal Arcade,0,2,1,3
1415,2023-01-17,SPROUT,brawlBall,Beach Ball,0,11,5,16
1416,2023-01-17,SPROUT,bounty,Hideout,0,3,8,11
1417,2023-01-16,SPROUT,knockout,Belle's Rock,0,49,55,104
1418,2023-01-16,SPROUT,hotZone,Quarter Pounder,0,1,0,1
1419,2023-01-16,SPROUT,gemGrab,Minecart Madness,0,8,6,14
1420,2023-01-16,SPROUT,brawlBall,Center Stage,0,10,13,23
1421,2023-01-16,SPROUT,brawlBall,Backyard Bowl,0,2,4,6
1422,2023-01-16,SPROUT,bounty,Hideout,0,8,11,19
1423,2023-01-15,SPROUT,knockout,Belle's Rock,0,38,60,98
1424,2023-01-15,SPROUT,hotZone,Quarter Pounder,0,18,51,69
1425,2023-01-15,SPROUT,heist,Bridge Too Far,0,4,1,5
1426,2023-01-15,SPROUT,gemGrab,Hard Rock Mine,0,2,0,2
1427,2023-01-15,SPROUT,gemGrab,Double Swoosh,0,1,1,2
1428,2023-01-15,SPROUT,brawlBall,Backyard Bowl,4,24,27,55
1429,2023-01-15,SPROUT,bounty,Canal Grande,0,0,2,2
1430,2023-01-14,SPROUT,knockout,Flaring Phoenix,0,12,10,22
1431,2023-01-14,SPROUT,hotZone,Controller Chaos,0,2,0,2
1432,2023-01-14,SPROUT,heist,Bridge Too Far,0,1,0,1
1433,2023-01-14,SPROUT,gemGrab,Hard Rock Mine,0,1,0,1
1434,2023-01-14,SPROUT,gemGrab,Deep Diner,0,3,10,13
1435,2023-01-14,SPROUT,brawlBall,Super Beach,0,6,6,12
1436,2023-01-14,SPROUT,bounty,Canal Grande,0,4,0,4
1437,2023-01-13,SPROUT,knockout,Flaring Phoenix,0,13,8,21
1438,2023-01-13,SPROUT,hotZone,Controller Chaos,0,7,23,30
1439,2023-01-13,SPROUT,gemGrab,Deep Diner,0,4,28,32
1440,2023-01-13,SPROUT,brawlBall,Sneaky Fields,0,6,4,10
1441,2023-01-12,SPROUT,knockout,Riverside,0,16,28,44
1442,2023-01-12,SPROUT,gemGrab,Undermine,0,1,0,1
1443,2023-01-12,SPROUT,brawlBall,Pinhole Punt,0,4,8,12
1444,2023-01-11,SPROUT,gemGrab,Gem Fort,0,0,1,1
1445,2023-01-11,SPROUT,brawlBall,Sunny Soccer,0,1,0,1
1446,2023-01-11,SPROUT,bounty,Excel,0,1,0,1
1447,2023-01-10,SPROUT,knockout,New Perspective,0,5,5,10
1448,2023-01-10,SPROUT,hotZone,Dueling Beetles,0,34,61,95
1449,2023-01-10,SPROUT,heist,Safe Zone,0,1,0,1
1450,2023-01-10,SPROUT,gemGrab,Minecart Madness,0,0,1,1
1451,2023-01-10,SPROUT,brawlBall,Beach Ball,0,11,13,24
1452,2023-01-10,SPROUT,bounty,Excel,0,1,1,2
1453,2023-01-09,SPROUT,knockout,New Perspective,0,0,1,1
1454,2023-01-09,SPROUT,hotZone,Dueling Beetles,0,18,16,34
1455,2023-01-09,SPROUT,gemGrab,Minecart Madness,0,3,3,6
1456,2023-01-09,SPROUT,brawlBall,Center Stage,0,1,0,1
1457,2023-01-09,SPROUT,brawlBall,Backyard Bowl,0,2,0,2
1458,2023-01-09,SPROUT,bounty,Layer Cake,0,20,16,36
1459,2023-01-08,SPROUT,knockout,X Marks the Spot,0,5,1,6
1460,2023-01-08,SPROUT,hotZone,Ring of Fire,0,2,14,16
1461,2023-01-08,SPROUT,heist,Snaked Assault,0,1,0,1
1462,2023-01-08,SPROUT,gemGrab,Double Swoosh,0,1,0,1
1463,2023-01-08,SPROUT,brawlBall,Super Beach,0,0,3,3
1464,2023-01-08,SPROUT,brawlBall,Backyard Bowl,0,2,4,6
1465,2023-01-08,SPROUT,bounty,Layer Cake,0,4,3,7
1466,2023-01-07,SPROUT,knockout,X Marks the Spot,0,8,6,14
1467,2023-01-07,SPROUT,gemGrab,Hard Rock Mine,0,1,1,2
1468,2023-01-07,SPROUT,brawlBall,Super Beach,0,2,1,3
1469,2023-01-07,SPROUT,bounty,Dry Season,0,11,10,21
1470,2023-01-06,SPROUT,knockout,Out in the Open,0,3,5,8
1471,2023-01-06,SPROUT,hotZone,Split,0,4,0,4
1472,2023-01-06,SPROUT,brawlBall,Sneaky Fields,0,4,1,5
1473,2023-01-06,SPROUT,brawlBall,Pinhole Punt,0,1,2,3
1474,2023-01-06,SPROUT,bounty,Dry Season,0,18,13,31
1475,2023-01-05,SPROUT,knockout,Out in the Open,0,3,3,6
1476,2023-01-05,SPROUT,hotZone,Split,0,17,8,25
1477,2023-01-05,SPROUT,gemGrab,Undermine,0,0,2,2
1478,2023-01-05,SPROUT,gemGrab,Gem Fort,0,1,0,1
1479,2023-01-05,SPROUT,brawlBall,Pinhole Punt,1,0,0,1
1480,2023-01-05,SPROUT,bounty,Shooting Star,0,8,2,10
1481,2023-01-04,SPROUT,knockout,Goldarm Gulch,0,5,4,9
1482,2023-01-04,SPROUT,gemGrab,Gem Fort,0,1,0,1
1483,2023-01-04,SPROUT,brawlBall,Sunny Soccer,0,5,11,16
1484,2023-01-04,SPROUT,bounty,Shooting Star,0,27,53,80
1485,2023-01-03,SPROUT,knockout,Goldarm Gulch,0,1,2,3
1486,2023-01-03,SPROUT,hotZone,Parallel Plays,0,2,0,2
1487,2023-01-03,SPROUT,gemGrab,Crystal Arcade,0,1,0,1
1488,2023-01-03,SPROUT,brawlBall,Beach Ball,1,1,0,2
1489,2023-01-03,SPROUT,bounty,Hideout,0,5,17,22
1490,2023-01-02,SPROUT,knockout,Belle's Rock,0,25,24,49
1491,2023-01-02,SPROUT,hotZone,Quarter Pounder,0,10,18,28
1492,2023-01-02,SPROUT,gemGrab,Minecart Madness,0,3,3,6
1493,2023-01-02,SPROUT,brawlBall,Center Stage,0,3,0,3
1494,2023-01-02,SPROUT,bounty,Hideout,0,14,5,19
1495,2023-01-01,SPROUT,knockout,Belle's Rock,0,22,11,33
1496,2023-01-01,SPROUT,hotZone,Quarter Pounder,0,3,9,12
1497,2023-01-01,SPROUT,hotZone,Controller Chaos,0,1,0,1
1498,2023-01-01,SPROUT,heist,Kaboom Canyon,0,1,0,1
1499,2023-01-01,SPROUT,brawlBall,Backyard Bowl,1,7,19,27
1500,2022-12-31,SPROUT,hotZone,Controller Chaos,0,1,0,1
1501,2022-12-31,SPROUT,gemGrab,Deep Diner,0,0,1,1
1502,2022-12-31,SPROUT,brawlBall,Super Beach,0,0,2,2
1503,2022-12-29,SPROUT,hotZone,Controller Chaos,0,0,1,1
1504,2022-12-29,SPROUT,brawlBall,Pinhole Punt,0,0,1,1
1505,2022-12-28,SPROUT,brawlBall,Sunny Soccer,0,1,0,1
1506,2022-12-27,SPROUT,hotZone,Dueling Beetles,0,2,0,2
1507,2022-12-26,SPROUT,gemGrab,Minecart Madness,0,1,0,1
1508,2022-12-24,SPROUT,knockout,X Marks the Spot,0,2,1,3
1509,2022-12-24,SPROUT,bounty,Dry Season,0,1,0,1
1510,2022-12-23,SPROUT,knockout,Out in the Open,0,9,9,18
1511,2022-12-22,SPROUT,brawlBall,Pinhole Punt,0,0,10,10
1512,2022-12-13,SPROUT,knockout,New Perspective,0,1,0,1
1513,2022-11-01,SPROUT,knockout,New Perspective,0,0,1,1
1514,2022-10-28,SPROUT,brawlBall,Beach Ball,0,1,0,1
1515,2022-10-26,SPROUT,bounty,Shooting Star,0,0,1,1
1516,2022-10-15,SPROUT,gemGrab,Hard Rock Mine,0,1,0,1
1517,2022-10-10,SPROUT,knockout,Belle's Rock,0,4,5,9
1518,2023-01-30,SPIKE,knockout,Belle's Rock,0,190,133,323
1519,2023-01-30,SPIKE,hotZone,Quarter Pounder,0,211,178,389
1520,2023-01-30,SPIKE,heist,Pit Stop,0,55,26,81
1521,2023-01-30,SPIKE,gemGrab,Minecart Madness,0,174,252,426
1522,2023-01-30,SPIKE,gemGrab,Double Swoosh,0,154,143,297
1523,2023-01-30,SPIKE,brawlBall,Center Stage,19,465,483,967
1524,2023-01-30,SPIKE,brawlBall,Backyard Bowl,9,80,69,158
1525,2023-01-30,SPIKE,bounty,Hideout,0,33,35,68
1526,2023-01-29,SPIKE,knockout,Belle's Rock,0,213,108,321
1527,2023-01-29,SPIKE,hotZone,Quarter Pounder,1,141,109,251
1528,2023-01-29,SPIKE,heist,Bridge Too Far,0,69,49,118
1529,2023-01-29,SPIKE,gemGrab,Hard Rock Mine,0,23,13,36
1530,2023-01-29,SPIKE,gemGrab,Double Swoosh,0,190,190,380
1531,2023-01-29,SPIKE,brawlBall,Super Beach,0,11,9,20
1532,2023-01-29,SPIKE,brawlBall,Backyard Bowl,70,836,884,1790
1533,2023-01-29,SPIKE,bounty,Canal Grande,0,34,22,56
1534,2023-01-28,SPIKE,knockout,Flaring Phoenix,0,78,41,119
1535,2023-01-28,SPIKE,hotZone,Controller Chaos,0,120,165,285
1536,2023-01-28,SPIKE,heist,Bridge Too Far,0,198,159,357
1537,2023-01-28,SPIKE,gemGrab,Hard Rock Mine,0,127,102,229
1538,2023-01-28,SPIKE,gemGrab,Deep Diner,0,64,51,115
1539,2023-01-28,SPIKE,brawlBall,Super Beach,22,751,708,1481
1540,2023-01-28,SPIKE,brawlBall,Sneaky Fields,1,41,38,80
1541,2023-01-28,SPIKE,bounty,Canal Grande,0,72,51,123
1542,2023-01-27,SPIKE,knockout,Flaring Phoenix,0,39,19,58
1543,2023-01-27,SPIKE,hotZone,Controller Chaos,0,36,23,59
1544,2023-01-27,SPIKE,heist,Hot Potato,0,30,24,54
1545,2023-01-27,SPIKE,gemGrab,Undermine,0,16,11,27
1546,2023-01-27,SPIKE,gemGrab,Deep Diner,0,84,99,183
1547,2023-01-27,SPIKE,brawlBall,Sneaky Fields,6,214,207,427
1548,2023-01-27,SPIKE,brawlBall,Pinhole Punt,0,11,7,18
1549,2023-01-27,SPIKE,bounty,Temple Ruins,0,27,21,48
1550,2023-01-26,SPIKE,knockout,Riverside,0,129,73,202
1551,2023-01-26,SPIKE,hotZone,Open Zone,0,132,90,222
1552,2023-01-26,SPIKE,heist,Hot Potato,0,88,80,168
1553,2023-01-26,SPIKE,gemGrab,Undermine,0,96,151,247
1554,2023-01-26,SPIKE,gemGrab,Gem Fort,0,36,35,71
1555,2023-01-26,SPIKE,brawlBall,Sunny Soccer,0,40,40,80
1556,2023-01-26,SPIKE,brawlBall,Pinhole Punt,31,794,809,1634
1557,2023-01-26,SPIKE,bounty,Temple Ruins,0,59,47,106
1558,2023-01-25,SPIKE,knockout,Riverside,0,56,36,92
1559,2023-01-25,SPIKE,hotZone,Open Zone,0,58,65,123
1560,2023-01-25,SPIKE,heist,Safe Zone,0,65,37,102
1561,2023-01-25,SPIKE,gemGrab,Gem Fort,0,40,32,72
1562,2023-01-25,SPIKE,gemGrab,Crystal Arcade,0,97,116,213
1563,2023-01-25,SPIKE,brawlBall,Sunny Soccer,28,522,515,1065
1564,2023-01-25,SPIKE,brawlBall,Beach Ball,3,90,94,187
1565,2023-01-25,SPIKE,bounty,Excel,0,40,22,62
1566,2023-01-24,SPIKE,knockout,New Perspective,0,104,107,211
1567,2023-01-24,SPIKE,hotZone,Dueling Beetles,0,109,109,218
1568,2023-01-24,SPIKE,heist,Safe Zone,0,97,69,166
1569,2023-01-24,SPIKE,gemGrab,Minecart Madness,0,61,75,136
1570,2023-01-24,SPIKE,gemGrab,Crystal Arcade,0,182,253,435
1571,2023-01-24,SPIKE,brawlBall,Center Stage,5,86,95,186
1572,2023-01-24,SPIKE,brawlBall,Beach Ball,38,711,753,1502
1573,2023-01-24,SPIKE,bounty,Excel,0,69,35,104
1574,2023-01-23,SPIKE,knockout,New Perspective,1,167,87,255
1575,2023-01-23,SPIKE,hotZone,Dueling Beetles,0,192,155,347
1576,2023-01-23,SPIKE,heist,Snaked Assault,2,135,75,212
1577,2023-01-23,SPIKE,gemGrab,Minecart Madness,0,302,401,703
1578,2023-01-23,SPIKE,gemGrab,Double Swoosh,0,107,92,199
1579,2023-01-23,SPIKE,brawlBall,Center Stage,43,980,839,1862
1580,2023-01-23,SPIKE,brawlBall,Backyard Bowl,2,47,63,112
1581,2023-01-23,SPIKE,bounty,Layer Cake,0,56,32,88
1582,2023-01-22,SPIKE,knockout,X Marks the Spot,0,86,57,143
1583,2023-01-22,SPIKE,hotZone,Ring of Fire,0,48,43,91
1584,2023-01-22,SPIKE,heist,Snaked Assault,0,82,52,134
1585,2023-01-22,SPIKE,gemGrab,Hard Rock Mine,0,33,26,59
1586,2023-01-22,SPIKE,gemGrab,Double Swoosh,0,111,136,247
1587,2023-01-22,SPIKE,brawlBall,Super Beach,6,81,104,191
1588,2023-01-22,SPIKE,brawlBall,Backyard Bowl,30,484,450,964
1589,2023-01-22,SPIKE,bounty,Layer Cake,0,20,10,30
1590,2023-01-21,SPIKE,knockout,X Marks the Spot,3,264,155,422
1591,2023-01-21,SPIKE,hotZone,Ring of Fire,2,215,202,419
1592,2023-01-21,SPIKE,heist,Tornado Ring,0,122,75,197
1593,2023-01-21,SPIKE,gemGrab,Hard Rock Mine,0,168,154,322
1594,2023-01-21,SPIKE,gemGrab,Deep Diner,0,45,26,71
1595,2023-01-21,SPIKE,brawlBall,Super Beach,32,1076,1055,2163
1596,2023-01-21,SPIKE,brawlBall,Sneaky Fields,2,35,23,60
1597,2023-01-21,SPIKE,bounty,Dry Season,0,99,56,155
1598,2023-01-20,SPIKE,knockout,Out in the Open,0,194,113,307
1599,2023-01-20,SPIKE,hotZone,Split,0,55,50,105
1600,2023-01-20,SPIKE,heist,Tornado Ring,1,106,92,199
1601,2023-01-20,SPIKE,gemGrab,Undermine,0,66,69,135
1602,2023-01-20,SPIKE,gemGrab,Deep Diner,0,221,204,425
1603,2023-01-20,SPIKE,brawlBall,Sneaky Fields,28,676,755,1459
1604,2023-01-20,SPIKE,brawlBall,Pinhole Punt,1,45,56,102
1605,2023-01-20,SPIKE,bounty,Dry Season,0,83,49,132
1606,2023-01-19,SPIKE,knockout,Out in the Open,0,221,138,359
1607,2023-01-19,SPIKE,hotZone,Split,0,63,24,87
1608,2023-01-19,SPIKE,heist,Kaboom Canyon,0,90,71,161
1609,2023-01-19,SPIKE,gemGrab,Undermine,0,187,190,377
1610,2023-01-19,SPIKE,gemGrab,Gem Fort,0,33,20,53
1611,2023-01-19,SPIKE,brawlBall,Sunny Soccer,2,30,42,74
1612,2023-01-19,SPIKE,brawlBall,Pinhole Punt,32,876,907,1815
1613,2023-01-19,SPIKE,bounty,Shooting Star,0,59,36,95
1614,2023-01-18,SPIKE,knockout,Goldarm Gulch,0,24,17,41
1615,2023-01-18,SPIKE,hotZone,Parallel Plays,0,16,22,38
1616,2023-01-18,SPIKE,heist,Kaboom Canyon,0,20,19,39
1617,2023-01-18,SPIKE,gemGrab,Gem Fort,0,22,17,39
1618,2023-01-18,SPIKE,gemGrab,Crystal Arcade,0,11,21,32
1619,2023-01-18,SPIKE,brawlBall,Sunny Soccer,9,230,258,497
1620,2023-01-18,SPIKE,brawlBall,Beach Ball,0,12,4,16
1621,2023-01-18,SPIKE,bounty,Shooting Star,0,26,19,45
1622,2023-01-17,SPIKE,knockout,Goldarm Gulch,0,19,15,34
1623,2023-01-17,SPIKE,hotZone,Parallel Plays,0,13,13,26
1624,2023-01-17,SPIKE,heist,Pit Stop,0,11,7,18
1625,2023-01-17,SPIKE,gemGrab,Minecart Madness,0,7,3,10
1626,2023-01-17,SPIKE,gemGrab,Crystal Arcade,0,25,47,72
1627,2023-01-17,SPIKE,brawlBall,Center Stage,0,2,3,5
1628,2023-01-17,SPIKE,brawlBall,Beach Ball,5,83,83,171
1629,2023-01-17,SPIKE,bounty,Hideout,0,7,2,9
1630,2023-01-16,SPIKE,knockout,Belle's Rock,0,13,7,20
1631,2023-01-16,SPIKE,hotZone,Quarter Pounder,0,19,12,31
1632,2023-01-16,SPIKE,heist,Pit Stop,0,27,13,40
1633,2023-01-16,SPIKE,gemGrab,Minecart Madness,0,15,20,35
1634,2023-01-16,SPIKE,gemGrab,Double Swoosh,0,7,2,9
1635,2023-01-16,SPIKE,brawlBall,Center Stage,4,90,51,145
1636,2023-01-16,SPIKE,brawlBall,Backyard Bowl,0,10,11,21
1637,2023-01-16,SPIKE,bounty,Hideout,0,10,2,12
1638,2023-01-15,SPIKE,knockout,Belle's Rock,0,24,8,32
1639,2023-01-15,SPIKE,hotZone,Quarter Pounder,0,37,21,58
1640,2023-01-15,SPIKE,heist,Bridge Too Far,0,18,30,48
1641,2023-01-15,SPIKE,gemGrab,Hard Rock Mine,0,5,1,6
1642,2023-01-15,SPIKE,gemGrab,Double Swoosh,0,17,6,23
1643,2023-01-15,SPIKE,brawlBall,Super Beach,1,22,22,45
1644,2023-01-15,SPIKE,brawlBall,Backyard Bowl,6,110,94,210
1645,2023-01-15,SPIKE,bounty,Canal Grande,0,3,5,8
1646,2023-01-14,SPIKE,knockout,Flaring Phoenix,0,3,0,3
1647,2023-01-14,SPIKE,hotZone,Controller Chaos,0,27,11,38
1648,2023-01-14,SPIKE,heist,Bridge Too Far,0,12,2,14
1649,2023-01-14,SPIKE,gemGrab,Hard Rock Mine,0,6,1,7
1650,2023-01-14,SPIKE,gemGrab,Deep Diner,0,7,23,30
1651,2023-01-14,SPIKE,brawlBall,Super Beach,1,51,76,128
1652,2023-01-14,SPIKE,brawlBall,Sneaky Fields,1,5,22,28
1653,2023-01-14,SPIKE,bounty,Canal Grande,0,7,2,9
1654,2023-01-13,SPIKE,knockout,Flaring Phoenix,0,13,2,15
1655,2023-01-13,SPIKE,hotZone,Controller Chaos,0,64,59,123
1656,2023-01-13,SPIKE,heist,Hot Potato,0,5,0,5
1657,2023-01-13,SPIKE,gemGrab,Deep Diner,0,15,21,36
1658,2023-01-13,SPIKE,brawlBall,Sneaky Fields,4,60,75,139
1659,2023-01-13,SPIKE,brawlBall,Pinhole Punt,0,1,2,3
1660,2023-01-13,SPIKE,bounty,Temple Ruins,0,5,2,7
1661,2023-01-12,SPIKE,knockout,Riverside,0,15,6,21
1662,2023-01-12,SPIKE,hotZone,Open Zone,0,14,23,37
1663,2023-01-12,SPIKE,gemGrab,Undermine,0,3,4,7
1664,2023-01-12,SPIKE,brawlBall,Sunny Soccer,0,5,2,7
1665,2023-01-12,SPIKE,brawlBall,Pinhole Punt,0,28,35,63
1666,2023-01-11,SPIKE,knockout,Riverside,0,1,0,1
1667,2023-01-11,SPIKE,hotZone,Open Zone,0,5,2,7
1668,2023-01-11,SPIKE,brawlBall,Sunny Soccer,1,21,37,59
1669,2023-01-11,SPIKE,brawlBall,Beach Ball,0,2,2,4
1670,2023-01-10,SPIKE,knockout,New Perspective,0,3,2,5
1671,2023-01-10,SPIKE,hotZone,Dueling Beetles,0,27,36,63
1672,2023-01-10,SPIKE,heist,Safe Zone,0,9,0,9
1673,2023-01-10,SPIKE,gemGrab,Minecart Madness,0,8,11,19
1674,2023-01-10,SPIKE,gemGrab,Crystal Arcade,0,9,7,16
1675,2023-01-10,SPIKE,brawlBall,Center Stage,0,3,2,5
1676,2023-01-10,SPIKE,brawlBall,Beach Ball,1,54,54,109
1677,2023-01-10,SPIKE,bounty,Excel,0,2,0,2
1678,2023-01-09,SPIKE,knockout,New Perspective,0,6,2,8
1679,2023-01-09,SPIKE,hotZone,Dueling Beetles,0,13,17,30
1680,2023-01-09,SPIKE,heist,Snaked Assault,0,24,34,58
1681,2023-01-09,SPIKE,gemGrab,Minecart Madness,1,23,50,74
1682,2023-01-09,SPIKE,gemGrab,Double Swoosh,0,9,5,14
1683,2023-01-09,SPIKE,brawlBall,Center Stage,1,26,16,43
1684,2023-01-09,SPIKE,brawlBall,Backyard Bowl,1,10,29,40
1685,2023-01-09,SPIKE,bounty,Layer Cake,0,6,0,6
1686,2023-01-08,SPIKE,knockout,X Marks the Spot,0,11,35,46
1687,2023-01-08,SPIKE,hotZone,Ring of Fire,0,19,26,45
1688,2023-01-08,SPIKE,heist,Snaked Assault,0,11,8,19
1689,2023-01-08,SPIKE,gemGrab,Hard Rock Mine,0,5,5,10
1690,2023-01-08,SPIKE,gemGrab,Double Swoosh,0,6,28,34
1691,2023-01-08,SPIKE,brawlBall,Super Beach,0,7,23,30
1692,2023-01-08,SPIKE,brawlBall,Backyard Bowl,4,50,49,103
1693,2023-01-08,SPIKE,bounty,Layer Cake,0,3,0,3
1694,2023-01-07,SPIKE,knockout,X Marks the Spot,0,10,5,15
1695,2023-01-07,SPIKE,hotZone,Ring of Fire,0,7,8,15
1696,2023-01-07,SPIKE,heist,Tornado Ring,0,9,19,28
1697,2023-01-07,SPIKE,gemGrab,Hard Rock Mine,0,10,5,15
1698,2023-01-07,SPIKE,gemGrab,Deep Diner,0,4,4,8
1699,2023-01-07,SPIKE,brawlBall,Super Beach,1,25,21,47
1700,2023-01-07,SPIKE,brawlBall,Sneaky Fields,0,2,1,3
1701,2023-01-07,SPIKE,bounty,Dry Season,0,10,0,10
1702,2023-01-06,SPIKE,knockout,Out in the Open,0,9,2,11
1703,2023-01-06,SPIKE,hotZone,Split,0,3,0,3
1704,2023-01-06,SPIKE,heist,Tornado Ring,1,24,19,44
1705,2023-01-06,SPIKE,gemGrab,Undermine,0,5,2,7
1706,2023-01-06,SPIKE,gemGrab,Deep Diner,0,21,3,24
1707,2023-01-06,SPIKE,brawlBall,Sneaky Fields,1,54,68,123
1708,2023-01-06,SPIKE,brawlBall,Pinhole Punt,0,7,4,11
1709,2023-01-06,SPIKE,bounty,Dry Season,0,3,5,8
1710,2023-01-05,SPIKE,knockout,Out in the Open,0,12,4,16
1711,2023-01-05,SPIKE,hotZone,Split,0,28,37,65
1712,2023-01-05,SPIKE,heist,Kaboom Canyon,0,11,3,14
1713,2023-01-05,SPIKE,gemGrab,Undermine,0,12,18,30
1714,2023-01-05,SPIKE,gemGrab,Gem Fort,0,2,0,2
1715,2023-01-05,SPIKE,brawlBall,Pinhole Punt,2,115,131,248
1716,2023-01-05,SPIKE,bounty,Shooting Star,0,5,0,5
1717,2023-01-04,SPIKE,knockout,Goldarm Gulch,0,2,13,15
1718,2023-01-04,SPIKE,hotZone,Parallel Plays,0,3,2,5
1719,2023-01-04,SPIKE,heist,Kaboom Canyon,0,17,33,50
1720,2023-01-04,SPIKE,gemGrab,Gem Fort,0,5,17,22
1721,2023-01-04,SPIKE,gemGrab,Crystal Arcade,0,8,11,19
1722,2023-01-04,SPIKE,brawlBall,Sunny Soccer,4,87,85,176
1723,2023-01-04,SPIKE,bounty,Shooting Star,0,11,5,16
1724,2023-01-03,SPIKE,knockout,Goldarm Gulch,0,7,3,10
1725,2023-01-03,SPIKE,hotZone,Parallel Plays,0,19,9,28
1726,2023-01-03,SPIKE,heist,Pit Stop,0,7,12,19
1727,2023-01-03,SPIKE,gemGrab,Minecart Madness,0,4,1,5
1728,2023-01-03,SPIKE,gemGrab,Crystal Arcade,0,26,15,41
1729,2023-01-03,SPIKE,brawlBall,Center Stage,0,2,0,2
1730,2023-01-03,SPIKE,brawlBall,Beach Ball,1,54,48,103
1731,2023-01-03,SPIKE,bounty,Hideout,0,10,2,12
1732,2023-01-02,SPIKE,knockout,Belle's Rock,0,5,8,13
1733,2023-01-02,SPIKE,hotZone,Quarter Pounder,0,30,44,74
1734,2023-01-02,SPIKE,heist,Pit Stop,0,16,17,33
1735,2023-01-02,SPIKE,gemGrab,Minecart Madness,0,44,32,76
1736,2023-01-02,SPIKE,gemGrab,Double Swoosh,0,15,31,46
1737,2023-01-02,SPIKE,brawlBall,Center Stage,0,57,51,108
1738,2023-01-02,SPIKE,brawlBall,Backyard Bowl,0,6,1,7
1739,2023-01-02,SPIKE,bounty,Hideout,0,23,30,53
1740,2023-01-01,SPIKE,knockout,Belle's Rock,0,5,2,7
1741,2023-01-01,SPIKE,hotZone,Quarter Pounder,0,14,3,17
1742,2023-01-01,SPIKE,hotZone,Controller Chaos,0,0,1,1
1743,2023-01-01,SPIKE,heist,Bridge Too Far,0,1,2,3
1744,2023-01-01,SPIKE,gemGrab,Minecart Madness,0,1,0,1
1745,2023-01-01,SPIKE,gemGrab,Double Swoosh,0,8,7,15
1746,2023-01-01,SPIKE,brawlBall,Backyard Bowl,0,38,12,50
1747,2023-01-01,SPIKE,bounty,Canal Grande,0,1,0,1
1748,2022-12-31,SPIKE,hotZone,Controller Chaos,0,1,0,1
1749,2022-12-31,SPIKE,heist,Kaboom Canyon,0,1,0,1
1750,2022-12-31,SPIKE,heist,Bridge Too Far,0,2,0,2
1751,2022-12-31,SPIKE,gemGrab,Hard Rock Mine,0,1,0,1
1752,2022-12-31,SPIKE,gemGrab,Deep Diner,0,4,3,7
1753,2022-12-31,SPIKE,brawlBall,Super Beach,0,7,3,10
1754,2022-12-31,SPIKE,bounty,Canal Grande,0,1,0,1
1755,2022-12-30,SPIKE,knockout,Flaring Phoenix,0,1,0,1
1756,2022-12-30,SPIKE,hotZone,Controller Chaos,0,3,1,4
1757,2022-12-30,SPIKE,heist,Kaboom Canyon,0,1,0,1
1758,2022-12-30,SPIKE,gemGrab,Undermine,0,1,1,2
1759,2022-12-30,SPIKE,gemGrab,Deep Diner,0,2,0,2
1760,2022-12-30,SPIKE,brawlBall,Sneaky Fields,0,3,1,4
1761,2022-12-29,SPIKE,hotZone,Controller Chaos,0,1,1,2
1762,2022-12-29,SPIKE,heist,Hot Potato,0,1,0,1
1763,2022-12-29,SPIKE,gemGrab,Undermine,0,1,1,2
1764,2022-12-29,SPIKE,gemGrab,Minecart Madness,0,2,0,2
1765,2022-12-29,SPIKE,brawlBall,Pinhole Punt,0,6,2,8
1766,2022-12-28,SPIKE,brawlBall,Sunny Soccer,0,1,0,1
1767,2022-12-27,SPIKE,knockout,New Perspective,0,0,1,1
1768,2022-12-27,SPIKE,hotZone,Dueling Beetles,0,0,1,1
1769,2022-12-27,SPIKE,hotZone,Controller Chaos,0,1,1,2
1770,2022-12-27,SPIKE,gemGrab,Minecart Madness,0,0,1,1
1771,2022-12-27,SPIKE,brawlBall,Beach Ball,0,1,0,1
1772,2022-12-26,SPIKE,hotZone,Controller Chaos,0,0,1,1
1773,2022-12-26,SPIKE,heist,Kaboom Canyon,0,2,0,2
1774,2022-12-26,SPIKE,gemGrab,Minecart Madness,0,2,1,3
1775,2022-12-26,SPIKE,brawlBall,Center Stage,0,1,1,2
1776,2022-12-25,SPIKE,hotZone,Ring of Fire,0,0,1,1
1777,2022-12-25,SPIKE,gemGrab,Double Swoosh,0,2,0,2
1778,2022-12-25,SPIKE,brawlBall,Backyard Bowl,0,1,0,1
1779,2022-12-24,SPIKE,knockout,X Marks the Spot,0,1,0,1
1780,2022-12-23,SPIKE,knockout,Out in the Open,0,3,2,5
1781,2022-12-21,SPIKE,brawlBall,Sunny Soccer,0,0,1,1
1782,2022-12-20,SPIKE,brawlBall,Beach Ball,1,0,0,1
1783,2022-12-19,SPIKE,brawlBall,Center Stage,0,2,1,3
1784,2022-12-16,SPIKE,brawlBall,Sneaky Fields,0,1,0,1
1785,2022-12-13,SPIKE,knockout,New Perspective,0,1,0,1
1786,2022-12-13,SPIKE,gemGrab,Crystal Arcade,0,1,0,1
1787,2022-12-11,SPIKE,brawlBall,Backyard Bowl,0,1,1,2
1788,2022-12-10,SPIKE,gemGrab,Hard Rock Mine,0,0,1,1
1789,2022-11-07,SPIKE,hotZone,Quarter Pounder,0,0,1,1
1790,2022-10-30,SPIKE,hotZone,Dueling Beetles,0,1,0,1
1791,2022-10-30,SPIKE,bounty,Canal Grande,0,1,0,1
1792,2022-10-28,SPIKE,knockout,Out in the Open,0,0,1,1
1793,2022-10-28,SPIKE,brawlBall,Beach Ball,0,0,1,1
1794,2023-01-30,SHELLY,knockout,Belle's Rock,0,49,34,83
1795,2023-01-30,SHELLY,hotZone,Quarter Pounder,1,34,19,54
1796,2023-01-30,SHELLY,heist,Pit Stop,0,23,14,37
1797,2023-01-30,SHELLY,gemGrab,Minecart Madness,0,10,9,19
1798,2023-01-30,SHELLY,gemGrab,Double Swoosh,0,60,25,85
1799,2023-01-30,SHELLY,brawlBall,Center Stage,22,751,743,1516
1800,2023-01-30,SHELLY,brawlBall,Backyard Bowl,3,25,14,42
1801,2023-01-30,SHELLY,bounty,Hideout,0,3,0,3
1802,2023-01-29,SHELLY,knockout,Belle's Rock,0,82,120,202
1803,2023-01-29,SHELLY,hotZone,Quarter Pounder,0,26,5,31
1804,2023-01-29,SHELLY,heist,Bridge Too Far,0,9,1,10
1805,2023-01-29,SHELLY,gemGrab,Hard Rock Mine,0,20,4,24
1806,2023-01-29,SHELLY,gemGrab,Double Swoosh,0,87,76,163
1807,2023-01-29,SHELLY,brawlBall,Super Beach,0,9,9,18
1808,2023-01-29,SHELLY,brawlBall,Backyard Bowl,5,226,122,353
1809,2023-01-29,SHELLY,bounty,Canal Grande,0,8,6,14
1810,2023-01-28,SHELLY,knockout,Flaring Phoenix,1,81,126,208
1811,2023-01-28,SHELLY,hotZone,Controller Chaos,0,37,9,46
1812,2023-01-28,SHELLY,heist,Bridge Too Far,0,16,4,20
1813,2023-01-28,SHELLY,gemGrab,Hard Rock Mine,0,50,41,91
1814,2023-01-28,SHELLY,gemGrab,Deep Diner,0,8,2,10
1815,2023-01-28,SHELLY,brawlBall,Super Beach,16,549,447,1012
1816,2023-01-28,SHELLY,brawlBall,Sneaky Fields,0,49,39,88
1817,2023-01-28,SHELLY,bounty,Canal Grande,0,32,5,37
1818,2023-01-27,SHELLY,knockout,Flaring Phoenix,1,31,53,85
1819,2023-01-27,SHELLY,hotZone,Controller Chaos,0,9,0,9
1820,2023-01-27,SHELLY,heist,Hot Potato,0,6,5,11
1821,2023-01-27,SHELLY,gemGrab,Undermine,0,3,2,5
1822,2023-01-27,SHELLY,gemGrab,Deep Diner,0,10,4,14
1823,2023-01-27,SHELLY,brawlBall,Sneaky Fields,5,330,260,595
1824,2023-01-27,SHELLY,brawlBall,Pinhole Punt,0,3,4,7
1825,2023-01-27,SHELLY,bounty,Temple Ruins,0,4,2,6
1826,2023-01-26,SHELLY,knockout,Riverside,0,10,7,17
1827,2023-01-26,SHELLY,hotZone,Open Zone,0,19,2,21
1828,2023-01-26,SHELLY,heist,Hot Potato,0,18,14,32
1829,2023-01-26,SHELLY,gemGrab,Undermine,0,31,13,44
1830,2023-01-26,SHELLY,gemGrab,Gem Fort,0,48,34,82
1831,2023-01-26,SHELLY,brawlBall,Sunny Soccer,1,22,45,68
1832,2023-01-26,SHELLY,brawlBall,Pinhole Punt,12,424,325,761
1833,2023-01-26,SHELLY,bounty,Temple Ruins,0,22,27,49
1834,2023-01-25,SHELLY,knockout,Riverside,0,14,8,22
1835,2023-01-25,SHELLY,hotZone,Open Zone,0,6,0,6
1836,2023-01-25,SHELLY,heist,Safe Zone,0,7,2,9
1837,2023-01-25,SHELLY,gemGrab,Gem Fort,0,37,32,69
1838,2023-01-25,SHELLY,gemGrab,Crystal Arcade,0,29,6,35
1839,2023-01-25,SHELLY,brawlBall,Sunny Soccer,11,299,235,545
1840,2023-01-25,SHELLY,brawlBall,Beach Ball,3,31,51,85
1841,2023-01-25,SHELLY,bounty,Excel,0,3,1,4
1842,2023-01-24,SHELLY,knockout,New Perspective,0,27,31,58
1843,2023-01-24,SHELLY,hotZone,Dueling Beetles,0,10,3,13
1844,2023-01-24,SHELLY,heist,Safe Zone,0,8,1,9
1845,2023-01-24,SHELLY,gemGrab,Minecart Madness,0,2,1,3
1846,2023-01-24,SHELLY,gemGrab,Crystal Arcade,0,28,24,52
1847,2023-01-24,SHELLY,brawlBall,Center Stage,3,87,94,184
1848,2023-01-24,SHELLY,brawlBall,Beach Ball,10,419,372,801
1849,2023-01-24,SHELLY,bounty,Excel,0,17,15,32
1850,2023-01-23,SHELLY,knockout,New Perspective,0,151,159,310
1851,2023-01-23,SHELLY,hotZone,Dueling Beetles,0,22,10,32
1852,2023-01-23,SHELLY,heist,Snaked Assault,0,27,5,32
1853,2023-01-23,SHELLY,gemGrab,Minecart Madness,0,31,15,46
1854,2023-01-23,SHELLY,gemGrab,Double Swoosh,0,38,23,61
1855,2023-01-23,SHELLY,brawlBall,Center Stage,36,1213,1152,2401
1856,2023-01-23,SHELLY,brawlBall,Backyard Bowl,1,21,8,30
1857,2023-01-23,SHELLY,bounty,Layer Cake,0,19,2,21
1858,2023-01-22,SHELLY,knockout,X Marks the Spot,0,76,93,169
1859,2023-01-22,SHELLY,hotZone,Ring of Fire,0,9,3,12
1860,2023-01-22,SHELLY,heist,Snaked Assault,0,9,4,13
1861,2023-01-22,SHELLY,gemGrab,Hard Rock Mine,0,16,14,30
1862,2023-01-22,SHELLY,gemGrab,Double Swoosh,0,53,45,98
1863,2023-01-22,SHELLY,brawlBall,Super Beach,0,38,25,63
1864,2023-01-22,SHELLY,brawlBall,Backyard Bowl,4,100,70,174
1865,2023-01-22,SHELLY,bounty,Layer Cake,0,7,1,8
1866,2023-01-21,SHELLY,knockout,X Marks the Spot,0,190,259,449
1867,2023-01-21,SHELLY,hotZone,Ring of Fire,0,16,6,22
1868,2023-01-21,SHELLY,heist,Tornado Ring,0,19,5,24
1869,2023-01-21,SHELLY,gemGrab,Hard Rock Mine,0,56,23,79
1870,2023-01-21,SHELLY,gemGrab,Deep Diner,0,7,3,10
1871,2023-01-21,SHELLY,brawlBall,Super Beach,15,667,524,1206
1872,2023-01-21,SHELLY,brawlBall,Sneaky Fields,1,39,42,82
1873,2023-01-21,SHELLY,bounty,Dry Season,0,15,4,19
1874,2023-01-20,SHELLY,knockout,Out in the Open,0,65,72,137
1875,2023-01-20,SHELLY,hotZone,Split,0,33,40,73
1876,2023-01-20,SHELLY,heist,Tornado Ring,0,18,9,27
1877,2023-01-20,SHELLY,gemGrab,Undermine,0,19,11,30
1878,2023-01-20,SHELLY,gemGrab,Deep Diner,0,34,9,43
1879,2023-01-20,SHELLY,brawlBall,Sneaky Fields,29,1079,1074,2182
1880,2023-01-20,SHELLY,brawlBall,Pinhole Punt,2,15,10,27
1881,2023-01-20,SHELLY,bounty,Dry Season,0,8,5,13
1882,2023-01-19,SHELLY,knockout,Out in the Open,2,114,140,256
1883,2023-01-19,SHELLY,hotZone,Split,0,37,9,46
1884,2023-01-19,SHELLY,heist,Kaboom Canyon,0,8,7,15
1885,2023-01-19,SHELLY,gemGrab,Undermine,0,51,47,98
1886,2023-01-19,SHELLY,gemGrab,Gem Fort,0,26,16,42
1887,2023-01-19,SHELLY,brawlBall,Sunny Soccer,0,16,14,30
1888,2023-01-19,SHELLY,brawlBall,Pinhole Punt,5,439,310,754
1889,2023-01-19,SHELLY,bounty,Shooting Star,0,15,4,19
1890,2023-01-18,SHELLY,knockout,Goldarm Gulch,0,28,34,62
1891,2023-01-18,SHELLY,hotZone,Parallel Plays,0,2,1,3
1892,2023-01-18,SHELLY,heist,Kaboom Canyon,0,1,1,2
1893,2023-01-18,SHELLY,gemGrab,Gem Fort,0,18,15,33
1894,2023-01-18,SHELLY,gemGrab,Crystal Arcade,0,1,1,2
1895,2023-01-18,SHELLY,brawlBall,Sunny Soccer,2,117,103,222
1896,2023-01-18,SHELLY,brawlBall,Beach Ball,0,3,6,9
1897,2023-01-18,SHELLY,bounty,Shooting Star,0,1,1,2
1898,2023-01-17,SHELLY,knockout,Goldarm Gulch,0,21,24,45
1899,2023-01-17,SHELLY,hotZone,Parallel Plays,0,1,1,2
1900,2023-01-17,SHELLY,heist,Pit Stop,0,3,4,7
1901,2023-01-17,SHELLY,gemGrab,Crystal Arcade,0,5,2,7
1902,2023-01-17,SHELLY,brawlBall,Center Stage,0,6,5,11
1903,2023-01-17,SHELLY,brawlBall,Beach Ball,0,34,26,60
1904,2023-01-16,SHELLY,knockout,Belle's Rock,0,5,0,5
1905,2023-01-16,SHELLY,hotZone,Quarter Pounder,0,6,0,6
1906,2023-01-16,SHELLY,heist,Pit Stop,0,8,8,16
1907,2023-01-16,SHELLY,gemGrab,Minecart Madness,0,1,0,1
1908,2023-01-16,SHELLY,gemGrab,Double Swoosh,0,4,2,6
1909,2023-01-16,SHELLY,brawlBall,Center Stage,2,85,63,150
1910,2023-01-16,SHELLY,brawlBall,Backyard Bowl,0,3,1,4
1911,2023-01-16,SHELLY,bounty,Hideout,0,1,0,1
1912,2023-01-15,SHELLY,knockout,Belle's Rock,0,9,20,29
1913,2023-01-15,SHELLY,hotZone,Quarter Pounder,0,6,0,6
1914,2023-01-15,SHELLY,heist,Bridge Too Far,0,2,0,2
1915,2023-01-15,SHELLY,gemGrab,Hard Rock Mine,0,5,0,5
1916,2023-01-15,SHELLY,gemGrab,Double Swoosh,0,7,3,10
1917,2023-01-15,SHELLY,brawlBall,Super Beach,0,8,2,10
1918,2023-01-15,SHELLY,brawlBall,Backyard Bowl,0,32,12,44
1919,2023-01-15,SHELLY,bounty,Canal Grande,0,7,1,8
1920,2023-01-14,SHELLY,knockout,Flaring Phoenix,0,11,8,19
1921,2023-01-14,SHELLY,hotZone,Controller Chaos,0,10,1,11
1922,2023-01-14,SHELLY,heist,Bridge Too Far,0,3,0,3
1923,2023-01-14,SHELLY,gemGrab,Hard Rock Mine,0,3,1,4
1924,2023-01-14,SHELLY,gemGrab,Deep Diner,0,2,1,3
1925,2023-01-14,SHELLY,brawlBall,Super Beach,1,42,34,77
1926,2023-01-14,SHELLY,brawlBall,Sneaky Fields,0,3,16,19
1927,2023-01-14,SHELLY,bounty,Canal Grande,0,3,8,11
1928,2023-01-13,SHELLY,knockout,Flaring Phoenix,0,6,6,12
1929,2023-01-13,SHELLY,hotZone,Controller Chaos,0,5,3,8
1930,2023-01-13,SHELLY,gemGrab,Deep Diner,0,5,3,8
1931,2023-01-13,SHELLY,brawlBall,Sneaky Fields,1,63,91,155
1932,2023-01-13,SHELLY,bounty,Temple Ruins,0,3,0,3
1933,2023-01-12,SHELLY,knockout,Riverside,0,4,0,4
1934,2023-01-12,SHELLY,hotZone,Open Zone,0,1,1,2
1935,2023-01-12,SHELLY,gemGrab,Undermine,0,2,0,2
1936,2023-01-12,SHELLY,gemGrab,Gem Fort,0,2,1,3
1937,2023-01-12,SHELLY,brawlBall,Sunny Soccer,0,2,0,2
1938,2023-01-12,SHELLY,brawlBall,Pinhole Punt,0,7,1,8
1939,2023-01-12,SHELLY,bounty,Temple Ruins,0,0,1,1
1940,2023-01-11,SHELLY,knockout,Riverside,0,1,0,1
1941,2023-01-11,SHELLY,gemGrab,Gem Fort,0,3,1,4
1942,2023-01-11,SHELLY,brawlBall,Sunny Soccer,0,11,11,22
1943,2023-01-11,SHELLY,brawlBall,Beach Ball,0,1,1,2
1944,2023-01-10,SHELLY,knockout,New Perspective,0,5,15,20
1945,2023-01-10,SHELLY,hotZone,Dueling Beetles,0,2,0,2
1946,2023-01-10,SHELLY,heist,Safe Zone,0,1,0,1
1947,2023-01-10,SHELLY,gemGrab,Minecart Madness,0,3,0,3
1948,2023-01-10,SHELLY,gemGrab,Crystal Arcade,0,3,0,3
1949,2023-01-10,SHELLY,brawlBall,Center Stage,1,5,3,9
1950,2023-01-10,SHELLY,brawlBall,Beach Ball,0,23,8,31
1951,2023-01-10,SHELLY,bounty,Excel,0,2,0,2
1952,2023-01-09,SHELLY,knockout,New Perspective,0,6,23,29
1953,2023-01-09,SHELLY,hotZone,Dueling Beetles,0,1,4,5
1954,2023-01-09,SHELLY,heist,Snaked Assault,0,4,1,5
1955,2023-01-09,SHELLY,gemGrab,Minecart Madness,0,2,0,2
1956,2023-01-09,SHELLY,gemGrab,Double Swoosh,0,8,0,8
1957,2023-01-09,SHELLY,brawlBall,Center Stage,1,80,68,149
1958,2023-01-09,SHELLY,brawlBall,Backyard Bowl,0,2,0,2
1959,2023-01-09,SHELLY,bounty,Layer Cake,0,5,0,5
1960,2023-01-08,SHELLY,knockout,X Marks the Spot,0,3,3,6
1961,2023-01-08,SHELLY,hotZone,Ring of Fire,0,1,0,1
1962,2023-01-08,SHELLY,heist,Snaked Assault,0,5,0,5
1963,2023-01-08,SHELLY,gemGrab,Hard Rock Mine,0,4,2,6
1964,2023-01-08,SHELLY,gemGrab,Double Swoosh,0,7,3,10
1965,2023-01-08,SHELLY,brawlBall,Super Beach,0,2,1,3
1966,2023-01-08,SHELLY,brawlBall,Backyard Bowl,0,21,4,25
1967,2023-01-08,SHELLY,bounty,Layer Cake,0,1,0,1
1968,2023-01-07,SHELLY,hotZone,Ring of Fire,0,1,0,1
1969,2023-01-07,SHELLY,heist,Tornado Ring,0,2,0,2
1970,2023-01-07,SHELLY,gemGrab,Hard Rock Mine,0,1,0,1
1971,2023-01-07,SHELLY,gemGrab,Deep Diner,0,3,0,3
1972,2023-01-07,SHELLY,brawlBall,Super Beach,0,7,2,9
1973,2023-01-07,SHELLY,brawlBall,Sneaky Fields,0,3,0,3
1974,2023-01-07,SHELLY,bounty,Dry Season,0,2,0,2
1975,2023-01-06,SHELLY,knockout,Out in the Open,0,12,24,36
1976,2023-01-06,SHELLY,hotZone,Split,0,5,0,5
1977,2023-01-06,SHELLY,heist,Tornado Ring,0,3,0,3
1978,2023-01-06,SHELLY,gemGrab,Deep Diner,0,2,0,2
1979,2023-01-06,SHELLY,brawlBall,Sneaky Fields,2,46,60,108
1980,2023-01-06,SHELLY,brawlBall,Pinhole Punt,0,4,1,5
1981,2023-01-06,SHELLY,bounty,Dry Season,0,1,0,1
1982,2023-01-05,SHELLY,knockout,Out in the Open,0,16,13,29
1983,2023-01-05,SHELLY,hotZone,Split,0,8,0,8
1984,2023-01-05,SHELLY,heist,Kaboom Canyon,0,3,1,4
1985,2023-01-05,SHELLY,gemGrab,Undermine,0,5,1,6
1986,2023-01-05,SHELLY,gemGrab,Gem Fort,0,0,1,1
1987,2023-01-05,SHELLY,brawlBall,Pinhole Punt,0,31,13,44
1988,2023-01-05,SHELLY,bounty,Shooting Star,0,1,0,1
1989,2023-01-04,SHELLY,knockout,Goldarm Gulch,0,7,5,12
1990,2023-01-04,SHELLY,hotZone,Parallel Plays,0,3,0,3
1991,2023-01-04,SHELLY,heist,Kaboom Canyon,0,3,0,3
1992,2023-01-04,SHELLY,gemGrab,Gem Fort,0,5,2,7
1993,2023-01-04,SHELLY,gemGrab,Crystal Arcade,0,1,3,4
1994,2023-01-04,SHELLY,brawlBall,Sunny Soccer,1,46,27,74
1995,2023-01-04,SHELLY,brawlBall,Beach Ball,0,1,0,1
1996,2023-01-03,SHELLY,knockout,Goldarm Gulch,0,3,0,3
1997,2023-01-03,SHELLY,hotZone,Parallel Plays,0,3,0,3
1998,2023-01-03,SHELLY,heist,Pit Stop,0,3,0,3
1999,2023-01-03,SHELLY,gemGrab,Minecart Madness,0,1,0,1
2000,2023-01-03,SHELLY,gemGrab,Crystal Arcade,0,2,1,3
2001,2023-01-03,SHELLY,brawlBall,Center Stage,1,4,10,15
2002,2023-01-03,SHELLY,brawlBall,Beach Ball,0,24,1,25
2003,2023-01-02,SHELLY,knockout,Belle's Rock,0,4,0,4
2004,2023-01-02,SHELLY,hotZone,Quarter Pounder,0,10,1,11
2005,2023-01-02,SHELLY,heist,Pit Stop,0,5,1,6
2006,2023-01-02,SHELLY,heist,Kaboom Canyon,0,0,1,1
2007,2023-01-02,SHELLY,gemGrab,Minecart Madness,0,1,0,1
2008,2023-01-02,SHELLY,gemGrab,Double Swoosh,0,9,15,24
2009,2023-01-02,SHELLY,brawlBall,Center Stage,1,68,79,148
2010,2023-01-02,SHELLY,brawlBall,Backyard Bowl,0,2,3,5
2011,2023-01-02,SHELLY,bounty,Hideout,0,4,0,4
2012,2023-01-01,SHELLY,knockout,Belle's Rock,0,2,4,6
2013,2023-01-01,SHELLY,hotZone,Quarter Pounder,0,1,0,1
2014,2023-01-01,SHELLY,gemGrab,Hard Rock Mine,0,0,1,1
2015,2023-01-01,SHELLY,gemGrab,Double Swoosh,0,5,1,6
2016,2023-01-01,SHELLY,brawlBall,Backyard Bowl,1,6,6,13
2017,2022-12-31,SHELLY,knockout,Flaring Phoenix,0,0,1,1
2018,2022-12-31,SHELLY,hotZone,Controller Chaos,0,2,0,2
2019,2022-12-31,SHELLY,gemGrab,Deep Diner,0,1,0,1
2020,2022-12-31,SHELLY,brawlBall,Super Beach,1,5,2,8
2021,2022-12-31,SHELLY,brawlBall,Sneaky Fields,0,0,1,1
2022,2022-12-30,SHELLY,knockout,Flaring Phoenix,0,2,1,3
2023,2022-12-30,SHELLY,hotZone,Controller Chaos,0,3,0,3
2024,2022-12-30,SHELLY,gemGrab,Minecart Madness,0,0,1,1
2025,2022-12-30,SHELLY,gemGrab,Deep Diner,0,1,0,1
2026,2022-12-30,SHELLY,brawlBall,Sneaky Fields,1,3,1,5
2027,2022-12-29,SHELLY,gemGrab,Undermine,0,1,0,1
2028,2022-12-29,SHELLY,brawlBall,Pinhole Punt,0,0,1,1
2029,2022-12-28,SHELLY,hotZone,Controller Chaos,0,0,1,1
2030,2022-12-28,SHELLY,gemGrab,Crystal Arcade,0,1,0,1
2031,2022-12-28,SHELLY,brawlBall,Beach Ball,0,1,0,1
2032,2022-12-27,SHELLY,brawlBall,Beach Ball,0,1,1,2
2033,2022-12-26,SHELLY,hotZone,Controller Chaos,0,0,1,1
2034,2022-12-26,SHELLY,heist,Kaboom Canyon,0,0,1,1
2035,2022-12-26,SHELLY,gemGrab,Minecart Madness,0,1,1,2
2036,2022-12-26,SHELLY,brawlBall,Center Stage,0,1,0,1
2037,2022-12-24,SHELLY,brawlBall,Super Beach,0,1,0,1
2038,2022-12-23,SHELLY,brawlBall,Sneaky Fields,0,0,1,1
2039,2022-12-22,SHELLY,brawlBall,Pinhole Punt,0,1,0,1
2040,2022-12-20,SHELLY,brawlBall,Beach Ball,0,1,1,2
2041,2022-12-13,SHELLY,brawlBall,Beach Ball,0,0,1,1
2042,2022-10-26,SHELLY,brawlBall,Sunny Soccer,0,0,1,1
2043,2023-01-30,SANDY,knockout,Belle's Rock,0,6,5,11
2044,2023-01-30,SANDY,hotZone,Quarter Pounder,1,47,67,115
2045,2023-01-30,SANDY,heist,Pit Stop,0,1,0,1
2046,2023-01-30,SANDY,gemGrab,Minecart Madness,0,30,34,64
2047,2023-01-30,SANDY,gemGrab,Double Swoosh,0,59,73,132
2048,2023-01-30,SANDY,brawlBall,Center Stage,2,132,160,294
2049,2023-01-30,SANDY,brawlBall,Backyard Bowl,0,4,2,6
2050,2023-01-30,SANDY,bounty,Hideout,0,2,1,3
2051,2023-01-29,SANDY,knockout,Belle's Rock,0,9,4,13
2052,2023-01-29,SANDY,hotZone,Quarter Pounder,0,21,18,39
2053,2023-01-29,SANDY,heist,Bridge Too Far,0,1,1,2
2054,2023-01-29,SANDY,gemGrab,Hard Rock Mine,0,10,23,33
2055,2023-01-29,SANDY,gemGrab,Double Swoosh,0,100,100,200
2056,2023-01-29,SANDY,brawlBall,Super Beach,0,10,20,30
2057,2023-01-29,SANDY,brawlBall,Backyard Bowl,5,75,61,141
2058,2023-01-29,SANDY,bounty,Canal Grande,0,15,9,24
2059,2023-01-28,SANDY,knockout,Flaring Phoenix,0,6,7,13
2060,2023-01-28,SANDY,hotZone,Controller Chaos,0,36,54,90
2061,2023-01-28,SANDY,heist,Bridge Too Far,1,3,0,4
2062,2023-01-28,SANDY,gemGrab,Hard Rock Mine,0,66,76,142
2063,2023-01-28,SANDY,gemGrab,Deep Diner,0,20,43,63
2064,2023-01-28,SANDY,brawlBall,Super Beach,12,310,342,664
2065,2023-01-28,SANDY,brawlBall,Sneaky Fields,0,7,9,16
2066,2023-01-28,SANDY,bounty,Canal Grande,0,23,26,49
2067,2023-01-27,SANDY,knockout,Flaring Phoenix,0,1,2,3
2068,2023-01-27,SANDY,hotZone,Controller Chaos,0,14,16,30
2069,2023-01-27,SANDY,gemGrab,Undermine,0,5,6,11
2070,2023-01-27,SANDY,gemGrab,Deep Diner,0,38,57,95
2071,2023-01-27,SANDY,brawlBall,Sneaky Fields,4,62,69,135
2072,2023-01-27,SANDY,brawlBall,Pinhole Punt,0,1,1,2
2073,2023-01-27,SANDY,bounty,Temple Ruins,0,3,7,10
2074,2023-01-26,SANDY,knockout,Riverside,0,8,9,17
2075,2023-01-26,SANDY,hotZone,Open Zone,0,28,12,40
2076,2023-01-26,SANDY,heist,Hot Potato,0,3,1,4
2077,2023-01-26,SANDY,gemGrab,Undermine,0,61,86,147
2078,2023-01-26,SANDY,gemGrab,Gem Fort,0,29,24,53
2079,2023-01-26,SANDY,brawlBall,Sunny Soccer,0,16,4,20
2080,2023-01-26,SANDY,brawlBall,Pinhole Punt,8,257,273,538
2081,2023-01-26,SANDY,bounty,Temple Ruins,0,13,10,23
2082,2023-01-25,SANDY,hotZone,Open Zone,0,1,6,7
2083,2023-01-25,SANDY,heist,Safe Zone,0,2,0,2
2084,2023-01-25,SANDY,gemGrab,Gem Fort,0,24,22,46
2085,2023-01-25,SANDY,gemGrab,Crystal Arcade,0,52,58,110
2086,2023-01-25,SANDY,brawlBall,Sunny Soccer,4,133,194,331
2087,2023-01-25,SANDY,brawlBall,Beach Ball,3,24,17,44
2088,2023-01-25,SANDY,bounty,Excel,0,2,1,3
2089,2023-01-24,SANDY,knockout,New Perspective,0,12,6,18
2090,2023-01-24,SANDY,hotZone,Dueling Beetles,0,57,41,98
2091,2023-01-24,SANDY,gemGrab,Minecart Madness,0,16,13,29
2092,2023-01-24,SANDY,gemGrab,Crystal Arcade,0,136,183,319
2093,2023-01-24,SANDY,brawlBall,Center Stage,2,23,35,60
2094,2023-01-24,SANDY,brawlBall,Beach Ball,12,273,320,605
2095,2023-01-24,SANDY,bounty,Excel,0,9,2,11
2096,2023-01-23,SANDY,knockout,New Perspective,0,18,7,25
2097,2023-01-23,SANDY,hotZone,Dueling Beetles,0,64,52,116
2098,2023-01-23,SANDY,heist,Snaked Assault,0,1,2,3
2099,2023-01-23,SANDY,gemGrab,Minecart Madness,0,41,35,76
2100,2023-01-23,SANDY,gemGrab,Double Swoosh,0,52,61,113
2101,2023-01-23,SANDY,brawlBall,Center Stage,7,242,329,578
2102,2023-01-23,SANDY,brawlBall,Backyard Bowl,1,5,3,9
2103,2023-01-23,SANDY,bounty,Layer Cake,0,3,7,10
2104,2023-01-22,SANDY,knockout,X Marks the Spot,0,3,3,6
2105,2023-01-22,SANDY,hotZone,Ring of Fire,0,22,17,39
2106,2023-01-22,SANDY,heist,Snaked Assault,0,1,0,1
2107,2023-01-22,SANDY,gemGrab,Hard Rock Mine,0,19,21,40
2108,2023-01-22,SANDY,gemGrab,Double Swoosh,0,92,112,204
2109,2023-01-22,SANDY,brawlBall,Super Beach,0,27,28,55
2110,2023-01-22,SANDY,brawlBall,Backyard Bowl,2,36,42,80
2111,2023-01-22,SANDY,bounty,Layer Cake,0,5,4,9
2112,2023-01-21,SANDY,knockout,X Marks the Spot,1,20,9,30
2113,2023-01-21,SANDY,hotZone,Ring of Fire,0,76,77,153
2114,2023-01-21,SANDY,heist,Tornado Ring,0,2,0,2
2115,2023-01-21,SANDY,gemGrab,Hard Rock Mine,0,113,101,214
2116,2023-01-21,SANDY,gemGrab,Deep Diner,0,16,10,26
2117,2023-01-21,SANDY,brawlBall,Super Beach,15,415,485,915
2118,2023-01-21,SANDY,brawlBall,Sneaky Fields,1,6,8,15
2119,2023-01-21,SANDY,bounty,Dry Season,0,1,4,5
2120,2023-01-20,SANDY,knockout,Out in the Open,0,14,21,35
2121,2023-01-20,SANDY,hotZone,Split,0,17,17,34
2122,2023-01-20,SANDY,heist,Tornado Ring,0,0,2,2
2123,2023-01-20,SANDY,gemGrab,Undermine,0,35,31,66
2124,2023-01-20,SANDY,gemGrab,Deep Diner,0,83,90,173
2125,2023-01-20,SANDY,brawlBall,Sneaky Fields,13,300,297,610
2126,2023-01-20,SANDY,brawlBall,Pinhole Punt,0,3,6,9
2127,2023-01-20,SANDY,bounty,Dry Season,0,5,11,16
2128,2023-01-19,SANDY,knockout,Out in the Open,0,20,9,29
2129,2023-01-19,SANDY,hotZone,Split,0,18,16,34
2130,2023-01-19,SANDY,heist,Kaboom Canyon,0,3,4,7
2131,2023-01-19,SANDY,gemGrab,Undermine,0,68,122,190
2132,2023-01-19,SANDY,gemGrab,Gem Fort,0,10,12,22
2133,2023-01-19,SANDY,brawlBall,Sunny Soccer,0,7,7,14
2134,2023-01-19,SANDY,brawlBall,Pinhole Punt,9,240,285,534
2135,2023-01-19,SANDY,bounty,Shooting Star,0,3,2,5
2136,2023-01-18,SANDY,knockout,Goldarm Gulch,0,4,4,8
2137,2023-01-18,SANDY,hotZone,Parallel Plays,0,5,12,17
2138,2023-01-18,SANDY,heist,Kaboom Canyon,0,0,1,1
2139,2023-01-18,SANDY,gemGrab,Gem Fort,0,17,14,31
2140,2023-01-18,SANDY,gemGrab,Crystal Arcade,0,9,15,24
2141,2023-01-18,SANDY,brawlBall,Sunny Soccer,2,88,95,185
2142,2023-01-18,SANDY,brawlBall,Beach Ball,1,4,2,7
2143,2023-01-18,SANDY,bounty,Shooting Star,0,2,0,2
2144,2023-01-17,SANDY,knockout,Goldarm Gulch,0,5,8,13
2145,2023-01-17,SANDY,hotZone,Parallel Plays,0,5,4,9
2146,2023-01-17,SANDY,heist,Pit Stop,0,0,1,1
2147,2023-01-17,SANDY,gemGrab,Crystal Arcade,0,7,8,15
2148,2023-01-17,SANDY,brawlBall,Beach Ball,3,23,31,57
2149,2023-01-17,SANDY,bounty,Hideout,0,4,4,8
2150,2023-01-16,SANDY,knockout,Belle's Rock,0,1,0,1
2151,2023-01-16,SANDY,hotZone,Quarter Pounder,0,7,3,10
2152,2023-01-16,SANDY,heist,Pit Stop,0,1,1,2
2153,2023-01-16,SANDY,gemGrab,Minecart Madness,0,1,0,1
2154,2023-01-16,SANDY,gemGrab,Double Swoosh,0,7,4,11
2155,2023-01-16,SANDY,brawlBall,Center Stage,2,13,4,19
2156,2023-01-16,SANDY,brawlBall,Backyard Bowl,0,1,0,1
2157,2023-01-15,SANDY,hotZone,Quarter Pounder,0,2,0,2
2158,2023-01-15,SANDY,heist,Bridge Too Far,0,0,1,1
2159,2023-01-15,SANDY,gemGrab,Hard Rock Mine,0,7,22,29
2160,2023-01-15,SANDY,gemGrab,Double Swoosh,0,16,17,33
2161,2023-01-15,SANDY,brawlBall,Super Beach,1,5,8,14
2162,2023-01-15,SANDY,brawlBall,Backyard Bowl,1,11,3,15
2163,2023-01-15,SANDY,bounty,Canal Grande,0,1,1,2
2164,2023-01-14,SANDY,hotZone,Controller Chaos,0,16,32,48
2165,2023-01-14,SANDY,gemGrab,Hard Rock Mine,0,4,2,6
2166,2023-01-14,SANDY,gemGrab,Deep Diner,0,1,4,5
2167,2023-01-14,SANDY,brawlBall,Super Beach,0,21,30,51
2168,2023-01-14,SANDY,brawlBall,Sneaky Fields,0,0,5,5
2169,2023-01-14,SANDY,bounty,Canal Grande,0,9,8,17
2170,2023-01-13,SANDY,knockout,Flaring Phoenix,0,1,0,1
2171,2023-01-13,SANDY,hotZone,Controller Chaos,0,3,0,3
2172,2023-01-13,SANDY,gemGrab,Undermine,0,0,1,1
2173,2023-01-13,SANDY,gemGrab,Deep Diner,0,6,2,8
2174,2023-01-13,SANDY,brawlBall,Sneaky Fields,0,10,6,16
2175,2023-01-13,SANDY,brawlBall,Pinhole Punt,0,0,1,1
2176,2023-01-12,SANDY,hotZone,Open Zone,0,4,0,4
2177,2023-01-12,SANDY,gemGrab,Undermine,0,4,5,9
2178,2023-01-12,SANDY,gemGrab,Gem Fort,0,2,3,5
2179,2023-01-12,SANDY,brawlBall,Sunny Soccer,0,2,13,15
2180,2023-01-12,SANDY,brawlBall,Pinhole Punt,0,10,11,21
2181,2023-01-11,SANDY,hotZone,Open Zone,0,0,3,3
2182,2023-01-11,SANDY,gemGrab,Gem Fort,0,1,0,1
2183,2023-01-11,SANDY,brawlBall,Sunny Soccer,0,6,2,8
2184,2023-01-11,SANDY,brawlBall,Beach Ball,0,0,1,1
2185,2023-01-10,SANDY,knockout,New Perspective,0,1,1,2
2186,2023-01-10,SANDY,hotZone,Dueling Beetles,0,13,12,25
2187,2023-01-10,SANDY,gemGrab,Crystal Arcade,0,15,43,58
2188,2023-01-10,SANDY,brawlBall,Center Stage,0,0,1,1
2189,2023-01-10,SANDY,brawlBall,Beach Ball,0,24,8,32
2190,2023-01-09,SANDY,knockout,New Perspective,0,2,0,2
2191,2023-01-09,SANDY,hotZone,Dueling Beetles,0,12,14,26
2192,2023-01-09,SANDY,gemGrab,Minecart Madness,0,2,1,3
2193,2023-01-09,SANDY,gemGrab,Double Swoosh,0,7,4,11
2194,2023-01-09,SANDY,brawlBall,Center Stage,0,7,15,22
2195,2023-01-09,SANDY,brawlBall,Backyard Bowl,0,2,0,2
2196,2023-01-08,SANDY,knockout,X Marks the Spot,0,2,0,2
2197,2023-01-08,SANDY,hotZone,Ring of Fire,0,3,4,7
2198,2023-01-08,SANDY,gemGrab,Hard Rock Mine,0,1,0,1
2199,2023-01-08,SANDY,gemGrab,Double Swoosh,0,7,22,29
2200,2023-01-08,SANDY,brawlBall,Super Beach,0,2,0,2
2201,2023-01-08,SANDY,brawlBall,Backyard Bowl,0,2,5,7
2202,2023-01-07,SANDY,hotZone,Ring of Fire,0,4,6,10
2203,2023-01-07,SANDY,gemGrab,Hard Rock Mine,0,6,3,9
2204,2023-01-07,SANDY,gemGrab,Deep Diner,0,4,7,11
2205,2023-01-07,SANDY,brawlBall,Super Beach,0,13,18,31
2206,2023-01-07,SANDY,brawlBall,Sneaky Fields,0,1,0,1
2207,2023-01-06,SANDY,hotZone,Split,0,2,4,6
2208,2023-01-06,SANDY,heist,Tornado Ring,0,1,0,1
2209,2023-01-06,SANDY,gemGrab,Undermine,0,4,1,5
2210,2023-01-06,SANDY,gemGrab,Deep Diner,0,12,7,19
2211,2023-01-06,SANDY,brawlBall,Sneaky Fields,0,11,11,22
2212,2023-01-06,SANDY,brawlBall,Pinhole Punt,0,4,1,5
2213,2023-01-06,SANDY,bounty,Dry Season,0,1,0,1
2214,2023-01-05,SANDY,hotZone,Split,0,6,13,19
2215,2023-01-05,SANDY,gemGrab,Undermine,0,5,3,8
2216,2023-01-05,SANDY,gemGrab,Gem Fort,0,2,12,14
2217,2023-01-05,SANDY,brawlBall,Pinhole Punt,0,24,23,47
2218,2023-01-04,SANDY,knockout,Goldarm Gulch,0,1,0,1
2219,2023-01-04,SANDY,hotZone,Parallel Plays,0,1,1,2
2220,2023-01-04,SANDY,gemGrab,Gem Fort,0,6,17,23
2221,2023-01-04,SANDY,gemGrab,Crystal Arcade,0,5,5,10
2222,2023-01-04,SANDY,brawlBall,Sunny Soccer,0,19,22,41
2223,2023-01-03,SANDY,gemGrab,Minecart Madness,0,1,0,1
2224,2023-01-03,SANDY,gemGrab,Crystal Arcade,0,22,5,27
2225,2023-01-03,SANDY,brawlBall,Beach Ball,0,13,11,24
2226,2023-01-02,SANDY,knockout,Belle's Rock,0,1,0,1
2227,2023-01-02,SANDY,hotZone,Quarter Pounder,0,2,1,3
2228,2023-01-02,SANDY,gemGrab,Minecart Madness,0,7,0,7
2229,2023-01-02,SANDY,gemGrab,Double Swoosh,0,8,16,24
2230,2023-01-02,SANDY,brawlBall,Center Stage,0,10,10,20
2231,2023-01-02,SANDY,brawlBall,Backyard Bowl,0,0,1,1
2232,2023-01-01,SANDY,hotZone,Quarter Pounder,0,6,11,17
2233,2023-01-01,SANDY,gemGrab,Double Swoosh,0,14,18,32
2234,2023-01-01,SANDY,brawlBall,Backyard Bowl,0,3,6,9
2235,2022-12-31,SANDY,hotZone,Controller Chaos,0,0,1,1
2236,2022-12-31,SANDY,gemGrab,Deep Diner,0,1,0,1
2237,2022-12-31,SANDY,brawlBall,Super Beach,0,5,2,7
2238,2022-12-30,SANDY,hotZone,Controller Chaos,0,1,2,3
2239,2022-12-30,SANDY,gemGrab,Minecart Madness,0,1,0,1
2240,2022-12-30,SANDY,gemGrab,Deep Diner,0,0,2,2
2241,2022-12-30,SANDY,brawlBall,Sneaky Fields,0,5,8,13
2242,2022-12-29,SANDY,brawlBall,Pinhole Punt,0,4,4,8
2243,2022-12-28,SANDY,gemGrab,Crystal Arcade,0,0,1,1
2244,2022-12-27,SANDY,hotZone,Dueling Beetles,0,1,0,1
2245,2022-12-27,SANDY,brawlBall,Beach Ball,0,0,1,1
2246,2022-12-21,SANDY,brawlBall,Sunny Soccer,0,0,1,1
2247,2022-12-20,SANDY,brawlBall,Beach Ball,0,0,1,1
2248,2022-12-19,SANDY,brawlBall,Center Stage,0,0,1,1
2249,2022-12-13,SANDY,knockout,New Perspective,0,1,0,1
2250,2022-12-13,SANDY,brawlBall,Beach Ball,0,0,1,1
2251,2022-10-30,SANDY,brawlBall,Beach Ball,0,1,0,1
2252,2022-10-15,SANDY,gemGrab,Hard Rock Mine,0,1,2,3
2253,2023-01-30,SAM,knockout,Belle's Rock,0,85,81,166
2254,2023-01-30,SAM,hotZone,Quarter Pounder,0,110,139,249
2255,2023-01-30,SAM,heist,Pit Stop,0,126,133,259
2256,2023-01-30,SAM,gemGrab,Minecart Madness,0,23,26,49
2257,2023-01-30,SAM,gemGrab,Double Swoosh,0,32,30,62
2258,2023-01-30,SAM,brawlBall,Center Stage,4,389,595,988
2259,2023-01-30,SAM,brawlBall,Backyard Bowl,2,33,45,80
2260,2023-01-30,SAM,bounty,Hideout,0,4,5,9
2261,2023-01-29,SAM,knockout,Belle's Rock,0,86,90,176
2262,2023-01-29,SAM,hotZone,Quarter Pounder,1,93,149,243
2263,2023-01-29,SAM,heist,Bridge Too Far,0,201,316,517
2264,2023-01-29,SAM,gemGrab,Hard Rock Mine,0,25,38,63
2265,2023-01-29,SAM,gemGrab,Double Swoosh,0,65,76,141
2266,2023-01-29,SAM,brawlBall,Super Beach,0,10,16,26
2267,2023-01-29,SAM,brawlBall,Backyard Bowl,19,302,451,772
2268,2023-01-29,SAM,bounty,Canal Grande,0,39,36,75
2269,2023-01-28,SAM,knockout,Flaring Phoenix,0,45,32,77
2270,2023-01-28,SAM,hotZone,Controller Chaos,0,73,143,216
2271,2023-01-28,SAM,heist,Bridge Too Far,0,306,424,730
2272,2023-01-28,SAM,gemGrab,Hard Rock Mine,0,101,158,259
2273,2023-01-28,SAM,gemGrab,Deep Diner,0,27,19,46
2274,2023-01-28,SAM,brawlBall,Super Beach,18,647,834,1499
2275,2023-01-28,SAM,brawlBall,Sneaky Fields,2,31,39,72
2276,2023-01-28,SAM,bounty,Canal Grande,0,42,35,77
2277,2023-01-27,SAM,knockout,Flaring Phoenix,1,15,29,45
2278,2023-01-27,SAM,hotZone,Controller Chaos,0,20,38,58
2279,2023-01-27,SAM,heist,Hot Potato,0,46,74,120
2280,2023-01-27,SAM,gemGrab,Undermine,0,5,6,11
2281,2023-01-27,SAM,gemGrab,Deep Diner,0,33,52,85
2282,2023-01-27,SAM,brawlBall,Sneaky Fields,4,203,208,415
2283,2023-01-27,SAM,brawlBall,Pinhole Punt,0,6,8,14
2284,2023-01-27,SAM,bounty,Temple Ruins,0,8,7,15
2285,2023-01-26,SAM,knockout,Riverside,0,29,24,53
2286,2023-01-26,SAM,hotZone,Open Zone,0,30,24,54
2287,2023-01-26,SAM,heist,Hot Potato,1,117,133,251
2288,2023-01-26,SAM,gemGrab,Undermine,0,68,67,135
2289,2023-01-26,SAM,gemGrab,Gem Fort,0,33,41,74
2290,2023-01-26,SAM,brawlBall,Sunny Soccer,0,33,43,76
2291,2023-01-26,SAM,brawlBall,Pinhole Punt,7,481,620,1108
2292,2023-01-26,SAM,bounty,Temple Ruins,0,28,32,60
2293,2023-01-25,SAM,knockout,Riverside,0,6,9,15
2294,2023-01-25,SAM,hotZone,Open Zone,0,7,1,8
2295,2023-01-25,SAM,heist,Safe Zone,1,41,53,95
2296,2023-01-25,SAM,gemGrab,Gem Fort,0,44,38,82
2297,2023-01-25,SAM,gemGrab,Crystal Arcade,0,30,23,53
2298,2023-01-25,SAM,brawlBall,Sunny Soccer,5,381,463,849
2299,2023-01-25,SAM,brawlBall,Beach Ball,3,72,78,153
2300,2023-01-25,SAM,bounty,Excel,0,17,27,44
2301,2023-01-24,SAM,knockout,New Perspective,0,37,29,66
2302,2023-01-24,SAM,hotZone,Dueling Beetles,0,82,108,190
2303,2023-01-24,SAM,heist,Safe Zone,0,54,112,166
2304,2023-01-24,SAM,gemGrab,Minecart Madness,0,15,23,38
2305,2023-01-24,SAM,gemGrab,Crystal Arcade,0,75,101,176
2306,2023-01-24,SAM,brawlBall,Center Stage,2,77,82,161
2307,2023-01-24,SAM,brawlBall,Beach Ball,10,473,629,1112
2308,2023-01-24,SAM,bounty,Excel,0,73,130,203
2309,2023-01-23,SAM,knockout,New Perspective,0,48,61,109
2310,2023-01-23,SAM,hotZone,Dueling Beetles,0,93,120,213
2311,2023-01-23,SAM,heist,Snaked Assault,0,123,97,220
2312,2023-01-23,SAM,gemGrab,Minecart Madness,0,71,80,151
2313,2023-01-23,SAM,gemGrab,Double Swoosh,0,16,28,44
2314,2023-01-23,SAM,brawlBall,Center Stage,23,648,823,1494
2315,2023-01-23,SAM,brawlBall,Backyard Bowl,0,15,22,37
2316,2023-01-23,SAM,bounty,Layer Cake,0,25,41,66
2317,2023-01-22,SAM,knockout,X Marks the Spot,0,18,21,39
2318,2023-01-22,SAM,hotZone,Ring of Fire,0,37,38,75
2319,2023-01-22,SAM,heist,Snaked Assault,0,43,48,91
2320,2023-01-22,SAM,gemGrab,Hard Rock Mine,0,26,33,59
2321,2023-01-22,SAM,gemGrab,Double Swoosh,0,47,53,100
2322,2023-01-22,SAM,brawlBall,Super Beach,1,60,99,160
2323,2023-01-22,SAM,brawlBall,Backyard Bowl,6,133,210,349
2324,2023-01-22,SAM,bounty,Layer Cake,0,16,18,34
2325,2023-01-21,SAM,knockout,X Marks the Spot,0,82,68,150
2326,2023-01-21,SAM,hotZone,Ring of Fire,0,74,76,150
2327,2023-01-21,SAM,heist,Tornado Ring,0,109,101,210
2328,2023-01-21,SAM,gemGrab,Hard Rock Mine,0,110,214,324
2329,2023-01-21,SAM,gemGrab,Deep Diner,0,21,34,55
2330,2023-01-21,SAM,brawlBall,Super Beach,29,735,997,1761
2331,2023-01-21,SAM,brawlBall,Sneaky Fields,2,52,65,119
2332,2023-01-21,SAM,bounty,Dry Season,0,20,32,52
2333,2023-01-20,SAM,knockout,Out in the Open,0,41,59,100
2334,2023-01-20,SAM,hotZone,Split,0,78,120,198
2335,2023-01-20,SAM,heist,Tornado Ring,0,69,85,154
2336,2023-01-20,SAM,gemGrab,Undermine,0,43,55,98
2337,2023-01-20,SAM,gemGrab,Deep Diner,0,84,93,177
2338,2023-01-20,SAM,brawlBall,Sneaky Fields,15,606,716,1337
2339,2023-01-20,SAM,brawlBall,Pinhole Punt,1,22,24,47
2340,2023-01-20,SAM,bounty,Dry Season,0,24,20,44
2341,2023-01-19,SAM,knockout,Out in the Open,0,46,49,95
2342,2023-01-19,SAM,hotZone,Split,0,195,296,491
2343,2023-01-19,SAM,heist,Kaboom Canyon,0,32,33,65
2344,2023-01-19,SAM,gemGrab,Undermine,0,55,69,124
2345,2023-01-19,SAM,gemGrab,Gem Fort,0,24,21,45
2346,2023-01-19,SAM,brawlBall,Sunny Soccer,0,23,16,39
2347,2023-01-19,SAM,brawlBall,Pinhole Punt,10,434,611,1055
2348,2023-01-19,SAM,bounty,Shooting Star,0,6,12,18
2349,2023-01-18,SAM,knockout,Goldarm Gulch,0,7,7,14
2350,2023-01-18,SAM,hotZone,Parallel Plays,0,21,16,37
2351,2023-01-18,SAM,heist,Kaboom Canyon,0,9,5,14
2352,2023-01-18,SAM,gemGrab,Gem Fort,0,12,8,20
2353,2023-01-18,SAM,gemGrab,Crystal Arcade,0,9,11,20
2354,2023-01-18,SAM,brawlBall,Sunny Soccer,4,161,210,375
2355,2023-01-18,SAM,brawlBall,Beach Ball,0,4,3,7
2356,2023-01-18,SAM,bounty,Shooting Star,0,2,6,8
2357,2023-01-17,SAM,knockout,Goldarm Gulch,0,19,12,31
2358,2023-01-17,SAM,hotZone,Parallel Plays,0,12,24,36
2359,2023-01-17,SAM,heist,Pit Stop,0,21,18,39
2360,2023-01-17,SAM,gemGrab,Minecart Madness,0,1,3,4
2361,2023-01-17,SAM,gemGrab,Crystal Arcade,0,7,5,12
2362,2023-01-17,SAM,brawlBall,Center Stage,0,0,2,2
2363,2023-01-17,SAM,brawlBall,Beach Ball,0,42,31,73
2364,2023-01-16,SAM,knockout,Belle's Rock,0,1,2,3
2365,2023-01-16,SAM,hotZone,Quarter Pounder,0,19,5,24
2366,2023-01-16,SAM,heist,Pit Stop,0,63,68,131
2367,2023-01-16,SAM,gemGrab,Minecart Madness,0,9,12,21
2368,2023-01-16,SAM,gemGrab,Double Swoosh,0,4,3,7
2369,2023-01-16,SAM,brawlBall,Center Stage,0,45,42,87
2370,2023-01-16,SAM,brawlBall,Backyard Bowl,0,5,1,6
2371,2023-01-16,SAM,bounty,Hideout,0,1,4,5
2372,2023-01-15,SAM,knockout,Belle's Rock,0,4,0,4
2373,2023-01-15,SAM,hotZone,Quarter Pounder,0,20,28,48
2374,2023-01-15,SAM,heist,Bridge Too Far,2,20,32,54
2375,2023-01-15,SAM,gemGrab,Hard Rock Mine,0,6,5,11
2376,2023-01-15,SAM,gemGrab,Double Swoosh,0,4,3,7
2377,2023-01-15,SAM,brawlBall,Super Beach,0,7,27,34
2378,2023-01-15,SAM,brawlBall,Backyard Bowl,1,17,25,43
2379,2023-01-15,SAM,bounty,Canal Grande,0,6,4,10
2380,2023-01-14,SAM,knockout,Flaring Phoenix,0,3,0,3
2381,2023-01-14,SAM,hotZone,Controller Chaos,0,24,12,36
2382,2023-01-14,SAM,heist,Bridge Too Far,0,25,17,42
2383,2023-01-14,SAM,gemGrab,Hard Rock Mine,0,4,2,6
2384,2023-01-14,SAM,gemGrab,Deep Diner,0,2,4,6
2385,2023-01-14,SAM,brawlBall,Super Beach,1,53,56,110
2386,2023-01-14,SAM,brawlBall,Sneaky Fields,0,3,1,4
2387,2023-01-14,SAM,bounty,Canal Grande,0,1,3,4
2388,2023-01-13,SAM,knockout,Flaring Phoenix,0,4,6,10
2389,2023-01-13,SAM,hotZone,Controller Chaos,0,9,4,13
2390,2023-01-13,SAM,heist,Hot Potato,0,7,18,25
2391,2023-01-13,SAM,gemGrab,Deep Diner,0,10,7,17
2392,2023-01-13,SAM,brawlBall,Sneaky Fields,0,20,38,58
2393,2023-01-12,SAM,hotZone,Open Zone,0,4,3,7
2394,2023-01-12,SAM,heist,Hot Potato,0,1,1,2
2395,2023-01-12,SAM,gemGrab,Undermine,0,2,0,2
2396,2023-01-12,SAM,gemGrab,Gem Fort,0,1,0,1
2397,2023-01-12,SAM,brawlBall,Sunny Soccer,0,1,5,6
2398,2023-01-12,SAM,brawlBall,Pinhole Punt,0,6,13,19
2399,2023-01-11,SAM,knockout,Riverside,0,1,0,1
2400,2023-01-11,SAM,hotZone,Open Zone,0,1,1,2
2401,2023-01-11,SAM,gemGrab,Gem Fort,0,1,2,3
2402,2023-01-11,SAM,brawlBall,Sunny Soccer,1,9,19,29
2403,2023-01-11,SAM,brawlBall,Beach Ball,0,0,2,2
2404,2023-01-11,SAM,bounty,Excel,0,1,0,1
2405,2023-01-10,SAM,knockout,New Perspective,0,0,1,1
2406,2023-01-10,SAM,hotZone,Dueling Beetles,0,11,4,15
2407,2023-01-10,SAM,gemGrab,Minecart Madness,0,2,8,10
2408,2023-01-10,SAM,gemGrab,Crystal Arcade,0,2,3,5
2409,2023-01-10,SAM,brawlBall,Center Stage,0,4,0,4
2410,2023-01-10,SAM,brawlBall,Beach Ball,0,18,9,27
2411,2023-01-09,SAM,knockout,New Perspective,0,0,1,1
2412,2023-01-09,SAM,hotZone,Dueling Beetles,0,1,7,8
2413,2023-01-09,SAM,heist,Snaked Assault,0,12,21,33
2414,2023-01-09,SAM,gemGrab,Minecart Madness,0,5,0,5
2415,2023-01-09,SAM,gemGrab,Double Swoosh,0,5,0,5
2416,2023-01-09,SAM,brawlBall,Center Stage,0,22,39,61
2417,2023-01-09,SAM,bounty,Layer Cake,0,2,4,6
2418,2023-01-08,SAM,knockout,X Marks the Spot,0,3,0,3
2419,2023-01-08,SAM,hotZone,Ring of Fire,0,2,8,10
2420,2023-01-08,SAM,heist,Snaked Assault,0,4,1,5
2421,2023-01-08,SAM,gemGrab,Hard Rock Mine,0,4,2,6
2422,2023-01-08,SAM,gemGrab,Double Swoosh,0,1,0,1
2423,2023-01-08,SAM,brawlBall,Backyard Bowl,2,15,3,20
2424,2023-01-07,SAM,hotZone,Ring of Fire,0,3,2,5
2425,2023-01-07,SAM,heist,Tornado Ring,0,7,1,8
2426,2023-01-07,SAM,gemGrab,Hard Rock Mine,0,0,4,4
2427,2023-01-07,SAM,gemGrab,Deep Diner,0,3,0,3
2428,2023-01-07,SAM,brawlBall,Super Beach,0,7,4,11
2429,2023-01-07,SAM,brawlBall,Sneaky Fields,0,4,0,4
2430,2023-01-07,SAM,bounty,Dry Season,0,0,1,1
2431,2023-01-06,SAM,hotZone,Split,0,8,14,22
2432,2023-01-06,SAM,heist,Tornado Ring,0,6,1,7
2433,2023-01-06,SAM,gemGrab,Deep Diner,0,3,2,5
2434,2023-01-06,SAM,brawlBall,Sneaky Fields,0,28,65,93
2435,2023-01-06,SAM,brawlBall,Pinhole Punt,0,1,0,1
2436,2023-01-06,SAM,bounty,Dry Season,0,2,9,11
2437,2023-01-05,SAM,knockout,Out in the Open,0,2,0,2
2438,2023-01-05,SAM,hotZone,Split,1,14,2,17
2439,2023-01-05,SAM,heist,Kaboom Canyon,0,7,0,7
2440,2023-01-05,SAM,gemGrab,Undermine,0,5,11,16
2441,2023-01-05,SAM,brawlBall,Sunny Soccer,0,1,0,1
2442,2023-01-05,SAM,brawlBall,Pinhole Punt,0,21,9,30
2443,2023-01-04,SAM,hotZone,Parallel Plays,0,2,1,3
2444,2023-01-04,SAM,heist,Kaboom Canyon,0,8,1,9
2445,2023-01-04,SAM,gemGrab,Gem Fort,0,7,2,9
2446,2023-01-04,SAM,gemGrab,Crystal Arcade,0,2,1,3
2447,2023-01-04,SAM,brawlBall,Sunny Soccer,2,36,31,69
2448,2023-01-04,SAM,bounty,Shooting Star,0,4,15,19
2449,2023-01-03,SAM,knockout,Goldarm Gulch,0,3,1,4
2450,2023-01-03,SAM,hotZone,Parallel Plays,0,5,14,19
2451,2023-01-03,SAM,heist,Pit Stop,0,21,44,65
2452,2023-01-03,SAM,gemGrab,Minecart Madness,0,1,0,1
2453,2023-01-03,SAM,gemGrab,Crystal Arcade,0,5,0,5
2454,2023-01-03,SAM,brawlBall,Center Stage,0,1,0,1
2455,2023-01-03,SAM,brawlBall,Beach Ball,0,18,36,54
2456,2023-01-03,SAM,bounty,Hideout,0,1,2,3
2457,2023-01-02,SAM,knockout,Belle's Rock,0,2,1,3
2458,2023-01-02,SAM,hotZone,Quarter Pounder,0,9,24,33
2459,2023-01-02,SAM,heist,Pit Stop,0,24,33,57
2460,2023-01-02,SAM,gemGrab,Minecart Madness,0,8,1,9
2461,2023-01-02,SAM,brawlBall,Center Stage,0,27,50,77
2462,2023-01-02,SAM,brawlBall,Backyard Bowl,0,1,2,3
2463,2023-01-02,SAM,bounty,Hideout,0,2,2,4
2464,2023-01-01,SAM,knockout,Belle's Rock,0,1,0,1
2465,2023-01-01,SAM,hotZone,Quarter Pounder,0,1,0,1
2466,2023-01-01,SAM,heist,Bridge Too Far,0,5,3,8
2467,2023-01-01,SAM,gemGrab,Double Swoosh,0,3,0,3
2468,2023-01-01,SAM,brawlBall,Backyard Bowl,0,1,3,4
2469,2023-01-01,SAM,bounty,Canal Grande,0,0,1,1
2470,2022-12-31,SAM,hotZone,Controller Chaos,0,3,0,3
2471,2022-12-31,SAM,heist,Bridge Too Far,0,2,3,5
2472,2022-12-31,SAM,gemGrab,Hard Rock Mine,0,1,0,1
2473,2022-12-31,SAM,brawlBall,Super Beach,0,6,6,12
2474,2022-12-31,SAM,brawlBall,Sneaky Fields,0,1,0,1
2475,2022-12-30,SAM,hotZone,Controller Chaos,0,1,0,1
2476,2022-12-30,SAM,gemGrab,Deep Diner,0,2,6,8
2477,2022-12-30,SAM,brawlBall,Sneaky Fields,0,2,2,4
2478,2022-12-29,SAM,gemGrab,Undermine,0,1,0,1
2479,2022-12-29,SAM,brawlBall,Pinhole Punt,0,1,1,2
2480,2022-12-28,SAM,gemGrab,Crystal Arcade,0,1,0,1
2481,2022-12-28,SAM,brawlBall,Beach Ball,0,1,0,1
2482,2022-12-27,SAM,brawlBall,Center Stage,0,0,1,1
2483,2022-12-26,SAM,brawlBall,Center Stage,0,1,0,1
2484,2022-12-23,SAM,knockout,Out in the Open,0,0,1,1
2485,2022-12-21,SAM,brawlBall,Sunny Soccer,0,1,0,1
2486,2022-12-20,SAM,brawlBall,Beach Ball,0,1,1,2
2487,2022-12-18,SAM,heist,Bridge Too Far,0,0,1,1
2488,2022-12-16,SAM,brawlBall,Sneaky Fields,0,0,1,1
2489,2022-12-13,SAM,brawlBall,Beach Ball,0,1,0,1
2490,2022-11-07,SAM,hotZone,Quarter Pounder,0,0,1,1
2491,2022-10-28,SAM,brawlBall,Beach Ball,0,0,1,1
2492,2022-10-15,SAM,brawlBall,Super Beach,0,0,1,1
2493,2022-10-10,SAM,knockout,Belle's Rock,0,0,1,1
2494,2023-01-30,RUFFS,knockout,Belle's Rock,0,31,43,74
2495,2023-01-30,RUFFS,hotZone,Quarter Pounder,0,61,120,181
2496,2023-01-30,RUFFS,heist,Pit Stop,0,16,9,25
2497,2023-01-30,RUFFS,gemGrab,Minecart Madness,0,37,64,101
2498,2023-01-30,RUFFS,gemGrab,Double Swoosh,0,29,34,63
2499,2023-01-30,RUFFS,brawlBall,Center Stage,3,135,144,282
2500,2023-01-30,RUFFS,brawlBall,Backyard Bowl,0,11,17,28
2501,2023-01-30,RUFFS,bounty,Hideout,0,2,0,2
2502,2023-01-29,RUFFS,knockout,Belle's Rock,1,50,72,123
2503,2023-01-29,RUFFS,hotZone,Quarter Pounder,1,95,221,317
2504,2023-01-29,RUFFS,heist,Bridge Too Far,0,9,1,10
2505,2023-01-29,RUFFS,gemGrab,Hard Rock Mine,0,27,39,66
2506,2023-01-29,RUFFS,gemGrab,Double Swoosh,0,28,22,50
2507,2023-01-29,RUFFS,brawlBall,Super Beach,0,1,2,3
2508,2023-01-29,RUFFS,brawlBall,Backyard Bowl,5,163,202,370
2509,2023-01-29,RUFFS,bounty,Canal Grande,0,13,24,37
2510,2023-01-28,RUFFS,knockout,Flaring Phoenix,0,28,26,54
2511,2023-01-28,RUFFS,hotZone,Controller Chaos,0,18,28,46
2512,2023-01-28,RUFFS,heist,Bridge Too Far,0,16,6,22
2513,2023-01-28,RUFFS,gemGrab,Hard Rock Mine,0,182,303,485
2514,2023-01-28,RUFFS,gemGrab,Deep Diner,0,67,103,170
2515,2023-01-28,RUFFS,brawlBall,Super Beach,7,215,248,470
2516,2023-01-28,RUFFS,brawlBall,Sneaky Fields,0,11,15,26
2517,2023-01-28,RUFFS,bounty,Canal Grande,0,33,60,93
2518,2023-01-27,RUFFS,knockout,Flaring Phoenix,0,19,26,45
2519,2023-01-27,RUFFS,hotZone,Controller Chaos,0,6,4,10
2520,2023-01-27,RUFFS,heist,Hot Potato,0,9,7,16
2521,2023-01-27,RUFFS,gemGrab,Undermine,0,5,1,6
2522,2023-01-27,RUFFS,gemGrab,Deep Diner,0,67,99,166
2523,2023-01-27,RUFFS,brawlBall,Sneaky Fields,1,62,65,128
2524,2023-01-27,RUFFS,brawlBall,Pinhole Punt,0,3,1,4
2525,2023-01-27,RUFFS,bounty,Temple Ruins,0,4,4,8
2526,2023-01-26,RUFFS,knockout,Riverside,0,18,34,52
2527,2023-01-26,RUFFS,hotZone,Open Zone,0,7,9,16
2528,2023-01-26,RUFFS,heist,Hot Potato,0,29,26,55
2529,2023-01-26,RUFFS,gemGrab,Undermine,0,12,19,31
2530,2023-01-26,RUFFS,gemGrab,Gem Fort,0,19,24,43
2531,2023-01-26,RUFFS,brawlBall,Sunny Soccer,0,5,10,15
2532,2023-01-26,RUFFS,brawlBall,Pinhole Punt,11,226,286,523
2533,2023-01-26,RUFFS,bounty,Temple Ruins,0,14,10,24
2534,2023-01-25,RUFFS,knockout,Riverside,0,7,8,15
2535,2023-01-25,RUFFS,hotZone,Open Zone,0,12,6,18
2536,2023-01-25,RUFFS,heist,Safe Zone,0,19,23,42
2537,2023-01-25,RUFFS,gemGrab,Gem Fort,0,15,12,27
2538,2023-01-25,RUFFS,gemGrab,Crystal Arcade,0,48,71,119
2539,2023-01-25,RUFFS,brawlBall,Sunny Soccer,3,135,139,277
2540,2023-01-25,RUFFS,brawlBall,Beach Ball,2,25,22,49
2541,2023-01-25,RUFFS,bounty,Excel,0,27,51,78
2542,2023-01-24,RUFFS,knockout,New Perspective,0,47,32,79
2543,2023-01-24,RUFFS,hotZone,Dueling Beetles,0,34,14,48
2544,2023-01-24,RUFFS,heist,Safe Zone,0,24,43,67
2545,2023-01-24,RUFFS,gemGrab,Minecart Madness,0,10,6,16
2546,2023-01-24,RUFFS,gemGrab,Crystal Arcade,0,79,88,167
2547,2023-01-24,RUFFS,brawlBall,Center Stage,1,19,30,50
2548,2023-01-24,RUFFS,brawlBall,Beach Ball,8,193,304,505
2549,2023-01-24,RUFFS,bounty,Excel,0,42,70,112
2550,2023-01-23,RUFFS,knockout,New Perspective,0,45,53,98
2551,2023-01-23,RUFFS,hotZone,Dueling Beetles,0,34,27,61
2552,2023-01-23,RUFFS,heist,Snaked Assault,0,6,3,9
2553,2023-01-23,RUFFS,gemGrab,Minecart Madness,0,44,86,130
2554,2023-01-23,RUFFS,gemGrab,Double Swoosh,0,13,14,27
2555,2023-01-23,RUFFS,brawlBall,Center Stage,7,265,338,610
2556,2023-01-23,RUFFS,brawlBall,Backyard Bowl,0,15,10,25
2557,2023-01-23,RUFFS,bounty,Layer Cake,0,25,15,40
2558,2023-01-22,RUFFS,knockout,X Marks the Spot,0,5,7,12
2559,2023-01-22,RUFFS,hotZone,Ring of Fire,0,21,25,46
2560,2023-01-22,RUFFS,heist,Snaked Assault,0,6,4,10
2561,2023-01-22,RUFFS,gemGrab,Hard Rock Mine,0,43,93,136
2562,2023-01-22,RUFFS,gemGrab,Double Swoosh,0,18,21,39
2563,2023-01-22,RUFFS,brawlBall,Super Beach,3,13,24,40
2564,2023-01-22,RUFFS,brawlBall,Backyard Bowl,7,75,125,207
2565,2023-01-22,RUFFS,bounty,Layer Cake,0,27,53,80
2566,2023-01-21,RUFFS,knockout,X Marks the Spot,0,40,45,85
2567,2023-01-21,RUFFS,hotZone,Ring of Fire,1,87,111,199
2568,2023-01-21,RUFFS,heist,Tornado Ring,0,5,10,15
2569,2023-01-21,RUFFS,gemGrab,Hard Rock Mine,0,271,474,745
2570,2023-01-21,RUFFS,gemGrab,Deep Diner,0,20,46,66
2571,2023-01-21,RUFFS,brawlBall,Super Beach,9,236,266,511
2572,2023-01-21,RUFFS,brawlBall,Sneaky Fields,0,2,7,9
2573,2023-01-21,RUFFS,bounty,Dry Season,0,48,63,111
2574,2023-01-20,RUFFS,knockout,Out in the Open,1,59,66,126
2575,2023-01-20,RUFFS,hotZone,Split,0,74,130,204
2576,2023-01-20,RUFFS,heist,Tornado Ring,0,8,12,20
2577,2023-01-20,RUFFS,gemGrab,Undermine,0,6,14,20
2578,2023-01-20,RUFFS,gemGrab,Deep Diner,0,168,338,506
2579,2023-01-20,RUFFS,brawlBall,Sneaky Fields,2,162,212,376
2580,2023-01-20,RUFFS,brawlBall,Pinhole Punt,0,5,4,9
2581,2023-01-20,RUFFS,bounty,Dry Season,0,74,140,214
2582,2023-01-19,RUFFS,knockout,Out in the Open,0,51,55,106
2583,2023-01-19,RUFFS,hotZone,Split,0,97,189,286
2584,2023-01-19,RUFFS,heist,Kaboom Canyon,0,10,6,16
2585,2023-01-19,RUFFS,gemGrab,Undermine,0,19,29,48
2586,2023-01-19,RUFFS,gemGrab,Gem Fort,0,6,17,23
2587,2023-01-19,RUFFS,brawlBall,Sunny Soccer,0,6,7,13
2588,2023-01-19,RUFFS,brawlBall,Pinhole Punt,10,242,366,618
2589,2023-01-19,RUFFS,bounty,Shooting Star,0,12,13,25
2590,2023-01-18,RUFFS,knockout,Goldarm Gulch,0,10,11,21
2591,2023-01-18,RUFFS,hotZone,Parallel Plays,0,7,3,10
2592,2023-01-18,RUFFS,heist,Kaboom Canyon,0,1,0,1
2593,2023-01-18,RUFFS,gemGrab,Gem Fort,0,9,18,27
2594,2023-01-18,RUFFS,gemGrab,Crystal Arcade,0,5,6,11
2595,2023-01-18,RUFFS,brawlBall,Sunny Soccer,2,64,76,142
2596,2023-01-18,RUFFS,brawlBall,Beach Ball,0,1,4,5
2597,2023-01-18,RUFFS,bounty,Shooting Star,0,3,7,10
2598,2023-01-17,RUFFS,knockout,Goldarm Gulch,0,11,9,20
2599,2023-01-17,RUFFS,hotZone,Parallel Plays,0,14,7,21
2600,2023-01-17,RUFFS,heist,Pit Stop,0,2,3,5
2601,2023-01-17,RUFFS,gemGrab,Crystal Arcade,0,7,8,15
2602,2023-01-17,RUFFS,brawlBall,Center Stage,0,1,0,1
2603,2023-01-17,RUFFS,brawlBall,Beach Ball,3,18,20,41
2604,2023-01-17,RUFFS,bounty,Hideout,0,1,1,2
2605,2023-01-16,RUFFS,knockout,Belle's Rock,0,1,2,3
2606,2023-01-16,RUFFS,hotZone,Quarter Pounder,0,7,7,14
2607,2023-01-16,RUFFS,heist,Pit Stop,0,11,14,25
2608,2023-01-16,RUFFS,gemGrab,Minecart Madness,0,3,6,9
2609,2023-01-16,RUFFS,gemGrab,Double Swoosh,0,1,0,1
2610,2023-01-16,RUFFS,brawlBall,Center Stage,0,15,13,28
2611,2023-01-16,RUFFS,brawlBall,Backyard Bowl,0,0,1,1
2612,2023-01-16,RUFFS,bounty,Hideout,0,1,0,1
2613,2023-01-15,RUFFS,knockout,Belle's Rock,0,3,2,5
2614,2023-01-15,RUFFS,hotZone,Quarter Pounder,0,7,9,16
2615,2023-01-15,RUFFS,heist,Bridge Too Far,0,1,1,2
2616,2023-01-15,RUFFS,gemGrab,Hard Rock Mine,0,13,11,24
2617,2023-01-15,RUFFS,gemGrab,Double Swoosh,0,3,4,7
2618,2023-01-15,RUFFS,brawlBall,Super Beach,0,0,1,1
2619,2023-01-15,RUFFS,brawlBall,Backyard Bowl,1,16,24,41
2620,2023-01-15,RUFFS,bounty,Canal Grande,0,3,2,5
2621,2023-01-14,RUFFS,knockout,Flaring Phoenix,1,0,2,3
2622,2023-01-14,RUFFS,hotZone,Controller Chaos,0,3,4,7
2623,2023-01-14,RUFFS,heist,Bridge Too Far,0,1,0,1
2624,2023-01-14,RUFFS,gemGrab,Hard Rock Mine,0,18,43,61
2625,2023-01-14,RUFFS,gemGrab,Deep Diner,0,1,4,5
2626,2023-01-14,RUFFS,brawlBall,Super Beach,0,14,18,32
2627,2023-01-14,RUFFS,bounty,Canal Grande,0,3,2,5
2628,2023-01-13,RUFFS,knockout,Flaring Phoenix,0,5,6,11
2629,2023-01-13,RUFFS,hotZone,Controller Chaos,0,8,9,17
2630,2023-01-13,RUFFS,heist,Hot Potato,0,1,0,1
2631,2023-01-13,RUFFS,gemGrab,Deep Diner,0,5,21,26
2632,2023-01-13,RUFFS,brawlBall,Sneaky Fields,0,8,9,17
2633,2023-01-13,RUFFS,bounty,Temple Ruins,0,1,0,1
2634,2023-01-12,RUFFS,knockout,Riverside,0,1,0,1
2635,2023-01-12,RUFFS,gemGrab,Undermine,0,4,2,6
2636,2023-01-12,RUFFS,gemGrab,Gem Fort,0,1,0,1
2637,2023-01-12,RUFFS,brawlBall,Pinhole Punt,0,3,19,22
2638,2023-01-11,RUFFS,hotZone,Open Zone,0,1,0,1
2639,2023-01-11,RUFFS,gemGrab,Gem Fort,0,1,1,2
2640,2023-01-11,RUFFS,brawlBall,Sunny Soccer,0,13,20,33
2641,2023-01-11,RUFFS,bounty,Excel,0,2,3,5
2642,2023-01-10,RUFFS,knockout,New Perspective,0,2,8,10
2643,2023-01-10,RUFFS,hotZone,Dueling Beetles,0,6,6,12
2644,2023-01-10,RUFFS,heist,Safe Zone,0,9,20,29
2645,2023-01-10,RUFFS,gemGrab,Minecart Madness,0,2,6,8
2646,2023-01-10,RUFFS,gemGrab,Crystal Arcade,0,1,0,1
2647,2023-01-10,RUFFS,brawlBall,Center Stage,0,2,0,2
2648,2023-01-10,RUFFS,brawlBall,Beach Ball,1,17,60,78
2649,2023-01-10,RUFFS,bounty,Excel,0,3,0,3
2650,2023-01-09,RUFFS,knockout,New Perspective,0,1,0,1
2651,2023-01-09,RUFFS,hotZone,Dueling Beetles,0,2,4,6
2652,2023-01-09,RUFFS,heist,Snaked Assault,0,1,1,2
2653,2023-01-09,RUFFS,gemGrab,Minecart Madness,1,6,6,13
2654,2023-01-09,RUFFS,gemGrab,Double Swoosh,0,2,0,2
2655,2023-01-09,RUFFS,brawlBall,Center Stage,1,6,15,22
2656,2023-01-09,RUFFS,bounty,Layer Cake,0,1,3,4
2657,2023-01-08,RUFFS,knockout,X Marks the Spot,0,3,2,5
2658,2023-01-08,RUFFS,hotZone,Ring of Fire,0,5,21,26
2659,2023-01-08,RUFFS,gemGrab,Hard Rock Mine,0,7,16,23
2660,2023-01-08,RUFFS,brawlBall,Backyard Bowl,1,6,4,11
2661,2023-01-08,RUFFS,bounty,Layer Cake,0,2,0,2
2662,2023-01-07,RUFFS,knockout,X Marks the Spot,0,2,5,7
2663,2023-01-07,RUFFS,hotZone,Ring of Fire,0,5,8,13
2664,2023-01-07,RUFFS,heist,Tornado Ring,0,1,0,1
2665,2023-01-07,RUFFS,gemGrab,Hard Rock Mine,0,7,25,32
2666,2023-01-07,RUFFS,gemGrab,Deep Diner,0,7,6,13
2667,2023-01-07,RUFFS,brawlBall,Super Beach,0,2,2,4
2668,2023-01-07,RUFFS,bounty,Dry Season,0,13,11,24
2669,2023-01-06,RUFFS,hotZone,Split,0,7,12,19
2670,2023-01-06,RUFFS,heist,Tornado Ring,0,2,1,3
2671,2023-01-06,RUFFS,gemGrab,Deep Diner,0,23,15,38
2672,2023-01-06,RUFFS,brawlBall,Sneaky Fields,0,2,0,2
2673,2023-01-06,RUFFS,brawlBall,Pinhole Punt,0,2,0,2
2674,2023-01-06,RUFFS,bounty,Dry Season,0,13,24,37
2675,2023-01-05,RUFFS,knockout,Out in the Open,0,6,3,9
2676,2023-01-05,RUFFS,hotZone,Split,0,28,67,95
2677,2023-01-05,RUFFS,heist,Kaboom Canyon,0,1,3,4
2678,2023-01-05,RUFFS,gemGrab,Undermine,0,2,1,3
2679,2023-01-05,RUFFS,brawlBall,Sunny Soccer,0,1,0,1
2680,2023-01-05,RUFFS,brawlBall,Pinhole Punt,0,49,63,112
2681,2023-01-04,RUFFS,knockout,Goldarm Gulch,0,1,1,2
2682,2023-01-04,RUFFS,hotZone,Parallel Plays,0,1,2,3
2683,2023-01-04,RUFFS,gemGrab,Crystal Arcade,0,3,0,3
2684,2023-01-04,RUFFS,brawlBall,Sunny Soccer,1,27,35,63
2685,2023-01-04,RUFFS,bounty,Shooting Star,0,1,0,1
2686,2023-01-03,RUFFS,knockout,Goldarm Gulch,0,6,2,8
2687,2023-01-03,RUFFS,hotZone,Parallel Plays,0,8,2,10
2688,2023-01-03,RUFFS,heist,Pit Stop,0,4,1,5
2689,2023-01-03,RUFFS,gemGrab,Crystal Arcade,0,9,18,27
2690,2023-01-03,RUFFS,brawlBall,Center Stage,0,3,0,3
2691,2023-01-03,RUFFS,brawlBall,Beach Ball,0,24,26,50
2692,2023-01-02,RUFFS,knockout,Belle's Rock,0,7,2,9
2693,2023-01-02,RUFFS,hotZone,Quarter Pounder,0,10,5,15
2694,2023-01-02,RUFFS,heist,Pit Stop,0,3,5,8
2695,2023-01-02,RUFFS,gemGrab,Minecart Madness,0,4,6,10
2696,2023-01-02,RUFFS,gemGrab,Double Swoosh,0,6,5,11
2697,2023-01-02,RUFFS,brawlBall,Center Stage,1,15,11,27
2698,2023-01-02,RUFFS,brawlBall,Backyard Bowl,0,2,0,2
2699,2023-01-02,RUFFS,bounty,Hideout,0,1,1,2
2700,2023-01-01,RUFFS,knockout,Belle's Rock,0,1,0,1
2701,2023-01-01,RUFFS,hotZone,Quarter Pounder,0,3,16,19
2702,2023-01-01,RUFFS,gemGrab,Hard Rock Mine,0,1,1,2
2703,2023-01-01,RUFFS,brawlBall,Backyard Bowl,0,5,5,10
2704,2022-12-31,RUFFS,gemGrab,Minecart Madness,0,0,1,1
2705,2022-12-31,RUFFS,gemGrab,Hard Rock Mine,0,2,3,5
2706,2022-12-31,RUFFS,brawlBall,Super Beach,0,1,0,1
2707,2022-12-31,RUFFS,brawlBall,Sneaky Fields,0,1,0,1
2708,2022-12-30,RUFFS,hotZone,Controller Chaos,0,1,0,1
2709,2022-12-30,RUFFS,gemGrab,Undermine,0,0,1,1
2710,2022-12-30,RUFFS,gemGrab,Deep Diner,0,1,0,1
2711,2022-12-30,RUFFS,brawlBall,Sneaky Fields,0,2,0,2
2712,2022-12-29,RUFFS,brawlBall,Pinhole Punt,0,1,0,1
2713,2022-12-25,RUFFS,brawlBall,Backyard Bowl,0,1,1,2
2714,2022-12-22,RUFFS,brawlBall,Pinhole Punt,0,0,1,1
2715,2022-12-19,RUFFS,brawlBall,Center Stage,0,2,1,3
2716,2022-11-01,RUFFS,knockout,New Perspective,0,1,0,1
2717,2022-10-30,RUFFS,knockout,Out in the Open,0,1,0,1
2718,2022-10-15,RUFFS,gemGrab,Hard Rock Mine,0,7,8,15
2719,2022-10-15,RUFFS,brawlBall,Super Beach,0,2,0,2
2720,2023-01-30,ROSA,knockout,Belle's Rock,0,6,8,14
2721,2023-01-30,ROSA,hotZone,Quarter Pounder,0,9,6,15
2722,2023-01-30,ROSA,heist,Pit Stop,0,2,2,4
2723,2023-01-30,ROSA,gemGrab,Minecart Madness,0,10,2,12
2724,2023-01-30,ROSA,gemGrab,Double Swoosh,0,89,68,157
2725,2023-01-30,ROSA,brawlBall,Center Stage,12,291,454,757
2726,2023-01-30,ROSA,brawlBall,Backyard Bowl,0,0,2,2
2727,2023-01-29,ROSA,knockout,Belle's Rock,0,1,1,2
2728,2023-01-29,ROSA,hotZone,Quarter Pounder,0,9,2,11
2729,2023-01-29,ROSA,heist,Bridge Too Far,0,2,2,4
2730,2023-01-29,ROSA,gemGrab,Hard Rock Mine,0,17,31,48
2731,2023-01-29,ROSA,gemGrab,Double Swoosh,0,179,237,416
2732,2023-01-29,ROSA,brawlBall,Super Beach,0,2,1,3
2733,2023-01-29,ROSA,brawlBall,Backyard Bowl,0,13,8,21
2734,2023-01-29,ROSA,bounty,Canal Grande,0,25,43,68
2735,2023-01-28,ROSA,knockout,Flaring Phoenix,0,15,48,63
2736,2023-01-28,ROSA,hotZone,Controller Chaos,0,45,61,106
2737,2023-01-28,ROSA,heist,Bridge Too Far,0,8,2,10
2738,2023-01-28,ROSA,gemGrab,Hard Rock Mine,0,114,109,223
2739,2023-01-28,ROSA,gemGrab,Deep Diner,0,8,7,15
2740,2023-01-28,ROSA,brawlBall,Super Beach,3,114,86,203
2741,2023-01-28,ROSA,brawlBall,Sneaky Fields,0,36,33,69
2742,2023-01-28,ROSA,bounty,Canal Grande,0,75,113,188
2743,2023-01-27,ROSA,knockout,Flaring Phoenix,0,2,1,3
2744,2023-01-27,ROSA,hotZone,Controller Chaos,0,13,20,33
2745,2023-01-27,ROSA,heist,Hot Potato,0,2,0,2
2746,2023-01-27,ROSA,gemGrab,Undermine,0,1,1,2
2747,2023-01-27,ROSA,gemGrab,Deep Diner,0,6,15,21
2748,2023-01-27,ROSA,brawlBall,Sneaky Fields,5,218,286,509
2749,2023-01-27,ROSA,brawlBall,Pinhole Punt,0,1,0,1
2750,2023-01-27,ROSA,bounty,Temple Ruins,0,7,19,26
2751,2023-01-26,ROSA,knockout,Riverside,0,3,0,3
2752,2023-01-26,ROSA,hotZone,Open Zone,0,13,4,17
2753,2023-01-26,ROSA,heist,Hot Potato,0,2,6,8
2754,2023-01-26,ROSA,gemGrab,Undermine,0,68,59,127
2755,2023-01-26,ROSA,gemGrab,Gem Fort,0,73,106,179
2756,2023-01-26,ROSA,brawlBall,Sunny Soccer,0,3,1,4
2757,2023-01-26,ROSA,brawlBall,Pinhole Punt,7,120,165,292
2758,2023-01-26,ROSA,bounty,Temple Ruins,0,17,24,41
2759,2023-01-25,ROSA,knockout,Riverside,0,0,1,1
2760,2023-01-25,ROSA,hotZone,Open Zone,0,1,5,6
2761,2023-01-25,ROSA,heist,Safe Zone,0,1,2,3
2762,2023-01-25,ROSA,gemGrab,Gem Fort,0,71,123,194
2763,2023-01-25,ROSA,gemGrab,Crystal Arcade,0,29,33,62
2764,2023-01-25,ROSA,brawlBall,Sunny Soccer,1,48,53,102
2765,2023-01-25,ROSA,brawlBall,Beach Ball,0,2,4,6
2766,2023-01-25,ROSA,bounty,Excel,0,1,2,3
2767,2023-01-24,ROSA,knockout,New Perspective,0,13,15,28
2768,2023-01-24,ROSA,hotZone,Dueling Beetles,0,19,15,34
2769,2023-01-24,ROSA,heist,Safe Zone,0,6,0,6
2770,2023-01-24,ROSA,gemGrab,Minecart Madness,0,1,1,2
2771,2023-01-24,ROSA,gemGrab,Crystal Arcade,0,56,119,175
2772,2023-01-24,ROSA,brawlBall,Center Stage,1,39,55,95
2773,2023-01-24,ROSA,brawlBall,Beach Ball,2,72,82,156
2774,2023-01-24,ROSA,bounty,Excel,0,1,5,6
2775,2023-01-23,ROSA,knockout,New Perspective,0,11,14,25
2776,2023-01-23,ROSA,hotZone,Dueling Beetles,0,33,40,73
2777,2023-01-23,ROSA,heist,Snaked Assault,0,14,3,17
2778,2023-01-23,ROSA,gemGrab,Minecart Madness,0,9,12,21
2779,2023-01-23,ROSA,gemGrab,Double Swoosh,0,60,82,142
2780,2023-01-23,ROSA,brawlBall,Center Stage,19,615,947,1581
2781,2023-01-23,ROSA,brawlBall,Backyard Bowl,0,1,1,2
2782,2023-01-23,ROSA,bounty,Layer Cake,0,12,11,23
2783,2023-01-22,ROSA,knockout,X Marks the Spot,0,1,2,3
2784,2023-01-22,ROSA,hotZone,Ring of Fire,0,15,12,27
2785,2023-01-22,ROSA,heist,Snaked Assault,0,5,2,7
2786,2023-01-22,ROSA,gemGrab,Hard Rock Mine,0,41,38,79
2787,2023-01-22,ROSA,gemGrab,Double Swoosh,0,90,121,211
2788,2023-01-22,ROSA,brawlBall,Super Beach,0,4,6,10
2789,2023-01-22,ROSA,brawlBall,Backyard Bowl,0,7,21,28
2790,2023-01-22,ROSA,bounty,Layer Cake,0,8,19,27
2791,2023-01-21,ROSA,knockout,X Marks the Spot,0,9,7,16
2792,2023-01-21,ROSA,hotZone,Ring of Fire,0,35,66,101
2793,2023-01-21,ROSA,heist,Tornado Ring,0,23,14,37
2794,2023-01-21,ROSA,gemGrab,Hard Rock Mine,0,153,166,319
2795,2023-01-21,ROSA,gemGrab,Deep Diner,0,3,1,4
2796,2023-01-21,ROSA,brawlBall,Super Beach,6,102,125,233
2797,2023-01-21,ROSA,brawlBall,Sneaky Fields,0,40,51,91
2798,2023-01-21,ROSA,bounty,Dry Season,0,4,2,6
2799,2023-01-20,ROSA,knockout,Out in the Open,0,6,10,16
2800,2023-01-20,ROSA,hotZone,Split,0,32,41,73
2801,2023-01-20,ROSA,heist,Tornado Ring,0,12,12,24
2802,2023-01-20,ROSA,gemGrab,Undermine,0,20,48,68
2803,2023-01-20,ROSA,gemGrab,Deep Diner,0,19,12,31
2804,2023-01-20,ROSA,brawlBall,Sneaky Fields,23,649,876,1548
2805,2023-01-20,ROSA,brawlBall,Pinhole Punt,0,7,4,11
2806,2023-01-20,ROSA,bounty,Dry Season,0,2,1,3
2807,2023-01-19,ROSA,knockout,Out in the Open,0,11,18,29
2808,2023-01-19,ROSA,hotZone,Split,0,51,65,116
2809,2023-01-19,ROSA,heist,Kaboom Canyon,0,3,3,6
2810,2023-01-19,ROSA,gemGrab,Undermine,0,68,108,176
2811,2023-01-19,ROSA,gemGrab,Gem Fort,0,39,56,95
2812,2023-01-19,ROSA,brawlBall,Sunny Soccer,0,0,4,4
2813,2023-01-19,ROSA,brawlBall,Pinhole Punt,3,94,160,257
2814,2023-01-19,ROSA,bounty,Shooting Star,0,2,1,3
2815,2023-01-18,ROSA,knockout,Goldarm Gulch,0,2,2,4
2816,2023-01-18,ROSA,hotZone,Parallel Plays,0,2,2,4
2817,2023-01-18,ROSA,heist,Kaboom Canyon,0,3,0,3
2818,2023-01-18,ROSA,gemGrab,Gem Fort,0,44,52,96
2819,2023-01-18,ROSA,gemGrab,Crystal Arcade,0,1,0,1
2820,2023-01-18,ROSA,brawlBall,Sunny Soccer,1,39,46,86
2821,2023-01-18,ROSA,brawlBall,Beach Ball,0,0,1,1
2822,2023-01-18,ROSA,bounty,Shooting Star,0,2,2,4
2823,2023-01-17,ROSA,knockout,Goldarm Gulch,0,4,0,4
2824,2023-01-17,ROSA,hotZone,Parallel Plays,0,3,7,10
2825,2023-01-17,ROSA,heist,Pit Stop,0,0,1,1
2826,2023-01-17,ROSA,gemGrab,Crystal Arcade,0,2,2,4
2827,2023-01-17,ROSA,brawlBall,Center Stage,0,1,2,3
2828,2023-01-17,ROSA,brawlBall,Beach Ball,0,6,8,14
2829,2023-01-17,ROSA,bounty,Hideout,0,0,1,1
2830,2023-01-16,ROSA,knockout,Belle's Rock,0,2,0,2
2831,2023-01-16,ROSA,hotZone,Quarter Pounder,0,1,1,2
2832,2023-01-16,ROSA,gemGrab,Double Swoosh,0,2,1,3
2833,2023-01-16,ROSA,brawlBall,Center Stage,1,30,61,92
2834,2023-01-16,ROSA,bounty,Hideout,0,1,0,1
2835,2023-01-15,ROSA,hotZone,Quarter Pounder,0,2,0,2
2836,2023-01-15,ROSA,gemGrab,Hard Rock Mine,0,8,24,32
2837,2023-01-15,ROSA,gemGrab,Double Swoosh,0,21,47,68
2838,2023-01-15,ROSA,brawlBall,Backyard Bowl,0,3,0,3
2839,2023-01-15,ROSA,bounty,Canal Grande,0,8,22,30
2840,2023-01-14,ROSA,knockout,Flaring Phoenix,0,2,0,2
2841,2023-01-14,ROSA,hotZone,Controller Chaos,0,13,32,45
2842,2023-01-14,ROSA,gemGrab,Hard Rock Mine,0,7,33,40
2843,2023-01-14,ROSA,gemGrab,Deep Diner,0,1,0,1
2844,2023-01-14,ROSA,brawlBall,Super Beach,0,5,2,7
2845,2023-01-14,ROSA,brawlBall,Sneaky Fields,0,8,9,17
2846,2023-01-14,ROSA,bounty,Canal Grande,0,3,3,6
2847,2023-01-13,ROSA,hotZone,Controller Chaos,0,11,16,27
2848,2023-01-13,ROSA,gemGrab,Deep Diner,0,7,0,7
2849,2023-01-13,ROSA,brawlBall,Sneaky Fields,0,75,98,173
2850,2023-01-13,ROSA,bounty,Temple Ruins,0,0,1,1
2851,2023-01-12,ROSA,hotZone,Open Zone,0,2,0,2
2852,2023-01-12,ROSA,gemGrab,Undermine,0,0,1,1
2853,2023-01-12,ROSA,gemGrab,Gem Fort,0,3,5,8
2854,2023-01-12,ROSA,brawlBall,Pinhole Punt,0,4,0,4
2855,2023-01-11,ROSA,gemGrab,Gem Fort,0,4,4,8
2856,2023-01-11,ROSA,brawlBall,Sunny Soccer,0,2,0,2
2857,2023-01-10,ROSA,hotZone,Dueling Beetles,0,4,3,7
2858,2023-01-10,ROSA,heist,Safe Zone,0,0,1,1
2859,2023-01-10,ROSA,gemGrab,Crystal Arcade,0,7,2,9
2860,2023-01-10,ROSA,brawlBall,Center Stage,0,5,2,7
2861,2023-01-10,ROSA,brawlBall,Beach Ball,0,5,1,6
2862,2023-01-09,ROSA,hotZone,Dueling Beetles,0,8,3,11
2863,2023-01-09,ROSA,gemGrab,Double Swoosh,0,3,3,6
2864,2023-01-09,ROSA,brawlBall,Center Stage,0,35,57,92
2865,2023-01-09,ROSA,bounty,Layer Cake,0,3,4,7
2866,2023-01-08,ROSA,hotZone,Ring of Fire,0,3,5,8
2867,2023-01-08,ROSA,heist,Snaked Assault,0,0,1,1
2868,2023-01-08,ROSA,gemGrab,Hard Rock Mine,0,5,1,6
2869,2023-01-08,ROSA,gemGrab,Double Swoosh,0,7,5,12
2870,2023-01-08,ROSA,brawlBall,Super Beach,0,1,0,1
2871,2023-01-08,ROSA,bounty,Layer Cake,0,1,6,7
2872,2023-01-07,ROSA,hotZone,Ring of Fire,0,2,0,2
2873,2023-01-07,ROSA,heist,Tornado Ring,0,3,1,4
2874,2023-01-07,ROSA,gemGrab,Hard Rock Mine,0,4,2,6
2875,2023-01-07,ROSA,gemGrab,Deep Diner,0,2,0,2
2876,2023-01-07,ROSA,brawlBall,Super Beach,0,2,0,2
2877,2023-01-07,ROSA,brawlBall,Sneaky Fields,0,4,1,5
2878,2023-01-06,ROSA,hotZone,Split,0,2,0,2
2879,2023-01-06,ROSA,heist,Tornado Ring,0,1,0,1
2880,2023-01-06,ROSA,gemGrab,Undermine,0,3,1,4
2881,2023-01-06,ROSA,brawlBall,Sneaky Fields,2,51,46,99
2882,2023-01-06,ROSA,brawlBall,Pinhole Punt,0,1,0,1
2883,2023-01-05,ROSA,knockout,Out in the Open,0,1,0,1
2884,2023-01-05,ROSA,hotZone,Split,0,6,5,11
2885,2023-01-05,ROSA,gemGrab,Undermine,0,2,0,2
2886,2023-01-05,ROSA,gemGrab,Gem Fort,0,2,1,3
2887,2023-01-05,ROSA,brawlBall,Pinhole Punt,0,12,6,18
2888,2023-01-04,ROSA,hotZone,Parallel Plays,0,1,1,2
2889,2023-01-04,ROSA,gemGrab,Gem Fort,0,20,22,42
2890,2023-01-04,ROSA,brawlBall,Sunny Soccer,0,5,3,8
2891,2023-01-04,ROSA,bounty,Shooting Star,0,1,0,1
2892,2023-01-03,ROSA,knockout,Goldarm Gulch,0,1,0,1
2893,2023-01-03,ROSA,hotZone,Parallel Plays,0,2,0,2
2894,2023-01-03,ROSA,heist,Pit Stop,0,2,1,3
2895,2023-01-03,ROSA,gemGrab,Crystal Arcade,0,13,1,14
2896,2023-01-03,ROSA,brawlBall,Center Stage,0,1,1,2
2897,2023-01-03,ROSA,brawlBall,Beach Ball,0,8,1,9
2898,2023-01-02,ROSA,hotZone,Quarter Pounder,0,1,0,1
2899,2023-01-02,ROSA,heist,Pit Stop,0,1,0,1
2900,2023-01-02,ROSA,heist,Kaboom Canyon,0,1,0,1
2901,2023-01-02,ROSA,gemGrab,Double Swoosh,0,10,2,12
2902,2023-01-02,ROSA,brawlBall,Center Stage,1,52,53,106
2903,2023-01-02,ROSA,bounty,Hideout,0,1,0,1
2904,2023-01-01,ROSA,hotZone,Quarter Pounder,0,7,10,17
2905,2023-01-01,ROSA,gemGrab,Double Swoosh,0,8,2,10
2906,2023-01-01,ROSA,brawlBall,Backyard Bowl,0,0,1,1
2907,2023-01-01,ROSA,bounty,Canal Grande,0,2,0,2
2908,2022-12-31,ROSA,hotZone,Controller Chaos,0,0,1,1
2909,2022-12-31,ROSA,gemGrab,Minecart Madness,0,1,0,1
2910,2022-12-31,ROSA,gemGrab,Hard Rock Mine,0,2,0,2
2911,2022-12-30,ROSA,hotZone,Controller Chaos,0,0,1,1
2912,2022-12-30,ROSA,gemGrab,Undermine,0,1,0,1
2913,2022-12-30,ROSA,brawlBall,Sneaky Fields,0,3,5,8
2914,2022-12-29,ROSA,heist,Hot Potato,0,0,3,3
2915,2022-12-27,ROSA,brawlBall,Center Stage,0,0,1,1
2916,2022-12-26,ROSA,brawlBall,Center Stage,0,0,2,2
2917,2022-12-22,ROSA,gemGrab,Gem Fort,0,6,1,7
2918,2022-12-19,ROSA,brawlBall,Center Stage,0,1,0,1
2919,2022-12-16,ROSA,brawlBall,Sneaky Fields,0,0,1,1
2920,2022-12-13,ROSA,gemGrab,Crystal Arcade,0,0,1,1
2921,2022-12-10,ROSA,gemGrab,Hard Rock Mine,0,0,1,1
2922,2022-10-30,ROSA,bounty,Canal Grande,0,1,1,2
2923,2023-01-30,RICO,knockout,Belle's Rock,0,133,126,259
2924,2023-01-30,RICO,hotZone,Quarter Pounder,1,72,181,254
2925,2023-01-30,RICO,heist,Pit Stop,0,132,81,213
2926,2023-01-30,RICO,gemGrab,Minecart Madness,0,31,29,60
2927,2023-01-30,RICO,gemGrab,Double Swoosh,0,19,9,28
2928,2023-01-30,RICO,brawlBall,Center Stage,48,1222,1300,2570
2929,2023-01-30,RICO,brawlBall,Backyard Bowl,2,24,20,46
2930,2023-01-30,RICO,bounty,Hideout,0,4,3,7
2931,2023-01-29,RICO,knockout,Belle's Rock,0,217,192,409
2932,2023-01-29,RICO,hotZone,Quarter Pounder,3,68,73,144
2933,2023-01-29,RICO,heist,Bridge Too Far,0,36,20,56
2934,2023-01-29,RICO,gemGrab,Hard Rock Mine,0,139,142,281
2935,2023-01-29,RICO,gemGrab,Double Swoosh,0,40,19,59
2936,2023-01-29,RICO,brawlBall,Super Beach,0,3,1,4
2937,2023-01-29,RICO,brawlBall,Backyard Bowl,9,141,107,257
2938,2023-01-29,RICO,bounty,Canal Grande,0,9,3,12
2939,2023-01-28,RICO,knockout,Flaring Phoenix,0,13,13,26
2940,2023-01-28,RICO,hotZone,Controller Chaos,0,17,4,21
2941,2023-01-28,RICO,heist,Bridge Too Far,0,91,33,124
2942,2023-01-28,RICO,gemGrab,Hard Rock Mine,0,821,922,1743
2943,2023-01-28,RICO,gemGrab,Deep Diner,0,36,27,63
2944,2023-01-28,RICO,brawlBall,Super Beach,14,347,316,677
2945,2023-01-28,RICO,brawlBall,Sneaky Fields,2,55,58,115
2946,2023-01-28,RICO,bounty,Canal Grande,0,20,9,29
2947,2023-01-27,RICO,knockout,Flaring Phoenix,0,5,6,11
2948,2023-01-27,RICO,hotZone,Controller Chaos,0,11,3,14
2949,2023-01-27,RICO,heist,Hot Potato,0,67,94,161
2950,2023-01-27,RICO,gemGrab,Undermine,0,8,3,11
2951,2023-01-27,RICO,gemGrab,Deep Diner,0,33,49,82
2952,2023-01-27,RICO,brawlBall,Sneaky Fields,9,354,350,713
2953,2023-01-27,RICO,brawlBall,Pinhole Punt,0,5,6,11
2954,2023-01-27,RICO,bounty,Temple Ruins,0,14,45,59
2955,2023-01-26,RICO,knockout,Riverside,0,32,27,59
2956,2023-01-26,RICO,hotZone,Open Zone,0,12,4,16
2957,2023-01-26,RICO,heist,Hot Potato,0,362,311,673
2958,2023-01-26,RICO,gemGrab,Undermine,0,56,76,132
2959,2023-01-26,RICO,gemGrab,Gem Fort,0,68,80,148
2960,2023-01-26,RICO,brawlBall,Sunny Soccer,0,18,32,50
2961,2023-01-26,RICO,brawlBall,Pinhole Punt,16,490,568,1074
2962,2023-01-26,RICO,bounty,Temple Ruins,0,55,77,132
2963,2023-01-25,RICO,knockout,Riverside,0,8,5,13
2964,2023-01-25,RICO,hotZone,Open Zone,0,5,2,7
2965,2023-01-25,RICO,heist,Safe Zone,3,229,321,553
2966,2023-01-25,RICO,gemGrab,Gem Fort,0,80,72,152
2967,2023-01-25,RICO,gemGrab,Crystal Arcade,0,26,31,57
2968,2023-01-25,RICO,brawlBall,Sunny Soccer,10,272,291,573
2969,2023-01-25,RICO,brawlBall,Beach Ball,2,26,26,54
2970,2023-01-25,RICO,bounty,Excel,0,82,70,152
2971,2023-01-24,RICO,knockout,New Perspective,0,63,56,119
2972,2023-01-24,RICO,hotZone,Dueling Beetles,0,18,10,28
2973,2023-01-24,RICO,heist,Safe Zone,1,519,677,1197
2974,2023-01-24,RICO,gemGrab,Minecart Madness,0,7,1,8
2975,2023-01-24,RICO,gemGrab,Crystal Arcade,0,52,52,104
2976,2023-01-24,RICO,brawlBall,Center Stage,7,208,172,387
2977,2023-01-24,RICO,brawlBall,Beach Ball,16,437,496,949
2978,2023-01-24,RICO,bounty,Excel,0,218,287,505
2979,2023-01-23,RICO,knockout,New Perspective,0,110,108,218
2980,2023-01-23,RICO,hotZone,Dueling Beetles,1,28,9,38
2981,2023-01-23,RICO,heist,Snaked Assault,0,24,12,36
2982,2023-01-23,RICO,gemGrab,Minecart Madness,0,57,27,84
2983,2023-01-23,RICO,gemGrab,Double Swoosh,0,12,8,20
2984,2023-01-23,RICO,brawlBall,Center Stage,66,2205,2146,4417
2985,2023-01-23,RICO,brawlBall,Backyard Bowl,0,16,18,34
2986,2023-01-23,RICO,bounty,Layer Cake,0,31,30,61
2987,2023-01-22,RICO,knockout,X Marks the Spot,0,12,6,18
2988,2023-01-22,RICO,hotZone,Ring of Fire,0,54,65,119
2989,2023-01-22,RICO,heist,Snaked Assault,0,14,8,22
2990,2023-01-22,RICO,gemGrab,Hard Rock Mine,0,204,202,406
2991,2023-01-22,RICO,gemGrab,Double Swoosh,0,24,19,43
2992,2023-01-22,RICO,brawlBall,Super Beach,0,45,25,70
2993,2023-01-22,RICO,brawlBall,Backyard Bowl,2,79,64,145
2994,2023-01-22,RICO,bounty,Layer Cake,0,33,48,81
2995,2023-01-21,RICO,knockout,X Marks the Spot,0,34,16,50
2996,2023-01-21,RICO,hotZone,Ring of Fire,0,194,159,353
2997,2023-01-21,RICO,heist,Tornado Ring,0,23,16,39
2998,2023-01-21,RICO,gemGrab,Hard Rock Mine,0,994,1132,2126
2999,2023-01-21,RICO,gemGrab,Deep Diner,0,31,18,49
3000,2023-01-21,RICO,brawlBall,Super Beach,14,467,413,894
3001,2023-01-21,RICO,brawlBall,Sneaky Fields,1,56,54,111
3002,2023-01-21,RICO,bounty,Dry Season,0,18,9,27
3003,2023-01-20,RICO,knockout,Out in the Open,0,44,23,67
3004,2023-01-20,RICO,hotZone,Split,0,556,691,1247
3005,2023-01-20,RICO,heist,Tornado Ring,0,25,9,34
3006,2023-01-20,RICO,gemGrab,Undermine,0,29,51,80
3007,2023-01-20,RICO,gemGrab,Deep Diner,0,91,72,163
3008,2023-01-20,RICO,brawlBall,Sneaky Fields,33,922,956,1911
3009,2023-01-20,RICO,brawlBall,Pinhole Punt,0,20,33,53
3010,2023-01-20,RICO,bounty,Dry Season,0,22,18,40
3011,2023-01-19,RICO,knockout,Out in the Open,0,43,43,86
3012,2023-01-19,RICO,hotZone,Split,0,972,1034,2006
3013,2023-01-19,RICO,heist,Kaboom Canyon,0,23,8,31
3014,2023-01-19,RICO,gemGrab,Undermine,0,73,99,172
3015,2023-01-19,RICO,gemGrab,Gem Fort,0,61,98,159
3016,2023-01-19,RICO,brawlBall,Sunny Soccer,0,18,17,35
3017,2023-01-19,RICO,brawlBall,Pinhole Punt,23,529,639,1191
3018,2023-01-19,RICO,bounty,Shooting Star,0,12,7,19
3019,2023-01-18,RICO,knockout,Goldarm Gulch,0,87,72,159
3020,2023-01-18,RICO,hotZone,Parallel Plays,0,1,0,1
3021,2023-01-18,RICO,heist,Kaboom Canyon,0,10,4,14
3022,2023-01-18,RICO,gemGrab,Gem Fort,0,35,40,75
3023,2023-01-18,RICO,gemGrab,Crystal Arcade,0,1,3,4
3024,2023-01-18,RICO,brawlBall,Sunny Soccer,4,98,88,190
3025,2023-01-18,RICO,brawlBall,Beach Ball,1,1,7,9
3026,2023-01-18,RICO,bounty,Shooting Star,0,4,1,5
3027,2023-01-17,RICO,knockout,Goldarm Gulch,0,68,69,137
3028,2023-01-17,RICO,hotZone,Parallel Plays,0,2,1,3
3029,2023-01-17,RICO,heist,Pit Stop,0,19,22,41
3030,2023-01-17,RICO,gemGrab,Crystal Arcade,0,2,3,5
3031,2023-01-17,RICO,brawlBall,Center Stage,0,4,3,7
3032,2023-01-17,RICO,brawlBall,Beach Ball,0,30,51,81
3033,2023-01-17,RICO,bounty,Hideout,0,2,0,2
3034,2023-01-16,RICO,knockout,Belle's Rock,0,12,7,19
3035,2023-01-16,RICO,hotZone,Quarter Pounder,0,13,39,52
3036,2023-01-16,RICO,heist,Pit Stop,0,54,43,97
3037,2023-01-16,RICO,gemGrab,Minecart Madness,0,1,1,2
3038,2023-01-16,RICO,gemGrab,Double Swoosh,0,4,0,4
3039,2023-01-16,RICO,brawlBall,Center Stage,4,157,166,327
3040,2023-01-16,RICO,brawlBall,Backyard Bowl,0,1,0,1
3041,2023-01-16,RICO,bounty,Hideout,0,2,3,5
3042,2023-01-15,RICO,knockout,Belle's Rock,0,21,28,49
3043,2023-01-15,RICO,hotZone,Quarter Pounder,0,25,23,48
3044,2023-01-15,RICO,heist,Bridge Too Far,0,5,14,19
3045,2023-01-15,RICO,gemGrab,Hard Rock Mine,0,39,43,82
3046,2023-01-15,RICO,gemGrab,Double Swoosh,0,6,2,8
3047,2023-01-15,RICO,brawlBall,Super Beach,0,2,1,3
3048,2023-01-15,RICO,brawlBall,Backyard Bowl,0,16,6,22
3049,2023-01-15,RICO,bounty,Canal Grande,0,1,6,7
3050,2023-01-14,RICO,knockout,Flaring Phoenix,0,0,2,2
3051,2023-01-14,RICO,hotZone,Controller Chaos,0,8,5,13
3052,2023-01-14,RICO,heist,Bridge Too Far,0,7,0,7
3053,2023-01-14,RICO,gemGrab,Hard Rock Mine,0,73,74,147
3054,2023-01-14,RICO,gemGrab,Deep Diner,0,5,6,11
3055,2023-01-14,RICO,brawlBall,Super Beach,1,28,16,45
3056,2023-01-14,RICO,brawlBall,Sneaky Fields,2,19,42,63
3057,2023-01-14,RICO,bounty,Canal Grande,0,2,0,2
3058,2023-01-13,RICO,knockout,Flaring Phoenix,0,2,0,2
3059,2023-01-13,RICO,hotZone,Controller Chaos,0,5,4,9
3060,2023-01-13,RICO,heist,Hot Potato,0,15,9,24
3061,2023-01-13,RICO,gemGrab,Deep Diner,0,9,3,12
3062,2023-01-13,RICO,brawlBall,Sneaky Fields,1,122,116,239
3063,2023-01-13,RICO,brawlBall,Pinhole Punt,0,1,1,2
3064,2023-01-13,RICO,bounty,Temple Ruins,0,3,19,22
3065,2023-01-12,RICO,knockout,Riverside,0,2,1,3
3066,2023-01-12,RICO,heist,Hot Potato,0,8,32,40
3067,2023-01-12,RICO,gemGrab,Undermine,0,2,3,5
3068,2023-01-12,RICO,gemGrab,Gem Fort,0,6,5,11
3069,2023-01-12,RICO,brawlBall,Sunny Soccer,0,4,2,6
3070,2023-01-12,RICO,brawlBall,Pinhole Punt,0,30,40,70
3071,2023-01-12,RICO,bounty,Temple Ruins,0,1,0,1
3072,2023-01-11,RICO,heist,Safe Zone,0,2,1,3
3073,2023-01-11,RICO,gemGrab,Gem Fort,0,5,2,7
3074,2023-01-11,RICO,brawlBall,Sunny Soccer,0,12,11,23
3075,2023-01-11,RICO,brawlBall,Beach Ball,0,2,0,2
3076,2023-01-11,RICO,bounty,Excel,0,1,5,6
3077,2023-01-10,RICO,knockout,New Perspective,0,6,4,10
3078,2023-01-10,RICO,hotZone,Dueling Beetles,0,2,0,2
3079,2023-01-10,RICO,heist,Safe Zone,0,38,75,113
3080,2023-01-10,RICO,gemGrab,Minecart Madness,0,1,0,1
3081,2023-01-10,RICO,gemGrab,Crystal Arcade,0,7,2,9
3082,2023-01-10,RICO,brawlBall,Center Stage,0,12,7,19
3083,2023-01-10,RICO,brawlBall,Beach Ball,2,26,41,69
3084,2023-01-10,RICO,bounty,Excel,0,3,6,9
3085,2023-01-09,RICO,knockout,New Perspective,0,2,2,4
3086,2023-01-09,RICO,hotZone,Dueling Beetles,0,2,0,2
3087,2023-01-09,RICO,heist,Snaked Assault,0,9,4,13
3088,2023-01-09,RICO,gemGrab,Minecart Madness,0,3,1,4
3089,2023-01-09,RICO,gemGrab,Double Swoosh,0,3,1,4
3090,2023-01-09,RICO,brawlBall,Center Stage,5,122,129,256
3091,2023-01-09,RICO,bounty,Layer Cake,0,5,15,20
3092,2023-01-08,RICO,knockout,X Marks the Spot,0,1,0,1
3093,2023-01-08,RICO,hotZone,Ring of Fire,0,10,0,10
3094,2023-01-08,RICO,heist,Snaked Assault,0,3,1,4
3095,2023-01-08,RICO,gemGrab,Hard Rock Mine,0,35,50,85
3096,2023-01-08,RICO,gemGrab,Double Swoosh,0,1,0,1
3097,2023-01-08,RICO,brawlBall,Super Beach,0,4,1,5
3098,2023-01-08,RICO,brawlBall,Backyard Bowl,0,12,9,21
3099,2023-01-08,RICO,bounty,Layer Cake,0,0,1,1
3100,2023-01-07,RICO,knockout,X Marks the Spot,0,1,0,1
3101,2023-01-07,RICO,hotZone,Ring of Fire,0,14,9,23
3102,2023-01-07,RICO,heist,Tornado Ring,0,1,0,1
3103,2023-01-07,RICO,gemGrab,Hard Rock Mine,0,58,73,131
3104,2023-01-07,RICO,gemGrab,Deep Diner,0,4,3,7
3105,2023-01-07,RICO,brawlBall,Super Beach,1,6,3,10
3106,2023-01-07,RICO,brawlBall,Sneaky Fields,0,4,1,5
3107,2023-01-06,RICO,knockout,Out in the Open,0,1,0,1
3108,2023-01-06,RICO,hotZone,Split,0,67,42,109
3109,2023-01-06,RICO,heist,Tornado Ring,0,3,2,5
3110,2023-01-06,RICO,gemGrab,Undermine,0,1,0,1
3111,2023-01-06,RICO,gemGrab,Deep Diner,0,16,27,43
3112,2023-01-06,RICO,brawlBall,Sneaky Fields,0,71,77,148
3113,2023-01-06,RICO,brawlBall,Pinhole Punt,0,9,11,20
3114,2023-01-05,RICO,knockout,Out in the Open,0,3,1,4
3115,2023-01-05,RICO,hotZone,Split,1,203,232,436
3116,2023-01-05,RICO,heist,Kaboom Canyon,0,2,1,3
3117,2023-01-05,RICO,gemGrab,Undermine,0,7,5,12
3118,2023-01-05,RICO,gemGrab,Gem Fort,0,0,11,11
3119,2023-01-05,RICO,brawlBall,Sunny Soccer,0,2,3,5
3120,2023-01-05,RICO,brawlBall,Pinhole Punt,2,77,88,167
3121,2023-01-05,RICO,bounty,Shooting Star,0,3,0,3
3122,2023-01-04,RICO,knockout,Goldarm Gulch,0,21,34,55
3123,2023-01-04,RICO,hotZone,Parallel Plays,0,1,1,2
3124,2023-01-04,RICO,heist,Kaboom Canyon,0,1,1,2
3125,2023-01-04,RICO,gemGrab,Gem Fort,0,23,30,53
3126,2023-01-04,RICO,gemGrab,Crystal Arcade,0,4,1,5
3127,2023-01-04,RICO,brawlBall,Sunny Soccer,3,45,59,107
3128,2023-01-04,RICO,brawlBall,Beach Ball,0,1,0,1
3129,2023-01-04,RICO,bounty,Shooting Star,0,1,0,1
3130,2023-01-03,RICO,knockout,Goldarm Gulch,0,23,23,46
3131,2023-01-03,RICO,hotZone,Controller Chaos,0,0,1,1
3132,2023-01-03,RICO,heist,Pit Stop,0,37,36,73
3133,2023-01-03,RICO,gemGrab,Crystal Arcade,0,7,2,9
3134,2023-01-03,RICO,brawlBall,Center Stage,0,6,2,8
3135,2023-01-03,RICO,brawlBall,Beach Ball,0,30,29,59
3136,2023-01-03,RICO,bounty,Hideout,0,1,0,1
3137,2023-01-02,RICO,knockout,Belle's Rock,0,17,10,27
3138,2023-01-02,RICO,hotZone,Quarter Pounder,0,11,16,27
3139,2023-01-02,RICO,heist,Pit Stop,1,57,25,83
3140,2023-01-02,RICO,heist,Kaboom Canyon,0,1,0,1
3141,2023-01-02,RICO,gemGrab,Minecart Madness,0,6,3,9
3142,2023-01-02,RICO,gemGrab,Double Swoosh,0,2,0,2
3143,2023-01-02,RICO,brawlBall,Center Stage,6,150,101,257
3144,2023-01-02,RICO,bounty,Hideout,0,2,0,2
3145,2023-01-01,RICO,knockout,Belle's Rock,0,10,5,15
3146,2023-01-01,RICO,hotZone,Quarter Pounder,0,5,1,6
3147,2023-01-01,RICO,gemGrab,Double Swoosh,0,3,0,3
3148,2023-01-01,RICO,brawlBall,Backyard Bowl,0,2,2,4
3149,2022-12-31,RICO,hotZone,Controller Chaos,0,1,0,1
3150,2022-12-31,RICO,gemGrab,Hard Rock Mine,0,15,11,26
3151,2022-12-31,RICO,gemGrab,Deep Diner,0,5,3,8
3152,2022-12-31,RICO,brawlBall,Super Beach,0,2,0,2
3153,2022-12-31,RICO,brawlBall,Sneaky Fields,0,1,1,2
3154,2022-12-30,RICO,heist,Hot Potato,0,0,1,1
3155,2022-12-30,RICO,gemGrab,Undermine,0,1,0,1
3156,2022-12-30,RICO,gemGrab,Deep Diner,0,4,0,4
3157,2022-12-30,RICO,brawlBall,Sneaky Fields,0,3,11,14
3158,2022-12-29,RICO,heist,Hot Potato,0,1,1,2
3159,2022-12-29,RICO,gemGrab,Gem Fort,0,2,0,2
3160,2022-12-29,RICO,brawlBall,Pinhole Punt,0,2,0,2
3161,2022-12-28,RICO,brawlBall,Sunny Soccer,0,3,1,4
3162,2022-12-27,RICO,hotZone,Dueling Beetles,0,0,1,1
3163,2022-12-27,RICO,hotZone,Controller Chaos,0,0,1,1
3164,2022-12-27,RICO,brawlBall,Center Stage,0,2,1,3
3165,2022-12-27,RICO,bounty,Excel,0,0,1,1
3166,2022-12-26,RICO,brawlBall,Center Stage,0,2,2,4
3167,2022-12-25,RICO,brawlBall,Backyard Bowl,0,1,0,1
3168,2022-12-20,RICO,brawlBall,Beach Ball,0,2,1,3
3169,2022-12-19,RICO,brawlBall,Center Stage,0,4,7,11
3170,2022-12-18,RICO,knockout,Belle's Rock,0,1,0,1
3171,2022-12-16,RICO,brawlBall,Sneaky Fields,0,2,0,2
3172,2022-12-13,RICO,heist,Safe Zone,0,2,0,2
3173,2022-12-13,RICO,gemGrab,Crystal Arcade,0,1,0,1
3174,2022-12-11,RICO,gemGrab,Double Swoosh,0,0,1,1
3175,2022-12-10,RICO,gemGrab,Hard Rock Mine,0,2,1,3
3176,2022-11-11,RICO,knockout,New Perspective,0,0,2,2
3177,2022-11-11,RICO,brawlBall,Sneaky Fields,0,1,1,2
3178,2022-11-01,RICO,knockout,New Perspective,0,2,0,2
3179,2022-10-15,RICO,gemGrab,Hard Rock Mine,0,2,3,5
3180,2023-01-30,POCO,knockout,Belle's Rock,0,37,36,73
3181,2023-01-30,POCO,hotZone,Quarter Pounder,1,261,157,419
3182,2023-01-30,POCO,heist,Pit Stop,0,6,1,7
3183,2023-01-30,POCO,gemGrab,Minecart Madness,0,94,73,167
3184,2023-01-30,POCO,gemGrab,Double Swoosh,0,132,141,273
3185,2023-01-30,POCO,brawlBall,Center Stage,13,340,422,775
3186,2023-01-30,POCO,brawlBall,Backyard Bowl,1,47,33,81
3187,2023-01-30,POCO,bounty,Hideout,0,4,2,6
3188,2023-01-29,POCO,knockout,Belle's Rock,0,30,13,43
3189,2023-01-29,POCO,hotZone,Quarter Pounder,1,184,116,301
3190,2023-01-29,POCO,heist,Bridge Too Far,0,11,3,14
3191,2023-01-29,POCO,gemGrab,Hard Rock Mine,0,51,22,73
3192,2023-01-29,POCO,gemGrab,Double Swoosh,0,245,270,515
3193,2023-01-29,POCO,brawlBall,Super Beach,0,9,16,25
3194,2023-01-29,POCO,brawlBall,Backyard Bowl,17,344,388,749
3195,2023-01-29,POCO,bounty,Canal Grande,0,21,30,51
3196,2023-01-28,POCO,knockout,Flaring Phoenix,0,19,12,31
3197,2023-01-28,POCO,hotZone,Controller Chaos,0,302,319,621
3198,2023-01-28,POCO,heist,Bridge Too Far,0,15,6,21
3199,2023-01-28,POCO,gemGrab,Hard Rock Mine,0,146,99,245
3200,2023-01-28,POCO,gemGrab,Deep Diner,0,69,61,130
3201,2023-01-28,POCO,brawlBall,Super Beach,13,727,778,1518
3202,2023-01-28,POCO,brawlBall,Sneaky Fields,1,50,45,96
3203,2023-01-28,POCO,bounty,Canal Grande,0,44,47,91
3204,2023-01-27,POCO,knockout,Flaring Phoenix,0,10,6,16
3205,2023-01-27,POCO,hotZone,Controller Chaos,0,83,105,188
3206,2023-01-27,POCO,heist,Hot Potato,0,6,3,9
3207,2023-01-27,POCO,gemGrab,Undermine,0,12,10,22
3208,2023-01-27,POCO,gemGrab,Deep Diner,0,69,45,114
3209,2023-01-27,POCO,brawlBall,Sneaky Fields,4,275,294,573
3210,2023-01-27,POCO,brawlBall,Pinhole Punt,0,17,16,33
3211,2023-01-27,POCO,bounty,Temple Ruins,0,9,2,11
3212,2023-01-26,POCO,knockout,Riverside,0,45,22,67
3213,2023-01-26,POCO,hotZone,Open Zone,0,451,578,1029
3214,2023-01-26,POCO,heist,Hot Potato,0,26,15,41
3215,2023-01-26,POCO,gemGrab,Undermine,0,125,97,222
3216,2023-01-26,POCO,gemGrab,Gem Fort,0,69,91,160
3217,2023-01-26,POCO,brawlBall,Sunny Soccer,1,41,43,85
3218,2023-01-26,POCO,brawlBall,Pinhole Punt,16,946,979,1941
3219,2023-01-26,POCO,bounty,Temple Ruins,0,31,24,55
3220,2023-01-25,POCO,knockout,Riverside,0,17,6,23
3221,2023-01-25,POCO,hotZone,Open Zone,0,213,260,473
3222,2023-01-25,POCO,heist,Safe Zone,0,17,7,24
3223,2023-01-25,POCO,gemGrab,Gem Fort,0,106,132,238
3224,2023-01-25,POCO,gemGrab,Crystal Arcade,0,117,80,197
3225,2023-01-25,POCO,brawlBall,Sunny Soccer,7,344,393,744
3226,2023-01-25,POCO,brawlBall,Beach Ball,5,60,54,119
3227,2023-01-25,POCO,bounty,Excel,0,19,6,25
3228,2023-01-24,POCO,knockout,New Perspective,0,36,19,55
3229,2023-01-24,POCO,hotZone,Dueling Beetles,0,520,684,1204
3230,2023-01-24,POCO,heist,Safe Zone,0,20,20,40
3231,2023-01-24,POCO,gemGrab,Minecart Madness,0,33,29,62
3232,2023-01-24,POCO,gemGrab,Crystal Arcade,0,189,129,318
3233,2023-01-24,POCO,brawlBall,Center Stage,2,46,57,105
3234,2023-01-24,POCO,brawlBall,Beach Ball,19,561,625,1205
3235,2023-01-24,POCO,bounty,Excel,0,46,41,87
3236,2023-01-23,POCO,knockout,New Perspective,1,52,24,77
3237,2023-01-23,POCO,hotZone,Dueling Beetles,0,805,1061,1866
3238,2023-01-23,POCO,heist,Snaked Assault,1,18,3,22
3239,2023-01-23,POCO,gemGrab,Minecart Madness,0,170,137,307
3240,2023-01-23,POCO,gemGrab,Double Swoosh,0,116,88,204
3241,2023-01-23,POCO,brawlBall,Center Stage,12,643,622,1277
3242,2023-01-23,POCO,brawlBall,Backyard Bowl,0,17,10,27
3243,2023-01-23,POCO,bounty,Layer Cake,0,38,44,82
3244,2023-01-22,POCO,knockout,X Marks the Spot,0,18,9,27
3245,2023-01-22,POCO,hotZone,Ring of Fire,1,239,250,490
3246,2023-01-22,POCO,heist,Snaked Assault,0,9,10,19
3247,2023-01-22,POCO,gemGrab,Hard Rock Mine,0,36,49,85
3248,2023-01-22,POCO,gemGrab,Double Swoosh,0,135,88,223
3249,2023-01-22,POCO,brawlBall,Super Beach,4,76,70,150
3250,2023-01-22,POCO,brawlBall,Backyard Bowl,3,176,140,319
3251,2023-01-22,POCO,bounty,Layer Cake,0,40,67,107
3252,2023-01-21,POCO,knockout,X Marks the Spot,1,70,43,114
3253,2023-01-21,POCO,hotZone,Ring of Fire,0,776,961,1737
3254,2023-01-21,POCO,heist,Tornado Ring,0,19,6,25
3255,2023-01-21,POCO,gemGrab,Hard Rock Mine,0,207,183,390
3256,2023-01-21,POCO,gemGrab,Deep Diner,0,66,26,92
3257,2023-01-21,POCO,brawlBall,Super Beach,23,863,940,1826
3258,2023-01-21,POCO,brawlBall,Sneaky Fields,1,47,43,91
3259,2023-01-21,POCO,bounty,Dry Season,0,48,18,66
3260,2023-01-20,POCO,knockout,Out in the Open,0,81,48,129
3261,2023-01-20,POCO,hotZone,Split,0,88,44,132
3262,2023-01-20,POCO,heist,Tornado Ring,0,25,10,35
3263,2023-01-20,POCO,gemGrab,Undermine,0,64,49,113
3264,2023-01-20,POCO,gemGrab,Deep Diner,0,218,197,415
3265,2023-01-20,POCO,brawlBall,Sneaky Fields,20,789,868,1677
3266,2023-01-20,POCO,brawlBall,Pinhole Punt,1,36,43,80
3267,2023-01-20,POCO,bounty,Dry Season,0,25,19,44
3268,2023-01-19,POCO,knockout,Out in the Open,1,78,49,128
3269,2023-01-19,POCO,hotZone,Split,0,103,65,168
3270,2023-01-19,POCO,heist,Kaboom Canyon,0,29,19,48
3271,2023-01-19,POCO,gemGrab,Undermine,0,199,149,348
3272,2023-01-19,POCO,gemGrab,Gem Fort,0,36,43,79
3273,2023-01-19,POCO,brawlBall,Sunny Soccer,0,17,16,33
3274,2023-01-19,POCO,brawlBall,Pinhole Punt,27,915,1117,2059
3275,2023-01-19,POCO,bounty,Shooting Star,0,44,38,82
3276,2023-01-18,POCO,knockout,Goldarm Gulch,0,7,1,8
3277,2023-01-18,POCO,hotZone,Parallel Plays,0,21,13,34
3278,2023-01-18,POCO,heist,Kaboom Canyon,0,2,3,5
3279,2023-01-18,POCO,gemGrab,Gem Fort,0,49,42,91
3280,2023-01-18,POCO,gemGrab,Crystal Arcade,0,18,11,29
3281,2023-01-18,POCO,brawlBall,Sunny Soccer,2,146,143,291
3282,2023-01-18,POCO,brawlBall,Beach Ball,0,3,5,8
3283,2023-01-18,POCO,bounty,Shooting Star,0,10,11,21
3284,2023-01-17,POCO,knockout,Goldarm Gulch,0,7,2,9
3285,2023-01-17,POCO,hotZone,Parallel Plays,0,7,8,15
3286,2023-01-17,POCO,heist,Pit Stop,0,3,0,3
3287,2023-01-17,POCO,gemGrab,Minecart Madness,0,1,0,1
3288,2023-01-17,POCO,gemGrab,Crystal Arcade,0,13,9,22
3289,2023-01-17,POCO,brawlBall,Center Stage,0,1,4,5
3290,2023-01-17,POCO,brawlBall,Beach Ball,1,48,45,94
3291,2023-01-17,POCO,bounty,Hideout,0,4,3,7
3292,2023-01-16,POCO,knockout,Belle's Rock,0,1,1,2
3293,2023-01-16,POCO,hotZone,Quarter Pounder,0,36,13,49
3294,2023-01-16,POCO,heist,Pit Stop,0,4,0,4
3295,2023-01-16,POCO,gemGrab,Minecart Madness,0,18,9,27
3296,2023-01-16,POCO,gemGrab,Double Swoosh,0,10,4,14
3297,2023-01-16,POCO,brawlBall,Center Stage,1,40,38,79
3298,2023-01-16,POCO,brawlBall,Backyard Bowl,0,2,1,3
3299,2023-01-16,POCO,bounty,Hideout,0,1,1,2
3300,2023-01-15,POCO,knockout,Belle's Rock,0,1,0,1
3301,2023-01-15,POCO,hotZone,Quarter Pounder,0,60,35,95
3302,2023-01-15,POCO,heist,Bridge Too Far,0,3,0,3
3303,2023-01-15,POCO,gemGrab,Hard Rock Mine,0,3,2,5
3304,2023-01-15,POCO,gemGrab,Double Swoosh,0,38,35,73
3305,2023-01-15,POCO,brawlBall,Super Beach,0,9,7,16
3306,2023-01-15,POCO,brawlBall,Backyard Bowl,1,39,31,71
3307,2023-01-15,POCO,bounty,Canal Grande,0,3,1,4
3308,2023-01-14,POCO,knockout,Flaring Phoenix,0,2,0,2
3309,2023-01-14,POCO,hotZone,Controller Chaos,0,58,117,175
3310,2023-01-14,POCO,heist,Bridge Too Far,0,4,1,5
3311,2023-01-14,POCO,gemGrab,Hard Rock Mine,0,10,7,17
3312,2023-01-14,POCO,gemGrab,Deep Diner,0,11,4,15
3313,2023-01-14,POCO,brawlBall,Super Beach,0,55,53,108
3314,2023-01-14,POCO,brawlBall,Sneaky Fields,1,12,1,14
3315,2023-01-14,POCO,bounty,Canal Grande,0,8,14,22
3316,2023-01-13,POCO,knockout,Flaring Phoenix,0,2,1,3
3317,2023-01-13,POCO,hotZone,Controller Chaos,0,104,89,193
3318,2023-01-13,POCO,gemGrab,Undermine,0,0,2,2
3319,2023-01-13,POCO,gemGrab,Deep Diner,0,19,14,33
3320,2023-01-13,POCO,brawlBall,Sneaky Fields,0,96,136,232
3321,2023-01-13,POCO,brawlBall,Pinhole Punt,0,3,2,5
3322,2023-01-13,POCO,bounty,Temple Ruins,0,2,1,3
3323,2023-01-12,POCO,knockout,Riverside,0,6,2,8
3324,2023-01-12,POCO,hotZone,Open Zone,0,89,102,191
3325,2023-01-12,POCO,gemGrab,Undermine,0,3,1,4
3326,2023-01-12,POCO,gemGrab,Gem Fort,0,2,5,7
3327,2023-01-12,POCO,brawlBall,Sunny Soccer,0,2,1,3
3328,2023-01-12,POCO,brawlBall,Pinhole Punt,1,33,39,73
3329,2023-01-12,POCO,bounty,Temple Ruins,0,0,1,1
3330,2023-01-11,POCO,hotZone,Open Zone,0,22,21,43
3331,2023-01-11,POCO,heist,Safe Zone,0,0,1,1
3332,2023-01-11,POCO,gemGrab,Gem Fort,0,5,1,6
3333,2023-01-11,POCO,brawlBall,Sunny Soccer,1,7,7,15
3334,2023-01-11,POCO,brawlBall,Beach Ball,0,1,0,1
3335,2023-01-11,POCO,bounty,Excel,0,1,0,1
3336,2023-01-10,POCO,knockout,New Perspective,0,2,2,4
3337,2023-01-10,POCO,hotZone,Dueling Beetles,0,101,130,231
3338,2023-01-10,POCO,heist,Safe Zone,0,1,3,4
3339,2023-01-10,POCO,gemGrab,Minecart Madness,0,9,1,10
3340,2023-01-10,POCO,gemGrab,Crystal Arcade,0,21,6,27
3341,2023-01-10,POCO,brawlBall,Center Stage,0,6,0,6
3342,2023-01-10,POCO,brawlBall,Beach Ball,0,44,32,76
3343,2023-01-09,POCO,knockout,New Perspective,0,2,2,4
3344,2023-01-09,POCO,hotZone,Dueling Beetles,0,57,38,95
3345,2023-01-09,POCO,heist,Snaked Assault,0,2,0,2
3346,2023-01-09,POCO,gemGrab,Minecart Madness,0,11,3,14
3347,2023-01-09,POCO,gemGrab,Double Swoosh,0,34,47,81
3348,2023-01-09,POCO,brawlBall,Center Stage,0,28,20,48
3349,2023-01-09,POCO,brawlBall,Backyard Bowl,0,3,1,4
3350,2023-01-09,POCO,bounty,Layer Cake,0,1,0,1
3351,2023-01-08,POCO,knockout,X Marks the Spot,0,7,0,7
3352,2023-01-08,POCO,hotZone,Ring of Fire,0,82,87,169
3353,2023-01-08,POCO,heist,Snaked Assault,0,1,0,1
3354,2023-01-08,POCO,gemGrab,Hard Rock Mine,0,6,1,7
3355,2023-01-08,POCO,gemGrab,Double Swoosh,0,8,6,14
3356,2023-01-08,POCO,brawlBall,Super Beach,0,4,4,8
3357,2023-01-08,POCO,brawlBall,Backyard Bowl,3,33,10,46
3358,2023-01-08,POCO,bounty,Layer Cake,0,1,6,7
3359,2023-01-07,POCO,knockout,X Marks the Spot,0,1,0,1
3360,2023-01-07,POCO,hotZone,Ring of Fire,0,46,29,75
3361,2023-01-07,POCO,heist,Tornado Ring,0,1,0,1
3362,2023-01-07,POCO,gemGrab,Hard Rock Mine,0,10,8,18
3363,2023-01-07,POCO,gemGrab,Deep Diner,0,7,2,9
3364,2023-01-07,POCO,brawlBall,Super Beach,0,23,15,38
3365,2023-01-07,POCO,brawlBall,Sneaky Fields,0,3,3,6
3366,2023-01-07,POCO,bounty,Dry Season,0,1,0,1
3367,2023-01-06,POCO,knockout,Out in the Open,0,2,0,2
3368,2023-01-06,POCO,hotZone,Split,0,7,1,8
3369,2023-01-06,POCO,gemGrab,Undermine,0,3,0,3
3370,2023-01-06,POCO,gemGrab,Deep Diner,0,28,8,36
3371,2023-01-06,POCO,brawlBall,Sneaky Fields,2,78,85,165
3372,2023-01-06,POCO,brawlBall,Pinhole Punt,0,2,9,11
3373,2023-01-06,POCO,bounty,Dry Season,0,3,4,7
3374,2023-01-05,POCO,knockout,Out in the Open,0,3,0,3
3375,2023-01-05,POCO,hotZone,Split,0,22,23,45
3376,2023-01-05,POCO,heist,Kaboom Canyon,0,2,0,2
3377,2023-01-05,POCO,gemGrab,Undermine,0,10,3,13
3378,2023-01-05,POCO,gemGrab,Gem Fort,0,4,5,9
3379,2023-01-05,POCO,brawlBall,Sunny Soccer,0,1,0,1
3380,2023-01-05,POCO,brawlBall,Pinhole Punt,1,112,72,185
3381,2023-01-05,POCO,bounty,Shooting Star,0,0,1,1
3382,2023-01-04,POCO,hotZone,Parallel Plays,0,15,4,19
3383,2023-01-04,POCO,heist,Kaboom Canyon,0,2,0,2
3384,2023-01-04,POCO,gemGrab,Gem Fort,0,44,41,85
3385,2023-01-04,POCO,gemGrab,Crystal Arcade,0,8,13,21
3386,2023-01-04,POCO,brawlBall,Sunny Soccer,0,43,50,93
3387,2023-01-04,POCO,brawlBall,Beach Ball,0,1,1,2
3388,2023-01-04,POCO,bounty,Shooting Star,0,3,15,18
3389,2023-01-03,POCO,knockout,Goldarm Gulch,0,1,0,1
3390,2023-01-03,POCO,hotZone,Parallel Plays,0,24,27,51
3391,2023-01-03,POCO,heist,Pit Stop,0,0,1,1
3392,2023-01-03,POCO,gemGrab,Minecart Madness,0,4,0,4
3393,2023-01-03,POCO,gemGrab,Crystal Arcade,0,32,6,38
3394,2023-01-03,POCO,brawlBall,Center Stage,0,1,0,1
3395,2023-01-03,POCO,brawlBall,Beach Ball,0,45,39,84
3396,2023-01-03,POCO,bounty,Hideout,0,3,0,3
3397,2023-01-02,POCO,knockout,Belle's Rock,0,1,0,1
3398,2023-01-02,POCO,hotZone,Quarter Pounder,1,68,75,144
3399,2023-01-02,POCO,hotZone,Controller Chaos,0,0,2,2
3400,2023-01-02,POCO,heist,Pit Stop,0,0,1,1
3401,2023-01-02,POCO,gemGrab,Minecart Madness,0,28,7,35
3402,2023-01-02,POCO,gemGrab,Double Swoosh,0,24,16,40
3403,2023-01-02,POCO,brawlBall,Center Stage,0,63,66,129
3404,2023-01-02,POCO,brawlBall,Backyard Bowl,0,2,1,3
3405,2023-01-02,POCO,bounty,Hideout,0,3,0,3
3406,2023-01-01,POCO,knockout,Belle's Rock,0,1,0,1
3407,2023-01-01,POCO,hotZone,Quarter Pounder,0,11,1,12
3408,2023-01-01,POCO,heist,Bridge Too Far,0,1,0,1
3409,2023-01-01,POCO,gemGrab,Minecart Madness,0,1,0,1
3410,2023-01-01,POCO,gemGrab,Double Swoosh,0,15,12,27
3411,2023-01-01,POCO,brawlBall,Backyard Bowl,0,10,4,14
3412,2023-01-01,POCO,bounty,Canal Grande,0,2,2,4
3413,2022-12-31,POCO,hotZone,Controller Chaos,0,7,2,9
3414,2022-12-31,POCO,gemGrab,Hard Rock Mine,0,3,1,4
3415,2022-12-31,POCO,gemGrab,Deep Diner,0,2,0,2
3416,2022-12-31,POCO,brawlBall,Super Beach,0,7,3,10
3417,2022-12-31,POCO,brawlBall,Sneaky Fields,0,0,1,1
3418,2022-12-31,POCO,bounty,Canal Grande,0,2,2,4
3419,2022-12-30,POCO,hotZone,Controller Chaos,0,5,2,7
3420,2022-12-30,POCO,gemGrab,Deep Diner,0,6,3,9
3421,2022-12-30,POCO,brawlBall,Sneaky Fields,0,4,3,7
3422,2022-12-29,POCO,hotZone,Open Zone,0,1,2,3
3423,2022-12-29,POCO,gemGrab,Gem Fort,0,1,0,1
3424,2022-12-29,POCO,brawlBall,Pinhole Punt,0,3,1,4
3425,2022-12-28,POCO,hotZone,Open Zone,0,4,3,7
3426,2022-12-27,POCO,hotZone,Dueling Beetles,0,2,0,2
3427,2022-12-26,POCO,brawlBall,Center Stage,0,1,0,1
3428,2022-12-23,POCO,knockout,Out in the Open,0,0,1,1
3429,2022-12-23,POCO,gemGrab,Deep Diner,0,1,0,1
3430,2022-12-22,POCO,gemGrab,Gem Fort,0,3,0,3
3431,2022-12-22,POCO,brawlBall,Pinhole Punt,0,3,0,3
3432,2022-12-21,POCO,brawlBall,Sunny Soccer,0,1,0,1
3433,2022-12-16,POCO,hotZone,Controller Chaos,0,1,0,1
3434,2022-12-13,POCO,knockout,New Perspective,0,1,0,1
3435,2022-12-13,POCO,heist,Safe Zone,0,2,0,2
3436,2022-12-11,POCO,gemGrab,Double Swoosh,0,0,1,1
3437,2022-12-10,POCO,gemGrab,Hard Rock Mine,0,0,1,1
3438,2022-11-11,POCO,brawlBall,Sneaky Fields,0,0,1,1
3439,2022-10-30,POCO,bounty,Canal Grande,0,1,0,1
3440,2022-10-28,POCO,knockout,Out in the Open,0,1,0,1
3441,2022-10-15,POCO,hotZone,Ring of Fire,0,1,2,3
3442,2022-10-15,POCO,gemGrab,Hard Rock Mine,0,0,3,3
3443,2022-10-10,POCO,knockout,Belle's Rock,0,1,0,1
3444,2023-01-30,PIPER,knockout,Belle's Rock,0,466,450,916
3445,2023-01-30,PIPER,hotZone,Quarter Pounder,0,26,23,49
3446,2023-01-30,PIPER,heist,Pit Stop,0,2,2,4
3447,2023-01-30,PIPER,gemGrab,Minecart Madness,0,181,266,447
3448,2023-01-30,PIPER,gemGrab,Double Swoosh,0,32,35,67
3449,2023-01-30,PIPER,brawlBall,Center Stage,2,47,13,62
3450,2023-01-30,PIPER,brawlBall,Backyard Bowl,1,112,117,230
3451,2023-01-30,PIPER,bounty,Hideout,0,236,259,495
3452,2023-01-29,PIPER,knockout,Belle's Rock,0,474,494,968
3453,2023-01-29,PIPER,hotZone,Quarter Pounder,0,35,16,51
3454,2023-01-29,PIPER,heist,Bridge Too Far,1,383,312,696
3455,2023-01-29,PIPER,gemGrab,Hard Rock Mine,0,30,54,84
3456,2023-01-29,PIPER,gemGrab,Double Swoosh,0,70,41,111
3457,2023-01-29,PIPER,brawlBall,Super Beach,0,2,1,3
3458,2023-01-29,PIPER,brawlBall,Backyard Bowl,73,1231,1175,2479
3459,2023-01-29,PIPER,bounty,Canal Grande,0,58,72,130
3460,2023-01-28,PIPER,knockout,Flaring Phoenix,1,214,148,363
3461,2023-01-28,PIPER,hotZone,Controller Chaos,0,12,1,13
3462,2023-01-28,PIPER,heist,Bridge Too Far,7,918,877,1802
3463,2023-01-28,PIPER,gemGrab,Hard Rock Mine,0,260,288,548
3464,2023-01-28,PIPER,gemGrab,Deep Diner,0,46,56,102
3465,2023-01-28,PIPER,brawlBall,Super Beach,2,86,66,154
3466,2023-01-28,PIPER,brawlBall,Sneaky Fields,0,3,0,3
3467,2023-01-28,PIPER,bounty,Canal Grande,0,95,51,146
3468,2023-01-27,PIPER,knockout,Flaring Phoenix,0,91,87,178
3469,2023-01-27,PIPER,hotZone,Controller Chaos,0,4,2,6
3470,2023-01-27,PIPER,heist,Hot Potato,0,12,4,16
3471,2023-01-27,PIPER,gemGrab,Undermine,0,11,9,20
3472,2023-01-27,PIPER,gemGrab,Deep Diner,0,68,59,127
3473,2023-01-27,PIPER,brawlBall,Sneaky Fields,0,14,11,25
3474,2023-01-27,PIPER,brawlBall,Pinhole Punt,0,6,8,14
3475,2023-01-27,PIPER,bounty,Temple Ruins,0,42,44,86
3476,2023-01-26,PIPER,knockout,Riverside,2,1503,1603,3108
3477,2023-01-26,PIPER,hotZone,Open Zone,0,77,47,124
3478,2023-01-26,PIPER,heist,Hot Potato,0,15,22,37
3479,2023-01-26,PIPER,gemGrab,Undermine,0,132,156,288
3480,2023-01-26,PIPER,gemGrab,Gem Fort,0,13,9,22
3481,2023-01-26,PIPER,brawlBall,Sunny Soccer,0,6,2,8
3482,2023-01-26,PIPER,brawlBall,Pinhole Punt,0,170,97,267
3483,2023-01-26,PIPER,bounty,Temple Ruins,0,133,120,253
3484,2023-01-25,PIPER,knockout,Riverside,0,789,837,1626
3485,2023-01-25,PIPER,hotZone,Open Zone,0,33,15,48
3486,2023-01-25,PIPER,heist,Safe Zone,1,175,153,329
3487,2023-01-25,PIPER,gemGrab,Gem Fort,0,29,17,46
3488,2023-01-25,PIPER,gemGrab,Crystal Arcade,0,75,76,151
3489,2023-01-25,PIPER,brawlBall,Sunny Soccer,0,27,20,47
3490,2023-01-25,PIPER,brawlBall,Beach Ball,0,12,6,18
3491,2023-01-25,PIPER,bounty,Excel,0,68,81,149
3492,2023-01-24,PIPER,knockout,New Perspective,0,268,254,522
3493,2023-01-24,PIPER,hotZone,Dueling Beetles,0,20,3,23
3494,2023-01-24,PIPER,heist,Safe Zone,0,313,237,550
3495,2023-01-24,PIPER,gemGrab,Minecart Madness,0,75,106,181
3496,2023-01-24,PIPER,gemGrab,Crystal Arcade,0,178,173,351
3497,2023-01-24,PIPER,brawlBall,Center Stage,0,3,7,10
3498,2023-01-24,PIPER,brawlBall,Beach Ball,0,68,47,115
3499,2023-01-24,PIPER,bounty,Excel,0,105,71,176
3500,2023-01-23,PIPER,knockout,New Perspective,1,392,330,723
3501,2023-01-23,PIPER,hotZone,Dueling Beetles,0,29,25,54
3502,2023-01-23,PIPER,heist,Snaked Assault,0,26,8,34
3503,2023-01-23,PIPER,gemGrab,Minecart Madness,0,317,371,688
3504,2023-01-23,PIPER,gemGrab,Double Swoosh,0,42,49,91
3505,2023-01-23,PIPER,brawlBall,Center Stage,0,90,53,143
3506,2023-01-23,PIPER,brawlBall,Backyard Bowl,3,69,71,143
3507,2023-01-23,PIPER,bounty,Layer Cake,0,205,201,406
3508,2023-01-22,PIPER,knockout,X Marks the Spot,0,264,224,488
3509,2023-01-22,PIPER,hotZone,Ring of Fire,0,22,4,26
3510,2023-01-22,PIPER,heist,Snaked Assault,0,5,4,9
3511,2023-01-22,PIPER,gemGrab,Hard Rock Mine,0,66,97,163
3512,2023-01-22,PIPER,gemGrab,Double Swoosh,0,37,29,66
3513,2023-01-22,PIPER,brawlBall,Super Beach,0,6,2,8
3514,2023-01-22,PIPER,brawlBall,Backyard Bowl,34,680,594,1308
3515,2023-01-22,PIPER,bounty,Layer Cake,0,125,143,268
3516,2023-01-21,PIPER,knockout,X Marks the Spot,1,832,834,1667
3517,2023-01-21,PIPER,hotZone,Ring of Fire,0,79,31,110
3518,2023-01-21,PIPER,heist,Tornado Ring,0,21,6,27
3519,2023-01-21,PIPER,gemGrab,Hard Rock Mine,0,365,368,733
3520,2023-01-21,PIPER,gemGrab,Deep Diner,0,42,14,56
3521,2023-01-21,PIPER,brawlBall,Super Beach,3,126,98,227
3522,2023-01-21,PIPER,brawlBall,Sneaky Fields,0,1,0,1
3523,2023-01-21,PIPER,bounty,Dry Season,0,706,723,1429
3524,2023-01-20,PIPER,knockout,Out in the Open,0,682,580,1262
3525,2023-01-20,PIPER,hotZone,Split,0,5,2,7
3526,2023-01-20,PIPER,heist,Tornado Ring,0,10,8,18
3527,2023-01-20,PIPER,gemGrab,Undermine,0,54,47,101
3528,2023-01-20,PIPER,gemGrab,Deep Diner,0,148,122,270
3529,2023-01-20,PIPER,brawlBall,Sneaky Fields,1,55,39,95
3530,2023-01-20,PIPER,brawlBall,Pinhole Punt,0,9,8,17
3531,2023-01-20,PIPER,bounty,Dry Season,0,581,498,1079
3532,2023-01-19,PIPER,knockout,Out in the Open,0,808,689,1497
3533,2023-01-19,PIPER,hotZone,Split,0,6,3,9
3534,2023-01-19,PIPER,heist,Kaboom Canyon,0,55,68,123
3535,2023-01-19,PIPER,gemGrab,Undermine,0,171,214,385
3536,2023-01-19,PIPER,gemGrab,Gem Fort,0,14,6,20
3537,2023-01-19,PIPER,brawlBall,Sunny Soccer,0,2,1,3
3538,2023-01-19,PIPER,brawlBall,Pinhole Punt,4,184,128,316
3539,2023-01-19,PIPER,bounty,Shooting Star,0,759,774,1533
3540,2023-01-18,PIPER,knockout,Goldarm Gulch,0,47,33,80
3541,2023-01-18,PIPER,hotZone,Parallel Plays,0,0,2,2
3542,2023-01-18,PIPER,heist,Kaboom Canyon,0,22,17,39
3543,2023-01-18,PIPER,gemGrab,Gem Fort,0,12,6,18
3544,2023-01-18,PIPER,gemGrab,Crystal Arcade,0,4,4,8
3545,2023-01-18,PIPER,brawlBall,Sunny Soccer,0,28,15,43
3546,2023-01-18,PIPER,bounty,Shooting Star,0,351,353,704
3547,2023-01-17,PIPER,knockout,Goldarm Gulch,0,69,54,123
3548,2023-01-17,PIPER,hotZone,Parallel Plays,0,2,0,2
3549,2023-01-17,PIPER,gemGrab,Minecart Madness,0,6,1,7
3550,2023-01-17,PIPER,gemGrab,Crystal Arcade,0,12,8,20
3551,2023-01-17,PIPER,brawlBall,Beach Ball,1,7,2,10
3552,2023-01-17,PIPER,bounty,Hideout,0,49,54,103
3553,2023-01-16,PIPER,knockout,Belle's Rock,0,50,61,111
3554,2023-01-16,PIPER,hotZone,Quarter Pounder,0,2,1,3
3555,2023-01-16,PIPER,heist,Pit Stop,0,1,0,1
3556,2023-01-16,PIPER,gemGrab,Minecart Madness,0,24,27,51
3557,2023-01-16,PIPER,gemGrab,Double Swoosh,0,2,0,2
3558,2023-01-16,PIPER,brawlBall,Center Stage,0,5,0,5
3559,2023-01-16,PIPER,brawlBall,Backyard Bowl,1,8,10,19
3560,2023-01-16,PIPER,bounty,Hideout,0,74,70,144
3561,2023-01-15,PIPER,knockout,Belle's Rock,0,58,100,158
3562,2023-01-15,PIPER,hotZone,Quarter Pounder,0,7,14,21
3563,2023-01-15,PIPER,heist,Bridge Too Far,0,103,97,200
3564,2023-01-15,PIPER,gemGrab,Hard Rock Mine,0,18,18,36
3565,2023-01-15,PIPER,gemGrab,Double Swoosh,0,10,2,12
3566,2023-01-15,PIPER,brawlBall,Super Beach,0,0,1,1
3567,2023-01-15,PIPER,brawlBall,Backyard Bowl,4,154,180,338
3568,2023-01-15,PIPER,bounty,Canal Grande,0,11,3,14
3569,2023-01-14,PIPER,knockout,Flaring Phoenix,0,22,5,27
3570,2023-01-14,PIPER,hotZone,Controller Chaos,0,1,1,2
3571,2023-01-14,PIPER,heist,Bridge Too Far,0,164,136,300
3572,2023-01-14,PIPER,gemGrab,Hard Rock Mine,0,16,23,39
3573,2023-01-14,PIPER,gemGrab,Deep Diner,0,7,11,18
3574,2023-01-14,PIPER,brawlBall,Super Beach,0,4,8,12
3575,2023-01-14,PIPER,bounty,Canal Grande,0,4,0,4
3576,2023-01-13,PIPER,knockout,Flaring Phoenix,0,13,3,16
3577,2023-01-13,PIPER,hotZone,Controller Chaos,0,1,6,7
3578,2023-01-13,PIPER,gemGrab,Deep Diner,0,18,13,31
3579,2023-01-13,PIPER,brawlBall,Sneaky Fields,0,8,2,10
3580,2023-01-13,PIPER,bounty,Temple Ruins,0,8,9,17
3581,2023-01-12,PIPER,knockout,Riverside,0,223,240,463
3582,2023-01-12,PIPER,hotZone,Open Zone,0,13,16,29
3583,2023-01-12,PIPER,gemGrab,Undermine,0,16,23,39
3584,2023-01-12,PIPER,brawlBall,Pinhole Punt,0,8,3,11
3585,2023-01-12,PIPER,bounty,Temple Ruins,0,1,0,1
3586,2023-01-11,PIPER,knockout,Riverside,0,68,73,141
3587,2023-01-11,PIPER,hotZone,Open Zone,0,0,1,1
3588,2023-01-11,PIPER,brawlBall,Sunny Soccer,0,1,0,1
3589,2023-01-11,PIPER,bounty,Excel,0,1,1,2
3590,2023-01-10,PIPER,knockout,New Perspective,0,19,10,29
3591,2023-01-10,PIPER,hotZone,Dueling Beetles,0,1,1,2
3592,2023-01-10,PIPER,heist,Safe Zone,0,32,38,70
3593,2023-01-10,PIPER,gemGrab,Minecart Madness,0,16,34,50
3594,2023-01-10,PIPER,gemGrab,Crystal Arcade,0,22,16,38
3595,2023-01-10,PIPER,brawlBall,Beach Ball,0,6,7,13
3596,2023-01-10,PIPER,bounty,Excel,0,4,0,4
3597,2023-01-09,PIPER,knockout,New Perspective,0,15,7,22
3598,2023-01-09,PIPER,hotZone,Dueling Beetles,0,1,1,2
3599,2023-01-09,PIPER,heist,Snaked Assault,0,2,1,3
3600,2023-01-09,PIPER,gemGrab,Minecart Madness,0,46,39,85
3601,2023-01-09,PIPER,gemGrab,Double Swoosh,0,4,1,5
3602,2023-01-09,PIPER,brawlBall,Center Stage,0,9,0,9
3603,2023-01-09,PIPER,brawlBall,Backyard Bowl,0,4,8,12
3604,2023-01-09,PIPER,bounty,Layer Cake,0,26,18,44
3605,2023-01-08,PIPER,knockout,X Marks the Spot,0,48,33,81
3606,2023-01-08,PIPER,hotZone,Ring of Fire,0,11,11,22
3607,2023-01-08,PIPER,heist,Snaked Assault,0,7,10,17
3608,2023-01-08,PIPER,gemGrab,Hard Rock Mine,0,9,20,29
3609,2023-01-08,PIPER,gemGrab,Double Swoosh,0,2,1,3
3610,2023-01-08,PIPER,brawlBall,Super Beach,0,0,1,1
3611,2023-01-08,PIPER,brawlBall,Backyard Bowl,5,116,104,225
3612,2023-01-08,PIPER,bounty,Layer Cake,0,10,5,15
3613,2023-01-07,PIPER,knockout,X Marks the Spot,0,54,56,110
3614,2023-01-07,PIPER,hotZone,Ring of Fire,0,4,1,5
3615,2023-01-07,PIPER,heist,Tornado Ring,0,0,1,1
3616,2023-01-07,PIPER,gemGrab,Hard Rock Mine,0,18,5,23
3617,2023-01-07,PIPER,gemGrab,Deep Diner,0,15,14,29
3618,2023-01-07,PIPER,brawlBall,Super Beach,0,5,0,5
3619,2023-01-07,PIPER,bounty,Dry Season,0,57,69,126
3620,2023-01-06,PIPER,knockout,Out in the Open,0,60,56,116
3621,2023-01-06,PIPER,hotZone,Split,0,4,0,4
3622,2023-01-06,PIPER,heist,Tornado Ring,0,3,0,3
3623,2023-01-06,PIPER,gemGrab,Undermine,0,13,15,28
3624,2023-01-06,PIPER,gemGrab,Deep Diner,0,27,17,44
3625,2023-01-06,PIPER,brawlBall,Sneaky Fields,0,7,1,8
3626,2023-01-06,PIPER,brawlBall,Pinhole Punt,0,4,7,11
3627,2023-01-06,PIPER,bounty,Dry Season,0,110,72,182
3628,2023-01-05,PIPER,knockout,Out in the Open,0,81,84,165
3629,2023-01-05,PIPER,heist,Kaboom Canyon,0,9,21,30
3630,2023-01-05,PIPER,gemGrab,Undermine,0,45,32,77
3631,2023-01-05,PIPER,brawlBall,Pinhole Punt,2,23,15,40
3632,2023-01-05,PIPER,bounty,Shooting Star,0,119,131,250
3633,2023-01-04,PIPER,knockout,Goldarm Gulch,0,14,5,19
3634,2023-01-04,PIPER,hotZone,Parallel Plays,0,1,1,2
3635,2023-01-04,PIPER,heist,Kaboom Canyon,0,35,30,65
3636,2023-01-04,PIPER,gemGrab,Gem Fort,0,1,0,1
3637,2023-01-04,PIPER,gemGrab,Crystal Arcade,0,6,2,8
3638,2023-01-04,PIPER,brawlBall,Sunny Soccer,0,2,2,4
3639,2023-01-04,PIPER,bounty,Shooting Star,0,326,294,620
3640,2023-01-03,PIPER,knockout,Goldarm Gulch,0,13,14,27
3641,2023-01-03,PIPER,hotZone,Parallel Plays,0,2,0,2
3642,2023-01-03,PIPER,heist,Kaboom Canyon,0,0,1,1
3643,2023-01-03,PIPER,gemGrab,Minecart Madness,0,5,11,16
3644,2023-01-03,PIPER,gemGrab,Crystal Arcade,0,22,18,40
3645,2023-01-03,PIPER,brawlBall,Center Stage,0,1,0,1
3646,2023-01-03,PIPER,brawlBall,Beach Ball,0,8,1,9
3647,2023-01-03,PIPER,bounty,Hideout,0,112,100,212
3648,2023-01-02,PIPER,knockout,Belle's Rock,0,49,84,133
3649,2023-01-02,PIPER,hotZone,Quarter Pounder,0,7,11,18
3650,2023-01-02,PIPER,heist,Pit Stop,0,2,0,2
3651,2023-01-02,PIPER,heist,Kaboom Canyon,0,1,0,1
3652,2023-01-02,PIPER,gemGrab,Minecart Madness,0,51,38,89
3653,2023-01-02,PIPER,gemGrab,Double Swoosh,0,2,1,3
3654,2023-01-02,PIPER,brawlBall,Center Stage,0,9,7,16
3655,2023-01-02,PIPER,brawlBall,Backyard Bowl,1,3,11,15
3656,2023-01-02,PIPER,bounty,Hideout,0,193,228,421
3657,2023-01-01,PIPER,knockout,Belle's Rock,0,44,66,110
3658,2023-01-01,PIPER,hotZone,Quarter Pounder,0,2,0,2
3659,2023-01-01,PIPER,heist,Bridge Too Far,0,20,10,30
3660,2023-01-01,PIPER,gemGrab,Hard Rock Mine,0,2,2,4
3661,2023-01-01,PIPER,gemGrab,Double Swoosh,0,2,0,2
3662,2023-01-01,PIPER,brawlBall,Backyard Bowl,2,66,45,113
3663,2023-01-01,PIPER,bounty,Canal Grande,0,1,0,1
3664,2022-12-31,PIPER,heist,Bridge Too Far,0,14,17,31
3665,2022-12-31,PIPER,gemGrab,Hard Rock Mine,0,3,1,4
3666,2022-12-31,PIPER,gemGrab,Deep Diner,0,4,1,5
3667,2022-12-31,PIPER,brawlBall,Super Beach,0,0,1,1
3668,2022-12-31,PIPER,bounty,Canal Grande,0,0,1,1
3669,2022-12-30,PIPER,knockout,Flaring Phoenix,0,3,4,7
3670,2022-12-30,PIPER,gemGrab,Deep Diner,0,2,1,3
3671,2022-12-30,PIPER,brawlBall,Sneaky Fields,0,1,0,1
3672,2022-12-29,PIPER,gemGrab,Undermine,0,1,1,2
3673,2022-12-29,PIPER,gemGrab,Minecart Madness,0,1,2,3
3674,2022-12-29,PIPER,gemGrab,Gem Fort,0,1,2,3
3675,2022-12-29,PIPER,brawlBall,Pinhole Punt,0,0,1,1
3676,2022-12-27,PIPER,knockout,New Perspective,0,1,1,2
3677,2022-12-27,PIPER,brawlBall,Beach Ball,0,0,1,1
3678,2022-12-26,PIPER,heist,Kaboom Canyon,0,0,2,2
3679,2022-12-26,PIPER,gemGrab,Minecart Madness,0,1,4,5
3680,2022-12-26,PIPER,brawlBall,Center Stage,0,1,2,3
3681,2022-12-25,PIPER,brawlBall,Backyard Bowl,0,3,12,15
3682,2022-12-25,PIPER,bounty,Layer Cake,0,0,1,1
3683,2022-12-24,PIPER,bounty,Dry Season,0,1,1,2
3684,2022-12-23,PIPER,knockout,Out in the Open,0,3,2,5
3685,2022-12-21,PIPER,bounty,Shooting Star,0,1,1,2
3686,2022-12-20,PIPER,brawlBall,Beach Ball,0,1,0,1
3687,2022-12-18,PIPER,heist,Bridge Too Far,0,1,1,2
3688,2022-12-17,PIPER,knockout,Flaring Phoenix,0,1,0,1
3689,2022-12-16,PIPER,bounty,Temple Ruins,0,1,0,1
3690,2022-12-13,PIPER,knockout,New Perspective,0,1,0,1
3691,2022-11-11,PIPER,knockout,New Perspective,0,1,0,1
3692,2022-11-01,PIPER,knockout,New Perspective,0,2,4,6
3693,2022-10-30,PIPER,knockout,Out in the Open,0,1,0,1
3694,2022-10-28,PIPER,knockout,Out in the Open,0,1,1,2
3695,2022-10-26,PIPER,bounty,Shooting Star,0,6,3,9
3696,2022-10-15,PIPER,gemGrab,Hard Rock Mine,0,1,2,3
3697,2022-10-10,PIPER,knockout,Belle's Rock,0,0,2,2
3698,2023-01-30,PENNY,knockout,Belle's Rock,0,84,99,183
3699,2023-01-30,PENNY,hotZone,Quarter Pounder,1,221,177,399
3700,2023-01-30,PENNY,heist,Pit Stop,0,37,11,48
3701,2023-01-30,PENNY,gemGrab,Minecart Madness,0,136,110,246
3702,2023-01-30,PENNY,gemGrab,Double Swoosh,0,85,149,234
3703,2023-01-30,PENNY,brawlBall,Center Stage,3,134,111,248
3704,2023-01-30,PENNY,brawlBall,Backyard Bowl,0,24,35,59
3705,2023-01-30,PENNY,bounty,Hideout,0,11,23,34
3706,2023-01-29,PENNY,knockout,Belle's Rock,0,126,117,243
3707,2023-01-29,PENNY,hotZone,Quarter Pounder,0,157,176,333
3708,2023-01-29,PENNY,heist,Bridge Too Far,0,45,24,69
3709,2023-01-29,PENNY,gemGrab,Hard Rock Mine,0,40,43,83
3710,2023-01-29,PENNY,gemGrab,Double Swoosh,0,187,295,482
3711,2023-01-29,PENNY,brawlBall,Super Beach,1,13,17,31
3712,2023-01-29,PENNY,brawlBall,Backyard Bowl,14,301,514,829
3713,2023-01-29,PENNY,bounty,Canal Grande,0,98,137,235
3714,2023-01-28,PENNY,knockout,Flaring Phoenix,0,95,85,180
3715,2023-01-28,PENNY,hotZone,Controller Chaos,0,132,134,266
3716,2023-01-28,PENNY,heist,Bridge Too Far,0,91,46,137
3717,2023-01-28,PENNY,gemGrab,Hard Rock Mine,0,188,188,376
3718,2023-01-28,PENNY,gemGrab,Deep Diner,0,100,122,222
3719,2023-01-28,PENNY,brawlBall,Super Beach,12,378,421,811
3720,2023-01-28,PENNY,brawlBall,Sneaky Fields,0,12,6,18
3721,2023-01-28,PENNY,bounty,Canal Grande,0,215,286,501
3722,2023-01-27,PENNY,knockout,Flaring Phoenix,1,38,52,91
3723,2023-01-27,PENNY,hotZone,Controller Chaos,0,31,18,49
3724,2023-01-27,PENNY,heist,Hot Potato,0,28,25,53
3725,2023-01-27,PENNY,gemGrab,Undermine,0,14,18,32
3726,2023-01-27,PENNY,gemGrab,Deep Diner,0,133,193,326
3727,2023-01-27,PENNY,brawlBall,Sneaky Fields,2,59,71,132
3728,2023-01-27,PENNY,brawlBall,Pinhole Punt,0,1,2,3
3729,2023-01-27,PENNY,bounty,Temple Ruins,0,6,3,9
3730,2023-01-26,PENNY,knockout,Riverside,0,32,38,70
3731,2023-01-26,PENNY,hotZone,Open Zone,0,113,133,246
3732,2023-01-26,PENNY,heist,Hot Potato,0,62,29,91
3733,2023-01-26,PENNY,gemGrab,Undermine,0,94,79,173
3734,2023-01-26,PENNY,gemGrab,Gem Fort,0,25,20,45
3735,2023-01-26,PENNY,brawlBall,Sunny Soccer,0,13,21,34
3736,2023-01-26,PENNY,brawlBall,Pinhole Punt,12,282,339,633
3737,2023-01-26,PENNY,bounty,Temple Ruins,0,47,77,124
3738,2023-01-25,PENNY,knockout,Riverside,0,19,20,39
3739,2023-01-25,PENNY,hotZone,Open Zone,0,52,66,118
3740,2023-01-25,PENNY,heist,Safe Zone,0,140,95,235
3741,2023-01-25,PENNY,gemGrab,Gem Fort,0,35,30,65
3742,2023-01-25,PENNY,gemGrab,Crystal Arcade,0,96,144,240
3743,2023-01-25,PENNY,brawlBall,Sunny Soccer,4,180,207,391
3744,2023-01-25,PENNY,brawlBall,Beach Ball,1,39,51,91
3745,2023-01-25,PENNY,bounty,Excel,0,53,62,115
3746,2023-01-24,PENNY,knockout,New Perspective,0,31,30,61
3747,2023-01-24,PENNY,hotZone,Dueling Beetles,0,385,416,801
3748,2023-01-24,PENNY,heist,Safe Zone,0,173,157,330
3749,2023-01-24,PENNY,gemGrab,Minecart Madness,0,41,49,90
3750,2023-01-24,PENNY,gemGrab,Crystal Arcade,0,165,204,369
3751,2023-01-24,PENNY,brawlBall,Center Stage,2,22,27,51
3752,2023-01-24,PENNY,brawlBall,Beach Ball,12,285,375,672
3753,2023-01-24,PENNY,bounty,Excel,0,114,205,319
3754,2023-01-23,PENNY,knockout,New Perspective,0,72,52,124
3755,2023-01-23,PENNY,hotZone,Dueling Beetles,2,640,860,1502
3756,2023-01-23,PENNY,heist,Snaked Assault,0,71,24,95
3757,2023-01-23,PENNY,gemGrab,Minecart Madness,0,247,250,497
3758,2023-01-23,PENNY,gemGrab,Double Swoosh,0,84,149,233
3759,2023-01-23,PENNY,brawlBall,Center Stage,10,225,267,502
3760,2023-01-23,PENNY,brawlBall,Backyard Bowl,2,17,25,44
3761,2023-01-23,PENNY,bounty,Layer Cake,0,202,303,505
3762,2023-01-22,PENNY,knockout,X Marks the Spot,0,37,28,65
3763,2023-01-22,PENNY,hotZone,Ring of Fire,0,155,169,324
3764,2023-01-22,PENNY,heist,Snaked Assault,0,46,18,64
3765,2023-01-22,PENNY,gemGrab,Hard Rock Mine,0,42,31,73
3766,2023-01-22,PENNY,gemGrab,Double Swoosh,0,112,174,286
3767,2023-01-22,PENNY,brawlBall,Super Beach,3,35,41,79
3768,2023-01-22,PENNY,brawlBall,Backyard Bowl,10,140,197,347
3769,2023-01-22,PENNY,bounty,Layer Cake,0,133,172,305
3770,2023-01-21,PENNY,knockout,X Marks the Spot,1,86,101,188
3771,2023-01-21,PENNY,hotZone,Ring of Fire,1,447,562,1010
3772,2023-01-21,PENNY,heist,Tornado Ring,0,59,27,86
3773,2023-01-21,PENNY,gemGrab,Hard Rock Mine,0,241,340,581
3774,2023-01-21,PENNY,gemGrab,Deep Diner,0,61,81,142
3775,2023-01-21,PENNY,brawlBall,Super Beach,14,415,551,980
3776,2023-01-21,PENNY,brawlBall,Sneaky Fields,0,18,11,29
3777,2023-01-21,PENNY,bounty,Dry Season,0,135,177,312
3778,2023-01-20,PENNY,knockout,Out in the Open,1,94,95,190
3779,2023-01-20,PENNY,hotZone,Split,0,61,54,115
3780,2023-01-20,PENNY,heist,Tornado Ring,0,45,23,68
3781,2023-01-20,PENNY,gemGrab,Undermine,0,58,64,122
3782,2023-01-20,PENNY,gemGrab,Deep Diner,0,306,393,699
3783,2023-01-20,PENNY,brawlBall,Sneaky Fields,8,167,222,397
3784,2023-01-20,PENNY,brawlBall,Pinhole Punt,0,8,10,18
3785,2023-01-20,PENNY,bounty,Dry Season,0,111,159,270
3786,2023-01-19,PENNY,knockout,Out in the Open,0,137,162,299
3787,2023-01-19,PENNY,hotZone,Split,0,74,43,117
3788,2023-01-19,PENNY,heist,Kaboom Canyon,1,67,42,110
3789,2023-01-19,PENNY,gemGrab,Undermine,0,160,222,382
3790,2023-01-19,PENNY,gemGrab,Gem Fort,0,17,31,48
3791,2023-01-19,PENNY,brawlBall,Sunny Soccer,0,7,7,14
3792,2023-01-19,PENNY,brawlBall,Pinhole Punt,11,225,272,508
3793,2023-01-19,PENNY,bounty,Shooting Star,0,59,25,84
3794,2023-01-18,PENNY,knockout,Goldarm Gulch,0,7,7,14
3795,2023-01-18,PENNY,hotZone,Parallel Plays,0,14,14,28
3796,2023-01-18,PENNY,heist,Kaboom Canyon,0,20,19,39
3797,2023-01-18,PENNY,gemGrab,Gem Fort,0,27,32,59
3798,2023-01-18,PENNY,gemGrab,Crystal Arcade,0,15,22,37
3799,2023-01-18,PENNY,brawlBall,Sunny Soccer,4,72,92,168
3800,2023-01-18,PENNY,brawlBall,Beach Ball,0,2,1,3
3801,2023-01-18,PENNY,bounty,Shooting Star,0,10,16,26
3802,2023-01-17,PENNY,knockout,Goldarm Gulch,0,9,11,20
3803,2023-01-17,PENNY,hotZone,Parallel Plays,0,11,25,36
3804,2023-01-17,PENNY,heist,Pit Stop,0,7,3,10
3805,2023-01-17,PENNY,gemGrab,Minecart Madness,0,1,5,6
3806,2023-01-17,PENNY,gemGrab,Crystal Arcade,0,17,13,30
3807,2023-01-17,PENNY,brawlBall,Center Stage,0,0,2,2
3808,2023-01-17,PENNY,brawlBall,Beach Ball,4,20,24,48
3809,2023-01-17,PENNY,bounty,Hideout,0,2,6,8
3810,2023-01-16,PENNY,knockout,Belle's Rock,0,18,30,48
3811,2023-01-16,PENNY,hotZone,Quarter Pounder,0,16,37,53
3812,2023-01-16,PENNY,heist,Pit Stop,0,11,5,16
3813,2023-01-16,PENNY,gemGrab,Minecart Madness,0,7,16,23
3814,2023-01-16,PENNY,gemGrab,Double Swoosh,0,3,3,6
3815,2023-01-16,PENNY,brawlBall,Center Stage,0,8,5,13
3816,2023-01-16,PENNY,brawlBall,Backyard Bowl,1,3,30,34
3817,2023-01-16,PENNY,bounty,Hideout,0,4,1,5
3818,2023-01-15,PENNY,knockout,Belle's Rock,0,17,7,24
3819,2023-01-15,PENNY,hotZone,Quarter Pounder,0,35,68,103
3820,2023-01-15,PENNY,heist,Bridge Too Far,0,11,17,28
3821,2023-01-15,PENNY,gemGrab,Hard Rock Mine,0,10,7,17
3822,2023-01-15,PENNY,gemGrab,Double Swoosh,0,29,58,87
3823,2023-01-15,PENNY,brawlBall,Super Beach,1,4,3,8
3824,2023-01-15,PENNY,brawlBall,Backyard Bowl,2,39,97,138
3825,2023-01-15,PENNY,bounty,Canal Grande,0,12,30,42
3826,2023-01-14,PENNY,knockout,Flaring Phoenix,0,3,2,5
3827,2023-01-14,PENNY,hotZone,Controller Chaos,0,35,37,72
3828,2023-01-14,PENNY,heist,Bridge Too Far,0,10,18,28
3829,2023-01-14,PENNY,gemGrab,Hard Rock Mine,0,13,14,27
3830,2023-01-14,PENNY,gemGrab,Deep Diner,0,14,3,17
3831,2023-01-14,PENNY,brawlBall,Super Beach,0,15,43,58
3832,2023-01-14,PENNY,brawlBall,Sneaky Fields,0,1,6,7
3833,2023-01-14,PENNY,bounty,Canal Grande,0,15,22,37
3834,2023-01-13,PENNY,knockout,Flaring Phoenix,0,5,16,21
3835,2023-01-13,PENNY,hotZone,Controller Chaos,0,33,69,102
3836,2023-01-13,PENNY,heist,Hot Potato,0,1,0,1
3837,2023-01-13,PENNY,gemGrab,Deep Diner,0,28,31,59
3838,2023-01-13,PENNY,brawlBall,Sneaky Fields,0,11,10,21
3839,2023-01-13,PENNY,bounty,Temple Ruins,0,3,0,3
3840,2023-01-12,PENNY,knockout,Riverside,0,5,1,6
3841,2023-01-12,PENNY,hotZone,Open Zone,0,14,26,40
3842,2023-01-12,PENNY,heist,Hot Potato,0,1,0,1
3843,2023-01-12,PENNY,gemGrab,Undermine,0,10,9,19
3844,2023-01-12,PENNY,gemGrab,Gem Fort,0,1,1,2
3845,2023-01-12,PENNY,brawlBall,Sunny Soccer,0,2,1,3
3846,2023-01-12,PENNY,brawlBall,Pinhole Punt,1,8,9,18
3847,2023-01-11,PENNY,knockout,Riverside,0,1,0,1
3848,2023-01-11,PENNY,hotZone,Open Zone,0,2,0,2
3849,2023-01-11,PENNY,heist,Safe Zone,0,0,1,1
3850,2023-01-11,PENNY,gemGrab,Gem Fort,0,2,3,5
3851,2023-01-11,PENNY,brawlBall,Sunny Soccer,1,8,11,20
3852,2023-01-11,PENNY,brawlBall,Beach Ball,0,1,0,1
3853,2023-01-11,PENNY,bounty,Excel,0,6,0,6
3854,2023-01-10,PENNY,knockout,New Perspective,0,2,1,3
3855,2023-01-10,PENNY,hotZone,Dueling Beetles,0,63,84,147
3856,2023-01-10,PENNY,heist,Safe Zone,0,10,3,13
3857,2023-01-10,PENNY,gemGrab,Minecart Madness,0,10,2,12
3858,2023-01-10,PENNY,gemGrab,Crystal Arcade,0,34,53,87
3859,2023-01-10,PENNY,brawlBall,Beach Ball,0,20,42,62
3860,2023-01-10,PENNY,bounty,Excel,0,2,6,8
3861,2023-01-09,PENNY,knockout,New Perspective,0,2,1,3
3862,2023-01-09,PENNY,hotZone,Dueling Beetles,0,44,62,106
3863,2023-01-09,PENNY,heist,Snaked Assault,0,12,2,14
3864,2023-01-09,PENNY,gemGrab,Minecart Madness,0,17,11,28
3865,2023-01-09,PENNY,gemGrab,Double Swoosh,0,15,6,21
3866,2023-01-09,PENNY,brawlBall,Center Stage,0,4,5,9
3867,2023-01-09,PENNY,brawlBall,Backyard Bowl,0,2,0,2
3868,2023-01-09,PENNY,bounty,Layer Cake,0,25,30,55
3869,2023-01-08,PENNY,knockout,X Marks the Spot,0,4,2,6
3870,2023-01-08,PENNY,hotZone,Ring of Fire,0,25,48,73
3871,2023-01-08,PENNY,heist,Snaked Assault,0,6,2,8
3872,2023-01-08,PENNY,gemGrab,Hard Rock Mine,0,11,13,24
3873,2023-01-08,PENNY,gemGrab,Double Swoosh,0,3,8,11
3874,2023-01-08,PENNY,brawlBall,Super Beach,0,4,8,12
3875,2023-01-08,PENNY,brawlBall,Backyard Bowl,0,14,28,42
3876,2023-01-08,PENNY,bounty,Layer Cake,0,5,5,10
3877,2023-01-07,PENNY,knockout,X Marks the Spot,0,3,1,4
3878,2023-01-07,PENNY,hotZone,Ring of Fire,0,14,40,54
3879,2023-01-07,PENNY,heist,Tornado Ring,0,5,2,7
3880,2023-01-07,PENNY,gemGrab,Hard Rock Mine,0,6,18,24
3881,2023-01-07,PENNY,gemGrab,Deep Diner,0,8,2,10
3882,2023-01-07,PENNY,brawlBall,Super Beach,0,12,20,32
3883,2023-01-07,PENNY,brawlBall,Sneaky Fields,0,0,1,1
3884,2023-01-07,PENNY,bounty,Dry Season,0,10,14,24
3885,2023-01-06,PENNY,knockout,Out in the Open,0,12,13,25
3886,2023-01-06,PENNY,hotZone,Split,0,3,1,4
3887,2023-01-06,PENNY,heist,Tornado Ring,0,6,2,8
3888,2023-01-06,PENNY,gemGrab,Undermine,0,3,0,3
3889,2023-01-06,PENNY,gemGrab,Deep Diner,0,49,49,98
3890,2023-01-06,PENNY,brawlBall,Sneaky Fields,0,7,19,26
3891,2023-01-06,PENNY,bounty,Dry Season,0,21,20,41
3892,2023-01-05,PENNY,knockout,Out in the Open,0,15,21,36
3893,2023-01-05,PENNY,hotZone,Split,0,12,10,22
3894,2023-01-05,PENNY,heist,Kaboom Canyon,0,11,14,25
3895,2023-01-05,PENNY,gemGrab,Undermine,0,13,47,60
3896,2023-01-05,PENNY,gemGrab,Gem Fort,0,0,2,2
3897,2023-01-05,PENNY,brawlBall,Sunny Soccer,0,1,0,1
3898,2023-01-05,PENNY,brawlBall,Pinhole Punt,2,24,35,61
3899,2023-01-05,PENNY,bounty,Shooting Star,0,7,0,7
3900,2023-01-04,PENNY,knockout,Goldarm Gulch,0,3,15,18
3901,2023-01-04,PENNY,hotZone,Parallel Plays,0,7,6,13
3902,2023-01-04,PENNY,heist,Kaboom Canyon,0,14,2,16
3903,2023-01-04,PENNY,gemGrab,Gem Fort,0,21,32,53
3904,2023-01-04,PENNY,gemGrab,Crystal Arcade,0,6,4,10
3905,2023-01-04,PENNY,brawlBall,Sunny Soccer,2,29,36,67
3906,2023-01-04,PENNY,bounty,Shooting Star,0,14,2,16
3907,2023-01-03,PENNY,knockout,Goldarm Gulch,0,4,5,9
3908,2023-01-03,PENNY,hotZone,Parallel Plays,0,6,11,17
3909,2023-01-03,PENNY,hotZone,Controller Chaos,0,1,1,2
3910,2023-01-03,PENNY,heist,Pit Stop,0,5,0,5
3911,2023-01-03,PENNY,gemGrab,Minecart Madness,0,10,18,28
3912,2023-01-03,PENNY,gemGrab,Crystal Arcade,0,23,23,46
3913,2023-01-03,PENNY,brawlBall,Center Stage,0,1,0,1
3914,2023-01-03,PENNY,brawlBall,Beach Ball,0,11,35,46
3915,2023-01-03,PENNY,bounty,Hideout,0,11,2,13
3916,2023-01-02,PENNY,knockout,Belle's Rock,0,6,3,9
3917,2023-01-02,PENNY,hotZone,Quarter Pounder,0,21,23,44
3918,2023-01-02,PENNY,heist,Pit Stop,0,3,3,6
3919,2023-01-02,PENNY,heist,Kaboom Canyon,0,0,1,1
3920,2023-01-02,PENNY,gemGrab,Minecart Madness,0,27,42,69
3921,2023-01-02,PENNY,gemGrab,Double Swoosh,0,25,36,61
3922,2023-01-02,PENNY,brawlBall,Center Stage,0,12,5,17
3923,2023-01-02,PENNY,brawlBall,Backyard Bowl,0,3,7,10
3924,2023-01-02,PENNY,bounty,Hideout,0,17,7,24
3925,2023-01-01,PENNY,knockout,Belle's Rock,0,2,2,4
3926,2023-01-01,PENNY,hotZone,Quarter Pounder,0,5,9,14
3927,2023-01-01,PENNY,heist,Kaboom Canyon,0,1,0,1
3928,2023-01-01,PENNY,heist,Bridge Too Far,0,1,0,1
3929,2023-01-01,PENNY,gemGrab,Minecart Madness,0,1,1,2
3930,2023-01-01,PENNY,gemGrab,Double Swoosh,0,15,38,53
3931,2023-01-01,PENNY,brawlBall,Backyard Bowl,0,11,5,16
3932,2023-01-01,PENNY,bounty,Canal Grande,0,0,1,1
3933,2022-12-31,PENNY,hotZone,Controller Chaos,0,0,1,1
3934,2022-12-31,PENNY,heist,Bridge Too Far,0,1,1,2
3935,2022-12-31,PENNY,gemGrab,Minecart Madness,0,1,2,3
3936,2022-12-31,PENNY,gemGrab,Hard Rock Mine,0,6,5,11
3937,2022-12-31,PENNY,gemGrab,Deep Diner,0,6,20,26
3938,2022-12-31,PENNY,brawlBall,Super Beach,0,4,7,11
3939,2022-12-31,PENNY,bounty,Canal Grande,0,1,2,3
3940,2022-12-30,PENNY,heist,Hot Potato,0,1,0,1
3941,2022-12-30,PENNY,gemGrab,Minecart Madness,0,0,1,1
3942,2022-12-30,PENNY,gemGrab,Deep Diner,0,10,16,26
3943,2022-12-30,PENNY,brawlBall,Sneaky Fields,0,1,0,1
3944,2022-12-29,PENNY,hotZone,Controller Chaos,0,1,0,1
3945,2022-12-29,PENNY,heist,Kaboom Canyon,0,0,1,1
3946,2022-12-29,PENNY,gemGrab,Undermine,0,1,0,1
3947,2022-12-29,PENNY,brawlBall,Pinhole Punt,0,3,0,3
3948,2022-12-27,PENNY,hotZone,Dueling Beetles,0,2,1,3
3949,2022-12-27,PENNY,heist,Kaboom Canyon,0,0,1,1
3950,2022-12-27,PENNY,gemGrab,Minecart Madness,0,1,0,1
3951,2022-12-27,PENNY,bounty,Excel,0,1,0,1
3952,2022-12-26,PENNY,brawlBall,Center Stage,0,2,1,3
3953,2022-12-25,PENNY,gemGrab,Double Swoosh,0,2,4,6
3954,2022-12-24,PENNY,bounty,Dry Season,0,1,1,2
3955,2022-12-23,PENNY,knockout,Out in the Open,0,2,0,2
3956,2022-12-22,PENNY,gemGrab,Gem Fort,0,1,0,1
3957,2022-12-20,PENNY,brawlBall,Beach Ball,0,1,1,2
3958,2022-12-18,PENNY,heist,Bridge Too Far,0,1,0,1
3959,2022-12-17,PENNY,brawlBall,Super Beach,0,0,1,1
3960,2022-12-16,PENNY,gemGrab,Undermine,0,0,1,1
3961,2022-12-16,PENNY,brawlBall,Sneaky Fields,0,1,0,1
3962,2022-12-16,PENNY,bounty,Temple Ruins,0,1,4,5
3963,2022-12-13,PENNY,heist,Safe Zone,0,1,1,2
3964,2022-12-13,PENNY,gemGrab,Crystal Arcade,0,0,2,2
3965,2022-10-30,PENNY,hotZone,Dueling Beetles,0,0,2,2
3966,2022-10-28,PENNY,hotZone,Dueling Beetles,0,1,0,1
3967,2022-10-26,PENNY,bounty,Shooting Star,0,0,1,1
3968,2022-10-15,PENNY,hotZone,Ring of Fire,0,2,2,4
3969,2022-10-15,PENNY,gemGrab,Hard Rock Mine,0,1,0,1
3970,2022-10-15,PENNY,bounty,Dry Season,0,1,0,1
3971,2022-10-10,PENNY,knockout,Belle's Rock,0,1,0,1
3972,2023-01-30,PAM,knockout,Belle's Rock,0,9,7,16
3973,2023-01-30,PAM,hotZone,Quarter Pounder,0,94,114,208
3974,2023-01-30,PAM,heist,Pit Stop,1,5,5,11
3975,2023-01-30,PAM,gemGrab,Minecart Madness,0,41,39,80
3976,2023-01-30,PAM,gemGrab,Double Swoosh,0,51,75,126
3977,2023-01-30,PAM,brawlBall,Center Stage,3,59,92,154
3978,2023-01-30,PAM,brawlBall,Backyard Bowl,1,34,45,80
3979,2023-01-30,PAM,bounty,Hideout,0,2,2,4
3980,2023-01-29,PAM,knockout,Belle's Rock,0,7,5,12
3981,2023-01-29,PAM,hotZone,Quarter Pounder,1,40,55,96
3982,2023-01-29,PAM,heist,Bridge Too Far,0,22,22,44
3983,2023-01-29,PAM,gemGrab,Hard Rock Mine,0,11,22,33
3984,2023-01-29,PAM,gemGrab,Double Swoosh,0,90,115,205
3985,2023-01-29,PAM,brawlBall,Super Beach,0,3,3,6
3986,2023-01-29,PAM,brawlBall,Backyard Bowl,18,282,389,689
3987,2023-01-29,PAM,bounty,Canal Grande,0,6,3,9
3988,2023-01-28,PAM,knockout,Flaring Phoenix,0,18,8,26
3989,2023-01-28,PAM,hotZone,Controller Chaos,0,81,72,153
3990,2023-01-28,PAM,heist,Bridge Too Far,0,32,27,59
3991,2023-01-28,PAM,gemGrab,Hard Rock Mine,0,65,91,156
3992,2023-01-28,PAM,gemGrab,Deep Diner,0,22,18,40
3993,2023-01-28,PAM,brawlBall,Super Beach,1,92,99,192
3994,2023-01-28,PAM,brawlBall,Sneaky Fields,0,4,3,7
3995,2023-01-28,PAM,bounty,Canal Grande,0,13,20,33
3996,2023-01-27,PAM,knockout,Flaring Phoenix,0,4,4,8
3997,2023-01-27,PAM,hotZone,Controller Chaos,0,36,40,76
3998,2023-01-27,PAM,heist,Hot Potato,0,4,4,8
3999,2023-01-27,PAM,gemGrab,Undermine,0,2,11,13
4000,2023-01-27,PAM,gemGrab,Deep Diner,0,33,32,65
4001,2023-01-27,PAM,brawlBall,Sneaky Fields,2,37,61,100
4002,2023-01-27,PAM,brawlBall,Pinhole Punt,0,3,2,5
4003,2023-01-27,PAM,bounty,Temple Ruins,0,4,3,7
4004,2023-01-26,PAM,knockout,Riverside,1,12,17,30
4005,2023-01-26,PAM,hotZone,Open Zone,0,137,208,345
4006,2023-01-26,PAM,heist,Hot Potato,0,19,15,34
4007,2023-01-26,PAM,gemGrab,Undermine,0,76,146,222
4008,2023-01-26,PAM,gemGrab,Gem Fort,0,37,54,91
4009,2023-01-26,PAM,brawlBall,Sunny Soccer,0,5,1,6
4010,2023-01-26,PAM,brawlBall,Pinhole Punt,10,193,255,458
4011,2023-01-26,PAM,bounty,Temple Ruins,0,17,14,31
4012,2023-01-25,PAM,knockout,Riverside,0,6,2,8
4013,2023-01-25,PAM,hotZone,Open Zone,0,73,115,188
4014,2023-01-25,PAM,heist,Safe Zone,0,5,3,8
4015,2023-01-25,PAM,gemGrab,Gem Fort,0,29,28,57
4016,2023-01-25,PAM,gemGrab,Crystal Arcade,0,34,33,67
4017,2023-01-25,PAM,brawlBall,Sunny Soccer,3,67,56,126
4018,2023-01-25,PAM,brawlBall,Beach Ball,0,7,7,14
4019,2023-01-25,PAM,bounty,Excel,0,3,2,5
4020,2023-01-24,PAM,knockout,New Perspective,0,15,22,37
4021,2023-01-24,PAM,hotZone,Dueling Beetles,0,66,79,145
4022,2023-01-24,PAM,heist,Safe Zone,0,15,25,40
4023,2023-01-24,PAM,gemGrab,Minecart Madness,0,13,12,25
4024,2023-01-24,PAM,gemGrab,Crystal Arcade,0,54,68,122
4025,2023-01-24,PAM,brawlBall,Center Stage,2,13,27,42
4026,2023-01-24,PAM,brawlBall,Beach Ball,3,120,161,284
4027,2023-01-24,PAM,bounty,Excel,0,5,18,23
4028,2023-01-23,PAM,knockout,New Perspective,0,13,8,21
4029,2023-01-23,PAM,hotZone,Dueling Beetles,0,77,66,143
4030,2023-01-23,PAM,heist,Snaked Assault,1,13,5,19
4031,2023-01-23,PAM,gemGrab,Minecart Madness,0,55,79,134
4032,2023-01-23,PAM,gemGrab,Double Swoosh,0,43,40,83
4033,2023-01-23,PAM,brawlBall,Center Stage,6,123,128,257
4034,2023-01-23,PAM,brawlBall,Backyard Bowl,1,18,38,57
4035,2023-01-23,PAM,bounty,Layer Cake,0,3,3,6
4036,2023-01-22,PAM,knockout,X Marks the Spot,0,6,11,17
4037,2023-01-22,PAM,hotZone,Ring of Fire,0,27,38,65
4038,2023-01-22,PAM,heist,Snaked Assault,0,8,10,18
4039,2023-01-22,PAM,gemGrab,Hard Rock Mine,0,6,12,18
4040,2023-01-22,PAM,gemGrab,Double Swoosh,0,58,68,126
4041,2023-01-22,PAM,brawlBall,Super Beach,0,3,5,8
4042,2023-01-22,PAM,brawlBall,Backyard Bowl,10,146,256,412
4043,2023-01-22,PAM,bounty,Layer Cake,0,3,1,4
4044,2023-01-21,PAM,knockout,X Marks the Spot,0,25,25,50
4045,2023-01-21,PAM,hotZone,Ring of Fire,0,118,128,246
4046,2023-01-21,PAM,heist,Tornado Ring,0,22,20,42
4047,2023-01-21,PAM,gemGrab,Hard Rock Mine,0,66,84,150
4048,2023-01-21,PAM,gemGrab,Deep Diner,0,21,30,51
4049,2023-01-21,PAM,brawlBall,Super Beach,7,102,101,210
4050,2023-01-21,PAM,brawlBall,Sneaky Fields,0,7,9,16
4051,2023-01-21,PAM,bounty,Dry Season,0,13,8,21
4052,2023-01-20,PAM,knockout,Out in the Open,0,31,19,50
4053,2023-01-20,PAM,hotZone,Split,0,26,18,44
4054,2023-01-20,PAM,heist,Tornado Ring,0,20,5,25
4055,2023-01-20,PAM,gemGrab,Undermine,0,52,110,162
4056,2023-01-20,PAM,gemGrab,Deep Diner,0,76,81,157
4057,2023-01-20,PAM,brawlBall,Sneaky Fields,2,97,114,213
4058,2023-01-20,PAM,brawlBall,Pinhole Punt,1,11,22,34
4059,2023-01-20,PAM,bounty,Dry Season,0,10,8,18
4060,2023-01-19,PAM,knockout,Out in the Open,0,30,23,53
4061,2023-01-19,PAM,hotZone,Split,0,51,62,113
4062,2023-01-19,PAM,heist,Kaboom Canyon,0,29,18,47
4063,2023-01-19,PAM,gemGrab,Undermine,0,94,163,257
4064,2023-01-19,PAM,gemGrab,Gem Fort,0,15,11,26
4065,2023-01-19,PAM,brawlBall,Sunny Soccer,0,0,3,3
4066,2023-01-19,PAM,brawlBall,Pinhole Punt,12,226,323,561
4067,2023-01-19,PAM,bounty,Shooting Star,0,18,11,29
4068,2023-01-18,PAM,knockout,Goldarm Gulch,0,2,2,4
4069,2023-01-18,PAM,hotZone,Parallel Plays,0,11,6,17
4070,2023-01-18,PAM,heist,Kaboom Canyon,0,7,17,24
4071,2023-01-18,PAM,gemGrab,Gem Fort,0,28,39,67
4072,2023-01-18,PAM,gemGrab,Crystal Arcade,0,2,1,3
4073,2023-01-18,PAM,brawlBall,Sunny Soccer,0,30,33,63
4074,2023-01-18,PAM,brawlBall,Beach Ball,1,4,3,8
4075,2023-01-18,PAM,bounty,Shooting Star,0,6,3,9
4076,2023-01-17,PAM,knockout,Goldarm Gulch,0,3,1,4
4077,2023-01-17,PAM,hotZone,Parallel Plays,0,17,12,29
4078,2023-01-17,PAM,heist,Pit Stop,0,0,1,1
4079,2023-01-17,PAM,gemGrab,Crystal Arcade,0,1,5,6
4080,2023-01-17,PAM,brawlBall,Beach Ball,1,16,12,29
4081,2023-01-16,PAM,hotZone,Quarter Pounder,0,3,4,7
4082,2023-01-16,PAM,heist,Pit Stop,0,1,0,1
4083,2023-01-16,PAM,gemGrab,Minecart Madness,0,8,5,13
4084,2023-01-16,PAM,gemGrab,Double Swoosh,0,6,18,24
4085,2023-01-16,PAM,brawlBall,Center Stage,0,8,27,35
4086,2023-01-16,PAM,brawlBall,Backyard Bowl,0,8,0,8
4087,2023-01-15,PAM,hotZone,Quarter Pounder,0,20,24,44
4088,2023-01-15,PAM,heist,Bridge Too Far,0,2,1,3
4089,2023-01-15,PAM,gemGrab,Hard Rock Mine,0,1,16,17
4090,2023-01-15,PAM,gemGrab,Double Swoosh,0,10,7,17
4091,2023-01-15,PAM,brawlBall,Super Beach,0,1,0,1
4092,2023-01-15,PAM,brawlBall,Backyard Bowl,0,38,59,97
4093,2023-01-14,PAM,knockout,Flaring Phoenix,0,1,0,1
4094,2023-01-14,PAM,hotZone,Controller Chaos,0,18,43,61
4095,2023-01-14,PAM,heist,Bridge Too Far,0,4,2,6
4096,2023-01-14,PAM,gemGrab,Hard Rock Mine,0,1,11,12
4097,2023-01-14,PAM,gemGrab,Deep Diner,0,2,1,3
4098,2023-01-14,PAM,brawlBall,Super Beach,0,4,8,12
4099,2023-01-14,PAM,bounty,Canal Grande,0,1,0,1
4100,2023-01-13,PAM,hotZone,Controller Chaos,0,9,9,18
4101,2023-01-13,PAM,gemGrab,Deep Diner,0,3,5,8
4102,2023-01-13,PAM,brawlBall,Sneaky Fields,0,12,7,19
4103,2023-01-13,PAM,brawlBall,Pinhole Punt,0,0,1,1
4104,2023-01-13,PAM,bounty,Temple Ruins,0,1,1,2
4105,2023-01-12,PAM,knockout,Riverside,0,7,7,14
4106,2023-01-12,PAM,hotZone,Open Zone,0,17,14,31
4107,2023-01-12,PAM,gemGrab,Undermine,0,10,14,24
4108,2023-01-12,PAM,gemGrab,Gem Fort,0,2,1,3
4109,2023-01-12,PAM,brawlBall,Pinhole Punt,0,7,13,20
4110,2023-01-11,PAM,hotZone,Open Zone,0,7,4,11
4111,2023-01-11,PAM,gemGrab,Gem Fort,0,1,1,2
4112,2023-01-10,PAM,knockout,New Perspective,0,1,0,1
4113,2023-01-10,PAM,hotZone,Dueling Beetles,0,9,14,23
4114,2023-01-10,PAM,heist,Safe Zone,0,10,14,24
4115,2023-01-10,PAM,gemGrab,Minecart Madness,0,2,5,7
4116,2023-01-10,PAM,gemGrab,Crystal Arcade,0,6,3,9
4117,2023-01-10,PAM,brawlBall,Beach Ball,0,1,1,2
4118,2023-01-10,PAM,bounty,Excel,0,1,0,1
4119,2023-01-09,PAM,hotZone,Dueling Beetles,0,4,1,5
4120,2023-01-09,PAM,heist,Snaked Assault,0,2,0,2
4121,2023-01-09,PAM,gemGrab,Minecart Madness,0,6,10,16
4122,2023-01-09,PAM,gemGrab,Double Swoosh,0,5,10,15
4123,2023-01-09,PAM,brawlBall,Center Stage,0,7,2,9
4124,2023-01-09,PAM,brawlBall,Backyard Bowl,0,0,11,11
4125,2023-01-09,PAM,bounty,Layer Cake,0,1,0,1
4126,2023-01-08,PAM,hotZone,Ring of Fire,0,19,23,42
4127,2023-01-08,PAM,heist,Snaked Assault,0,2,0,2
4128,2023-01-08,PAM,gemGrab,Hard Rock Mine,0,1,0,1
4129,2023-01-08,PAM,gemGrab,Double Swoosh,0,2,1,3
4130,2023-01-08,PAM,brawlBall,Super Beach,0,0,2,2
4131,2023-01-08,PAM,brawlBall,Backyard Bowl,0,11,41,52
4132,2023-01-07,PAM,hotZone,Ring of Fire,0,7,22,29
4133,2023-01-07,PAM,heist,Tornado Ring,0,1,3,4
4134,2023-01-07,PAM,gemGrab,Hard Rock Mine,0,2,2,4
4135,2023-01-07,PAM,gemGrab,Deep Diner,0,1,0,1
4136,2023-01-07,PAM,brawlBall,Super Beach,0,1,7,8
4137,2023-01-07,PAM,brawlBall,Sneaky Fields,0,1,0,1
4138,2023-01-06,PAM,heist,Tornado Ring,0,3,1,4
4139,2023-01-06,PAM,gemGrab,Undermine,0,1,0,1
4140,2023-01-06,PAM,gemGrab,Deep Diner,0,1,2,3
4141,2023-01-06,PAM,brawlBall,Sneaky Fields,0,2,6,8
4142,2023-01-06,PAM,bounty,Dry Season,0,1,0,1
4143,2023-01-05,PAM,knockout,Out in the Open,0,1,0,1
4144,2023-01-05,PAM,hotZone,Split,0,3,0,3
4145,2023-01-05,PAM,heist,Kaboom Canyon,0,2,0,2
4146,2023-01-05,PAM,gemGrab,Undermine,0,10,5,15
4147,2023-01-05,PAM,gemGrab,Gem Fort,0,3,9,12
4148,2023-01-05,PAM,brawlBall,Pinhole Punt,0,23,42,65
4149,2023-01-04,PAM,knockout,Goldarm Gulch,0,1,0,1
4150,2023-01-04,PAM,hotZone,Parallel Plays,0,3,5,8
4151,2023-01-04,PAM,heist,Kaboom Canyon,0,1,0,1
4152,2023-01-04,PAM,gemGrab,Gem Fort,0,2,9,11
4153,2023-01-04,PAM,gemGrab,Crystal Arcade,0,2,0,2
4154,2023-01-04,PAM,brawlBall,Sunny Soccer,1,10,12,23
4155,2023-01-04,PAM,bounty,Shooting Star,0,4,1,5
4156,2023-01-03,PAM,knockout,Goldarm Gulch,0,1,0,1
4157,2023-01-03,PAM,hotZone,Parallel Plays,0,5,8,13
4158,2023-01-03,PAM,heist,Pit Stop,0,1,0,1
4159,2023-01-03,PAM,gemGrab,Minecart Madness,0,1,2,3
4160,2023-01-03,PAM,gemGrab,Crystal Arcade,0,6,0,6
4161,2023-01-03,PAM,brawlBall,Center Stage,0,2,0,2
4162,2023-01-03,PAM,brawlBall,Beach Ball,1,6,4,11
4163,2023-01-03,PAM,bounty,Hideout,0,1,0,1
4164,2023-01-02,PAM,knockout,Belle's Rock,0,1,0,1
4165,2023-01-02,PAM,hotZone,Quarter Pounder,0,11,7,18
4166,2023-01-02,PAM,gemGrab,Minecart Madness,0,9,10,19
4167,2023-01-02,PAM,gemGrab,Double Swoosh,0,8,7,15
4168,2023-01-02,PAM,brawlBall,Center Stage,0,12,8,20
4169,2023-01-02,PAM,brawlBall,Backyard Bowl,0,2,2,4
4170,2023-01-02,PAM,bounty,Hideout,0,1,2,3
4171,2023-01-01,PAM,hotZone,Quarter Pounder,0,4,3,7
4172,2023-01-01,PAM,heist,Bridge Too Far,0,1,0,1
4173,2023-01-01,PAM,gemGrab,Double Swoosh,0,5,2,7
4174,2023-01-01,PAM,brawlBall,Backyard Bowl,0,12,9,21
4175,2022-12-31,PAM,hotZone,Controller Chaos,0,2,3,5
4176,2022-12-31,PAM,gemGrab,Deep Diner,0,2,0,2
4177,2022-12-31,PAM,brawlBall,Super Beach,0,0,1,1
4178,2022-12-31,PAM,bounty,Canal Grande,0,2,2,4
4179,2022-12-30,PAM,hotZone,Controller Chaos,0,1,3,4
4180,2022-12-30,PAM,gemGrab,Deep Diner,0,1,1,2
4181,2022-12-30,PAM,brawlBall,Sneaky Fields,0,1,2,3
4182,2022-12-29,PAM,hotZone,Controller Chaos,0,1,0,1
4183,2022-12-29,PAM,heist,Kaboom Canyon,0,0,1,1
4184,2022-12-29,PAM,gemGrab,Undermine,0,0,8,8
4185,2022-12-29,PAM,brawlBall,Pinhole Punt,0,1,0,1
4186,2022-12-28,PAM,hotZone,Open Zone,0,0,1,1
4187,2022-12-27,PAM,hotZone,Controller Chaos,0,0,1,1
4188,2022-12-27,PAM,brawlBall,Beach Ball,0,2,0,2
4189,2022-12-26,PAM,hotZone,Controller Chaos,0,1,0,1
4190,2022-12-26,PAM,heist,Kaboom Canyon,0,0,1,1
4191,2022-12-26,PAM,gemGrab,Minecart Madness,0,1,0,1
4192,2022-12-25,PAM,brawlBall,Backyard Bowl,0,1,1,2
4193,2022-12-22,PAM,brawlBall,Pinhole Punt,0,0,5,5
4194,2022-12-20,PAM,brawlBall,Beach Ball,0,0,1,1
4195,2022-12-16,PAM,brawlBall,Sneaky Fields,0,1,0,1
4196,2022-12-13,PAM,hotZone,Dueling Beetles,0,0,1,1
4197,2022-12-13,PAM,gemGrab,Crystal Arcade,0,1,0,1
4198,2022-11-07,PAM,hotZone,Quarter Pounder,0,1,0,1
4199,2022-10-30,PAM,brawlBall,Beach Ball,0,1,0,1
4200,2022-10-15,PAM,hotZone,Ring of Fire,0,0,2,2
4201,2022-10-15,PAM,gemGrab,Hard Rock Mine,0,0,1,1
4202,2023-01-30,OTIS,knockout,Belle's Rock,0,43,51,94
4203,2023-01-30,OTIS,hotZone,Quarter Pounder,1,63,160,224
4204,2023-01-30,OTIS,heist,Pit Stop,0,14,10,24
4205,2023-01-30,OTIS,gemGrab,Minecart Madness,0,43,52,95
4206,2023-01-30,OTIS,gemGrab,Double Swoosh,0,42,66,108
4207,2023-01-30,OTIS,brawlBall,Center Stage,12,285,463,760
4208,2023-01-30,OTIS,brawlBall,Backyard Bowl,2,40,46,88
4209,2023-01-30,OTIS,bounty,Hideout,0,3,1,4
4210,2023-01-29,OTIS,knockout,Belle's Rock,1,51,51,103
4211,2023-01-29,OTIS,hotZone,Quarter Pounder,1,42,65,108
4212,2023-01-29,OTIS,heist,Bridge Too Far,0,40,51,91
4213,2023-01-29,OTIS,gemGrab,Hard Rock Mine,0,13,24,37
4214,2023-01-29,OTIS,gemGrab,Double Swoosh,0,93,99,192
4215,2023-01-29,OTIS,brawlBall,Super Beach,0,9,13,22
4216,2023-01-29,OTIS,brawlBall,Backyard Bowl,29,359,410,798
4217,2023-01-29,OTIS,bounty,Canal Grande,0,16,21,37
4218,2023-01-28,OTIS,knockout,Flaring Phoenix,0,19,12,31
4219,2023-01-28,OTIS,hotZone,Controller Chaos,0,89,138,227
4220,2023-01-28,OTIS,heist,Bridge Too Far,0,89,83,172
4221,2023-01-28,OTIS,gemGrab,Hard Rock Mine,0,95,134,229
4222,2023-01-28,OTIS,gemGrab,Deep Diner,0,19,22,41
4223,2023-01-28,OTIS,brawlBall,Super Beach,10,281,410,701
4224,2023-01-28,OTIS,brawlBall,Sneaky Fields,0,18,15,33
4225,2023-01-28,OTIS,bounty,Canal Grande,0,37,27,64
4226,2023-01-27,OTIS,knockout,Flaring Phoenix,0,17,21,38
4227,2023-01-27,OTIS,hotZone,Controller Chaos,0,17,30,47
4228,2023-01-27,OTIS,heist,Hot Potato,0,5,12,17
4229,2023-01-27,OTIS,gemGrab,Undermine,0,5,6,11
4230,2023-01-27,OTIS,gemGrab,Deep Diner,0,24,27,51
4231,2023-01-27,OTIS,brawlBall,Sneaky Fields,2,132,163,297
4232,2023-01-27,OTIS,brawlBall,Pinhole Punt,0,14,9,23
4233,2023-01-27,OTIS,bounty,Temple Ruins,0,14,43,57
4234,2023-01-26,OTIS,knockout,Riverside,0,34,15,49
4235,2023-01-26,OTIS,hotZone,Open Zone,0,50,67,117
4236,2023-01-26,OTIS,heist,Hot Potato,0,19,17,36
4237,2023-01-26,OTIS,gemGrab,Undermine,0,46,67,113
4238,2023-01-26,OTIS,gemGrab,Gem Fort,0,29,32,61
4239,2023-01-26,OTIS,brawlBall,Sunny Soccer,0,11,31,42
4240,2023-01-26,OTIS,brawlBall,Pinhole Punt,18,381,597,996
4241,2023-01-26,OTIS,bounty,Temple Ruins,0,22,37,59
4242,2023-01-25,OTIS,knockout,Riverside,0,5,11,16
4243,2023-01-25,OTIS,hotZone,Open Zone,0,13,22,35
4244,2023-01-25,OTIS,heist,Safe Zone,0,18,27,45
4245,2023-01-25,OTIS,gemGrab,Gem Fort,0,23,60,83
4246,2023-01-25,OTIS,gemGrab,Crystal Arcade,0,51,90,141
4247,2023-01-25,OTIS,brawlBall,Sunny Soccer,12,210,323,545
4248,2023-01-25,OTIS,brawlBall,Beach Ball,3,47,70,120
4249,2023-01-25,OTIS,bounty,Excel,0,16,12,28
4250,2023-01-24,OTIS,knockout,New Perspective,0,36,34,70
4251,2023-01-24,OTIS,hotZone,Dueling Beetles,0,26,31,57
4252,2023-01-24,OTIS,heist,Safe Zone,0,25,18,43
4253,2023-01-24,OTIS,gemGrab,Minecart Madness,0,16,22,38
4254,2023-01-24,OTIS,gemGrab,Crystal Arcade,0,57,98,155
4255,2023-01-24,OTIS,brawlBall,Center Stage,2,39,45,86
4256,2023-01-24,OTIS,brawlBall,Beach Ball,14,372,477,863
4257,2023-01-24,OTIS,bounty,Excel,0,31,19,50
4258,2023-01-23,OTIS,knockout,New Perspective,0,52,65,117
4259,2023-01-23,OTIS,hotZone,Dueling Beetles,0,91,83,174
4260,2023-01-23,OTIS,heist,Snaked Assault,0,36,44,80
4261,2023-01-23,OTIS,gemGrab,Minecart Madness,0,78,143,221
4262,2023-01-23,OTIS,gemGrab,Double Swoosh,0,36,39,75
4263,2023-01-23,OTIS,brawlBall,Center Stage,12,524,789,1325
4264,2023-01-23,OTIS,brawlBall,Backyard Bowl,1,25,32,58
4265,2023-01-23,OTIS,bounty,Layer Cake,0,24,41,65
4266,2023-01-22,OTIS,knockout,X Marks the Spot,0,12,14,26
4267,2023-01-22,OTIS,hotZone,Ring of Fire,0,17,23,40
4268,2023-01-22,OTIS,heist,Snaked Assault,0,21,26,47
4269,2023-01-22,OTIS,gemGrab,Hard Rock Mine,0,30,52,82
4270,2023-01-22,OTIS,gemGrab,Double Swoosh,0,42,78,120
4271,2023-01-22,OTIS,brawlBall,Super Beach,2,35,63,100
4272,2023-01-22,OTIS,brawlBall,Backyard Bowl,19,179,267,465
4273,2023-01-22,OTIS,bounty,Layer Cake,0,13,8,21
4274,2023-01-21,OTIS,knockout,X Marks the Spot,1,55,76,132
4275,2023-01-21,OTIS,hotZone,Ring of Fire,0,74,93,167
4276,2023-01-21,OTIS,heist,Tornado Ring,1,19,23,43
4277,2023-01-21,OTIS,gemGrab,Hard Rock Mine,0,87,91,178
4278,2023-01-21,OTIS,gemGrab,Deep Diner,0,17,32,49
4279,2023-01-21,OTIS,brawlBall,Super Beach,22,529,791,1342
4280,2023-01-21,OTIS,brawlBall,Sneaky Fields,0,9,14,23
4281,2023-01-21,OTIS,bounty,Dry Season,0,33,47,80
4282,2023-01-20,OTIS,knockout,Out in the Open,0,73,90,163
4283,2023-01-20,OTIS,hotZone,Split,0,10,17,27
4284,2023-01-20,OTIS,heist,Tornado Ring,0,20,22,42
4285,2023-01-20,OTIS,gemGrab,Undermine,0,20,30,50
4286,2023-01-20,OTIS,gemGrab,Deep Diner,0,85,113,198
4287,2023-01-20,OTIS,brawlBall,Sneaky Fields,26,377,557,960
4288,2023-01-20,OTIS,brawlBall,Pinhole Punt,0,22,46,68
4289,2023-01-20,OTIS,bounty,Dry Season,0,30,35,65
4290,2023-01-19,OTIS,knockout,Out in the Open,0,83,91,174
4291,2023-01-19,OTIS,hotZone,Split,0,14,11,25
4292,2023-01-19,OTIS,heist,Kaboom Canyon,0,17,13,30
4293,2023-01-19,OTIS,gemGrab,Undermine,0,60,69,129
4294,2023-01-19,OTIS,gemGrab,Gem Fort,0,15,4,19
4295,2023-01-19,OTIS,brawlBall,Sunny Soccer,0,3,6,9
4296,2023-01-19,OTIS,brawlBall,Pinhole Punt,25,433,624,1082
4297,2023-01-19,OTIS,bounty,Shooting Star,0,16,17,33
4298,2023-01-18,OTIS,knockout,Goldarm Gulch,0,6,6,12
4299,2023-01-18,OTIS,hotZone,Parallel Plays,0,3,10,13
4300,2023-01-18,OTIS,heist,Kaboom Canyon,0,8,14,22
4301,2023-01-18,OTIS,gemGrab,Gem Fort,0,23,36,59
4302,2023-01-18,OTIS,gemGrab,Crystal Arcade,0,5,5,10
4303,2023-01-18,OTIS,brawlBall,Sunny Soccer,3,112,167,282
4304,2023-01-18,OTIS,brawlBall,Beach Ball,0,0,2,2
4305,2023-01-18,OTIS,bounty,Shooting Star,0,10,4,14
4306,2023-01-17,OTIS,knockout,Goldarm Gulch,0,14,13,27
4307,2023-01-17,OTIS,hotZone,Parallel Plays,0,10,4,14
4308,2023-01-17,OTIS,heist,Pit Stop,0,5,2,7
4309,2023-01-17,OTIS,gemGrab,Minecart Madness,0,1,1,2
4310,2023-01-17,OTIS,gemGrab,Crystal Arcade,0,13,19,32
4311,2023-01-17,OTIS,brawlBall,Center Stage,0,1,1,2
4312,2023-01-17,OTIS,brawlBall,Beach Ball,2,27,51,80
4313,2023-01-17,OTIS,bounty,Hideout,0,0,1,1
4314,2023-01-16,OTIS,knockout,Belle's Rock,0,4,2,6
4315,2023-01-16,OTIS,hotZone,Quarter Pounder,0,6,22,28
4316,2023-01-16,OTIS,heist,Pit Stop,0,8,3,11
4317,2023-01-16,OTIS,gemGrab,Minecart Madness,0,6,9,15
4318,2023-01-16,OTIS,gemGrab,Double Swoosh,0,1,6,7
4319,2023-01-16,OTIS,brawlBall,Center Stage,3,33,65,101
4320,2023-01-16,OTIS,brawlBall,Backyard Bowl,0,3,6,9
4321,2023-01-15,OTIS,knockout,Belle's Rock,0,4,5,9
4322,2023-01-15,OTIS,hotZone,Quarter Pounder,0,18,4,22
4323,2023-01-15,OTIS,heist,Bridge Too Far,0,6,9,15
4324,2023-01-15,OTIS,gemGrab,Hard Rock Mine,0,2,11,13
4325,2023-01-15,OTIS,gemGrab,Double Swoosh,0,16,47,63
4326,2023-01-15,OTIS,brawlBall,Super Beach,0,4,9,13
4327,2023-01-15,OTIS,brawlBall,Backyard Bowl,0,42,74,116
4328,2023-01-15,OTIS,bounty,Canal Grande,0,3,4,7
4329,2023-01-14,OTIS,knockout,Flaring Phoenix,0,3,4,7
4330,2023-01-14,OTIS,hotZone,Controller Chaos,0,29,64,93
4331,2023-01-14,OTIS,heist,Bridge Too Far,0,15,24,39
4332,2023-01-14,OTIS,gemGrab,Hard Rock Mine,0,5,4,9
4333,2023-01-14,OTIS,gemGrab,Deep Diner,0,5,20,25
4334,2023-01-14,OTIS,brawlBall,Super Beach,2,27,43,72
4335,2023-01-14,OTIS,brawlBall,Sneaky Fields,2,9,35,46
4336,2023-01-14,OTIS,bounty,Canal Grande,0,2,1,3
4337,2023-01-13,OTIS,knockout,Flaring Phoenix,0,2,0,2
4338,2023-01-13,OTIS,hotZone,Controller Chaos,0,14,27,41
4339,2023-01-13,OTIS,heist,Hot Potato,0,3,8,11
4340,2023-01-13,OTIS,gemGrab,Deep Diner,0,6,23,29
4341,2023-01-13,OTIS,brawlBall,Sneaky Fields,1,47,40,88
4342,2023-01-13,OTIS,brawlBall,Pinhole Punt,0,2,1,3
4343,2023-01-13,OTIS,bounty,Temple Ruins,0,1,2,3
4344,2023-01-12,OTIS,knockout,Riverside,0,1,4,5
4345,2023-01-12,OTIS,hotZone,Open Zone,0,9,7,16
4346,2023-01-12,OTIS,heist,Hot Potato,0,2,0,2
4347,2023-01-12,OTIS,gemGrab,Undermine,0,4,6,10
4348,2023-01-12,OTIS,brawlBall,Sunny Soccer,0,3,6,9
4349,2023-01-12,OTIS,brawlBall,Pinhole Punt,1,16,9,26
4350,2023-01-11,OTIS,hotZone,Open Zone,0,1,0,1
4351,2023-01-11,OTIS,gemGrab,Gem Fort,0,1,1,2
4352,2023-01-11,OTIS,brawlBall,Sunny Soccer,0,5,22,27
4353,2023-01-10,OTIS,hotZone,Dueling Beetles,0,10,49,59
4354,2023-01-10,OTIS,heist,Safe Zone,0,3,7,10
4355,2023-01-10,OTIS,gemGrab,Minecart Madness,0,5,5,10
4356,2023-01-10,OTIS,gemGrab,Crystal Arcade,0,10,13,23
4357,2023-01-10,OTIS,brawlBall,Center Stage,0,6,3,9
4358,2023-01-10,OTIS,brawlBall,Beach Ball,0,29,42,71
4359,2023-01-09,OTIS,knockout,New Perspective,0,1,2,3
4360,2023-01-09,OTIS,hotZone,Dueling Beetles,0,4,1,5
4361,2023-01-09,OTIS,heist,Snaked Assault,0,3,2,5
4362,2023-01-09,OTIS,gemGrab,Minecart Madness,1,10,25,36
4363,2023-01-09,OTIS,gemGrab,Double Swoosh,0,9,17,26
4364,2023-01-09,OTIS,brawlBall,Center Stage,0,32,36,68
4365,2023-01-09,OTIS,bounty,Layer Cake,0,6,23,29
4366,2023-01-08,OTIS,knockout,X Marks the Spot,0,5,17,22
4367,2023-01-08,OTIS,hotZone,Ring of Fire,0,12,18,30
4368,2023-01-08,OTIS,heist,Snaked Assault,0,2,5,7
4369,2023-01-08,OTIS,gemGrab,Hard Rock Mine,0,1,0,1
4370,2023-01-08,OTIS,gemGrab,Double Swoosh,0,5,11,16
4371,2023-01-08,OTIS,brawlBall,Super Beach,0,7,19,26
4372,2023-01-08,OTIS,brawlBall,Backyard Bowl,2,25,40,67
4373,2023-01-07,OTIS,hotZone,Ring of Fire,0,8,9,17
4374,2023-01-07,OTIS,heist,Tornado Ring,0,2,0,2
4375,2023-01-07,OTIS,gemGrab,Hard Rock Mine,0,7,22,29
4376,2023-01-07,OTIS,gemGrab,Deep Diner,0,2,0,2
4377,2023-01-07,OTIS,brawlBall,Super Beach,0,11,8,19
4378,2023-01-07,OTIS,brawlBall,Sneaky Fields,0,1,9,10
4379,2023-01-07,OTIS,bounty,Dry Season,0,7,20,27
4380,2023-01-06,OTIS,knockout,Out in the Open,0,4,0,4
4381,2023-01-06,OTIS,hotZone,Split,0,1,2,3
4382,2023-01-06,OTIS,heist,Tornado Ring,0,6,0,6
4383,2023-01-06,OTIS,gemGrab,Undermine,0,2,1,3
4384,2023-01-06,OTIS,gemGrab,Deep Diner,0,6,2,8
4385,2023-01-06,OTIS,brawlBall,Sneaky Fields,1,40,104,145
4386,2023-01-06,OTIS,brawlBall,Pinhole Punt,0,2,1,3
4387,2023-01-06,OTIS,bounty,Dry Season,0,4,7,11
4388,2023-01-05,OTIS,knockout,Out in the Open,0,11,16,27
4389,2023-01-05,OTIS,hotZone,Split,0,5,16,21
4390,2023-01-05,OTIS,heist,Kaboom Canyon,0,1,6,7
4391,2023-01-05,OTIS,gemGrab,Undermine,0,6,0,6
4392,2023-01-05,OTIS,brawlBall,Pinhole Punt,4,47,119,170
4393,2023-01-04,OTIS,knockout,Goldarm Gulch,0,4,5,9
4394,2023-01-04,OTIS,hotZone,Parallel Plays,0,7,7,14
4395,2023-01-04,OTIS,heist,Kaboom Canyon,0,8,4,12
4396,2023-01-04,OTIS,gemGrab,Gem Fort,0,6,7,13
4397,2023-01-04,OTIS,gemGrab,Crystal Arcade,0,5,5,10
4398,2023-01-04,OTIS,brawlBall,Sunny Soccer,3,43,75,121
4399,2023-01-04,OTIS,bounty,Shooting Star,0,3,0,3
4400,2023-01-03,OTIS,knockout,Goldarm Gulch,0,7,14,21
4401,2023-01-03,OTIS,hotZone,Parallel Plays,0,4,7,11
4402,2023-01-03,OTIS,heist,Pit Stop,0,3,0,3
4403,2023-01-03,OTIS,gemGrab,Minecart Madness,0,1,0,1
4404,2023-01-03,OTIS,gemGrab,Crystal Arcade,0,3,5,8
4405,2023-01-03,OTIS,brawlBall,Center Stage,0,1,4,5
4406,2023-01-03,OTIS,brawlBall,Beach Ball,3,44,109,156
4407,2023-01-03,OTIS,bounty,Hideout,0,3,0,3
4408,2023-01-02,OTIS,knockout,Belle's Rock,0,7,3,10
4409,2023-01-02,OTIS,hotZone,Quarter Pounder,0,10,31,41
4410,2023-01-02,OTIS,heist,Pit Stop,0,0,2,2
4411,2023-01-02,OTIS,gemGrab,Minecart Madness,0,7,62,69
4412,2023-01-02,OTIS,gemGrab,Double Swoosh,0,8,4,12
4413,2023-01-02,OTIS,brawlBall,Center Stage,3,45,63,111
4414,2023-01-02,OTIS,brawlBall,Backyard Bowl,0,4,8,12
4415,2023-01-02,OTIS,bounty,Hideout,0,3,4,7
4416,2023-01-01,OTIS,knockout,Belle's Rock,0,3,2,5
4417,2023-01-01,OTIS,hotZone,Quarter Pounder,0,6,9,15
4418,2023-01-01,OTIS,heist,Bridge Too Far,0,6,2,8
4419,2023-01-01,OTIS,gemGrab,Double Swoosh,0,6,6,12
4420,2023-01-01,OTIS,brawlBall,Backyard Bowl,0,14,38,52
4421,2023-01-01,OTIS,bounty,Canal Grande,0,0,2,2
4422,2022-12-31,OTIS,hotZone,Controller Chaos,0,2,14,16
4423,2022-12-31,OTIS,heist,Bridge Too Far,0,2,0,2
4424,2022-12-31,OTIS,gemGrab,Minecart Madness,0,0,1,1
4425,2022-12-31,OTIS,brawlBall,Super Beach,0,5,0,5
4426,2022-12-31,OTIS,brawlBall,Sneaky Fields,0,0,1,1
4427,2022-12-31,OTIS,bounty,Canal Grande,0,1,0,1
4428,2022-12-30,OTIS,heist,Kaboom Canyon,0,0,1,1
4429,2022-12-30,OTIS,gemGrab,Deep Diner,0,1,3,4
4430,2022-12-30,OTIS,brawlBall,Sneaky Fields,0,4,5,9
4431,2022-12-29,OTIS,hotZone,Open Zone,0,5,3,8
4432,2022-12-29,OTIS,heist,Hot Potato,0,1,5,6
4433,2022-12-29,OTIS,gemGrab,Minecart Madness,0,0,1,1
4434,2022-12-29,OTIS,brawlBall,Pinhole Punt,0,1,1,2
4435,2022-12-28,OTIS,hotZone,Open Zone,0,7,13,20
4436,2022-12-27,OTIS,hotZone,Dueling Beetles,0,1,0,1
4437,2022-12-27,OTIS,brawlBall,Beach Ball,0,0,2,2
4438,2022-12-26,OTIS,gemGrab,Minecart Madness,0,0,1,1
4439,2022-12-25,OTIS,brawlBall,Backyard Bowl,0,1,0,1
4440,2022-12-22,OTIS,gemGrab,Gem Fort,0,1,12,13
4441,2022-12-22,OTIS,brawlBall,Pinhole Punt,0,1,8,9
4442,2022-12-21,OTIS,brawlBall,Sunny Soccer,0,0,1,1
4443,2022-12-19,OTIS,brawlBall,Center Stage,0,2,1,3
4444,2022-12-16,OTIS,brawlBall,Sneaky Fields,0,3,2,5
4445,2022-12-13,OTIS,gemGrab,Crystal Arcade,0,0,1,1
4446,2022-12-11,OTIS,brawlBall,Backyard Bowl,0,1,0,1
4447,2022-11-07,OTIS,hotZone,Quarter Pounder,0,3,1,4
4448,2022-10-26,OTIS,brawlBall,Sunny Soccer,0,1,2,3
4449,2022-10-15,OTIS,gemGrab,Hard Rock Mine,0,0,1,1
4450,2022-10-15,OTIS,bounty,Dry Season,0,0,1,1
4451,2022-10-10,OTIS,knockout,Belle's Rock,0,1,0,1
4452,2023-01-30,NITA,knockout,Belle's Rock,0,15,4,19
4453,2023-01-30,NITA,hotZone,Quarter Pounder,0,179,69,248
4454,2023-01-30,NITA,heist,Pit Stop,0,514,382,896
4455,2023-01-30,NITA,gemGrab,Minecart Madness,0,35,15,50
4456,2023-01-30,NITA,gemGrab,Double Swoosh,0,140,110,250
4457,2023-01-30,NITA,brawlBall,Center Stage,15,605,677,1297
4458,2023-01-30,NITA,brawlBall,Backyard Bowl,0,22,14,36
4459,2023-01-30,NITA,bounty,Hideout,0,2,3,5
4460,2023-01-29,NITA,knockout,Belle's Rock,0,17,9,26
4461,2023-01-29,NITA,hotZone,Quarter Pounder,0,171,135,306
4462,2023-01-29,NITA,heist,Bridge Too Far,0,62,18,80
4463,2023-01-29,NITA,gemGrab,Hard Rock Mine,0,40,52,92
4464,2023-01-29,NITA,gemGrab,Double Swoosh,0,279,306,585
4465,2023-01-29,NITA,brawlBall,Super Beach,0,12,13,25
4466,2023-01-29,NITA,brawlBall,Backyard Bowl,5,224,146,375
4467,2023-01-29,NITA,bounty,Canal Grande,0,27,17,44
4468,2023-01-28,NITA,knockout,Flaring Phoenix,0,23,10,33
4469,2023-01-28,NITA,hotZone,Controller Chaos,0,249,267,516
4470,2023-01-28,NITA,heist,Bridge Too Far,0,129,53,182
4471,2023-01-28,NITA,gemGrab,Hard Rock Mine,0,176,156,332
4472,2023-01-28,NITA,gemGrab,Deep Diner,0,44,43,87
4473,2023-01-28,NITA,brawlBall,Super Beach,28,1115,1194,2337
4474,2023-01-28,NITA,brawlBall,Sneaky Fields,1,82,114,197
4475,2023-01-28,NITA,bounty,Canal Grande,0,90,105,195
4476,2023-01-27,NITA,knockout,Flaring Phoenix,0,2,4,6
4477,2023-01-27,NITA,hotZone,Controller Chaos,0,56,70,126
4478,2023-01-27,NITA,heist,Hot Potato,0,151,185,336
4479,2023-01-27,NITA,gemGrab,Undermine,0,10,5,15
4480,2023-01-27,NITA,gemGrab,Deep Diner,0,53,38,91
4481,2023-01-27,NITA,brawlBall,Sneaky Fields,12,414,490,916
4482,2023-01-27,NITA,brawlBall,Pinhole Punt,0,5,3,8
4483,2023-01-27,NITA,bounty,Temple Ruins,0,7,1,8
4484,2023-01-26,NITA,knockout,Riverside,0,18,6,24
4485,2023-01-26,NITA,hotZone,Open Zone,0,39,16,55
4486,2023-01-26,NITA,heist,Hot Potato,1,637,639,1277
4487,2023-01-26,NITA,gemGrab,Undermine,0,128,179,307
4488,2023-01-26,NITA,gemGrab,Gem Fort,0,49,41,90
4489,2023-01-26,NITA,brawlBall,Sunny Soccer,0,63,77,140
4490,2023-01-26,NITA,brawlBall,Pinhole Punt,9,428,542,979
4491,2023-01-26,NITA,bounty,Temple Ruins,0,16,7,23
4492,2023-01-25,NITA,knockout,Riverside,0,2,0,2
4493,2023-01-25,NITA,hotZone,Open Zone,0,18,8,26
4494,2023-01-25,NITA,heist,Safe Zone,0,88,39,127
4495,2023-01-25,NITA,gemGrab,Gem Fort,0,74,89,163
4496,2023-01-25,NITA,gemGrab,Crystal Arcade,0,113,143,256
4497,2023-01-25,NITA,brawlBall,Sunny Soccer,11,488,503,1002
4498,2023-01-25,NITA,brawlBall,Beach Ball,2,57,49,108
4499,2023-01-25,NITA,bounty,Excel,0,12,13,25
4500,2023-01-24,NITA,knockout,New Perspective,0,9,6,15
4501,2023-01-24,NITA,hotZone,Dueling Beetles,0,83,40,123
4502,2023-01-24,NITA,heist,Safe Zone,0,112,68,180
4503,2023-01-24,NITA,gemGrab,Minecart Madness,0,7,5,12
4504,2023-01-24,NITA,gemGrab,Crystal Arcade,0,339,404,743
4505,2023-01-24,NITA,brawlBall,Center Stage,1,81,78,160
4506,2023-01-24,NITA,brawlBall,Beach Ball,18,604,639,1261
4507,2023-01-24,NITA,bounty,Excel,0,11,6,17
4508,2023-01-23,NITA,knockout,New Perspective,0,30,15,45
4509,2023-01-23,NITA,hotZone,Dueling Beetles,0,140,90,230
4510,2023-01-23,NITA,heist,Snaked Assault,1,1010,1151,2162
4511,2023-01-23,NITA,gemGrab,Minecart Madness,0,61,47,108
4512,2023-01-23,NITA,gemGrab,Double Swoosh,0,92,98,190
4513,2023-01-23,NITA,brawlBall,Center Stage,24,1041,1060,2125
4514,2023-01-23,NITA,brawlBall,Backyard Bowl,0,6,6,12
4515,2023-01-23,NITA,bounty,Layer Cake,0,16,6,22
4516,2023-01-22,NITA,knockout,X Marks the Spot,0,10,3,13
4517,2023-01-22,NITA,hotZone,Ring of Fire,0,43,40,83
4518,2023-01-22,NITA,heist,Snaked Assault,3,531,584,1118
4519,2023-01-22,NITA,gemGrab,Hard Rock Mine,0,67,95,162
4520,2023-01-22,NITA,gemGrab,Double Swoosh,0,145,134,279
4521,2023-01-22,NITA,brawlBall,Super Beach,3,107,112,222
4522,2023-01-22,NITA,brawlBall,Backyard Bowl,1,96,90,187
4523,2023-01-22,NITA,bounty,Layer Cake,0,13,5,18
4524,2023-01-21,NITA,knockout,X Marks the Spot,0,28,6,34
4525,2023-01-21,NITA,hotZone,Ring of Fire,0,91,59,150
4526,2023-01-21,NITA,heist,Tornado Ring,2,750,932,1684
4527,2023-01-21,NITA,gemGrab,Hard Rock Mine,0,277,266,543
4528,2023-01-21,NITA,gemGrab,Deep Diner,0,31,54,85
4529,2023-01-21,NITA,brawlBall,Super Beach,48,1367,1599,3014
4530,2023-01-21,NITA,brawlBall,Sneaky Fields,2,70,98,170
4531,2023-01-21,NITA,bounty,Dry Season,0,5,12,17
4532,2023-01-20,NITA,knockout,Out in the Open,0,20,9,29
4533,2023-01-20,NITA,hotZone,Split,0,109,52,161
4534,2023-01-20,NITA,heist,Tornado Ring,6,841,883,1730
4535,2023-01-20,NITA,gemGrab,Undermine,0,51,57,108
4536,2023-01-20,NITA,gemGrab,Deep Diner,0,190,222,412
4537,2023-01-20,NITA,brawlBall,Sneaky Fields,42,1190,1412,2644
4538,2023-01-20,NITA,brawlBall,Pinhole Punt,2,16,13,31
4539,2023-01-20,NITA,bounty,Dry Season,0,7,4,11
4540,2023-01-19,NITA,knockout,Out in the Open,0,25,6,31
4541,2023-01-19,NITA,hotZone,Split,0,148,116,264
4542,2023-01-19,NITA,heist,Kaboom Canyon,0,126,93,219
4543,2023-01-19,NITA,gemGrab,Undermine,0,177,216,393
4544,2023-01-19,NITA,gemGrab,Gem Fort,0,32,36,68
4545,2023-01-19,NITA,brawlBall,Sunny Soccer,0,18,15,33
4546,2023-01-19,NITA,brawlBall,Pinhole Punt,19,538,526,1083
4547,2023-01-19,NITA,bounty,Shooting Star,0,5,1,6
4548,2023-01-18,NITA,knockout,Goldarm Gulch,0,4,3,7
4549,2023-01-18,NITA,hotZone,Parallel Plays,0,29,21,50
4550,2023-01-18,NITA,heist,Kaboom Canyon,0,41,21,62
4551,2023-01-18,NITA,gemGrab,Gem Fort,0,33,33,66
4552,2023-01-18,NITA,gemGrab,Crystal Arcade,0,7,15,22
4553,2023-01-18,NITA,brawlBall,Sunny Soccer,4,217,224,445
4554,2023-01-18,NITA,brawlBall,Beach Ball,0,6,6,12
4555,2023-01-18,NITA,bounty,Shooting Star,0,1,1,2
4556,2023-01-17,NITA,knockout,Goldarm Gulch,0,7,3,10
4557,2023-01-17,NITA,hotZone,Parallel Plays,0,25,22,47
4558,2023-01-17,NITA,heist,Pit Stop,0,56,62,118
4559,2023-01-17,NITA,gemGrab,Crystal Arcade,0,19,22,41
4560,2023-01-17,NITA,brawlBall,Center Stage,0,2,2,4
4561,2023-01-17,NITA,brawlBall,Beach Ball,0,56,70,126
4562,2023-01-16,NITA,knockout,Belle's Rock,0,1,0,1
4563,2023-01-16,NITA,hotZone,Quarter Pounder,0,15,8,23
4564,2023-01-16,NITA,heist,Pit Stop,0,173,190,363
4565,2023-01-16,NITA,gemGrab,Minecart Madness,0,4,3,7
4566,2023-01-16,NITA,gemGrab,Double Swoosh,0,5,5,10
4567,2023-01-16,NITA,brawlBall,Center Stage,2,88,117,207
4568,2023-01-16,NITA,brawlBall,Backyard Bowl,0,2,0,2
4569,2023-01-15,NITA,knockout,Belle's Rock,0,1,0,1
4570,2023-01-15,NITA,hotZone,Quarter Pounder,0,68,36,104
4571,2023-01-15,NITA,heist,Bridge Too Far,0,10,2,12
4572,2023-01-15,NITA,gemGrab,Hard Rock Mine,0,15,5,20
4573,2023-01-15,NITA,gemGrab,Double Swoosh,0,44,40,84
4574,2023-01-15,NITA,brawlBall,Super Beach,0,14,9,23
4575,2023-01-15,NITA,brawlBall,Backyard Bowl,0,33,18,51
4576,2023-01-15,NITA,bounty,Canal Grande,0,8,1,9
4577,2023-01-14,NITA,knockout,Flaring Phoenix,0,1,0,1
4578,2023-01-14,NITA,hotZone,Controller Chaos,0,76,36,112
4579,2023-01-14,NITA,heist,Bridge Too Far,0,21,4,25
4580,2023-01-14,NITA,gemGrab,Hard Rock Mine,0,9,4,13
4581,2023-01-14,NITA,gemGrab,Deep Diner,0,13,16,29
4582,2023-01-14,NITA,brawlBall,Super Beach,1,98,105,204
4583,2023-01-14,NITA,brawlBall,Sneaky Fields,0,21,27,48
4584,2023-01-14,NITA,bounty,Canal Grande,0,6,2,8
4585,2023-01-13,NITA,knockout,Flaring Phoenix,0,4,0,4
4586,2023-01-13,NITA,hotZone,Controller Chaos,0,138,102,240
4587,2023-01-13,NITA,heist,Hot Potato,0,33,50,83
4588,2023-01-13,NITA,gemGrab,Deep Diner,0,9,7,16
4589,2023-01-13,NITA,brawlBall,Sneaky Fields,4,124,157,285
4590,2023-01-13,NITA,brawlBall,Pinhole Punt,1,0,0,1
4591,2023-01-13,NITA,bounty,Temple Ruins,0,3,0,3
4592,2023-01-12,NITA,hotZone,Open Zone,0,3,1,4
4593,2023-01-12,NITA,heist,Hot Potato,0,23,17,40
4594,2023-01-12,NITA,gemGrab,Undermine,0,10,11,21
4595,2023-01-12,NITA,gemGrab,Gem Fort,0,2,0,2
4596,2023-01-12,NITA,brawlBall,Sunny Soccer,0,2,2,4
4597,2023-01-12,NITA,brawlBall,Pinhole Punt,0,19,6,25
4598,2023-01-11,NITA,knockout,Riverside,0,1,0,1
4599,2023-01-11,NITA,hotZone,Open Zone,0,2,0,2
4600,2023-01-11,NITA,heist,Safe Zone,0,0,1,1
4601,2023-01-11,NITA,gemGrab,Gem Fort,0,8,3,11
4602,2023-01-11,NITA,brawlBall,Sunny Soccer,1,23,16,40
4603,2023-01-11,NITA,brawlBall,Beach Ball,0,0,1,1
4604,2023-01-11,NITA,bounty,Excel,0,3,2,5
4605,2023-01-10,NITA,hotZone,Dueling Beetles,0,21,3,24
4606,2023-01-10,NITA,heist,Safe Zone,0,9,1,10
4607,2023-01-10,NITA,gemGrab,Minecart Madness,0,2,0,2
4608,2023-01-10,NITA,gemGrab,Crystal Arcade,0,48,46,94
4609,2023-01-10,NITA,brawlBall,Center Stage,0,6,14,20
4610,2023-01-10,NITA,brawlBall,Beach Ball,1,44,85,130
4611,2023-01-09,NITA,knockout,New Perspective,0,1,0,1
4612,2023-01-09,NITA,hotZone,Dueling Beetles,0,11,2,13
4613,2023-01-09,NITA,heist,Snaked Assault,0,148,130,278
4614,2023-01-09,NITA,gemGrab,Minecart Madness,0,7,0,7
4615,2023-01-09,NITA,gemGrab,Double Swoosh,0,16,14,30
4616,2023-01-09,NITA,brawlBall,Center Stage,1,55,52,108
4617,2023-01-09,NITA,brawlBall,Backyard Bowl,0,3,0,3
4618,2023-01-09,NITA,bounty,Layer Cake,0,3,0,3
4619,2023-01-08,NITA,hotZone,Ring of Fire,0,11,1,12
4620,2023-01-08,NITA,heist,Snaked Assault,0,110,88,198
4621,2023-01-08,NITA,gemGrab,Hard Rock Mine,0,14,13,27
4622,2023-01-08,NITA,gemGrab,Double Swoosh,0,13,7,20
4623,2023-01-08,NITA,brawlBall,Super Beach,0,18,9,27
4624,2023-01-08,NITA,brawlBall,Backyard Bowl,0,16,5,21
4625,2023-01-08,NITA,bounty,Layer Cake,0,1,0,1
4626,2023-01-07,NITA,hotZone,Ring of Fire,0,4,0,4
4627,2023-01-07,NITA,heist,Tornado Ring,1,115,124,240
4628,2023-01-07,NITA,gemGrab,Hard Rock Mine,0,14,6,20
4629,2023-01-07,NITA,gemGrab,Deep Diner,0,21,27,48
4630,2023-01-07,NITA,brawlBall,Super Beach,2,52,45,99
4631,2023-01-07,NITA,brawlBall,Sneaky Fields,1,6,3,10
4632,2023-01-07,NITA,bounty,Dry Season,0,2,0,2
4633,2023-01-06,NITA,knockout,Out in the Open,0,1,0,1
4634,2023-01-06,NITA,hotZone,Split,0,19,4,23
4635,2023-01-06,NITA,heist,Tornado Ring,2,202,211,415
4636,2023-01-06,NITA,gemGrab,Undermine,0,5,0,5
4637,2023-01-06,NITA,gemGrab,Deep Diner,0,29,24,53
4638,2023-01-06,NITA,brawlBall,Sneaky Fields,0,121,136,257
4639,2023-01-06,NITA,brawlBall,Pinhole Punt,0,4,1,5
4640,2023-01-05,NITA,knockout,Out in the Open,0,2,0,2
4641,2023-01-05,NITA,hotZone,Split,0,32,11,43
4642,2023-01-05,NITA,heist,Kaboom Canyon,0,25,8,33
4643,2023-01-05,NITA,gemGrab,Undermine,0,15,20,35
4644,2023-01-05,NITA,gemGrab,Gem Fort,0,4,4,8
4645,2023-01-05,NITA,brawlBall,Sunny Soccer,0,0,1,1
4646,2023-01-05,NITA,brawlBall,Pinhole Punt,1,47,32,80
4647,2023-01-04,NITA,knockout,Goldarm Gulch,0,2,0,2
4648,2023-01-04,NITA,hotZone,Parallel Plays,0,15,8,23
4649,2023-01-04,NITA,heist,Kaboom Canyon,0,36,6,42
4650,2023-01-04,NITA,gemGrab,Gem Fort,0,26,37,63
4651,2023-01-04,NITA,gemGrab,Crystal Arcade,0,7,12,19
4652,2023-01-04,NITA,brawlBall,Sunny Soccer,2,96,61,159
4653,2023-01-04,NITA,bounty,Shooting Star,0,1,0,1
4654,2023-01-03,NITA,knockout,Goldarm Gulch,0,1,1,2
4655,2023-01-03,NITA,hotZone,Parallel Plays,1,50,39,90
4656,2023-01-03,NITA,hotZone,Controller Chaos,0,0,1,1
4657,2023-01-03,NITA,heist,Pit Stop,1,147,103,251
4658,2023-01-03,NITA,gemGrab,Crystal Arcade,0,70,58,128
4659,2023-01-03,NITA,brawlBall,Center Stage,1,2,8,11
4660,2023-01-03,NITA,brawlBall,Beach Ball,1,67,64,132
4661,2023-01-03,NITA,bounty,Hideout,0,1,0,1
4662,2023-01-02,NITA,knockout,Belle's Rock,0,3,0,3
4663,2023-01-02,NITA,hotZone,Quarter Pounder,0,26,27,53
4664,2023-01-02,NITA,heist,Pit Stop,0,264,180,444
4665,2023-01-02,NITA,heist,Kaboom Canyon,0,3,1,4
4666,2023-01-02,NITA,gemGrab,Minecart Madness,0,10,2,12
4667,2023-01-02,NITA,gemGrab,Double Swoosh,0,26,21,47
4668,2023-01-02,NITA,brawlBall,Center Stage,1,95,79,175
4669,2023-01-02,NITA,brawlBall,Backyard Bowl,0,1,0,1
4670,2023-01-02,NITA,bounty,Hideout,0,0,1,1
4671,2023-01-01,NITA,hotZone,Quarter Pounder,0,20,5,25
4672,2023-01-01,NITA,heist,Bridge Too Far,0,2,0,2
4673,2023-01-01,NITA,gemGrab,Double Swoosh,0,14,3,17
4674,2023-01-01,NITA,brawlBall,Backyard Bowl,0,5,0,5
4675,2022-12-31,NITA,hotZone,Controller Chaos,0,3,1,4
4676,2022-12-31,NITA,heist,Kaboom Canyon,0,1,0,1
4677,2022-12-31,NITA,gemGrab,Minecart Madness,0,1,0,1
4678,2022-12-31,NITA,gemGrab,Hard Rock Mine,0,1,2,3
4679,2022-12-31,NITA,gemGrab,Deep Diner,0,2,0,2
4680,2022-12-31,NITA,brawlBall,Super Beach,0,6,2,8
4681,2022-12-31,NITA,brawlBall,Sneaky Fields,0,5,6,11
4682,2022-12-30,NITA,hotZone,Controller Chaos,0,5,1,6
4683,2022-12-30,NITA,heist,Hot Potato,0,1,3,4
4684,2022-12-30,NITA,gemGrab,Undermine,0,3,14,17
4685,2022-12-30,NITA,gemGrab,Minecart Madness,0,0,1,1
4686,2022-12-30,NITA,gemGrab,Deep Diner,0,5,9,14
4687,2022-12-30,NITA,brawlBall,Sneaky Fields,0,17,19,36
4688,2022-12-29,NITA,heist,Kaboom Canyon,0,1,0,1
4689,2022-12-29,NITA,heist,Hot Potato,0,1,3,4
4690,2022-12-29,NITA,gemGrab,Undermine,0,1,1,2
4691,2022-12-29,NITA,brawlBall,Pinhole Punt,0,4,0,4
4692,2022-12-27,NITA,hotZone,Controller Chaos,0,1,0,1
4693,2022-12-27,NITA,heist,Kaboom Canyon,0,0,1,1
4694,2022-12-27,NITA,brawlBall,Center Stage,0,2,1,3
4695,2022-12-27,NITA,brawlBall,Beach Ball,0,1,0,1
4696,2022-12-26,NITA,heist,Kaboom Canyon,0,2,0,2
4697,2022-12-26,NITA,gemGrab,Minecart Madness,0,1,0,1
4698,2022-12-26,NITA,brawlBall,Center Stage,0,1,2,3
4699,2022-12-24,NITA,brawlBall,Super Beach,0,1,1,2
4700,2022-12-23,NITA,brawlBall,Sneaky Fields,0,1,1,2
4701,2022-12-22,NITA,gemGrab,Gem Fort,0,1,0,1
4702,2022-12-22,NITA,brawlBall,Pinhole Punt,0,2,0,2
4703,2022-12-21,NITA,brawlBall,Sunny Soccer,0,2,0,2
4704,2022-12-20,NITA,brawlBall,Beach Ball,0,1,1,2
4705,2022-12-19,NITA,brawlBall,Center Stage,0,1,2,3
4706,2022-12-16,NITA,brawlBall,Sneaky Fields,0,1,0,1
4707,2022-12-13,NITA,heist,Safe Zone,0,1,0,1
4708,2022-12-13,NITA,gemGrab,Crystal Arcade,0,1,1,2
4709,2022-12-13,NITA,brawlBall,Beach Ball,0,2,0,2
4710,2022-12-10,NITA,gemGrab,Hard Rock Mine,0,1,1,2
4711,2022-11-11,NITA,brawlBall,Sneaky Fields,0,1,2,3
4712,2022-11-03,NITA,brawlBall,Pinhole Punt,0,1,0,1
4713,2022-10-28,NITA,bounty,Canal Grande,0,1,0,1
4714,2022-10-15,NITA,gemGrab,Hard Rock Mine,0,0,1,1
4715,2023-01-30,NANI,knockout,Belle's Rock,0,56,55,111
4716,2023-01-30,NANI,hotZone,Quarter Pounder,0,6,1,7
4717,2023-01-30,NANI,heist,Pit Stop,0,2,0,2
4718,2023-01-30,NANI,gemGrab,Minecart Madness,0,20,15,35
4719,2023-01-30,NANI,gemGrab,Double Swoosh,0,6,2,8
4720,2023-01-30,NANI,brawlBall,Center Stage,0,23,23,46
4721,2023-01-30,NANI,brawlBall,Backyard Bowl,0,16,18,34
4722,2023-01-30,NANI,bounty,Hideout,0,105,154,259
4723,2023-01-29,NANI,knockout,Belle's Rock,0,61,67,128
4724,2023-01-29,NANI,hotZone,Quarter Pounder,0,9,11,20
4725,2023-01-29,NANI,heist,Bridge Too Far,0,111,89,200
4726,2023-01-29,NANI,gemGrab,Hard Rock Mine,0,0,3,3
4727,2023-01-29,NANI,gemGrab,Double Swoosh,0,13,3,16
4728,2023-01-29,NANI,brawlBall,Backyard Bowl,19,210,218,447
4729,2023-01-29,NANI,bounty,Canal Grande,0,8,25,33
4730,2023-01-28,NANI,knockout,Flaring Phoenix,0,39,20,59
4731,2023-01-28,NANI,hotZone,Controller Chaos,0,3,1,4
4732,2023-01-28,NANI,heist,Bridge Too Far,0,239,336,575
4733,2023-01-28,NANI,gemGrab,Hard Rock Mine,0,15,9,24
4734,2023-01-28,NANI,gemGrab,Deep Diner,0,4,3,7
4735,2023-01-28,NANI,brawlBall,Super Beach,0,38,25,63
4736,2023-01-28,NANI,brawlBall,Sneaky Fields,0,1,1,2
4737,2023-01-28,NANI,bounty,Canal Grande,0,7,4,11
4738,2023-01-27,NANI,knockout,Flaring Phoenix,0,15,10,25
4739,2023-01-27,NANI,hotZone,Controller Chaos,0,1,0,1
4740,2023-01-27,NANI,heist,Hot Potato,0,5,0,5
4741,2023-01-27,NANI,gemGrab,Undermine,0,1,2,3
4742,2023-01-27,NANI,gemGrab,Deep Diner,0,5,1,6
4743,2023-01-27,NANI,brawlBall,Sneaky Fields,0,3,12,15
4744,2023-01-27,NANI,bounty,Temple Ruins,0,5,4,9
4745,2023-01-26,NANI,knockout,Riverside,0,741,1129,1870
4746,2023-01-26,NANI,hotZone,Open Zone,0,24,10,34
4747,2023-01-26,NANI,heist,Hot Potato,0,6,4,10
4748,2023-01-26,NANI,gemGrab,Undermine,0,6,2,8
4749,2023-01-26,NANI,gemGrab,Gem Fort,0,2,3,5
4750,2023-01-26,NANI,brawlBall,Sunny Soccer,0,1,2,3
4751,2023-01-26,NANI,brawlBall,Pinhole Punt,3,61,45,109
4752,2023-01-26,NANI,bounty,Temple Ruins,0,16,11,27
4753,2023-01-25,NANI,knockout,Riverside,0,487,687,1174
4754,2023-01-25,NANI,hotZone,Open Zone,0,4,9,13
4755,2023-01-25,NANI,heist,Safe Zone,0,12,13,25
4756,2023-01-25,NANI,gemGrab,Gem Fort,0,4,1,5
4757,2023-01-25,NANI,gemGrab,Crystal Arcade,0,7,4,11
4758,2023-01-25,NANI,brawlBall,Sunny Soccer,0,22,5,27
4759,2023-01-25,NANI,brawlBall,Beach Ball,0,1,11,12
4760,2023-01-25,NANI,bounty,Excel,0,12,7,19
4761,2023-01-24,NANI,knockout,New Perspective,0,73,90,163
4762,2023-01-24,NANI,hotZone,Dueling Beetles,0,8,4,12
4763,2023-01-24,NANI,heist,Safe Zone,3,36,36,75
4764,2023-01-24,NANI,gemGrab,Minecart Madness,0,5,6,11
4765,2023-01-24,NANI,gemGrab,Crystal Arcade,0,12,4,16
4766,2023-01-24,NANI,brawlBall,Center Stage,0,5,0,5
4767,2023-01-24,NANI,brawlBall,Beach Ball,0,33,13,46
4768,2023-01-24,NANI,bounty,Excel,0,23,16,39
4769,2023-01-23,NANI,knockout,New Perspective,0,99,91,190
4770,2023-01-23,NANI,hotZone,Dueling Beetles,0,2,0,2
4771,2023-01-23,NANI,heist,Snaked Assault,0,8,1,9
4772,2023-01-23,NANI,gemGrab,Minecart Madness,0,28,41,69
4773,2023-01-23,NANI,gemGrab,Double Swoosh,0,5,1,6
4774,2023-01-23,NANI,brawlBall,Center Stage,1,44,32,77
4775,2023-01-23,NANI,brawlBall,Backyard Bowl,0,18,21,39
4776,2023-01-23,NANI,bounty,Layer Cake,0,26,26,52
4777,2023-01-22,NANI,knockout,X Marks the Spot,0,115,159,274
4778,2023-01-22,NANI,hotZone,Ring of Fire,0,8,1,9
4779,2023-01-22,NANI,heist,Snaked Assault,0,10,12,22
4780,2023-01-22,NANI,gemGrab,Hard Rock Mine,0,1,1,2
4781,2023-01-22,NANI,gemGrab,Double Swoosh,0,5,2,7
4782,2023-01-22,NANI,brawlBall,Super Beach,0,1,0,1
4783,2023-01-22,NANI,brawlBall,Backyard Bowl,5,118,120,243
4784,2023-01-22,NANI,bounty,Layer Cake,0,5,11,16
4785,2023-01-21,NANI,knockout,X Marks the Spot,3,369,498,870
4786,2023-01-21,NANI,hotZone,Ring of Fire,0,9,4,13
4787,2023-01-21,NANI,heist,Tornado Ring,0,2,2,4
4788,2023-01-21,NANI,gemGrab,Hard Rock Mine,0,17,12,29
4789,2023-01-21,NANI,gemGrab,Deep Diner,0,2,0,2
4790,2023-01-21,NANI,brawlBall,Super Beach,1,35,32,68
4791,2023-01-21,NANI,brawlBall,Sneaky Fields,0,2,0,2
4792,2023-01-21,NANI,bounty,Dry Season,0,118,134,252
4793,2023-01-20,NANI,knockout,Out in the Open,0,150,154,304
4794,2023-01-20,NANI,hotZone,Split,0,1,1,2
4795,2023-01-20,NANI,heist,Tornado Ring,0,7,2,9
4796,2023-01-20,NANI,gemGrab,Undermine,0,5,2,7
4797,2023-01-20,NANI,gemGrab,Deep Diner,0,29,18,47
4798,2023-01-20,NANI,brawlBall,Sneaky Fields,0,16,7,23
4799,2023-01-20,NANI,brawlBall,Pinhole Punt,0,1,8,9
4800,2023-01-20,NANI,bounty,Dry Season,0,87,93,180
4801,2023-01-19,NANI,knockout,Out in the Open,0,164,169,333
4802,2023-01-19,NANI,hotZone,Split,0,6,3,9
4803,2023-01-19,NANI,heist,Kaboom Canyon,1,42,61,104
4804,2023-01-19,NANI,gemGrab,Undermine,0,10,12,22
4805,2023-01-19,NANI,gemGrab,Gem Fort,0,1,1,2
4806,2023-01-19,NANI,brawlBall,Sunny Soccer,0,1,0,1
4807,2023-01-19,NANI,brawlBall,Pinhole Punt,2,53,45,100
4808,2023-01-19,NANI,bounty,Shooting Star,0,411,553,964
4809,2023-01-18,NANI,knockout,Goldarm Gulch,0,9,10,19
4810,2023-01-18,NANI,hotZone,Parallel Plays,0,2,1,3
4811,2023-01-18,NANI,heist,Kaboom Canyon,0,12,8,20
4812,2023-01-18,NANI,gemGrab,Gem Fort,0,3,0,3
4813,2023-01-18,NANI,brawlBall,Sunny Soccer,1,13,3,17
4814,2023-01-18,NANI,bounty,Shooting Star,0,212,226,438
4815,2023-01-17,NANI,knockout,Goldarm Gulch,0,2,3,5
4816,2023-01-17,NANI,heist,Pit Stop,0,1,0,1
4817,2023-01-17,NANI,gemGrab,Minecart Madness,0,0,1,1
4818,2023-01-17,NANI,brawlBall,Beach Ball,0,4,4,8
4819,2023-01-17,NANI,bounty,Hideout,0,25,22,47
4820,2023-01-16,NANI,knockout,Belle's Rock,0,3,2,5
4821,2023-01-16,NANI,hotZone,Quarter Pounder,0,2,0,2
4822,2023-01-16,NANI,gemGrab,Minecart Madness,0,3,5,8
4823,2023-01-16,NANI,brawlBall,Center Stage,0,5,1,6
4824,2023-01-16,NANI,brawlBall,Backyard Bowl,0,1,3,4
4825,2023-01-16,NANI,bounty,Hideout,0,27,56,83
4826,2023-01-15,NANI,knockout,Belle's Rock,0,5,2,7
4827,2023-01-15,NANI,hotZone,Quarter Pounder,0,1,1,2
4828,2023-01-15,NANI,heist,Bridge Too Far,0,21,37,58
4829,2023-01-15,NANI,gemGrab,Hard Rock Mine,0,0,1,1
4830,2023-01-15,NANI,gemGrab,Double Swoosh,0,1,0,1
4831,2023-01-15,NANI,brawlBall,Backyard Bowl,1,24,24,49
4832,2023-01-15,NANI,bounty,Canal Grande,0,1,0,1
4833,2023-01-14,NANI,knockout,Flaring Phoenix,0,3,1,4
4834,2023-01-14,NANI,hotZone,Controller Chaos,0,5,0,5
4835,2023-01-14,NANI,heist,Bridge Too Far,0,47,50,97
4836,2023-01-14,NANI,gemGrab,Deep Diner,0,3,8,11
4837,2023-01-14,NANI,brawlBall,Super Beach,0,2,0,2
4838,2023-01-14,NANI,brawlBall,Sneaky Fields,0,1,0,1
4839,2023-01-14,NANI,bounty,Canal Grande,0,1,0,1
4840,2023-01-13,NANI,knockout,Flaring Phoenix,0,7,3,10
4841,2023-01-13,NANI,hotZone,Controller Chaos,0,2,0,2
4842,2023-01-13,NANI,gemGrab,Deep Diner,0,1,1,2
4843,2023-01-13,NANI,brawlBall,Sneaky Fields,0,1,1,2
4844,2023-01-13,NANI,bounty,Temple Ruins,0,1,1,2
4845,2023-01-12,NANI,knockout,Riverside,0,131,158,289
4846,2023-01-12,NANI,brawlBall,Pinhole Punt,0,1,0,1
4847,2023-01-11,NANI,knockout,Riverside,0,37,49,86
4848,2023-01-11,NANI,hotZone,Open Zone,0,1,1,2
4849,2023-01-11,NANI,bounty,Excel,0,1,0,1
4850,2023-01-10,NANI,knockout,New Perspective,0,4,3,7
4851,2023-01-10,NANI,heist,Safe Zone,0,1,1,2
4852,2023-01-10,NANI,gemGrab,Minecart Madness,0,4,14,18
4853,2023-01-10,NANI,gemGrab,Crystal Arcade,0,3,2,5
4854,2023-01-10,NANI,brawlBall,Beach Ball,0,2,0,2
4855,2023-01-09,NANI,knockout,New Perspective,0,2,2,4
4856,2023-01-09,NANI,gemGrab,Minecart Madness,0,2,5,7
4857,2023-01-09,NANI,brawlBall,Backyard Bowl,0,2,2,4
4858,2023-01-09,NANI,bounty,Layer Cake,0,2,1,3
4859,2023-01-08,NANI,knockout,X Marks the Spot,0,23,12,35
4860,2023-01-08,NANI,hotZone,Ring of Fire,0,1,0,1
4861,2023-01-08,NANI,brawlBall,Super Beach,0,1,1,2
4862,2023-01-08,NANI,brawlBall,Backyard Bowl,2,5,16,23
4863,2023-01-08,NANI,bounty,Layer Cake,0,1,1,2
4864,2023-01-07,NANI,knockout,X Marks the Spot,0,11,2,13
4865,2023-01-07,NANI,gemGrab,Hard Rock Mine,0,2,0,2
4866,2023-01-07,NANI,gemGrab,Deep Diner,0,1,0,1
4867,2023-01-07,NANI,brawlBall,Super Beach,0,1,0,1
4868,2023-01-07,NANI,bounty,Dry Season,0,8,5,13
4869,2023-01-06,NANI,knockout,Out in the Open,0,5,1,6
4870,2023-01-06,NANI,bounty,Dry Season,0,10,15,25
4871,2023-01-05,NANI,knockout,Out in the Open,0,18,11,29
4872,2023-01-05,NANI,heist,Kaboom Canyon,0,2,1,3
4873,2023-01-05,NANI,gemGrab,Undermine,0,0,1,1
4874,2023-01-05,NANI,brawlBall,Pinhole Punt,0,1,0,1
4875,2023-01-05,NANI,bounty,Shooting Star,0,74,139,213
4876,2023-01-04,NANI,knockout,Goldarm Gulch,0,0,2,2
4877,2023-01-04,NANI,heist,Kaboom Canyon,0,5,10,15
4878,2023-01-04,NANI,brawlBall,Sunny Soccer,0,0,1,1
4879,2023-01-04,NANI,bounty,Shooting Star,0,235,329,564
4880,2023-01-03,NANI,knockout,Goldarm Gulch,0,1,4,5
4881,2023-01-03,NANI,gemGrab,Crystal Arcade,0,1,0,1
4882,2023-01-03,NANI,brawlBall,Beach Ball,0,2,0,2
4883,2023-01-03,NANI,bounty,Hideout,0,29,48,77
4884,2023-01-02,NANI,knockout,Belle's Rock,0,9,8,17
4885,2023-01-02,NANI,hotZone,Quarter Pounder,0,1,2,3
4886,2023-01-02,NANI,gemGrab,Minecart Madness,0,1,0,1
4887,2023-01-02,NANI,brawlBall,Center Stage,0,2,0,2
4888,2023-01-02,NANI,brawlBall,Backyard Bowl,0,0,1,1
4889,2023-01-02,NANI,bounty,Hideout,0,66,50,116
4890,2023-01-01,NANI,hotZone,Quarter Pounder,0,12,13,25
4891,2023-01-01,NANI,heist,Bridge Too Far,0,4,3,7
4892,2023-01-01,NANI,gemGrab,Double Swoosh,0,1,0,1
4893,2023-01-01,NANI,brawlBall,Backyard Bowl,0,8,3,11
4894,2022-12-31,NANI,heist,Bridge Too Far,0,2,1,3
4895,2022-12-30,NANI,knockout,Flaring Phoenix,0,0,1,1
4896,2022-12-29,NANI,heist,Kaboom Canyon,0,1,0,1
4897,2022-12-24,NANI,knockout,X Marks the Spot,0,0,1,1
4898,2022-12-22,NANI,brawlBall,Pinhole Punt,0,1,0,1
4899,2022-12-13,NANI,knockout,New Perspective,0,2,13,15
4900,2022-11-01,NANI,knockout,New Perspective,0,2,1,3
4901,2022-10-26,NANI,bounty,Shooting Star,0,4,4,8
4902,2022-10-15,NANI,gemGrab,Hard Rock Mine,0,0,1,1
4903,2023-01-30,MR. P,knockout,Belle's Rock,1,154,156,311
4904,2023-01-30,MR. P,hotZone,Quarter Pounder,0,40,14,54
4905,2023-01-30,MR. P,heist,Pit Stop,0,5,3,8
4906,2023-01-30,MR. P,gemGrab,Minecart Madness,0,45,44,89
4907,2023-01-30,MR. P,gemGrab,Double Swoosh,0,24,30,54
4908,2023-01-30,MR. P,brawlBall,Center Stage,2,48,53,103
4909,2023-01-30,MR. P,brawlBall,Backyard Bowl,0,15,11,26
4910,2023-01-30,MR. P,bounty,Hideout,0,18,12,30
4911,2023-01-29,MR. P,knockout,Belle's Rock,1,163,215,379
4912,2023-01-29,MR. P,hotZone,Quarter Pounder,0,20,14,34
4913,2023-01-29,MR. P,heist,Bridge Too Far,0,16,11,27
4914,2023-01-29,MR. P,gemGrab,Hard Rock Mine,0,11,7,18
4915,2023-01-29,MR. P,gemGrab,Double Swoosh,0,34,36,70
4916,2023-01-29,MR. P,brawlBall,Backyard Bowl,1,83,115,199
4917,2023-01-29,MR. P,bounty,Canal Grande,0,45,40,85
4918,2023-01-28,MR. P,knockout,Flaring Phoenix,0,70,75,145
4919,2023-01-28,MR. P,hotZone,Controller Chaos,0,16,9,25
4920,2023-01-28,MR. P,heist,Bridge Too Far,0,37,40,77
4921,2023-01-28,MR. P,gemGrab,Hard Rock Mine,0,44,56,100
4922,2023-01-28,MR. P,gemGrab,Deep Diner,0,21,30,51
4923,2023-01-28,MR. P,brawlBall,Super Beach,1,49,63,113
4924,2023-01-28,MR. P,brawlBall,Sneaky Fields,0,5,4,9
4925,2023-01-28,MR. P,bounty,Canal Grande,0,80,100,180
4926,2023-01-27,MR. P,knockout,Flaring Phoenix,0,24,15,39
4927,2023-01-27,MR. P,hotZone,Controller Chaos,0,8,4,12
4928,2023-01-27,MR. P,heist,Hot Potato,0,4,8,12
4929,2023-01-27,MR. P,gemGrab,Undermine,0,5,3,8
4930,2023-01-27,MR. P,gemGrab,Deep Diner,0,50,51,101
4931,2023-01-27,MR. P,brawlBall,Sneaky Fields,0,16,11,27
4932,2023-01-27,MR. P,brawlBall,Pinhole Punt,0,1,0,1
4933,2023-01-27,MR. P,bounty,Temple Ruins,0,8,7,15
4934,2023-01-26,MR. P,knockout,Riverside,0,98,125,223
4935,2023-01-26,MR. P,hotZone,Open Zone,0,27,11,38
4936,2023-01-26,MR. P,heist,Hot Potato,0,7,3,10
4937,2023-01-26,MR. P,gemGrab,Undermine,0,27,57,84
4938,2023-01-26,MR. P,gemGrab,Gem Fort,0,8,6,14
4939,2023-01-26,MR. P,brawlBall,Sunny Soccer,0,4,9,13
4940,2023-01-26,MR. P,brawlBall,Pinhole Punt,2,69,68,139
4941,2023-01-26,MR. P,bounty,Temple Ruins,0,21,30,51
4942,2023-01-25,MR. P,knockout,Riverside,0,40,45,85
4943,2023-01-25,MR. P,hotZone,Open Zone,0,6,3,9
4944,2023-01-25,MR. P,heist,Safe Zone,0,9,4,13
4945,2023-01-25,MR. P,gemGrab,Gem Fort,0,20,12,32
4946,2023-01-25,MR. P,gemGrab,Crystal Arcade,0,28,35,63
4947,2023-01-25,MR. P,brawlBall,Sunny Soccer,1,28,39,68
4948,2023-01-25,MR. P,brawlBall,Beach Ball,0,5,4,9
4949,2023-01-25,MR. P,bounty,Excel,0,43,54,97
4950,2023-01-24,MR. P,knockout,New Perspective,0,40,42,82
4951,2023-01-24,MR. P,hotZone,Dueling Beetles,0,21,21,42
4952,2023-01-24,MR. P,heist,Safe Zone,0,24,6,30
4953,2023-01-24,MR. P,gemGrab,Minecart Madness,0,21,26,47
4954,2023-01-24,MR. P,gemGrab,Crystal Arcade,0,30,32,62
4955,2023-01-24,MR. P,brawlBall,Center Stage,0,3,2,5
4956,2023-01-24,MR. P,brawlBall,Beach Ball,3,74,86,163
4957,2023-01-24,MR. P,bounty,Excel,0,86,107,193
4958,2023-01-23,MR. P,knockout,New Perspective,0,57,73,130
4959,2023-01-23,MR. P,hotZone,Dueling Beetles,0,24,17,41
4960,2023-01-23,MR. P,heist,Snaked Assault,0,14,13,27
4961,2023-01-23,MR. P,gemGrab,Minecart Madness,0,78,82,160
4962,2023-01-23,MR. P,gemGrab,Double Swoosh,0,14,22,36
4963,2023-01-23,MR. P,brawlBall,Center Stage,4,73,89,166
4964,2023-01-23,MR. P,brawlBall,Backyard Bowl,0,3,4,7
4965,2023-01-23,MR. P,bounty,Layer Cake,0,89,88,177
4966,2023-01-22,MR. P,knockout,X Marks the Spot,0,26,39,65
4967,2023-01-22,MR. P,hotZone,Ring of Fire,0,5,5,10
4968,2023-01-22,MR. P,heist,Snaked Assault,0,2,2,4
4969,2023-01-22,MR. P,gemGrab,Hard Rock Mine,0,12,11,23
4970,2023-01-22,MR. P,gemGrab,Double Swoosh,0,17,24,41
4971,2023-01-22,MR. P,brawlBall,Super Beach,0,6,11,17
4972,2023-01-22,MR. P,brawlBall,Backyard Bowl,2,58,67,127
4973,2023-01-22,MR. P,bounty,Layer Cake,0,48,36,84
4974,2023-01-21,MR. P,knockout,X Marks the Spot,0,143,174,317
4975,2023-01-21,MR. P,hotZone,Ring of Fire,0,13,10,23
4976,2023-01-21,MR. P,heist,Tornado Ring,0,5,2,7
4977,2023-01-21,MR. P,gemGrab,Hard Rock Mine,0,41,42,83
4978,2023-01-21,MR. P,gemGrab,Deep Diner,0,22,43,65
4979,2023-01-21,MR. P,brawlBall,Super Beach,1,86,87,174
4980,2023-01-21,MR. P,brawlBall,Sneaky Fields,0,2,1,3
4981,2023-01-21,MR. P,bounty,Dry Season,0,113,141,254
4982,2023-01-20,MR. P,knockout,Out in the Open,2,79,109,190
4983,2023-01-20,MR. P,hotZone,Split,0,13,9,22
4984,2023-01-20,MR. P,heist,Tornado Ring,0,8,9,17
4985,2023-01-20,MR. P,gemGrab,Undermine,0,14,21,35
4986,2023-01-20,MR. P,gemGrab,Deep Diner,0,68,91,159
4987,2023-01-20,MR. P,brawlBall,Sneaky Fields,2,31,35,68
4988,2023-01-20,MR. P,brawlBall,Pinhole Punt,0,1,0,1
4989,2023-01-20,MR. P,bounty,Dry Season,0,91,94,185
4990,2023-01-19,MR. P,knockout,Out in the Open,0,87,60,147
4991,2023-01-19,MR. P,hotZone,Split,0,12,7,19
4992,2023-01-19,MR. P,heist,Kaboom Canyon,0,10,15,25
4993,2023-01-19,MR. P,gemGrab,Undermine,0,50,81,131
4994,2023-01-19,MR. P,gemGrab,Gem Fort,0,12,16,28
4995,2023-01-19,MR. P,brawlBall,Sunny Soccer,0,2,2,4
4996,2023-01-19,MR. P,brawlBall,Pinhole Punt,0,59,77,136
4997,2023-01-19,MR. P,bounty,Shooting Star,0,40,81,121
4998,2023-01-18,MR. P,knockout,Goldarm Gulch,0,18,13,31
4999,2023-01-18,MR. P,hotZone,Parallel Plays,0,1,2,3
5000,2023-01-18,MR. P,heist,Kaboom Canyon,0,1,2,3
5001,2023-01-18,MR. P,gemGrab,Gem Fort,0,7,7,14
5002,2023-01-18,MR. P,gemGrab,Crystal Arcade,0,1,1,2
5003,2023-01-18,MR. P,brawlBall,Sunny Soccer,1,13,29,43
5004,2023-01-18,MR. P,bounty,Shooting Star,0,28,38,66
5005,2023-01-17,MR. P,knockout,Goldarm Gulch,0,8,10,18
5006,2023-01-17,MR. P,hotZone,Parallel Plays,0,4,3,7
5007,2023-01-17,MR. P,gemGrab,Minecart Madness,0,1,0,1
5008,2023-01-17,MR. P,gemGrab,Crystal Arcade,0,5,10,15
5009,2023-01-17,MR. P,brawlBall,Beach Ball,0,12,11,23
5010,2023-01-17,MR. P,bounty,Hideout,0,4,8,12
5011,2023-01-16,MR. P,knockout,Belle's Rock,0,14,8,22
5012,2023-01-16,MR. P,hotZone,Quarter Pounder,0,1,4,5
5013,2023-01-16,MR. P,heist,Pit Stop,0,2,2,4
5014,2023-01-16,MR. P,gemGrab,Minecart Madness,0,2,12,14
5015,2023-01-16,MR. P,gemGrab,Double Swoosh,0,2,8,10
5016,2023-01-16,MR. P,brawlBall,Center Stage,0,4,3,7
5017,2023-01-16,MR. P,brawlBall,Backyard Bowl,1,0,0,1
5018,2023-01-16,MR. P,bounty,Hideout,0,2,5,7
5019,2023-01-15,MR. P,knockout,Belle's Rock,0,13,18,31
5020,2023-01-15,MR. P,hotZone,Quarter Pounder,0,5,1,6
5021,2023-01-15,MR. P,heist,Bridge Too Far,0,5,6,11
5022,2023-01-15,MR. P,gemGrab,Hard Rock Mine,0,2,0,2
5023,2023-01-15,MR. P,gemGrab,Double Swoosh,0,2,3,5
5024,2023-01-15,MR. P,brawlBall,Backyard Bowl,0,7,36,43
5025,2023-01-15,MR. P,bounty,Canal Grande,0,5,22,27
5026,2023-01-14,MR. P,knockout,Flaring Phoenix,0,8,17,25
5027,2023-01-14,MR. P,hotZone,Controller Chaos,0,7,2,9
5028,2023-01-14,MR. P,heist,Bridge Too Far,0,8,0,8
5029,2023-01-14,MR. P,gemGrab,Hard Rock Mine,0,1,1,2
5030,2023-01-14,MR. P,gemGrab,Deep Diner,0,5,3,8
5031,2023-01-14,MR. P,brawlBall,Super Beach,0,7,3,10
5032,2023-01-14,MR. P,bounty,Canal Grande,0,4,2,6
5033,2023-01-13,MR. P,knockout,Flaring Phoenix,0,8,17,25
5034,2023-01-13,MR. P,gemGrab,Deep Diner,0,8,1,9
5035,2023-01-13,MR. P,brawlBall,Sneaky Fields,0,3,7,10
5036,2023-01-13,MR. P,brawlBall,Pinhole Punt,0,1,0,1
5037,2023-01-13,MR. P,bounty,Temple Ruins,0,0,3,3
5038,2023-01-12,MR. P,knockout,Riverside,0,11,1,12
5039,2023-01-12,MR. P,hotZone,Open Zone,0,2,1,3
5040,2023-01-12,MR. P,gemGrab,Undermine,0,1,1,2
5041,2023-01-12,MR. P,brawlBall,Pinhole Punt,0,0,2,2
5042,2023-01-11,MR. P,hotZone,Open Zone,0,1,0,1
5043,2023-01-11,MR. P,heist,Safe Zone,0,1,0,1
5044,2023-01-11,MR. P,gemGrab,Gem Fort,0,1,0,1
5045,2023-01-11,MR. P,brawlBall,Sunny Soccer,0,3,2,5
5046,2023-01-11,MR. P,bounty,Excel,0,1,8,9
5047,2023-01-10,MR. P,knockout,New Perspective,0,8,6,14
5048,2023-01-10,MR. P,hotZone,Dueling Beetles,0,3,1,4
5049,2023-01-10,MR. P,heist,Safe Zone,0,2,0,2
5050,2023-01-10,MR. P,gemGrab,Minecart Madness,0,4,14,18
5051,2023-01-10,MR. P,gemGrab,Crystal Arcade,0,2,0,2
5052,2023-01-10,MR. P,brawlBall,Beach Ball,0,6,12,18
5053,2023-01-10,MR. P,bounty,Excel,0,2,2,4
5054,2023-01-09,MR. P,knockout,New Perspective,0,1,0,1
5055,2023-01-09,MR. P,hotZone,Dueling Beetles,0,4,10,14
5056,2023-01-09,MR. P,gemGrab,Minecart Madness,0,9,12,21
5057,2023-01-09,MR. P,gemGrab,Double Swoosh,0,2,11,13
5058,2023-01-09,MR. P,brawlBall,Center Stage,0,1,2,3
5059,2023-01-09,MR. P,bounty,Layer Cake,0,11,4,15
5060,2023-01-08,MR. P,knockout,X Marks the Spot,0,4,2,6
5061,2023-01-08,MR. P,hotZone,Ring of Fire,0,1,0,1
5062,2023-01-08,MR. P,heist,Snaked Assault,0,3,0,3
5063,2023-01-08,MR. P,gemGrab,Double Swoosh,0,9,41,50
5064,2023-01-08,MR. P,brawlBall,Backyard Bowl,0,4,14,18
5065,2023-01-07,MR. P,knockout,X Marks the Spot,0,3,11,14
5066,2023-01-07,MR. P,hotZone,Ring of Fire,0,3,1,4
5067,2023-01-07,MR. P,gemGrab,Deep Diner,0,2,1,3
5068,2023-01-07,MR. P,bounty,Dry Season,0,9,2,11
5069,2023-01-06,MR. P,knockout,Out in the Open,0,3,1,4
5070,2023-01-06,MR. P,hotZone,Split,0,1,0,1
5071,2023-01-06,MR. P,gemGrab,Deep Diner,0,5,3,8
5072,2023-01-06,MR. P,brawlBall,Sneaky Fields,0,0,5,5
5073,2023-01-06,MR. P,bounty,Dry Season,0,19,15,34
5074,2023-01-05,MR. P,knockout,Out in the Open,0,8,24,32
5075,2023-01-05,MR. P,gemGrab,Undermine,0,3,1,4
5076,2023-01-05,MR. P,gemGrab,Gem Fort,0,0,1,1
5077,2023-01-05,MR. P,brawlBall,Pinhole Punt,0,4,8,12
5078,2023-01-05,MR. P,bounty,Shooting Star,0,6,1,7
5079,2023-01-04,MR. P,knockout,Goldarm Gulch,0,0,1,1
5080,2023-01-04,MR. P,hotZone,Parallel Plays,0,1,0,1
5081,2023-01-04,MR. P,heist,Kaboom Canyon,0,1,0,1
5082,2023-01-04,MR. P,gemGrab,Crystal Arcade,0,1,3,4
5083,2023-01-04,MR. P,brawlBall,Sunny Soccer,0,3,2,5
5084,2023-01-04,MR. P,bounty,Shooting Star,0,18,5,23
5085,2023-01-03,MR. P,knockout,Goldarm Gulch,0,1,1,2
5086,2023-01-03,MR. P,hotZone,Parallel Plays,0,1,2,3
5087,2023-01-03,MR. P,heist,Pit Stop,0,1,0,1
5088,2023-01-03,MR. P,gemGrab,Crystal Arcade,0,4,5,9
5089,2023-01-03,MR. P,brawlBall,Center Stage,0,1,0,1
5090,2023-01-03,MR. P,brawlBall,Beach Ball,0,5,16,21
5091,2023-01-03,MR. P,bounty,Hideout,0,7,4,11
5092,2023-01-02,MR. P,knockout,Belle's Rock,0,14,4,18
5093,2023-01-02,MR. P,hotZone,Quarter Pounder,0,5,9,14
5094,2023-01-02,MR. P,heist,Pit Stop,0,1,0,1
5095,2023-01-02,MR. P,gemGrab,Minecart Madness,0,10,18,28
5096,2023-01-02,MR. P,brawlBall,Center Stage,0,4,2,6
5097,2023-01-02,MR. P,brawlBall,Backyard Bowl,0,1,0,1
5098,2023-01-02,MR. P,bounty,Hideout,0,9,7,16
5099,2023-01-01,MR. P,knockout,Belle's Rock,0,1,2,3
5100,2023-01-01,MR. P,hotZone,Quarter Pounder,0,1,0,1
5101,2023-01-01,MR. P,gemGrab,Double Swoosh,0,7,25,32
5102,2023-01-01,MR. P,brawlBall,Backyard Bowl,0,9,16,25
5103,2023-01-01,MR. P,bounty,Canal Grande,0,1,2,3
5104,2022-12-31,MR. P,hotZone,Controller Chaos,0,1,1,2
5105,2022-12-24,MR. P,knockout,X Marks the Spot,0,1,1,2
5106,2022-12-23,MR. P,knockout,Out in the Open,0,1,0,1
5107,2022-12-22,MR. P,gemGrab,Gem Fort,0,1,0,1
5108,2022-11-07,MR. P,hotZone,Quarter Pounder,0,1,0,1
5109,2022-11-01,MR. P,knockout,New Perspective,0,2,2,4
5110,2022-10-30,MR. P,knockout,Out in the Open,0,0,2,2
5111,2022-10-26,MR. P,bounty,Shooting Star,0,0,1,1
5112,2023-01-30,MORTIS,knockout,Belle's Rock,0,588,542,1130
5113,2023-01-30,MORTIS,hotZone,Quarter Pounder,0,103,59,162
5114,2023-01-30,MORTIS,heist,Pit Stop,0,9,2,11
5115,2023-01-30,MORTIS,gemGrab,Minecart Madness,0,196,206,402
5116,2023-01-30,MORTIS,gemGrab,Double Swoosh,0,233,188,421
5117,2023-01-30,MORTIS,brawlBall,Center Stage,45,2473,1833,4351
5118,2023-01-30,MORTIS,brawlBall,Backyard Bowl,5,305,196,506
5119,2023-01-30,MORTIS,bounty,Hideout,0,125,141,266
5120,2023-01-29,MORTIS,knockout,Belle's Rock,0,570,575,1145
5121,2023-01-29,MORTIS,hotZone,Quarter Pounder,0,63,54,117
5122,2023-01-29,MORTIS,heist,Bridge Too Far,0,14,1,15
5123,2023-01-29,MORTIS,gemGrab,Hard Rock Mine,0,112,70,182
5124,2023-01-29,MORTIS,gemGrab,Double Swoosh,0,426,344,770
5125,2023-01-29,MORTIS,brawlBall,Super Beach,0,69,40,109
5126,2023-01-29,MORTIS,brawlBall,Backyard Bowl,100,3940,3253,7293
5127,2023-01-29,MORTIS,bounty,Canal Grande,0,102,53,155
5128,2023-01-28,MORTIS,knockout,Flaring Phoenix,1,543,501,1045
5129,2023-01-28,MORTIS,hotZone,Controller Chaos,0,77,40,117
5130,2023-01-28,MORTIS,heist,Bridge Too Far,0,25,6,31
5131,2023-01-28,MORTIS,gemGrab,Hard Rock Mine,0,463,369,832
5132,2023-01-28,MORTIS,gemGrab,Deep Diner,0,178,106,284
5133,2023-01-28,MORTIS,brawlBall,Super Beach,73,4425,3526,8024
5134,2023-01-28,MORTIS,brawlBall,Sneaky Fields,0,110,82,192
5135,2023-01-28,MORTIS,bounty,Canal Grande,0,193,113,306
5136,2023-01-27,MORTIS,knockout,Flaring Phoenix,1,289,299,589
5137,2023-01-27,MORTIS,hotZone,Controller Chaos,0,18,6,24
5138,2023-01-27,MORTIS,heist,Hot Potato,0,2,2,4
5139,2023-01-27,MORTIS,gemGrab,Undermine,0,19,15,34
5140,2023-01-27,MORTIS,gemGrab,Deep Diner,0,227,195,422
5141,2023-01-27,MORTIS,brawlBall,Sneaky Fields,13,915,734,1662
5142,2023-01-27,MORTIS,brawlBall,Pinhole Punt,2,25,26,53
5143,2023-01-27,MORTIS,bounty,Temple Ruins,0,61,36,97
5144,2023-01-26,MORTIS,knockout,Riverside,0,121,47,168
5145,2023-01-26,MORTIS,hotZone,Open Zone,0,70,24,94
5146,2023-01-26,MORTIS,heist,Hot Potato,0,19,5,24
5147,2023-01-26,MORTIS,gemGrab,Undermine,0,314,218,532
5148,2023-01-26,MORTIS,gemGrab,Gem Fort,0,162,118,280
5149,2023-01-26,MORTIS,brawlBall,Sunny Soccer,0,204,143,347
5150,2023-01-26,MORTIS,brawlBall,Pinhole Punt,67,3774,2903,6744
5151,2023-01-26,MORTIS,bounty,Temple Ruins,0,175,164,339
5152,2023-01-25,MORTIS,knockout,Riverside,0,51,28,79
5153,2023-01-25,MORTIS,hotZone,Open Zone,0,25,6,31
5154,2023-01-25,MORTIS,heist,Safe Zone,0,11,1,12
5155,2023-01-25,MORTIS,gemGrab,Gem Fort,0,180,127,307
5156,2023-01-25,MORTIS,gemGrab,Crystal Arcade,0,200,135,335
5157,2023-01-25,MORTIS,brawlBall,Sunny Soccer,49,2178,1643,3870
5158,2023-01-25,MORTIS,brawlBall,Beach Ball,9,327,245,581
5159,2023-01-25,MORTIS,bounty,Excel,0,305,328,633
5160,2023-01-24,MORTIS,knockout,New Perspective,0,288,297,585
5161,2023-01-24,MORTIS,hotZone,Dueling Beetles,0,113,99,212
5162,2023-01-24,MORTIS,heist,Safe Zone,0,15,6,21
5163,2023-01-24,MORTIS,gemGrab,Minecart Madness,0,91,91,182
5164,2023-01-24,MORTIS,gemGrab,Crystal Arcade,0,414,346,760
5165,2023-01-24,MORTIS,brawlBall,Center Stage,6,270,221,497
5166,2023-01-24,MORTIS,brawlBall,Beach Ball,82,3536,2801,6419
5167,2023-01-24,MORTIS,bounty,Excel,0,603,614,1217
5168,2023-01-23,MORTIS,knockout,New Perspective,3,741,829,1573
5169,2023-01-23,MORTIS,hotZone,Dueling Beetles,1,180,138,319
5170,2023-01-23,MORTIS,heist,Snaked Assault,0,14,7,21
5171,2023-01-23,MORTIS,gemGrab,Minecart Madness,0,467,413,880
5172,2023-01-23,MORTIS,gemGrab,Double Swoosh,0,180,138,318
5173,2023-01-23,MORTIS,brawlBall,Center Stage,67,4123,3107,7297
5174,2023-01-23,MORTIS,brawlBall,Backyard Bowl,2,183,133,318
5175,2023-01-23,MORTIS,bounty,Layer Cake,0,561,480,1041
5176,2023-01-22,MORTIS,knockout,X Marks the Spot,0,188,137,325
5177,2023-01-22,MORTIS,hotZone,Ring of Fire,0,43,18,61
5178,2023-01-22,MORTIS,heist,Snaked Assault,0,5,1,6
5179,2023-01-22,MORTIS,gemGrab,Hard Rock Mine,0,167,139,306
5180,2023-01-22,MORTIS,gemGrab,Double Swoosh,0,241,141,382
5181,2023-01-22,MORTIS,brawlBall,Super Beach,7,355,278,640
5182,2023-01-22,MORTIS,brawlBall,Backyard Bowl,52,1867,1524,3443
5183,2023-01-22,MORTIS,bounty,Layer Cake,0,355,357,712
5184,2023-01-21,MORTIS,knockout,X Marks the Spot,3,622,563,1188
5185,2023-01-21,MORTIS,hotZone,Ring of Fire,0,85,75,160
5186,2023-01-21,MORTIS,heist,Tornado Ring,0,17,3,20
5187,2023-01-21,MORTIS,gemGrab,Hard Rock Mine,0,764,606,1370
5188,2023-01-21,MORTIS,gemGrab,Deep Diner,0,133,87,220
5189,2023-01-21,MORTIS,brawlBall,Super Beach,116,5585,4101,9802
5190,2023-01-21,MORTIS,brawlBall,Sneaky Fields,0,161,103,264
5191,2023-01-21,MORTIS,bounty,Dry Season,0,444,380,824
5192,2023-01-20,MORTIS,knockout,Out in the Open,3,365,275,643
5193,2023-01-20,MORTIS,hotZone,Split,0,86,54,140
5194,2023-01-20,MORTIS,heist,Tornado Ring,0,23,2,25
5195,2023-01-20,MORTIS,gemGrab,Undermine,0,188,132,320
5196,2023-01-20,MORTIS,gemGrab,Deep Diner,0,633,469,1102
5197,2023-01-20,MORTIS,brawlBall,Sneaky Fields,59,3370,2371,5800
5198,2023-01-20,MORTIS,brawlBall,Pinhole Punt,1,161,133,295
5199,2023-01-20,MORTIS,bounty,Dry Season,0,408,460,868
5200,2023-01-19,MORTIS,knockout,Out in the Open,0,504,420,924
5201,2023-01-19,MORTIS,hotZone,Split,0,81,49,130
5202,2023-01-19,MORTIS,heist,Kaboom Canyon,0,13,2,15
5203,2023-01-19,MORTIS,gemGrab,Undermine,0,443,335,778
5204,2023-01-19,MORTIS,gemGrab,Gem Fort,0,75,46,121
5205,2023-01-19,MORTIS,brawlBall,Sunny Soccer,1,114,81,196
5206,2023-01-19,MORTIS,brawlBall,Pinhole Punt,57,4563,3469,8089
5207,2023-01-19,MORTIS,bounty,Shooting Star,0,178,156,334
5208,2023-01-18,MORTIS,knockout,Goldarm Gulch,1,47,40,88
5209,2023-01-18,MORTIS,hotZone,Parallel Plays,0,8,13,21
5210,2023-01-18,MORTIS,heist,Kaboom Canyon,0,3,0,3
5211,2023-01-18,MORTIS,gemGrab,Gem Fort,0,100,74,174
5212,2023-01-18,MORTIS,gemGrab,Crystal Arcade,0,21,9,30
5213,2023-01-18,MORTIS,brawlBall,Sunny Soccer,13,1115,868,1996
5214,2023-01-18,MORTIS,brawlBall,Beach Ball,0,43,40,83
5215,2023-01-18,MORTIS,bounty,Shooting Star,0,86,92,178
5216,2023-01-17,MORTIS,knockout,Goldarm Gulch,0,57,45,102
5217,2023-01-17,MORTIS,hotZone,Parallel Plays,0,7,2,9
5218,2023-01-17,MORTIS,gemGrab,Minecart Madness,0,3,6,9
5219,2023-01-17,MORTIS,gemGrab,Crystal Arcade,0,39,19,58
5220,2023-01-17,MORTIS,brawlBall,Center Stage,0,21,10,31
5221,2023-01-17,MORTIS,brawlBall,Beach Ball,1,368,283,652
5222,2023-01-17,MORTIS,bounty,Hideout,0,19,24,43
5223,2023-01-16,MORTIS,knockout,Belle's Rock,0,45,34,79
5224,2023-01-16,MORTIS,hotZone,Quarter Pounder,0,10,2,12
5225,2023-01-16,MORTIS,heist,Pit Stop,0,2,0,2
5226,2023-01-16,MORTIS,gemGrab,Minecart Madness,0,42,27,69
5227,2023-01-16,MORTIS,gemGrab,Double Swoosh,0,9,7,16
5228,2023-01-16,MORTIS,brawlBall,Center Stage,1,236,166,403
5229,2023-01-16,MORTIS,brawlBall,Backyard Bowl,0,40,10,50
5230,2023-01-16,MORTIS,bounty,Hideout,0,42,17,59
5231,2023-01-15,MORTIS,knockout,Belle's Rock,0,77,71,148
5232,2023-01-15,MORTIS,hotZone,Quarter Pounder,0,12,9,21
5233,2023-01-15,MORTIS,heist,Bridge Too Far,0,2,0,2
5234,2023-01-15,MORTIS,gemGrab,Hard Rock Mine,0,41,22,63
5235,2023-01-15,MORTIS,gemGrab,Double Swoosh,0,82,58,140
5236,2023-01-15,MORTIS,brawlBall,Super Beach,2,41,22,65
5237,2023-01-15,MORTIS,brawlBall,Backyard Bowl,9,437,257,703
5238,2023-01-15,MORTIS,bounty,Canal Grande,0,19,9,28
5239,2023-01-14,MORTIS,knockout,Flaring Phoenix,1,24,25,50
5240,2023-01-14,MORTIS,hotZone,Controller Chaos,0,17,7,24
5241,2023-01-14,MORTIS,heist,Bridge Too Far,0,3,0,3
5242,2023-01-14,MORTIS,gemGrab,Hard Rock Mine,0,44,36,80
5243,2023-01-14,MORTIS,gemGrab,Deep Diner,0,25,35,60
5244,2023-01-14,MORTIS,brawlBall,Super Beach,6,304,205,515
5245,2023-01-14,MORTIS,brawlBall,Sneaky Fields,0,12,5,17
5246,2023-01-14,MORTIS,bounty,Canal Grande,0,14,23,37
5247,2023-01-13,MORTIS,knockout,Flaring Phoenix,0,49,63,112
5248,2023-01-13,MORTIS,hotZone,Controller Chaos,0,24,45,69
5249,2023-01-13,MORTIS,gemGrab,Undermine,0,1,0,1
5250,2023-01-13,MORTIS,gemGrab,Deep Diner,0,73,32,105
5251,2023-01-13,MORTIS,brawlBall,Sneaky Fields,2,171,97,270
5252,2023-01-13,MORTIS,brawlBall,Pinhole Punt,0,2,3,5
5253,2023-01-13,MORTIS,bounty,Temple Ruins,0,10,20,30
5254,2023-01-12,MORTIS,knockout,Riverside,0,12,5,17
5255,2023-01-12,MORTIS,hotZone,Open Zone,0,9,2,11
5256,2023-01-12,MORTIS,gemGrab,Undermine,0,8,7,15
5257,2023-01-12,MORTIS,gemGrab,Gem Fort,0,3,2,5
5258,2023-01-12,MORTIS,brawlBall,Sunny Soccer,0,3,0,3
5259,2023-01-12,MORTIS,brawlBall,Pinhole Punt,0,67,55,122
5260,2023-01-11,MORTIS,knockout,Riverside,0,2,0,2
5261,2023-01-11,MORTIS,hotZone,Open Zone,0,1,1,2
5262,2023-01-11,MORTIS,gemGrab,Gem Fort,0,8,3,11
5263,2023-01-11,MORTIS,brawlBall,Sunny Soccer,0,47,46,93
5264,2023-01-11,MORTIS,brawlBall,Beach Ball,0,2,2,4
5265,2023-01-11,MORTIS,bounty,Excel,0,18,12,30
5266,2023-01-10,MORTIS,knockout,New Perspective,0,15,15,30
5267,2023-01-10,MORTIS,hotZone,Dueling Beetles,0,31,22,53
5268,2023-01-10,MORTIS,heist,Safe Zone,0,1,0,1
5269,2023-01-10,MORTIS,gemGrab,Minecart Madness,0,23,19,42
5270,2023-01-10,MORTIS,gemGrab,Crystal Arcade,0,52,30,82
5271,2023-01-10,MORTIS,brawlBall,Center Stage,0,26,34,60
5272,2023-01-10,MORTIS,brawlBall,Beach Ball,0,156,74,230
5273,2023-01-10,MORTIS,bounty,Excel,0,22,7,29
5274,2023-01-09,MORTIS,knockout,New Perspective,0,34,35,69
5275,2023-01-09,MORTIS,hotZone,Dueling Beetles,0,13,17,30
5276,2023-01-09,MORTIS,heist,Snaked Assault,0,1,1,2
5277,2023-01-09,MORTIS,gemGrab,Minecart Madness,0,44,14,58
5278,2023-01-09,MORTIS,gemGrab,Double Swoosh,0,24,15,39
5279,2023-01-09,MORTIS,brawlBall,Center Stage,3,142,120,265
5280,2023-01-09,MORTIS,brawlBall,Backyard Bowl,0,13,6,19
5281,2023-01-09,MORTIS,bounty,Layer Cake,0,77,110,187
5282,2023-01-08,MORTIS,knockout,X Marks the Spot,0,32,21,53
5283,2023-01-08,MORTIS,hotZone,Ring of Fire,0,8,1,9
5284,2023-01-08,MORTIS,heist,Snaked Assault,0,1,0,1
5285,2023-01-08,MORTIS,gemGrab,Hard Rock Mine,0,17,10,27
5286,2023-01-08,MORTIS,gemGrab,Double Swoosh,0,14,7,21
5287,2023-01-08,MORTIS,brawlBall,Super Beach,0,17,9,26
5288,2023-01-08,MORTIS,brawlBall,Backyard Bowl,1,169,71,241
5289,2023-01-08,MORTIS,bounty,Layer Cake,0,26,17,43
5290,2023-01-07,MORTIS,knockout,X Marks the Spot,0,15,11,26
5291,2023-01-07,MORTIS,hotZone,Ring of Fire,0,3,1,4
5292,2023-01-07,MORTIS,heist,Tornado Ring,0,2,0,2
5293,2023-01-07,MORTIS,gemGrab,Hard Rock Mine,0,36,15,51
5294,2023-01-07,MORTIS,gemGrab,Deep Diner,0,29,9,38
5295,2023-01-07,MORTIS,brawlBall,Super Beach,0,88,35,123
5296,2023-01-07,MORTIS,brawlBall,Sneaky Fields,0,12,2,14
5297,2023-01-07,MORTIS,bounty,Dry Season,0,56,38,94
5298,2023-01-06,MORTIS,knockout,Out in the Open,0,23,31,54
5299,2023-01-06,MORTIS,hotZone,Split,0,7,3,10
5300,2023-01-06,MORTIS,gemGrab,Undermine,0,9,17,26
5301,2023-01-06,MORTIS,gemGrab,Deep Diner,0,59,17,76
5302,2023-01-06,MORTIS,brawlBall,Sneaky Fields,0,88,36,124
5303,2023-01-06,MORTIS,brawlBall,Pinhole Punt,0,20,10,30
5304,2023-01-06,MORTIS,bounty,Dry Season,0,67,54,121
5305,2023-01-05,MORTIS,knockout,Out in the Open,1,50,20,71
5306,2023-01-05,MORTIS,hotZone,Split,0,9,2,11
5307,2023-01-05,MORTIS,heist,Kaboom Canyon,0,1,0,1
5308,2023-01-05,MORTIS,gemGrab,Undermine,0,38,28,66
5309,2023-01-05,MORTIS,gemGrab,Gem Fort,0,1,2,3
5310,2023-01-05,MORTIS,brawlBall,Sunny Soccer,0,4,1,5
5311,2023-01-05,MORTIS,brawlBall,Pinhole Punt,2,227,93,322
5312,2023-01-05,MORTIS,bounty,Shooting Star,0,20,29,49
5313,2023-01-04,MORTIS,knockout,Goldarm Gulch,0,15,13,28
5314,2023-01-04,MORTIS,hotZone,Parallel Plays,0,9,8,17
5315,2023-01-04,MORTIS,gemGrab,Gem Fort,0,49,18,67
5316,2023-01-04,MORTIS,gemGrab,Crystal Arcade,0,17,8,25
5317,2023-01-04,MORTIS,brawlBall,Sunny Soccer,2,171,77,250
5318,2023-01-04,MORTIS,brawlBall,Beach Ball,0,5,2,7
5319,2023-01-04,MORTIS,bounty,Shooting Star,0,59,51,110
5320,2023-01-03,MORTIS,knockout,Goldarm Gulch,0,17,7,24
5321,2023-01-03,MORTIS,hotZone,Parallel Plays,0,9,2,11
5322,2023-01-03,MORTIS,heist,Pit Stop,0,1,0,1
5323,2023-01-03,MORTIS,gemGrab,Minecart Madness,0,6,3,9
5324,2023-01-03,MORTIS,gemGrab,Crystal Arcade,0,57,26,83
5325,2023-01-03,MORTIS,brawlBall,Center Stage,0,15,5,20
5326,2023-01-03,MORTIS,brawlBall,Beach Ball,1,184,51,236
5327,2023-01-03,MORTIS,bounty,Hideout,0,50,65,115
5328,2023-01-02,MORTIS,knockout,Belle's Rock,0,45,34,79
5329,2023-01-02,MORTIS,hotZone,Quarter Pounder,0,15,11,26
5330,2023-01-02,MORTIS,gemGrab,Minecart Madness,0,55,11,66
5331,2023-01-02,MORTIS,gemGrab,Double Swoosh,0,21,4,25
5332,2023-01-02,MORTIS,brawlBall,Center Stage,2,165,53,220
5333,2023-01-02,MORTIS,brawlBall,Backyard Bowl,3,25,19,47
5334,2023-01-02,MORTIS,bounty,Hideout,0,93,68,161
5335,2023-01-01,MORTIS,knockout,Belle's Rock,0,17,9,26
5336,2023-01-01,MORTIS,hotZone,Quarter Pounder,0,7,12,19
5337,2023-01-01,MORTIS,hotZone,Controller Chaos,0,0,1,1
5338,2023-01-01,MORTIS,gemGrab,Minecart Madness,0,0,1,1
5339,2023-01-01,MORTIS,gemGrab,Hard Rock Mine,0,1,0,1
5340,2023-01-01,MORTIS,gemGrab,Double Swoosh,0,14,6,20
5341,2023-01-01,MORTIS,brawlBall,Backyard Bowl,1,106,32,139
5342,2023-01-01,MORTIS,bounty,Canal Grande,0,0,2,2
5343,2022-12-31,MORTIS,knockout,Flaring Phoenix,0,0,1,1
5344,2022-12-31,MORTIS,hotZone,Controller Chaos,0,1,0,1
5345,2022-12-31,MORTIS,gemGrab,Hard Rock Mine,0,13,4,17
5346,2022-12-31,MORTIS,gemGrab,Deep Diner,0,4,4,8
5347,2022-12-31,MORTIS,brawlBall,Super Beach,1,26,10,37
5348,2022-12-31,MORTIS,bounty,Canal Grande,0,1,0,1
5349,2022-12-30,MORTIS,knockout,Flaring Phoenix,0,3,2,5
5350,2022-12-30,MORTIS,hotZone,Controller Chaos,0,3,6,9
5351,2022-12-30,MORTIS,heist,Kaboom Canyon,0,1,0,1
5352,2022-12-30,MORTIS,gemGrab,Deep Diner,0,11,4,15
5353,2022-12-30,MORTIS,brawlBall,Sneaky Fields,0,19,10,29
5354,2022-12-29,MORTIS,hotZone,Open Zone,0,1,0,1
5355,2022-12-29,MORTIS,gemGrab,Undermine,0,1,1,2
5356,2022-12-29,MORTIS,gemGrab,Minecart Madness,0,1,1,2
5357,2022-12-29,MORTIS,brawlBall,Pinhole Punt,0,8,14,22
5358,2022-12-28,MORTIS,brawlBall,Sunny Soccer,0,4,4,8
5359,2022-12-27,MORTIS,gemGrab,Minecart Madness,0,0,2,2
5360,2022-12-27,MORTIS,brawlBall,Beach Ball,0,9,5,14
5361,2022-12-26,MORTIS,heist,Kaboom Canyon,0,0,2,2
5362,2022-12-26,MORTIS,gemGrab,Minecart Madness,0,1,5,6
5363,2022-12-26,MORTIS,brawlBall,Center Stage,0,5,2,7
5364,2022-12-25,MORTIS,brawlBall,Backyard Bowl,0,1,0,1
5365,2022-12-25,MORTIS,bounty,Layer Cake,0,1,1,2
5366,2022-12-24,MORTIS,brawlBall,Super Beach,0,2,2,4
5367,2022-12-24,MORTIS,bounty,Dry Season,0,1,0,1
5368,2022-12-23,MORTIS,knockout,Out in the Open,0,0,1,1
5369,2022-12-23,MORTIS,brawlBall,Sneaky Fields,0,0,1,1
5370,2022-12-22,MORTIS,gemGrab,Gem Fort,0,1,2,3
5371,2022-12-22,MORTIS,brawlBall,Pinhole Punt,0,5,0,5
5372,2022-12-21,MORTIS,brawlBall,Sunny Soccer,0,3,3,6
5373,2022-12-20,MORTIS,brawlBall,Beach Ball,0,5,6,11
5374,2022-12-19,MORTIS,brawlBall,Center Stage,0,7,5,12
5375,2022-12-17,MORTIS,knockout,Flaring Phoenix,0,4,4,8
5376,2022-12-16,MORTIS,brawlBall,Sneaky Fields,0,4,2,6
5377,2022-12-16,MORTIS,bounty,Temple Ruins,0,1,4,5
5378,2022-12-13,MORTIS,knockout,New Perspective,0,2,1,3
5379,2022-12-13,MORTIS,gemGrab,Crystal Arcade,0,2,1,3
5380,2022-12-13,MORTIS,brawlBall,Beach Ball,0,4,1,5
5381,2022-12-11,MORTIS,gemGrab,Double Swoosh,0,2,0,2
5382,2022-12-10,MORTIS,knockout,X Marks the Spot,0,1,1,2
5383,2022-11-11,MORTIS,brawlBall,Sneaky Fields,0,1,0,1
5384,2022-11-03,MORTIS,bounty,Temple Ruins,0,0,1,1
5385,2022-10-28,MORTIS,brawlBall,Beach Ball,0,1,0,1
5386,2022-10-26,MORTIS,brawlBall,Sunny Soccer,0,2,0,2
5387,2022-10-26,MORTIS,bounty,Shooting Star,0,0,1,1
5388,2022-10-15,MORTIS,hotZone,Ring of Fire,0,1,0,1
5389,2022-10-15,MORTIS,gemGrab,Hard Rock Mine,0,2,2,4
5390,2022-10-15,MORTIS,brawlBall,Super Beach,0,1,1,2
5391,2022-10-10,MORTIS,knockout,Belle's Rock,0,1,0,1
5392,2023-01-30,MEG,knockout,Belle's Rock,0,13,10,23
5393,2023-01-30,MEG,hotZone,Quarter Pounder,0,134,307,441
5394,2023-01-30,MEG,gemGrab,Minecart Madness,0,41,90,131
5395,2023-01-30,MEG,gemGrab,Double Swoosh,0,16,29,45
5396,2023-01-30,MEG,brawlBall,Center Stage,0,43,39,82
5397,2023-01-30,MEG,brawlBall,Backyard Bowl,2,33,54,89
5398,2023-01-30,MEG,bounty,Hideout,0,5,3,8
5399,2023-01-29,MEG,knockout,Belle's Rock,0,10,19,29
5400,2023-01-29,MEG,hotZone,Quarter Pounder,3,147,356,506
5401,2023-01-29,MEG,heist,Bridge Too Far,1,50,113,164
5402,2023-01-29,MEG,gemGrab,Hard Rock Mine,0,7,7,14
5403,2023-01-29,MEG,gemGrab,Double Swoosh,0,17,31,48
5404,2023-01-29,MEG,brawlBall,Super Beach,0,0,1,1
5405,2023-01-29,MEG,brawlBall,Backyard Bowl,22,344,504,870
5406,2023-01-29,MEG,bounty,Canal Grande,0,3,1,4
5407,2023-01-28,MEG,knockout,Flaring Phoenix,0,7,6,13
5408,2023-01-28,MEG,hotZone,Controller Chaos,0,71,62,133
5409,2023-01-28,MEG,heist,Bridge Too Far,2,179,218,399
5410,2023-01-28,MEG,gemGrab,Hard Rock Mine,0,56,52,108
5411,2023-01-28,MEG,gemGrab,Deep Diner,0,9,19,28
5412,2023-01-28,MEG,brawlBall,Super Beach,0,110,141,251
5413,2023-01-28,MEG,brawlBall,Sneaky Fields,0,1,1,2
5414,2023-01-28,MEG,bounty,Canal Grande,0,2,1,3
5415,2023-01-27,MEG,knockout,Flaring Phoenix,0,1,2,3
5416,2023-01-27,MEG,hotZone,Controller Chaos,0,16,16,32
5417,2023-01-27,MEG,heist,Hot Potato,0,8,5,13
5418,2023-01-27,MEG,gemGrab,Undermine,0,3,2,5
5419,2023-01-27,MEG,gemGrab,Deep Diner,0,14,12,26
5420,2023-01-27,MEG,brawlBall,Sneaky Fields,0,14,29,43
5421,2023-01-27,MEG,brawlBall,Pinhole Punt,0,1,0,1
5422,2023-01-27,MEG,bounty,Temple Ruins,0,4,3,7
5423,2023-01-26,MEG,knockout,Riverside,0,26,26,52
5424,2023-01-26,MEG,hotZone,Open Zone,0,213,473,686
5425,2023-01-26,MEG,heist,Hot Potato,0,6,5,11
5426,2023-01-26,MEG,gemGrab,Undermine,0,14,23,37
5427,2023-01-26,MEG,gemGrab,Gem Fort,0,8,6,14
5428,2023-01-26,MEG,brawlBall,Sunny Soccer,0,3,3,6
5429,2023-01-26,MEG,brawlBall,Pinhole Punt,8,213,250,471
5430,2023-01-26,MEG,bounty,Temple Ruins,0,9,8,17
5431,2023-01-25,MEG,knockout,Riverside,0,21,23,44
5432,2023-01-25,MEG,hotZone,Open Zone,0,150,249,399
5433,2023-01-25,MEG,heist,Safe Zone,0,22,25,47
5434,2023-01-25,MEG,gemGrab,Gem Fort,0,21,19,40
5435,2023-01-25,MEG,gemGrab,Crystal Arcade,0,19,10,29
5436,2023-01-25,MEG,brawlBall,Sunny Soccer,0,48,68,116
5437,2023-01-25,MEG,brawlBall,Beach Ball,1,11,13,25
5438,2023-01-25,MEG,bounty,Excel,0,0,1,1
5439,2023-01-24,MEG,knockout,New Perspective,0,13,22,35
5440,2023-01-24,MEG,hotZone,Dueling Beetles,0,130,381,511
5441,2023-01-24,MEG,heist,Safe Zone,0,33,46,79
5442,2023-01-24,MEG,gemGrab,Minecart Madness,0,37,47,84
5443,2023-01-24,MEG,gemGrab,Crystal Arcade,0,36,46,82
5444,2023-01-24,MEG,brawlBall,Center Stage,0,20,12,32
5445,2023-01-24,MEG,brawlBall,Beach Ball,4,108,148,260
5446,2023-01-24,MEG,bounty,Excel,0,3,8,11
5447,2023-01-23,MEG,knockout,New Perspective,0,14,9,23
5448,2023-01-23,MEG,hotZone,Dueling Beetles,0,305,536,841
5449,2023-01-23,MEG,heist,Snaked Assault,0,13,15,28
5450,2023-01-23,MEG,gemGrab,Minecart Madness,0,65,111,176
5451,2023-01-23,MEG,gemGrab,Double Swoosh,0,16,10,26
5452,2023-01-23,MEG,brawlBall,Center Stage,2,108,130,240
5453,2023-01-23,MEG,brawlBall,Backyard Bowl,0,29,37,66
5454,2023-01-23,MEG,bounty,Layer Cake,0,8,10,18
5455,2023-01-22,MEG,knockout,X Marks the Spot,0,4,5,9
5456,2023-01-22,MEG,hotZone,Ring of Fire,0,70,137,207
5457,2023-01-22,MEG,heist,Snaked Assault,0,4,1,5
5458,2023-01-22,MEG,gemGrab,Hard Rock Mine,0,0,6,6
5459,2023-01-22,MEG,gemGrab,Double Swoosh,0,25,22,47
5460,2023-01-22,MEG,brawlBall,Super Beach,1,11,13,25
5461,2023-01-22,MEG,brawlBall,Backyard Bowl,10,152,215,377
5462,2023-01-22,MEG,bounty,Layer Cake,0,1,2,3
5463,2023-01-21,MEG,knockout,X Marks the Spot,0,27,50,77
5464,2023-01-21,MEG,hotZone,Ring of Fire,1,260,448,709
5465,2023-01-21,MEG,heist,Tornado Ring,1,14,14,29
5466,2023-01-21,MEG,gemGrab,Hard Rock Mine,0,31,32,63
5467,2023-01-21,MEG,gemGrab,Deep Diner,0,5,12,17
5468,2023-01-21,MEG,brawlBall,Super Beach,4,100,119,223
5469,2023-01-21,MEG,brawlBall,Sneaky Fields,0,2,3,5
5470,2023-01-21,MEG,bounty,Dry Season,0,10,5,15
5471,2023-01-20,MEG,knockout,Out in the Open,0,17,32,49
5472,2023-01-20,MEG,hotZone,Split,0,7,6,13
5473,2023-01-20,MEG,heist,Tornado Ring,0,11,7,18
5474,2023-01-20,MEG,gemGrab,Undermine,0,12,18,30
5475,2023-01-20,MEG,gemGrab,Deep Diner,0,39,67,106
5476,2023-01-20,MEG,brawlBall,Sneaky Fields,1,57,66,124
5477,2023-01-20,MEG,brawlBall,Pinhole Punt,0,12,11,23
5478,2023-01-20,MEG,bounty,Dry Season,0,15,11,26
5479,2023-01-19,MEG,knockout,Out in the Open,0,39,31,70
5480,2023-01-19,MEG,hotZone,Split,0,11,9,20
5481,2023-01-19,MEG,heist,Kaboom Canyon,0,20,49,69
5482,2023-01-19,MEG,gemGrab,Undermine,0,27,32,59
5483,2023-01-19,MEG,gemGrab,Gem Fort,0,6,5,11
5484,2023-01-19,MEG,brawlBall,Sunny Soccer,0,3,0,3
5485,2023-01-19,MEG,brawlBall,Pinhole Punt,5,196,269,470
5486,2023-01-19,MEG,bounty,Shooting Star,0,12,14,26
5487,2023-01-18,MEG,knockout,Goldarm Gulch,0,3,1,4
5488,2023-01-18,MEG,hotZone,Parallel Plays,0,4,0,4
5489,2023-01-18,MEG,heist,Kaboom Canyon,0,9,28,37
5490,2023-01-18,MEG,gemGrab,Gem Fort,0,6,6,12
5491,2023-01-18,MEG,gemGrab,Crystal Arcade,0,2,5,7
5492,2023-01-18,MEG,brawlBall,Sunny Soccer,2,18,28,48
5493,2023-01-18,MEG,brawlBall,Beach Ball,0,4,0,4
5494,2023-01-18,MEG,bounty,Shooting Star,0,7,15,22
5495,2023-01-17,MEG,knockout,Goldarm Gulch,0,0,1,1
5496,2023-01-17,MEG,hotZone,Parallel Plays,0,2,1,3
5497,2023-01-17,MEG,gemGrab,Minecart Madness,0,2,2,4
5498,2023-01-17,MEG,gemGrab,Crystal Arcade,0,2,3,5
5499,2023-01-17,MEG,brawlBall,Beach Ball,0,17,16,33
5500,2023-01-17,MEG,bounty,Hideout,0,0,2,2
5501,2023-01-16,MEG,knockout,Belle's Rock,0,1,0,1
5502,2023-01-16,MEG,hotZone,Quarter Pounder,0,9,57,66
5503,2023-01-16,MEG,gemGrab,Minecart Madness,0,5,12,17
5504,2023-01-16,MEG,gemGrab,Double Swoosh,0,1,0,1
5505,2023-01-16,MEG,brawlBall,Center Stage,0,3,2,5
5506,2023-01-16,MEG,brawlBall,Backyard Bowl,0,3,13,16
5507,2023-01-16,MEG,bounty,Hideout,0,2,0,2
5508,2023-01-15,MEG,knockout,Belle's Rock,0,1,1,2
5509,2023-01-15,MEG,hotZone,Quarter Pounder,0,36,120,156
5510,2023-01-15,MEG,heist,Bridge Too Far,0,26,42,68
5511,2023-01-15,MEG,gemGrab,Double Swoosh,0,3,7,10
5512,2023-01-15,MEG,brawlBall,Backyard Bowl,1,48,54,103
5513,2023-01-14,MEG,knockout,Flaring Phoenix,0,1,2,3
5514,2023-01-14,MEG,hotZone,Controller Chaos,0,6,34,40
5515,2023-01-14,MEG,heist,Bridge Too Far,0,15,51,66
5516,2023-01-14,MEG,gemGrab,Hard Rock Mine,0,1,0,1
5517,2023-01-14,MEG,gemGrab,Deep Diner,0,3,0,3
5518,2023-01-14,MEG,brawlBall,Super Beach,0,7,9,16
5519,2023-01-14,MEG,brawlBall,Sneaky Fields,0,3,0,3
5520,2023-01-13,MEG,knockout,Flaring Phoenix,0,0,1,1
5521,2023-01-13,MEG,hotZone,Controller Chaos,0,12,26,38
5522,2023-01-13,MEG,gemGrab,Deep Diner,0,1,1,2
5523,2023-01-13,MEG,brawlBall,Sneaky Fields,0,2,0,2
5524,2023-01-13,MEG,brawlBall,Pinhole Punt,0,0,1,1
5525,2023-01-13,MEG,bounty,Temple Ruins,0,0,1,1
5526,2023-01-12,MEG,knockout,Riverside,0,1,0,1
5527,2023-01-12,MEG,hotZone,Open Zone,0,13,69,82
5528,2023-01-12,MEG,brawlBall,Pinhole Punt,0,5,10,15
5529,2023-01-11,MEG,knockout,Riverside,0,4,3,7
5530,2023-01-11,MEG,hotZone,Open Zone,0,16,27,43
5531,2023-01-11,MEG,brawlBall,Sunny Soccer,0,2,1,3
5532,2023-01-10,MEG,hotZone,Dueling Beetles,0,20,54,74
5533,2023-01-10,MEG,heist,Safe Zone,0,2,4,6
5534,2023-01-10,MEG,gemGrab,Minecart Madness,0,2,18,20
5535,2023-01-10,MEG,gemGrab,Crystal Arcade,0,1,0,1
5536,2023-01-10,MEG,brawlBall,Beach Ball,0,17,41,58
5537,2023-01-09,MEG,knockout,New Perspective,0,0,1,1
5538,2023-01-09,MEG,hotZone,Dueling Beetles,0,9,31,40
5539,2023-01-09,MEG,heist,Snaked Assault,0,3,0,3
5540,2023-01-09,MEG,gemGrab,Minecart Madness,0,7,29,36
5541,2023-01-09,MEG,gemGrab,Double Swoosh,0,1,1,2
5542,2023-01-09,MEG,brawlBall,Center Stage,0,1,0,1
5543,2023-01-09,MEG,brawlBall,Backyard Bowl,1,4,10,15
5544,2023-01-09,MEG,bounty,Layer Cake,0,1,2,3
5545,2023-01-08,MEG,knockout,X Marks the Spot,0,4,3,7
5546,2023-01-08,MEG,hotZone,Ring of Fire,0,23,42,65
5547,2023-01-08,MEG,heist,Snaked Assault,0,1,0,1
5548,2023-01-08,MEG,gemGrab,Hard Rock Mine,0,1,1,2
5549,2023-01-08,MEG,gemGrab,Double Swoosh,0,1,0,1
5550,2023-01-08,MEG,brawlBall,Super Beach,0,0,4,4
5551,2023-01-08,MEG,brawlBall,Backyard Bowl,0,25,29,54
5552,2023-01-08,MEG,bounty,Layer Cake,0,1,0,1
5553,2023-01-07,MEG,hotZone,Ring of Fire,0,19,39,58
5554,2023-01-07,MEG,brawlBall,Sneaky Fields,0,0,3,3
5555,2023-01-07,MEG,bounty,Dry Season,0,0,3,3
5556,2023-01-06,MEG,gemGrab,Undermine,0,2,1,3
5557,2023-01-06,MEG,brawlBall,Sneaky Fields,0,5,2,7
5558,2023-01-06,MEG,brawlBall,Pinhole Punt,0,0,2,2
5559,2023-01-06,MEG,bounty,Dry Season,0,0,1,1
5560,2023-01-05,MEG,knockout,Out in the Open,0,5,2,7
5561,2023-01-05,MEG,hotZone,Split,0,1,0,1
5562,2023-01-05,MEG,heist,Kaboom Canyon,0,5,12,17
5563,2023-01-05,MEG,gemGrab,Undermine,0,3,5,8
5564,2023-01-05,MEG,gemGrab,Gem Fort,0,0,1,1
5565,2023-01-05,MEG,brawlBall,Pinhole Punt,1,9,25,35
5566,2023-01-05,MEG,bounty,Shooting Star,0,0,1,1
5567,2023-01-04,MEG,hotZone,Parallel Plays,0,0,3,3
5568,2023-01-04,MEG,heist,Kaboom Canyon,0,3,8,11
5569,2023-01-04,MEG,gemGrab,Gem Fort,0,1,0,1
5570,2023-01-04,MEG,gemGrab,Crystal Arcade,0,1,0,1
5571,2023-01-04,MEG,brawlBall,Sunny Soccer,0,1,0,1
5572,2023-01-04,MEG,bounty,Shooting Star,0,1,1,2
5573,2023-01-03,MEG,knockout,Goldarm Gulch,0,1,0,1
5574,2023-01-03,MEG,hotZone,Parallel Plays,0,1,0,1
5575,2023-01-03,MEG,gemGrab,Minecart Madness,0,2,17,19
5576,2023-01-03,MEG,gemGrab,Crystal Arcade,0,3,0,3
5577,2023-01-03,MEG,brawlBall,Beach Ball,0,4,1,5
5578,2023-01-03,MEG,bounty,Hideout,0,1,0,1
5579,2023-01-02,MEG,knockout,Belle's Rock,0,1,0,1
5580,2023-01-02,MEG,hotZone,Quarter Pounder,0,24,33,57
5581,2023-01-02,MEG,gemGrab,Minecart Madness,0,9,15,24
5582,2023-01-02,MEG,gemGrab,Double Swoosh,0,1,0,1
5583,2023-01-02,MEG,brawlBall,Center Stage,0,3,0,3
5584,2023-01-02,MEG,brawlBall,Backyard Bowl,0,1,0,1
5585,2023-01-02,MEG,bounty,Hideout,0,2,1,3
5586,2023-01-01,MEG,knockout,Belle's Rock,0,1,6,7
5587,2023-01-01,MEG,hotZone,Quarter Pounder,0,12,19,31
5588,2023-01-01,MEG,heist,Bridge Too Far,0,1,1,2
5589,2023-01-01,MEG,brawlBall,Backyard Bowl,0,13,5,18
5590,2022-12-31,MEG,gemGrab,Hard Rock Mine,0,0,3,3
5591,2022-12-31,MEG,brawlBall,Super Beach,0,0,8,8
5592,2022-12-30,MEG,hotZone,Controller Chaos,0,6,15,21
5593,2022-12-30,MEG,heist,Kaboom Canyon,0,1,1,2
5594,2022-12-30,MEG,gemGrab,Minecart Madness,0,0,1,1
5595,2022-12-30,MEG,gemGrab,Deep Diner,0,2,0,2
5596,2022-12-30,MEG,brawlBall,Sneaky Fields,0,0,1,1
5597,2022-12-29,MEG,hotZone,Open Zone,0,1,1,2
5598,2022-12-29,MEG,brawlBall,Pinhole Punt,0,0,1,1
5599,2022-12-27,MEG,heist,Kaboom Canyon,0,0,1,1
5600,2022-12-27,MEG,gemGrab,Minecart Madness,0,0,1,1
5601,2022-12-27,MEG,brawlBall,Beach Ball,0,2,1,3
5602,2022-12-26,MEG,gemGrab,Minecart Madness,0,0,1,1
5603,2022-12-22,MEG,brawlBall,Pinhole Punt,0,0,1,1
5604,2022-12-11,MEG,brawlBall,Backyard Bowl,0,0,1,1
5605,2022-12-10,MEG,gemGrab,Hard Rock Mine,0,1,0,1
5606,2023-01-30,MAX,knockout,Belle's Rock,0,134,179,313
5607,2023-01-30,MAX,hotZone,Quarter Pounder,0,101,75,176
5608,2023-01-30,MAX,heist,Pit Stop,0,34,32,66
5609,2023-01-30,MAX,gemGrab,Minecart Madness,0,132,149,281
5610,2023-01-30,MAX,gemGrab,Double Swoosh,0,80,68,148
5611,2023-01-30,MAX,brawlBall,Center Stage,10,458,519,987
5612,2023-01-30,MAX,brawlBall,Backyard Bowl,6,135,155,296
5613,2023-01-30,MAX,bounty,Hideout,0,61,76,137
5614,2023-01-29,MAX,knockout,Belle's Rock,0,142,103,245
5615,2023-01-29,MAX,hotZone,Quarter Pounder,0,72,99,171
5616,2023-01-29,MAX,heist,Bridge Too Far,0,205,219,424
5617,2023-01-29,MAX,gemGrab,Hard Rock Mine,0,41,17,58
5618,2023-01-29,MAX,gemGrab,Double Swoosh,0,115,104,219
5619,2023-01-29,MAX,brawlBall,Super Beach,0,17,8,25
5620,2023-01-29,MAX,brawlBall,Backyard Bowl,72,1451,1473,2996
5621,2023-01-29,MAX,bounty,Canal Grande,0,17,24,41
5622,2023-01-28,MAX,knockout,Flaring Phoenix,0,28,49,77
5623,2023-01-28,MAX,hotZone,Controller Chaos,0,44,66,110
5624,2023-01-28,MAX,heist,Bridge Too Far,1,544,582,1127
5625,2023-01-28,MAX,gemGrab,Hard Rock Mine,0,200,232,432
5626,2023-01-28,MAX,gemGrab,Deep Diner,0,61,61,122
5627,2023-01-28,MAX,brawlBall,Super Beach,30,1047,1123,2200
5628,2023-01-28,MAX,brawlBall,Sneaky Fields,0,35,45,80
5629,2023-01-28,MAX,bounty,Canal Grande,0,41,42,83
5630,2023-01-27,MAX,knockout,Flaring Phoenix,0,23,6,29
5631,2023-01-27,MAX,hotZone,Controller Chaos,0,13,7,20
5632,2023-01-27,MAX,heist,Hot Potato,0,13,12,25
5633,2023-01-27,MAX,gemGrab,Undermine,0,11,17,28
5634,2023-01-27,MAX,gemGrab,Deep Diner,0,70,66,136
5635,2023-01-27,MAX,brawlBall,Sneaky Fields,6,244,321,571
5636,2023-01-27,MAX,brawlBall,Pinhole Punt,0,12,12,24
5637,2023-01-27,MAX,bounty,Temple Ruins,0,26,21,47
5638,2023-01-26,MAX,knockout,Riverside,0,121,101,222
5639,2023-01-26,MAX,hotZone,Open Zone,0,151,159,310
5640,2023-01-26,MAX,heist,Hot Potato,0,41,32,73
5641,2023-01-26,MAX,gemGrab,Undermine,0,98,123,221
5642,2023-01-26,MAX,gemGrab,Gem Fort,0,43,46,89
5643,2023-01-26,MAX,brawlBall,Sunny Soccer,1,49,53,103
5644,2023-01-26,MAX,brawlBall,Pinhole Punt,34,1131,1177,2342
5645,2023-01-26,MAX,bounty,Temple Ruins,0,48,52,100
5646,2023-01-25,MAX,knockout,Riverside,0,66,66,132
5647,2023-01-25,MAX,hotZone,Open Zone,0,87,63,150
5648,2023-01-25,MAX,heist,Safe Zone,1,88,105,194
5649,2023-01-25,MAX,gemGrab,Gem Fort,0,42,47,89
5650,2023-01-25,MAX,gemGrab,Crystal Arcade,0,104,123,227
5651,2023-01-25,MAX,brawlBall,Sunny Soccer,11,495,551,1057
5652,2023-01-25,MAX,brawlBall,Beach Ball,1,81,128,210
5653,2023-01-25,MAX,bounty,Excel,0,22,39,61
5654,2023-01-24,MAX,knockout,New Perspective,0,84,41,125
5655,2023-01-24,MAX,hotZone,Dueling Beetles,0,46,34,80
5656,2023-01-24,MAX,heist,Safe Zone,0,216,245,461
5657,2023-01-24,MAX,gemGrab,Minecart Madness,0,26,35,61
5658,2023-01-24,MAX,gemGrab,Crystal Arcade,0,154,231,385
5659,2023-01-24,MAX,brawlBall,Center Stage,1,74,91,166
5660,2023-01-24,MAX,brawlBall,Beach Ball,33,882,998,1913
5661,2023-01-24,MAX,bounty,Excel,0,67,68,135
5662,2023-01-23,MAX,knockout,New Perspective,0,113,85,198
5663,2023-01-23,MAX,hotZone,Dueling Beetles,0,94,103,197
5664,2023-01-23,MAX,heist,Snaked Assault,0,91,157,248
5665,2023-01-23,MAX,gemGrab,Minecart Madness,0,184,242,426
5666,2023-01-23,MAX,gemGrab,Double Swoosh,0,51,59,110
5667,2023-01-23,MAX,brawlBall,Center Stage,24,860,957,1841
5668,2023-01-23,MAX,brawlBall,Backyard Bowl,3,98,95,196
5669,2023-01-23,MAX,bounty,Layer Cake,0,63,94,157
5670,2023-01-22,MAX,knockout,X Marks the Spot,0,75,68,143
5671,2023-01-22,MAX,hotZone,Ring of Fire,0,44,25,69
5672,2023-01-22,MAX,heist,Snaked Assault,0,49,43,92
5673,2023-01-22,MAX,gemGrab,Hard Rock Mine,0,44,59,103
5674,2023-01-22,MAX,gemGrab,Double Swoosh,0,54,66,120
5675,2023-01-22,MAX,brawlBall,Super Beach,2,126,168,296
5676,2023-01-22,MAX,brawlBall,Backyard Bowl,28,671,695,1394
5677,2023-01-22,MAX,bounty,Layer Cake,0,29,41,70
5678,2023-01-21,MAX,knockout,X Marks the Spot,1,215,177,393
5679,2023-01-21,MAX,hotZone,Ring of Fire,0,103,65,168
5680,2023-01-21,MAX,heist,Tornado Ring,0,31,33,64
5681,2023-01-21,MAX,gemGrab,Hard Rock Mine,0,240,254,494
5682,2023-01-21,MAX,gemGrab,Deep Diner,0,31,49,80
5683,2023-01-21,MAX,brawlBall,Super Beach,40,1255,1285,2580
5684,2023-01-21,MAX,brawlBall,Sneaky Fields,1,41,52,94
5685,2023-01-21,MAX,bounty,Dry Season,0,136,120,256
5686,2023-01-20,MAX,knockout,Out in the Open,0,169,153,322
5687,2023-01-20,MAX,hotZone,Split,0,21,10,31
5688,2023-01-20,MAX,heist,Tornado Ring,0,45,30,75
5689,2023-01-20,MAX,gemGrab,Undermine,0,51,51,102
5690,2023-01-20,MAX,gemGrab,Deep Diner,0,180,136,316
5691,2023-01-20,MAX,brawlBall,Sneaky Fields,7,651,754,1412
5692,2023-01-20,MAX,brawlBall,Pinhole Punt,1,27,41,69
5693,2023-01-20,MAX,bounty,Dry Season,0,113,106,219
5694,2023-01-19,MAX,knockout,Out in the Open,1,192,111,304
5695,2023-01-19,MAX,hotZone,Split,0,17,18,35
5696,2023-01-19,MAX,heist,Kaboom Canyon,1,76,99,176
5697,2023-01-19,MAX,gemGrab,Undermine,0,91,108,199
5698,2023-01-19,MAX,gemGrab,Gem Fort,0,25,47,72
5699,2023-01-19,MAX,brawlBall,Sunny Soccer,0,15,47,62
5700,2023-01-19,MAX,brawlBall,Pinhole Punt,25,1128,1206,2359
5701,2023-01-19,MAX,bounty,Shooting Star,0,157,186,343
5702,2023-01-18,MAX,knockout,Goldarm Gulch,0,10,23,33
5703,2023-01-18,MAX,hotZone,Parallel Plays,0,4,6,10
5704,2023-01-18,MAX,heist,Kaboom Canyon,0,37,52,89
5705,2023-01-18,MAX,gemGrab,Gem Fort,0,9,13,22
5706,2023-01-18,MAX,gemGrab,Crystal Arcade,0,6,1,7
5707,2023-01-18,MAX,brawlBall,Sunny Soccer,3,193,219,415
5708,2023-01-18,MAX,brawlBall,Beach Ball,0,11,18,29
5709,2023-01-18,MAX,bounty,Shooting Star,0,72,62,134
5710,2023-01-17,MAX,knockout,Goldarm Gulch,0,9,5,14
5711,2023-01-17,MAX,hotZone,Parallel Plays,0,1,2,3
5712,2023-01-17,MAX,gemGrab,Minecart Madness,0,2,3,5
5713,2023-01-17,MAX,gemGrab,Crystal Arcade,0,13,8,21
5714,2023-01-17,MAX,brawlBall,Center Stage,0,2,5,7
5715,2023-01-17,MAX,brawlBall,Beach Ball,2,42,64,108
5716,2023-01-17,MAX,bounty,Hideout,0,12,12,24
5717,2023-01-16,MAX,knockout,Belle's Rock,0,15,8,23
5718,2023-01-16,MAX,hotZone,Quarter Pounder,0,8,7,15
5719,2023-01-16,MAX,heist,Pit Stop,0,14,7,21
5720,2023-01-16,MAX,gemGrab,Minecart Madness,0,19,14,33
5721,2023-01-16,MAX,gemGrab,Double Swoosh,0,8,3,11
5722,2023-01-16,MAX,brawlBall,Center Stage,1,41,66,108
5723,2023-01-16,MAX,brawlBall,Backyard Bowl,0,21,8,29
5724,2023-01-16,MAX,bounty,Hideout,0,27,21,48
5725,2023-01-15,MAX,knockout,Belle's Rock,0,29,21,50
5726,2023-01-15,MAX,hotZone,Quarter Pounder,0,16,33,49
5727,2023-01-15,MAX,heist,Bridge Too Far,0,50,52,102
5728,2023-01-15,MAX,gemGrab,Hard Rock Mine,0,14,20,34
5729,2023-01-15,MAX,gemGrab,Double Swoosh,0,16,29,45
5730,2023-01-15,MAX,brawlBall,Super Beach,0,16,12,28
5731,2023-01-15,MAX,brawlBall,Backyard Bowl,4,189,246,439
5732,2023-01-15,MAX,bounty,Canal Grande,0,2,3,5
5733,2023-01-14,MAX,knockout,Flaring Phoenix,0,5,2,7
5734,2023-01-14,MAX,hotZone,Controller Chaos,0,9,1,10
5735,2023-01-14,MAX,heist,Bridge Too Far,0,91,52,143
5736,2023-01-14,MAX,gemGrab,Hard Rock Mine,0,21,15,36
5737,2023-01-14,MAX,gemGrab,Deep Diner,0,9,23,32
5738,2023-01-14,MAX,brawlBall,Super Beach,4,98,157,259
5739,2023-01-14,MAX,brawlBall,Sneaky Fields,0,17,17,34
5740,2023-01-14,MAX,bounty,Canal Grande,0,0,2,2
5741,2023-01-13,MAX,knockout,Flaring Phoenix,0,7,4,11
5742,2023-01-13,MAX,hotZone,Controller Chaos,0,4,1,5
5743,2023-01-13,MAX,heist,Hot Potato,0,1,2,3
5744,2023-01-13,MAX,gemGrab,Deep Diner,0,19,21,40
5745,2023-01-13,MAX,brawlBall,Sneaky Fields,0,88,74,162
5746,2023-01-13,MAX,brawlBall,Pinhole Punt,0,1,2,3
5747,2023-01-13,MAX,bounty,Temple Ruins,0,6,4,10
5748,2023-01-12,MAX,knockout,Riverside,0,18,17,35
5749,2023-01-12,MAX,hotZone,Open Zone,0,24,13,37
5750,2023-01-12,MAX,heist,Hot Potato,0,0,1,1
5751,2023-01-12,MAX,gemGrab,Undermine,0,4,2,6
5752,2023-01-12,MAX,gemGrab,Gem Fort,0,1,0,1
5753,2023-01-12,MAX,brawlBall,Sunny Soccer,0,1,1,2
5754,2023-01-12,MAX,brawlBall,Pinhole Punt,0,54,75,129
5755,2023-01-12,MAX,bounty,Temple Ruins,0,1,0,1
5756,2023-01-11,MAX,knockout,Riverside,0,2,1,3
5757,2023-01-11,MAX,hotZone,Open Zone,0,8,1,9
5758,2023-01-11,MAX,gemGrab,Gem Fort,0,3,1,4
5759,2023-01-11,MAX,brawlBall,Sunny Soccer,2,27,31,60
5760,2023-01-11,MAX,bounty,Excel,0,1,0,1
5761,2023-01-10,MAX,knockout,New Perspective,0,4,1,5
5762,2023-01-10,MAX,hotZone,Dueling Beetles,0,13,30,43
5763,2023-01-10,MAX,heist,Safe Zone,0,9,11,20
5764,2023-01-10,MAX,gemGrab,Minecart Madness,0,8,1,9
5765,2023-01-10,MAX,gemGrab,Crystal Arcade,0,23,27,50
5766,2023-01-10,MAX,brawlBall,Center Stage,0,3,0,3
5767,2023-01-10,MAX,brawlBall,Beach Ball,4,51,60,115
5768,2023-01-10,MAX,bounty,Excel,0,3,0,3
5769,2023-01-09,MAX,knockout,New Perspective,0,2,4,6
5770,2023-01-09,MAX,hotZone,Dueling Beetles,0,7,4,11
5771,2023-01-09,MAX,heist,Snaked Assault,0,25,18,43
5772,2023-01-09,MAX,gemGrab,Minecart Madness,0,21,14,35
5773,2023-01-09,MAX,gemGrab,Double Swoosh,0,10,12,22
5774,2023-01-09,MAX,brawlBall,Center Stage,0,55,63,118
5775,2023-01-09,MAX,brawlBall,Backyard Bowl,2,11,12,25
5776,2023-01-09,MAX,bounty,Layer Cake,0,19,30,49
5777,2023-01-08,MAX,knockout,X Marks the Spot,0,14,6,20
5778,2023-01-08,MAX,hotZone,Ring of Fire,0,19,7,26
5779,2023-01-08,MAX,heist,Snaked Assault,0,6,7,13
5780,2023-01-08,MAX,gemGrab,Hard Rock Mine,0,8,7,15
5781,2023-01-08,MAX,gemGrab,Double Swoosh,0,8,9,17
5782,2023-01-08,MAX,brawlBall,Super Beach,0,14,26,40
5783,2023-01-08,MAX,brawlBall,Backyard Bowl,4,168,191,363
5784,2023-01-08,MAX,bounty,Layer Cake,0,2,0,2
5785,2023-01-07,MAX,knockout,X Marks the Spot,0,9,8,17
5786,2023-01-07,MAX,hotZone,Ring of Fire,0,3,3,6
5787,2023-01-07,MAX,heist,Tornado Ring,0,7,0,7
5788,2023-01-07,MAX,gemGrab,Hard Rock Mine,0,14,11,25
5789,2023-01-07,MAX,gemGrab,Deep Diner,0,13,14,27
5790,2023-01-07,MAX,brawlBall,Super Beach,2,52,93,147
5791,2023-01-07,MAX,brawlBall,Sneaky Fields,0,4,4,8
5792,2023-01-07,MAX,bounty,Dry Season,0,17,18,35
5793,2023-01-06,MAX,knockout,Out in the Open,0,13,7,20
5794,2023-01-06,MAX,hotZone,Split,0,3,0,3
5795,2023-01-06,MAX,heist,Tornado Ring,0,8,10,18
5796,2023-01-06,MAX,gemGrab,Undermine,0,8,20,28
5797,2023-01-06,MAX,gemGrab,Deep Diner,0,16,32,48
5798,2023-01-06,MAX,brawlBall,Sneaky Fields,0,54,101,155
5799,2023-01-06,MAX,brawlBall,Pinhole Punt,0,9,14,23
5800,2023-01-06,MAX,bounty,Dry Season,0,43,42,85
5801,2023-01-05,MAX,knockout,Out in the Open,0,34,38,72
5802,2023-01-05,MAX,hotZone,Split,0,3,0,3
5803,2023-01-05,MAX,heist,Kaboom Canyon,0,11,32,43
5804,2023-01-05,MAX,gemGrab,Undermine,0,19,34,53
5805,2023-01-05,MAX,gemGrab,Gem Fort,0,4,0,4
5806,2023-01-05,MAX,brawlBall,Sunny Soccer,0,2,0,2
5807,2023-01-05,MAX,brawlBall,Pinhole Punt,5,151,129,285
5808,2023-01-05,MAX,bounty,Shooting Star,0,27,22,49
5809,2023-01-04,MAX,knockout,Goldarm Gulch,0,6,8,14
5810,2023-01-04,MAX,hotZone,Parallel Plays,0,7,1,8
5811,2023-01-04,MAX,heist,Kaboom Canyon,0,17,12,29
5812,2023-01-04,MAX,gemGrab,Gem Fort,0,12,14,26
5813,2023-01-04,MAX,gemGrab,Crystal Arcade,0,5,1,6
5814,2023-01-04,MAX,brawlBall,Sunny Soccer,2,91,67,160
5815,2023-01-04,MAX,brawlBall,Beach Ball,0,1,3,4
5816,2023-01-04,MAX,bounty,Shooting Star,0,82,41,123
5817,2023-01-03,MAX,knockout,Goldarm Gulch,0,3,2,5
5818,2023-01-03,MAX,hotZone,Parallel Plays,0,4,0,4
5819,2023-01-03,MAX,heist,Pit Stop,0,1,1,2
5820,2023-01-03,MAX,gemGrab,Minecart Madness,0,6,2,8
5821,2023-01-03,MAX,gemGrab,Crystal Arcade,0,17,22,39
5822,2023-01-03,MAX,brawlBall,Center Stage,0,5,0,5
5823,2023-01-03,MAX,brawlBall,Beach Ball,0,76,89,165
5824,2023-01-03,MAX,bounty,Hideout,0,37,59,96
5825,2023-01-02,MAX,knockout,Belle's Rock,0,20,28,48
5826,2023-01-02,MAX,hotZone,Quarter Pounder,0,29,58,87
5827,2023-01-02,MAX,heist,Pit Stop,0,5,0,5
5828,2023-01-02,MAX,heist,Kaboom Canyon,0,1,0,1
5829,2023-01-02,MAX,gemGrab,Minecart Madness,0,31,35,66
5830,2023-01-02,MAX,gemGrab,Double Swoosh,0,10,14,24
5831,2023-01-02,MAX,brawlBall,Center Stage,1,59,60,120
5832,2023-01-02,MAX,brawlBall,Backyard Bowl,0,10,9,19
5833,2023-01-02,MAX,bounty,Hideout,0,62,52,114
5834,2023-01-01,MAX,knockout,Belle's Rock,0,5,5,10
5835,2023-01-01,MAX,hotZone,Quarter Pounder,0,5,5,10
5836,2023-01-01,MAX,heist,Bridge Too Far,0,7,10,17
5837,2023-01-01,MAX,gemGrab,Hard Rock Mine,0,4,3,7
5838,2023-01-01,MAX,gemGrab,Double Swoosh,0,18,3,21
5839,2023-01-01,MAX,brawlBall,Backyard Bowl,0,86,88,174
5840,2023-01-01,MAX,bounty,Canal Grande,0,1,3,4
5841,2022-12-31,MAX,heist,Kaboom Canyon,0,1,0,1
5842,2022-12-31,MAX,heist,Bridge Too Far,0,4,3,7
5843,2022-12-31,MAX,gemGrab,Hard Rock Mine,0,7,4,11
5844,2022-12-31,MAX,gemGrab,Deep Diner,0,1,0,1
5845,2022-12-31,MAX,brawlBall,Super Beach,0,10,22,32
5846,2022-12-31,MAX,brawlBall,Sneaky Fields,0,4,7,11
5847,2022-12-30,MAX,knockout,Flaring Phoenix,0,1,0,1
5848,2022-12-30,MAX,hotZone,Controller Chaos,0,6,4,10
5849,2022-12-30,MAX,gemGrab,Minecart Madness,0,1,0,1
5850,2022-12-30,MAX,gemGrab,Deep Diner,0,7,6,13
5851,2022-12-30,MAX,brawlBall,Sneaky Fields,0,5,4,9
5852,2022-12-29,MAX,heist,Kaboom Canyon,0,0,1,1
5853,2022-12-29,MAX,gemGrab,Undermine,0,2,0,2
5854,2022-12-29,MAX,gemGrab,Minecart Madness,0,1,0,1
5855,2022-12-29,MAX,brawlBall,Pinhole Punt,0,5,4,9
5856,2022-12-28,MAX,hotZone,Open Zone,0,1,1,2
5857,2022-12-28,MAX,brawlBall,Sunny Soccer,0,1,1,2
5858,2022-12-27,MAX,brawlBall,Center Stage,0,1,0,1
5859,2022-12-27,MAX,brawlBall,Beach Ball,0,4,1,5
5860,2022-12-26,MAX,hotZone,Controller Chaos,0,1,0,1
5861,2022-12-26,MAX,gemGrab,Minecart Madness,0,0,1,1
5862,2022-12-26,MAX,brawlBall,Center Stage,0,0,2,2
5863,2022-12-25,MAX,brawlBall,Backyard Bowl,0,1,1,2
5864,2022-12-24,MAX,brawlBall,Super Beach,0,2,0,2
5865,2022-12-23,MAX,knockout,Out in the Open,0,1,0,1
5866,2022-12-23,MAX,brawlBall,Sneaky Fields,0,1,0,1
5867,2022-12-22,MAX,gemGrab,Gem Fort,0,2,0,2
5868,2022-12-22,MAX,brawlBall,Pinhole Punt,0,2,1,3
5869,2022-12-20,MAX,brawlBall,Beach Ball,0,2,0,2
5870,2022-12-19,MAX,brawlBall,Center Stage,0,1,0,1
5871,2022-12-13,MAX,knockout,New Perspective,0,2,0,2
5872,2022-12-13,MAX,gemGrab,Crystal Arcade,0,1,0,1
5873,2022-12-13,MAX,brawlBall,Beach Ball,0,0,2,2
5874,2022-11-11,MAX,brawlBall,Sneaky Fields,0,0,1,1
5875,2022-11-03,MAX,brawlBall,Pinhole Punt,0,0,1,1
5876,2022-11-01,MAX,knockout,New Perspective,0,0,1,1
5877,2022-10-30,MAX,hotZone,Dueling Beetles,0,1,0,1
5878,2022-10-15,MAX,gemGrab,Hard Rock Mine,0,1,0,1
5879,2022-10-15,MAX,bounty,Dry Season,0,1,0,1
5880,2023-01-30,MANDY,knockout,Belle's Rock,1,570,852,1423
5881,2023-01-30,MANDY,hotZone,Quarter Pounder,0,56,65,121
5882,2023-01-30,MANDY,heist,Pit Stop,1,5,8,14
5883,2023-01-30,MANDY,gemGrab,Minecart Madness,0,178,304,482
5884,2023-01-30,MANDY,gemGrab,Double Swoosh,0,66,64,130
5885,2023-01-30,MANDY,brawlBall,Center Stage,15,355,430,800
5886,2023-01-30,MANDY,brawlBall,Backyard Bowl,11,80,156,247
5887,2023-01-30,MANDY,bounty,Hideout,0,120,208,328
5888,2023-01-29,MANDY,knockout,Belle's Rock,0,663,957,1620
5889,2023-01-29,MANDY,hotZone,Quarter Pounder,1,59,56,116
5890,2023-01-29,MANDY,heist,Bridge Too Far,2,284,369,655
5891,2023-01-29,MANDY,gemGrab,Hard Rock Mine,0,19,35,54
5892,2023-01-29,MANDY,gemGrab,Double Swoosh,0,152,179,331
5893,2023-01-29,MANDY,brawlBall,Super Beach,0,10,11,21
5894,2023-01-29,MANDY,brawlBall,Backyard Bowl,89,1193,1705,2987
5895,2023-01-29,MANDY,bounty,Canal Grande,0,79,101,180
5896,2023-01-28,MANDY,knockout,Flaring Phoenix,1,369,510,880
5897,2023-01-28,MANDY,hotZone,Controller Chaos,0,38,48,86
5898,2023-01-28,MANDY,heist,Bridge Too Far,3,646,678,1327
5899,2023-01-28,MANDY,gemGrab,Hard Rock Mine,0,140,148,288
5900,2023-01-28,MANDY,gemGrab,Deep Diner,0,42,56,98
5901,2023-01-28,MANDY,brawlBall,Super Beach,20,581,847,1448
5902,2023-01-28,MANDY,brawlBall,Sneaky Fields,0,24,35,59
5903,2023-01-28,MANDY,bounty,Canal Grande,0,144,223,367
5904,2023-01-27,MANDY,knockout,Flaring Phoenix,0,171,231,402
5905,2023-01-27,MANDY,hotZone,Controller Chaos,0,18,10,28
5906,2023-01-27,MANDY,heist,Hot Potato,0,16,21,37
5907,2023-01-27,MANDY,gemGrab,Undermine,0,7,7,14
5908,2023-01-27,MANDY,gemGrab,Deep Diner,0,69,123,192
5909,2023-01-27,MANDY,brawlBall,Sneaky Fields,5,119,187,311
5910,2023-01-27,MANDY,brawlBall,Pinhole Punt,0,4,3,7
5911,2023-01-27,MANDY,bounty,Temple Ruins,0,29,52,81
5912,2023-01-26,MANDY,knockout,Riverside,1,670,1034,1705
5913,2023-01-26,MANDY,hotZone,Open Zone,0,99,155,254
5914,2023-01-26,MANDY,heist,Hot Potato,0,54,67,121
5915,2023-01-26,MANDY,gemGrab,Undermine,0,76,142,218
5916,2023-01-26,MANDY,gemGrab,Gem Fort,0,33,37,70
5917,2023-01-26,MANDY,brawlBall,Sunny Soccer,0,4,12,16
5918,2023-01-26,MANDY,brawlBall,Pinhole Punt,32,644,1081,1757
5919,2023-01-26,MANDY,bounty,Temple Ruins,0,75,125,200
5920,2023-01-25,MANDY,knockout,Riverside,0,414,607,1021
5921,2023-01-25,MANDY,hotZone,Open Zone,0,42,60,102
5922,2023-01-25,MANDY,heist,Safe Zone,1,119,133,253
5923,2023-01-25,MANDY,gemGrab,Gem Fort,0,63,65,128
5924,2023-01-25,MANDY,gemGrab,Crystal Arcade,0,59,94,153
5925,2023-01-25,MANDY,brawlBall,Sunny Soccer,19,341,521,881
5926,2023-01-25,MANDY,brawlBall,Beach Ball,2,34,43,79
5927,2023-01-25,MANDY,bounty,Excel,0,82,116,198
5928,2023-01-24,MANDY,knockout,New Perspective,0,271,457,728
5929,2023-01-24,MANDY,hotZone,Dueling Beetles,0,43,46,89
5930,2023-01-24,MANDY,heist,Safe Zone,4,250,238,492
5931,2023-01-24,MANDY,gemGrab,Minecart Madness,0,87,109,196
5932,2023-01-24,MANDY,gemGrab,Crystal Arcade,0,184,260,444
5933,2023-01-24,MANDY,brawlBall,Center Stage,1,28,72,101
5934,2023-01-24,MANDY,brawlBall,Beach Ball,28,482,796,1306
5935,2023-01-24,MANDY,bounty,Excel,0,141,234,375
5936,2023-01-23,MANDY,knockout,New Perspective,2,527,720,1249
5937,2023-01-23,MANDY,hotZone,Dueling Beetles,0,79,111,190
5938,2023-01-23,MANDY,heist,Snaked Assault,1,43,50,94
5939,2023-01-23,MANDY,gemGrab,Minecart Madness,0,318,452,770
5940,2023-01-23,MANDY,gemGrab,Double Swoosh,0,49,90,139
5941,2023-01-23,MANDY,brawlBall,Center Stage,26,678,987,1691
5942,2023-01-23,MANDY,brawlBall,Backyard Bowl,4,66,86,156
5943,2023-01-23,MANDY,bounty,Layer Cake,0,151,213,364
5944,2023-01-22,MANDY,knockout,X Marks the Spot,1,294,397,692
5945,2023-01-22,MANDY,hotZone,Ring of Fire,2,28,40,70
5946,2023-01-22,MANDY,heist,Snaked Assault,0,22,32,54
5947,2023-01-22,MANDY,gemGrab,Hard Rock Mine,0,64,106,170
5948,2023-01-22,MANDY,gemGrab,Double Swoosh,0,86,122,208
5949,2023-01-22,MANDY,brawlBall,Super Beach,0,50,64,114
5950,2023-01-22,MANDY,brawlBall,Backyard Bowl,31,598,890,1519
5951,2023-01-22,MANDY,bounty,Layer Cake,0,84,136,220
5952,2023-01-21,MANDY,knockout,X Marks the Spot,5,903,1276,2184
5953,2023-01-21,MANDY,hotZone,Ring of Fire,0,103,97,200
5954,2023-01-21,MANDY,heist,Tornado Ring,1,34,38,73
5955,2023-01-21,MANDY,gemGrab,Hard Rock Mine,0,205,310,515
5956,2023-01-21,MANDY,gemGrab,Deep Diner,0,68,80,148
5957,2023-01-21,MANDY,brawlBall,Super Beach,21,713,1272,2006
5958,2023-01-21,MANDY,brawlBall,Sneaky Fields,0,15,29,44
5959,2023-01-21,MANDY,bounty,Dry Season,0,385,605,990
5960,2023-01-20,MANDY,knockout,Out in the Open,1,669,919,1589
5961,2023-01-20,MANDY,hotZone,Split,0,26,39,65
5962,2023-01-20,MANDY,heist,Tornado Ring,0,53,51,104
5963,2023-01-20,MANDY,gemGrab,Undermine,0,62,103,165
5964,2023-01-20,MANDY,gemGrab,Deep Diner,0,225,372,597
5965,2023-01-20,MANDY,brawlBall,Sneaky Fields,13,469,693,1175
5966,2023-01-20,MANDY,brawlBall,Pinhole Punt,1,29,26,56
5967,2023-01-20,MANDY,bounty,Dry Season,0,436,677,1113
5968,2023-01-19,MANDY,knockout,Out in the Open,5,686,1017,1708
5969,2023-01-19,MANDY,hotZone,Split,0,37,57,94
5970,2023-01-19,MANDY,heist,Kaboom Canyon,0,71,128,199
5971,2023-01-19,MANDY,gemGrab,Undermine,0,133,200,333
5972,2023-01-19,MANDY,gemGrab,Gem Fort,0,13,30,43
5973,2023-01-19,MANDY,brawlBall,Sunny Soccer,0,16,41,57
5974,2023-01-19,MANDY,brawlBall,Pinhole Punt,24,758,1082,1864
5975,2023-01-19,MANDY,bounty,Shooting Star,0,305,528,833
5976,2023-01-18,MANDY,knockout,Goldarm Gulch,0,71,136,207
5977,2023-01-18,MANDY,hotZone,Parallel Plays,0,6,5,11
5978,2023-01-18,MANDY,heist,Kaboom Canyon,0,35,67,102
5979,2023-01-18,MANDY,gemGrab,Gem Fort,0,44,48,92
5980,2023-01-18,MANDY,gemGrab,Crystal Arcade,0,7,3,10
5981,2023-01-18,MANDY,brawlBall,Sunny Soccer,6,221,338,565
5982,2023-01-18,MANDY,brawlBall,Beach Ball,1,12,10,23
5983,2023-01-18,MANDY,bounty,Shooting Star,0,223,320,543
5984,2023-01-17,MANDY,knockout,Goldarm Gulch,0,60,84,144
5985,2023-01-17,MANDY,hotZone,Parallel Plays,0,12,6,18
5986,2023-01-17,MANDY,heist,Pit Stop,0,2,4,6
5987,2023-01-17,MANDY,gemGrab,Minecart Madness,0,6,6,12
5988,2023-01-17,MANDY,gemGrab,Crystal Arcade,0,10,16,26
5989,2023-01-17,MANDY,brawlBall,Center Stage,0,1,0,1
5990,2023-01-17,MANDY,brawlBall,Beach Ball,2,41,104,147
5991,2023-01-17,MANDY,bounty,Hideout,0,17,14,31
5992,2023-01-16,MANDY,knockout,Belle's Rock,0,38,65,103
5993,2023-01-16,MANDY,hotZone,Quarter Pounder,0,9,8,17
5994,2023-01-16,MANDY,heist,Pit Stop,0,2,0,2
5995,2023-01-16,MANDY,gemGrab,Minecart Madness,0,20,39,59
5996,2023-01-16,MANDY,gemGrab,Double Swoosh,0,1,0,1
5997,2023-01-16,MANDY,brawlBall,Center Stage,1,52,55,108
5998,2023-01-16,MANDY,brawlBall,Backyard Bowl,1,9,50,60
5999,2023-01-16,MANDY,bounty,Hideout,0,38,112,150
6000,2023-01-15,MANDY,knockout,Belle's Rock,0,71,127,198
6001,2023-01-15,MANDY,hotZone,Quarter Pounder,0,18,21,39
6002,2023-01-15,MANDY,heist,Bridge Too Far,0,54,68,122
6003,2023-01-15,MANDY,gemGrab,Hard Rock Mine,0,7,26,33
6004,2023-01-15,MANDY,gemGrab,Double Swoosh,0,11,13,24
6005,2023-01-15,MANDY,brawlBall,Super Beach,0,5,4,9
6006,2023-01-15,MANDY,brawlBall,Backyard Bowl,10,104,224,338
6007,2023-01-15,MANDY,bounty,Canal Grande,0,5,31,36
6008,2023-01-14,MANDY,knockout,Flaring Phoenix,0,20,39,59
6009,2023-01-14,MANDY,hotZone,Controller Chaos,0,16,18,34
6010,2023-01-14,MANDY,heist,Bridge Too Far,0,76,150,226
6011,2023-01-14,MANDY,gemGrab,Hard Rock Mine,0,5,12,17
6012,2023-01-14,MANDY,gemGrab,Deep Diner,0,13,24,37
6013,2023-01-14,MANDY,brawlBall,Super Beach,2,63,201,266
6014,2023-01-14,MANDY,brawlBall,Sneaky Fields,0,3,1,4
6015,2023-01-14,MANDY,bounty,Canal Grande,0,3,6,9
6016,2023-01-13,MANDY,knockout,Flaring Phoenix,0,31,87,118
6017,2023-01-13,MANDY,hotZone,Controller Chaos,0,1,1,2
6018,2023-01-13,MANDY,gemGrab,Undermine,0,1,1,2
6019,2023-01-13,MANDY,gemGrab,Deep Diner,0,12,15,27
6020,2023-01-13,MANDY,brawlBall,Sneaky Fields,1,39,95,135
6021,2023-01-13,MANDY,bounty,Temple Ruins,0,1,2,3
6022,2023-01-12,MANDY,knockout,Riverside,0,44,103,147
6023,2023-01-12,MANDY,hotZone,Open Zone,0,11,25,36
6024,2023-01-12,MANDY,gemGrab,Undermine,0,8,2,10
6025,2023-01-12,MANDY,brawlBall,Sunny Soccer,0,3,11,14
6026,2023-01-12,MANDY,brawlBall,Pinhole Punt,0,7,4,11
6027,2023-01-11,MANDY,knockout,Riverside,0,8,7,15
6028,2023-01-11,MANDY,hotZone,Open Zone,0,0,1,1
6029,2023-01-11,MANDY,gemGrab,Gem Fort,0,2,7,9
6030,2023-01-11,MANDY,brawlBall,Sunny Soccer,0,4,10,14
6031,2023-01-10,MANDY,knockout,New Perspective,0,3,9,12
6032,2023-01-10,MANDY,hotZone,Dueling Beetles,0,8,17,25
6033,2023-01-10,MANDY,heist,Safe Zone,0,1,0,1
6034,2023-01-10,MANDY,gemGrab,Minecart Madness,0,5,30,35
6035,2023-01-10,MANDY,gemGrab,Crystal Arcade,0,12,28,40
6036,2023-01-10,MANDY,brawlBall,Beach Ball,1,26,48,75
6037,2023-01-09,MANDY,knockout,New Perspective,0,4,9,13
6038,2023-01-09,MANDY,hotZone,Dueling Beetles,0,9,20,29
6039,2023-01-09,MANDY,gemGrab,Minecart Madness,0,8,25,33
6040,2023-01-09,MANDY,gemGrab,Double Swoosh,0,3,7,10
6041,2023-01-09,MANDY,brawlBall,Center Stage,0,9,24,33
6042,2023-01-09,MANDY,brawlBall,Backyard Bowl,0,2,1,3
6043,2023-01-09,MANDY,bounty,Layer Cake,0,4,6,10
6044,2023-01-08,MANDY,knockout,X Marks the Spot,0,8,3,11
6045,2023-01-08,MANDY,hotZone,Ring of Fire,0,0,9,9
6046,2023-01-08,MANDY,heist,Snaked Assault,0,5,17,22
6047,2023-01-08,MANDY,gemGrab,Hard Rock Mine,0,0,2,2
6048,2023-01-08,MANDY,brawlBall,Super Beach,0,3,0,3
6049,2023-01-08,MANDY,brawlBall,Backyard Bowl,0,7,10,17
6050,2023-01-08,MANDY,bounty,Layer Cake,0,0,1,1
6051,2023-01-07,MANDY,knockout,X Marks the Spot,0,4,10,14
6052,2023-01-07,MANDY,heist,Tornado Ring,0,1,0,1
6053,2023-01-07,MANDY,brawlBall,Super Beach,0,3,8,11
6054,2023-01-07,MANDY,bounty,Dry Season,0,8,26,34
6055,2023-01-06,MANDY,knockout,Out in the Open,0,3,16,19
6056,2023-01-06,MANDY,heist,Tornado Ring,1,4,11,16
6057,2023-01-06,MANDY,gemGrab,Deep Diner,0,1,2,3
6058,2023-01-06,MANDY,brawlBall,Sneaky Fields,1,28,52,81
6059,2023-01-06,MANDY,brawlBall,Pinhole Punt,0,2,5,7
6060,2023-01-06,MANDY,bounty,Dry Season,0,24,51,75
6061,2023-01-05,MANDY,knockout,Out in the Open,0,47,88,135
6062,2023-01-05,MANDY,heist,Kaboom Canyon,0,2,2,4
6063,2023-01-05,MANDY,brawlBall,Pinhole Punt,2,51,129,182
6064,2023-01-05,MANDY,bounty,Shooting Star,0,13,14,27
6065,2023-01-04,MANDY,knockout,Goldarm Gulch,0,6,31,37
6066,2023-01-04,MANDY,hotZone,Parallel Plays,0,2,20,22
6067,2023-01-04,MANDY,heist,Kaboom Canyon,0,1,17,18
6068,2023-01-04,MANDY,gemGrab,Gem Fort,0,2,1,3
6069,2023-01-04,MANDY,gemGrab,Crystal Arcade,0,0,2,2
6070,2023-01-04,MANDY,brawlBall,Sunny Soccer,2,36,99,137
6071,2023-01-04,MANDY,bounty,Shooting Star,0,29,91,120
6072,2023-01-03,MANDY,knockout,Goldarm Gulch,0,11,22,33
6073,2023-01-03,MANDY,hotZone,Parallel Plays,0,3,14,17
6074,2023-01-03,MANDY,heist,Pit Stop,0,2,0,2
6075,2023-01-03,MANDY,gemGrab,Minecart Madness,0,11,34,45
6076,2023-01-03,MANDY,gemGrab,Crystal Arcade,0,11,45,56
6077,2023-01-03,MANDY,brawlBall,Center Stage,1,4,21,26
6078,2023-01-03,MANDY,brawlBall,Beach Ball,3,48,153,204
6079,2023-01-03,MANDY,bounty,Hideout,0,17,70,87
6080,2023-01-02,MANDY,knockout,Belle's Rock,0,2,29,31
6081,2023-01-02,MANDY,hotZone,Quarter Pounder,0,0,1,1
6082,2023-01-02,MANDY,heist,Pit Stop,0,1,0,1
6083,2023-01-02,MANDY,gemGrab,Minecart Madness,0,41,137,178
6084,2023-01-02,MANDY,brawlBall,Center Stage,3,90,290,383
6085,2023-01-02,MANDY,bounty,Hideout,0,49,152,201
6086,2023-01-30,LOU,knockout,Belle's Rock,0,12,12,24
6087,2023-01-30,LOU,hotZone,Quarter Pounder,2,125,254,381
6088,2023-01-30,LOU,heist,Pit Stop,0,4,0,4
6089,2023-01-30,LOU,gemGrab,Minecart Madness,0,30,28,58
6090,2023-01-30,LOU,gemGrab,Double Swoosh,0,30,20,50
6091,2023-01-30,LOU,brawlBall,Center Stage,5,157,221,383
6092,2023-01-30,LOU,brawlBall,Backyard Bowl,1,19,24,44
6093,2023-01-30,LOU,bounty,Hideout,0,2,0,2
6094,2023-01-29,LOU,knockout,Belle's Rock,0,18,10,28
6095,2023-01-29,LOU,hotZone,Quarter Pounder,1,85,123,209
6096,2023-01-29,LOU,heist,Bridge Too Far,0,18,11,29
6097,2023-01-29,LOU,gemGrab,Hard Rock Mine,0,5,3,8
6098,2023-01-29,LOU,gemGrab,Double Swoosh,0,31,16,47
6099,2023-01-29,LOU,brawlBall,Super Beach,0,4,3,7
6100,2023-01-29,LOU,brawlBall,Backyard Bowl,13,182,219,414
6101,2023-01-29,LOU,bounty,Canal Grande,0,9,8,17
6102,2023-01-28,LOU,knockout,Flaring Phoenix,0,14,6,20
6103,2023-01-28,LOU,hotZone,Controller Chaos,0,115,160,275
6104,2023-01-28,LOU,heist,Bridge Too Far,0,23,34,57
6105,2023-01-28,LOU,gemGrab,Hard Rock Mine,0,46,34,80
6106,2023-01-28,LOU,gemGrab,Deep Diner,0,16,19,35
6107,2023-01-28,LOU,brawlBall,Super Beach,10,262,326,598
6108,2023-01-28,LOU,brawlBall,Sneaky Fields,0,12,28,40
6109,2023-01-28,LOU,bounty,Canal Grande,0,14,13,27
6110,2023-01-27,LOU,knockout,Flaring Phoenix,0,4,3,7
6111,2023-01-27,LOU,hotZone,Controller Chaos,0,24,22,46
6112,2023-01-27,LOU,heist,Hot Potato,0,3,1,4
6113,2023-01-27,LOU,gemGrab,Undermine,0,4,4,8
6114,2023-01-27,LOU,gemGrab,Deep Diner,0,24,28,52
6115,2023-01-27,LOU,brawlBall,Sneaky Fields,3,80,116,199
6116,2023-01-27,LOU,brawlBall,Pinhole Punt,0,3,0,3
6117,2023-01-27,LOU,bounty,Temple Ruins,0,6,9,15
6118,2023-01-26,LOU,knockout,Riverside,0,22,10,32
6119,2023-01-26,LOU,hotZone,Open Zone,0,99,114,213
6120,2023-01-26,LOU,heist,Hot Potato,0,6,3,9
6121,2023-01-26,LOU,gemGrab,Undermine,0,18,26,44
6122,2023-01-26,LOU,gemGrab,Gem Fort,0,8,10,18
6123,2023-01-26,LOU,brawlBall,Sunny Soccer,1,13,11,25
6124,2023-01-26,LOU,brawlBall,Pinhole Punt,10,266,357,633
6125,2023-01-26,LOU,bounty,Temple Ruins,0,10,2,12
6126,2023-01-25,LOU,knockout,Riverside,0,7,3,10
6127,2023-01-25,LOU,hotZone,Open Zone,0,55,80,135
6128,2023-01-25,LOU,heist,Safe Zone,0,7,1,8
6129,2023-01-25,LOU,gemGrab,Gem Fort,0,11,11,22
6130,2023-01-25,LOU,gemGrab,Crystal Arcade,0,13,10,23
6131,2023-01-25,LOU,brawlBall,Sunny Soccer,7,153,206,366
6132,2023-01-25,LOU,brawlBall,Beach Ball,0,24,37,61
6133,2023-01-25,LOU,bounty,Excel,0,6,11,17
6134,2023-01-24,LOU,knockout,New Perspective,0,8,4,12
6135,2023-01-24,LOU,hotZone,Dueling Beetles,0,263,536,799
6136,2023-01-24,LOU,heist,Safe Zone,0,17,5,22
6137,2023-01-24,LOU,gemGrab,Minecart Madness,0,16,6,22
6138,2023-01-24,LOU,gemGrab,Crystal Arcade,0,35,35,70
6139,2023-01-24,LOU,brawlBall,Center Stage,1,11,13,25
6140,2023-01-24,LOU,brawlBall,Beach Ball,6,221,275,502
6141,2023-01-24,LOU,bounty,Excel,0,8,2,10
6142,2023-01-23,LOU,knockout,New Perspective,0,20,18,38
6143,2023-01-23,LOU,hotZone,Dueling Beetles,1,557,923,1481
6144,2023-01-23,LOU,heist,Snaked Assault,0,4,4,8
6145,2023-01-23,LOU,gemGrab,Minecart Madness,0,66,100,166
6146,2023-01-23,LOU,gemGrab,Double Swoosh,0,15,4,19
6147,2023-01-23,LOU,brawlBall,Center Stage,19,243,417,679
6148,2023-01-23,LOU,brawlBall,Backyard Bowl,0,4,19,23
6149,2023-01-23,LOU,bounty,Layer Cake,0,4,4,8
6150,2023-01-22,LOU,knockout,X Marks the Spot,0,6,2,8
6151,2023-01-22,LOU,hotZone,Ring of Fire,0,132,246,378
6152,2023-01-22,LOU,heist,Snaked Assault,0,4,1,5
6153,2023-01-22,LOU,gemGrab,Hard Rock Mine,0,2,5,7
6154,2023-01-22,LOU,gemGrab,Double Swoosh,0,13,17,30
6155,2023-01-22,LOU,brawlBall,Super Beach,0,25,62,87
6156,2023-01-22,LOU,brawlBall,Backyard Bowl,6,87,105,198
6157,2023-01-22,LOU,bounty,Layer Cake,0,3,8,11
6158,2023-01-21,LOU,knockout,X Marks the Spot,0,25,25,50
6159,2023-01-21,LOU,hotZone,Ring of Fire,4,469,645,1118
6160,2023-01-21,LOU,heist,Tornado Ring,0,4,2,6
6161,2023-01-21,LOU,gemGrab,Hard Rock Mine,0,21,23,44
6162,2023-01-21,LOU,gemGrab,Deep Diner,0,14,5,19
6163,2023-01-21,LOU,brawlBall,Super Beach,17,339,578,934
6164,2023-01-21,LOU,brawlBall,Sneaky Fields,0,8,9,17
6165,2023-01-21,LOU,bounty,Dry Season,0,10,7,17
6166,2023-01-20,LOU,knockout,Out in the Open,1,23,10,34
6167,2023-01-20,LOU,hotZone,Split,0,25,19,44
6168,2023-01-20,LOU,heist,Tornado Ring,1,10,9,20
6169,2023-01-20,LOU,gemGrab,Undermine,0,8,11,19
6170,2023-01-20,LOU,gemGrab,Deep Diner,0,56,47,103
6171,2023-01-20,LOU,brawlBall,Sneaky Fields,13,243,272,528
6172,2023-01-20,LOU,brawlBall,Pinhole Punt,0,9,19,28
6173,2023-01-20,LOU,bounty,Dry Season,0,5,7,12
6174,2023-01-19,LOU,knockout,Out in the Open,0,24,19,43
6175,2023-01-19,LOU,hotZone,Split,0,35,34,69
6176,2023-01-19,LOU,heist,Kaboom Canyon,1,9,5,15
6177,2023-01-19,LOU,gemGrab,Undermine,0,22,25,47
6178,2023-01-19,LOU,gemGrab,Gem Fort,0,5,2,7
6179,2023-01-19,LOU,brawlBall,Sunny Soccer,0,7,4,11
6180,2023-01-19,LOU,brawlBall,Pinhole Punt,6,209,248,463
6181,2023-01-19,LOU,bounty,Shooting Star,0,6,9,15
6182,2023-01-18,LOU,knockout,Goldarm Gulch,0,2,1,3
6183,2023-01-18,LOU,hotZone,Parallel Plays,0,6,10,16
6184,2023-01-18,LOU,heist,Kaboom Canyon,0,3,7,10
6185,2023-01-18,LOU,gemGrab,Gem Fort,0,9,3,12
6186,2023-01-18,LOU,gemGrab,Crystal Arcade,0,0,4,4
6187,2023-01-18,LOU,brawlBall,Sunny Soccer,1,56,49,106
6188,2023-01-18,LOU,bounty,Shooting Star,0,2,2,4
6189,2023-01-17,LOU,knockout,Goldarm Gulch,0,3,2,5
6190,2023-01-17,LOU,hotZone,Parallel Plays,0,4,4,8
6191,2023-01-17,LOU,gemGrab,Minecart Madness,0,1,2,3
6192,2023-01-17,LOU,gemGrab,Crystal Arcade,0,3,0,3
6193,2023-01-17,LOU,brawlBall,Beach Ball,1,11,20,32
6194,2023-01-17,LOU,bounty,Hideout,0,0,2,2
6195,2023-01-16,LOU,knockout,Belle's Rock,0,1,0,1
6196,2023-01-16,LOU,hotZone,Quarter Pounder,0,4,2,6
6197,2023-01-16,LOU,heist,Pit Stop,0,4,1,5
6198,2023-01-16,LOU,gemGrab,Minecart Madness,0,6,9,15
6199,2023-01-16,LOU,brawlBall,Center Stage,0,8,17,25
6200,2023-01-16,LOU,brawlBall,Backyard Bowl,0,3,0,3
6201,2023-01-15,LOU,knockout,Belle's Rock,0,0,1,1
6202,2023-01-15,LOU,hotZone,Quarter Pounder,0,13,17,30
6203,2023-01-15,LOU,heist,Bridge Too Far,0,1,5,6
6204,2023-01-15,LOU,gemGrab,Double Swoosh,0,5,6,11
6205,2023-01-15,LOU,brawlBall,Super Beach,1,9,9,19
6206,2023-01-15,LOU,brawlBall,Backyard Bowl,0,17,34,51
6207,2023-01-15,LOU,bounty,Canal Grande,0,1,1,2
6208,2023-01-14,LOU,knockout,Flaring Phoenix,0,1,0,1
6209,2023-01-14,LOU,hotZone,Controller Chaos,0,19,77,96
6210,2023-01-14,LOU,heist,Bridge Too Far,0,3,0,3
6211,2023-01-14,LOU,gemGrab,Hard Rock Mine,0,1,1,2
6212,2023-01-14,LOU,gemGrab,Deep Diner,0,1,0,1
6213,2023-01-14,LOU,brawlBall,Super Beach,0,31,23,54
6214,2023-01-14,LOU,brawlBall,Sneaky Fields,0,5,4,9
6215,2023-01-13,LOU,knockout,Flaring Phoenix,0,1,2,3
6216,2023-01-13,LOU,hotZone,Controller Chaos,0,47,70,117
6217,2023-01-13,LOU,gemGrab,Deep Diner,0,4,10,14
6218,2023-01-13,LOU,brawlBall,Sneaky Fields,1,15,40,56
6219,2023-01-13,LOU,brawlBall,Pinhole Punt,0,2,1,3
6220,2023-01-12,LOU,knockout,Riverside,0,1,0,1
6221,2023-01-12,LOU,hotZone,Open Zone,0,7,15,22
6222,2023-01-12,LOU,heist,Hot Potato,0,1,0,1
6223,2023-01-12,LOU,gemGrab,Undermine,0,1,0,1
6224,2023-01-12,LOU,brawlBall,Sunny Soccer,0,2,2,4
6225,2023-01-12,LOU,brawlBall,Pinhole Punt,0,5,2,7
6226,2023-01-11,LOU,knockout,Riverside,0,1,0,1
6227,2023-01-11,LOU,hotZone,Open Zone,0,4,3,7
6228,2023-01-11,LOU,gemGrab,Gem Fort,0,1,0,1
6229,2023-01-11,LOU,brawlBall,Sunny Soccer,0,7,20,27
6230,2023-01-11,LOU,bounty,Excel,0,1,0,1
6231,2023-01-10,LOU,knockout,New Perspective,0,0,1,1
6232,2023-01-10,LOU,hotZone,Dueling Beetles,0,55,80,135
6233,2023-01-10,LOU,heist,Safe Zone,0,1,0,1
6234,2023-01-10,LOU,gemGrab,Minecart Madness,0,2,0,2
6235,2023-01-10,LOU,gemGrab,Crystal Arcade,0,2,0,2
6236,2023-01-10,LOU,brawlBall,Center Stage,0,1,0,1
6237,2023-01-10,LOU,brawlBall,Beach Ball,0,7,9,16
6238,2023-01-09,LOU,hotZone,Dueling Beetles,0,38,73,111
6239,2023-01-09,LOU,gemGrab,Minecart Madness,0,4,1,5
6240,2023-01-09,LOU,gemGrab,Double Swoosh,0,2,2,4
6241,2023-01-09,LOU,brawlBall,Center Stage,0,10,19,29
6242,2023-01-09,LOU,bounty,Layer Cake,0,1,0,1
6243,2023-01-08,LOU,knockout,X Marks the Spot,0,1,0,1
6244,2023-01-08,LOU,hotZone,Ring of Fire,0,26,24,50
6245,2023-01-08,LOU,heist,Snaked Assault,0,2,0,2
6246,2023-01-08,LOU,gemGrab,Double Swoosh,0,1,0,1
6247,2023-01-08,LOU,brawlBall,Backyard Bowl,0,10,10,20
6248,2023-01-07,LOU,knockout,X Marks the Spot,0,1,0,1
6249,2023-01-07,LOU,hotZone,Ring of Fire,0,14,14,28
6250,2023-01-07,LOU,heist,Tornado Ring,0,1,3,4
6251,2023-01-07,LOU,gemGrab,Deep Diner,0,0,1,1
6252,2023-01-07,LOU,brawlBall,Super Beach,0,7,13,20
6253,2023-01-06,LOU,gemGrab,Undermine,0,1,0,1
6254,2023-01-06,LOU,gemGrab,Deep Diner,0,2,0,2
6255,2023-01-06,LOU,brawlBall,Sneaky Fields,1,21,16,38
6256,2023-01-06,LOU,brawlBall,Pinhole Punt,0,1,0,1
6257,2023-01-05,LOU,knockout,Out in the Open,0,3,1,4
6258,2023-01-05,LOU,hotZone,Split,0,7,8,15
6259,2023-01-05,LOU,brawlBall,Pinhole Punt,2,31,73,106
6260,2023-01-04,LOU,hotZone,Parallel Plays,0,3,2,5
6261,2023-01-04,LOU,heist,Kaboom Canyon,0,0,2,2
6262,2023-01-04,LOU,gemGrab,Gem Fort,0,4,3,7
6263,2023-01-04,LOU,gemGrab,Crystal Arcade,0,0,1,1
6264,2023-01-04,LOU,brawlBall,Sunny Soccer,0,27,24,51
6265,2023-01-03,LOU,hotZone,Parallel Plays,0,3,0,3
6266,2023-01-03,LOU,hotZone,Controller Chaos,0,1,0,1
6267,2023-01-03,LOU,gemGrab,Minecart Madness,0,4,6,10
6268,2023-01-03,LOU,gemGrab,Crystal Arcade,0,0,2,2
6269,2023-01-03,LOU,brawlBall,Beach Ball,0,16,25,41
6270,2023-01-02,LOU,knockout,Belle's Rock,0,3,0,3
6271,2023-01-02,LOU,hotZone,Quarter Pounder,0,24,20,44
6272,2023-01-02,LOU,heist,Pit Stop,0,0,1,1
6273,2023-01-02,LOU,gemGrab,Minecart Madness,0,1,3,4
6274,2023-01-02,LOU,gemGrab,Double Swoosh,0,1,3,4
6275,2023-01-02,LOU,brawlBall,Center Stage,0,16,26,42
6276,2023-01-02,LOU,brawlBall,Backyard Bowl,0,1,1,2
6277,2023-01-01,LOU,hotZone,Quarter Pounder,0,4,3,7
6278,2023-01-01,LOU,gemGrab,Double Swoosh,0,3,0,3
6279,2023-01-01,LOU,brawlBall,Backyard Bowl,0,7,9,16
6280,2022-12-31,LOU,hotZone,Controller Chaos,0,7,15,22
6281,2022-12-31,LOU,gemGrab,Minecart Madness,0,1,1,2
6282,2022-12-31,LOU,gemGrab,Deep Diner,0,1,0,1
6283,2022-12-31,LOU,brawlBall,Super Beach,0,0,1,1
6284,2022-12-31,LOU,brawlBall,Sneaky Fields,0,1,0,1
6285,2022-12-30,LOU,hotZone,Controller Chaos,0,7,16,23
6286,2022-12-30,LOU,brawlBall,Sneaky Fields,1,3,2,6
6287,2022-12-29,LOU,hotZone,Open Zone,0,0,2,2
6288,2022-12-29,LOU,heist,Hot Potato,0,1,0,1
6289,2022-12-28,LOU,hotZone,Open Zone,0,3,2,5
6290,2022-12-28,LOU,brawlBall,Sunny Soccer,0,1,1,2
6291,2022-12-27,LOU,hotZone,Controller Chaos,0,0,1,1
6292,2022-12-26,LOU,hotZone,Controller Chaos,0,1,0,1
6293,2022-12-26,LOU,gemGrab,Minecart Madness,0,1,0,1
6294,2022-12-22,LOU,brawlBall,Pinhole Punt,0,3,2,5
6295,2022-12-20,LOU,brawlBall,Beach Ball,0,2,1,3
6296,2022-12-17,LOU,brawlBall,Super Beach,0,1,1,2
6297,2022-12-16,LOU,gemGrab,Undermine,0,1,0,1
6298,2022-12-16,LOU,brawlBall,Sneaky Fields,0,2,0,2
6299,2022-12-10,LOU,hotZone,Ring of Fire,0,0,1,1
6300,2022-11-07,LOU,hotZone,Quarter Pounder,0,3,1,4
6301,2022-10-30,LOU,hotZone,Dueling Beetles,0,0,2,2
6302,2022-10-30,LOU,heist,Safe Zone,0,0,1,1
6303,2022-10-28,LOU,hotZone,Dueling Beetles,0,1,0,1
6304,2023-01-30,LOLA,knockout,Belle's Rock,0,11,18,29
6305,2023-01-30,LOLA,hotZone,Quarter Pounder,0,35,98,133
6306,2023-01-30,LOLA,heist,Pit Stop,0,6,1,7
6307,2023-01-30,LOLA,gemGrab,Minecart Madness,0,37,40,77
6308,2023-01-30,LOLA,gemGrab,Double Swoosh,0,12,23,35
6309,2023-01-30,LOLA,brawlBall,Center Stage,4,67,52,123
6310,2023-01-30,LOLA,brawlBall,Backyard Bowl,1,34,50,85
6311,2023-01-30,LOLA,bounty,Hideout,0,12,16,28
6312,2023-01-29,LOLA,knockout,Belle's Rock,0,17,8,25
6313,2023-01-29,LOLA,hotZone,Quarter Pounder,2,52,111,165
6314,2023-01-29,LOLA,heist,Bridge Too Far,2,169,223,394
6315,2023-01-29,LOLA,gemGrab,Hard Rock Mine,0,15,34,49
6316,2023-01-29,LOLA,gemGrab,Double Swoosh,0,33,45,78
6317,2023-01-29,LOLA,brawlBall,Super Beach,0,7,5,12
6318,2023-01-29,LOLA,brawlBall,Backyard Bowl,24,343,433,800
6319,2023-01-29,LOLA,bounty,Canal Grande,0,4,3,7
6320,2023-01-28,LOLA,knockout,Flaring Phoenix,0,9,6,15
6321,2023-01-28,LOLA,hotZone,Controller Chaos,0,28,38,66
6322,2023-01-28,LOLA,heist,Bridge Too Far,2,462,567,1031
6323,2023-01-28,LOLA,gemGrab,Hard Rock Mine,0,45,78,123
6324,2023-01-28,LOLA,gemGrab,Deep Diner,0,8,20,28
6325,2023-01-28,LOLA,brawlBall,Super Beach,5,115,121,241
6326,2023-01-28,LOLA,brawlBall,Sneaky Fields,0,6,0,6
6327,2023-01-28,LOLA,bounty,Canal Grande,0,2,4,6
6328,2023-01-27,LOLA,knockout,Flaring Phoenix,0,11,17,28
6329,2023-01-27,LOLA,hotZone,Controller Chaos,0,4,4,8
6330,2023-01-27,LOLA,heist,Hot Potato,0,22,39,61
6331,2023-01-27,LOLA,gemGrab,Undermine,0,4,1,5
6332,2023-01-27,LOLA,gemGrab,Deep Diner,0,8,8,16
6333,2023-01-27,LOLA,brawlBall,Sneaky Fields,1,28,15,44
6334,2023-01-27,LOLA,brawlBall,Pinhole Punt,0,0,1,1
6335,2023-01-27,LOLA,bounty,Temple Ruins,0,5,5,10
6336,2023-01-26,LOLA,knockout,Riverside,0,44,56,100
6337,2023-01-26,LOLA,hotZone,Open Zone,0,91,141,232
6338,2023-01-26,LOLA,heist,Hot Potato,0,40,32,72
6339,2023-01-26,LOLA,gemGrab,Undermine,0,22,27,49
6340,2023-01-26,LOLA,gemGrab,Gem Fort,0,17,17,34
6341,2023-01-26,LOLA,brawlBall,Sunny Soccer,0,2,2,4
6342,2023-01-26,LOLA,brawlBall,Pinhole Punt,6,223,344,573
6343,2023-01-26,LOLA,bounty,Temple Ruins,0,17,13,30
6344,2023-01-25,LOLA,knockout,Riverside,0,23,24,47
6345,2023-01-25,LOLA,hotZone,Open Zone,0,70,94,164
6346,2023-01-25,LOLA,heist,Safe Zone,2,66,131,199
6347,2023-01-25,LOLA,gemGrab,Gem Fort,0,8,10,18
6348,2023-01-25,LOLA,gemGrab,Crystal Arcade,0,20,24,44
6349,2023-01-25,LOLA,brawlBall,Sunny Soccer,2,41,56,99
6350,2023-01-25,LOLA,brawlBall,Beach Ball,0,11,6,17
6351,2023-01-25,LOLA,bounty,Excel,0,2,1,3
6352,2023-01-24,LOLA,knockout,New Perspective,0,9,11,20
6353,2023-01-24,LOLA,hotZone,Dueling Beetles,0,34,30,64
6354,2023-01-24,LOLA,heist,Safe Zone,1,117,121,239
6355,2023-01-24,LOLA,gemGrab,Minecart Madness,0,11,39,50
6356,2023-01-24,LOLA,gemGrab,Crystal Arcade,0,35,27,62
6357,2023-01-24,LOLA,brawlBall,Center Stage,0,6,5,11
6358,2023-01-24,LOLA,brawlBall,Beach Ball,4,80,103,187
6359,2023-01-24,LOLA,bounty,Excel,0,8,2,10
6360,2023-01-23,LOLA,knockout,New Perspective,0,22,15,37
6361,2023-01-23,LOLA,hotZone,Dueling Beetles,0,46,85,131
6362,2023-01-23,LOLA,heist,Snaked Assault,1,96,147,244
6363,2023-01-23,LOLA,gemGrab,Minecart Madness,0,72,124,196
6364,2023-01-23,LOLA,gemGrab,Double Swoosh,0,6,17,23
6365,2023-01-23,LOLA,brawlBall,Center Stage,4,89,124,217
6366,2023-01-23,LOLA,brawlBall,Backyard Bowl,0,26,44,70
6367,2023-01-23,LOLA,bounty,Layer Cake,0,12,15,27
6368,2023-01-22,LOLA,knockout,X Marks the Spot,0,4,5,9
6369,2023-01-22,LOLA,hotZone,Ring of Fire,0,21,61,82
6370,2023-01-22,LOLA,heist,Snaked Assault,0,40,60,100
6371,2023-01-22,LOLA,gemGrab,Hard Rock Mine,0,15,11,26
6372,2023-01-22,LOLA,gemGrab,Double Swoosh,0,24,23,47
6373,2023-01-22,LOLA,brawlBall,Super Beach,0,9,30,39
6374,2023-01-22,LOLA,brawlBall,Backyard Bowl,12,157,214,383
6375,2023-01-22,LOLA,bounty,Layer Cake,0,3,1,4
6376,2023-01-21,LOLA,knockout,X Marks the Spot,0,48,51,99
6377,2023-01-21,LOLA,hotZone,Ring of Fire,0,89,98,187
6378,2023-01-21,LOLA,heist,Tornado Ring,0,26,29,55
6379,2023-01-21,LOLA,gemGrab,Hard Rock Mine,0,43,36,79
6380,2023-01-21,LOLA,gemGrab,Deep Diner,0,15,16,31
6381,2023-01-21,LOLA,brawlBall,Super Beach,5,129,173,307
6382,2023-01-21,LOLA,brawlBall,Sneaky Fields,0,1,1,2
6383,2023-01-21,LOLA,bounty,Dry Season,0,21,13,34
6384,2023-01-20,LOLA,knockout,Out in the Open,0,33,26,59
6385,2023-01-20,LOLA,hotZone,Split,0,9,10,19
6386,2023-01-20,LOLA,heist,Tornado Ring,0,30,15,45
6387,2023-01-20,LOLA,gemGrab,Undermine,0,7,17,24
6388,2023-01-20,LOLA,gemGrab,Deep Diner,0,35,76,111
6389,2023-01-20,LOLA,brawlBall,Sneaky Fields,1,60,54,115
6390,2023-01-20,LOLA,brawlBall,Pinhole Punt,0,6,5,11
6391,2023-01-20,LOLA,bounty,Dry Season,0,7,28,35
6392,2023-01-19,LOLA,knockout,Out in the Open,0,53,46,99
6393,2023-01-19,LOLA,hotZone,Split,0,7,10,17
6394,2023-01-19,LOLA,heist,Kaboom Canyon,0,71,125,196
6395,2023-01-19,LOLA,gemGrab,Undermine,0,33,50,83
6396,2023-01-19,LOLA,gemGrab,Gem Fort,0,15,20,35
6397,2023-01-19,LOLA,brawlBall,Sunny Soccer,0,5,10,15
6398,2023-01-19,LOLA,brawlBall,Pinhole Punt,11,232,319,562
6399,2023-01-19,LOLA,bounty,Shooting Star,0,14,17,31
6400,2023-01-18,LOLA,knockout,Goldarm Gulch,0,5,4,9
6401,2023-01-18,LOLA,hotZone,Parallel Plays,0,2,2,4
6402,2023-01-18,LOLA,heist,Kaboom Canyon,0,21,40,61
6403,2023-01-18,LOLA,gemGrab,Gem Fort,0,4,5,9
6404,2023-01-18,LOLA,gemGrab,Crystal Arcade,0,3,0,3
6405,2023-01-18,LOLA,brawlBall,Sunny Soccer,0,24,23,47
6406,2023-01-18,LOLA,brawlBall,Beach Ball,0,4,1,5
6407,2023-01-18,LOLA,bounty,Shooting Star,0,9,10,19
6408,2023-01-17,LOLA,knockout,Goldarm Gulch,0,5,6,11
6409,2023-01-17,LOLA,hotZone,Parallel Plays,0,2,3,5
6410,2023-01-17,LOLA,heist,Pit Stop,0,0,1,1
6411,2023-01-17,LOLA,gemGrab,Minecart Madness,0,1,5,6
6412,2023-01-17,LOLA,gemGrab,Crystal Arcade,0,2,4,6
6413,2023-01-17,LOLA,brawlBall,Beach Ball,1,6,8,15
6414,2023-01-17,LOLA,bounty,Hideout,0,2,2,4
6415,2023-01-16,LOLA,knockout,Belle's Rock,0,1,5,6
6416,2023-01-16,LOLA,hotZone,Quarter Pounder,0,11,21,32
6417,2023-01-16,LOLA,heist,Pit Stop,0,2,0,2
6418,2023-01-16,LOLA,gemGrab,Minecart Madness,0,17,14,31
6419,2023-01-16,LOLA,gemGrab,Double Swoosh,0,1,14,15
6420,2023-01-16,LOLA,brawlBall,Center Stage,0,2,6,8
6421,2023-01-16,LOLA,brawlBall,Backyard Bowl,0,3,9,12
6422,2023-01-16,LOLA,bounty,Hideout,0,3,3,6
6423,2023-01-15,LOLA,hotZone,Quarter Pounder,0,8,15,23
6424,2023-01-15,LOLA,heist,Bridge Too Far,0,51,54,105
6425,2023-01-15,LOLA,gemGrab,Hard Rock Mine,0,1,0,1
6426,2023-01-15,LOLA,gemGrab,Double Swoosh,0,2,3,5
6427,2023-01-15,LOLA,brawlBall,Super Beach,0,1,0,1
6428,2023-01-15,LOLA,brawlBall,Backyard Bowl,4,52,63,119
6429,2023-01-15,LOLA,bounty,Canal Grande,0,1,0,1
6430,2023-01-14,LOLA,knockout,Flaring Phoenix,0,1,10,11
6431,2023-01-14,LOLA,hotZone,Controller Chaos,0,4,3,7
6432,2023-01-14,LOLA,heist,Bridge Too Far,0,99,137,236
6433,2023-01-14,LOLA,gemGrab,Hard Rock Mine,0,1,0,1
6434,2023-01-14,LOLA,gemGrab,Deep Diner,0,2,0,2
6435,2023-01-14,LOLA,brawlBall,Super Beach,0,15,13,28
6436,2023-01-13,LOLA,knockout,Flaring Phoenix,0,2,0,2
6437,2023-01-13,LOLA,hotZone,Controller Chaos,0,4,1,5
6438,2023-01-13,LOLA,heist,Hot Potato,0,0,1,1
6439,2023-01-13,LOLA,gemGrab,Deep Diner,0,5,1,6
6440,2023-01-13,LOLA,brawlBall,Sneaky Fields,0,8,8,16
6441,2023-01-13,LOLA,brawlBall,Pinhole Punt,0,1,1,2
6442,2023-01-12,LOLA,knockout,Riverside,0,3,0,3
6443,2023-01-12,LOLA,hotZone,Open Zone,0,9,7,16
6444,2023-01-12,LOLA,gemGrab,Undermine,0,4,7,11
6445,2023-01-12,LOLA,brawlBall,Pinhole Punt,0,1,1,2
6446,2023-01-11,LOLA,hotZone,Open Zone,0,4,6,10
6447,2023-01-11,LOLA,gemGrab,Gem Fort,0,0,1,1
6448,2023-01-11,LOLA,brawlBall,Sunny Soccer,0,1,4,5
6449,2023-01-10,LOLA,knockout,New Perspective,0,1,0,1
6450,2023-01-10,LOLA,hotZone,Dueling Beetles,0,4,12,16
6451,2023-01-10,LOLA,heist,Safe Zone,0,7,8,15
6452,2023-01-10,LOLA,gemGrab,Minecart Madness,0,1,3,4
6453,2023-01-10,LOLA,gemGrab,Crystal Arcade,0,0,2,2
6454,2023-01-10,LOLA,brawlBall,Beach Ball,0,2,2,4
6455,2023-01-09,LOLA,knockout,New Perspective,0,1,0,1
6456,2023-01-09,LOLA,hotZone,Dueling Beetles,0,3,2,5
6457,2023-01-09,LOLA,heist,Snaked Assault,0,5,3,8
6458,2023-01-09,LOLA,gemGrab,Minecart Madness,1,13,23,37
6459,2023-01-09,LOLA,gemGrab,Double Swoosh,0,2,2,4
6460,2023-01-09,LOLA,brawlBall,Center Stage,0,1,6,7
6461,2023-01-09,LOLA,brawlBall,Backyard Bowl,0,2,3,5
6462,2023-01-08,LOLA,knockout,X Marks the Spot,0,2,0,2
6463,2023-01-08,LOLA,hotZone,Ring of Fire,0,8,4,12
6464,2023-01-08,LOLA,heist,Snaked Assault,0,8,2,10
6465,2023-01-08,LOLA,gemGrab,Hard Rock Mine,0,4,5,9
6466,2023-01-08,LOLA,gemGrab,Double Swoosh,0,3,1,4
6467,2023-01-08,LOLA,brawlBall,Backyard Bowl,0,17,37,54
6468,2023-01-08,LOLA,bounty,Layer Cake,0,1,0,1
6469,2023-01-07,LOLA,knockout,X Marks the Spot,0,2,0,2
6470,2023-01-07,LOLA,hotZone,Ring of Fire,0,4,0,4
6471,2023-01-07,LOLA,heist,Tornado Ring,0,3,1,4
6472,2023-01-07,LOLA,gemGrab,Hard Rock Mine,0,1,0,1
6473,2023-01-07,LOLA,gemGrab,Deep Diner,0,1,1,2
6474,2023-01-07,LOLA,brawlBall,Super Beach,0,1,8,9
6475,2023-01-07,LOLA,brawlBall,Sneaky Fields,0,1,0,1
6476,2023-01-07,LOLA,bounty,Dry Season,0,2,0,2
6477,2023-01-06,LOLA,knockout,Out in the Open,0,0,4,4
6478,2023-01-06,LOLA,hotZone,Split,0,2,0,2
6479,2023-01-06,LOLA,heist,Tornado Ring,0,4,1,5
6480,2023-01-06,LOLA,gemGrab,Undermine,0,2,0,2
6481,2023-01-06,LOLA,gemGrab,Deep Diner,0,0,17,17
6482,2023-01-06,LOLA,brawlBall,Sneaky Fields,0,4,8,12
6483,2023-01-06,LOLA,brawlBall,Pinhole Punt,0,1,2,3
6484,2023-01-06,LOLA,bounty,Dry Season,0,8,15,23
6485,2023-01-05,LOLA,heist,Kaboom Canyon,0,17,57,74
6486,2023-01-05,LOLA,brawlBall,Pinhole Punt,3,21,62,86
6487,2023-01-05,LOLA,bounty,Shooting Star,0,4,16,20
6488,2023-01-04,LOLA,knockout,Goldarm Gulch,0,1,0,1
6489,2023-01-04,LOLA,hotZone,Parallel Plays,0,1,0,1
6490,2023-01-04,LOLA,heist,Kaboom Canyon,1,39,82,122
6491,2023-01-04,LOLA,gemGrab,Gem Fort,0,3,1,4
6492,2023-01-04,LOLA,brawlBall,Sunny Soccer,0,1,1,2
6493,2023-01-04,LOLA,bounty,Shooting Star,0,6,0,6
6494,2023-01-03,LOLA,knockout,Goldarm Gulch,0,2,3,5
6495,2023-01-03,LOLA,hotZone,Parallel Plays,0,3,0,3
6496,2023-01-03,LOLA,heist,Pit Stop,0,1,0,1
6497,2023-01-03,LOLA,gemGrab,Minecart Madness,0,1,24,25
6498,2023-01-03,LOLA,brawlBall,Center Stage,0,2,0,2
6499,2023-01-03,LOLA,brawlBall,Beach Ball,0,3,1,4
6500,2023-01-02,LOLA,knockout,Belle's Rock,0,1,1,2
6501,2023-01-02,LOLA,hotZone,Quarter Pounder,0,6,6,12
6502,2023-01-02,LOLA,heist,Pit Stop,0,3,0,3
6503,2023-01-02,LOLA,gemGrab,Minecart Madness,0,9,15,24
6504,2023-01-02,LOLA,gemGrab,Double Swoosh,0,2,0,2
6505,2023-01-02,LOLA,brawlBall,Center Stage,0,8,4,12
6506,2023-01-02,LOLA,brawlBall,Backyard Bowl,1,2,4,7
6507,2023-01-02,LOLA,bounty,Hideout,0,3,1,4
6508,2023-01-01,LOLA,knockout,Belle's Rock,0,2,0,2
6509,2023-01-01,LOLA,hotZone,Quarter Pounder,0,2,1,3
6510,2023-01-01,LOLA,heist,Bridge Too Far,0,12,22,34
6511,2023-01-01,LOLA,gemGrab,Double Swoosh,0,2,4,6
6512,2023-01-01,LOLA,brawlBall,Backyard Bowl,0,21,47,68
6513,2022-12-31,LOLA,heist,Bridge Too Far,0,6,10,16
6514,2022-12-31,LOLA,gemGrab,Minecart Madness,0,1,0,1
6515,2022-12-31,LOLA,gemGrab,Hard Rock Mine,0,2,0,2
6516,2022-12-31,LOLA,gemGrab,Deep Diner,0,0,1,1
6517,2022-12-31,LOLA,brawlBall,Super Beach,0,1,3,4
6518,2022-12-30,LOLA,hotZone,Controller Chaos,0,1,0,1
6519,2022-12-30,LOLA,heist,Hot Potato,0,1,0,1
6520,2022-12-30,LOLA,gemGrab,Undermine,0,2,0,2
6521,2022-12-30,LOLA,brawlBall,Sneaky Fields,0,2,1,3
6522,2022-12-29,LOLA,hotZone,Open Zone,0,0,1,1
6523,2022-12-29,LOLA,heist,Hot Potato,0,1,0,1
6524,2022-12-29,LOLA,gemGrab,Undermine,0,1,0,1
6525,2022-12-28,LOLA,hotZone,Open Zone,0,2,8,10
6526,2022-12-27,LOLA,knockout,New Perspective,0,1,0,1
6527,2022-12-26,LOLA,heist,Kaboom Canyon,0,0,1,1
6528,2022-12-26,LOLA,brawlBall,Center Stage,0,1,0,1
6529,2022-12-22,LOLA,brawlBall,Pinhole Punt,0,1,0,1
6530,2022-12-21,LOLA,brawlBall,Sunny Soccer,0,0,1,1
6531,2022-12-16,LOLA,gemGrab,Undermine,0,1,0,1
6532,2022-12-13,LOLA,heist,Safe Zone,0,0,2,2
6533,2022-12-13,LOLA,gemGrab,Crystal Arcade,0,1,0,1
6534,2022-12-11,LOLA,gemGrab,Double Swoosh,0,0,1,1
6535,2022-11-01,LOLA,knockout,New Perspective,0,0,1,1
6536,2022-10-10,LOLA,knockout,Belle's Rock,0,2,0,2
6537,2023-01-30,LEON,knockout,Belle's Rock,0,218,178,396
6538,2023-01-30,LEON,hotZone,Quarter Pounder,0,66,36,102
6539,2023-01-30,LEON,heist,Pit Stop,0,14,1,15
6540,2023-01-30,LEON,gemGrab,Minecart Madness,0,65,71,136
6541,2023-01-30,LEON,gemGrab,Double Swoosh,0,86,55,141
6542,2023-01-30,LEON,brawlBall,Center Stage,1,232,162,395
6543,2023-01-30,LEON,brawlBall,Backyard Bowl,6,60,87,153
6544,2023-01-30,LEON,bounty,Hideout,0,70,52,122
6545,2023-01-29,LEON,knockout,Belle's Rock,0,243,206,449
6546,2023-01-29,LEON,hotZone,Quarter Pounder,0,37,13,50
6547,2023-01-29,LEON,heist,Bridge Too Far,0,17,5,22
6548,2023-01-29,LEON,gemGrab,Hard Rock Mine,0,24,18,42
6549,2023-01-29,LEON,gemGrab,Double Swoosh,0,124,100,224
6550,2023-01-29,LEON,brawlBall,Super Beach,0,3,3,6
6551,2023-01-29,LEON,brawlBall,Backyard Bowl,40,818,875,1733
6552,2023-01-29,LEON,bounty,Canal Grande,0,58,26,84
6553,2023-01-28,LEON,knockout,Flaring Phoenix,0,154,101,255
6554,2023-01-28,LEON,hotZone,Controller Chaos,0,45,11,56
6555,2023-01-28,LEON,heist,Bridge Too Far,0,31,15,46
6556,2023-01-28,LEON,gemGrab,Hard Rock Mine,0,203,176,379
6557,2023-01-28,LEON,gemGrab,Deep Diner,0,77,71,148
6558,2023-01-28,LEON,brawlBall,Super Beach,10,354,282,646
6559,2023-01-28,LEON,brawlBall,Sneaky Fields,0,6,8,14
6560,2023-01-28,LEON,bounty,Canal Grande,0,134,108,242
6561,2023-01-27,LEON,knockout,Flaring Phoenix,0,73,57,130
6562,2023-01-27,LEON,hotZone,Controller Chaos,0,14,4,18
6563,2023-01-27,LEON,heist,Hot Potato,0,7,1,8
6564,2023-01-27,LEON,gemGrab,Undermine,0,11,12,23
6565,2023-01-27,LEON,gemGrab,Deep Diner,0,87,77,164
6566,2023-01-27,LEON,brawlBall,Sneaky Fields,1,84,71,156
6567,2023-01-27,LEON,brawlBall,Pinhole Punt,1,5,5,11
6568,2023-01-27,LEON,bounty,Temple Ruins,0,36,20,56
6569,2023-01-26,LEON,knockout,Riverside,0,184,87,271
6570,2023-01-26,LEON,hotZone,Open Zone,0,66,37,103
6571,2023-01-26,LEON,heist,Hot Potato,0,14,3,17
6572,2023-01-26,LEON,gemGrab,Undermine,0,92,44,136
6573,2023-01-26,LEON,gemGrab,Gem Fort,0,47,40,87
6574,2023-01-26,LEON,brawlBall,Sunny Soccer,0,27,5,32
6575,2023-01-26,LEON,brawlBall,Pinhole Punt,20,509,530,1059
6576,2023-01-26,LEON,bounty,Temple Ruins,0,87,53,140
6577,2023-01-25,LEON,knockout,Riverside,0,100,70,170
6578,2023-01-25,LEON,hotZone,Open Zone,0,31,28,59
6579,2023-01-25,LEON,heist,Safe Zone,0,20,6,26
6580,2023-01-25,LEON,gemGrab,Gem Fort,0,50,52,102
6581,2023-01-25,LEON,gemGrab,Crystal Arcade,0,92,44,136
6582,2023-01-25,LEON,brawlBall,Sunny Soccer,6,228,190,424
6583,2023-01-25,LEON,brawlBall,Beach Ball,2,51,24,77
6584,2023-01-25,LEON,bounty,Excel,0,68,52,120
6585,2023-01-24,LEON,knockout,New Perspective,0,196,114,310
6586,2023-01-24,LEON,hotZone,Dueling Beetles,0,39,41,80
6587,2023-01-24,LEON,heist,Safe Zone,0,25,7,32
6588,2023-01-24,LEON,gemGrab,Minecart Madness,0,31,23,54
6589,2023-01-24,LEON,gemGrab,Crystal Arcade,0,156,108,264
6590,2023-01-24,LEON,brawlBall,Center Stage,3,40,21,64
6591,2023-01-24,LEON,brawlBall,Beach Ball,7,451,402,860
6592,2023-01-24,LEON,bounty,Excel,0,106,76,182
6593,2023-01-23,LEON,knockout,New Perspective,0,264,192,456
6594,2023-01-23,LEON,hotZone,Dueling Beetles,0,61,49,110
6595,2023-01-23,LEON,heist,Snaked Assault,0,30,12,42
6596,2023-01-23,LEON,gemGrab,Minecart Madness,0,133,90,223
6597,2023-01-23,LEON,gemGrab,Double Swoosh,0,53,22,75
6598,2023-01-23,LEON,brawlBall,Center Stage,8,410,299,717
6599,2023-01-23,LEON,brawlBall,Backyard Bowl,1,44,76,121
6600,2023-01-23,LEON,bounty,Layer Cake,0,161,186,347
6601,2023-01-22,LEON,knockout,X Marks the Spot,0,84,77,161
6602,2023-01-22,LEON,hotZone,Ring of Fire,0,45,32,77
6603,2023-01-22,LEON,heist,Snaked Assault,0,13,4,17
6604,2023-01-22,LEON,gemGrab,Hard Rock Mine,0,54,37,91
6605,2023-01-22,LEON,gemGrab,Double Swoosh,0,71,57,128
6606,2023-01-22,LEON,brawlBall,Super Beach,1,32,20,53
6607,2023-01-22,LEON,brawlBall,Backyard Bowl,17,376,412,805
6608,2023-01-22,LEON,bounty,Layer Cake,0,119,91,210
6609,2023-01-21,LEON,knockout,X Marks the Spot,0,313,254,567
6610,2023-01-21,LEON,hotZone,Ring of Fire,0,102,139,241
6611,2023-01-21,LEON,heist,Tornado Ring,0,23,19,42
6612,2023-01-21,LEON,gemGrab,Hard Rock Mine,0,253,203,456
6613,2023-01-21,LEON,gemGrab,Deep Diner,0,68,70,138
6614,2023-01-21,LEON,brawlBall,Super Beach,8,464,308,780
6615,2023-01-21,LEON,brawlBall,Sneaky Fields,0,16,15,31
6616,2023-01-21,LEON,bounty,Dry Season,0,177,238,415
6617,2023-01-20,LEON,knockout,Out in the Open,0,251,183,434
6618,2023-01-20,LEON,hotZone,Split,0,26,14,40
6619,2023-01-20,LEON,heist,Tornado Ring,0,15,8,23
6620,2023-01-20,LEON,gemGrab,Undermine,0,63,40,103
6621,2023-01-20,LEON,gemGrab,Deep Diner,0,208,198,406
6622,2023-01-20,LEON,brawlBall,Sneaky Fields,6,302,186,494
6623,2023-01-20,LEON,brawlBall,Pinhole Punt,0,35,38,73
6624,2023-01-20,LEON,bounty,Dry Season,0,189,174,363
6625,2023-01-19,LEON,knockout,Out in the Open,0,262,153,415
6626,2023-01-19,LEON,hotZone,Split,0,37,19,56
6627,2023-01-19,LEON,heist,Kaboom Canyon,0,14,12,26
6628,2023-01-19,LEON,gemGrab,Undermine,0,141,114,255
6629,2023-01-19,LEON,gemGrab,Gem Fort,0,30,29,59
6630,2023-01-19,LEON,brawlBall,Sunny Soccer,0,18,5,23
6631,2023-01-19,LEON,brawlBall,Pinhole Punt,20,554,516,1090
6632,2023-01-19,LEON,bounty,Shooting Star,0,103,64,167
6633,2023-01-18,LEON,knockout,Goldarm Gulch,1,41,31,73
6634,2023-01-18,LEON,hotZone,Parallel Plays,0,7,2,9
6635,2023-01-18,LEON,heist,Kaboom Canyon,0,4,2,6
6636,2023-01-18,LEON,gemGrab,Gem Fort,0,38,29,67
6637,2023-01-18,LEON,gemGrab,Crystal Arcade,0,10,7,17
6638,2023-01-18,LEON,brawlBall,Sunny Soccer,3,118,81,202
6639,2023-01-18,LEON,brawlBall,Beach Ball,0,6,0,6
6640,2023-01-18,LEON,bounty,Shooting Star,0,52,49,101
6641,2023-01-17,LEON,knockout,Goldarm Gulch,0,36,21,57
6642,2023-01-17,LEON,hotZone,Parallel Plays,0,12,7,19
6643,2023-01-17,LEON,heist,Pit Stop,0,1,1,2
6644,2023-01-17,LEON,gemGrab,Minecart Madness,0,1,1,2
6645,2023-01-17,LEON,gemGrab,Crystal Arcade,0,5,4,9
6646,2023-01-17,LEON,brawlBall,Center Stage,0,3,1,4
6647,2023-01-17,LEON,brawlBall,Beach Ball,1,51,30,82
6648,2023-01-17,LEON,bounty,Hideout,0,9,10,19
6649,2023-01-16,LEON,knockout,Belle's Rock,0,9,7,16
6650,2023-01-16,LEON,hotZone,Quarter Pounder,0,7,14,21
6651,2023-01-16,LEON,heist,Pit Stop,0,2,0,2
6652,2023-01-16,LEON,gemGrab,Minecart Madness,0,15,15,30
6653,2023-01-16,LEON,gemGrab,Double Swoosh,0,6,0,6
6654,2023-01-16,LEON,brawlBall,Center Stage,1,19,12,32
6655,2023-01-16,LEON,brawlBall,Backyard Bowl,1,14,0,15
6656,2023-01-16,LEON,bounty,Hideout,0,20,25,45
6657,2023-01-15,LEON,knockout,Belle's Rock,0,31,15,46
6658,2023-01-15,LEON,hotZone,Quarter Pounder,0,11,1,12
6659,2023-01-15,LEON,heist,Bridge Too Far,0,1,1,2
6660,2023-01-15,LEON,gemGrab,Hard Rock Mine,0,16,26,42
6661,2023-01-15,LEON,gemGrab,Double Swoosh,0,14,4,18
6662,2023-01-15,LEON,brawlBall,Super Beach,0,2,4,6
6663,2023-01-15,LEON,brawlBall,Backyard Bowl,6,117,113,236
6664,2023-01-15,LEON,bounty,Canal Grande,0,8,4,12
6665,2023-01-14,LEON,knockout,Flaring Phoenix,0,11,5,16
6666,2023-01-14,LEON,hotZone,Controller Chaos,0,9,4,13
6667,2023-01-14,LEON,heist,Bridge Too Far,0,6,0,6
6668,2023-01-14,LEON,gemGrab,Hard Rock Mine,0,17,11,28
6669,2023-01-14,LEON,gemGrab,Deep Diner,0,6,4,10
6670,2023-01-14,LEON,brawlBall,Super Beach,1,22,11,34
6671,2023-01-14,LEON,brawlBall,Sneaky Fields,0,2,0,2
6672,2023-01-14,LEON,bounty,Canal Grande,0,9,8,17
6673,2023-01-13,LEON,knockout,Flaring Phoenix,0,11,8,19
6674,2023-01-13,LEON,hotZone,Controller Chaos,0,11,0,11
6675,2023-01-13,LEON,gemGrab,Deep Diner,0,25,3,28
6676,2023-01-13,LEON,brawlBall,Sneaky Fields,0,11,2,13
6677,2023-01-13,LEON,brawlBall,Pinhole Punt,0,0,1,1
6678,2023-01-13,LEON,bounty,Temple Ruins,0,4,2,6
6679,2023-01-12,LEON,knockout,Riverside,0,22,9,31
6680,2023-01-12,LEON,hotZone,Open Zone,0,10,2,12
6681,2023-01-12,LEON,gemGrab,Undermine,0,5,3,8
6682,2023-01-12,LEON,gemGrab,Gem Fort,0,1,1,2
6683,2023-01-12,LEON,brawlBall,Sunny Soccer,0,3,0,3
6684,2023-01-12,LEON,brawlBall,Pinhole Punt,0,22,10,32
6685,2023-01-11,LEON,knockout,Riverside,0,1,4,5
6686,2023-01-11,LEON,hotZone,Open Zone,0,11,31,42
6687,2023-01-11,LEON,gemGrab,Gem Fort,0,5,2,7
6688,2023-01-11,LEON,brawlBall,Sunny Soccer,0,13,21,34
6689,2023-01-11,LEON,bounty,Excel,0,3,2,5
6690,2023-01-10,LEON,knockout,New Perspective,0,11,10,21
6691,2023-01-10,LEON,hotZone,Dueling Beetles,0,9,2,11
6692,2023-01-10,LEON,gemGrab,Minecart Madness,0,7,4,11
6693,2023-01-10,LEON,gemGrab,Crystal Arcade,0,20,4,24
6694,2023-01-10,LEON,brawlBall,Center Stage,0,1,0,1
6695,2023-01-10,LEON,brawlBall,Beach Ball,0,16,12,28
6696,2023-01-10,LEON,bounty,Excel,0,5,0,5
6697,2023-01-09,LEON,knockout,New Perspective,0,11,4,15
6698,2023-01-09,LEON,hotZone,Dueling Beetles,0,9,6,15
6699,2023-01-09,LEON,heist,Snaked Assault,0,3,1,4
6700,2023-01-09,LEON,gemGrab,Minecart Madness,0,22,10,32
6701,2023-01-09,LEON,gemGrab,Double Swoosh,0,8,0,8
6702,2023-01-09,LEON,brawlBall,Center Stage,1,20,12,33
6703,2023-01-09,LEON,brawlBall,Backyard Bowl,1,4,0,5
6704,2023-01-09,LEON,bounty,Layer Cake,0,24,16,40
6705,2023-01-08,LEON,knockout,X Marks the Spot,0,29,31,60
6706,2023-01-08,LEON,hotZone,Ring of Fire,0,9,5,14
6707,2023-01-08,LEON,heist,Snaked Assault,0,3,1,4
6708,2023-01-08,LEON,gemGrab,Hard Rock Mine,0,4,4,8
6709,2023-01-08,LEON,gemGrab,Double Swoosh,0,4,0,4
6710,2023-01-08,LEON,brawlBall,Super Beach,0,4,2,6
6711,2023-01-08,LEON,brawlBall,Backyard Bowl,1,66,60,127
6712,2023-01-08,LEON,bounty,Layer Cake,0,0,2,2
6713,2023-01-07,LEON,knockout,X Marks the Spot,0,5,2,7
6714,2023-01-07,LEON,hotZone,Ring of Fire,0,1,0,1
6715,2023-01-07,LEON,heist,Tornado Ring,0,4,0,4
6716,2023-01-07,LEON,gemGrab,Hard Rock Mine,0,16,16,32
6717,2023-01-07,LEON,gemGrab,Deep Diner,0,6,2,8
6718,2023-01-07,LEON,brawlBall,Super Beach,0,8,3,11
6719,2023-01-07,LEON,brawlBall,Sneaky Fields,1,3,2,6
6720,2023-01-07,LEON,bounty,Dry Season,0,22,12,34
6721,2023-01-06,LEON,knockout,Out in the Open,0,11,6,17
6722,2023-01-06,LEON,hotZone,Split,0,5,0,5
6723,2023-01-06,LEON,heist,Tornado Ring,0,4,1,5
6724,2023-01-06,LEON,gemGrab,Undermine,0,5,0,5
6725,2023-01-06,LEON,gemGrab,Deep Diner,0,20,5,25
6726,2023-01-06,LEON,brawlBall,Sneaky Fields,0,13,9,22
6727,2023-01-06,LEON,brawlBall,Pinhole Punt,0,0,2,2
6728,2023-01-06,LEON,bounty,Dry Season,0,31,49,80
6729,2023-01-05,LEON,knockout,Out in the Open,0,28,19,47
6730,2023-01-05,LEON,hotZone,Split,1,5,2,8
6731,2023-01-05,LEON,heist,Kaboom Canyon,0,1,0,1
6732,2023-01-05,LEON,gemGrab,Undermine,0,14,6,20
6733,2023-01-05,LEON,gemGrab,Gem Fort,0,4,1,5
6734,2023-01-05,LEON,brawlBall,Pinhole Punt,2,58,123,183
6735,2023-01-05,LEON,bounty,Shooting Star,0,24,9,33
6736,2023-01-04,LEON,knockout,Goldarm Gulch,0,15,1,16
6737,2023-01-04,LEON,hotZone,Parallel Plays,0,10,4,14
6738,2023-01-04,LEON,heist,Kaboom Canyon,0,3,0,3
6739,2023-01-04,LEON,gemGrab,Gem Fort,0,10,4,14
6740,2023-01-04,LEON,gemGrab,Crystal Arcade,0,5,1,6
6741,2023-01-04,LEON,brawlBall,Sunny Soccer,0,15,12,27
6742,2023-01-04,LEON,bounty,Shooting Star,0,46,10,56
6743,2023-01-03,LEON,knockout,Goldarm Gulch,0,12,2,14
6744,2023-01-03,LEON,hotZone,Parallel Plays,1,29,92,122
6745,2023-01-03,LEON,heist,Pit Stop,0,0,1,1
6746,2023-01-03,LEON,gemGrab,Minecart Madness,0,4,0,4
6747,2023-01-03,LEON,gemGrab,Crystal Arcade,0,24,1,25
6748,2023-01-03,LEON,brawlBall,Center Stage,0,3,0,3
6749,2023-01-03,LEON,brawlBall,Beach Ball,0,21,15,36
6750,2023-01-03,LEON,bounty,Hideout,0,26,20,46
6751,2023-01-02,LEON,knockout,Belle's Rock,0,18,3,21
6752,2023-01-02,LEON,hotZone,Quarter Pounder,0,12,10,22
6753,2023-01-02,LEON,heist,Pit Stop,0,2,0,2
6754,2023-01-02,LEON,gemGrab,Minecart Madness,0,25,5,30
6755,2023-01-02,LEON,gemGrab,Double Swoosh,0,9,1,10
6756,2023-01-02,LEON,brawlBall,Center Stage,1,19,10,30
6757,2023-01-02,LEON,brawlBall,Backyard Bowl,0,6,1,7
6758,2023-01-02,LEON,bounty,Hideout,0,63,59,122
6759,2023-01-01,LEON,knockout,Belle's Rock,0,8,5,13
6760,2023-01-01,LEON,hotZone,Quarter Pounder,0,2,11,13
6761,2023-01-01,LEON,gemGrab,Double Swoosh,0,8,3,11
6762,2023-01-01,LEON,brawlBall,Backyard Bowl,0,22,21,43
6763,2023-01-01,LEON,bounty,Canal Grande,0,1,0,1
6764,2022-12-31,LEON,gemGrab,Hard Rock Mine,0,2,11,13
6765,2022-12-31,LEON,gemGrab,Deep Diner,0,5,8,13
6766,2022-12-31,LEON,brawlBall,Super Beach,0,3,4,7
6767,2022-12-31,LEON,bounty,Canal Grande,0,1,0,1
6768,2022-12-30,LEON,knockout,Flaring Phoenix,0,1,0,1
6769,2022-12-30,LEON,hotZone,Controller Chaos,0,1,0,1
6770,2022-12-30,LEON,gemGrab,Deep Diner,0,14,7,21
6771,2022-12-30,LEON,brawlBall,Sneaky Fields,0,5,3,8
6772,2022-12-29,LEON,hotZone,Open Zone,0,1,0,1
6773,2022-12-29,LEON,gemGrab,Gem Fort,0,2,1,3
6774,2022-12-29,LEON,brawlBall,Pinhole Punt,0,3,0,3
6775,2022-12-28,LEON,hotZone,Open Zone,0,0,1,1
6776,2022-12-27,LEON,knockout,New Perspective,0,0,1,1
6777,2022-12-27,LEON,hotZone,Controller Chaos,0,1,0,1
6778,2022-12-27,LEON,heist,Safe Zone,0,1,1,2
6779,2022-12-27,LEON,gemGrab,Minecart Madness,0,1,0,1
6780,2022-12-27,LEON,brawlBall,Beach Ball,0,8,5,13
6781,2022-12-27,LEON,bounty,Excel,0,2,1,3
6782,2022-12-25,LEON,brawlBall,Backyard Bowl,0,1,0,1
6783,2022-12-23,LEON,knockout,Out in the Open,0,1,1,2
6784,2022-12-22,LEON,brawlBall,Pinhole Punt,0,4,0,4
6785,2022-12-21,LEON,brawlBall,Sunny Soccer,0,1,0,1
6786,2022-12-20,LEON,brawlBall,Beach Ball,0,1,2,3
6787,2022-12-16,LEON,bounty,Temple Ruins,0,1,0,1
6788,2022-12-13,LEON,knockout,New Perspective,0,3,0,3
6789,2022-12-13,LEON,gemGrab,Crystal Arcade,0,4,0,4
6790,2022-11-07,LEON,hotZone,Quarter Pounder,0,1,0,1
6791,2022-11-01,LEON,knockout,New Perspective,0,0,1,1
6792,2022-10-26,LEON,bounty,Shooting Star,0,1,4,5
6793,2022-10-15,LEON,gemGrab,Hard Rock Mine,0,2,2,4
6794,2023-01-30,JESSIE,knockout,Belle's Rock,0,34,18,52
6795,2023-01-30,JESSIE,hotZone,Quarter Pounder,2,241,123,366
6796,2023-01-30,JESSIE,heist,Pit Stop,1,108,63,172
6797,2023-01-30,JESSIE,gemGrab,Minecart Madness,0,85,64,149
6798,2023-01-30,JESSIE,gemGrab,Double Swoosh,0,89,59,148
6799,2023-01-30,JESSIE,brawlBall,Center Stage,7,150,200,357
6800,2023-01-30,JESSIE,brawlBall,Backyard Bowl,2,32,19,53
6801,2023-01-30,JESSIE,bounty,Hideout,0,9,5,14
6802,2023-01-29,JESSIE,knockout,Belle's Rock,0,33,11,44
6803,2023-01-29,JESSIE,hotZone,Quarter Pounder,0,125,50,175
6804,2023-01-29,JESSIE,heist,Bridge Too Far,1,178,104,283
6805,2023-01-29,JESSIE,gemGrab,Hard Rock Mine,0,19,8,27
6806,2023-01-29,JESSIE,gemGrab,Double Swoosh,0,121,140,261
6807,2023-01-29,JESSIE,brawlBall,Super Beach,1,12,13,26
6808,2023-01-29,JESSIE,brawlBall,Backyard Bowl,15,305,275,595
6809,2023-01-29,JESSIE,bounty,Canal Grande,0,12,9,21
6810,2023-01-28,JESSIE,knockout,Flaring Phoenix,0,15,11,26
6811,2023-01-28,JESSIE,hotZone,Controller Chaos,0,136,118,254
6812,2023-01-28,JESSIE,heist,Bridge Too Far,0,327,251,578
6813,2023-01-28,JESSIE,gemGrab,Hard Rock Mine,0,100,69,169
6814,2023-01-28,JESSIE,gemGrab,Deep Diner,0,63,45,108
6815,2023-01-28,JESSIE,brawlBall,Super Beach,15,424,493,932
6816,2023-01-28,JESSIE,brawlBall,Sneaky Fields,0,5,6,11
6817,2023-01-28,JESSIE,bounty,Canal Grande,0,36,9,45
6818,2023-01-27,JESSIE,knockout,Flaring Phoenix,0,9,6,15
6819,2023-01-27,JESSIE,hotZone,Controller Chaos,0,18,30,48
6820,2023-01-27,JESSIE,heist,Hot Potato,1,115,82,198
6821,2023-01-27,JESSIE,gemGrab,Undermine,0,5,4,9
6822,2023-01-27,JESSIE,gemGrab,Deep Diner,0,57,40,97
6823,2023-01-27,JESSIE,brawlBall,Sneaky Fields,3,74,79,156
6824,2023-01-27,JESSIE,brawlBall,Pinhole Punt,0,2,0,2
6825,2023-01-27,JESSIE,bounty,Temple Ruins,0,3,1,4
6826,2023-01-26,JESSIE,knockout,Riverside,0,29,18,47
6827,2023-01-26,JESSIE,hotZone,Open Zone,0,97,58,155
6828,2023-01-26,JESSIE,heist,Hot Potato,0,300,222,522
6829,2023-01-26,JESSIE,gemGrab,Undermine,0,72,78,150
6830,2023-01-26,JESSIE,gemGrab,Gem Fort,0,57,33,90
6831,2023-01-26,JESSIE,brawlBall,Sunny Soccer,0,22,18,40
6832,2023-01-26,JESSIE,brawlBall,Pinhole Punt,6,286,312,604
6833,2023-01-26,JESSIE,bounty,Temple Ruins,0,18,11,29
6834,2023-01-25,JESSIE,knockout,Riverside,0,12,6,18
6835,2023-01-25,JESSIE,hotZone,Open Zone,0,50,40,90
6836,2023-01-25,JESSIE,heist,Safe Zone,2,272,161,435
6837,2023-01-25,JESSIE,gemGrab,Gem Fort,0,50,42,92
6838,2023-01-25,JESSIE,gemGrab,Crystal Arcade,0,71,93,164
6839,2023-01-25,JESSIE,brawlBall,Sunny Soccer,7,199,218,424
6840,2023-01-25,JESSIE,brawlBall,Beach Ball,2,26,26,54
6841,2023-01-25,JESSIE,bounty,Excel,0,17,6,23
6842,2023-01-24,JESSIE,knockout,New Perspective,0,32,40,72
6843,2023-01-24,JESSIE,hotZone,Dueling Beetles,0,140,119,259
6844,2023-01-24,JESSIE,heist,Safe Zone,0,443,300,743
6845,2023-01-24,JESSIE,gemGrab,Minecart Madness,0,23,12,35
6846,2023-01-24,JESSIE,gemGrab,Crystal Arcade,0,99,65,164
6847,2023-01-24,JESSIE,brawlBall,Center Stage,0,27,20,47
6848,2023-01-24,JESSIE,brawlBall,Beach Ball,9,285,277,571
6849,2023-01-24,JESSIE,bounty,Excel,0,15,5,20
6850,2023-01-23,JESSIE,knockout,New Perspective,0,35,19,54
6851,2023-01-23,JESSIE,hotZone,Dueling Beetles,0,219,139,358
6852,2023-01-23,JESSIE,heist,Snaked Assault,2,631,343,976
6853,2023-01-23,JESSIE,gemGrab,Minecart Madness,0,118,79,197
6854,2023-01-23,JESSIE,gemGrab,Double Swoosh,0,65,64,129
6855,2023-01-23,JESSIE,brawlBall,Center Stage,10,274,236,520
6856,2023-01-23,JESSIE,brawlBall,Backyard Bowl,1,24,11,36
6857,2023-01-23,JESSIE,bounty,Layer Cake,0,26,9,35
6858,2023-01-22,JESSIE,knockout,X Marks the Spot,0,16,5,21
6859,2023-01-22,JESSIE,hotZone,Ring of Fire,0,65,37,102
6860,2023-01-22,JESSIE,heist,Snaked Assault,2,239,151,392
6861,2023-01-22,JESSIE,gemGrab,Hard Rock Mine,0,24,15,39
6862,2023-01-22,JESSIE,gemGrab,Double Swoosh,0,74,66,140
6863,2023-01-22,JESSIE,brawlBall,Super Beach,0,42,47,89
6864,2023-01-22,JESSIE,brawlBall,Backyard Bowl,8,143,108,259
6865,2023-01-22,JESSIE,bounty,Layer Cake,0,12,3,15
6866,2023-01-21,JESSIE,knockout,X Marks the Spot,0,45,18,63
6867,2023-01-21,JESSIE,hotZone,Ring of Fire,0,174,130,304
6868,2023-01-21,JESSIE,heist,Tornado Ring,2,367,213,582
6869,2023-01-21,JESSIE,gemGrab,Hard Rock Mine,0,176,104,280
6870,2023-01-21,JESSIE,gemGrab,Deep Diner,0,49,62,111
6871,2023-01-21,JESSIE,brawlBall,Super Beach,12,500,691,1203
6872,2023-01-21,JESSIE,brawlBall,Sneaky Fields,1,13,10,24
6873,2023-01-21,JESSIE,bounty,Dry Season,0,31,11,42
6874,2023-01-20,JESSIE,knockout,Out in the Open,0,44,35,79
6875,2023-01-20,JESSIE,hotZone,Split,0,40,15,55
6876,2023-01-20,JESSIE,heist,Tornado Ring,3,315,238,556
6877,2023-01-20,JESSIE,gemGrab,Undermine,0,40,40,80
6878,2023-01-20,JESSIE,gemGrab,Deep Diner,0,190,170,360
6879,2023-01-20,JESSIE,brawlBall,Sneaky Fields,9,236,263,508
6880,2023-01-20,JESSIE,brawlBall,Pinhole Punt,0,23,30,53
6881,2023-01-20,JESSIE,bounty,Dry Season,0,16,16,32
6882,2023-01-19,JESSIE,knockout,Out in the Open,0,57,25,82
6883,2023-01-19,JESSIE,hotZone,Split,0,62,23,85
6884,2023-01-19,JESSIE,heist,Kaboom Canyon,0,215,164,379
6885,2023-01-19,JESSIE,gemGrab,Undermine,0,116,75,191
6886,2023-01-19,JESSIE,gemGrab,Gem Fort,0,27,16,43
6887,2023-01-19,JESSIE,brawlBall,Sunny Soccer,0,8,10,18
6888,2023-01-19,JESSIE,brawlBall,Pinhole Punt,11,336,336,683
6889,2023-01-19,JESSIE,bounty,Shooting Star,0,16,4,20
6890,2023-01-18,JESSIE,knockout,Goldarm Gulch,0,4,7,11
6891,2023-01-18,JESSIE,hotZone,Parallel Plays,0,13,14,27
6892,2023-01-18,JESSIE,heist,Kaboom Canyon,0,71,45,116
6893,2023-01-18,JESSIE,gemGrab,Gem Fort,0,36,31,67
6894,2023-01-18,JESSIE,gemGrab,Crystal Arcade,0,13,1,14
6895,2023-01-18,JESSIE,brawlBall,Sunny Soccer,6,86,90,182
6896,2023-01-18,JESSIE,brawlBall,Beach Ball,0,2,2,4
6897,2023-01-18,JESSIE,bounty,Shooting Star,0,7,5,12
6898,2023-01-17,JESSIE,knockout,Goldarm Gulch,0,3,0,3
6899,2023-01-17,JESSIE,hotZone,Parallel Plays,0,16,13,29
6900,2023-01-17,JESSIE,heist,Pit Stop,0,22,8,30
6901,2023-01-17,JESSIE,gemGrab,Minecart Madness,0,1,3,4
6902,2023-01-17,JESSIE,gemGrab,Crystal Arcade,0,7,4,11
6903,2023-01-17,JESSIE,brawlBall,Beach Ball,1,28,29,58
6904,2023-01-17,JESSIE,bounty,Hideout,0,2,0,2
6905,2023-01-16,JESSIE,knockout,Belle's Rock,0,6,1,7
6906,2023-01-16,JESSIE,hotZone,Quarter Pounder,0,21,4,25
6907,2023-01-16,JESSIE,heist,Pit Stop,0,30,16,46
6908,2023-01-16,JESSIE,gemGrab,Minecart Madness,0,16,12,28
6909,2023-01-16,JESSIE,gemGrab,Double Swoosh,0,6,3,9
6910,2023-01-16,JESSIE,brawlBall,Center Stage,1,14,12,27
6911,2023-01-16,JESSIE,brawlBall,Backyard Bowl,0,2,0,2
6912,2023-01-16,JESSIE,bounty,Hideout,0,0,1,1
6913,2023-01-15,JESSIE,knockout,Belle's Rock,0,4,4,8
6914,2023-01-15,JESSIE,hotZone,Quarter Pounder,0,38,12,50
6915,2023-01-15,JESSIE,heist,Bridge Too Far,0,57,30,87
6916,2023-01-15,JESSIE,gemGrab,Hard Rock Mine,0,5,1,6
6917,2023-01-15,JESSIE,gemGrab,Double Swoosh,0,14,16,30
6918,2023-01-15,JESSIE,brawlBall,Super Beach,0,5,2,7
6919,2023-01-15,JESSIE,brawlBall,Backyard Bowl,2,31,38,71
6920,2023-01-15,JESSIE,bounty,Canal Grande,0,3,1,4
6921,2023-01-14,JESSIE,knockout,Flaring Phoenix,0,2,0,2
6922,2023-01-14,JESSIE,hotZone,Controller Chaos,0,27,15,42
6923,2023-01-14,JESSIE,heist,Bridge Too Far,0,44,19,63
6924,2023-01-14,JESSIE,gemGrab,Hard Rock Mine,0,8,3,11
6925,2023-01-14,JESSIE,gemGrab,Deep Diner,0,8,6,14
6926,2023-01-14,JESSIE,brawlBall,Super Beach,0,44,57,101
6927,2023-01-14,JESSIE,brawlBall,Sneaky Fields,0,3,1,4
6928,2023-01-14,JESSIE,bounty,Canal Grande,0,1,1,2
6929,2023-01-13,JESSIE,knockout,Flaring Phoenix,0,3,1,4
6930,2023-01-13,JESSIE,hotZone,Controller Chaos,0,26,6,32
6931,2023-01-13,JESSIE,heist,Hot Potato,0,17,20,37
6932,2023-01-13,JESSIE,gemGrab,Undermine,0,1,0,1
6933,2023-01-13,JESSIE,gemGrab,Deep Diner,0,13,6,19
6934,2023-01-13,JESSIE,brawlBall,Sneaky Fields,0,15,35,50
6935,2023-01-13,JESSIE,brawlBall,Pinhole Punt,0,1,0,1
6936,2023-01-13,JESSIE,bounty,Temple Ruins,0,1,0,1
6937,2023-01-12,JESSIE,knockout,Riverside,0,3,0,3
6938,2023-01-12,JESSIE,hotZone,Open Zone,0,21,1,22
6939,2023-01-12,JESSIE,heist,Hot Potato,0,8,3,11
6940,2023-01-12,JESSIE,gemGrab,Undermine,0,2,1,3
6941,2023-01-12,JESSIE,brawlBall,Sunny Soccer,0,0,1,1
6942,2023-01-12,JESSIE,brawlBall,Pinhole Punt,0,12,26,38
6943,2023-01-11,JESSIE,knockout,Riverside,0,1,0,1
6944,2023-01-11,JESSIE,hotZone,Open Zone,0,1,2,3
6945,2023-01-11,JESSIE,heist,Safe Zone,0,2,1,3
6946,2023-01-11,JESSIE,gemGrab,Gem Fort,0,4,1,5
6947,2023-01-11,JESSIE,brawlBall,Sunny Soccer,0,4,7,11
6948,2023-01-10,JESSIE,hotZone,Dueling Beetles,0,36,30,66
6949,2023-01-10,JESSIE,heist,Safe Zone,0,33,9,42
6950,2023-01-10,JESSIE,gemGrab,Minecart Madness,0,8,5,13
6951,2023-01-10,JESSIE,gemGrab,Crystal Arcade,0,8,1,9
6952,2023-01-10,JESSIE,brawlBall,Center Stage,0,3,1,4
6953,2023-01-10,JESSIE,brawlBall,Beach Ball,0,13,17,30
6954,2023-01-09,JESSIE,knockout,New Perspective,0,1,0,1
6955,2023-01-09,JESSIE,hotZone,Dueling Beetles,0,11,14,25
6956,2023-01-09,JESSIE,heist,Snaked Assault,0,78,49,127
6957,2023-01-09,JESSIE,gemGrab,Minecart Madness,0,16,10,26
6958,2023-01-09,JESSIE,gemGrab,Double Swoosh,0,7,2,9
6959,2023-01-09,JESSIE,brawlBall,Center Stage,0,9,1,10
6960,2023-01-09,JESSIE,brawlBall,Backyard Bowl,0,1,1,2
6961,2023-01-09,JESSIE,bounty,Layer Cake,0,2,2,4
6962,2023-01-08,JESSIE,knockout,X Marks the Spot,0,2,0,2
6963,2023-01-08,JESSIE,hotZone,Ring of Fire,0,24,2,26
6964,2023-01-08,JESSIE,heist,Snaked Assault,0,38,19,57
6965,2023-01-08,JESSIE,gemGrab,Hard Rock Mine,0,6,1,7
6966,2023-01-08,JESSIE,gemGrab,Double Swoosh,0,8,11,19
6967,2023-01-08,JESSIE,brawlBall,Super Beach,0,4,10,14
6968,2023-01-08,JESSIE,brawlBall,Backyard Bowl,0,19,11,30
6969,2023-01-08,JESSIE,bounty,Layer Cake,0,1,1,2
6970,2023-01-07,JESSIE,hotZone,Ring of Fire,0,9,2,11
6971,2023-01-07,JESSIE,heist,Tornado Ring,0,27,10,37
6972,2023-01-07,JESSIE,gemGrab,Hard Rock Mine,0,6,3,9
6973,2023-01-07,JESSIE,gemGrab,Deep Diner,0,13,7,20
6974,2023-01-07,JESSIE,brawlBall,Super Beach,2,15,23,40
6975,2023-01-07,JESSIE,brawlBall,Sneaky Fields,0,1,0,1
6976,2023-01-07,JESSIE,bounty,Dry Season,0,2,0,2
6977,2023-01-06,JESSIE,knockout,Out in the Open,0,3,1,4
6978,2023-01-06,JESSIE,hotZone,Split,0,4,0,4
6979,2023-01-06,JESSIE,heist,Tornado Ring,0,43,32,75
6980,2023-01-06,JESSIE,gemGrab,Undermine,0,1,2,3
6981,2023-01-06,JESSIE,gemGrab,Deep Diner,0,20,3,23
6982,2023-01-06,JESSIE,brawlBall,Sneaky Fields,0,5,6,11
6983,2023-01-06,JESSIE,brawlBall,Pinhole Punt,0,1,1,2
6984,2023-01-06,JESSIE,bounty,Dry Season,0,2,0,2
6985,2023-01-05,JESSIE,knockout,Out in the Open,0,2,1,3
6986,2023-01-05,JESSIE,hotZone,Split,0,3,1,4
6987,2023-01-05,JESSIE,heist,Kaboom Canyon,0,36,7,43
6988,2023-01-05,JESSIE,gemGrab,Undermine,0,20,5,25
6989,2023-01-05,JESSIE,gemGrab,Gem Fort,0,1,3,4
6990,2023-01-05,JESSIE,brawlBall,Pinhole Punt,0,17,18,35
6991,2023-01-05,JESSIE,bounty,Shooting Star,0,1,0,1
6992,2023-01-04,JESSIE,knockout,Goldarm Gulch,0,2,0,2
6993,2023-01-04,JESSIE,hotZone,Parallel Plays,0,11,21,32
6994,2023-01-04,JESSIE,heist,Kaboom Canyon,1,59,38,98
6995,2023-01-04,JESSIE,gemGrab,Gem Fort,0,12,8,20
6996,2023-01-04,JESSIE,gemGrab,Crystal Arcade,0,7,4,11
6997,2023-01-04,JESSIE,brawlBall,Sunny Soccer,1,28,12,41
6998,2023-01-04,JESSIE,brawlBall,Beach Ball,0,1,0,1
6999,2023-01-04,JESSIE,bounty,Shooting Star,0,3,1,4
7000,2023-01-03,JESSIE,hotZone,Parallel Plays,2,17,7,26
7001,2023-01-03,JESSIE,heist,Pit Stop,0,15,8,23
7002,2023-01-03,JESSIE,gemGrab,Minecart Madness,0,3,0,3
7003,2023-01-03,JESSIE,gemGrab,Crystal Arcade,0,17,10,27
7004,2023-01-03,JESSIE,brawlBall,Center Stage,0,2,0,2
7005,2023-01-03,JESSIE,brawlBall,Beach Ball,1,21,32,54
7006,2023-01-03,JESSIE,bounty,Hideout,0,2,0,2
7007,2023-01-02,JESSIE,knockout,Belle's Rock,0,3,0,3
7008,2023-01-02,JESSIE,hotZone,Quarter Pounder,0,26,5,31
7009,2023-01-02,JESSIE,hotZone,Controller Chaos,0,1,0,1
7010,2023-01-02,JESSIE,heist,Pit Stop,0,37,2,39
7011,2023-01-02,JESSIE,heist,Kaboom Canyon,0,0,1,1
7012,2023-01-02,JESSIE,gemGrab,Minecart Madness,0,16,2,18
7013,2023-01-02,JESSIE,gemGrab,Double Swoosh,0,7,4,11
7014,2023-01-02,JESSIE,brawlBall,Center Stage,0,12,3,15
7015,2023-01-02,JESSIE,brawlBall,Backyard Bowl,0,1,0,1
7016,2023-01-02,JESSIE,bounty,Hideout,0,3,1,4
7017,2023-01-01,JESSIE,knockout,Belle's Rock,0,1,0,1
7018,2023-01-01,JESSIE,hotZone,Quarter Pounder,0,10,2,12
7019,2023-01-01,JESSIE,heist,Kaboom Canyon,0,0,1,1
7020,2023-01-01,JESSIE,heist,Bridge Too Far,0,4,3,7
7021,2023-01-01,JESSIE,gemGrab,Double Swoosh,0,6,13,19
7022,2023-01-01,JESSIE,brawlBall,Backyard Bowl,0,7,10,17
7023,2023-01-01,JESSIE,bounty,Canal Grande,0,0,1,1
7024,2022-12-31,JESSIE,hotZone,Controller Chaos,0,3,0,3
7025,2022-12-31,JESSIE,heist,Bridge Too Far,0,2,0,2
7026,2022-12-31,JESSIE,gemGrab,Hard Rock Mine,0,1,0,1
7027,2022-12-31,JESSIE,gemGrab,Deep Diner,0,1,0,1
7028,2022-12-31,JESSIE,brawlBall,Super Beach,0,3,11,14
7029,2022-12-30,JESSIE,hotZone,Controller Chaos,0,3,2,5
7030,2022-12-30,JESSIE,gemGrab,Undermine,0,2,0,2
7031,2022-12-30,JESSIE,gemGrab,Deep Diner,0,9,1,10
7032,2022-12-30,JESSIE,brawlBall,Sneaky Fields,0,1,0,1
7033,2022-12-29,JESSIE,brawlBall,Pinhole Punt,0,2,3,5
7034,2022-12-27,JESSIE,heist,Safe Zone,0,1,0,1
7035,2022-12-27,JESSIE,heist,Kaboom Canyon,0,2,0,2
7036,2022-12-27,JESSIE,brawlBall,Beach Ball,0,1,1,2
7037,2022-12-26,JESSIE,heist,Kaboom Canyon,0,2,0,2
7038,2022-12-26,JESSIE,gemGrab,Minecart Madness,0,1,0,1
7039,2022-12-26,JESSIE,brawlBall,Center Stage,0,1,0,1
7040,2022-12-24,JESSIE,brawlBall,Super Beach,0,1,0,1
7041,2022-12-23,JESSIE,knockout,Out in the Open,0,0,1,1
7042,2022-12-22,JESSIE,brawlBall,Pinhole Punt,0,1,0,1
7043,2022-12-13,JESSIE,heist,Safe Zone,0,2,3,5
7044,2022-12-10,JESSIE,knockout,X Marks the Spot,0,2,0,2
7045,2022-12-10,JESSIE,hotZone,Ring of Fire,0,0,1,1
7046,2022-11-11,JESSIE,brawlBall,Sneaky Fields,0,1,0,1
7047,2022-11-01,JESSIE,knockout,New Perspective,0,1,0,1
7048,2022-10-30,JESSIE,heist,Safe Zone,0,1,0,1
7049,2022-10-30,JESSIE,brawlBall,Beach Ball,0,1,0,1
7050,2022-10-30,JESSIE,bounty,Canal Grande,0,1,0,1
7051,2022-10-15,JESSIE,gemGrab,Hard Rock Mine,0,0,2,2
7052,2023-01-30,JANET,knockout,Belle's Rock,0,101,121,222
7053,2023-01-30,JANET,hotZone,Quarter Pounder,1,26,70,97
7054,2023-01-30,JANET,heist,Pit Stop,0,3,0,3
7055,2023-01-30,JANET,gemGrab,Minecart Madness,0,45,70,115
7056,2023-01-30,JANET,gemGrab,Double Swoosh,0,69,129,198
7057,2023-01-30,JANET,brawlBall,Center Stage,9,163,181,353
7058,2023-01-30,JANET,brawlBall,Backyard Bowl,1,10,10,21
7059,2023-01-30,JANET,bounty,Hideout,0,17,34,51
7060,2023-01-29,JANET,knockout,Belle's Rock,0,92,101,193
7061,2023-01-29,JANET,hotZone,Quarter Pounder,0,36,72,108
7062,2023-01-29,JANET,heist,Bridge Too Far,0,4,3,7
7063,2023-01-29,JANET,gemGrab,Hard Rock Mine,0,19,22,41
7064,2023-01-29,JANET,gemGrab,Double Swoosh,0,143,223,366
7065,2023-01-29,JANET,brawlBall,Super Beach,0,2,5,7
7066,2023-01-29,JANET,brawlBall,Backyard Bowl,16,196,246,458
7067,2023-01-29,JANET,bounty,Canal Grande,0,24,93,117
7068,2023-01-28,JANET,knockout,Flaring Phoenix,0,34,47,81
7069,2023-01-28,JANET,hotZone,Controller Chaos,0,23,53,76
7070,2023-01-28,JANET,heist,Bridge Too Far,0,21,10,31
7071,2023-01-28,JANET,gemGrab,Hard Rock Mine,0,86,134,220
7072,2023-01-28,JANET,gemGrab,Deep Diner,0,33,44,77
7073,2023-01-28,JANET,brawlBall,Super Beach,7,148,183,338
7074,2023-01-28,JANET,brawlBall,Sneaky Fields,0,15,23,38
7075,2023-01-28,JANET,bounty,Canal Grande,0,83,92,175
7076,2023-01-27,JANET,knockout,Flaring Phoenix,0,10,10,20
7077,2023-01-27,JANET,hotZone,Controller Chaos,0,12,13,25
7078,2023-01-27,JANET,heist,Hot Potato,0,1,1,2
7079,2023-01-27,JANET,gemGrab,Undermine,0,5,7,12
7080,2023-01-27,JANET,gemGrab,Deep Diner,0,38,41,79
7081,2023-01-27,JANET,brawlBall,Sneaky Fields,4,45,65,114
7082,2023-01-27,JANET,brawlBall,Pinhole Punt,0,0,1,1
7083,2023-01-27,JANET,bounty,Temple Ruins,0,10,6,16
7084,2023-01-26,JANET,knockout,Riverside,2,54,25,81
7085,2023-01-26,JANET,hotZone,Open Zone,0,51,75,126
7086,2023-01-26,JANET,heist,Hot Potato,0,1,5,6
7087,2023-01-26,JANET,gemGrab,Undermine,0,58,106,164
7088,2023-01-26,JANET,gemGrab,Gem Fort,0,17,15,32
7089,2023-01-26,JANET,brawlBall,Sunny Soccer,0,4,9,13
7090,2023-01-26,JANET,brawlBall,Pinhole Punt,9,204,279,492
7091,2023-01-26,JANET,bounty,Temple Ruins,0,45,59,104
7092,2023-01-25,JANET,knockout,Riverside,0,20,17,37
7093,2023-01-25,JANET,hotZone,Open Zone,0,29,33,62
7094,2023-01-25,JANET,heist,Safe Zone,0,4,3,7
7095,2023-01-25,JANET,gemGrab,Gem Fort,0,28,19,47
7096,2023-01-25,JANET,gemGrab,Crystal Arcade,0,32,45,77
7097,2023-01-25,JANET,brawlBall,Sunny Soccer,4,73,87,164
7098,2023-01-25,JANET,brawlBall,Beach Ball,0,16,27,43
7099,2023-01-25,JANET,bounty,Excel,0,13,14,27
7100,2023-01-24,JANET,knockout,New Perspective,0,30,25,55
7101,2023-01-24,JANET,hotZone,Dueling Beetles,0,62,84,146
7102,2023-01-24,JANET,heist,Safe Zone,0,7,2,9
7103,2023-01-24,JANET,gemGrab,Minecart Madness,0,19,40,59
7104,2023-01-24,JANET,gemGrab,Crystal Arcade,0,60,67,127
7105,2023-01-24,JANET,brawlBall,Center Stage,1,23,28,52
7106,2023-01-24,JANET,brawlBall,Beach Ball,8,206,280,494
7107,2023-01-24,JANET,bounty,Excel,0,37,36,73
7108,2023-01-23,JANET,knockout,New Perspective,0,75,68,143
7109,2023-01-23,JANET,hotZone,Dueling Beetles,0,103,155,258
7110,2023-01-23,JANET,heist,Snaked Assault,0,6,3,9
7111,2023-01-23,JANET,gemGrab,Minecart Madness,0,119,181,300
7112,2023-01-23,JANET,gemGrab,Double Swoosh,0,56,73,129
7113,2023-01-23,JANET,brawlBall,Center Stage,10,301,369,680
7114,2023-01-23,JANET,brawlBall,Backyard Bowl,0,17,39,56
7115,2023-01-23,JANET,bounty,Layer Cake,0,62,134,196
7116,2023-01-22,JANET,knockout,X Marks the Spot,0,32,16,48
7117,2023-01-22,JANET,hotZone,Ring of Fire,0,19,26,45
7118,2023-01-22,JANET,heist,Snaked Assault,0,1,3,4
7119,2023-01-22,JANET,gemGrab,Hard Rock Mine,0,14,9,23
7120,2023-01-22,JANET,gemGrab,Double Swoosh,0,66,105,171
7121,2023-01-22,JANET,brawlBall,Super Beach,1,23,26,50
7122,2023-01-22,JANET,brawlBall,Backyard Bowl,3,103,128,234
7123,2023-01-22,JANET,bounty,Layer Cake,0,24,18,42
7124,2023-01-21,JANET,knockout,X Marks the Spot,0,135,106,241
7125,2023-01-21,JANET,hotZone,Ring of Fire,0,63,68,131
7126,2023-01-21,JANET,heist,Tornado Ring,0,6,3,9
7127,2023-01-21,JANET,gemGrab,Hard Rock Mine,0,136,156,292
7128,2023-01-21,JANET,gemGrab,Deep Diner,0,23,38,61
7129,2023-01-21,JANET,brawlBall,Super Beach,5,169,166,340
7130,2023-01-21,JANET,brawlBall,Sneaky Fields,0,7,3,10
7131,2023-01-21,JANET,bounty,Dry Season,0,41,80,121
7132,2023-01-20,JANET,knockout,Out in the Open,0,84,79,163
7133,2023-01-20,JANET,hotZone,Split,0,27,26,53
7134,2023-01-20,JANET,heist,Tornado Ring,0,4,2,6
7135,2023-01-20,JANET,gemGrab,Undermine,0,29,24,53
7136,2023-01-20,JANET,gemGrab,Deep Diner,0,101,128,229
7137,2023-01-20,JANET,brawlBall,Sneaky Fields,9,174,192,375
7138,2023-01-20,JANET,brawlBall,Pinhole Punt,0,5,4,9
7139,2023-01-20,JANET,bounty,Dry Season,0,29,21,50
7140,2023-01-19,JANET,knockout,Out in the Open,0,91,122,213
7141,2023-01-19,JANET,hotZone,Split,0,14,7,21
7142,2023-01-19,JANET,heist,Kaboom Canyon,0,8,3,11
7143,2023-01-19,JANET,gemGrab,Undermine,0,67,88,155
7144,2023-01-19,JANET,gemGrab,Gem Fort,0,7,22,29
7145,2023-01-19,JANET,brawlBall,Sunny Soccer,0,4,2,6
7146,2023-01-19,JANET,brawlBall,Pinhole Punt,7,251,329,587
7147,2023-01-19,JANET,bounty,Shooting Star,0,23,34,57
7148,2023-01-18,JANET,knockout,Goldarm Gulch,0,18,31,49
7149,2023-01-18,JANET,hotZone,Parallel Plays,0,3,16,19
7150,2023-01-18,JANET,heist,Kaboom Canyon,0,1,1,2
7151,2023-01-18,JANET,gemGrab,Gem Fort,0,11,15,26
7152,2023-01-18,JANET,gemGrab,Crystal Arcade,0,6,7,13
7153,2023-01-18,JANET,brawlBall,Sunny Soccer,2,58,77,137
7154,2023-01-18,JANET,brawlBall,Beach Ball,0,3,0,3
7155,2023-01-18,JANET,bounty,Shooting Star,0,17,22,39
7156,2023-01-17,JANET,knockout,Goldarm Gulch,0,8,6,14
7157,2023-01-17,JANET,hotZone,Parallel Plays,0,3,4,7
7158,2023-01-17,JANET,heist,Pit Stop,0,0,1,1
7159,2023-01-17,JANET,gemGrab,Minecart Madness,0,1,2,3
7160,2023-01-17,JANET,gemGrab,Crystal Arcade,0,15,12,27
7161,2023-01-17,JANET,brawlBall,Center Stage,0,1,0,1
7162,2023-01-17,JANET,brawlBall,Beach Ball,1,10,13,24
7163,2023-01-17,JANET,bounty,Hideout,0,3,1,4
7164,2023-01-16,JANET,knockout,Belle's Rock,0,10,16,26
7165,2023-01-16,JANET,hotZone,Quarter Pounder,0,4,0,4
7166,2023-01-16,JANET,heist,Pit Stop,0,0,1,1
7167,2023-01-16,JANET,gemGrab,Minecart Madness,0,8,7,15
7168,2023-01-16,JANET,gemGrab,Double Swoosh,0,8,1,9
7169,2023-01-16,JANET,brawlBall,Center Stage,0,16,36,52
7170,2023-01-16,JANET,brawlBall,Backyard Bowl,0,3,6,9
7171,2023-01-16,JANET,bounty,Hideout,0,11,18,29
7172,2023-01-15,JANET,knockout,Belle's Rock,0,9,24,33
7173,2023-01-15,JANET,hotZone,Quarter Pounder,0,12,9,21
7174,2023-01-15,JANET,heist,Bridge Too Far,0,1,0,1
7175,2023-01-15,JANET,gemGrab,Hard Rock Mine,0,3,0,3
7176,2023-01-15,JANET,gemGrab,Double Swoosh,0,12,57,69
7177,2023-01-15,JANET,brawlBall,Super Beach,0,1,0,1
7178,2023-01-15,JANET,brawlBall,Backyard Bowl,0,27,32,59
7179,2023-01-15,JANET,bounty,Canal Grande,0,5,4,9
7180,2023-01-14,JANET,knockout,Flaring Phoenix,0,2,1,3
7181,2023-01-14,JANET,hotZone,Controller Chaos,0,9,6,15
7182,2023-01-14,JANET,heist,Bridge Too Far,0,1,0,1
7183,2023-01-14,JANET,gemGrab,Hard Rock Mine,0,3,6,9
7184,2023-01-14,JANET,gemGrab,Deep Diner,0,6,1,7
7185,2023-01-14,JANET,brawlBall,Super Beach,0,10,3,13
7186,2023-01-14,JANET,brawlBall,Sneaky Fields,0,1,0,1
7187,2023-01-14,JANET,bounty,Canal Grande,0,2,7,9
7188,2023-01-13,JANET,knockout,Flaring Phoenix,0,2,3,5
7189,2023-01-13,JANET,hotZone,Controller Chaos,0,7,5,12
7190,2023-01-13,JANET,heist,Hot Potato,0,1,0,1
7191,2023-01-13,JANET,gemGrab,Deep Diner,0,6,6,12
7192,2023-01-13,JANET,brawlBall,Sneaky Fields,0,12,5,17
7193,2023-01-13,JANET,bounty,Temple Ruins,0,1,0,1
7194,2023-01-12,JANET,knockout,Riverside,0,3,0,3
7195,2023-01-12,JANET,hotZone,Open Zone,0,5,13,18
7196,2023-01-12,JANET,gemGrab,Undermine,0,7,20,27
7197,2023-01-12,JANET,brawlBall,Sunny Soccer,0,1,0,1
7198,2023-01-12,JANET,brawlBall,Pinhole Punt,0,12,30,42
7199,2023-01-12,JANET,bounty,Temple Ruins,0,1,0,1
7200,2023-01-11,JANET,hotZone,Open Zone,0,2,7,9
7201,2023-01-11,JANET,gemGrab,Gem Fort,0,3,1,4
7202,2023-01-11,JANET,brawlBall,Sunny Soccer,1,1,4,6
7203,2023-01-10,JANET,knockout,New Perspective,0,4,2,6
7204,2023-01-10,JANET,hotZone,Dueling Beetles,0,6,4,10
7205,2023-01-10,JANET,heist,Safe Zone,0,0,1,1
7206,2023-01-10,JANET,gemGrab,Minecart Madness,0,6,23,29
7207,2023-01-10,JANET,gemGrab,Crystal Arcade,0,3,20,23
7208,2023-01-10,JANET,brawlBall,Center Stage,0,3,0,3
7209,2023-01-10,JANET,brawlBall,Beach Ball,1,9,54,64
7210,2023-01-09,JANET,knockout,New Perspective,0,3,3,6
7211,2023-01-09,JANET,hotZone,Dueling Beetles,0,6,0,6
7212,2023-01-09,JANET,gemGrab,Minecart Madness,0,2,11,13
7213,2023-01-09,JANET,gemGrab,Double Swoosh,0,8,26,34
7214,2023-01-09,JANET,brawlBall,Center Stage,2,10,21,33
7215,2023-01-09,JANET,bounty,Layer Cake,0,4,14,18
7216,2023-01-08,JANET,knockout,X Marks the Spot,0,17,12,29
7217,2023-01-08,JANET,hotZone,Ring of Fire,0,1,3,4
7218,2023-01-08,JANET,gemGrab,Hard Rock Mine,0,4,2,6
7219,2023-01-08,JANET,gemGrab,Double Swoosh,0,4,8,12
7220,2023-01-08,JANET,brawlBall,Backyard Bowl,1,14,8,23
7221,2023-01-08,JANET,bounty,Layer Cake,0,7,27,34
7222,2023-01-07,JANET,knockout,X Marks the Spot,0,2,0,2
7223,2023-01-07,JANET,hotZone,Ring of Fire,0,5,3,8
7224,2023-01-07,JANET,heist,Tornado Ring,0,1,0,1
7225,2023-01-07,JANET,gemGrab,Hard Rock Mine,0,3,1,4
7226,2023-01-07,JANET,gemGrab,Deep Diner,0,5,4,9
7227,2023-01-07,JANET,brawlBall,Super Beach,0,2,5,7
7228,2023-01-07,JANET,bounty,Dry Season,0,8,14,22
7229,2023-01-06,JANET,knockout,Out in the Open,0,4,2,6
7230,2023-01-06,JANET,hotZone,Split,0,1,1,2
7231,2023-01-06,JANET,heist,Tornado Ring,0,1,0,1
7232,2023-01-06,JANET,gemGrab,Undermine,0,2,2,4
7233,2023-01-06,JANET,gemGrab,Deep Diner,0,14,2,16
7234,2023-01-06,JANET,brawlBall,Sneaky Fields,0,5,3,8
7235,2023-01-06,JANET,brawlBall,Pinhole Punt,0,1,5,6
7236,2023-01-06,JANET,bounty,Dry Season,0,7,3,10
7237,2023-01-05,JANET,knockout,Out in the Open,0,7,28,35
7238,2023-01-05,JANET,hotZone,Split,0,10,11,21
7239,2023-01-05,JANET,heist,Kaboom Canyon,0,1,0,1
7240,2023-01-05,JANET,gemGrab,Undermine,0,13,27,40
7241,2023-01-05,JANET,gemGrab,Gem Fort,0,1,0,1
7242,2023-01-05,JANET,brawlBall,Sunny Soccer,0,1,0,1
7243,2023-01-05,JANET,brawlBall,Pinhole Punt,0,24,40,64
7244,2023-01-05,JANET,bounty,Shooting Star,0,2,2,4
7245,2023-01-04,JANET,knockout,Goldarm Gulch,0,2,1,3
7246,2023-01-04,JANET,hotZone,Parallel Plays,0,5,22,27
7247,2023-01-04,JANET,heist,Kaboom Canyon,0,4,0,4
7248,2023-01-04,JANET,gemGrab,Gem Fort,0,5,0,5
7249,2023-01-04,JANET,gemGrab,Crystal Arcade,0,4,17,21
7250,2023-01-04,JANET,brawlBall,Sunny Soccer,0,8,5,13
7251,2023-01-04,JANET,bounty,Shooting Star,0,3,1,4
7252,2023-01-03,JANET,knockout,Goldarm Gulch,0,3,3,6
7253,2023-01-03,JANET,hotZone,Parallel Plays,1,14,36,51
7254,2023-01-03,JANET,gemGrab,Minecart Madness,0,1,2,3
7255,2023-01-03,JANET,gemGrab,Crystal Arcade,0,14,6,20
7256,2023-01-03,JANET,brawlBall,Center Stage,0,2,11,13
7257,2023-01-03,JANET,brawlBall,Beach Ball,1,16,62,79
7258,2023-01-03,JANET,bounty,Hideout,0,6,20,26
7259,2023-01-02,JANET,knockout,Belle's Rock,0,6,2,8
7260,2023-01-02,JANET,hotZone,Quarter Pounder,0,10,18,28
7261,2023-01-02,JANET,heist,Pit Stop,0,1,0,1
7262,2023-01-02,JANET,heist,Kaboom Canyon,0,0,1,1
7263,2023-01-02,JANET,gemGrab,Minecart Madness,0,12,17,29
7264,2023-01-02,JANET,gemGrab,Double Swoosh,0,11,19,30
7265,2023-01-02,JANET,brawlBall,Center Stage,2,12,36,50
7266,2023-01-02,JANET,brawlBall,Backyard Bowl,0,1,1,2
7267,2023-01-02,JANET,bounty,Hideout,0,10,23,33
7268,2023-01-01,JANET,knockout,Belle's Rock,0,11,13,24
7269,2023-01-01,JANET,hotZone,Quarter Pounder,0,7,10,17
7270,2023-01-01,JANET,gemGrab,Double Swoosh,0,8,7,15
7271,2023-01-01,JANET,brawlBall,Backyard Bowl,0,11,3,14
7272,2023-01-01,JANET,bounty,Canal Grande,0,6,8,14
7273,2022-12-31,JANET,hotZone,Controller Chaos,0,1,0,1
7274,2022-12-31,JANET,gemGrab,Minecart Madness,0,0,1,1
7275,2022-12-31,JANET,gemGrab,Hard Rock Mine,0,1,0,1
7276,2022-12-31,JANET,gemGrab,Deep Diner,0,2,0,2
7277,2022-12-31,JANET,brawlBall,Super Beach,0,0,1,1
7278,2022-12-31,JANET,bounty,Canal Grande,0,3,3,6
7279,2022-12-30,JANET,knockout,Flaring Phoenix,0,0,1,1
7280,2022-12-30,JANET,brawlBall,Sneaky Fields,0,0,2,2
7281,2022-12-29,JANET,gemGrab,Undermine,0,1,0,1
7282,2022-12-29,JANET,gemGrab,Minecart Madness,0,1,0,1
7283,2022-12-29,JANET,gemGrab,Gem Fort,0,1,1,2
7284,2022-12-28,JANET,hotZone,Open Zone,0,0,1,1
7285,2022-12-27,JANET,brawlBall,Center Stage,0,0,1,1
7286,2022-12-25,JANET,gemGrab,Double Swoosh,0,2,3,5
7287,2022-12-23,JANET,knockout,Out in the Open,0,1,1,2
7288,2022-12-22,JANET,brawlBall,Pinhole Punt,0,0,1,1
7289,2022-12-16,JANET,gemGrab,Undermine,0,0,1,1
7290,2022-12-13,JANET,gemGrab,Crystal Arcade,0,1,0,1
7291,2022-10-28,JANET,knockout,Out in the Open,0,1,1,2
7292,2022-10-28,JANET,hotZone,Dueling Beetles,0,0,2,2
7293,2022-10-28,JANET,bounty,Canal Grande,0,0,2,2
7294,2022-10-15,JANET,hotZone,Ring of Fire,0,0,1,1
7295,2023-01-30,JACKY,knockout,Belle's Rock,1,129,194,324
7296,2023-01-30,JACKY,hotZone,Quarter Pounder,0,21,11,32
7297,2023-01-30,JACKY,heist,Pit Stop,0,6,4,10
7298,2023-01-30,JACKY,gemGrab,Minecart Madness,0,5,7,12
7299,2023-01-30,JACKY,gemGrab,Double Swoosh,0,46,35,81
7300,2023-01-30,JACKY,brawlBall,Center Stage,31,831,1057,1919
7301,2023-01-30,JACKY,brawlBall,Backyard Bowl,0,19,4,23
7302,2023-01-30,JACKY,bounty,Hideout,0,5,2,7
7303,2023-01-29,JACKY,knockout,Belle's Rock,2,305,394,701
7304,2023-01-29,JACKY,hotZone,Quarter Pounder,0,18,10,28
7305,2023-01-29,JACKY,gemGrab,Hard Rock Mine,0,17,11,28
7306,2023-01-29,JACKY,gemGrab,Double Swoosh,0,66,46,112
7307,2023-01-29,JACKY,brawlBall,Super Beach,1,10,19,30
7308,2023-01-29,JACKY,brawlBall,Backyard Bowl,5,159,106,270
7309,2023-01-29,JACKY,bounty,Canal Grande,0,48,83,131
7310,2023-01-28,JACKY,knockout,Flaring Phoenix,3,172,274,449
7311,2023-01-28,JACKY,hotZone,Controller Chaos,0,27,7,34
7312,2023-01-28,JACKY,heist,Bridge Too Far,0,13,4,17
7313,2023-01-28,JACKY,gemGrab,Hard Rock Mine,0,48,45,93
7314,2023-01-28,JACKY,gemGrab,Deep Diner,0,7,0,7
7315,2023-01-28,JACKY,brawlBall,Super Beach,43,975,1150,2168
7316,2023-01-28,JACKY,brawlBall,Sneaky Fields,1,88,73,162
7317,2023-01-28,JACKY,bounty,Canal Grande,0,101,135,236
7318,2023-01-27,JACKY,knockout,Flaring Phoenix,1,101,151,253
7319,2023-01-27,JACKY,hotZone,Controller Chaos,0,10,6,16
7320,2023-01-27,JACKY,heist,Hot Potato,0,3,1,4
7321,2023-01-27,JACKY,gemGrab,Undermine,0,2,1,3
7322,2023-01-27,JACKY,gemGrab,Deep Diner,0,11,9,20
7323,2023-01-27,JACKY,brawlBall,Sneaky Fields,18,541,580,1139
7324,2023-01-27,JACKY,brawlBall,Pinhole Punt,0,3,12,15
7325,2023-01-27,JACKY,bounty,Temple Ruins,0,2,0,2
7326,2023-01-26,JACKY,knockout,Riverside,0,6,2,8
7327,2023-01-26,JACKY,hotZone,Open Zone,0,3,2,5
7328,2023-01-26,JACKY,heist,Hot Potato,0,19,9,28
7329,2023-01-26,JACKY,gemGrab,Undermine,0,29,13,42
7330,2023-01-26,JACKY,gemGrab,Gem Fort,0,19,28,47
7331,2023-01-26,JACKY,brawlBall,Sunny Soccer,0,39,40,79
7332,2023-01-26,JACKY,brawlBall,Pinhole Punt,8,403,386,797
7333,2023-01-26,JACKY,bounty,Temple Ruins,0,26,21,47
7334,2023-01-25,JACKY,knockout,Riverside,0,7,0,7
7335,2023-01-25,JACKY,hotZone,Open Zone,0,3,0,3
7336,2023-01-25,JACKY,heist,Safe Zone,0,4,0,4
7337,2023-01-25,JACKY,gemGrab,Gem Fort,0,40,21,61
7338,2023-01-25,JACKY,gemGrab,Crystal Arcade,0,17,14,31
7339,2023-01-25,JACKY,brawlBall,Sunny Soccer,10,416,546,972
7340,2023-01-25,JACKY,brawlBall,Beach Ball,1,67,47,115
7341,2023-01-25,JACKY,bounty,Excel,0,6,6,12
7342,2023-01-24,JACKY,knockout,New Perspective,1,140,228,369
7343,2023-01-24,JACKY,hotZone,Dueling Beetles,0,33,18,51
7344,2023-01-24,JACKY,heist,Safe Zone,0,7,4,11
7345,2023-01-24,JACKY,gemGrab,Minecart Madness,0,3,2,5
7346,2023-01-24,JACKY,gemGrab,Crystal Arcade,0,20,34,54
7347,2023-01-24,JACKY,brawlBall,Center Stage,5,81,95,181
7348,2023-01-24,JACKY,brawlBall,Beach Ball,17,601,594,1212
7349,2023-01-24,JACKY,bounty,Excel,0,36,39,75
7350,2023-01-23,JACKY,knockout,New Perspective,2,459,605,1066
7351,2023-01-23,JACKY,hotZone,Dueling Beetles,0,50,16,66
7352,2023-01-23,JACKY,heist,Snaked Assault,0,14,2,16
7353,2023-01-23,JACKY,gemGrab,Minecart Madness,0,10,8,18
7354,2023-01-23,JACKY,gemGrab,Double Swoosh,0,45,18,63
7355,2023-01-23,JACKY,brawlBall,Center Stage,51,1388,1420,2859
7356,2023-01-23,JACKY,brawlBall,Backyard Bowl,0,6,3,9
7357,2023-01-23,JACKY,bounty,Layer Cake,0,28,26,54
7358,2023-01-22,JACKY,knockout,X Marks the Spot,2,186,244,432
7359,2023-01-22,JACKY,hotZone,Ring of Fire,0,8,7,15
7360,2023-01-22,JACKY,heist,Snaked Assault,0,6,6,12
7361,2023-01-22,JACKY,gemGrab,Hard Rock Mine,0,17,18,35
7362,2023-01-22,JACKY,gemGrab,Double Swoosh,0,51,32,83
7363,2023-01-22,JACKY,brawlBall,Super Beach,5,103,106,214
7364,2023-01-22,JACKY,brawlBall,Backyard Bowl,1,67,40,108
7365,2023-01-22,JACKY,bounty,Layer Cake,0,25,32,57
7366,2023-01-21,JACKY,knockout,X Marks the Spot,2,750,898,1650
7367,2023-01-21,JACKY,hotZone,Ring of Fire,0,25,54,79
7368,2023-01-21,JACKY,heist,Tornado Ring,0,16,11,27
7369,2023-01-21,JACKY,gemGrab,Hard Rock Mine,0,80,61,141
7370,2023-01-21,JACKY,gemGrab,Deep Diner,0,20,9,29
7371,2023-01-21,JACKY,brawlBall,Super Beach,35,1196,1347,2578
7372,2023-01-21,JACKY,brawlBall,Sneaky Fields,1,94,105,200
7373,2023-01-21,JACKY,bounty,Dry Season,0,14,7,21
7374,2023-01-20,JACKY,knockout,Out in the Open,8,297,509,814
7375,2023-01-20,JACKY,hotZone,Split,0,41,74,115
7376,2023-01-20,JACKY,heist,Tornado Ring,0,10,8,18
7377,2023-01-20,JACKY,gemGrab,Undermine,0,12,3,15
7378,2023-01-20,JACKY,gemGrab,Deep Diner,0,22,15,37
7379,2023-01-20,JACKY,brawlBall,Sneaky Fields,47,1860,2216,4123
7380,2023-01-20,JACKY,brawlBall,Pinhole Punt,0,22,19,41
7381,2023-01-20,JACKY,bounty,Dry Season,0,1,14,15
7382,2023-01-19,JACKY,knockout,Out in the Open,11,696,1005,1712
7383,2023-01-19,JACKY,hotZone,Split,0,62,46,108
7384,2023-01-19,JACKY,heist,Kaboom Canyon,0,10,3,13
7385,2023-01-19,JACKY,gemGrab,Undermine,0,46,24,70
7386,2023-01-19,JACKY,gemGrab,Gem Fort,0,14,13,27
7387,2023-01-19,JACKY,brawlBall,Sunny Soccer,0,20,23,43
7388,2023-01-19,JACKY,brawlBall,Pinhole Punt,14,427,454,895
7389,2023-01-19,JACKY,bounty,Shooting Star,0,6,0,6
7390,2023-01-18,JACKY,knockout,Goldarm Gulch,3,49,46,98
7391,2023-01-18,JACKY,hotZone,Parallel Plays,0,5,7,12
7392,2023-01-18,JACKY,heist,Kaboom Canyon,0,3,0,3
7393,2023-01-18,JACKY,gemGrab,Gem Fort,0,14,16,30
7394,2023-01-18,JACKY,gemGrab,Crystal Arcade,0,2,0,2
7395,2023-01-18,JACKY,brawlBall,Sunny Soccer,7,183,194,384
7396,2023-01-18,JACKY,brawlBall,Beach Ball,0,4,8,12
7397,2023-01-18,JACKY,bounty,Shooting Star,0,1,0,1
7398,2023-01-17,JACKY,knockout,Goldarm Gulch,0,35,73,108
7399,2023-01-17,JACKY,hotZone,Parallel Plays,0,6,3,9
7400,2023-01-17,JACKY,heist,Pit Stop,0,0,1,1
7401,2023-01-17,JACKY,gemGrab,Crystal Arcade,0,4,5,9
7402,2023-01-17,JACKY,brawlBall,Center Stage,1,5,9,15
7403,2023-01-17,JACKY,brawlBall,Beach Ball,2,41,50,93
7404,2023-01-16,JACKY,knockout,Belle's Rock,0,18,32,50
7405,2023-01-16,JACKY,hotZone,Quarter Pounder,0,2,0,2
7406,2023-01-16,JACKY,heist,Pit Stop,0,2,0,2
7407,2023-01-16,JACKY,gemGrab,Minecart Madness,0,1,1,2
7408,2023-01-16,JACKY,gemGrab,Double Swoosh,0,5,1,6
7409,2023-01-16,JACKY,brawlBall,Center Stage,3,103,95,201
7410,2023-01-16,JACKY,brawlBall,Backyard Bowl,0,1,1,2
7411,2023-01-16,JACKY,bounty,Hideout,0,3,2,5
7412,2023-01-15,JACKY,knockout,Belle's Rock,0,31,28,59
7413,2023-01-15,JACKY,hotZone,Quarter Pounder,0,12,1,13
7414,2023-01-15,JACKY,gemGrab,Hard Rock Mine,0,5,13,18
7415,2023-01-15,JACKY,gemGrab,Double Swoosh,0,16,6,22
7416,2023-01-15,JACKY,brawlBall,Super Beach,1,18,11,30
7417,2023-01-15,JACKY,brawlBall,Backyard Bowl,0,17,8,25
7418,2023-01-15,JACKY,bounty,Canal Grande,0,10,9,19
7419,2023-01-14,JACKY,knockout,Flaring Phoenix,1,20,41,62
7420,2023-01-14,JACKY,hotZone,Controller Chaos,0,5,2,7
7421,2023-01-14,JACKY,heist,Bridge Too Far,0,1,0,1
7422,2023-01-14,JACKY,gemGrab,Hard Rock Mine,0,5,2,7
7423,2023-01-14,JACKY,brawlBall,Super Beach,6,97,112,215
7424,2023-01-14,JACKY,brawlBall,Sneaky Fields,0,40,29,69
7425,2023-01-14,JACKY,bounty,Canal Grande,0,11,18,29
7426,2023-01-13,JACKY,knockout,Flaring Phoenix,0,13,19,32
7427,2023-01-13,JACKY,hotZone,Controller Chaos,0,5,0,5
7428,2023-01-13,JACKY,gemGrab,Deep Diner,0,2,0,2
7429,2023-01-13,JACKY,brawlBall,Sneaky Fields,2,171,173,346
7430,2023-01-13,JACKY,brawlBall,Pinhole Punt,0,1,1,2
7431,2023-01-13,JACKY,bounty,Temple Ruins,0,0,3,3
7432,2023-01-12,JACKY,hotZone,Open Zone,0,3,0,3
7433,2023-01-12,JACKY,gemGrab,Undermine,0,4,1,5
7434,2023-01-12,JACKY,gemGrab,Gem Fort,0,1,0,1
7435,2023-01-12,JACKY,brawlBall,Sunny Soccer,0,1,0,1
7436,2023-01-12,JACKY,brawlBall,Pinhole Punt,0,21,11,32
7437,2023-01-11,JACKY,gemGrab,Gem Fort,0,3,12,15
7438,2023-01-11,JACKY,brawlBall,Sunny Soccer,0,19,18,37
7439,2023-01-11,JACKY,brawlBall,Beach Ball,0,1,0,1
7440,2023-01-10,JACKY,knockout,New Perspective,0,12,13,25
7441,2023-01-10,JACKY,hotZone,Dueling Beetles,0,9,0,9
7442,2023-01-10,JACKY,gemGrab,Crystal Arcade,0,6,4,10
7443,2023-01-10,JACKY,brawlBall,Center Stage,0,17,5,22
7444,2023-01-10,JACKY,brawlBall,Beach Ball,0,54,15,69
7445,2023-01-10,JACKY,bounty,Excel,0,2,2,4
7446,2023-01-09,JACKY,knockout,New Perspective,0,27,28,55
7447,2023-01-09,JACKY,hotZone,Dueling Beetles,0,12,1,13
7448,2023-01-09,JACKY,heist,Snaked Assault,0,3,0,3
7449,2023-01-09,JACKY,gemGrab,Minecart Madness,0,1,0,1
7450,2023-01-09,JACKY,gemGrab,Double Swoosh,0,3,2,5
7451,2023-01-09,JACKY,brawlBall,Center Stage,3,113,108,224
7452,2023-01-09,JACKY,brawlBall,Backyard Bowl,0,1,0,1
7453,2023-01-09,JACKY,bounty,Layer Cake,0,3,1,4
7454,2023-01-08,JACKY,knockout,X Marks the Spot,0,41,90,131
7455,2023-01-08,JACKY,hotZone,Ring of Fire,0,2,0,2
7456,2023-01-08,JACKY,gemGrab,Hard Rock Mine,0,4,0,4
7457,2023-01-08,JACKY,gemGrab,Double Swoosh,0,4,0,4
7458,2023-01-08,JACKY,brawlBall,Super Beach,0,5,8,13
7459,2023-01-08,JACKY,brawlBall,Backyard Bowl,1,13,3,17
7460,2023-01-08,JACKY,bounty,Layer Cake,0,0,1,1
7461,2023-01-07,JACKY,knockout,X Marks the Spot,0,27,36,63
7462,2023-01-07,JACKY,hotZone,Ring of Fire,0,1,0,1
7463,2023-01-07,JACKY,heist,Tornado Ring,0,3,0,3
7464,2023-01-07,JACKY,gemGrab,Hard Rock Mine,0,0,1,1
7465,2023-01-07,JACKY,gemGrab,Deep Diner,0,2,0,2
7466,2023-01-07,JACKY,brawlBall,Super Beach,0,44,6,50
7467,2023-01-07,JACKY,brawlBall,Sneaky Fields,0,13,3,16
7468,2023-01-07,JACKY,bounty,Dry Season,0,1,2,3
7469,2023-01-06,JACKY,knockout,Out in the Open,0,44,62,106
7470,2023-01-06,JACKY,hotZone,Split,0,6,0,6
7471,2023-01-06,JACKY,heist,Tornado Ring,0,1,2,3
7472,2023-01-06,JACKY,gemGrab,Undermine,0,0,1,1
7473,2023-01-06,JACKY,gemGrab,Deep Diner,0,1,2,3
7474,2023-01-06,JACKY,brawlBall,Sneaky Fields,4,143,88,235
7475,2023-01-06,JACKY,brawlBall,Pinhole Punt,0,4,1,5
7476,2023-01-06,JACKY,bounty,Dry Season,0,4,3,7
7477,2023-01-05,JACKY,knockout,Out in the Open,2,68,115,185
7478,2023-01-05,JACKY,hotZone,Split,0,22,19,41
7479,2023-01-05,JACKY,heist,Kaboom Canyon,0,1,0,1
7480,2023-01-05,JACKY,gemGrab,Undermine,0,2,1,3
7481,2023-01-05,JACKY,gemGrab,Gem Fort,0,2,0,2
7482,2023-01-05,JACKY,brawlBall,Pinhole Punt,1,53,6,60
7483,2023-01-05,JACKY,bounty,Shooting Star,0,1,0,1
7484,2023-01-04,JACKY,knockout,Goldarm Gulch,0,7,2,9
7485,2023-01-04,JACKY,hotZone,Parallel Plays,0,3,0,3
7486,2023-01-04,JACKY,heist,Kaboom Canyon,0,0,1,1
7487,2023-01-04,JACKY,gemGrab,Gem Fort,0,5,6,11
7488,2023-01-04,JACKY,gemGrab,Crystal Arcade,0,1,0,1
7489,2023-01-04,JACKY,brawlBall,Sunny Soccer,0,59,38,97
7490,2023-01-04,JACKY,brawlBall,Beach Ball,0,0,1,1
7491,2023-01-03,JACKY,knockout,Goldarm Gulch,0,9,9,18
7492,2023-01-03,JACKY,hotZone,Parallel Plays,0,5,0,5
7493,2023-01-03,JACKY,heist,Pit Stop,0,1,0,1
7494,2023-01-03,JACKY,gemGrab,Crystal Arcade,0,8,14,22
7495,2023-01-03,JACKY,brawlBall,Beach Ball,0,56,14,70
7496,2023-01-03,JACKY,bounty,Hideout,0,1,0,1
7497,2023-01-02,JACKY,knockout,Belle's Rock,0,10,23,33
7498,2023-01-02,JACKY,hotZone,Quarter Pounder,0,11,9,20
7499,2023-01-02,JACKY,heist,Pit Stop,0,3,0,3
7500,2023-01-02,JACKY,gemGrab,Minecart Madness,0,1,1,2
7501,2023-01-02,JACKY,gemGrab,Double Swoosh,0,2,2,4
7502,2023-01-02,JACKY,brawlBall,Center Stage,2,112,77,191
7503,2023-01-02,JACKY,bounty,Hideout,0,2,1,3
7504,2023-01-01,JACKY,knockout,Belle's Rock,0,3,12,15
7505,2023-01-01,JACKY,hotZone,Quarter Pounder,0,1,0,1
7506,2023-01-01,JACKY,gemGrab,Minecart Madness,0,0,1,1
7507,2023-01-01,JACKY,gemGrab,Double Swoosh,0,3,4,7
7508,2023-01-01,JACKY,brawlBall,Backyard Bowl,0,10,4,14
7509,2023-01-01,JACKY,bounty,Canal Grande,0,0,1,1
7510,2022-12-31,JACKY,hotZone,Controller Chaos,0,1,0,1
7511,2022-12-31,JACKY,gemGrab,Hard Rock Mine,0,1,0,1
7512,2022-12-31,JACKY,gemGrab,Deep Diner,0,0,1,1
7513,2022-12-31,JACKY,brawlBall,Super Beach,0,10,7,17
7514,2022-12-31,JACKY,brawlBall,Sneaky Fields,0,0,1,1
7515,2022-12-31,JACKY,bounty,Canal Grande,0,1,0,1
7516,2022-12-30,JACKY,hotZone,Controller Chaos,0,3,0,3
7517,2022-12-30,JACKY,heist,Kaboom Canyon,0,1,1,2
7518,2022-12-30,JACKY,gemGrab,Minecart Madness,0,1,0,1
7519,2022-12-30,JACKY,brawlBall,Sneaky Fields,0,7,7,14
7520,2022-12-29,JACKY,brawlBall,Pinhole Punt,0,1,1,2
7521,2022-12-28,JACKY,brawlBall,Sunny Soccer,0,1,1,2
7522,2022-12-27,JACKY,brawlBall,Beach Ball,0,0,2,2
7523,2022-12-26,JACKY,gemGrab,Minecart Madness,0,1,0,1
7524,2022-12-26,JACKY,brawlBall,Center Stage,0,0,1,1
7525,2022-12-24,JACKY,brawlBall,Super Beach,0,1,1,2
7526,2022-12-23,JACKY,brawlBall,Sneaky Fields,0,1,0,1
7527,2022-12-22,JACKY,brawlBall,Pinhole Punt,0,1,0,1
7528,2022-12-21,JACKY,brawlBall,Sunny Soccer,0,1,0,1
7529,2022-12-19,JACKY,brawlBall,Center Stage,0,1,0,1
7530,2022-12-16,JACKY,gemGrab,Undermine,0,1,0,1
7531,2022-12-16,JACKY,brawlBall,Sneaky Fields,0,1,0,1
7532,2022-11-11,JACKY,brawlBall,Sneaky Fields,0,3,1,4
7533,2022-10-30,JACKY,bounty,Canal Grande,0,0,2,2
7534,2022-10-28,JACKY,hotZone,Dueling Beetles,0,1,0,1
7535,2023-01-30,GUS,knockout,Belle's Rock,0,194,307,501
7536,2023-01-30,GUS,hotZone,Quarter Pounder,0,41,132,173
7537,2023-01-30,GUS,heist,Pit Stop,0,3,4,7
7538,2023-01-30,GUS,gemGrab,Minecart Madness,0,108,167,275
7539,2023-01-30,GUS,gemGrab,Double Swoosh,0,33,27,60
7540,2023-01-30,GUS,brawlBall,Center Stage,2,76,92,170
7541,2023-01-30,GUS,brawlBall,Backyard Bowl,2,28,52,82
7542,2023-01-30,GUS,bounty,Hideout,0,48,75,123
7543,2023-01-29,GUS,knockout,Belle's Rock,0,175,291,466
7544,2023-01-29,GUS,hotZone,Quarter Pounder,1,49,55,105
7545,2023-01-29,GUS,heist,Bridge Too Far,1,20,39,60
7546,2023-01-29,GUS,gemGrab,Hard Rock Mine,0,23,31,54
7547,2023-01-29,GUS,gemGrab,Double Swoosh,0,55,51,106
7548,2023-01-29,GUS,brawlBall,Super Beach,0,4,1,5
7549,2023-01-29,GUS,brawlBall,Backyard Bowl,30,430,610,1070
7550,2023-01-29,GUS,bounty,Canal Grande,0,14,14,28
7551,2023-01-28,GUS,knockout,Flaring Phoenix,0,40,51,91
7552,2023-01-28,GUS,hotZone,Controller Chaos,0,24,29,53
7553,2023-01-28,GUS,heist,Bridge Too Far,0,68,85,153
7554,2023-01-28,GUS,gemGrab,Hard Rock Mine,0,123,139,262
7555,2023-01-28,GUS,gemGrab,Deep Diner,0,33,42,75
7556,2023-01-28,GUS,brawlBall,Super Beach,5,240,250,495
7557,2023-01-28,GUS,brawlBall,Sneaky Fields,0,8,11,19
7558,2023-01-28,GUS,bounty,Canal Grande,0,22,29,51
7559,2023-01-27,GUS,knockout,Flaring Phoenix,0,26,23,49
7560,2023-01-27,GUS,hotZone,Controller Chaos,0,13,13,26
7561,2023-01-27,GUS,heist,Hot Potato,0,1,1,2
7562,2023-01-27,GUS,gemGrab,Undermine,0,8,11,19
7563,2023-01-27,GUS,gemGrab,Deep Diner,0,55,89,144
7564,2023-01-27,GUS,brawlBall,Sneaky Fields,1,59,53,113
7565,2023-01-27,GUS,brawlBall,Pinhole Punt,0,1,4,5
7566,2023-01-27,GUS,bounty,Temple Ruins,0,15,29,44
7567,2023-01-26,GUS,knockout,Riverside,1,232,381,614
7568,2023-01-26,GUS,hotZone,Open Zone,0,61,111,172
7569,2023-01-26,GUS,heist,Hot Potato,0,1,1,2
7570,2023-01-26,GUS,gemGrab,Undermine,0,50,94,144
7571,2023-01-26,GUS,gemGrab,Gem Fort,0,10,7,17
7572,2023-01-26,GUS,brawlBall,Sunny Soccer,0,6,5,11
7573,2023-01-26,GUS,brawlBall,Pinhole Punt,4,252,300,556
7574,2023-01-26,GUS,bounty,Temple Ruins,0,26,37,63
7575,2023-01-25,GUS,knockout,Riverside,0,88,132,220
7576,2023-01-25,GUS,hotZone,Open Zone,0,45,52,97
7577,2023-01-25,GUS,heist,Safe Zone,0,15,18,33
7578,2023-01-25,GUS,gemGrab,Gem Fort,0,15,38,53
7579,2023-01-25,GUS,gemGrab,Crystal Arcade,0,51,94,145
7580,2023-01-25,GUS,brawlBall,Sunny Soccer,4,96,119,219
7581,2023-01-25,GUS,brawlBall,Beach Ball,0,14,5,19
7582,2023-01-25,GUS,bounty,Excel,0,25,57,82
7583,2023-01-24,GUS,knockout,New Perspective,0,62,88,150
7584,2023-01-24,GUS,hotZone,Dueling Beetles,0,42,63,105
7585,2023-01-24,GUS,heist,Safe Zone,1,26,30,57
7586,2023-01-24,GUS,gemGrab,Minecart Madness,0,25,34,59
7587,2023-01-24,GUS,gemGrab,Crystal Arcade,0,118,132,250
7588,2023-01-24,GUS,brawlBall,Center Stage,0,12,10,22
7589,2023-01-24,GUS,brawlBall,Beach Ball,6,180,174,360
7590,2023-01-24,GUS,bounty,Excel,0,71,116,187
7591,2023-01-23,GUS,knockout,New Perspective,0,119,152,271
7592,2023-01-23,GUS,hotZone,Dueling Beetles,0,74,85,159
7593,2023-01-23,GUS,heist,Snaked Assault,0,5,5,10
7594,2023-01-23,GUS,gemGrab,Minecart Madness,0,130,188,318
7595,2023-01-23,GUS,gemGrab,Double Swoosh,0,31,42,73
7596,2023-01-23,GUS,brawlBall,Center Stage,4,168,186,358
7597,2023-01-23,GUS,brawlBall,Backyard Bowl,0,36,57,93
7598,2023-01-23,GUS,bounty,Layer Cake,0,48,66,114
7599,2023-01-22,GUS,knockout,X Marks the Spot,0,67,76,143
7600,2023-01-22,GUS,hotZone,Ring of Fire,0,26,30,56
7601,2023-01-22,GUS,heist,Snaked Assault,0,1,1,2
7602,2023-01-22,GUS,gemGrab,Hard Rock Mine,0,35,67,102
7603,2023-01-22,GUS,gemGrab,Double Swoosh,0,29,45,74
7604,2023-01-22,GUS,brawlBall,Super Beach,0,24,16,40
7605,2023-01-22,GUS,brawlBall,Backyard Bowl,14,256,370,640
7606,2023-01-22,GUS,bounty,Layer Cake,0,29,27,56
7607,2023-01-21,GUS,knockout,X Marks the Spot,1,278,336,615
7608,2023-01-21,GUS,hotZone,Ring of Fire,0,102,118,220
7609,2023-01-21,GUS,heist,Tornado Ring,0,11,3,14
7610,2023-01-21,GUS,gemGrab,Hard Rock Mine,0,116,138,254
7611,2023-01-21,GUS,gemGrab,Deep Diner,0,39,55,94
7612,2023-01-21,GUS,brawlBall,Super Beach,6,307,394,707
7613,2023-01-21,GUS,brawlBall,Sneaky Fields,0,8,3,11
7614,2023-01-21,GUS,bounty,Dry Season,0,181,261,442
7615,2023-01-20,GUS,knockout,Out in the Open,1,265,313,579
7616,2023-01-20,GUS,hotZone,Split,0,6,5,11
7617,2023-01-20,GUS,heist,Tornado Ring,0,1,1,2
7618,2023-01-20,GUS,gemGrab,Undermine,0,14,25,39
7619,2023-01-20,GUS,gemGrab,Deep Diner,0,127,210,337
7620,2023-01-20,GUS,brawlBall,Sneaky Fields,3,163,150,316
7621,2023-01-20,GUS,brawlBall,Pinhole Punt,0,7,13,20
7622,2023-01-20,GUS,bounty,Dry Season,0,129,194,323
7623,2023-01-19,GUS,knockout,Out in the Open,1,204,266,471
7624,2023-01-19,GUS,hotZone,Split,0,13,7,20
7625,2023-01-19,GUS,heist,Kaboom Canyon,0,11,18,29
7626,2023-01-19,GUS,gemGrab,Undermine,0,63,100,163
7627,2023-01-19,GUS,gemGrab,Gem Fort,0,9,10,19
7628,2023-01-19,GUS,brawlBall,Sunny Soccer,0,4,0,4
7629,2023-01-19,GUS,brawlBall,Pinhole Punt,15,300,401,716
7630,2023-01-19,GUS,bounty,Shooting Star,0,101,189,290
7631,2023-01-18,GUS,knockout,Goldarm Gulch,0,17,15,32
7632,2023-01-18,GUS,hotZone,Parallel Plays,0,2,3,5
7633,2023-01-18,GUS,heist,Kaboom Canyon,0,6,2,8
7634,2023-01-18,GUS,gemGrab,Gem Fort,0,13,13,26
7635,2023-01-18,GUS,gemGrab,Crystal Arcade,0,7,11,18
7636,2023-01-18,GUS,brawlBall,Sunny Soccer,0,40,43,83
7637,2023-01-18,GUS,brawlBall,Beach Ball,0,4,6,10
7638,2023-01-18,GUS,bounty,Shooting Star,0,63,72,135
7639,2023-01-17,GUS,knockout,Goldarm Gulch,0,21,18,39
7640,2023-01-17,GUS,hotZone,Parallel Plays,0,8,4,12
7641,2023-01-17,GUS,gemGrab,Minecart Madness,0,6,4,10
7642,2023-01-17,GUS,gemGrab,Crystal Arcade,0,6,4,10
7643,2023-01-17,GUS,brawlBall,Beach Ball,1,23,27,51
7644,2023-01-17,GUS,bounty,Hideout,0,8,8,16
7645,2023-01-16,GUS,knockout,Belle's Rock,0,35,32,67
7646,2023-01-16,GUS,hotZone,Quarter Pounder,0,3,3,6
7647,2023-01-16,GUS,gemGrab,Minecart Madness,0,8,13,21
7648,2023-01-16,GUS,gemGrab,Double Swoosh,0,2,4,6
7649,2023-01-16,GUS,brawlBall,Center Stage,0,10,14,24
7650,2023-01-16,GUS,brawlBall,Backyard Bowl,0,2,5,7
7651,2023-01-16,GUS,bounty,Hideout,0,17,47,64
7652,2023-01-15,GUS,knockout,Belle's Rock,0,32,47,79
7653,2023-01-15,GUS,hotZone,Quarter Pounder,0,10,18,28
7654,2023-01-15,GUS,heist,Bridge Too Far,0,3,2,5
7655,2023-01-15,GUS,gemGrab,Hard Rock Mine,0,2,1,3
7656,2023-01-15,GUS,gemGrab,Double Swoosh,0,5,23,28
7657,2023-01-15,GUS,brawlBall,Super Beach,0,1,0,1
7658,2023-01-15,GUS,brawlBall,Backyard Bowl,5,48,89,142
7659,2023-01-15,GUS,bounty,Canal Grande,0,1,1,2
7660,2023-01-14,GUS,knockout,Flaring Phoenix,0,15,8,23
7661,2023-01-14,GUS,hotZone,Controller Chaos,0,7,48,55
7662,2023-01-14,GUS,heist,Bridge Too Far,0,8,0,8
7663,2023-01-14,GUS,gemGrab,Hard Rock Mine,0,9,21,30
7664,2023-01-14,GUS,gemGrab,Deep Diner,0,3,3,6
7665,2023-01-14,GUS,brawlBall,Super Beach,0,11,11,22
7666,2023-01-14,GUS,brawlBall,Sneaky Fields,0,2,13,15
7667,2023-01-14,GUS,bounty,Canal Grande,0,0,2,2
7668,2023-01-13,GUS,knockout,Flaring Phoenix,0,5,27,32
7669,2023-01-13,GUS,hotZone,Controller Chaos,0,4,0,4
7670,2023-01-13,GUS,gemGrab,Undermine,0,1,0,1
7671,2023-01-13,GUS,gemGrab,Deep Diner,0,6,4,10
7672,2023-01-13,GUS,brawlBall,Sneaky Fields,0,18,29,47
7673,2023-01-13,GUS,bounty,Temple Ruins,0,3,1,4
7674,2023-01-12,GUS,knockout,Riverside,0,25,46,71
7675,2023-01-12,GUS,hotZone,Open Zone,0,9,27,36
7676,2023-01-12,GUS,gemGrab,Undermine,0,5,4,9
7677,2023-01-12,GUS,brawlBall,Sunny Soccer,0,0,1,1
7678,2023-01-12,GUS,brawlBall,Pinhole Punt,3,9,7,19
7679,2023-01-11,GUS,knockout,Riverside,0,4,5,9
7680,2023-01-11,GUS,hotZone,Open Zone,0,5,0,5
7681,2023-01-11,GUS,heist,Safe Zone,0,5,0,5
7682,2023-01-11,GUS,gemGrab,Gem Fort,0,1,0,1
7683,2023-01-11,GUS,brawlBall,Sunny Soccer,0,6,2,8
7684,2023-01-11,GUS,bounty,Excel,0,1,0,1
7685,2023-01-10,GUS,knockout,New Perspective,0,1,5,6
7686,2023-01-10,GUS,hotZone,Dueling Beetles,0,4,11,15
7687,2023-01-10,GUS,heist,Safe Zone,0,3,0,3
7688,2023-01-10,GUS,gemGrab,Minecart Madness,0,7,7,14
7689,2023-01-10,GUS,gemGrab,Crystal Arcade,0,2,7,9
7690,2023-01-10,GUS,brawlBall,Center Stage,0,3,3,6
7691,2023-01-10,GUS,brawlBall,Beach Ball,0,11,8,19
7692,2023-01-10,GUS,bounty,Excel,0,3,15,18
7693,2023-01-09,GUS,knockout,New Perspective,0,1,12,13
7694,2023-01-09,GUS,hotZone,Dueling Beetles,0,5,9,14
7695,2023-01-09,GUS,gemGrab,Minecart Madness,0,17,40,57
7696,2023-01-09,GUS,gemGrab,Double Swoosh,0,0,2,2
7697,2023-01-09,GUS,brawlBall,Center Stage,0,4,6,10
7698,2023-01-09,GUS,bounty,Layer Cake,0,8,50,58
7699,2023-01-08,GUS,knockout,X Marks the Spot,0,10,30,40
7700,2023-01-08,GUS,hotZone,Ring of Fire,0,4,9,13
7701,2023-01-08,GUS,heist,Snaked Assault,0,0,1,1
7702,2023-01-08,GUS,gemGrab,Hard Rock Mine,0,5,8,13
7703,2023-01-08,GUS,brawlBall,Backyard Bowl,0,30,61,91
7704,2023-01-08,GUS,bounty,Layer Cake,0,4,0,4
7705,2023-01-07,GUS,knockout,X Marks the Spot,0,7,5,12
7706,2023-01-07,GUS,hotZone,Ring of Fire,0,0,1,1
7707,2023-01-07,GUS,heist,Tornado Ring,0,0,1,1
7708,2023-01-07,GUS,gemGrab,Hard Rock Mine,0,4,10,14
7709,2023-01-07,GUS,gemGrab,Deep Diner,0,4,12,16
7710,2023-01-07,GUS,brawlBall,Super Beach,0,13,5,18
7711,2023-01-07,GUS,bounty,Dry Season,0,14,16,30
7712,2023-01-06,GUS,knockout,Out in the Open,0,20,32,52
7713,2023-01-06,GUS,gemGrab,Undermine,0,0,10,10
7714,2023-01-06,GUS,gemGrab,Deep Diner,0,11,47,58
7715,2023-01-06,GUS,brawlBall,Sneaky Fields,0,3,3,6
7716,2023-01-06,GUS,brawlBall,Pinhole Punt,0,2,4,6
7717,2023-01-06,GUS,bounty,Dry Season,0,32,38,70
7718,2023-01-05,GUS,knockout,Out in the Open,0,31,40,71
7719,2023-01-05,GUS,gemGrab,Undermine,0,8,15,23
7720,2023-01-05,GUS,brawlBall,Pinhole Punt,0,21,26,47
7721,2023-01-05,GUS,bounty,Shooting Star,0,24,50,74
7722,2023-01-04,GUS,knockout,Goldarm Gulch,0,5,2,7
7723,2023-01-04,GUS,hotZone,Parallel Plays,0,3,2,5
7724,2023-01-04,GUS,heist,Kaboom Canyon,0,0,5,5
7725,2023-01-04,GUS,gemGrab,Gem Fort,0,3,6,9
7726,2023-01-04,GUS,gemGrab,Crystal Arcade,0,5,22,27
7727,2023-01-04,GUS,brawlBall,Sunny Soccer,0,8,6,14
7728,2023-01-04,GUS,brawlBall,Beach Ball,0,0,1,1
7729,2023-01-04,GUS,bounty,Shooting Star,0,41,91,132
7730,2023-01-03,GUS,knockout,Goldarm Gulch,0,8,9,17
7731,2023-01-03,GUS,hotZone,Parallel Plays,0,1,3,4
7732,2023-01-03,GUS,gemGrab,Minecart Madness,0,0,7,7
7733,2023-01-03,GUS,gemGrab,Crystal Arcade,0,21,76,97
7734,2023-01-03,GUS,brawlBall,Center Stage,1,0,4,5
7735,2023-01-03,GUS,brawlBall,Beach Ball,0,11,6,17
7736,2023-01-03,GUS,bounty,Hideout,0,13,21,34
7737,2023-01-02,GUS,knockout,Belle's Rock,0,17,45,62
7738,2023-01-02,GUS,hotZone,Quarter Pounder,0,18,13,31
7739,2023-01-02,GUS,heist,Kaboom Canyon,0,1,0,1
7740,2023-01-02,GUS,gemGrab,Minecart Madness,0,8,76,84
7741,2023-01-02,GUS,gemGrab,Double Swoosh,0,5,5,10
7742,2023-01-02,GUS,brawlBall,Center Stage,0,9,5,14
7743,2023-01-02,GUS,brawlBall,Backyard Bowl,1,0,1,2
7744,2023-01-02,GUS,bounty,Hideout,0,40,91,131
7745,2023-01-01,GUS,knockout,Belle's Rock,0,18,33,51
7746,2023-01-01,GUS,hotZone,Quarter Pounder,0,4,5,9
7747,2023-01-01,GUS,heist,Bridge Too Far,0,1,0,1
7748,2023-01-01,GUS,gemGrab,Hard Rock Mine,0,1,0,1
7749,2023-01-01,GUS,gemGrab,Double Swoosh,0,4,7,11
7750,2023-01-01,GUS,brawlBall,Backyard Bowl,0,20,57,77
7751,2022-12-31,GUS,heist,Bridge Too Far,0,4,3,7
7752,2022-12-31,GUS,gemGrab,Hard Rock Mine,0,0,4,4
7753,2022-12-31,GUS,gemGrab,Deep Diner,0,3,19,22
7754,2022-12-31,GUS,brawlBall,Super Beach,0,8,2,10
7755,2022-12-31,GUS,bounty,Canal Grande,0,2,0,2
7756,2022-12-30,GUS,gemGrab,Deep Diner,0,2,0,2
7757,2022-12-29,GUS,gemGrab,Gem Fort,0,0,1,1
7758,2022-12-29,GUS,brawlBall,Pinhole Punt,0,2,3,5
7759,2022-12-28,GUS,brawlBall,Sunny Soccer,0,0,1,1
7760,2022-12-27,GUS,knockout,New Perspective,0,0,1,1
7761,2022-12-27,GUS,hotZone,Dueling Beetles,0,4,3,7
7762,2022-12-27,GUS,brawlBall,Beach Ball,0,2,0,2
7763,2022-12-26,GUS,hotZone,Controller Chaos,0,0,1,1
7764,2022-12-23,GUS,gemGrab,Deep Diner,0,0,1,1
7765,2022-12-22,GUS,brawlBall,Pinhole Punt,0,2,2,4
7766,2022-12-21,GUS,brawlBall,Sunny Soccer,0,0,2,2
7767,2022-12-17,GUS,knockout,Flaring Phoenix,0,1,0,1
7768,2022-12-16,GUS,brawlBall,Sneaky Fields,0,1,0,1
7769,2022-12-13,GUS,gemGrab,Crystal Arcade,0,1,0,1
7770,2022-12-11,GUS,brawlBall,Backyard Bowl,0,0,1,1
7771,2022-12-10,GUS,knockout,X Marks the Spot,0,1,0,1
7772,2022-11-07,GUS,hotZone,Quarter Pounder,0,0,1,1
7773,2022-11-03,GUS,brawlBall,Pinhole Punt,0,0,1,1
7774,2022-10-15,GUS,gemGrab,Hard Rock Mine,0,1,0,1
7775,2022-10-15,GUS,bounty,Dry Season,0,0,1,1
7776,2022-10-10,GUS,knockout,Belle's Rock,0,1,1,2
7777,2023-01-30,GROM,knockout,Belle's Rock,1,1392,1396,2789
7778,2023-01-30,GROM,hotZone,Quarter Pounder,1,101,75,177
7779,2023-01-30,GROM,heist,Pit Stop,0,49,54,103
7780,2023-01-30,GROM,gemGrab,Minecart Madness,0,109,126,235
7781,2023-01-30,GROM,gemGrab,Double Swoosh,0,22,25,47
7782,2023-01-30,GROM,brawlBall,Center Stage,21,866,1045,1932
7783,2023-01-30,GROM,brawlBall,Backyard Bowl,0,20,18,38
7784,2023-01-30,GROM,bounty,Hideout,0,203,219,422
7785,2023-01-29,GROM,knockout,Belle's Rock,2,1703,1672,3377
7786,2023-01-29,GROM,hotZone,Quarter Pounder,0,83,72,155
7787,2023-01-29,GROM,heist,Bridge Too Far,0,330,522,852
7788,2023-01-29,GROM,gemGrab,Hard Rock Mine,0,8,5,13
7789,2023-01-29,GROM,gemGrab,Double Swoosh,0,58,50,108
7790,2023-01-29,GROM,brawlBall,Super Beach,0,9,17,26
7791,2023-01-29,GROM,brawlBall,Backyard Bowl,5,126,128,259
7792,2023-01-29,GROM,bounty,Canal Grande,0,256,291,547
7793,2023-01-28,GROM,knockout,Flaring Phoenix,0,403,434,837
7794,2023-01-28,GROM,hotZone,Controller Chaos,0,50,40,90
7795,2023-01-28,GROM,heist,Bridge Too Far,2,612,874,1488
7796,2023-01-28,GROM,gemGrab,Hard Rock Mine,0,56,51,107
7797,2023-01-28,GROM,gemGrab,Deep Diner,0,44,55,99
7798,2023-01-28,GROM,brawlBall,Super Beach,3,211,187,401
7799,2023-01-28,GROM,brawlBall,Sneaky Fields,0,10,6,16
7800,2023-01-28,GROM,bounty,Canal Grande,0,554,647,1201
7801,2023-01-27,GROM,knockout,Flaring Phoenix,0,185,159,344
7802,2023-01-27,GROM,hotZone,Controller Chaos,0,25,15,40
7803,2023-01-27,GROM,heist,Hot Potato,0,30,32,62
7804,2023-01-27,GROM,gemGrab,Undermine,0,1,1,2
7805,2023-01-27,GROM,gemGrab,Deep Diner,0,64,66,130
7806,2023-01-27,GROM,brawlBall,Sneaky Fields,0,78,87,165
7807,2023-01-27,GROM,brawlBall,Pinhole Punt,0,16,11,27
7808,2023-01-27,GROM,bounty,Temple Ruins,0,35,18,53
7809,2023-01-26,GROM,knockout,Riverside,1,370,256,627
7810,2023-01-26,GROM,hotZone,Open Zone,0,46,14,60
7811,2023-01-26,GROM,heist,Hot Potato,0,54,48,102
7812,2023-01-26,GROM,gemGrab,Undermine,0,43,21,64
7813,2023-01-26,GROM,gemGrab,Gem Fort,0,8,13,21
7814,2023-01-26,GROM,brawlBall,Sunny Soccer,0,23,15,38
7815,2023-01-26,GROM,brawlBall,Pinhole Punt,5,192,164,361
7816,2023-01-26,GROM,bounty,Temple Ruins,0,114,133,247
7817,2023-01-25,GROM,knockout,Riverside,0,155,116,271
7818,2023-01-25,GROM,hotZone,Open Zone,0,18,11,29
7819,2023-01-25,GROM,heist,Safe Zone,1,231,233,465
7820,2023-01-25,GROM,gemGrab,Gem Fort,0,24,11,35
7821,2023-01-25,GROM,gemGrab,Crystal Arcade,0,31,30,61
7822,2023-01-25,GROM,brawlBall,Sunny Soccer,4,234,224,462
7823,2023-01-25,GROM,brawlBall,Beach Ball,1,29,58,88
7824,2023-01-25,GROM,bounty,Excel,0,310,330,640
7825,2023-01-24,GROM,knockout,New Perspective,0,292,315,607
7826,2023-01-24,GROM,hotZone,Dueling Beetles,0,116,71,187
7827,2023-01-24,GROM,heist,Safe Zone,1,306,367,674
7828,2023-01-24,GROM,gemGrab,Minecart Madness,0,33,32,65
7829,2023-01-24,GROM,gemGrab,Crystal Arcade,0,58,33,91
7830,2023-01-24,GROM,brawlBall,Center Stage,6,157,204,367
7831,2023-01-24,GROM,brawlBall,Beach Ball,9,418,432,859
7832,2023-01-24,GROM,bounty,Excel,0,580,522,1102
7833,2023-01-23,GROM,knockout,New Perspective,0,538,507,1045
7834,2023-01-23,GROM,hotZone,Dueling Beetles,1,191,125,317
7835,2023-01-23,GROM,heist,Snaked Assault,0,44,13,57
7836,2023-01-23,GROM,gemGrab,Minecart Madness,0,194,128,322
7837,2023-01-23,GROM,gemGrab,Double Swoosh,0,27,13,40
7838,2023-01-23,GROM,brawlBall,Center Stage,48,2078,2563,4689
7839,2023-01-23,GROM,brawlBall,Backyard Bowl,1,9,3,13
7840,2023-01-23,GROM,bounty,Layer Cake,0,420,509,929
7841,2023-01-22,GROM,knockout,X Marks the Spot,1,335,401,737
7842,2023-01-22,GROM,hotZone,Ring of Fire,0,28,20,48
7843,2023-01-22,GROM,heist,Snaked Assault,0,15,12,27
7844,2023-01-22,GROM,gemGrab,Hard Rock Mine,0,14,9,23
7845,2023-01-22,GROM,gemGrab,Double Swoosh,0,29,45,74
7846,2023-01-22,GROM,brawlBall,Super Beach,0,22,14,36
7847,2023-01-22,GROM,brawlBall,Backyard Bowl,2,89,63,154
7848,2023-01-22,GROM,bounty,Layer Cake,0,327,313,640
7849,2023-01-21,GROM,knockout,X Marks the Spot,1,1123,1055,2179
7850,2023-01-21,GROM,hotZone,Ring of Fire,0,98,59,157
7851,2023-01-21,GROM,heist,Tornado Ring,0,34,17,51
7852,2023-01-21,GROM,gemGrab,Hard Rock Mine,0,60,60,120
7853,2023-01-21,GROM,gemGrab,Deep Diner,0,41,35,76
7854,2023-01-21,GROM,brawlBall,Super Beach,4,312,242,558
7855,2023-01-21,GROM,brawlBall,Sneaky Fields,0,12,13,25
7856,2023-01-21,GROM,bounty,Dry Season,0,484,497,981
7857,2023-01-20,GROM,knockout,Out in the Open,3,457,421,881
7858,2023-01-20,GROM,hotZone,Split,0,173,92,265
7859,2023-01-20,GROM,heist,Tornado Ring,0,38,18,56
7860,2023-01-20,GROM,gemGrab,Undermine,0,18,16,34
7861,2023-01-20,GROM,gemGrab,Deep Diner,0,187,183,370
7862,2023-01-20,GROM,brawlBall,Sneaky Fields,3,224,236,463
7863,2023-01-20,GROM,brawlBall,Pinhole Punt,0,7,9,16
7864,2023-01-20,GROM,bounty,Dry Season,0,329,339,668
7865,2023-01-19,GROM,knockout,Out in the Open,0,613,554,1167
7866,2023-01-19,GROM,hotZone,Split,0,248,194,442
7867,2023-01-19,GROM,heist,Kaboom Canyon,0,63,62,125
7868,2023-01-19,GROM,gemGrab,Undermine,0,51,35,86
7869,2023-01-19,GROM,gemGrab,Gem Fort,0,3,1,4
7870,2023-01-19,GROM,brawlBall,Sunny Soccer,0,14,7,21
7871,2023-01-19,GROM,brawlBall,Pinhole Punt,3,200,160,363
7872,2023-01-19,GROM,bounty,Shooting Star,0,317,397,714
7873,2023-01-18,GROM,knockout,Goldarm Gulch,0,104,105,209
7874,2023-01-18,GROM,hotZone,Parallel Plays,0,4,1,5
7875,2023-01-18,GROM,heist,Kaboom Canyon,0,27,15,42
7876,2023-01-18,GROM,gemGrab,Gem Fort,0,12,4,16
7877,2023-01-18,GROM,gemGrab,Crystal Arcade,0,3,0,3
7878,2023-01-18,GROM,brawlBall,Sunny Soccer,5,98,87,190
7879,2023-01-18,GROM,brawlBall,Beach Ball,0,3,7,10
7880,2023-01-18,GROM,bounty,Shooting Star,0,127,144,271
7881,2023-01-17,GROM,knockout,Goldarm Gulch,0,92,111,203
7882,2023-01-17,GROM,hotZone,Parallel Plays,0,5,6,11
7883,2023-01-17,GROM,heist,Pit Stop,0,7,5,12
7884,2023-01-17,GROM,gemGrab,Minecart Madness,0,1,1,2
7885,2023-01-17,GROM,gemGrab,Crystal Arcade,0,3,2,5
7886,2023-01-17,GROM,brawlBall,Center Stage,0,1,2,3
7887,2023-01-17,GROM,brawlBall,Beach Ball,2,34,28,64
7888,2023-01-17,GROM,bounty,Hideout,0,41,37,78
7889,2023-01-16,GROM,knockout,Belle's Rock,0,104,119,223
7890,2023-01-16,GROM,hotZone,Quarter Pounder,0,13,14,27
7891,2023-01-16,GROM,heist,Pit Stop,0,17,19,36
7892,2023-01-16,GROM,gemGrab,Minecart Madness,0,12,12,24
7893,2023-01-16,GROM,gemGrab,Double Swoosh,0,4,3,7
7894,2023-01-16,GROM,brawlBall,Center Stage,7,177,204,388
7895,2023-01-16,GROM,brawlBall,Backyard Bowl,0,1,1,2
7896,2023-01-16,GROM,bounty,Hideout,0,74,54,128
7897,2023-01-15,GROM,knockout,Belle's Rock,0,210,212,422
7898,2023-01-15,GROM,hotZone,Quarter Pounder,0,30,33,63
7899,2023-01-15,GROM,heist,Bridge Too Far,1,46,43,90
7900,2023-01-15,GROM,gemGrab,Hard Rock Mine,0,1,1,2
7901,2023-01-15,GROM,gemGrab,Double Swoosh,0,7,2,9
7902,2023-01-15,GROM,brawlBall,Super Beach,0,6,0,6
7903,2023-01-15,GROM,brawlBall,Backyard Bowl,1,21,16,38
7904,2023-01-15,GROM,bounty,Canal Grande,0,54,61,115
7905,2023-01-14,GROM,knockout,Flaring Phoenix,0,60,34,94
7906,2023-01-14,GROM,hotZone,Controller Chaos,0,26,9,35
7907,2023-01-14,GROM,heist,Bridge Too Far,0,76,70,146
7908,2023-01-14,GROM,gemGrab,Hard Rock Mine,0,2,7,9
7909,2023-01-14,GROM,gemGrab,Deep Diner,0,10,8,18
7910,2023-01-14,GROM,brawlBall,Super Beach,2,24,12,38
7911,2023-01-14,GROM,bounty,Canal Grande,0,57,71,128
7912,2023-01-13,GROM,knockout,Flaring Phoenix,0,43,38,81
7913,2023-01-13,GROM,hotZone,Controller Chaos,0,19,10,29
7914,2023-01-13,GROM,heist,Hot Potato,0,4,3,7
7915,2023-01-13,GROM,gemGrab,Deep Diner,0,11,5,16
7916,2023-01-13,GROM,brawlBall,Sneaky Fields,1,22,14,37
7917,2023-01-13,GROM,brawlBall,Pinhole Punt,0,1,0,1
7918,2023-01-13,GROM,bounty,Temple Ruins,0,2,2,4
7919,2023-01-12,GROM,knockout,Riverside,0,63,30,93
7920,2023-01-12,GROM,hotZone,Open Zone,0,5,1,6
7921,2023-01-12,GROM,heist,Hot Potato,0,0,2,2
7922,2023-01-12,GROM,gemGrab,Undermine,0,3,2,5
7923,2023-01-12,GROM,brawlBall,Sunny Soccer,0,2,0,2
7924,2023-01-12,GROM,brawlBall,Pinhole Punt,0,4,3,7
7925,2023-01-12,GROM,bounty,Temple Ruins,0,0,4,4
7926,2023-01-11,GROM,knockout,Riverside,0,11,2,13
7927,2023-01-11,GROM,hotZone,Open Zone,0,2,0,2
7928,2023-01-11,GROM,heist,Safe Zone,0,1,1,2
7929,2023-01-11,GROM,gemGrab,Gem Fort,0,0,4,4
7930,2023-01-11,GROM,brawlBall,Sunny Soccer,1,18,18,37
7931,2023-01-11,GROM,bounty,Excel,0,13,14,27
7932,2023-01-10,GROM,knockout,New Perspective,0,35,52,87
7933,2023-01-10,GROM,hotZone,Dueling Beetles,0,25,31,56
7934,2023-01-10,GROM,heist,Safe Zone,0,24,9,33
7935,2023-01-10,GROM,gemGrab,Minecart Madness,0,9,19,28
7936,2023-01-10,GROM,gemGrab,Crystal Arcade,0,7,6,13
7937,2023-01-10,GROM,brawlBall,Center Stage,0,18,49,67
7938,2023-01-10,GROM,brawlBall,Beach Ball,0,31,35,66
7939,2023-01-10,GROM,bounty,Excel,0,18,12,30
7940,2023-01-09,GROM,knockout,New Perspective,0,28,28,56
7941,2023-01-09,GROM,hotZone,Dueling Beetles,0,33,15,48
7942,2023-01-09,GROM,heist,Snaked Assault,0,8,3,11
7943,2023-01-09,GROM,gemGrab,Minecart Madness,0,25,6,31
7944,2023-01-09,GROM,gemGrab,Double Swoosh,0,6,0,6
7945,2023-01-09,GROM,brawlBall,Center Stage,7,207,283,497
7946,2023-01-09,GROM,brawlBall,Backyard Bowl,0,1,2,3
7947,2023-01-09,GROM,bounty,Layer Cake,0,70,49,119
7948,2023-01-08,GROM,knockout,X Marks the Spot,0,81,75,156
7949,2023-01-08,GROM,hotZone,Ring of Fire,0,6,4,10
7950,2023-01-08,GROM,heist,Snaked Assault,0,7,10,17
7951,2023-01-08,GROM,gemGrab,Hard Rock Mine,0,1,0,1
7952,2023-01-08,GROM,gemGrab,Double Swoosh,0,5,5,10
7953,2023-01-08,GROM,brawlBall,Backyard Bowl,0,10,8,18
7954,2023-01-08,GROM,bounty,Layer Cake,0,24,27,51
7955,2023-01-07,GROM,knockout,X Marks the Spot,0,41,42,83
7956,2023-01-07,GROM,hotZone,Ring of Fire,0,8,9,17
7957,2023-01-07,GROM,heist,Tornado Ring,0,1,3,4
7958,2023-01-07,GROM,gemGrab,Hard Rock Mine,0,3,2,5
7959,2023-01-07,GROM,gemGrab,Deep Diner,0,8,13,21
7960,2023-01-07,GROM,brawlBall,Super Beach,0,14,11,25
7961,2023-01-07,GROM,brawlBall,Sneaky Fields,1,1,1,3
7962,2023-01-07,GROM,bounty,Dry Season,0,60,94,154
7963,2023-01-06,GROM,knockout,Out in the Open,0,52,40,92
7964,2023-01-06,GROM,hotZone,Split,0,25,24,49
7965,2023-01-06,GROM,heist,Tornado Ring,0,5,1,6
7966,2023-01-06,GROM,gemGrab,Undermine,0,0,1,1
7967,2023-01-06,GROM,gemGrab,Deep Diner,0,30,72,102
7968,2023-01-06,GROM,brawlBall,Sneaky Fields,1,13,20,34
7969,2023-01-06,GROM,bounty,Dry Season,0,95,118,213
7970,2023-01-05,GROM,knockout,Out in the Open,0,101,92,193
7971,2023-01-05,GROM,hotZone,Split,0,52,92,144
7972,2023-01-05,GROM,heist,Kaboom Canyon,0,7,5,12
7973,2023-01-05,GROM,gemGrab,Undermine,0,2,4,6
7974,2023-01-05,GROM,gemGrab,Gem Fort,0,0,2,2
7975,2023-01-05,GROM,brawlBall,Sunny Soccer,0,0,1,1
7976,2023-01-05,GROM,brawlBall,Pinhole Punt,0,25,20,45
7977,2023-01-05,GROM,bounty,Shooting Star,0,56,58,114
7978,2023-01-04,GROM,knockout,Goldarm Gulch,0,35,38,73
7979,2023-01-04,GROM,hotZone,Parallel Plays,0,4,1,5
7980,2023-01-04,GROM,heist,Kaboom Canyon,0,19,26,45
7981,2023-01-04,GROM,gemGrab,Gem Fort,0,1,0,1
7982,2023-01-04,GROM,gemGrab,Crystal Arcade,0,1,1,2
7983,2023-01-04,GROM,brawlBall,Sunny Soccer,1,46,59,106
7984,2023-01-04,GROM,bounty,Shooting Star,0,144,162,306
7985,2023-01-03,GROM,knockout,Goldarm Gulch,0,49,55,104
7986,2023-01-03,GROM,hotZone,Parallel Plays,0,10,9,19
7987,2023-01-03,GROM,heist,Pit Stop,0,10,2,12
7988,2023-01-03,GROM,gemGrab,Minecart Madness,0,6,2,8
7989,2023-01-03,GROM,gemGrab,Crystal Arcade,0,2,2,4
7990,2023-01-03,GROM,brawlBall,Center Stage,0,9,1,10
7991,2023-01-03,GROM,brawlBall,Beach Ball,0,36,31,67
7992,2023-01-03,GROM,bounty,Hideout,0,86,105,191
7993,2023-01-02,GROM,knockout,Belle's Rock,0,120,142,262
7994,2023-01-02,GROM,hotZone,Quarter Pounder,1,17,12,30
7995,2023-01-02,GROM,heist,Pit Stop,0,5,1,6
7996,2023-01-02,GROM,gemGrab,Minecart Madness,0,16,15,31
7997,2023-01-02,GROM,gemGrab,Double Swoosh,0,1,0,1
7998,2023-01-02,GROM,brawlBall,Center Stage,7,264,305,576
7999,2023-01-02,GROM,brawlBall,Backyard Bowl,0,2,2,4
8000,2023-01-02,GROM,bounty,Hideout,0,169,192,361
8001,2023-01-01,GROM,knockout,Belle's Rock,0,61,80,141
8002,2023-01-01,GROM,hotZone,Quarter Pounder,0,6,26,32
8003,2023-01-01,GROM,heist,Bridge Too Far,0,13,20,33
8004,2023-01-01,GROM,gemGrab,Hard Rock Mine,0,0,1,1
8005,2023-01-01,GROM,gemGrab,Double Swoosh,0,2,1,3
8006,2023-01-01,GROM,brawlBall,Backyard Bowl,0,4,0,4
8007,2023-01-01,GROM,bounty,Canal Grande,0,2,3,5
8008,2022-12-31,GROM,knockout,Flaring Phoenix,0,2,0,2
8009,2022-12-31,GROM,heist,Bridge Too Far,0,2,3,5
8010,2022-12-31,GROM,gemGrab,Minecart Madness,0,0,1,1
8011,2022-12-31,GROM,gemGrab,Hard Rock Mine,0,1,0,1
8012,2022-12-31,GROM,gemGrab,Deep Diner,0,1,4,5
8013,2022-12-31,GROM,brawlBall,Super Beach,0,3,0,3
8014,2022-12-31,GROM,bounty,Canal Grande,0,1,3,4
8015,2022-12-30,GROM,knockout,Flaring Phoenix,0,4,1,5
8016,2022-12-30,GROM,hotZone,Controller Chaos,0,4,0,4
8017,2022-12-30,GROM,gemGrab,Deep Diner,0,4,0,4
8018,2022-12-30,GROM,brawlBall,Sneaky Fields,0,4,0,4
8019,2022-12-29,GROM,gemGrab,Undermine,0,0,1,1
8020,2022-12-29,GROM,gemGrab,Minecart Madness,0,0,1,1
8021,2022-12-29,GROM,brawlBall,Pinhole Punt,0,2,0,2
8022,2022-12-28,GROM,brawlBall,Sunny Soccer,0,0,1,1
8023,2022-12-27,GROM,hotZone,Dueling Beetles,0,0,1,1
8024,2022-12-27,GROM,heist,Safe Zone,0,2,0,2
8025,2022-12-27,GROM,brawlBall,Center Stage,0,1,2,3
8026,2022-12-27,GROM,brawlBall,Beach Ball,0,2,0,2
8027,2022-12-27,GROM,bounty,Excel,0,0,1,1
8028,2022-12-26,GROM,heist,Kaboom Canyon,0,0,1,1
8029,2022-12-26,GROM,brawlBall,Center Stage,0,3,4,7
8030,2022-12-25,GROM,bounty,Layer Cake,0,2,1,3
8031,2022-12-24,GROM,brawlBall,Super Beach,0,0,1,1
8032,2022-12-23,GROM,knockout,Out in the Open,0,4,8,12
8033,2022-12-22,GROM,gemGrab,Gem Fort,0,1,0,1
8034,2022-12-19,GROM,brawlBall,Center Stage,0,2,0,2
8035,2022-12-18,GROM,knockout,Belle's Rock,0,1,0,1
8036,2022-12-17,GROM,knockout,Flaring Phoenix,0,3,1,4
8037,2022-12-13,GROM,knockout,New Perspective,0,4,13,17
8038,2022-12-13,GROM,heist,Safe Zone,0,0,1,1
8039,2022-12-11,GROM,brawlBall,Backyard Bowl,0,1,0,1
8040,2022-10-26,GROM,bounty,Shooting Star,0,1,0,1
8041,2022-10-15,GROM,gemGrab,Hard Rock Mine,0,1,0,1
8042,2022-10-10,GROM,knockout,Belle's Rock,0,1,1,2
8043,2023-01-30,GRIFF,knockout,Belle's Rock,0,24,12,36
8044,2023-01-30,GRIFF,hotZone,Quarter Pounder,1,256,407,664
8045,2023-01-30,GRIFF,heist,Pit Stop,0,80,76,156
8046,2023-01-30,GRIFF,gemGrab,Minecart Madness,0,43,38,81
8047,2023-01-30,GRIFF,gemGrab,Double Swoosh,0,95,94,189
8048,2023-01-30,GRIFF,brawlBall,Center Stage,20,415,381,816
8049,2023-01-30,GRIFF,brawlBall,Backyard Bowl,3,44,62,109
8050,2023-01-30,GRIFF,bounty,Hideout,0,3,2,5
8051,2023-01-29,GRIFF,knockout,Belle's Rock,0,23,9,32
8052,2023-01-29,GRIFF,hotZone,Quarter Pounder,6,313,400,719
8053,2023-01-29,GRIFF,heist,Bridge Too Far,0,33,25,58
8054,2023-01-29,GRIFF,gemGrab,Hard Rock Mine,0,12,10,22
8055,2023-01-29,GRIFF,gemGrab,Double Swoosh,0,132,117,249
8056,2023-01-29,GRIFF,brawlBall,Super Beach,1,7,6,14
8057,2023-01-29,GRIFF,brawlBall,Backyard Bowl,16,403,323,742
8058,2023-01-29,GRIFF,bounty,Canal Grande,0,31,28,59
8059,2023-01-28,GRIFF,knockout,Flaring Phoenix,0,20,11,31
8060,2023-01-28,GRIFF,hotZone,Controller Chaos,0,164,224,388
8061,2023-01-28,GRIFF,heist,Bridge Too Far,0,71,52,123
8062,2023-01-28,GRIFF,gemGrab,Hard Rock Mine,0,106,90,196
8063,2023-01-28,GRIFF,gemGrab,Deep Diner,0,60,58,118
8064,2023-01-28,GRIFF,brawlBall,Super Beach,30,718,746,1494
8065,2023-01-28,GRIFF,brawlBall,Sneaky Fields,1,20,21,42
8066,2023-01-28,GRIFF,bounty,Canal Grande,0,60,39,99
8067,2023-01-27,GRIFF,knockout,Flaring Phoenix,0,8,6,14
8068,2023-01-27,GRIFF,hotZone,Controller Chaos,0,40,27,67
8069,2023-01-27,GRIFF,heist,Hot Potato,0,32,25,57
8070,2023-01-27,GRIFF,gemGrab,Undermine,0,7,6,13
8071,2023-01-27,GRIFF,gemGrab,Deep Diner,0,86,90,176
8072,2023-01-27,GRIFF,brawlBall,Sneaky Fields,3,210,177,390
8073,2023-01-27,GRIFF,brawlBall,Pinhole Punt,0,5,8,13
8074,2023-01-27,GRIFF,bounty,Temple Ruins,0,9,1,10
8075,2023-01-26,GRIFF,knockout,Riverside,0,16,7,23
8076,2023-01-26,GRIFF,hotZone,Open Zone,0,77,54,131
8077,2023-01-26,GRIFF,heist,Hot Potato,0,140,160,300
8078,2023-01-26,GRIFF,gemGrab,Undermine,0,73,85,158
8079,2023-01-26,GRIFF,gemGrab,Gem Fort,0,44,41,85
8080,2023-01-26,GRIFF,brawlBall,Sunny Soccer,0,34,41,75
8081,2023-01-26,GRIFF,brawlBall,Pinhole Punt,21,654,653,1328
8082,2023-01-26,GRIFF,bounty,Temple Ruins,0,16,14,30
8083,2023-01-25,GRIFF,knockout,Riverside,0,6,4,10
8084,2023-01-25,GRIFF,hotZone,Open Zone,0,54,20,74
8085,2023-01-25,GRIFF,heist,Safe Zone,0,55,89,144
8086,2023-01-25,GRIFF,gemGrab,Gem Fort,0,39,50,89
8087,2023-01-25,GRIFF,gemGrab,Crystal Arcade,0,60,50,110
8088,2023-01-25,GRIFF,brawlBall,Sunny Soccer,12,311,320,643
8089,2023-01-25,GRIFF,brawlBall,Beach Ball,4,58,64,126
8090,2023-01-25,GRIFF,bounty,Excel,0,17,8,25
8091,2023-01-24,GRIFF,knockout,New Perspective,0,17,11,28
8092,2023-01-24,GRIFF,hotZone,Dueling Beetles,0,139,161,300
8093,2023-01-24,GRIFF,heist,Safe Zone,2,90,97,189
8094,2023-01-24,GRIFF,gemGrab,Minecart Madness,0,17,12,29
8095,2023-01-24,GRIFF,gemGrab,Crystal Arcade,0,114,102,216
8096,2023-01-24,GRIFF,brawlBall,Center Stage,3,74,114,191
8097,2023-01-24,GRIFF,brawlBall,Beach Ball,14,609,761,1384
8098,2023-01-24,GRIFF,bounty,Excel,0,20,6,26
8099,2023-01-23,GRIFF,knockout,New Perspective,0,37,29,66
8100,2023-01-23,GRIFF,hotZone,Dueling Beetles,0,268,202,470
8101,2023-01-23,GRIFF,heist,Snaked Assault,1,234,269,504
8102,2023-01-23,GRIFF,gemGrab,Minecart Madness,0,75,96,171
8103,2023-01-23,GRIFF,gemGrab,Double Swoosh,0,75,45,120
8104,2023-01-23,GRIFF,brawlBall,Center Stage,29,833,900,1762
8105,2023-01-23,GRIFF,brawlBall,Backyard Bowl,0,21,24,45
8106,2023-01-23,GRIFF,bounty,Layer Cake,0,18,19,37
8107,2023-01-22,GRIFF,knockout,X Marks the Spot,0,16,15,31
8108,2023-01-22,GRIFF,hotZone,Ring of Fire,0,91,103,194
8109,2023-01-22,GRIFF,heist,Snaked Assault,0,135,166,301
8110,2023-01-22,GRIFF,gemGrab,Hard Rock Mine,0,30,15,45
8111,2023-01-22,GRIFF,gemGrab,Double Swoosh,0,68,59,127
8112,2023-01-22,GRIFF,brawlBall,Super Beach,2,58,60,120
8113,2023-01-22,GRIFF,brawlBall,Backyard Bowl,16,233,169,418
8114,2023-01-22,GRIFF,bounty,Layer Cake,0,18,18,36
8115,2023-01-21,GRIFF,knockout,X Marks the Spot,0,52,25,77
8116,2023-01-21,GRIFF,hotZone,Ring of Fire,1,170,184,355
8117,2023-01-21,GRIFF,heist,Tornado Ring,3,166,195,364
8118,2023-01-21,GRIFF,gemGrab,Hard Rock Mine,0,140,169,309
8119,2023-01-21,GRIFF,gemGrab,Deep Diner,0,40,60,100
8120,2023-01-21,GRIFF,brawlBall,Super Beach,35,952,910,1897
8121,2023-01-21,GRIFF,brawlBall,Sneaky Fields,1,38,35,74
8122,2023-01-21,GRIFF,bounty,Dry Season,0,16,9,25
8123,2023-01-20,GRIFF,knockout,Out in the Open,0,38,32,70
8124,2023-01-20,GRIFF,hotZone,Split,0,80,93,173
8125,2023-01-20,GRIFF,heist,Tornado Ring,2,127,137,266
8126,2023-01-20,GRIFF,gemGrab,Undermine,0,50,29,79
8127,2023-01-20,GRIFF,gemGrab,Deep Diner,0,200,224,424
8128,2023-01-20,GRIFF,brawlBall,Sneaky Fields,23,710,719,1452
8129,2023-01-20,GRIFF,brawlBall,Pinhole Punt,1,35,25,61
8130,2023-01-20,GRIFF,bounty,Dry Season,0,10,5,15
8131,2023-01-19,GRIFF,knockout,Out in the Open,0,65,31,96
8132,2023-01-19,GRIFF,hotZone,Split,0,127,94,221
8133,2023-01-19,GRIFF,heist,Kaboom Canyon,0,63,65,128
8134,2023-01-19,GRIFF,gemGrab,Undermine,0,86,74,160
8135,2023-01-19,GRIFF,gemGrab,Gem Fort,0,32,17,49
8136,2023-01-19,GRIFF,brawlBall,Sunny Soccer,0,13,16,29
8137,2023-01-19,GRIFF,brawlBall,Pinhole Punt,26,728,739,1493
8138,2023-01-19,GRIFF,bounty,Shooting Star,0,17,7,24
8139,2023-01-18,GRIFF,knockout,Goldarm Gulch,0,9,9,18
8140,2023-01-18,GRIFF,hotZone,Parallel Plays,0,16,26,42
8141,2023-01-18,GRIFF,heist,Kaboom Canyon,0,13,15,28
8142,2023-01-18,GRIFF,gemGrab,Gem Fort,0,42,33,75
8143,2023-01-18,GRIFF,gemGrab,Crystal Arcade,0,4,3,7
8144,2023-01-18,GRIFF,brawlBall,Sunny Soccer,2,156,176,334
8145,2023-01-18,GRIFF,brawlBall,Beach Ball,0,6,6,12
8146,2023-01-18,GRIFF,bounty,Shooting Star,0,3,2,5
8147,2023-01-17,GRIFF,knockout,Goldarm Gulch,0,1,4,5
8148,2023-01-17,GRIFF,hotZone,Parallel Plays,0,13,24,37
8149,2023-01-17,GRIFF,heist,Pit Stop,0,11,13,24
8150,2023-01-17,GRIFF,gemGrab,Crystal Arcade,0,11,11,22
8151,2023-01-17,GRIFF,brawlBall,Center Stage,0,2,5,7
8152,2023-01-17,GRIFF,brawlBall,Beach Ball,1,48,48,97
8153,2023-01-17,GRIFF,bounty,Hideout,0,2,0,2
8154,2023-01-16,GRIFF,knockout,Belle's Rock,0,1,0,1
8155,2023-01-16,GRIFF,hotZone,Quarter Pounder,0,22,17,39
8156,2023-01-16,GRIFF,heist,Pit Stop,0,41,40,81
8157,2023-01-16,GRIFF,gemGrab,Minecart Madness,0,8,3,11
8158,2023-01-16,GRIFF,gemGrab,Double Swoosh,0,6,8,14
8159,2023-01-16,GRIFF,brawlBall,Center Stage,1,43,51,95
8160,2023-01-16,GRIFF,brawlBall,Backyard Bowl,0,2,6,8
8161,2023-01-15,GRIFF,knockout,Belle's Rock,0,0,1,1
8162,2023-01-15,GRIFF,hotZone,Quarter Pounder,0,73,125,198
8163,2023-01-15,GRIFF,heist,Bridge Too Far,0,16,16,32
8164,2023-01-15,GRIFF,gemGrab,Hard Rock Mine,0,5,2,7
8165,2023-01-15,GRIFF,gemGrab,Double Swoosh,0,15,2,17
8166,2023-01-15,GRIFF,brawlBall,Super Beach,0,2,6,8
8167,2023-01-15,GRIFF,brawlBall,Backyard Bowl,0,41,50,91
8168,2023-01-15,GRIFF,bounty,Canal Grande,0,2,0,2
8169,2023-01-14,GRIFF,knockout,Flaring Phoenix,0,2,0,2
8170,2023-01-14,GRIFF,hotZone,Controller Chaos,0,48,86,134
8171,2023-01-14,GRIFF,heist,Bridge Too Far,0,6,2,8
8172,2023-01-14,GRIFF,gemGrab,Hard Rock Mine,0,1,2,3
8173,2023-01-14,GRIFF,gemGrab,Deep Diner,0,6,5,11
8174,2023-01-14,GRIFF,brawlBall,Super Beach,5,60,97,162
8175,2023-01-14,GRIFF,brawlBall,Sneaky Fields,0,9,1,10
8176,2023-01-14,GRIFF,bounty,Canal Grande,0,1,0,1
8177,2023-01-13,GRIFF,knockout,Flaring Phoenix,0,4,0,4
8178,2023-01-13,GRIFF,hotZone,Controller Chaos,0,67,88,155
8179,2023-01-13,GRIFF,heist,Hot Potato,0,5,2,7
8180,2023-01-13,GRIFF,gemGrab,Deep Diner,0,16,19,35
8181,2023-01-13,GRIFF,brawlBall,Sneaky Fields,2,49,62,113
8182,2023-01-13,GRIFF,brawlBall,Pinhole Punt,2,9,13,24
8183,2023-01-12,GRIFF,knockout,Riverside,0,1,1,2
8184,2023-01-12,GRIFF,hotZone,Open Zone,0,13,6,19
8185,2023-01-12,GRIFF,heist,Hot Potato,0,5,0,5
8186,2023-01-12,GRIFF,gemGrab,Undermine,0,2,7,9
8187,2023-01-12,GRIFF,gemGrab,Gem Fort,0,0,1,1
8188,2023-01-12,GRIFF,brawlBall,Sunny Soccer,0,1,0,1
8189,2023-01-12,GRIFF,brawlBall,Pinhole Punt,0,24,23,47
8190,2023-01-11,GRIFF,hotZone,Open Zone,0,3,0,3
8191,2023-01-11,GRIFF,heist,Safe Zone,0,1,0,1
8192,2023-01-11,GRIFF,gemGrab,Gem Fort,0,2,0,2
8193,2023-01-11,GRIFF,brawlBall,Sunny Soccer,0,8,5,13
8194,2023-01-10,GRIFF,knockout,New Perspective,0,3,0,3
8195,2023-01-10,GRIFF,hotZone,Dueling Beetles,0,23,34,57
8196,2023-01-10,GRIFF,heist,Safe Zone,0,8,2,10
8197,2023-01-10,GRIFF,gemGrab,Minecart Madness,0,1,0,1
8198,2023-01-10,GRIFF,gemGrab,Crystal Arcade,0,15,51,66
8199,2023-01-10,GRIFF,brawlBall,Center Stage,0,9,0,9
8200,2023-01-10,GRIFF,brawlBall,Beach Ball,0,33,27,60
8201,2023-01-09,GRIFF,hotZone,Dueling Beetles,0,14,23,37
8202,2023-01-09,GRIFF,heist,Snaked Assault,0,32,40,72
8203,2023-01-09,GRIFF,gemGrab,Minecart Madness,0,5,1,6
8204,2023-01-09,GRIFF,gemGrab,Double Swoosh,0,6,15,21
8205,2023-01-09,GRIFF,brawlBall,Center Stage,1,41,28,70
8206,2023-01-09,GRIFF,brawlBall,Backyard Bowl,0,3,2,5
8207,2023-01-09,GRIFF,bounty,Layer Cake,0,2,0,2
8208,2023-01-08,GRIFF,hotZone,Ring of Fire,0,19,29,48
8209,2023-01-08,GRIFF,heist,Snaked Assault,0,14,7,21
8210,2023-01-08,GRIFF,gemGrab,Hard Rock Mine,0,3,5,8
8211,2023-01-08,GRIFF,gemGrab,Double Swoosh,0,2,1,3
8212,2023-01-08,GRIFF,brawlBall,Super Beach,0,10,8,18
8213,2023-01-08,GRIFF,brawlBall,Backyard Bowl,0,21,26,47
8214,2023-01-07,GRIFF,hotZone,Ring of Fire,0,8,20,28
8215,2023-01-07,GRIFF,heist,Tornado Ring,0,19,4,23
8216,2023-01-07,GRIFF,gemGrab,Hard Rock Mine,0,7,2,9
8217,2023-01-07,GRIFF,gemGrab,Deep Diner,0,4,2,6
8218,2023-01-07,GRIFF,brawlBall,Super Beach,1,24,22,47
8219,2023-01-07,GRIFF,bounty,Dry Season,0,2,4,6
8220,2023-01-06,GRIFF,knockout,Out in the Open,0,2,1,3
8221,2023-01-06,GRIFF,hotZone,Split,0,9,6,15
8222,2023-01-06,GRIFF,heist,Tornado Ring,0,23,47,70
8223,2023-01-06,GRIFF,gemGrab,Undermine,0,3,1,4
8224,2023-01-06,GRIFF,gemGrab,Deep Diner,0,24,28,52
8225,2023-01-06,GRIFF,brawlBall,Sneaky Fields,0,31,28,59
8226,2023-01-06,GRIFF,brawlBall,Pinhole Punt,0,2,6,8
8227,2023-01-05,GRIFF,knockout,Out in the Open,0,6,1,7
8228,2023-01-05,GRIFF,hotZone,Split,1,44,62,107
8229,2023-01-05,GRIFF,heist,Kaboom Canyon,0,5,1,6
8230,2023-01-05,GRIFF,gemGrab,Undermine,0,5,1,6
8231,2023-01-05,GRIFF,gemGrab,Gem Fort,0,2,1,3
8232,2023-01-05,GRIFF,brawlBall,Sunny Soccer,0,0,1,1
8233,2023-01-05,GRIFF,brawlBall,Pinhole Punt,2,77,76,155
8234,2023-01-04,GRIFF,hotZone,Parallel Plays,0,9,42,51
8235,2023-01-04,GRIFF,heist,Kaboom Canyon,0,12,9,21
8236,2023-01-04,GRIFF,gemGrab,Gem Fort,0,11,23,34
8237,2023-01-04,GRIFF,gemGrab,Crystal Arcade,0,1,0,1
8238,2023-01-04,GRIFF,brawlBall,Sunny Soccer,1,69,56,126
8239,2023-01-04,GRIFF,brawlBall,Beach Ball,0,1,0,1
8240,2023-01-04,GRIFF,bounty,Shooting Star,0,1,0,1
8241,2023-01-03,GRIFF,hotZone,Parallel Plays,1,29,57,87
8242,2023-01-03,GRIFF,heist,Pit Stop,0,13,27,40
8243,2023-01-03,GRIFF,gemGrab,Minecart Madness,0,2,0,2
8244,2023-01-03,GRIFF,gemGrab,Crystal Arcade,0,30,57,87
8245,2023-01-03,GRIFF,brawlBall,Center Stage,0,1,2,3
8246,2023-01-03,GRIFF,brawlBall,Beach Ball,1,36,35,72
8247,2023-01-03,GRIFF,bounty,Hideout,0,3,0,3
8248,2023-01-02,GRIFF,knockout,Belle's Rock,0,2,0,2
8249,2023-01-02,GRIFF,hotZone,Quarter Pounder,1,37,44,82
8250,2023-01-02,GRIFF,hotZone,Controller Chaos,0,0,2,2
8251,2023-01-02,GRIFF,heist,Pit Stop,0,35,26,61
8252,2023-01-02,GRIFF,heist,Kaboom Canyon,0,1,0,1
8253,2023-01-02,GRIFF,gemGrab,Minecart Madness,0,11,4,15
8254,2023-01-02,GRIFF,gemGrab,Double Swoosh,0,14,17,31
8255,2023-01-02,GRIFF,brawlBall,Center Stage,0,39,35,74
8256,2023-01-02,GRIFF,brawlBall,Backyard Bowl,0,2,1,3
8257,2023-01-02,GRIFF,bounty,Hideout,0,2,0,2
8258,2023-01-01,GRIFF,hotZone,Quarter Pounder,0,19,14,33
8259,2023-01-01,GRIFF,hotZone,Controller Chaos,0,1,0,1
8260,2023-01-01,GRIFF,heist,Bridge Too Far,0,0,1,1
8261,2023-01-01,GRIFF,gemGrab,Double Swoosh,0,7,16,23
8262,2023-01-01,GRIFF,brawlBall,Backyard Bowl,0,17,22,39
8263,2023-01-01,GRIFF,bounty,Canal Grande,0,2,0,2
8264,2022-12-31,GRIFF,hotZone,Controller Chaos,0,0,1,1
8265,2022-12-31,GRIFF,heist,Bridge Too Far,0,2,0,2
8266,2022-12-31,GRIFF,gemGrab,Hard Rock Mine,0,1,0,1
8267,2022-12-31,GRIFF,gemGrab,Deep Diner,0,3,1,4
8268,2022-12-31,GRIFF,brawlBall,Super Beach,0,3,2,5
8269,2022-12-31,GRIFF,brawlBall,Sneaky Fields,0,0,1,1
8270,2022-12-31,GRIFF,bounty,Canal Grande,0,1,0,1
8271,2022-12-30,GRIFF,knockout,Flaring Phoenix,0,1,0,1
8272,2022-12-30,GRIFF,hotZone,Controller Chaos,0,5,1,6
8273,2022-12-30,GRIFF,heist,Hot Potato,0,1,0,1
8274,2022-12-30,GRIFF,gemGrab,Undermine,0,2,13,15
8275,2022-12-30,GRIFF,gemGrab,Deep Diner,0,5,7,12
8276,2022-12-30,GRIFF,brawlBall,Sneaky Fields,0,5,10,15
8277,2022-12-29,GRIFF,hotZone,Open Zone,0,0,1,1
8278,2022-12-29,GRIFF,heist,Kaboom Canyon,0,1,0,1
8279,2022-12-29,GRIFF,brawlBall,Pinhole Punt,0,3,1,4
8280,2022-12-27,GRIFF,hotZone,Controller Chaos,0,1,0,1
8281,2022-12-27,GRIFF,heist,Safe Zone,0,1,0,1
8282,2022-12-27,GRIFF,heist,Kaboom Canyon,0,1,1,2
8283,2022-12-27,GRIFF,gemGrab,Minecart Madness,0,0,1,1
8284,2022-12-27,GRIFF,brawlBall,Beach Ball,0,0,2,2
8285,2022-12-26,GRIFF,hotZone,Controller Chaos,0,0,2,2
8286,2022-12-26,GRIFF,heist,Kaboom Canyon,0,1,0,1
8287,2022-12-26,GRIFF,brawlBall,Center Stage,0,4,3,7
8288,2022-12-24,GRIFF,brawlBall,Super Beach,0,1,0,1
8289,2022-12-22,GRIFF,gemGrab,Gem Fort,0,1,0,1
8290,2022-12-22,GRIFF,brawlBall,Pinhole Punt,0,2,0,2
8291,2022-12-21,GRIFF,brawlBall,Sunny Soccer,0,1,0,1
8292,2022-12-20,GRIFF,brawlBall,Beach Ball,0,1,1,2
8293,2022-12-19,GRIFF,brawlBall,Center Stage,0,2,1,3
8294,2022-12-16,GRIFF,hotZone,Controller Chaos,0,0,1,1
8295,2022-12-16,GRIFF,brawlBall,Sneaky Fields,0,0,1,1
8296,2022-12-13,GRIFF,gemGrab,Crystal Arcade,0,1,0,1
8297,2022-12-11,GRIFF,gemGrab,Double Swoosh,0,0,1,1
8298,2022-12-11,GRIFF,brawlBall,Backyard Bowl,0,1,2,3
8299,2022-11-11,GRIFF,brawlBall,Sneaky Fields,0,3,5,8
8300,2022-10-30,GRIFF,hotZone,Dueling Beetles,0,1,0,1
8301,2022-10-30,GRIFF,brawlBall,Beach Ball,0,1,0,1
8302,2022-10-28,GRIFF,knockout,Out in the Open,0,1,0,1
8303,2022-10-28,GRIFF,bounty,Canal Grande,0,0,2,2
8304,2022-10-15,GRIFF,hotZone,Ring of Fire,0,1,2,3
8305,2022-10-15,GRIFF,gemGrab,Hard Rock Mine,0,0,1,1
8306,2023-01-30,GRAY,knockout,Belle's Rock,2,559,818,1379
8307,2023-01-30,GRAY,hotZone,Quarter Pounder,0,56,98,154
8308,2023-01-30,GRAY,heist,Pit Stop,0,2,1,3
8309,2023-01-30,GRAY,gemGrab,Minecart Madness,0,82,97,179
8310,2023-01-30,GRAY,gemGrab,Double Swoosh,0,47,39,86
8311,2023-01-30,GRAY,brawlBall,Center Stage,6,248,234,488
8312,2023-01-30,GRAY,brawlBall,Backyard Bowl,1,66,86,153
8313,2023-01-30,GRAY,bounty,Hideout,0,31,41,72
8314,2023-01-29,GRAY,knockout,Belle's Rock,2,661,916,1579
8315,2023-01-29,GRAY,hotZone,Quarter Pounder,1,40,99,140
8316,2023-01-29,GRAY,heist,Bridge Too Far,0,13,20,33
8317,2023-01-29,GRAY,gemGrab,Hard Rock Mine,0,24,30,54
8318,2023-01-29,GRAY,gemGrab,Double Swoosh,0,71,79,150
8319,2023-01-29,GRAY,brawlBall,Super Beach,0,9,8,17
8320,2023-01-29,GRAY,brawlBall,Backyard Bowl,28,693,949,1670
8321,2023-01-29,GRAY,bounty,Canal Grande,0,55,103,158
8322,2023-01-28,GRAY,knockout,Flaring Phoenix,4,333,475,812
8323,2023-01-28,GRAY,hotZone,Controller Chaos,0,36,34,70
8324,2023-01-28,GRAY,heist,Bridge Too Far,1,31,19,51
8325,2023-01-28,GRAY,gemGrab,Hard Rock Mine,0,92,110,202
8326,2023-01-28,GRAY,gemGrab,Deep Diner,0,35,59,94
8327,2023-01-28,GRAY,brawlBall,Super Beach,17,457,537,1011
8328,2023-01-28,GRAY,brawlBall,Sneaky Fields,0,19,19,38
8329,2023-01-28,GRAY,bounty,Canal Grande,0,70,79,149
8330,2023-01-27,GRAY,knockout,Flaring Phoenix,2,191,261,454
8331,2023-01-27,GRAY,hotZone,Controller Chaos,0,10,9,19
8332,2023-01-27,GRAY,heist,Hot Potato,0,6,2,8
8333,2023-01-27,GRAY,gemGrab,Undermine,0,3,8,11
8334,2023-01-27,GRAY,gemGrab,Deep Diner,0,52,93,145
8335,2023-01-27,GRAY,brawlBall,Sneaky Fields,1,98,98,197
8336,2023-01-27,GRAY,brawlBall,Pinhole Punt,0,5,7,12
8337,2023-01-27,GRAY,bounty,Temple Ruins,0,14,28,42
8338,2023-01-26,GRAY,knockout,Riverside,1,166,176,343
8339,2023-01-26,GRAY,hotZone,Open Zone,0,31,52,83
8340,2023-01-26,GRAY,heist,Hot Potato,0,12,10,22
8341,2023-01-26,GRAY,gemGrab,Undermine,0,27,35,62
8342,2023-01-26,GRAY,gemGrab,Gem Fort,0,29,23,52
8343,2023-01-26,GRAY,brawlBall,Sunny Soccer,0,33,38,71
8344,2023-01-26,GRAY,brawlBall,Pinhole Punt,18,412,474,904
8345,2023-01-26,GRAY,bounty,Temple Ruins,0,67,79,146
8346,2023-01-25,GRAY,knockout,Riverside,0,96,82,178
8347,2023-01-25,GRAY,hotZone,Open Zone,0,13,30,43
8348,2023-01-25,GRAY,heist,Safe Zone,0,11,7,18
8349,2023-01-25,GRAY,gemGrab,Gem Fort,0,33,66,99
8350,2023-01-25,GRAY,gemGrab,Crystal Arcade,0,41,80,121
8351,2023-01-25,GRAY,brawlBall,Sunny Soccer,4,275,279,558
8352,2023-01-25,GRAY,brawlBall,Beach Ball,3,62,61,126
8353,2023-01-25,GRAY,bounty,Excel,0,44,33,77
8354,2023-01-24,GRAY,knockout,New Perspective,2,301,400,703
8355,2023-01-24,GRAY,hotZone,Dueling Beetles,0,35,39,74
8356,2023-01-24,GRAY,heist,Safe Zone,0,26,34,60
8357,2023-01-24,GRAY,gemGrab,Minecart Madness,0,37,65,102
8358,2023-01-24,GRAY,gemGrab,Crystal Arcade,0,80,117,197
8359,2023-01-24,GRAY,brawlBall,Center Stage,1,43,21,65
8360,2023-01-24,GRAY,brawlBall,Beach Ball,11,524,603,1138
8361,2023-01-24,GRAY,bounty,Excel,0,116,138,254
8362,2023-01-23,GRAY,knockout,New Perspective,2,829,1092,1923
8363,2023-01-23,GRAY,hotZone,Dueling Beetles,0,75,73,148
8364,2023-01-23,GRAY,heist,Snaked Assault,0,13,14,27
8365,2023-01-23,GRAY,gemGrab,Minecart Madness,0,153,240,393
8366,2023-01-23,GRAY,gemGrab,Double Swoosh,0,29,41,70
8367,2023-01-23,GRAY,brawlBall,Center Stage,12,460,534,1006
8368,2023-01-23,GRAY,brawlBall,Backyard Bowl,0,28,22,50
8369,2023-01-23,GRAY,bounty,Layer Cake,0,134,195,329
8370,2023-01-22,GRAY,knockout,X Marks the Spot,3,368,432,803
8371,2023-01-22,GRAY,hotZone,Ring of Fire,0,3,5,8
8372,2023-01-22,GRAY,heist,Snaked Assault,0,7,6,13
8373,2023-01-22,GRAY,gemGrab,Hard Rock Mine,0,29,29,58
8374,2023-01-22,GRAY,gemGrab,Double Swoosh,0,44,44,88
8375,2023-01-22,GRAY,brawlBall,Super Beach,0,39,65,104
8376,2023-01-22,GRAY,brawlBall,Backyard Bowl,12,318,439,769
8377,2023-01-22,GRAY,bounty,Layer Cake,0,68,77,145
8378,2023-01-21,GRAY,knockout,X Marks the Spot,3,1274,1670,2947
8379,2023-01-21,GRAY,hotZone,Ring of Fire,0,47,78,125
8380,2023-01-21,GRAY,heist,Tornado Ring,0,17,6,23
8381,2023-01-21,GRAY,gemGrab,Hard Rock Mine,0,79,100,179
8382,2023-01-21,GRAY,gemGrab,Deep Diner,0,34,54,88
8383,2023-01-21,GRAY,brawlBall,Super Beach,19,653,854,1526
8384,2023-01-21,GRAY,brawlBall,Sneaky Fields,0,15,21,36
8385,2023-01-21,GRAY,bounty,Dry Season,0,156,165,321
8386,2023-01-20,GRAY,knockout,Out in the Open,8,558,844,1410
8387,2023-01-20,GRAY,hotZone,Split,0,61,81,142
8388,2023-01-20,GRAY,heist,Tornado Ring,0,19,8,27
8389,2023-01-20,GRAY,gemGrab,Undermine,0,28,21,49
8390,2023-01-20,GRAY,gemGrab,Deep Diner,0,140,187,327
8391,2023-01-20,GRAY,brawlBall,Sneaky Fields,5,264,270,539
8392,2023-01-20,GRAY,brawlBall,Pinhole Punt,1,10,12,23
8393,2023-01-20,GRAY,bounty,Dry Season,0,119,161,280
8394,2023-01-19,GRAY,knockout,Out in the Open,13,1052,1525,2590
8395,2023-01-19,GRAY,hotZone,Split,0,68,57,125
8396,2023-01-19,GRAY,heist,Kaboom Canyon,1,18,23,42
8397,2023-01-19,GRAY,gemGrab,Undermine,0,53,78,131
8398,2023-01-19,GRAY,gemGrab,Gem Fort,0,9,8,17
8399,2023-01-19,GRAY,brawlBall,Sunny Soccer,0,17,23,40
8400,2023-01-19,GRAY,brawlBall,Pinhole Punt,21,417,474,912
8401,2023-01-19,GRAY,bounty,Shooting Star,0,89,120,209
8402,2023-01-18,GRAY,knockout,Goldarm Gulch,3,109,123,235
8403,2023-01-18,GRAY,hotZone,Parallel Plays,0,9,7,16
8404,2023-01-18,GRAY,heist,Kaboom Canyon,0,8,8,16
8405,2023-01-18,GRAY,gemGrab,Gem Fort,0,20,19,39
8406,2023-01-18,GRAY,gemGrab,Crystal Arcade,0,2,3,5
8407,2023-01-18,GRAY,brawlBall,Sunny Soccer,8,163,177,348
8408,2023-01-18,GRAY,brawlBall,Beach Ball,1,8,10,19
8409,2023-01-18,GRAY,bounty,Shooting Star,0,57,36,93
8410,2023-01-17,GRAY,knockout,Goldarm Gulch,0,83,132,215
8411,2023-01-17,GRAY,hotZone,Parallel Plays,0,4,8,12
8412,2023-01-17,GRAY,gemGrab,Minecart Madness,0,2,4,6
8413,2023-01-17,GRAY,gemGrab,Crystal Arcade,0,7,5,12
8414,2023-01-17,GRAY,brawlBall,Center Stage,0,1,0,1
8415,2023-01-17,GRAY,brawlBall,Beach Ball,1,30,62,93
8416,2023-01-17,GRAY,bounty,Hideout,0,4,8,12
8417,2023-01-16,GRAY,knockout,Belle's Rock,0,44,70,114
8418,2023-01-16,GRAY,hotZone,Quarter Pounder,0,7,3,10
8419,2023-01-16,GRAY,heist,Pit Stop,0,2,0,2
8420,2023-01-16,GRAY,gemGrab,Minecart Madness,0,17,28,45
8421,2023-01-16,GRAY,gemGrab,Double Swoosh,0,1,1,2
8422,2023-01-16,GRAY,brawlBall,Center Stage,0,28,34,62
8423,2023-01-16,GRAY,brawlBall,Backyard Bowl,0,4,1,5
8424,2023-01-16,GRAY,bounty,Hideout,0,11,11,22
8425,2023-01-15,GRAY,knockout,Belle's Rock,0,83,95,178
8426,2023-01-15,GRAY,hotZone,Quarter Pounder,0,21,82,103
8427,2023-01-15,GRAY,heist,Bridge Too Far,0,3,0,3
8428,2023-01-15,GRAY,gemGrab,Hard Rock Mine,0,2,4,6
8429,2023-01-15,GRAY,gemGrab,Double Swoosh,0,8,7,15
8430,2023-01-15,GRAY,brawlBall,Super Beach,0,3,1,4
8431,2023-01-15,GRAY,brawlBall,Backyard Bowl,1,49,50,100
8432,2023-01-15,GRAY,bounty,Canal Grande,0,6,3,9
8433,2023-01-14,GRAY,knockout,Flaring Phoenix,1,43,60,104
8434,2023-01-14,GRAY,hotZone,Controller Chaos,0,9,0,9
8435,2023-01-14,GRAY,heist,Bridge Too Far,0,3,0,3
8436,2023-01-14,GRAY,gemGrab,Hard Rock Mine,0,3,1,4
8437,2023-01-14,GRAY,gemGrab,Deep Diner,0,8,6,14
8438,2023-01-14,GRAY,brawlBall,Super Beach,0,26,27,53
8439,2023-01-14,GRAY,bounty,Canal Grande,0,4,3,7
8440,2023-01-13,GRAY,knockout,Flaring Phoenix,0,33,38,71
8441,2023-01-13,GRAY,hotZone,Controller Chaos,0,3,3,6
8442,2023-01-13,GRAY,gemGrab,Deep Diner,0,7,23,30
8443,2023-01-13,GRAY,brawlBall,Sneaky Fields,1,12,42,55
8444,2023-01-13,GRAY,brawlBall,Pinhole Punt,0,0,1,1
8445,2023-01-13,GRAY,bounty,Temple Ruins,0,1,1,2
8446,2023-01-12,GRAY,knockout,Riverside,0,24,16,40
8447,2023-01-12,GRAY,hotZone,Open Zone,0,8,13,21
8448,2023-01-12,GRAY,heist,Hot Potato,0,1,0,1
8449,2023-01-12,GRAY,gemGrab,Undermine,0,7,17,24
8450,2023-01-12,GRAY,gemGrab,Gem Fort,0,2,8,10
8451,2023-01-12,GRAY,brawlBall,Sunny Soccer,0,5,6,11
8452,2023-01-12,GRAY,brawlBall,Pinhole Punt,0,14,14,28
8453,2023-01-11,GRAY,knockout,Riverside,0,7,8,15
8454,2023-01-11,GRAY,hotZone,Open Zone,0,2,0,2
8455,2023-01-11,GRAY,heist,Safe Zone,0,0,3,3
8456,2023-01-11,GRAY,gemGrab,Gem Fort,0,0,2,2
8457,2023-01-11,GRAY,brawlBall,Sunny Soccer,0,15,27,42
8458,2023-01-11,GRAY,bounty,Excel,0,2,0,2
8459,2023-01-10,GRAY,knockout,New Perspective,0,25,38,63
8460,2023-01-10,GRAY,hotZone,Dueling Beetles,0,12,30,42
8461,2023-01-10,GRAY,gemGrab,Minecart Madness,0,1,4,5
8462,2023-01-10,GRAY,gemGrab,Crystal Arcade,0,13,30,43
8463,2023-01-10,GRAY,brawlBall,Center Stage,0,4,0,4
8464,2023-01-10,GRAY,brawlBall,Beach Ball,1,48,54,103
8465,2023-01-10,GRAY,bounty,Excel,0,6,3,9
8466,2023-01-09,GRAY,knockout,New Perspective,0,51,60,111
8467,2023-01-09,GRAY,hotZone,Dueling Beetles,0,10,17,27
8468,2023-01-09,GRAY,gemGrab,Minecart Madness,0,21,37,58
8469,2023-01-09,GRAY,gemGrab,Double Swoosh,0,10,32,42
8470,2023-01-09,GRAY,brawlBall,Center Stage,1,40,28,69
8471,2023-01-09,GRAY,brawlBall,Backyard Bowl,2,11,35,48
8472,2023-01-09,GRAY,bounty,Layer Cake,0,12,12,24
8473,2023-01-08,GRAY,knockout,X Marks the Spot,0,61,100,161
8474,2023-01-08,GRAY,hotZone,Ring of Fire,0,3,0,3
8475,2023-01-08,GRAY,heist,Snaked Assault,0,1,12,13
8476,2023-01-08,GRAY,gemGrab,Hard Rock Mine,0,2,0,2
8477,2023-01-08,GRAY,gemGrab,Double Swoosh,0,9,14,23
8478,2023-01-08,GRAY,brawlBall,Super Beach,0,5,2,7
8479,2023-01-08,GRAY,brawlBall,Backyard Bowl,0,58,67,125
8480,2023-01-08,GRAY,bounty,Layer Cake,0,4,2,6
8481,2023-01-07,GRAY,knockout,X Marks the Spot,0,47,89,136
8482,2023-01-07,GRAY,hotZone,Ring of Fire,0,0,3,3
8483,2023-01-07,GRAY,heist,Tornado Ring,0,1,0,1
8484,2023-01-07,GRAY,gemGrab,Hard Rock Mine,0,7,35,42
8485,2023-01-07,GRAY,gemGrab,Deep Diner,0,10,21,31
8486,2023-01-07,GRAY,brawlBall,Super Beach,0,38,38,76
8487,2023-01-07,GRAY,brawlBall,Sneaky Fields,0,0,1,1
8488,2023-01-07,GRAY,bounty,Dry Season,0,10,4,14
8489,2023-01-06,GRAY,knockout,Out in the Open,0,86,137,223
8490,2023-01-06,GRAY,hotZone,Split,0,10,23,33
8491,2023-01-06,GRAY,heist,Tornado Ring,1,1,0,2
8492,2023-01-06,GRAY,gemGrab,Undermine,0,9,4,13
8493,2023-01-06,GRAY,gemGrab,Deep Diner,0,13,23,36
8494,2023-01-06,GRAY,brawlBall,Sneaky Fields,1,26,22,49
8495,2023-01-06,GRAY,brawlBall,Pinhole Punt,0,12,9,21
8496,2023-01-06,GRAY,bounty,Dry Season,0,14,6,20
8497,2023-01-05,GRAY,knockout,Out in the Open,2,126,201,329
8498,2023-01-05,GRAY,hotZone,Split,0,46,78,124
8499,2023-01-05,GRAY,heist,Kaboom Canyon,0,2,0,2
8500,2023-01-05,GRAY,gemGrab,Undermine,0,12,28,40
8501,2023-01-05,GRAY,gemGrab,Gem Fort,0,3,0,3
8502,2023-01-05,GRAY,brawlBall,Sunny Soccer,0,0,2,2
8503,2023-01-05,GRAY,brawlBall,Pinhole Punt,4,84,132,220
8504,2023-01-05,GRAY,bounty,Shooting Star,0,9,9,18
8505,2023-01-04,GRAY,knockout,Goldarm Gulch,0,24,14,38
8506,2023-01-04,GRAY,hotZone,Parallel Plays,0,2,3,5
8507,2023-01-04,GRAY,heist,Kaboom Canyon,0,1,5,6
8508,2023-01-04,GRAY,gemGrab,Gem Fort,0,9,33,42
8509,2023-01-04,GRAY,gemGrab,Crystal Arcade,0,8,9,17
8510,2023-01-04,GRAY,brawlBall,Sunny Soccer,1,95,161,257
8511,2023-01-04,GRAY,bounty,Shooting Star,0,5,8,13
8512,2023-01-03,GRAY,knockout,Goldarm Gulch,0,15,28,43
8513,2023-01-03,GRAY,hotZone,Parallel Plays,0,4,0,4
8514,2023-01-03,GRAY,gemGrab,Minecart Madness,0,3,2,5
8515,2023-01-03,GRAY,gemGrab,Crystal Arcade,0,15,81,96
8516,2023-01-03,GRAY,brawlBall,Center Stage,0,7,9,16
8517,2023-01-03,GRAY,brawlBall,Beach Ball,1,71,124,196
8518,2023-01-03,GRAY,bounty,Hideout,0,16,14,30
8519,2023-01-02,GRAY,knockout,Belle's Rock,0,44,49,93
8520,2023-01-02,GRAY,hotZone,Quarter Pounder,0,16,9,25
8521,2023-01-02,GRAY,heist,Pit Stop,0,1,0,1
8522,2023-01-02,GRAY,gemGrab,Minecart Madness,0,13,13,26
8523,2023-01-02,GRAY,gemGrab,Double Swoosh,0,15,22,37
8524,2023-01-02,GRAY,brawlBall,Center Stage,2,90,165,257
8525,2023-01-02,GRAY,brawlBall,Backyard Bowl,2,17,31,50
8526,2023-01-02,GRAY,bounty,Hideout,0,33,91,124
8527,2023-01-01,GRAY,knockout,Belle's Rock,0,16,24,40
8528,2023-01-01,GRAY,hotZone,Quarter Pounder,0,30,41,71
8529,2023-01-01,GRAY,heist,Bridge Too Far,0,0,1,1
8530,2023-01-01,GRAY,gemGrab,Double Swoosh,0,9,12,21
8531,2023-01-01,GRAY,brawlBall,Backyard Bowl,2,39,88,129
8532,2023-01-01,GRAY,bounty,Canal Grande,0,1,0,1
8533,2022-12-31,GRAY,knockout,Flaring Phoenix,0,1,1,2
8534,2022-12-31,GRAY,heist,Kaboom Canyon,0,1,1,2
8535,2022-12-31,GRAY,heist,Bridge Too Far,0,1,0,1
8536,2022-12-31,GRAY,gemGrab,Hard Rock Mine,0,9,15,24
8537,2022-12-31,GRAY,gemGrab,Deep Diner,0,3,4,7
8538,2022-12-31,GRAY,brawlBall,Super Beach,0,5,5,10
8539,2022-12-31,GRAY,brawlBall,Sneaky Fields,0,1,0,1
8540,2022-12-31,GRAY,bounty,Canal Grande,0,0,2,2
8541,2022-12-30,GRAY,knockout,Flaring Phoenix,0,4,8,12
8542,2022-12-30,GRAY,hotZone,Controller Chaos,0,2,1,3
8543,2022-12-30,GRAY,heist,Hot Potato,0,1,0,1
8544,2022-12-30,GRAY,gemGrab,Undermine,0,1,0,1
8545,2022-12-30,GRAY,gemGrab,Minecart Madness,0,1,0,1
8546,2022-12-30,GRAY,gemGrab,Deep Diner,0,7,14,21
8547,2022-12-30,GRAY,brawlBall,Sneaky Fields,2,15,26,43
8548,2022-12-29,GRAY,hotZone,Open Zone,0,1,0,1
8549,2022-12-29,GRAY,heist,Kaboom Canyon,0,0,1,1
8550,2022-12-29,GRAY,gemGrab,Undermine,0,2,8,10
8551,2022-12-29,GRAY,gemGrab,Minecart Madness,0,0,1,1
8552,2022-12-29,GRAY,brawlBall,Pinhole Punt,0,6,7,13
8553,2022-12-28,GRAY,hotZone,Open Zone,0,2,2,4
8554,2022-12-27,GRAY,knockout,New Perspective,0,3,0,3
8555,2022-12-27,GRAY,hotZone,Dueling Beetles,0,0,1,1
8556,2022-12-27,GRAY,hotZone,Controller Chaos,0,1,0,1
8557,2022-12-27,GRAY,gemGrab,Minecart Madness,0,0,2,2
8558,2022-12-27,GRAY,brawlBall,Beach Ball,0,3,10,13
8559,2022-12-27,GRAY,bounty,Excel,0,0,1,1
8560,2022-12-26,GRAY,hotZone,Controller Chaos,0,3,2,5
8561,2022-12-26,GRAY,heist,Kaboom Canyon,0,0,1,1
8562,2022-12-26,GRAY,gemGrab,Minecart Madness,0,1,2,3
8563,2022-12-26,GRAY,brawlBall,Center Stage,0,0,1,1
8564,2022-12-25,GRAY,hotZone,Ring of Fire,0,1,1,2
8565,2022-12-23,GRAY,knockout,Out in the Open,0,0,1,1
8566,2022-12-22,GRAY,brawlBall,Pinhole Punt,0,1,2,3
8567,2022-12-20,GRAY,brawlBall,Beach Ball,1,3,1,5
8568,2022-12-18,GRAY,knockout,Belle's Rock,0,0,1,1
8569,2022-12-17,GRAY,knockout,Flaring Phoenix,0,1,0,1
8570,2022-12-13,GRAY,knockout,New Perspective,0,2,0,2
8571,2022-12-13,GRAY,brawlBall,Beach Ball,0,2,5,7
8572,2023-01-30,GENE,knockout,Belle's Rock,0,216,238,454
8573,2023-01-30,GENE,hotZone,Quarter Pounder,0,15,3,18
8574,2023-01-30,GENE,heist,Pit Stop,0,1,0,1
8575,2023-01-30,GENE,gemGrab,Minecart Madness,0,158,143,301
8576,2023-01-30,GENE,gemGrab,Double Swoosh,0,269,359,628
8577,2023-01-30,GENE,brawlBall,Center Stage,4,90,59,153
8578,2023-01-30,GENE,brawlBall,Backyard Bowl,4,29,34,67
8579,2023-01-30,GENE,bounty,Hideout,0,76,85,161
8580,2023-01-29,GENE,knockout,Belle's Rock,0,275,305,580
8581,2023-01-29,GENE,hotZone,Quarter Pounder,0,10,10,20
8582,2023-01-29,GENE,heist,Bridge Too Far,0,9,1,10
8583,2023-01-29,GENE,gemGrab,Hard Rock Mine,0,58,68,126
8584,2023-01-29,GENE,gemGrab,Double Swoosh,0,506,534,1040
8585,2023-01-29,GENE,brawlBall,Backyard Bowl,20,371,395,786
8586,2023-01-29,GENE,bounty,Canal Grande,0,57,40,97
8587,2023-01-28,GENE,knockout,Flaring Phoenix,0,123,108,231
8588,2023-01-28,GENE,hotZone,Controller Chaos,0,10,5,15
8589,2023-01-28,GENE,heist,Bridge Too Far,0,9,4,13
8590,2023-01-28,GENE,gemGrab,Hard Rock Mine,0,388,374,762
8591,2023-01-28,GENE,gemGrab,Deep Diner,0,93,126,219
8592,2023-01-28,GENE,brawlBall,Super Beach,5,130,86,221
8593,2023-01-28,GENE,brawlBall,Sneaky Fields,0,7,7,14
8594,2023-01-28,GENE,bounty,Canal Grande,0,138,161,299
8595,2023-01-27,GENE,knockout,Flaring Phoenix,2,43,58,103
8596,2023-01-27,GENE,hotZone,Controller Chaos,0,3,5,8
8597,2023-01-27,GENE,heist,Hot Potato,0,1,0,1
8598,2023-01-27,GENE,gemGrab,Undermine,0,16,20,36
8599,2023-01-27,GENE,gemGrab,Deep Diner,0,123,133,256
8600,2023-01-27,GENE,brawlBall,Sneaky Fields,0,39,23,62
8601,2023-01-27,GENE,brawlBall,Pinhole Punt,0,1,1,2
8602,2023-01-27,GENE,bounty,Temple Ruins,0,30,72,102
8603,2023-01-26,GENE,knockout,Riverside,0,215,240,455
8604,2023-01-26,GENE,hotZone,Open Zone,0,29,3,32
8605,2023-01-26,GENE,heist,Hot Potato,0,1,2,3
8606,2023-01-26,GENE,gemGrab,Undermine,0,207,185,392
8607,2023-01-26,GENE,gemGrab,Gem Fort,0,74,87,161
8608,2023-01-26,GENE,brawlBall,Sunny Soccer,0,5,3,8
8609,2023-01-26,GENE,brawlBall,Pinhole Punt,7,246,217,470
8610,2023-01-26,GENE,bounty,Temple Ruins,0,100,152,252
8611,2023-01-25,GENE,knockout,Riverside,0,114,97,211
8612,2023-01-25,GENE,hotZone,Open Zone,0,12,6,18
8613,2023-01-25,GENE,heist,Safe Zone,0,4,2,6
8614,2023-01-25,GENE,gemGrab,Gem Fort,0,91,76,167
8615,2023-01-25,GENE,gemGrab,Crystal Arcade,0,140,136,276
8616,2023-01-25,GENE,brawlBall,Sunny Soccer,2,90,73,165
8617,2023-01-25,GENE,brawlBall,Beach Ball,1,18,13,32
8618,2023-01-25,GENE,bounty,Excel,0,68,91,159
8619,2023-01-24,GENE,knockout,New Perspective,0,112,93,205
8620,2023-01-24,GENE,hotZone,Dueling Beetles,0,5,8,13
8621,2023-01-24,GENE,heist,Safe Zone,0,7,3,10
8622,2023-01-24,GENE,gemGrab,Minecart Madness,0,57,66,123
8623,2023-01-24,GENE,gemGrab,Crystal Arcade,0,360,279,639
8624,2023-01-24,GENE,brawlBall,Center Stage,1,6,8,15
8625,2023-01-24,GENE,brawlBall,Beach Ball,5,158,153,316
8626,2023-01-24,GENE,bounty,Excel,0,160,244,404
8627,2023-01-23,GENE,knockout,New Perspective,0,164,179,343
8628,2023-01-23,GENE,hotZone,Dueling Beetles,0,9,1,10
8629,2023-01-23,GENE,heist,Snaked Assault,0,18,10,28
8630,2023-01-23,GENE,gemGrab,Minecart Madness,0,338,369,707
8631,2023-01-23,GENE,gemGrab,Double Swoosh,0,190,161,351
8632,2023-01-23,GENE,brawlBall,Center Stage,5,157,152,314
8633,2023-01-23,GENE,brawlBall,Backyard Bowl,2,30,32,64
8634,2023-01-23,GENE,bounty,Layer Cake,0,146,228,374
8635,2023-01-22,GENE,knockout,X Marks the Spot,0,152,178,330
8636,2023-01-22,GENE,hotZone,Ring of Fire,0,8,1,9
8637,2023-01-22,GENE,gemGrab,Hard Rock Mine,0,92,87,179
8638,2023-01-22,GENE,gemGrab,Double Swoosh,0,299,313,612
8639,2023-01-22,GENE,brawlBall,Super Beach,1,12,12,25
8640,2023-01-22,GENE,brawlBall,Backyard Bowl,5,173,174,352
8641,2023-01-22,GENE,bounty,Layer Cake,0,119,150,269
8642,2023-01-21,GENE,knockout,X Marks the Spot,2,451,562,1015
8643,2023-01-21,GENE,hotZone,Ring of Fire,0,20,3,23
8644,2023-01-21,GENE,heist,Tornado Ring,0,5,0,5
8645,2023-01-21,GENE,gemGrab,Hard Rock Mine,0,583,560,1143
8646,2023-01-21,GENE,gemGrab,Deep Diner,0,57,82,139
8647,2023-01-21,GENE,brawlBall,Super Beach,8,166,126,300
8648,2023-01-21,GENE,brawlBall,Sneaky Fields,0,12,4,16
8649,2023-01-21,GENE,bounty,Dry Season,0,239,362,601
8650,2023-01-20,GENE,knockout,Out in the Open,2,331,380,713
8651,2023-01-20,GENE,hotZone,Split,0,9,1,10
8652,2023-01-20,GENE,heist,Tornado Ring,0,1,0,1
8653,2023-01-20,GENE,gemGrab,Undermine,0,109,130,239
8654,2023-01-20,GENE,gemGrab,Deep Diner,0,362,338,700
8655,2023-01-20,GENE,brawlBall,Sneaky Fields,6,101,103,210
8656,2023-01-20,GENE,brawlBall,Pinhole Punt,0,5,7,12
8657,2023-01-20,GENE,bounty,Dry Season,0,261,316,577
8658,2023-01-19,GENE,knockout,Out in the Open,1,408,355,764
8659,2023-01-19,GENE,hotZone,Split,0,5,6,11
8660,2023-01-19,GENE,heist,Kaboom Canyon,0,6,2,8
8661,2023-01-19,GENE,gemGrab,Undermine,0,259,248,507
8662,2023-01-19,GENE,gemGrab,Gem Fort,0,39,33,72
8663,2023-01-19,GENE,brawlBall,Sunny Soccer,0,3,2,5
8664,2023-01-19,GENE,brawlBall,Pinhole Punt,14,206,189,409
8665,2023-01-19,GENE,bounty,Shooting Star,0,132,184,316
8666,2023-01-18,GENE,knockout,Goldarm Gulch,0,31,40,71
8667,2023-01-18,GENE,hotZone,Parallel Plays,0,2,2,4
8668,2023-01-18,GENE,heist,Kaboom Canyon,0,2,0,2
8669,2023-01-18,GENE,gemGrab,Gem Fort,0,51,47,98
8670,2023-01-18,GENE,gemGrab,Crystal Arcade,0,20,39,59
8671,2023-01-18,GENE,brawlBall,Sunny Soccer,1,30,57,88
8672,2023-01-18,GENE,brawlBall,Beach Ball,0,2,1,3
8673,2023-01-18,GENE,bounty,Shooting Star,0,65,87,152
8674,2023-01-17,GENE,knockout,Goldarm Gulch,0,34,31,65
8675,2023-01-17,GENE,hotZone,Parallel Plays,0,0,3,3
8676,2023-01-17,GENE,heist,Pit Stop,0,0,1,1
8677,2023-01-17,GENE,gemGrab,Minecart Madness,0,4,2,6
8678,2023-01-17,GENE,gemGrab,Crystal Arcade,0,24,31,55
8679,2023-01-17,GENE,brawlBall,Beach Ball,0,20,15,35
8680,2023-01-17,GENE,bounty,Hideout,0,14,9,23
8681,2023-01-16,GENE,knockout,Belle's Rock,0,19,20,39
8682,2023-01-16,GENE,gemGrab,Minecart Madness,0,25,24,49
8683,2023-01-16,GENE,gemGrab,Double Swoosh,0,24,55,79
8684,2023-01-16,GENE,brawlBall,Center Stage,0,7,8,15
8685,2023-01-16,GENE,brawlBall,Backyard Bowl,0,2,2,4
8686,2023-01-16,GENE,bounty,Hideout,0,13,17,30
8687,2023-01-15,GENE,knockout,Belle's Rock,0,42,33,75
8688,2023-01-15,GENE,hotZone,Quarter Pounder,0,3,0,3
8689,2023-01-15,GENE,heist,Bridge Too Far,0,1,0,1
8690,2023-01-15,GENE,gemGrab,Hard Rock Mine,0,30,29,59
8691,2023-01-15,GENE,gemGrab,Double Swoosh,0,89,71,160
8692,2023-01-15,GENE,brawlBall,Backyard Bowl,4,54,36,94
8693,2023-01-15,GENE,bounty,Canal Grande,0,13,10,23
8694,2023-01-14,GENE,knockout,Flaring Phoenix,0,11,22,33
8695,2023-01-14,GENE,hotZone,Controller Chaos,0,3,0,3
8696,2023-01-14,GENE,heist,Bridge Too Far,0,2,1,3
8697,2023-01-14,GENE,gemGrab,Hard Rock Mine,0,26,11,37
8698,2023-01-14,GENE,gemGrab,Deep Diner,0,25,32,57
8699,2023-01-14,GENE,brawlBall,Super Beach,0,11,4,15
8700,2023-01-14,GENE,brawlBall,Sneaky Fields,0,1,12,13
8701,2023-01-14,GENE,bounty,Canal Grande,0,8,4,12
8702,2023-01-13,GENE,knockout,Flaring Phoenix,0,19,11,30
8703,2023-01-13,GENE,gemGrab,Deep Diner,0,26,57,83
8704,2023-01-13,GENE,brawlBall,Sneaky Fields,2,8,19,29
8705,2023-01-13,GENE,brawlBall,Pinhole Punt,0,0,1,1
8706,2023-01-13,GENE,bounty,Temple Ruins,0,8,0,8
8707,2023-01-12,GENE,knockout,Riverside,0,17,7,24
8708,2023-01-12,GENE,hotZone,Open Zone,0,9,11,20
8709,2023-01-12,GENE,gemGrab,Undermine,0,21,19,40
8710,2023-01-12,GENE,gemGrab,Gem Fort,0,3,2,5
8711,2023-01-12,GENE,brawlBall,Pinhole Punt,0,7,3,10
8712,2023-01-11,GENE,knockout,Riverside,0,2,2,4
8713,2023-01-11,GENE,gemGrab,Gem Fort,0,14,22,36
8714,2023-01-11,GENE,brawlBall,Sunny Soccer,0,3,1,4
8715,2023-01-11,GENE,bounty,Excel,0,6,15,21
8716,2023-01-10,GENE,knockout,New Perspective,0,3,2,5
8717,2023-01-10,GENE,hotZone,Dueling Beetles,0,1,0,1
8718,2023-01-10,GENE,gemGrab,Minecart Madness,0,23,1,24
8719,2023-01-10,GENE,gemGrab,Crystal Arcade,0,18,14,32
8720,2023-01-10,GENE,brawlBall,Beach Ball,0,9,12,21
8721,2023-01-10,GENE,bounty,Excel,0,6,12,18
8722,2023-01-09,GENE,knockout,New Perspective,0,2,16,18
8723,2023-01-09,GENE,hotZone,Dueling Beetles,0,1,0,1
8724,2023-01-09,GENE,gemGrab,Minecart Madness,1,34,22,57
8725,2023-01-09,GENE,gemGrab,Double Swoosh,0,30,28,58
8726,2023-01-09,GENE,brawlBall,Center Stage,1,6,6,13
8727,2023-01-09,GENE,brawlBall,Backyard Bowl,1,0,1,2
8728,2023-01-09,GENE,bounty,Layer Cake,0,23,62,85
8729,2023-01-08,GENE,knockout,X Marks the Spot,0,25,41,66
8730,2023-01-08,GENE,hotZone,Ring of Fire,0,0,1,1
8731,2023-01-08,GENE,heist,Snaked Assault,0,1,0,1
8732,2023-01-08,GENE,gemGrab,Hard Rock Mine,0,18,12,30
8733,2023-01-08,GENE,gemGrab,Double Swoosh,0,29,31,60
8734,2023-01-08,GENE,brawlBall,Super Beach,0,2,0,2
8735,2023-01-08,GENE,brawlBall,Backyard Bowl,0,27,29,56
8736,2023-01-08,GENE,bounty,Layer Cake,0,29,53,82
8737,2023-01-07,GENE,knockout,X Marks the Spot,0,25,26,51
8738,2023-01-07,GENE,heist,Tornado Ring,0,1,0,1
8739,2023-01-07,GENE,gemGrab,Hard Rock Mine,0,38,28,66
8740,2023-01-07,GENE,gemGrab,Deep Diner,0,28,19,47
8741,2023-01-07,GENE,brawlBall,Super Beach,0,7,1,8
8742,2023-01-07,GENE,brawlBall,Sneaky Fields,0,1,0,1
8743,2023-01-07,GENE,bounty,Dry Season,0,44,60,104
8744,2023-01-06,GENE,knockout,Out in the Open,0,17,9,26
8745,2023-01-06,GENE,hotZone,Split,0,2,0,2
8746,2023-01-06,GENE,heist,Tornado Ring,0,2,0,2
8747,2023-01-06,GENE,gemGrab,Undermine,0,10,8,18
8748,2023-01-06,GENE,gemGrab,Deep Diner,0,51,35,86
8749,2023-01-06,GENE,brawlBall,Sneaky Fields,0,3,1,4
8750,2023-01-06,GENE,brawlBall,Pinhole Punt,0,0,2,2
8751,2023-01-06,GENE,bounty,Dry Season,0,77,106,183
8752,2023-01-05,GENE,knockout,Out in the Open,0,67,50,117
8753,2023-01-05,GENE,heist,Kaboom Canyon,0,1,0,1
8754,2023-01-05,GENE,gemGrab,Undermine,0,30,25,55
8755,2023-01-05,GENE,gemGrab,Gem Fort,0,4,1,5
8756,2023-01-05,GENE,brawlBall,Pinhole Punt,2,18,20,40
8757,2023-01-05,GENE,bounty,Shooting Star,0,24,13,37
8758,2023-01-04,GENE,knockout,Goldarm Gulch,0,18,32,50
8759,2023-01-04,GENE,hotZone,Parallel Plays,0,1,0,1
8760,2023-01-04,GENE,heist,Kaboom Canyon,0,1,0,1
8761,2023-01-04,GENE,gemGrab,Gem Fort,0,34,31,65
8762,2023-01-04,GENE,gemGrab,Crystal Arcade,0,12,3,15
8763,2023-01-04,GENE,brawlBall,Sunny Soccer,1,7,7,15
8764,2023-01-04,GENE,bounty,Shooting Star,0,57,30,87
8765,2023-01-03,GENE,knockout,Goldarm Gulch,0,6,11,17
8766,2023-01-03,GENE,hotZone,Parallel Plays,0,2,0,2
8767,2023-01-03,GENE,heist,Pit Stop,0,1,0,1
8768,2023-01-03,GENE,gemGrab,Minecart Madness,0,12,26,38
8769,2023-01-03,GENE,gemGrab,Crystal Arcade,0,72,88,160
8770,2023-01-03,GENE,brawlBall,Beach Ball,1,7,2,10
8771,2023-01-03,GENE,bounty,Hideout,0,23,24,47
8772,2023-01-02,GENE,knockout,Belle's Rock,0,35,28,63
8773,2023-01-02,GENE,hotZone,Quarter Pounder,0,4,5,9
8774,2023-01-02,GENE,heist,Pit Stop,0,1,0,1
8775,2023-01-02,GENE,gemGrab,Minecart Madness,0,48,27,75
8776,2023-01-02,GENE,gemGrab,Double Swoosh,0,69,83,152
8777,2023-01-02,GENE,brawlBall,Center Stage,0,23,5,28
8778,2023-01-02,GENE,brawlBall,Backyard Bowl,0,1,0,1
8779,2023-01-02,GENE,bounty,Hideout,0,69,48,117
8780,2023-01-01,GENE,knockout,Belle's Rock,0,30,16,46
8781,2023-01-01,GENE,hotZone,Quarter Pounder,0,4,14,18
8782,2023-01-01,GENE,hotZone,Controller Chaos,0,0,1,1
8783,2023-01-01,GENE,gemGrab,Hard Rock Mine,0,0,1,1
8784,2023-01-01,GENE,gemGrab,Double Swoosh,0,57,29,86
8785,2023-01-01,GENE,brawlBall,Backyard Bowl,1,10,20,31
8786,2023-01-01,GENE,bounty,Canal Grande,0,2,3,5
8787,2022-12-31,GENE,gemGrab,Hard Rock Mine,0,8,9,17
8788,2022-12-31,GENE,gemGrab,Deep Diner,0,11,4,15
8789,2022-12-31,GENE,brawlBall,Super Beach,0,2,0,2
8790,2022-12-31,GENE,bounty,Canal Grande,0,1,2,3
8791,2022-12-30,GENE,knockout,Flaring Phoenix,0,2,1,3
8792,2022-12-30,GENE,hotZone,Controller Chaos,0,0,1,1
8793,2022-12-30,GENE,gemGrab,Undermine,0,1,1,2
8794,2022-12-30,GENE,gemGrab,Deep Diner,0,7,8,15
8795,2022-12-29,GENE,gemGrab,Undermine,0,7,7,14
8796,2022-12-29,GENE,brawlBall,Pinhole Punt,0,1,0,1
8797,2022-12-27,GENE,gemGrab,Minecart Madness,0,0,2,2
8798,2022-12-26,GENE,gemGrab,Minecart Madness,0,0,2,2
8799,2022-12-25,GENE,gemGrab,Double Swoosh,0,1,0,1
8800,2022-12-23,GENE,knockout,Out in the Open,0,10,12,22
8801,2022-12-23,GENE,gemGrab,Deep Diner,0,1,0,1
8802,2022-12-22,GENE,gemGrab,Gem Fort,0,3,0,3
8803,2022-12-22,GENE,brawlBall,Pinhole Punt,0,1,0,1
8804,2022-12-21,GENE,bounty,Shooting Star,0,1,2,3
8805,2022-12-20,GENE,brawlBall,Beach Ball,0,1,0,1
8806,2022-12-19,GENE,brawlBall,Center Stage,0,0,1,1
8807,2022-12-17,GENE,knockout,Flaring Phoenix,0,0,1,1
8808,2022-12-13,GENE,gemGrab,Crystal Arcade,0,1,0,1
8809,2022-12-13,GENE,brawlBall,Beach Ball,0,0,1,1
8810,2022-12-10,GENE,knockout,X Marks the Spot,0,0,1,1
8811,2022-12-10,GENE,gemGrab,Hard Rock Mine,0,2,1,3
8812,2022-11-01,GENE,knockout,New Perspective,0,1,2,3
8813,2022-10-30,GENE,knockout,Out in the Open,0,1,2,3
8814,2022-10-30,GENE,bounty,Canal Grande,0,0,2,2
8815,2022-10-26,GENE,bounty,Shooting Star,0,0,1,1
8816,2022-10-15,GENE,gemGrab,Hard Rock Mine,0,0,2,2
8817,2022-10-10,GENE,knockout,Belle's Rock,0,0,3,3
8818,2023-01-30,GALE,knockout,Belle's Rock,0,24,9,33
8819,2023-01-30,GALE,hotZone,Quarter Pounder,0,69,67,136
8820,2023-01-30,GALE,heist,Pit Stop,0,2,2,4
8821,2023-01-30,GALE,gemGrab,Minecart Madness,0,23,19,42
8822,2023-01-30,GALE,gemGrab,Double Swoosh,0,24,17,41
8823,2023-01-30,GALE,brawlBall,Center Stage,11,328,313,652
8824,2023-01-30,GALE,brawlBall,Backyard Bowl,1,19,13,33
8825,2023-01-30,GALE,bounty,Hideout,0,3,0,3
8826,2023-01-29,GALE,knockout,Belle's Rock,0,38,23,61
8827,2023-01-29,GALE,hotZone,Quarter Pounder,1,56,36,93
8828,2023-01-29,GALE,heist,Bridge Too Far,0,4,4,8
8829,2023-01-29,GALE,gemGrab,Hard Rock Mine,0,8,3,11
8830,2023-01-29,GALE,gemGrab,Double Swoosh,0,39,30,69
8831,2023-01-29,GALE,brawlBall,Super Beach,0,3,4,7
8832,2023-01-29,GALE,brawlBall,Backyard Bowl,7,255,197,459
8833,2023-01-29,GALE,bounty,Canal Grande,0,5,4,9
8834,2023-01-28,GALE,knockout,Flaring Phoenix,0,18,5,23
8835,2023-01-28,GALE,hotZone,Controller Chaos,0,76,85,161
8836,2023-01-28,GALE,heist,Bridge Too Far,0,13,4,17
8837,2023-01-28,GALE,gemGrab,Hard Rock Mine,0,27,34,61
8838,2023-01-28,GALE,gemGrab,Deep Diner,0,9,3,12
8839,2023-01-28,GALE,brawlBall,Super Beach,9,386,360,755
8840,2023-01-28,GALE,brawlBall,Sneaky Fields,0,20,8,28
8841,2023-01-28,GALE,bounty,Canal Grande,0,13,10,23
8842,2023-01-27,GALE,knockout,Flaring Phoenix,0,11,5,16
8843,2023-01-27,GALE,hotZone,Controller Chaos,0,16,10,26
8844,2023-01-27,GALE,heist,Hot Potato,0,5,0,5
8845,2023-01-27,GALE,gemGrab,Undermine,0,2,2,4
8846,2023-01-27,GALE,gemGrab,Deep Diner,0,17,7,24
8847,2023-01-27,GALE,brawlBall,Sneaky Fields,1,144,131,276
8848,2023-01-27,GALE,brawlBall,Pinhole Punt,0,10,7,17
8849,2023-01-27,GALE,bounty,Temple Ruins,0,7,1,8
8850,2023-01-26,GALE,knockout,Riverside,0,16,4,20
8851,2023-01-26,GALE,hotZone,Open Zone,0,37,11,48
8852,2023-01-26,GALE,heist,Hot Potato,0,14,8,22
8853,2023-01-26,GALE,gemGrab,Undermine,0,29,43,72
8854,2023-01-26,GALE,gemGrab,Gem Fort,0,21,18,39
8855,2023-01-26,GALE,brawlBall,Sunny Soccer,1,21,36,58
8856,2023-01-26,GALE,brawlBall,Pinhole Punt,17,389,314,720
8857,2023-01-26,GALE,bounty,Temple Ruins,0,13,19,32
8858,2023-01-25,GALE,knockout,Riverside,0,5,3,8
8859,2023-01-25,GALE,hotZone,Open Zone,0,17,9,26
8860,2023-01-25,GALE,heist,Safe Zone,0,7,5,12
8861,2023-01-25,GALE,gemGrab,Gem Fort,0,28,17,45
8862,2023-01-25,GALE,gemGrab,Crystal Arcade,0,18,6,24
8863,2023-01-25,GALE,brawlBall,Sunny Soccer,12,237,205,454
8864,2023-01-25,GALE,brawlBall,Beach Ball,2,33,46,81
8865,2023-01-25,GALE,bounty,Excel,0,4,11,15
8866,2023-01-24,GALE,knockout,New Perspective,0,30,16,46
8867,2023-01-24,GALE,hotZone,Dueling Beetles,0,24,18,42
8868,2023-01-24,GALE,heist,Safe Zone,0,15,4,19
8869,2023-01-24,GALE,gemGrab,Minecart Madness,0,14,8,22
8870,2023-01-24,GALE,gemGrab,Crystal Arcade,0,34,27,61
8871,2023-01-24,GALE,brawlBall,Center Stage,2,50,69,121
8872,2023-01-24,GALE,brawlBall,Beach Ball,15,360,283,658
8873,2023-01-24,GALE,bounty,Excel,0,15,12,27
8874,2023-01-23,GALE,knockout,New Perspective,0,41,27,68
8875,2023-01-23,GALE,hotZone,Dueling Beetles,1,61,53,115
8876,2023-01-23,GALE,heist,Snaked Assault,0,10,5,15
8877,2023-01-23,GALE,gemGrab,Minecart Madness,0,50,30,80
8878,2023-01-23,GALE,gemGrab,Double Swoosh,0,14,21,35
8879,2023-01-23,GALE,brawlBall,Center Stage,31,633,714,1378
8880,2023-01-23,GALE,brawlBall,Backyard Bowl,1,11,6,18
8881,2023-01-23,GALE,bounty,Layer Cake,0,12,7,19
8882,2023-01-22,GALE,knockout,X Marks the Spot,0,12,6,18
8883,2023-01-22,GALE,hotZone,Ring of Fire,0,11,1,12
8884,2023-01-22,GALE,heist,Snaked Assault,0,7,6,13
8885,2023-01-22,GALE,gemGrab,Hard Rock Mine,0,9,5,14
8886,2023-01-22,GALE,gemGrab,Double Swoosh,0,17,16,33
8887,2023-01-22,GALE,brawlBall,Super Beach,0,37,15,52
8888,2023-01-22,GALE,brawlBall,Backyard Bowl,2,104,85,191
8889,2023-01-22,GALE,bounty,Layer Cake,0,4,3,7
8890,2023-01-21,GALE,knockout,X Marks the Spot,1,50,34,85
8891,2023-01-21,GALE,hotZone,Ring of Fire,0,35,15,50
8892,2023-01-21,GALE,heist,Tornado Ring,0,11,0,11
8893,2023-01-21,GALE,gemGrab,Hard Rock Mine,0,43,63,106
8894,2023-01-21,GALE,gemGrab,Deep Diner,0,11,7,18
8895,2023-01-21,GALE,brawlBall,Super Beach,13,488,413,914
8896,2023-01-21,GALE,brawlBall,Sneaky Fields,0,18,15,33
8897,2023-01-21,GALE,bounty,Dry Season,0,10,0,10
8898,2023-01-20,GALE,knockout,Out in the Open,0,37,40,77
8899,2023-01-20,GALE,hotZone,Split,0,109,229,338
8900,2023-01-20,GALE,heist,Tornado Ring,0,12,4,16
8901,2023-01-20,GALE,gemGrab,Undermine,0,23,18,41
8902,2023-01-20,GALE,gemGrab,Deep Diner,0,35,33,68
8903,2023-01-20,GALE,brawlBall,Sneaky Fields,8,359,310,677
8904,2023-01-20,GALE,brawlBall,Pinhole Punt,0,11,10,21
8905,2023-01-20,GALE,bounty,Dry Season,0,10,3,13
8906,2023-01-19,GALE,knockout,Out in the Open,0,47,19,66
8907,2023-01-19,GALE,hotZone,Split,0,157,232,389
8908,2023-01-19,GALE,heist,Kaboom Canyon,0,23,26,49
8909,2023-01-19,GALE,gemGrab,Undermine,0,41,27,68
8910,2023-01-19,GALE,gemGrab,Gem Fort,0,6,5,11
8911,2023-01-19,GALE,brawlBall,Sunny Soccer,0,14,15,29
8912,2023-01-19,GALE,brawlBall,Pinhole Punt,11,416,354,781
8913,2023-01-19,GALE,bounty,Shooting Star,0,14,5,19
8914,2023-01-18,GALE,knockout,Goldarm Gulch,0,0,6,6
8915,2023-01-18,GALE,hotZone,Parallel Plays,0,7,5,12
8916,2023-01-18,GALE,heist,Kaboom Canyon,0,10,11,21
8917,2023-01-18,GALE,gemGrab,Gem Fort,0,9,8,17
8918,2023-01-18,GALE,gemGrab,Crystal Arcade,0,8,3,11
8919,2023-01-18,GALE,brawlBall,Sunny Soccer,2,116,87,205
8920,2023-01-18,GALE,brawlBall,Beach Ball,0,2,4,6
8921,2023-01-18,GALE,bounty,Shooting Star,0,6,1,7
8922,2023-01-17,GALE,knockout,Goldarm Gulch,0,9,2,11
8923,2023-01-17,GALE,hotZone,Parallel Plays,0,9,8,17
8924,2023-01-17,GALE,heist,Pit Stop,0,1,0,1
8925,2023-01-17,GALE,gemGrab,Minecart Madness,0,1,1,2
8926,2023-01-17,GALE,gemGrab,Crystal Arcade,0,1,1,2
8927,2023-01-17,GALE,brawlBall,Center Stage,0,3,3,6
8928,2023-01-17,GALE,brawlBall,Beach Ball,1,31,27,59
8929,2023-01-16,GALE,hotZone,Quarter Pounder,0,9,1,10
8930,2023-01-16,GALE,heist,Pit Stop,0,8,1,9
8931,2023-01-16,GALE,gemGrab,Minecart Madness,0,3,3,6
8932,2023-01-16,GALE,gemGrab,Double Swoosh,0,2,3,5
8933,2023-01-16,GALE,brawlBall,Center Stage,1,38,43,82
8934,2023-01-16,GALE,brawlBall,Backyard Bowl,0,3,2,5
8935,2023-01-15,GALE,knockout,Belle's Rock,0,4,1,5
8936,2023-01-15,GALE,hotZone,Quarter Pounder,0,11,12,23
8937,2023-01-15,GALE,heist,Bridge Too Far,0,1,0,1
8938,2023-01-15,GALE,gemGrab,Hard Rock Mine,0,3,0,3
8939,2023-01-15,GALE,gemGrab,Double Swoosh,0,5,4,9
8940,2023-01-15,GALE,brawlBall,Super Beach,0,4,1,5
8941,2023-01-15,GALE,brawlBall,Backyard Bowl,2,31,18,51
8942,2023-01-15,GALE,bounty,Canal Grande,0,1,0,1
8943,2023-01-14,GALE,knockout,Flaring Phoenix,0,0,2,2
8944,2023-01-14,GALE,hotZone,Controller Chaos,0,25,11,36
8945,2023-01-14,GALE,heist,Bridge Too Far,0,2,2,4
8946,2023-01-14,GALE,gemGrab,Hard Rock Mine,0,1,0,1
8947,2023-01-14,GALE,brawlBall,Super Beach,1,29,11,41
8948,2023-01-14,GALE,brawlBall,Sneaky Fields,0,2,15,17
8949,2023-01-14,GALE,bounty,Canal Grande,0,0,1,1
8950,2023-01-13,GALE,knockout,Flaring Phoenix,0,3,0,3
8951,2023-01-13,GALE,hotZone,Controller Chaos,0,21,26,47
8952,2023-01-13,GALE,heist,Hot Potato,0,0,4,4
8953,2023-01-13,GALE,gemGrab,Deep Diner,0,6,3,9
8954,2023-01-13,GALE,brawlBall,Sneaky Fields,1,36,24,61
8955,2023-01-13,GALE,brawlBall,Pinhole Punt,0,1,0,1
8956,2023-01-12,GALE,knockout,Riverside,0,1,0,1
8957,2023-01-12,GALE,hotZone,Open Zone,0,6,10,16
8958,2023-01-12,GALE,heist,Hot Potato,0,1,0,1
8959,2023-01-12,GALE,gemGrab,Undermine,0,4,4,8
8960,2023-01-12,GALE,gemGrab,Gem Fort,0,2,0,2
8961,2023-01-12,GALE,brawlBall,Sunny Soccer,0,6,2,8
8962,2023-01-12,GALE,brawlBall,Pinhole Punt,0,10,9,19
8963,2023-01-11,GALE,hotZone,Open Zone,0,2,7,9
8964,2023-01-11,GALE,brawlBall,Sunny Soccer,1,10,8,19
8965,2023-01-10,GALE,hotZone,Dueling Beetles,0,11,0,11
8966,2023-01-10,GALE,gemGrab,Crystal Arcade,0,5,0,5
8967,2023-01-10,GALE,brawlBall,Center Stage,0,6,0,6
8968,2023-01-10,GALE,brawlBall,Beach Ball,1,15,16,32
8969,2023-01-09,GALE,knockout,New Perspective,0,1,0,1
8970,2023-01-09,GALE,hotZone,Dueling Beetles,0,5,0,5
8971,2023-01-09,GALE,heist,Snaked Assault,0,1,0,1
8972,2023-01-09,GALE,gemGrab,Minecart Madness,0,5,1,6
8973,2023-01-09,GALE,gemGrab,Double Swoosh,0,5,0,5
8974,2023-01-09,GALE,brawlBall,Center Stage,0,37,35,72
8975,2023-01-09,GALE,brawlBall,Backyard Bowl,0,4,3,7
8976,2023-01-09,GALE,bounty,Layer Cake,0,2,1,3
8977,2023-01-08,GALE,knockout,X Marks the Spot,0,2,0,2
8978,2023-01-08,GALE,hotZone,Ring of Fire,0,8,3,11
8979,2023-01-08,GALE,heist,Snaked Assault,0,0,1,1
8980,2023-01-08,GALE,gemGrab,Hard Rock Mine,0,1,0,1
8981,2023-01-08,GALE,gemGrab,Double Swoosh,0,1,0,1
8982,2023-01-08,GALE,brawlBall,Super Beach,0,2,2,4
8983,2023-01-08,GALE,brawlBall,Backyard Bowl,2,22,21,45
8984,2023-01-07,GALE,hotZone,Ring of Fire,0,3,0,3
8985,2023-01-07,GALE,heist,Tornado Ring,0,2,0,2
8986,2023-01-07,GALE,gemGrab,Hard Rock Mine,0,1,0,1
8987,2023-01-07,GALE,brawlBall,Super Beach,0,14,16,30
8988,2023-01-07,GALE,brawlBall,Sneaky Fields,0,3,2,5
8989,2023-01-06,GALE,knockout,Out in the Open,0,1,0,1
8990,2023-01-06,GALE,hotZone,Split,0,22,18,40
8991,2023-01-06,GALE,heist,Tornado Ring,0,1,0,1
8992,2023-01-06,GALE,gemGrab,Undermine,0,4,0,4
8993,2023-01-06,GALE,gemGrab,Deep Diner,0,6,1,7
8994,2023-01-06,GALE,brawlBall,Sneaky Fields,0,27,11,38
8995,2023-01-06,GALE,brawlBall,Pinhole Punt,0,1,0,1
8996,2023-01-05,GALE,knockout,Out in the Open,1,3,3,7
8997,2023-01-05,GALE,hotZone,Split,0,111,126,237
8998,2023-01-05,GALE,heist,Kaboom Canyon,0,2,6,8
8999,2023-01-05,GALE,gemGrab,Undermine,0,7,0,7
9000,2023-01-05,GALE,gemGrab,Gem Fort,0,2,0,2
9001,2023-01-05,GALE,brawlBall,Pinhole Punt,4,56,48,108
9002,2023-01-04,GALE,knockout,Goldarm Gulch,0,1,0,1
9003,2023-01-04,GALE,hotZone,Parallel Plays,0,8,2,10
9004,2023-01-04,GALE,heist,Kaboom Canyon,0,7,7,14
9005,2023-01-04,GALE,gemGrab,Gem Fort,0,2,0,2
9006,2023-01-04,GALE,gemGrab,Crystal Arcade,0,2,0,2
9007,2023-01-04,GALE,brawlBall,Sunny Soccer,0,32,22,54
9008,2023-01-04,GALE,bounty,Shooting Star,0,2,0,2
9009,2023-01-03,GALE,knockout,Goldarm Gulch,0,3,0,3
9010,2023-01-03,GALE,hotZone,Parallel Plays,0,18,25,43
9011,2023-01-03,GALE,heist,Pit Stop,0,4,0,4
9012,2023-01-03,GALE,gemGrab,Minecart Madness,0,1,0,1
9013,2023-01-03,GALE,gemGrab,Crystal Arcade,0,2,0,2
9014,2023-01-03,GALE,brawlBall,Center Stage,0,1,0,1
9015,2023-01-03,GALE,brawlBall,Beach Ball,0,37,26,63
9016,2023-01-02,GALE,knockout,Belle's Rock,0,2,0,2
9017,2023-01-02,GALE,hotZone,Quarter Pounder,0,14,3,17
9018,2023-01-02,GALE,heist,Pit Stop,0,1,2,3
9019,2023-01-02,GALE,gemGrab,Minecart Madness,0,8,9,17
9020,2023-01-02,GALE,gemGrab,Double Swoosh,0,5,14,19
9021,2023-01-02,GALE,brawlBall,Center Stage,1,53,38,92
9022,2023-01-02,GALE,brawlBall,Backyard Bowl,0,1,1,2
9023,2023-01-02,GALE,bounty,Hideout,0,1,1,2
9024,2023-01-01,GALE,hotZone,Quarter Pounder,0,8,0,8
9025,2023-01-01,GALE,hotZone,Controller Chaos,0,1,0,1
9026,2023-01-01,GALE,gemGrab,Double Swoosh,0,2,0,2
9027,2023-01-01,GALE,brawlBall,Backyard Bowl,0,17,1,18
9028,2022-12-31,GALE,hotZone,Controller Chaos,0,1,2,3
9029,2022-12-31,GALE,brawlBall,Super Beach,0,4,1,5
9030,2022-12-31,GALE,bounty,Canal Grande,0,1,2,3
9031,2022-12-30,GALE,hotZone,Controller Chaos,0,3,1,4
9032,2022-12-30,GALE,gemGrab,Undermine,0,1,0,1
9033,2022-12-30,GALE,brawlBall,Sneaky Fields,0,0,3,3
9034,2022-12-29,GALE,gemGrab,Undermine,0,1,0,1
9035,2022-12-29,GALE,gemGrab,Gem Fort,0,0,1,1
9036,2022-12-29,GALE,brawlBall,Pinhole Punt,0,2,2,4
9037,2022-12-28,GALE,hotZone,Open Zone,0,1,0,1
9038,2022-12-27,GALE,hotZone,Dueling Beetles,0,1,0,1
9039,2022-12-27,GALE,gemGrab,Minecart Madness,0,2,0,2
9040,2022-12-26,GALE,heist,Kaboom Canyon,0,1,0,1
9041,2022-12-26,GALE,gemGrab,Minecart Madness,0,2,0,2
9042,2022-12-26,GALE,brawlBall,Center Stage,0,0,1,1
9043,2022-12-24,GALE,brawlBall,Super Beach,0,1,1,2
9044,2022-12-23,GALE,brawlBall,Sneaky Fields,0,1,0,1
9045,2022-12-22,GALE,heist,Kaboom Canyon,0,1,0,1
9046,2022-12-22,GALE,gemGrab,Gem Fort,0,1,0,1
9047,2022-12-22,GALE,brawlBall,Pinhole Punt,0,2,1,3
9048,2022-12-21,GALE,brawlBall,Sunny Soccer,0,0,1,1
9049,2022-12-20,GALE,brawlBall,Beach Ball,0,1,0,1
9050,2022-12-19,GALE,brawlBall,Center Stage,0,1,0,1
9051,2022-12-17,GALE,brawlBall,Super Beach,0,1,0,1
9052,2022-12-16,GALE,brawlBall,Sneaky Fields,0,1,0,1
9053,2022-12-13,GALE,knockout,New Perspective,0,1,0,1
9054,2022-12-13,GALE,brawlBall,Beach Ball,0,2,0,2
9055,2022-12-11,GALE,brawlBall,Backyard Bowl,0,2,1,3
9056,2022-11-11,GALE,knockout,New Perspective,0,1,0,1
9057,2022-11-11,GALE,brawlBall,Sneaky Fields,0,1,0,1
9058,2022-10-30,GALE,knockout,Out in the Open,0,0,2,2
9059,2022-10-15,GALE,gemGrab,Hard Rock Mine,0,2,0,2
9060,2023-01-30,FRANK,knockout,Belle's Rock,0,25,28,53
9061,2023-01-30,FRANK,hotZone,Quarter Pounder,0,72,63,135
9062,2023-01-30,FRANK,heist,Pit Stop,0,50,68,118
9063,2023-01-30,FRANK,gemGrab,Minecart Madness,0,15,7,22
9064,2023-01-30,FRANK,gemGrab,Double Swoosh,0,23,15,38
9065,2023-01-30,FRANK,brawlBall,Center Stage,18,657,628,1303
9066,2023-01-30,FRANK,brawlBall,Backyard Bowl,0,32,44,76
9067,2023-01-30,FRANK,bounty,Hideout,0,3,0,3
9068,2023-01-29,FRANK,knockout,Belle's Rock,0,21,13,34
9069,2023-01-29,FRANK,hotZone,Quarter Pounder,1,53,33,87
9070,2023-01-29,FRANK,heist,Bridge Too Far,0,13,7,20
9071,2023-01-29,FRANK,gemGrab,Hard Rock Mine,0,9,9,18
9072,2023-01-29,FRANK,gemGrab,Double Swoosh,0,46,36,82
9073,2023-01-29,FRANK,brawlBall,Super Beach,0,8,8,16
9074,2023-01-29,FRANK,brawlBall,Backyard Bowl,4,393,325,722
9075,2023-01-29,FRANK,bounty,Canal Grande,0,7,8,15
9076,2023-01-28,FRANK,knockout,Flaring Phoenix,0,19,9,28
9077,2023-01-28,FRANK,hotZone,Controller Chaos,0,94,46,140
9078,2023-01-28,FRANK,heist,Bridge Too Far,0,21,22,43
9079,2023-01-28,FRANK,gemGrab,Hard Rock Mine,0,38,18,56
9080,2023-01-28,FRANK,gemGrab,Deep Diner,0,4,4,8
9081,2023-01-28,FRANK,brawlBall,Super Beach,7,835,770,1612
9082,2023-01-28,FRANK,brawlBall,Sneaky Fields,0,40,47,87
9083,2023-01-28,FRANK,bounty,Canal Grande,0,25,16,41
9084,2023-01-27,FRANK,knockout,Flaring Phoenix,0,4,4,8
9085,2023-01-27,FRANK,hotZone,Controller Chaos,0,18,56,74
9086,2023-01-27,FRANK,heist,Hot Potato,0,10,8,18
9087,2023-01-27,FRANK,gemGrab,Undermine,0,2,1,3
9088,2023-01-27,FRANK,gemGrab,Deep Diner,0,10,7,17
9089,2023-01-27,FRANK,brawlBall,Sneaky Fields,8,273,294,575
9090,2023-01-27,FRANK,brawlBall,Pinhole Punt,0,5,2,7
9091,2023-01-27,FRANK,bounty,Temple Ruins,0,2,0,2
9092,2023-01-26,FRANK,knockout,Riverside,0,6,6,12
9093,2023-01-26,FRANK,hotZone,Open Zone,0,20,16,36
9094,2023-01-26,FRANK,heist,Hot Potato,0,22,10,32
9095,2023-01-26,FRANK,gemGrab,Undermine,0,34,47,81
9096,2023-01-26,FRANK,gemGrab,Gem Fort,0,12,12,24
9097,2023-01-26,FRANK,brawlBall,Sunny Soccer,0,46,31,77
9098,2023-01-26,FRANK,brawlBall,Pinhole Punt,15,577,529,1121
9099,2023-01-26,FRANK,bounty,Temple Ruins,0,10,8,18
9100,2023-01-25,FRANK,knockout,Riverside,0,7,3,10
9101,2023-01-25,FRANK,hotZone,Open Zone,0,8,5,13
9102,2023-01-25,FRANK,heist,Safe Zone,0,11,1,12
9103,2023-01-25,FRANK,gemGrab,Gem Fort,0,23,21,44
9104,2023-01-25,FRANK,gemGrab,Crystal Arcade,0,24,28,52
9105,2023-01-25,FRANK,brawlBall,Sunny Soccer,4,444,388,836
9106,2023-01-25,FRANK,brawlBall,Beach Ball,3,64,63,130
9107,2023-01-25,FRANK,bounty,Excel,0,6,2,8
9108,2023-01-24,FRANK,knockout,New Perspective,0,14,14,28
9109,2023-01-24,FRANK,hotZone,Dueling Beetles,0,77,57,134
9110,2023-01-24,FRANK,heist,Safe Zone,0,14,15,29
9111,2023-01-24,FRANK,gemGrab,Minecart Madness,0,3,2,5
9112,2023-01-24,FRANK,gemGrab,Crystal Arcade,0,31,24,55
9113,2023-01-24,FRANK,brawlBall,Center Stage,6,91,83,180
9114,2023-01-24,FRANK,brawlBall,Beach Ball,16,727,653,1396
9115,2023-01-24,FRANK,bounty,Excel,0,15,12,27
9116,2023-01-23,FRANK,knockout,New Perspective,0,24,23,47
9117,2023-01-23,FRANK,hotZone,Dueling Beetles,0,85,57,142
9118,2023-01-23,FRANK,heist,Snaked Assault,0,69,68,137
9119,2023-01-23,FRANK,gemGrab,Minecart Madness,0,25,13,38
9120,2023-01-23,FRANK,gemGrab,Double Swoosh,0,17,19,36
9121,2023-01-23,FRANK,brawlBall,Center Stage,14,1074,1019,2107
9122,2023-01-23,FRANK,brawlBall,Backyard Bowl,0,24,27,51
9123,2023-01-23,FRANK,bounty,Layer Cake,0,17,22,39
9124,2023-01-22,FRANK,knockout,X Marks the Spot,0,11,6,17
9125,2023-01-22,FRANK,hotZone,Ring of Fire,0,22,25,47
9126,2023-01-22,FRANK,heist,Snaked Assault,0,18,23,41
9127,2023-01-22,FRANK,gemGrab,Hard Rock Mine,0,6,6,12
9128,2023-01-22,FRANK,gemGrab,Double Swoosh,0,41,40,81
9129,2023-01-22,FRANK,brawlBall,Super Beach,3,85,67,155
9130,2023-01-22,FRANK,brawlBall,Backyard Bowl,4,161,147,312
9131,2023-01-22,FRANK,bounty,Layer Cake,0,17,21,38
9132,2023-01-21,FRANK,knockout,X Marks the Spot,0,38,33,71
9133,2023-01-21,FRANK,hotZone,Ring of Fire,0,59,70,129
9134,2023-01-21,FRANK,heist,Tornado Ring,0,48,44,92
9135,2023-01-21,FRANK,gemGrab,Hard Rock Mine,0,41,27,68
9136,2023-01-21,FRANK,gemGrab,Deep Diner,0,11,6,17
9137,2023-01-21,FRANK,brawlBall,Super Beach,15,1104,1042,2161
9138,2023-01-21,FRANK,brawlBall,Sneaky Fields,0,42,50,92
9139,2023-01-21,FRANK,bounty,Dry Season,0,8,6,14
9140,2023-01-20,FRANK,knockout,Out in the Open,0,14,7,21
9141,2023-01-20,FRANK,hotZone,Split,0,160,248,408
9142,2023-01-20,FRANK,heist,Tornado Ring,0,51,50,101
9143,2023-01-20,FRANK,gemGrab,Undermine,0,14,6,20
9144,2023-01-20,FRANK,gemGrab,Deep Diner,0,23,34,57
9145,2023-01-20,FRANK,brawlBall,Sneaky Fields,15,999,957,1971
9146,2023-01-20,FRANK,brawlBall,Pinhole Punt,1,24,26,51
9147,2023-01-20,FRANK,bounty,Dry Season,0,7,4,11
9148,2023-01-19,FRANK,knockout,Out in the Open,0,21,12,33
9149,2023-01-19,FRANK,hotZone,Split,0,182,301,483
9150,2023-01-19,FRANK,heist,Kaboom Canyon,0,15,4,19
9151,2023-01-19,FRANK,gemGrab,Undermine,0,48,29,77
9152,2023-01-19,FRANK,gemGrab,Gem Fort,0,9,8,17
9153,2023-01-19,FRANK,brawlBall,Sunny Soccer,0,24,17,41
9154,2023-01-19,FRANK,brawlBall,Pinhole Punt,18,590,505,1113
9155,2023-01-19,FRANK,bounty,Shooting Star,0,12,25,37
9156,2023-01-18,FRANK,knockout,Goldarm Gulch,0,6,7,13
9157,2023-01-18,FRANK,hotZone,Parallel Plays,0,6,2,8
9158,2023-01-18,FRANK,heist,Kaboom Canyon,0,5,0,5
9159,2023-01-18,FRANK,gemGrab,Gem Fort,0,15,9,24
9160,2023-01-18,FRANK,gemGrab,Crystal Arcade,0,0,1,1
9161,2023-01-18,FRANK,brawlBall,Sunny Soccer,1,198,166,365
9162,2023-01-18,FRANK,brawlBall,Beach Ball,0,7,7,14
9163,2023-01-18,FRANK,bounty,Shooting Star,0,6,7,13
9164,2023-01-17,FRANK,knockout,Goldarm Gulch,0,3,6,9
9165,2023-01-17,FRANK,hotZone,Parallel Plays,0,5,4,9
9166,2023-01-17,FRANK,heist,Pit Stop,0,8,17,25
9167,2023-01-17,FRANK,gemGrab,Crystal Arcade,0,3,1,4
9168,2023-01-17,FRANK,brawlBall,Center Stage,0,6,4,10
9169,2023-01-17,FRANK,brawlBall,Beach Ball,0,66,70,136
9170,2023-01-17,FRANK,bounty,Hideout,0,1,0,1
9171,2023-01-16,FRANK,knockout,Belle's Rock,0,2,0,2
9172,2023-01-16,FRANK,hotZone,Quarter Pounder,0,21,17,38
9173,2023-01-16,FRANK,heist,Pit Stop,0,20,46,66
9174,2023-01-16,FRANK,gemGrab,Minecart Madness,0,1,0,1
9175,2023-01-16,FRANK,gemGrab,Double Swoosh,0,1,1,2
9176,2023-01-16,FRANK,brawlBall,Center Stage,3,56,97,156
9177,2023-01-16,FRANK,brawlBall,Backyard Bowl,0,5,6,11
9178,2023-01-16,FRANK,bounty,Hideout,0,2,0,2
9179,2023-01-15,FRANK,knockout,Belle's Rock,0,3,3,6
9180,2023-01-15,FRANK,hotZone,Quarter Pounder,0,19,5,24
9181,2023-01-15,FRANK,heist,Bridge Too Far,0,1,0,1
9182,2023-01-15,FRANK,gemGrab,Hard Rock Mine,0,5,5,10
9183,2023-01-15,FRANK,gemGrab,Double Swoosh,0,9,5,14
9184,2023-01-15,FRANK,brawlBall,Super Beach,0,7,4,11
9185,2023-01-15,FRANK,brawlBall,Backyard Bowl,1,67,46,114
9186,2023-01-15,FRANK,bounty,Canal Grande,0,2,5,7
9187,2023-01-14,FRANK,hotZone,Controller Chaos,0,32,22,54
9188,2023-01-14,FRANK,heist,Bridge Too Far,0,3,0,3
9189,2023-01-14,FRANK,gemGrab,Hard Rock Mine,0,2,0,2
9190,2023-01-14,FRANK,gemGrab,Deep Diner,0,0,1,1
9191,2023-01-14,FRANK,brawlBall,Super Beach,1,74,65,140
9192,2023-01-14,FRANK,brawlBall,Sneaky Fields,0,12,2,14
9193,2023-01-14,FRANK,bounty,Canal Grande,0,4,1,5
9194,2023-01-13,FRANK,knockout,Flaring Phoenix,0,4,1,5
9195,2023-01-13,FRANK,hotZone,Controller Chaos,0,27,6,33
9196,2023-01-13,FRANK,heist,Hot Potato,0,2,0,2
9197,2023-01-13,FRANK,gemGrab,Deep Diner,0,6,1,7
9198,2023-01-13,FRANK,brawlBall,Sneaky Fields,1,87,64,152
9199,2023-01-13,FRANK,brawlBall,Pinhole Punt,0,1,0,1
9200,2023-01-13,FRANK,bounty,Temple Ruins,0,0,1,1
9201,2023-01-12,FRANK,knockout,Riverside,0,1,1,2
9202,2023-01-12,FRANK,hotZone,Open Zone,0,9,0,9
9203,2023-01-12,FRANK,heist,Hot Potato,0,1,0,1
9204,2023-01-12,FRANK,gemGrab,Undermine,0,3,2,5
9205,2023-01-12,FRANK,gemGrab,Gem Fort,0,1,0,1
9206,2023-01-12,FRANK,brawlBall,Sunny Soccer,0,5,4,9
9207,2023-01-12,FRANK,brawlBall,Pinhole Punt,0,30,22,52
9208,2023-01-11,FRANK,brawlBall,Sunny Soccer,0,14,14,28
9209,2023-01-11,FRANK,bounty,Excel,0,3,3,6
9210,2023-01-10,FRANK,knockout,New Perspective,0,1,0,1
9211,2023-01-10,FRANK,hotZone,Dueling Beetles,0,15,5,20
9212,2023-01-10,FRANK,gemGrab,Crystal Arcade,0,1,0,1
9213,2023-01-10,FRANK,brawlBall,Center Stage,0,8,24,32
9214,2023-01-10,FRANK,brawlBall,Beach Ball,1,46,22,69
9215,2023-01-09,FRANK,hotZone,Dueling Beetles,0,6,2,8
9216,2023-01-09,FRANK,heist,Snaked Assault,0,9,0,9
9217,2023-01-09,FRANK,gemGrab,Minecart Madness,0,1,2,3
9218,2023-01-09,FRANK,gemGrab,Double Swoosh,0,2,1,3
9219,2023-01-09,FRANK,brawlBall,Center Stage,0,64,70,134
9220,2023-01-09,FRANK,brawlBall,Backyard Bowl,0,2,7,9
9221,2023-01-09,FRANK,bounty,Layer Cake,0,5,0,5
9222,2023-01-08,FRANK,knockout,X Marks the Spot,0,3,0,3
9223,2023-01-08,FRANK,hotZone,Ring of Fire,0,6,1,7
9224,2023-01-08,FRANK,heist,Snaked Assault,0,4,0,4
9225,2023-01-08,FRANK,gemGrab,Double Swoosh,0,7,38,45
9226,2023-01-08,FRANK,brawlBall,Super Beach,0,2,2,4
9227,2023-01-08,FRANK,brawlBall,Backyard Bowl,0,16,10,26
9228,2023-01-08,FRANK,bounty,Layer Cake,0,0,2,2
9229,2023-01-07,FRANK,knockout,X Marks the Spot,0,1,0,1
9230,2023-01-07,FRANK,hotZone,Ring of Fire,0,4,1,5
9231,2023-01-07,FRANK,heist,Tornado Ring,0,10,15,25
9232,2023-01-07,FRANK,gemGrab,Hard Rock Mine,0,2,0,2
9233,2023-01-07,FRANK,brawlBall,Super Beach,0,28,33,61
9234,2023-01-07,FRANK,brawlBall,Sneaky Fields,1,7,18,26
9235,2023-01-07,FRANK,bounty,Dry Season,0,2,1,3
9236,2023-01-06,FRANK,hotZone,Split,0,10,5,15
9237,2023-01-06,FRANK,heist,Tornado Ring,0,20,20,40
9238,2023-01-06,FRANK,gemGrab,Undermine,0,1,1,2
9239,2023-01-06,FRANK,gemGrab,Deep Diner,0,5,3,8
9240,2023-01-06,FRANK,brawlBall,Sneaky Fields,2,54,55,111
9241,2023-01-06,FRANK,brawlBall,Pinhole Punt,0,2,0,2
9242,2023-01-06,FRANK,bounty,Dry Season,0,1,0,1
9243,2023-01-05,FRANK,knockout,Out in the Open,0,1,0,1
9244,2023-01-05,FRANK,hotZone,Split,0,68,42,110
9245,2023-01-05,FRANK,heist,Kaboom Canyon,0,3,0,3
9246,2023-01-05,FRANK,gemGrab,Undermine,0,9,2,11
9247,2023-01-05,FRANK,brawlBall,Sunny Soccer,0,0,1,1
9248,2023-01-05,FRANK,brawlBall,Pinhole Punt,1,40,48,89
9249,2023-01-05,FRANK,bounty,Shooting Star,0,1,1,2
9250,2023-01-04,FRANK,hotZone,Parallel Plays,0,4,0,4
9251,2023-01-04,FRANK,heist,Kaboom Canyon,0,2,0,2
9252,2023-01-04,FRANK,gemGrab,Gem Fort,0,3,3,6
9253,2023-01-04,FRANK,gemGrab,Crystal Arcade,0,6,12,18
9254,2023-01-04,FRANK,brawlBall,Sunny Soccer,1,65,38,104
9255,2023-01-04,FRANK,bounty,Shooting Star,0,1,0,1
9256,2023-01-03,FRANK,knockout,Goldarm Gulch,0,1,0,1
9257,2023-01-03,FRANK,hotZone,Parallel Plays,0,7,0,7
9258,2023-01-03,FRANK,heist,Pit Stop,0,9,0,9
9259,2023-01-03,FRANK,gemGrab,Minecart Madness,0,1,0,1
9260,2023-01-03,FRANK,gemGrab,Crystal Arcade,0,1,3,4
9261,2023-01-03,FRANK,brawlBall,Center Stage,0,4,1,5
9262,2023-01-03,FRANK,brawlBall,Beach Ball,1,56,19,76
9263,2023-01-02,FRANK,knockout,Belle's Rock,0,3,0,3
9264,2023-01-02,FRANK,hotZone,Quarter Pounder,1,17,21,39
9265,2023-01-02,FRANK,heist,Pit Stop,0,23,26,49
9266,2023-01-02,FRANK,heist,Kaboom Canyon,0,1,0,1
9267,2023-01-02,FRANK,gemGrab,Minecart Madness,0,2,1,3
9268,2023-01-02,FRANK,gemGrab,Double Swoosh,0,10,9,19
9269,2023-01-02,FRANK,brawlBall,Center Stage,1,51,20,72
9270,2023-01-02,FRANK,brawlBall,Backyard Bowl,0,4,3,7
9271,2023-01-02,FRANK,bounty,Hideout,0,3,2,5
9272,2023-01-01,FRANK,hotZone,Quarter Pounder,0,6,14,20
9273,2023-01-01,FRANK,heist,Bridge Too Far,0,1,0,1
9274,2023-01-01,FRANK,gemGrab,Double Swoosh,0,3,0,3
9275,2023-01-01,FRANK,brawlBall,Backyard Bowl,0,19,31,50
9276,2022-12-31,FRANK,hotZone,Controller Chaos,0,1,0,1
9277,2022-12-31,FRANK,heist,Bridge Too Far,0,1,1,2
9278,2022-12-31,FRANK,gemGrab,Hard Rock Mine,0,1,1,2
9279,2022-12-31,FRANK,brawlBall,Super Beach,0,5,3,8
9280,2022-12-31,FRANK,brawlBall,Sneaky Fields,0,1,0,1
9281,2022-12-30,FRANK,hotZone,Controller Chaos,0,5,0,5
9282,2022-12-30,FRANK,gemGrab,Deep Diner,0,2,1,3
9283,2022-12-30,FRANK,brawlBall,Sneaky Fields,0,11,9,20
9284,2022-12-29,FRANK,gemGrab,Gem Fort,0,0,1,1
9285,2022-12-29,FRANK,brawlBall,Pinhole Punt,0,4,5,9
9286,2022-12-28,FRANK,brawlBall,Sunny Soccer,0,1,0,1
9287,2022-12-27,FRANK,hotZone,Controller Chaos,0,1,0,1
9288,2022-12-27,FRANK,brawlBall,Beach Ball,0,0,1,1
9289,2022-12-26,FRANK,hotZone,Controller Chaos,0,0,1,1
9290,2022-12-26,FRANK,brawlBall,Center Stage,0,0,1,1
9291,2022-12-22,FRANK,brawlBall,Pinhole Punt,0,1,0,1
9292,2022-12-21,FRANK,brawlBall,Sunny Soccer,0,1,0,1
9293,2022-12-20,FRANK,brawlBall,Beach Ball,0,1,1,2
9294,2022-12-19,FRANK,brawlBall,Center Stage,0,0,3,3
9295,2022-12-16,FRANK,brawlBall,Sneaky Fields,0,1,0,1
9296,2022-12-13,FRANK,brawlBall,Beach Ball,0,0,1,1
9297,2022-11-07,FRANK,hotZone,Quarter Pounder,0,1,0,1
9298,2022-10-28,FRANK,brawlBall,Beach Ball,0,1,0,1
9299,2022-10-26,FRANK,brawlBall,Sunny Soccer,0,2,0,2
9300,2022-10-15,FRANK,brawlBall,Super Beach,0,0,1,1
9301,2023-01-30,FANG,knockout,Belle's Rock,1,281,382,664
9302,2023-01-30,FANG,hotZone,Quarter Pounder,0,71,17,88
9303,2023-01-30,FANG,heist,Pit Stop,0,15,16,31
9304,2023-01-30,FANG,gemGrab,Minecart Madness,0,86,105,191
9305,2023-01-30,FANG,gemGrab,Double Swoosh,0,95,81,176
9306,2023-01-30,FANG,brawlBall,Center Stage,15,537,506,1058
9307,2023-01-30,FANG,brawlBall,Backyard Bowl,2,130,128,260
9308,2023-01-30,FANG,bounty,Hideout,0,51,43,94
9309,2023-01-29,FANG,knockout,Belle's Rock,0,263,272,535
9310,2023-01-29,FANG,hotZone,Quarter Pounder,1,46,21,68
9311,2023-01-29,FANG,heist,Bridge Too Far,0,48,18,66
9312,2023-01-29,FANG,gemGrab,Hard Rock Mine,0,59,34,93
9313,2023-01-29,FANG,gemGrab,Double Swoosh,0,161,126,287
9314,2023-01-29,FANG,brawlBall,Super Beach,0,18,11,29
9315,2023-01-29,FANG,brawlBall,Backyard Bowl,44,1052,1108,2204
9316,2023-01-29,FANG,bounty,Canal Grande,0,97,115,212
9317,2023-01-28,FANG,knockout,Flaring Phoenix,0,135,73,208
9318,2023-01-28,FANG,hotZone,Controller Chaos,0,58,41,99
9319,2023-01-28,FANG,heist,Bridge Too Far,0,87,57,144
9320,2023-01-28,FANG,gemGrab,Hard Rock Mine,0,188,144,332
9321,2023-01-28,FANG,gemGrab,Deep Diner,0,69,55,124
9322,2023-01-28,FANG,brawlBall,Super Beach,15,1007,962,1984
9323,2023-01-28,FANG,brawlBall,Sneaky Fields,1,28,24,53
9324,2023-01-28,FANG,bounty,Canal Grande,0,117,155,272
9325,2023-01-27,FANG,knockout,Flaring Phoenix,2,49,36,87
9326,2023-01-27,FANG,hotZone,Controller Chaos,0,22,30,52
9327,2023-01-27,FANG,heist,Hot Potato,0,12,3,15
9328,2023-01-27,FANG,gemGrab,Undermine,0,19,19,38
9329,2023-01-27,FANG,gemGrab,Deep Diner,0,53,51,104
9330,2023-01-27,FANG,brawlBall,Sneaky Fields,1,256,195,452
9331,2023-01-27,FANG,brawlBall,Pinhole Punt,0,8,7,15
9332,2023-01-27,FANG,bounty,Temple Ruins,0,31,18,49
9333,2023-01-26,FANG,knockout,Riverside,0,212,172,384
9334,2023-01-26,FANG,hotZone,Open Zone,0,78,31,109
9335,2023-01-26,FANG,heist,Hot Potato,0,34,28,62
9336,2023-01-26,FANG,gemGrab,Undermine,0,88,69,157
9337,2023-01-26,FANG,gemGrab,Gem Fort,0,47,26,73
9338,2023-01-26,FANG,brawlBall,Sunny Soccer,0,53,54,107
9339,2023-01-26,FANG,brawlBall,Pinhole Punt,26,871,855,1752
9340,2023-01-26,FANG,bounty,Temple Ruins,0,53,48,101
9341,2023-01-25,FANG,knockout,Riverside,0,65,37,102
9342,2023-01-25,FANG,hotZone,Open Zone,0,34,17,51
9343,2023-01-25,FANG,heist,Safe Zone,3,57,33,93
9344,2023-01-25,FANG,gemGrab,Gem Fort,0,55,49,104
9345,2023-01-25,FANG,gemGrab,Crystal Arcade,0,109,115,224
9346,2023-01-25,FANG,brawlBall,Sunny Soccer,5,471,521,997
9347,2023-01-25,FANG,brawlBall,Beach Ball,3,91,79,173
9348,2023-01-25,FANG,bounty,Excel,0,69,111,180
9349,2023-01-24,FANG,knockout,New Perspective,1,163,195,359
9350,2023-01-24,FANG,hotZone,Dueling Beetles,0,61,42,103
9351,2023-01-24,FANG,heist,Safe Zone,0,45,58,103
9352,2023-01-24,FANG,gemGrab,Minecart Madness,0,33,25,58
9353,2023-01-24,FANG,gemGrab,Crystal Arcade,0,152,150,302
9354,2023-01-24,FANG,brawlBall,Center Stage,2,102,86,190
9355,2023-01-24,FANG,brawlBall,Beach Ball,29,789,804,1622
9356,2023-01-24,FANG,bounty,Excel,0,157,265,422
9357,2023-01-23,FANG,knockout,New Perspective,0,188,179,367
9358,2023-01-23,FANG,hotZone,Dueling Beetles,0,57,45,102
9359,2023-01-23,FANG,heist,Snaked Assault,0,17,20,37
9360,2023-01-23,FANG,gemGrab,Minecart Madness,0,160,220,380
9361,2023-01-23,FANG,gemGrab,Double Swoosh,0,52,33,85
9362,2023-01-23,FANG,brawlBall,Center Stage,25,933,864,1822
9363,2023-01-23,FANG,brawlBall,Backyard Bowl,2,72,73,147
9364,2023-01-23,FANG,bounty,Layer Cake,0,153,260,413
9365,2023-01-22,FANG,knockout,X Marks the Spot,1,117,90,208
9366,2023-01-22,FANG,hotZone,Ring of Fire,0,39,42,81
9367,2023-01-22,FANG,heist,Snaked Assault,0,19,26,45
9368,2023-01-22,FANG,gemGrab,Hard Rock Mine,0,28,23,51
9369,2023-01-22,FANG,gemGrab,Double Swoosh,0,48,36,84
9370,2023-01-22,FANG,brawlBall,Super Beach,4,89,80,173
9371,2023-01-22,FANG,brawlBall,Backyard Bowl,14,484,534,1032
9372,2023-01-22,FANG,bounty,Layer Cake,0,100,121,221
9373,2023-01-21,FANG,knockout,X Marks the Spot,1,359,329,689
9374,2023-01-21,FANG,hotZone,Ring of Fire,0,102,61,163
9375,2023-01-21,FANG,heist,Tornado Ring,0,22,9,31
9376,2023-01-21,FANG,gemGrab,Hard Rock Mine,0,195,177,372
9377,2023-01-21,FANG,gemGrab,Deep Diner,0,49,44,93
9378,2023-01-21,FANG,brawlBall,Super Beach,27,1046,1069,2142
9379,2023-01-21,FANG,brawlBall,Sneaky Fields,0,48,33,81
9380,2023-01-21,FANG,bounty,Dry Season,0,168,255,423
9381,2023-01-20,FANG,knockout,Out in the Open,2,221,194,417
9382,2023-01-20,FANG,hotZone,Split,0,20,25,45
9383,2023-01-20,FANG,heist,Tornado Ring,0,20,9,29
9384,2023-01-20,FANG,gemGrab,Undermine,0,44,34,78
9385,2023-01-20,FANG,gemGrab,Deep Diner,0,167,160,327
9386,2023-01-20,FANG,brawlBall,Sneaky Fields,13,726,659,1398
9387,2023-01-20,FANG,brawlBall,Pinhole Punt,1,54,34,89
9388,2023-01-20,FANG,bounty,Dry Season,0,120,125,245
9389,2023-01-19,FANG,knockout,Out in the Open,0,212,137,349
9390,2023-01-19,FANG,hotZone,Split,0,29,21,50
9391,2023-01-19,FANG,heist,Kaboom Canyon,2,31,11,44
9392,2023-01-19,FANG,gemGrab,Undermine,0,110,101,211
9393,2023-01-19,FANG,gemGrab,Gem Fort,0,30,23,53
9394,2023-01-19,FANG,brawlBall,Sunny Soccer,0,36,26,62
9395,2023-01-19,FANG,brawlBall,Pinhole Punt,26,878,882,1786
9396,2023-01-19,FANG,bounty,Shooting Star,0,110,122,232
9397,2023-01-18,FANG,knockout,Goldarm Gulch,0,27,22,49
9398,2023-01-18,FANG,hotZone,Parallel Plays,0,12,14,26
9399,2023-01-18,FANG,heist,Kaboom Canyon,0,9,9,18
9400,2023-01-18,FANG,gemGrab,Gem Fort,0,22,29,51
9401,2023-01-18,FANG,gemGrab,Crystal Arcade,0,15,17,32
9402,2023-01-18,FANG,brawlBall,Sunny Soccer,5,165,186,356
9403,2023-01-18,FANG,brawlBall,Beach Ball,0,14,13,27
9404,2023-01-18,FANG,bounty,Shooting Star,0,45,39,84
9405,2023-01-17,FANG,knockout,Goldarm Gulch,0,26,23,49
9406,2023-01-17,FANG,hotZone,Parallel Plays,0,8,1,9
9407,2023-01-17,FANG,heist,Pit Stop,0,1,0,1
9408,2023-01-17,FANG,gemGrab,Minecart Madness,0,3,4,7
9409,2023-01-17,FANG,gemGrab,Crystal Arcade,0,12,10,22
9410,2023-01-17,FANG,brawlBall,Center Stage,0,2,3,5
9411,2023-01-17,FANG,brawlBall,Beach Ball,2,65,72,139
9412,2023-01-17,FANG,bounty,Hideout,0,6,3,9
9413,2023-01-16,FANG,knockout,Belle's Rock,0,25,13,38
9414,2023-01-16,FANG,hotZone,Quarter Pounder,0,12,8,20
9415,2023-01-16,FANG,heist,Pit Stop,0,4,0,4
9416,2023-01-16,FANG,gemGrab,Minecart Madness,0,6,21,27
9417,2023-01-16,FANG,gemGrab,Double Swoosh,0,10,2,12
9418,2023-01-16,FANG,brawlBall,Center Stage,2,52,40,94
9419,2023-01-16,FANG,brawlBall,Backyard Bowl,0,13,17,30
9420,2023-01-16,FANG,bounty,Hideout,0,10,8,18
9421,2023-01-15,FANG,knockout,Belle's Rock,0,36,56,92
9422,2023-01-15,FANG,hotZone,Quarter Pounder,0,16,4,20
9423,2023-01-15,FANG,heist,Bridge Too Far,0,3,4,7
9424,2023-01-15,FANG,gemGrab,Hard Rock Mine,0,10,5,15
9425,2023-01-15,FANG,gemGrab,Double Swoosh,0,11,12,23
9426,2023-01-15,FANG,brawlBall,Super Beach,1,13,3,17
9427,2023-01-15,FANG,brawlBall,Backyard Bowl,4,138,142,284
9428,2023-01-15,FANG,bounty,Canal Grande,0,15,10,25
9429,2023-01-14,FANG,knockout,Flaring Phoenix,0,15,6,21
9430,2023-01-14,FANG,hotZone,Controller Chaos,0,6,4,10
9431,2023-01-14,FANG,heist,Bridge Too Far,0,9,15,24
9432,2023-01-14,FANG,gemGrab,Hard Rock Mine,0,10,8,18
9433,2023-01-14,FANG,gemGrab,Deep Diner,0,9,1,10
9434,2023-01-14,FANG,brawlBall,Super Beach,0,42,28,70
9435,2023-01-14,FANG,brawlBall,Sneaky Fields,0,6,2,8
9436,2023-01-14,FANG,bounty,Canal Grande,0,21,23,44
9437,2023-01-13,FANG,knockout,Flaring Phoenix,0,6,1,7
9438,2023-01-13,FANG,hotZone,Controller Chaos,0,13,1,14
9439,2023-01-13,FANG,heist,Hot Potato,0,1,0,1
9440,2023-01-13,FANG,gemGrab,Deep Diner,0,13,22,35
9441,2023-01-13,FANG,brawlBall,Sneaky Fields,1,24,14,39
9442,2023-01-13,FANG,brawlBall,Pinhole Punt,2,1,0,3
9443,2023-01-13,FANG,bounty,Temple Ruins,0,5,11,16
9444,2023-01-12,FANG,knockout,Riverside,0,30,25,55
9445,2023-01-12,FANG,hotZone,Open Zone,0,10,5,15
9446,2023-01-12,FANG,gemGrab,Undermine,0,8,2,10
9447,2023-01-12,FANG,gemGrab,Gem Fort,0,4,1,5
9448,2023-01-12,FANG,brawlBall,Sunny Soccer,0,2,1,3
9449,2023-01-12,FANG,brawlBall,Pinhole Punt,0,27,23,50
9450,2023-01-12,FANG,bounty,Temple Ruins,0,1,0,1
9451,2023-01-11,FANG,knockout,Riverside,0,3,1,4
9452,2023-01-11,FANG,hotZone,Open Zone,0,2,0,2
9453,2023-01-11,FANG,heist,Safe Zone,0,1,0,1
9454,2023-01-11,FANG,gemGrab,Gem Fort,0,2,10,12
9455,2023-01-11,FANG,brawlBall,Sunny Soccer,0,14,14,28
9456,2023-01-11,FANG,bounty,Excel,0,0,11,11
9457,2023-01-10,FANG,knockout,New Perspective,0,17,19,36
9458,2023-01-10,FANG,hotZone,Dueling Beetles,0,11,14,25
9459,2023-01-10,FANG,heist,Safe Zone,0,4,1,5
9460,2023-01-10,FANG,gemGrab,Minecart Madness,0,5,2,7
9461,2023-01-10,FANG,gemGrab,Crystal Arcade,0,11,12,23
9462,2023-01-10,FANG,brawlBall,Center Stage,0,6,3,9
9463,2023-01-10,FANG,brawlBall,Beach Ball,0,35,40,75
9464,2023-01-10,FANG,bounty,Excel,0,5,4,9
9465,2023-01-09,FANG,knockout,New Perspective,0,5,12,17
9466,2023-01-09,FANG,hotZone,Dueling Beetles,0,7,15,22
9467,2023-01-09,FANG,heist,Snaked Assault,0,6,3,9
9468,2023-01-09,FANG,gemGrab,Minecart Madness,0,10,7,17
9469,2023-01-09,FANG,gemGrab,Double Swoosh,0,8,6,14
9470,2023-01-09,FANG,brawlBall,Center Stage,1,52,26,79
9471,2023-01-09,FANG,brawlBall,Backyard Bowl,1,5,14,20
9472,2023-01-09,FANG,bounty,Layer Cake,0,19,12,31
9473,2023-01-08,FANG,knockout,X Marks the Spot,0,27,25,52
9474,2023-01-08,FANG,hotZone,Ring of Fire,0,23,17,40
9475,2023-01-08,FANG,heist,Snaked Assault,0,7,6,13
9476,2023-01-08,FANG,gemGrab,Hard Rock Mine,0,2,1,3
9477,2023-01-08,FANG,gemGrab,Double Swoosh,0,5,1,6
9478,2023-01-08,FANG,brawlBall,Super Beach,0,5,3,8
9479,2023-01-08,FANG,brawlBall,Backyard Bowl,2,57,77,136
9480,2023-01-08,FANG,bounty,Layer Cake,0,7,2,9
9481,2023-01-07,FANG,knockout,X Marks the Spot,0,10,21,31
9482,2023-01-07,FANG,hotZone,Ring of Fire,0,6,2,8
9483,2023-01-07,FANG,heist,Tornado Ring,0,2,0,2
9484,2023-01-07,FANG,gemGrab,Hard Rock Mine,0,4,1,5
9485,2023-01-07,FANG,gemGrab,Deep Diner,0,5,1,6
9486,2023-01-07,FANG,brawlBall,Super Beach,0,31,30,61
9487,2023-01-07,FANG,brawlBall,Sneaky Fields,0,1,0,1
9488,2023-01-07,FANG,bounty,Dry Season,0,15,16,31
9489,2023-01-06,FANG,knockout,Out in the Open,0,7,1,8
9490,2023-01-06,FANG,hotZone,Split,0,1,5,6
9491,2023-01-06,FANG,heist,Tornado Ring,0,1,0,1
9492,2023-01-06,FANG,gemGrab,Undermine,0,1,0,1
9493,2023-01-06,FANG,gemGrab,Deep Diner,0,12,6,18
9494,2023-01-06,FANG,brawlBall,Sneaky Fields,0,22,14,36
9495,2023-01-06,FANG,bounty,Dry Season,0,23,38,61
9496,2023-01-05,FANG,knockout,Out in the Open,0,22,12,34
9497,2023-01-05,FANG,hotZone,Split,0,7,0,7
9498,2023-01-05,FANG,heist,Kaboom Canyon,0,4,0,4
9499,2023-01-05,FANG,gemGrab,Undermine,0,19,33,52
9500,2023-01-05,FANG,gemGrab,Gem Fort,0,3,1,4
9501,2023-01-05,FANG,brawlBall,Pinhole Punt,1,63,20,84
9502,2023-01-05,FANG,bounty,Shooting Star,0,18,28,46
9503,2023-01-04,FANG,knockout,Goldarm Gulch,0,12,4,16
9504,2023-01-04,FANG,hotZone,Parallel Plays,0,1,0,1
9505,2023-01-04,FANG,heist,Kaboom Canyon,0,6,3,9
9506,2023-01-04,FANG,gemGrab,Gem Fort,0,9,1,10
9507,2023-01-04,FANG,gemGrab,Crystal Arcade,0,10,15,25
9508,2023-01-04,FANG,brawlBall,Sunny Soccer,0,31,54,85
9509,2023-01-04,FANG,bounty,Shooting Star,0,27,43,70
9510,2023-01-03,FANG,knockout,Goldarm Gulch,0,13,24,37
9511,2023-01-03,FANG,hotZone,Parallel Plays,1,4,2,7
9512,2023-01-03,FANG,heist,Pit Stop,0,1,0,1
9513,2023-01-03,FANG,gemGrab,Minecart Madness,0,2,0,2
9514,2023-01-03,FANG,gemGrab,Crystal Arcade,0,13,5,18
9515,2023-01-03,FANG,brawlBall,Center Stage,0,2,0,2
9516,2023-01-03,FANG,brawlBall,Beach Ball,1,48,34,83
9517,2023-01-03,FANG,bounty,Hideout,0,10,5,15
9518,2023-01-02,FANG,knockout,Belle's Rock,0,17,4,21
9519,2023-01-02,FANG,hotZone,Quarter Pounder,0,9,4,13
9520,2023-01-02,FANG,heist,Pit Stop,0,3,0,3
9521,2023-01-02,FANG,gemGrab,Minecart Madness,0,17,24,41
9522,2023-01-02,FANG,gemGrab,Double Swoosh,0,8,6,14
9523,2023-01-02,FANG,brawlBall,Center Stage,0,42,19,61
9524,2023-01-02,FANG,brawlBall,Backyard Bowl,0,5,1,6
9525,2023-01-02,FANG,bounty,Hideout,0,26,36,62
9526,2023-01-01,FANG,knockout,Belle's Rock,0,13,20,33
9527,2023-01-01,FANG,hotZone,Quarter Pounder,0,2,0,2
9528,2023-01-01,FANG,gemGrab,Hard Rock Mine,0,2,0,2
9529,2023-01-01,FANG,gemGrab,Double Swoosh,0,7,1,8
9530,2023-01-01,FANG,brawlBall,Backyard Bowl,0,29,20,49
9531,2023-01-01,FANG,bounty,Canal Grande,0,1,1,2
9532,2022-12-31,FANG,gemGrab,Hard Rock Mine,0,4,1,5
9533,2022-12-31,FANG,gemGrab,Deep Diner,0,1,2,3
9534,2022-12-31,FANG,brawlBall,Super Beach,0,5,4,9
9535,2022-12-30,FANG,knockout,Flaring Phoenix,0,0,1,1
9536,2022-12-30,FANG,hotZone,Controller Chaos,0,1,0,1
9537,2022-12-30,FANG,gemGrab,Undermine,0,1,0,1
9538,2022-12-30,FANG,gemGrab,Deep Diner,0,3,1,4
9539,2022-12-30,FANG,brawlBall,Sneaky Fields,0,3,1,4
9540,2022-12-29,FANG,hotZone,Open Zone,0,1,0,1
9541,2022-12-29,FANG,gemGrab,Undermine,0,1,0,1
9542,2022-12-27,FANG,hotZone,Dueling Beetles,0,0,1,1
9543,2022-12-26,FANG,hotZone,Controller Chaos,0,1,0,1
9544,2022-12-24,FANG,bounty,Dry Season,0,1,1,2
9545,2022-12-23,FANG,knockout,Out in the Open,0,1,0,1
9546,2022-12-22,FANG,brawlBall,Pinhole Punt,0,1,5,6
9547,2022-12-21,FANG,brawlBall,Sunny Soccer,0,0,1,1
9548,2022-12-21,FANG,bounty,Shooting Star,0,1,0,1
9549,2022-12-20,FANG,brawlBall,Beach Ball,0,0,1,1
9550,2022-12-19,FANG,brawlBall,Center Stage,0,2,2,4
9551,2022-12-16,FANG,gemGrab,Undermine,0,0,1,1
9552,2022-12-16,FANG,brawlBall,Sneaky Fields,0,1,2,3
9553,2022-12-13,FANG,heist,Safe Zone,0,0,1,1
9554,2022-12-13,FANG,brawlBall,Beach Ball,0,2,5,7
9555,2022-11-11,FANG,knockout,New Perspective,0,0,2,2
9556,2022-10-28,FANG,hotZone,Dueling Beetles,0,1,0,1
9557,2022-10-26,FANG,brawlBall,Sunny Soccer,0,1,2,3
9558,2022-10-15,FANG,hotZone,Ring of Fire,0,1,0,1
9559,2022-10-15,FANG,gemGrab,Hard Rock Mine,0,1,0,1
9560,2022-10-15,FANG,bounty,Dry Season,0,0,1,1
9561,2022-10-10,FANG,knockout,Belle's Rock,0,2,0,2
9562,2023-01-30,EVE,knockout,Belle's Rock,0,86,81,167
9563,2023-01-30,EVE,hotZone,Quarter Pounder,1,29,10,40
9564,2023-01-30,EVE,heist,Pit Stop,0,3,0,3
9565,2023-01-30,EVE,gemGrab,Minecart Madness,0,16,28,44
9566,2023-01-30,EVE,gemGrab,Double Swoosh,0,16,18,34
9567,2023-01-30,EVE,brawlBall,Center Stage,1,33,44,78
9568,2023-01-30,EVE,brawlBall,Backyard Bowl,0,10,16,26
9569,2023-01-30,EVE,bounty,Hideout,0,9,15,24
9570,2023-01-29,EVE,knockout,Belle's Rock,0,54,50,104
9571,2023-01-29,EVE,hotZone,Quarter Pounder,0,16,9,25
9572,2023-01-29,EVE,heist,Bridge Too Far,3,175,179,357
9573,2023-01-29,EVE,gemGrab,Hard Rock Mine,0,11,2,13
9574,2023-01-29,EVE,gemGrab,Double Swoosh,0,38,47,85
9575,2023-01-29,EVE,brawlBall,Super Beach,0,1,0,1
9576,2023-01-29,EVE,brawlBall,Backyard Bowl,6,141,158,305
9577,2023-01-29,EVE,bounty,Canal Grande,0,230,320,550
9578,2023-01-28,EVE,knockout,Flaring Phoenix,0,27,23,50
9579,2023-01-28,EVE,hotZone,Controller Chaos,0,12,6,18
9580,2023-01-28,EVE,heist,Bridge Too Far,3,442,546,991
9581,2023-01-28,EVE,gemGrab,Hard Rock Mine,0,26,32,58
9582,2023-01-28,EVE,gemGrab,Deep Diner,0,14,24,38
9583,2023-01-28,EVE,brawlBall,Super Beach,0,56,66,122
9584,2023-01-28,EVE,brawlBall,Sneaky Fields,0,1,0,1
9585,2023-01-28,EVE,bounty,Canal Grande,0,530,680,1210
9586,2023-01-27,EVE,knockout,Flaring Phoenix,0,17,9,26
9587,2023-01-27,EVE,hotZone,Controller Chaos,0,5,5,10
9588,2023-01-27,EVE,heist,Hot Potato,0,1,0,1
9589,2023-01-27,EVE,gemGrab,Undermine,0,2,3,5
9590,2023-01-27,EVE,gemGrab,Deep Diner,0,17,11,28
9591,2023-01-27,EVE,brawlBall,Sneaky Fields,2,20,19,41
9592,2023-01-27,EVE,brawlBall,Pinhole Punt,0,1,1,2
9593,2023-01-27,EVE,bounty,Temple Ruins,0,9,3,12
9594,2023-01-26,EVE,knockout,Riverside,0,743,1125,1868
9595,2023-01-26,EVE,hotZone,Open Zone,0,30,15,45
9596,2023-01-26,EVE,heist,Hot Potato,0,7,4,11
9597,2023-01-26,EVE,gemGrab,Undermine,0,44,57,101
9598,2023-01-26,EVE,gemGrab,Gem Fort,0,16,10,26
9599,2023-01-26,EVE,brawlBall,Sunny Soccer,0,3,2,5
9600,2023-01-26,EVE,brawlBall,Pinhole Punt,0,127,106,233
9601,2023-01-26,EVE,bounty,Temple Ruins,0,17,27,44
9602,2023-01-25,EVE,knockout,Riverside,0,526,700,1226
9603,2023-01-25,EVE,hotZone,Open Zone,0,10,3,13
9604,2023-01-25,EVE,heist,Safe Zone,0,112,105,217
9605,2023-01-25,EVE,gemGrab,Gem Fort,0,18,17,35
9606,2023-01-25,EVE,gemGrab,Crystal Arcade,0,34,25,59
9607,2023-01-25,EVE,brawlBall,Sunny Soccer,0,34,69,103
9608,2023-01-25,EVE,brawlBall,Beach Ball,2,13,15,30
9609,2023-01-25,EVE,bounty,Excel,0,10,6,16
9610,2023-01-24,EVE,knockout,New Perspective,0,51,56,107
9611,2023-01-24,EVE,hotZone,Dueling Beetles,0,18,16,34
9612,2023-01-24,EVE,heist,Safe Zone,1,149,212,362
9613,2023-01-24,EVE,gemGrab,Minecart Madness,0,15,15,30
9614,2023-01-24,EVE,gemGrab,Crystal Arcade,0,31,35,66
9615,2023-01-24,EVE,brawlBall,Center Stage,0,18,16,34
9616,2023-01-24,EVE,brawlBall,Beach Ball,0,61,73,134
9617,2023-01-24,EVE,bounty,Excel,0,26,13,39
9618,2023-01-23,EVE,knockout,New Perspective,0,59,47,106
9619,2023-01-23,EVE,hotZone,Dueling Beetles,0,16,10,26
9620,2023-01-23,EVE,heist,Snaked Assault,0,18,10,28
9621,2023-01-23,EVE,gemGrab,Minecart Madness,0,45,37,82
9622,2023-01-23,EVE,gemGrab,Double Swoosh,0,21,12,33
9623,2023-01-23,EVE,brawlBall,Center Stage,3,80,76,159
9624,2023-01-23,EVE,brawlBall,Backyard Bowl,0,8,5,13
9625,2023-01-23,EVE,bounty,Layer Cake,0,31,42,73
9626,2023-01-22,EVE,knockout,X Marks the Spot,0,41,33,74
9627,2023-01-22,EVE,hotZone,Ring of Fire,0,16,12,28
9628,2023-01-22,EVE,heist,Snaked Assault,0,6,6,12
9629,2023-01-22,EVE,gemGrab,Hard Rock Mine,0,21,16,37
9630,2023-01-22,EVE,gemGrab,Double Swoosh,0,21,12,33
9631,2023-01-22,EVE,brawlBall,Super Beach,0,5,9,14
9632,2023-01-22,EVE,brawlBall,Backyard Bowl,3,70,100,173
9633,2023-01-22,EVE,bounty,Layer Cake,0,15,27,42
9634,2023-01-21,EVE,knockout,X Marks the Spot,0,129,172,301
9635,2023-01-21,EVE,hotZone,Ring of Fire,1,43,34,78
9636,2023-01-21,EVE,heist,Tornado Ring,0,6,6,12
9637,2023-01-21,EVE,gemGrab,Hard Rock Mine,0,63,60,123
9638,2023-01-21,EVE,gemGrab,Deep Diner,0,19,11,30
9639,2023-01-21,EVE,brawlBall,Super Beach,1,65,78,144
9640,2023-01-21,EVE,brawlBall,Sneaky Fields,0,1,1,2
9641,2023-01-21,EVE,bounty,Dry Season,0,86,57,143
9642,2023-01-20,EVE,knockout,Out in the Open,1,284,359,644
9643,2023-01-20,EVE,hotZone,Split,0,7,4,11
9644,2023-01-20,EVE,heist,Tornado Ring,0,11,4,15
9645,2023-01-20,EVE,gemGrab,Undermine,0,14,19,33
9646,2023-01-20,EVE,gemGrab,Deep Diner,0,63,57,120
9647,2023-01-20,EVE,brawlBall,Sneaky Fields,0,39,34,73
9648,2023-01-20,EVE,brawlBall,Pinhole Punt,0,0,6,6
9649,2023-01-20,EVE,bounty,Dry Season,0,43,47,90
9650,2023-01-19,EVE,knockout,Out in the Open,0,289,319,608
9651,2023-01-19,EVE,hotZone,Split,0,8,8,16
9652,2023-01-19,EVE,heist,Kaboom Canyon,1,62,74,137
9653,2023-01-19,EVE,gemGrab,Undermine,0,49,35,84
9654,2023-01-19,EVE,gemGrab,Gem Fort,0,10,7,17
9655,2023-01-19,EVE,brawlBall,Sunny Soccer,0,1,2,3
9656,2023-01-19,EVE,brawlBall,Pinhole Punt,6,110,103,219
9657,2023-01-19,EVE,bounty,Shooting Star,0,75,62,137
9658,2023-01-18,EVE,knockout,Goldarm Gulch,1,15,14,30
9659,2023-01-18,EVE,hotZone,Parallel Plays,0,3,3,6
9660,2023-01-18,EVE,heist,Kaboom Canyon,0,28,21,49
9661,2023-01-18,EVE,gemGrab,Gem Fort,0,15,7,22
9662,2023-01-18,EVE,gemGrab,Crystal Arcade,0,5,4,9
9663,2023-01-18,EVE,brawlBall,Sunny Soccer,2,26,27,55
9664,2023-01-18,EVE,brawlBall,Beach Ball,0,2,1,3
9665,2023-01-18,EVE,bounty,Shooting Star,0,22,31,53
9666,2023-01-17,EVE,knockout,Goldarm Gulch,0,13,8,21
9667,2023-01-17,EVE,hotZone,Parallel Plays,0,5,4,9
9668,2023-01-17,EVE,gemGrab,Minecart Madness,0,1,0,1
9669,2023-01-17,EVE,gemGrab,Crystal Arcade,0,6,5,11
9670,2023-01-17,EVE,brawlBall,Beach Ball,0,8,5,13
9671,2023-01-17,EVE,bounty,Hideout,0,3,2,5
9672,2023-01-16,EVE,knockout,Belle's Rock,0,4,2,6
9673,2023-01-16,EVE,hotZone,Quarter Pounder,0,3,0,3
9674,2023-01-16,EVE,gemGrab,Minecart Madness,0,4,10,14
9675,2023-01-16,EVE,gemGrab,Double Swoosh,0,1,0,1
9676,2023-01-16,EVE,brawlBall,Center Stage,0,3,1,4
9677,2023-01-16,EVE,brawlBall,Backyard Bowl,0,2,0,2
9678,2023-01-16,EVE,bounty,Hideout,0,2,3,5
9679,2023-01-15,EVE,knockout,Belle's Rock,0,5,3,8
9680,2023-01-15,EVE,hotZone,Quarter Pounder,0,6,1,7
9681,2023-01-15,EVE,heist,Bridge Too Far,0,40,44,84
9682,2023-01-15,EVE,gemGrab,Hard Rock Mine,0,0,2,2
9683,2023-01-15,EVE,gemGrab,Double Swoosh,0,2,2,4
9684,2023-01-15,EVE,brawlBall,Backyard Bowl,2,14,8,24
9685,2023-01-15,EVE,bounty,Canal Grande,0,42,38,80
9686,2023-01-14,EVE,knockout,Flaring Phoenix,0,7,14,21
9687,2023-01-14,EVE,hotZone,Controller Chaos,0,4,0,4
9688,2023-01-14,EVE,heist,Bridge Too Far,0,95,133,228
9689,2023-01-14,EVE,gemGrab,Deep Diner,0,2,0,2
9690,2023-01-14,EVE,brawlBall,Super Beach,0,8,17,25
9691,2023-01-14,EVE,bounty,Canal Grande,0,57,82,139
9692,2023-01-13,EVE,knockout,Flaring Phoenix,0,4,0,4
9693,2023-01-13,EVE,hotZone,Controller Chaos,0,5,1,6
9694,2023-01-13,EVE,gemGrab,Deep Diner,0,3,6,9
9695,2023-01-13,EVE,brawlBall,Sneaky Fields,0,6,0,6
9696,2023-01-13,EVE,bounty,Temple Ruins,0,0,1,1
9697,2023-01-12,EVE,knockout,Riverside,0,135,244,379
9698,2023-01-12,EVE,hotZone,Open Zone,0,3,0,3
9699,2023-01-12,EVE,gemGrab,Undermine,0,1,0,1
9700,2023-01-12,EVE,brawlBall,Sunny Soccer,0,0,1,1
9701,2023-01-12,EVE,brawlBall,Pinhole Punt,0,4,21,25
9702,2023-01-11,EVE,knockout,Riverside,0,50,72,122
9703,2023-01-11,EVE,hotZone,Open Zone,0,1,0,1
9704,2023-01-11,EVE,heist,Safe Zone,0,1,1,2
9705,2023-01-11,EVE,gemGrab,Gem Fort,0,2,1,3
9706,2023-01-11,EVE,brawlBall,Sunny Soccer,0,2,0,2
9707,2023-01-11,EVE,bounty,Excel,0,1,0,1
9708,2023-01-10,EVE,knockout,New Perspective,0,1,2,3
9709,2023-01-10,EVE,hotZone,Dueling Beetles,0,1,4,5
9710,2023-01-10,EVE,heist,Safe Zone,0,20,5,25
9711,2023-01-10,EVE,gemGrab,Minecart Madness,0,1,0,1
9712,2023-01-10,EVE,gemGrab,Crystal Arcade,0,3,1,4
9713,2023-01-10,EVE,brawlBall,Beach Ball,0,6,8,14
9714,2023-01-09,EVE,knockout,New Perspective,0,1,0,1
9715,2023-01-09,EVE,hotZone,Dueling Beetles,0,2,0,2
9716,2023-01-09,EVE,heist,Snaked Assault,0,5,2,7
9717,2023-01-09,EVE,gemGrab,Minecart Madness,0,3,5,8
9718,2023-01-09,EVE,gemGrab,Double Swoosh,0,1,0,1
9719,2023-01-09,EVE,brawlBall,Center Stage,0,9,8,17
9720,2023-01-09,EVE,bounty,Layer Cake,0,2,1,3
9721,2023-01-08,EVE,knockout,X Marks the Spot,0,4,2,6
9722,2023-01-08,EVE,hotZone,Ring of Fire,0,3,5,8
9723,2023-01-08,EVE,heist,Snaked Assault,0,1,0,1
9724,2023-01-08,EVE,brawlBall,Backyard Bowl,0,5,1,6
9725,2023-01-08,EVE,bounty,Layer Cake,0,2,1,3
9726,2023-01-07,EVE,knockout,X Marks the Spot,0,7,5,12
9727,2023-01-07,EVE,hotZone,Ring of Fire,0,1,0,1
9728,2023-01-07,EVE,brawlBall,Super Beach,0,2,0,2
9729,2023-01-07,EVE,brawlBall,Sneaky Fields,0,1,3,4
9730,2023-01-07,EVE,bounty,Dry Season,0,5,3,8
9731,2023-01-06,EVE,knockout,Out in the Open,0,19,15,34
9732,2023-01-06,EVE,hotZone,Split,0,2,0,2
9733,2023-01-06,EVE,heist,Tornado Ring,0,5,0,5
9734,2023-01-06,EVE,gemGrab,Undermine,0,3,0,3
9735,2023-01-06,EVE,gemGrab,Deep Diner,0,3,0,3
9736,2023-01-06,EVE,brawlBall,Sneaky Fields,0,3,10,13
9737,2023-01-06,EVE,bounty,Dry Season,0,5,12,17
9738,2023-01-05,EVE,knockout,Out in the Open,0,39,30,69
9739,2023-01-05,EVE,hotZone,Split,0,2,1,3
9740,2023-01-05,EVE,heist,Kaboom Canyon,0,6,5,11
9741,2023-01-05,EVE,gemGrab,Undermine,0,2,1,3
9742,2023-01-05,EVE,brawlBall,Pinhole Punt,0,9,18,27
9743,2023-01-05,EVE,bounty,Shooting Star,0,4,3,7
9744,2023-01-04,EVE,knockout,Goldarm Gulch,0,3,1,4
9745,2023-01-04,EVE,hotZone,Parallel Plays,0,1,0,1
9746,2023-01-04,EVE,heist,Kaboom Canyon,0,14,17,31
9747,2023-01-04,EVE,gemGrab,Gem Fort,0,1,6,7
9748,2023-01-04,EVE,gemGrab,Crystal Arcade,0,3,12,15
9749,2023-01-04,EVE,brawlBall,Sunny Soccer,0,2,0,2
9750,2023-01-04,EVE,bounty,Shooting Star,0,17,28,45
9751,2023-01-03,EVE,knockout,Goldarm Gulch,0,4,6,10
9752,2023-01-03,EVE,hotZone,Parallel Plays,0,1,0,1
9753,2023-01-03,EVE,heist,Pit Stop,0,1,0,1
9754,2023-01-03,EVE,heist,Kaboom Canyon,0,0,1,1
9755,2023-01-03,EVE,gemGrab,Crystal Arcade,0,6,0,6
9756,2023-01-03,EVE,brawlBall,Center Stage,0,1,4,5
9757,2023-01-03,EVE,brawlBall,Beach Ball,0,7,2,9
9758,2023-01-03,EVE,bounty,Hideout,0,3,1,4
9759,2023-01-02,EVE,knockout,Belle's Rock,0,10,14,24
9760,2023-01-02,EVE,hotZone,Quarter Pounder,0,3,2,5
9761,2023-01-02,EVE,gemGrab,Minecart Madness,0,13,0,13
9762,2023-01-02,EVE,brawlBall,Center Stage,0,7,2,9
9763,2023-01-02,EVE,brawlBall,Backyard Bowl,0,0,1,1
9764,2023-01-02,EVE,bounty,Hideout,0,11,1,12
9765,2023-01-01,EVE,knockout,Belle's Rock,0,1,0,1
9766,2023-01-01,EVE,hotZone,Quarter Pounder,0,4,0,4
9767,2023-01-01,EVE,heist,Bridge Too Far,0,9,11,20
9768,2023-01-01,EVE,gemGrab,Double Swoosh,0,3,0,3
9769,2023-01-01,EVE,brawlBall,Backyard Bowl,0,10,53,63
9770,2023-01-01,EVE,bounty,Canal Grande,0,3,5,8
9771,2022-12-31,EVE,heist,Bridge Too Far,0,4,6,10
9772,2022-12-31,EVE,gemGrab,Hard Rock Mine,0,2,0,2
9773,2022-12-31,EVE,bounty,Canal Grande,0,1,0,1
9774,2022-12-30,EVE,gemGrab,Deep Diner,0,1,0,1
9775,2022-12-28,EVE,hotZone,Controller Chaos,0,1,0,1
9776,2022-12-27,EVE,knockout,New Perspective,0,1,0,1
9777,2022-12-23,EVE,knockout,Out in the Open,0,0,2,2
9778,2022-12-13,EVE,knockout,New Perspective,0,1,0,1
9779,2022-12-13,EVE,heist,Safe Zone,0,1,0,1
9780,2022-12-13,EVE,gemGrab,Crystal Arcade,0,1,7,8
9781,2022-11-11,EVE,brawlBall,Sneaky Fields,0,1,0,1
9782,2022-10-30,EVE,knockout,Out in the Open,0,1,0,1
9783,2022-10-28,EVE,knockout,Out in the Open,0,0,1,1
9784,2022-10-28,EVE,heist,Safe Zone,0,0,1,1
9785,2022-10-15,EVE,hotZone,Ring of Fire,0,2,2,4
9786,2023-01-30,EMZ,knockout,Belle's Rock,0,22,16,38
9787,2023-01-30,EMZ,hotZone,Quarter Pounder,0,217,71,288
9788,2023-01-30,EMZ,heist,Pit Stop,0,131,147,278
9789,2023-01-30,EMZ,gemGrab,Minecart Madness,0,68,42,110
9790,2023-01-30,EMZ,gemGrab,Double Swoosh,0,226,244,470
9791,2023-01-30,EMZ,brawlBall,Center Stage,16,395,489,900
9792,2023-01-30,EMZ,brawlBall,Backyard Bowl,1,21,9,31
9793,2023-01-30,EMZ,bounty,Hideout,0,1,3,4
9794,2023-01-29,EMZ,knockout,Belle's Rock,0,21,1,22
9795,2023-01-29,EMZ,hotZone,Quarter Pounder,0,149,70,219
9796,2023-01-29,EMZ,heist,Bridge Too Far,0,22,6,28
9797,2023-01-29,EMZ,gemGrab,Hard Rock Mine,0,14,19,33
9798,2023-01-29,EMZ,gemGrab,Double Swoosh,0,395,390,785
9799,2023-01-29,EMZ,brawlBall,Super Beach,0,4,5,9
9800,2023-01-29,EMZ,brawlBall,Backyard Bowl,7,214,134,355
9801,2023-01-29,EMZ,bounty,Canal Grande,0,29,18,47
9802,2023-01-28,EMZ,knockout,Flaring Phoenix,0,28,16,44
9803,2023-01-28,EMZ,hotZone,Controller Chaos,0,252,285,537
9804,2023-01-28,EMZ,heist,Bridge Too Far,0,36,12,48
9805,2023-01-28,EMZ,gemGrab,Hard Rock Mine,0,109,69,178
9806,2023-01-28,EMZ,gemGrab,Deep Diner,0,23,29,52
9807,2023-01-28,EMZ,brawlBall,Super Beach,16,467,564,1047
9808,2023-01-28,EMZ,brawlBall,Sneaky Fields,3,44,57,104
9809,2023-01-28,EMZ,bounty,Canal Grande,0,49,30,79
9810,2023-01-27,EMZ,knockout,Flaring Phoenix,0,8,4,12
9811,2023-01-27,EMZ,hotZone,Controller Chaos,0,50,81,131
9812,2023-01-27,EMZ,heist,Hot Potato,1,39,46,86
9813,2023-01-27,EMZ,gemGrab,Undermine,0,12,8,20
9814,2023-01-27,EMZ,gemGrab,Deep Diner,0,37,25,62
9815,2023-01-27,EMZ,brawlBall,Sneaky Fields,6,203,260,469
9816,2023-01-27,EMZ,brawlBall,Pinhole Punt,0,6,6,12
9817,2023-01-27,EMZ,bounty,Temple Ruins,0,7,15,22
9818,2023-01-26,EMZ,knockout,Riverside,0,22,7,29
9819,2023-01-26,EMZ,hotZone,Open Zone,0,74,36,110
9820,2023-01-26,EMZ,heist,Hot Potato,1,482,564,1047
9821,2023-01-26,EMZ,gemGrab,Undermine,0,157,134,291
9822,2023-01-26,EMZ,gemGrab,Gem Fort,0,46,51,97
9823,2023-01-26,EMZ,brawlBall,Sunny Soccer,0,22,11,33
9824,2023-01-26,EMZ,brawlBall,Pinhole Punt,18,494,505,1017
9825,2023-01-26,EMZ,bounty,Temple Ruins,0,35,26,61
9826,2023-01-25,EMZ,knockout,Riverside,0,16,2,18
9827,2023-01-25,EMZ,hotZone,Open Zone,0,33,23,56
9828,2023-01-25,EMZ,heist,Safe Zone,0,30,9,39
9829,2023-01-25,EMZ,gemGrab,Gem Fort,0,66,62,128
9830,2023-01-25,EMZ,gemGrab,Crystal Arcade,0,90,71,161
9831,2023-01-25,EMZ,brawlBall,Sunny Soccer,11,281,311,603
9832,2023-01-25,EMZ,brawlBall,Beach Ball,5,29,21,55
9833,2023-01-25,EMZ,bounty,Excel,0,10,2,12
9834,2023-01-24,EMZ,knockout,New Perspective,0,30,16,46
9835,2023-01-24,EMZ,hotZone,Dueling Beetles,0,133,87,220
9836,2023-01-24,EMZ,heist,Safe Zone,0,46,26,72
9837,2023-01-24,EMZ,gemGrab,Minecart Madness,0,25,5,30
9838,2023-01-24,EMZ,gemGrab,Crystal Arcade,0,123,105,228
9839,2023-01-24,EMZ,brawlBall,Center Stage,5,68,78,151
9840,2023-01-24,EMZ,brawlBall,Beach Ball,9,394,385,788
9841,2023-01-24,EMZ,bounty,Excel,0,12,6,18
9842,2023-01-23,EMZ,knockout,New Perspective,0,46,29,75
9843,2023-01-23,EMZ,hotZone,Dueling Beetles,0,220,88,308
9844,2023-01-23,EMZ,heist,Snaked Assault,1,574,807,1382
9845,2023-01-23,EMZ,gemGrab,Minecart Madness,0,107,52,159
9846,2023-01-23,EMZ,gemGrab,Double Swoosh,0,181,147,328
9847,2023-01-23,EMZ,brawlBall,Center Stage,17,614,708,1339
9848,2023-01-23,EMZ,brawlBall,Backyard Bowl,0,15,5,20
9849,2023-01-23,EMZ,bounty,Layer Cake,0,33,8,41
9850,2023-01-22,EMZ,knockout,X Marks the Spot,0,17,8,25
9851,2023-01-22,EMZ,hotZone,Ring of Fire,0,61,53,114
9852,2023-01-22,EMZ,heist,Snaked Assault,2,312,425,739
9853,2023-01-22,EMZ,gemGrab,Hard Rock Mine,0,24,15,39
9854,2023-01-22,EMZ,gemGrab,Double Swoosh,0,196,203,399
9855,2023-01-22,EMZ,brawlBall,Super Beach,1,43,49,93
9856,2023-01-22,EMZ,brawlBall,Backyard Bowl,6,96,59,161
9857,2023-01-22,EMZ,bounty,Layer Cake,0,11,4,15
9858,2023-01-21,EMZ,knockout,X Marks the Spot,0,55,22,77
9859,2023-01-21,EMZ,hotZone,Ring of Fire,0,162,109,271
9860,2023-01-21,EMZ,heist,Tornado Ring,3,534,767,1304
9861,2023-01-21,EMZ,gemGrab,Hard Rock Mine,0,143,65,208
9862,2023-01-21,EMZ,gemGrab,Deep Diner,0,47,22,69
9863,2023-01-21,EMZ,brawlBall,Super Beach,22,677,687,1386
9864,2023-01-21,EMZ,brawlBall,Sneaky Fields,0,24,33,57
9865,2023-01-21,EMZ,bounty,Dry Season,0,11,4,15
9866,2023-01-20,EMZ,knockout,Out in the Open,0,44,14,58
9867,2023-01-20,EMZ,hotZone,Split,0,52,34,86
9868,2023-01-20,EMZ,heist,Tornado Ring,7,709,942,1658
9869,2023-01-20,EMZ,gemGrab,Undermine,0,52,42,94
9870,2023-01-20,EMZ,gemGrab,Deep Diner,0,157,98,255
9871,2023-01-20,EMZ,brawlBall,Sneaky Fields,32,762,1001,1795
9872,2023-01-20,EMZ,brawlBall,Pinhole Punt,0,23,36,59
9873,2023-01-20,EMZ,bounty,Dry Season,0,11,4,15
9874,2023-01-19,EMZ,knockout,Out in the Open,0,61,27,88
9875,2023-01-19,EMZ,hotZone,Split,0,76,44,120
9876,2023-01-19,EMZ,heist,Kaboom Canyon,0,24,20,44
9877,2023-01-19,EMZ,gemGrab,Undermine,0,255,271,526
9878,2023-01-19,EMZ,gemGrab,Gem Fort,0,42,26,68
9879,2023-01-19,EMZ,brawlBall,Sunny Soccer,0,11,9,20
9880,2023-01-19,EMZ,brawlBall,Pinhole Punt,15,478,498,991
9881,2023-01-19,EMZ,bounty,Shooting Star,0,10,4,14
9882,2023-01-18,EMZ,knockout,Goldarm Gulch,0,5,2,7
9883,2023-01-18,EMZ,hotZone,Parallel Plays,0,13,8,21
9884,2023-01-18,EMZ,heist,Kaboom Canyon,0,8,1,9
9885,2023-01-18,EMZ,gemGrab,Gem Fort,0,40,38,78
9886,2023-01-18,EMZ,gemGrab,Crystal Arcade,0,12,3,15
9887,2023-01-18,EMZ,brawlBall,Sunny Soccer,0,125,144,269
9888,2023-01-18,EMZ,brawlBall,Beach Ball,0,0,4,4
9889,2023-01-18,EMZ,bounty,Shooting Star,0,6,1,7
9890,2023-01-17,EMZ,knockout,Goldarm Gulch,0,3,3,6
9891,2023-01-17,EMZ,hotZone,Parallel Plays,0,13,13,26
9892,2023-01-17,EMZ,heist,Pit Stop,0,10,7,17
9893,2023-01-17,EMZ,gemGrab,Minecart Madness,0,1,0,1
9894,2023-01-17,EMZ,gemGrab,Crystal Arcade,0,14,16,30
9895,2023-01-17,EMZ,brawlBall,Center Stage,0,1,1,2
9896,2023-01-17,EMZ,brawlBall,Beach Ball,0,31,24,55
9897,2023-01-17,EMZ,bounty,Hideout,0,1,0,1
9898,2023-01-16,EMZ,knockout,Belle's Rock,0,2,0,2
9899,2023-01-16,EMZ,hotZone,Quarter Pounder,0,18,18,36
9900,2023-01-16,EMZ,heist,Pit Stop,0,47,68,115
9901,2023-01-16,EMZ,gemGrab,Minecart Madness,0,3,3,6
9902,2023-01-16,EMZ,gemGrab,Double Swoosh,0,12,14,26
9903,2023-01-16,EMZ,brawlBall,Center Stage,3,36,45,84
9904,2023-01-16,EMZ,brawlBall,Backyard Bowl,0,2,4,6
9905,2023-01-16,EMZ,bounty,Hideout,0,1,0,1
9906,2023-01-15,EMZ,knockout,Belle's Rock,0,1,1,2
9907,2023-01-15,EMZ,hotZone,Quarter Pounder,0,40,20,60
9908,2023-01-15,EMZ,heist,Bridge Too Far,0,3,0,3
9909,2023-01-15,EMZ,gemGrab,Hard Rock Mine,0,8,2,10
9910,2023-01-15,EMZ,gemGrab,Double Swoosh,0,46,38,84
9911,2023-01-15,EMZ,brawlBall,Super Beach,0,4,3,7
9912,2023-01-15,EMZ,brawlBall,Backyard Bowl,2,24,5,31
9913,2023-01-15,EMZ,bounty,Canal Grande,0,5,1,6
9914,2023-01-14,EMZ,knockout,Flaring Phoenix,0,2,1,3
9915,2023-01-14,EMZ,hotZone,Controller Chaos,0,76,67,143
9916,2023-01-14,EMZ,heist,Bridge Too Far,0,3,1,4
9917,2023-01-14,EMZ,gemGrab,Hard Rock Mine,0,7,1,8
9918,2023-01-14,EMZ,gemGrab,Deep Diner,0,5,1,6
9919,2023-01-14,EMZ,brawlBall,Super Beach,1,41,27,69
9920,2023-01-14,EMZ,brawlBall,Sneaky Fields,0,16,6,22
9921,2023-01-14,EMZ,bounty,Canal Grande,0,3,3,6
9922,2023-01-13,EMZ,hotZone,Controller Chaos,0,86,85,171
9923,2023-01-13,EMZ,heist,Hot Potato,0,18,12,30
9924,2023-01-13,EMZ,gemGrab,Undermine,0,1,0,1
9925,2023-01-13,EMZ,gemGrab,Deep Diner,0,10,5,15
9926,2023-01-13,EMZ,brawlBall,Sneaky Fields,0,65,39,104
9927,2023-01-13,EMZ,bounty,Temple Ruins,0,2,0,2
9928,2023-01-12,EMZ,knockout,Riverside,0,1,0,1
9929,2023-01-12,EMZ,hotZone,Open Zone,0,17,0,17
9930,2023-01-12,EMZ,heist,Hot Potato,0,17,31,48
9931,2023-01-12,EMZ,gemGrab,Undermine,0,10,8,18
9932,2023-01-12,EMZ,gemGrab,Gem Fort,0,2,1,3
9933,2023-01-12,EMZ,brawlBall,Sunny Soccer,0,6,8,14
9934,2023-01-12,EMZ,brawlBall,Pinhole Punt,0,22,11,33
9935,2023-01-11,EMZ,hotZone,Open Zone,0,2,0,2
9936,2023-01-11,EMZ,heist,Safe Zone,0,1,0,1
9937,2023-01-11,EMZ,gemGrab,Gem Fort,0,7,9,16
9938,2023-01-11,EMZ,brawlBall,Sunny Soccer,0,15,14,29
9939,2023-01-10,EMZ,knockout,New Perspective,0,1,0,1
9940,2023-01-10,EMZ,hotZone,Dueling Beetles,0,41,8,49
9941,2023-01-10,EMZ,heist,Safe Zone,0,2,0,2
9942,2023-01-10,EMZ,gemGrab,Minecart Madness,0,7,6,13
9943,2023-01-10,EMZ,gemGrab,Crystal Arcade,0,16,4,20
9944,2023-01-10,EMZ,brawlBall,Center Stage,0,15,55,70
9945,2023-01-10,EMZ,brawlBall,Beach Ball,0,29,17,46
9946,2023-01-09,EMZ,knockout,New Perspective,0,4,1,5
9947,2023-01-09,EMZ,hotZone,Dueling Beetles,0,21,8,29
9948,2023-01-09,EMZ,heist,Snaked Assault,0,59,78,137
9949,2023-01-09,EMZ,gemGrab,Minecart Madness,0,10,7,17
9950,2023-01-09,EMZ,gemGrab,Double Swoosh,0,21,9,30
9951,2023-01-09,EMZ,brawlBall,Center Stage,1,52,144,197
9952,2023-01-09,EMZ,bounty,Layer Cake,0,5,0,5
9953,2023-01-08,EMZ,knockout,X Marks the Spot,0,4,0,4
9954,2023-01-08,EMZ,hotZone,Ring of Fire,0,11,4,15
9955,2023-01-08,EMZ,heist,Snaked Assault,0,67,45,112
9956,2023-01-08,EMZ,gemGrab,Hard Rock Mine,0,5,1,6
9957,2023-01-08,EMZ,gemGrab,Double Swoosh,0,21,13,34
9958,2023-01-08,EMZ,brawlBall,Super Beach,0,3,2,5
9959,2023-01-08,EMZ,brawlBall,Backyard Bowl,0,7,5,12
9960,2023-01-07,EMZ,knockout,X Marks the Spot,0,1,0,1
9961,2023-01-07,EMZ,hotZone,Ring of Fire,0,10,1,11
9962,2023-01-07,EMZ,heist,Tornado Ring,2,70,83,155
9963,2023-01-07,EMZ,gemGrab,Hard Rock Mine,0,6,1,7
9964,2023-01-07,EMZ,gemGrab,Deep Diner,0,7,4,11
9965,2023-01-07,EMZ,brawlBall,Super Beach,0,23,11,34
9966,2023-01-07,EMZ,brawlBall,Sneaky Fields,0,4,14,18
9967,2023-01-07,EMZ,bounty,Dry Season,0,1,0,1
9968,2023-01-06,EMZ,knockout,Out in the Open,0,2,2,4
9969,2023-01-06,EMZ,hotZone,Split,0,4,0,4
9970,2023-01-06,EMZ,heist,Tornado Ring,2,164,164,330
9971,2023-01-06,EMZ,gemGrab,Undermine,0,10,10,20
9972,2023-01-06,EMZ,gemGrab,Deep Diner,0,10,4,14
9973,2023-01-06,EMZ,brawlBall,Sneaky Fields,2,47,87,136
9974,2023-01-06,EMZ,brawlBall,Pinhole Punt,0,2,5,7
9975,2023-01-06,EMZ,bounty,Dry Season,0,1,0,1
9976,2023-01-05,EMZ,knockout,Out in the Open,0,5,0,5
9977,2023-01-05,EMZ,hotZone,Split,0,9,0,9
9978,2023-01-05,EMZ,heist,Kaboom Canyon,0,4,0,4
9979,2023-01-05,EMZ,gemGrab,Undermine,0,23,25,48
9980,2023-01-05,EMZ,gemGrab,Gem Fort,0,3,2,5
9981,2023-01-05,EMZ,brawlBall,Sunny Soccer,0,1,0,1
9982,2023-01-05,EMZ,brawlBall,Pinhole Punt,4,66,70,140
9983,2023-01-04,EMZ,knockout,Goldarm Gulch,0,3,0,3
9984,2023-01-04,EMZ,hotZone,Parallel Plays,0,12,3,15
9985,2023-01-04,EMZ,heist,Kaboom Canyon,0,14,0,14
9986,2023-01-04,EMZ,gemGrab,Gem Fort,0,21,15,36
9987,2023-01-04,EMZ,gemGrab,Crystal Arcade,0,9,5,14
9988,2023-01-04,EMZ,brawlBall,Sunny Soccer,3,47,98,148
9989,2023-01-04,EMZ,bounty,Shooting Star,0,1,0,1
9990,2023-01-03,EMZ,knockout,Goldarm Gulch,0,1,0,1
9991,2023-01-03,EMZ,hotZone,Parallel Plays,0,23,10,33
9992,2023-01-03,EMZ,heist,Pit Stop,0,12,20,32
9993,2023-01-03,EMZ,gemGrab,Minecart Madness,0,2,0,2
9994,2023-01-03,EMZ,gemGrab,Crystal Arcade,0,15,3,18
9995,2023-01-03,EMZ,brawlBall,Center Stage,0,4,10,14
9996,2023-01-03,EMZ,brawlBall,Beach Ball,0,41,46,87
9997,2023-01-03,EMZ,bounty,Hideout,0,2,1,3
9998,2023-01-02,EMZ,hotZone,Quarter Pounder,0,42,4,46
9999,2023-01-02,EMZ,hotZone,Controller Chaos,0,1,1,2
10000,2023-01-02,EMZ,heist,Pit Stop,0,42,37,79
10001,2023-01-02,EMZ,heist,Kaboom Canyon,0,0,1,1
10002,2023-01-02,EMZ,gemGrab,Minecart Madness,0,7,2,9
10003,2023-01-02,EMZ,gemGrab,Double Swoosh,0,25,29,54
10004,2023-01-02,EMZ,brawlBall,Center Stage,1,70,69,140
10005,2023-01-02,EMZ,brawlBall,Backyard Bowl,0,2,3,5
10006,2023-01-02,EMZ,bounty,Hideout,0,4,0,4
10007,2023-01-01,EMZ,hotZone,Quarter Pounder,0,9,1,10
10008,2023-01-01,EMZ,heist,Kaboom Canyon,0,1,0,1
10009,2023-01-01,EMZ,heist,Bridge Too Far,0,1,0,1
10010,2023-01-01,EMZ,gemGrab,Double Swoosh,0,15,17,32
10011,2023-01-01,EMZ,brawlBall,Backyard Bowl,0,4,5,9
10012,2023-01-01,EMZ,bounty,Canal Grande,0,1,0,1
10013,2022-12-31,EMZ,hotZone,Controller Chaos,0,6,3,9
10014,2022-12-31,EMZ,gemGrab,Hard Rock Mine,0,4,0,4
10015,2022-12-31,EMZ,gemGrab,Deep Diner,0,2,0,2
10016,2022-12-31,EMZ,brawlBall,Super Beach,0,4,5,9
10017,2022-12-30,EMZ,knockout,Flaring Phoenix,0,0,1,1
10018,2022-12-30,EMZ,hotZone,Controller Chaos,0,4,2,6
10019,2022-12-30,EMZ,heist,Kaboom Canyon,0,0,1,1
10020,2022-12-30,EMZ,gemGrab,Undermine,0,1,0,1
10021,2022-12-30,EMZ,gemGrab,Minecart Madness,0,0,1,1
10022,2022-12-30,EMZ,gemGrab,Deep Diner,0,1,0,1
10023,2022-12-30,EMZ,brawlBall,Sneaky Fields,0,10,12,22
10024,2022-12-29,EMZ,hotZone,Open Zone,0,1,0,1
10025,2022-12-29,EMZ,hotZone,Controller Chaos,0,0,1,1
10026,2022-12-29,EMZ,heist,Hot Potato,0,4,1,5
10027,2022-12-29,EMZ,gemGrab,Undermine,0,7,4,11
10028,2022-12-29,EMZ,gemGrab,Minecart Madness,0,0,1,1
10029,2022-12-29,EMZ,brawlBall,Pinhole Punt,0,1,0,1
10030,2022-12-27,EMZ,hotZone,Dueling Beetles,0,0,1,1
10031,2022-12-27,EMZ,hotZone,Controller Chaos,0,0,2,2
10032,2022-12-27,EMZ,heist,Kaboom Canyon,0,1,0,1
10033,2022-12-27,EMZ,brawlBall,Beach Ball,0,1,1,2
10034,2022-12-26,EMZ,hotZone,Controller Chaos,0,2,0,2
10035,2022-12-26,EMZ,gemGrab,Minecart Madness,0,1,2,3
10036,2022-12-26,EMZ,brawlBall,Center Stage,0,1,1,2
10037,2022-12-25,EMZ,hotZone,Ring of Fire,0,1,0,1
10038,2022-12-25,EMZ,gemGrab,Double Swoosh,0,1,1,2
10039,2022-12-22,EMZ,gemGrab,Gem Fort,0,1,0,1
10040,2022-12-22,EMZ,brawlBall,Pinhole Punt,0,2,1,3
10041,2022-12-20,EMZ,brawlBall,Beach Ball,0,0,1,1
10042,2022-12-19,EMZ,brawlBall,Center Stage,0,2,3,5
10043,2022-12-16,EMZ,brawlBall,Sneaky Fields,0,1,0,1
10044,2022-12-13,EMZ,hotZone,Dueling Beetles,0,1,0,1
10045,2022-12-13,EMZ,brawlBall,Beach Ball,0,1,0,1
10046,2022-12-11,EMZ,gemGrab,Double Swoosh,0,1,1,2
10047,2022-11-11,EMZ,brawlBall,Sneaky Fields,0,1,4,5
10048,2022-10-30,EMZ,hotZone,Dueling Beetles,0,1,0,1
10049,2022-10-30,EMZ,brawlBall,Beach Ball,0,1,0,1
10050,2022-10-30,EMZ,bounty,Canal Grande,0,0,1,1
10051,2022-10-28,EMZ,brawlBall,Beach Ball,0,1,2,3
10052,2022-10-15,EMZ,gemGrab,Hard Rock Mine,0,3,1,4
10053,2023-01-30,EL PRIMO,knockout,Belle's Rock,0,42,18,60
10054,2023-01-30,EL PRIMO,hotZone,Quarter Pounder,0,65,15,80
10055,2023-01-30,EL PRIMO,heist,Pit Stop,1,277,301,579
10056,2023-01-30,EL PRIMO,gemGrab,Minecart Madness,0,33,15,48
10057,2023-01-30,EL PRIMO,gemGrab,Double Swoosh,0,60,47,107
10058,2023-01-30,EL PRIMO,brawlBall,Center Stage,27,1163,1142,2332
10059,2023-01-30,EL PRIMO,brawlBall,Backyard Bowl,1,58,53,112
10060,2023-01-30,EL PRIMO,bounty,Hideout,0,4,1,5
10061,2023-01-29,EL PRIMO,knockout,Belle's Rock,0,32,21,53
10062,2023-01-29,EL PRIMO,hotZone,Quarter Pounder,0,43,7,50
10063,2023-01-29,EL PRIMO,heist,Bridge Too Far,0,41,13,54
10064,2023-01-29,EL PRIMO,gemGrab,Hard Rock Mine,0,9,6,15
10065,2023-01-29,EL PRIMO,gemGrab,Double Swoosh,0,73,41,114
10066,2023-01-29,EL PRIMO,brawlBall,Super Beach,2,38,37,77
10067,2023-01-29,EL PRIMO,brawlBall,Backyard Bowl,14,569,420,1003
10068,2023-01-29,EL PRIMO,bounty,Canal Grande,0,22,9,31
10069,2023-01-28,EL PRIMO,knockout,Flaring Phoenix,0,32,7,39
10070,2023-01-28,EL PRIMO,hotZone,Controller Chaos,0,76,30,106
10071,2023-01-28,EL PRIMO,heist,Bridge Too Far,0,85,32,117
10072,2023-01-28,EL PRIMO,gemGrab,Hard Rock Mine,0,80,83,163
10073,2023-01-28,EL PRIMO,gemGrab,Deep Diner,0,13,4,17
10074,2023-01-28,EL PRIMO,brawlBall,Super Beach,26,1307,1189,2522
10075,2023-01-28,EL PRIMO,brawlBall,Sneaky Fields,3,103,69,175
10076,2023-01-28,EL PRIMO,bounty,Canal Grande,0,30,12,42
10077,2023-01-27,EL PRIMO,knockout,Flaring Phoenix,1,16,7,24
10078,2023-01-27,EL PRIMO,hotZone,Controller Chaos,0,9,6,15
10079,2023-01-27,EL PRIMO,heist,Hot Potato,0,50,35,85
10080,2023-01-27,EL PRIMO,gemGrab,Undermine,0,1,2,3
10081,2023-01-27,EL PRIMO,gemGrab,Deep Diner,0,18,6,24
10082,2023-01-27,EL PRIMO,brawlBall,Sneaky Fields,8,628,542,1178
10083,2023-01-27,EL PRIMO,brawlBall,Pinhole Punt,0,13,14,27
10084,2023-01-27,EL PRIMO,bounty,Temple Ruins,0,4,0,4
10085,2023-01-26,EL PRIMO,knockout,Riverside,0,18,7,25
10086,2023-01-26,EL PRIMO,hotZone,Open Zone,0,20,5,25
10087,2023-01-26,EL PRIMO,heist,Hot Potato,1,176,147,324
10088,2023-01-26,EL PRIMO,gemGrab,Undermine,0,34,29,63
10089,2023-01-26,EL PRIMO,gemGrab,Gem Fort,0,32,16,48
10090,2023-01-26,EL PRIMO,brawlBall,Sunny Soccer,1,89,81,171
10091,2023-01-26,EL PRIMO,brawlBall,Pinhole Punt,17,907,697,1621
10092,2023-01-26,EL PRIMO,bounty,Temple Ruins,0,18,2,20
10093,2023-01-25,EL PRIMO,knockout,Riverside,0,17,4,21
10094,2023-01-25,EL PRIMO,hotZone,Open Zone,0,6,1,7
10095,2023-01-25,EL PRIMO,heist,Safe Zone,0,25,21,46
10096,2023-01-25,EL PRIMO,gemGrab,Gem Fort,0,41,36,77
10097,2023-01-25,EL PRIMO,gemGrab,Crystal Arcade,0,26,18,44
10098,2023-01-25,EL PRIMO,brawlBall,Sunny Soccer,19,759,623,1401
10099,2023-01-25,EL PRIMO,brawlBall,Beach Ball,4,127,103,234
10100,2023-01-25,EL PRIMO,bounty,Excel,0,16,16,32
10101,2023-01-24,EL PRIMO,knockout,New Perspective,0,18,9,27
10102,2023-01-24,EL PRIMO,hotZone,Dueling Beetles,0,39,8,47
10103,2023-01-24,EL PRIMO,heist,Safe Zone,0,67,47,114
10104,2023-01-24,EL PRIMO,gemGrab,Minecart Madness,0,19,22,41
10105,2023-01-24,EL PRIMO,gemGrab,Crystal Arcade,0,45,36,81
10106,2023-01-24,EL PRIMO,brawlBall,Center Stage,9,184,152,345
10107,2023-01-24,EL PRIMO,brawlBall,Beach Ball,21,1154,883,2058
10108,2023-01-24,EL PRIMO,bounty,Excel,0,8,10,18
10109,2023-01-23,EL PRIMO,knockout,New Perspective,0,42,21,63
10110,2023-01-23,EL PRIMO,hotZone,Dueling Beetles,0,60,19,79
10111,2023-01-23,EL PRIMO,heist,Snaked Assault,0,236,166,402
10112,2023-01-23,EL PRIMO,gemGrab,Minecart Madness,0,62,34,96
10113,2023-01-23,EL PRIMO,gemGrab,Double Swoosh,0,39,15,54
10114,2023-01-23,EL PRIMO,brawlBall,Center Stage,46,2101,1960,4107
10115,2023-01-23,EL PRIMO,brawlBall,Backyard Bowl,0,37,25,62
10116,2023-01-23,EL PRIMO,bounty,Layer Cake,0,20,20,40
10117,2023-01-22,EL PRIMO,knockout,X Marks the Spot,0,9,3,12
10118,2023-01-22,EL PRIMO,hotZone,Ring of Fire,0,25,24,49
10119,2023-01-22,EL PRIMO,heist,Snaked Assault,0,98,72,170
10120,2023-01-22,EL PRIMO,gemGrab,Hard Rock Mine,0,21,25,46
10121,2023-01-22,EL PRIMO,gemGrab,Double Swoosh,0,56,27,83
10122,2023-01-22,EL PRIMO,brawlBall,Super Beach,3,149,125,277
10123,2023-01-22,EL PRIMO,brawlBall,Backyard Bowl,4,265,203,472
10124,2023-01-22,EL PRIMO,bounty,Layer Cake,0,11,7,18
10125,2023-01-21,EL PRIMO,knockout,X Marks the Spot,0,40,19,59
10126,2023-01-21,EL PRIMO,hotZone,Ring of Fire,0,31,48,79
10127,2023-01-21,EL PRIMO,heist,Tornado Ring,1,213,170,384
10128,2023-01-21,EL PRIMO,gemGrab,Hard Rock Mine,0,101,76,177
10129,2023-01-21,EL PRIMO,gemGrab,Deep Diner,0,9,8,17
10130,2023-01-21,EL PRIMO,brawlBall,Super Beach,32,1635,1414,3081
10131,2023-01-21,EL PRIMO,brawlBall,Sneaky Fields,0,86,87,173
10132,2023-01-21,EL PRIMO,bounty,Dry Season,0,18,7,25
10133,2023-01-20,EL PRIMO,knockout,Out in the Open,0,33,13,46
10134,2023-01-20,EL PRIMO,hotZone,Split,0,77,59,136
10135,2023-01-20,EL PRIMO,heist,Tornado Ring,1,146,123,270
10136,2023-01-20,EL PRIMO,gemGrab,Undermine,0,16,5,21
10137,2023-01-20,EL PRIMO,gemGrab,Deep Diner,0,57,32,89
10138,2023-01-20,EL PRIMO,brawlBall,Sneaky Fields,29,1926,1716,3671
10139,2023-01-20,EL PRIMO,brawlBall,Pinhole Punt,2,36,24,62
10140,2023-01-20,EL PRIMO,bounty,Dry Season,0,7,7,14
10141,2023-01-19,EL PRIMO,knockout,Out in the Open,0,28,17,45
10142,2023-01-19,EL PRIMO,hotZone,Split,0,125,74,199
10143,2023-01-19,EL PRIMO,heist,Kaboom Canyon,1,48,21,70
10144,2023-01-19,EL PRIMO,gemGrab,Undermine,0,60,28,88
10145,2023-01-19,EL PRIMO,gemGrab,Gem Fort,0,15,13,28
10146,2023-01-19,EL PRIMO,brawlBall,Sunny Soccer,0,65,49,114
10147,2023-01-19,EL PRIMO,brawlBall,Pinhole Punt,20,912,727,1659
10148,2023-01-19,EL PRIMO,bounty,Shooting Star,0,5,2,7
10149,2023-01-18,EL PRIMO,knockout,Goldarm Gulch,0,5,5,10
10150,2023-01-18,EL PRIMO,hotZone,Parallel Plays,0,3,2,5
10151,2023-01-18,EL PRIMO,heist,Kaboom Canyon,0,6,3,9
10152,2023-01-18,EL PRIMO,gemGrab,Gem Fort,0,13,12,25
10153,2023-01-18,EL PRIMO,gemGrab,Crystal Arcade,0,2,2,4
10154,2023-01-18,EL PRIMO,brawlBall,Sunny Soccer,4,360,337,701
10155,2023-01-18,EL PRIMO,brawlBall,Beach Ball,0,12,6,18
10156,2023-01-18,EL PRIMO,bounty,Shooting Star,0,3,0,3
10157,2023-01-17,EL PRIMO,knockout,Goldarm Gulch,0,6,5,11
10158,2023-01-17,EL PRIMO,hotZone,Parallel Plays,0,7,3,10
10159,2023-01-17,EL PRIMO,heist,Pit Stop,0,23,31,54
10160,2023-01-17,EL PRIMO,gemGrab,Minecart Madness,0,2,0,2
10161,2023-01-17,EL PRIMO,gemGrab,Crystal Arcade,0,4,4,8
10162,2023-01-17,EL PRIMO,brawlBall,Center Stage,0,4,8,12
10163,2023-01-17,EL PRIMO,brawlBall,Beach Ball,1,85,75,161
10164,2023-01-16,EL PRIMO,knockout,Belle's Rock,0,4,1,5
10165,2023-01-16,EL PRIMO,hotZone,Quarter Pounder,0,3,0,3
10166,2023-01-16,EL PRIMO,heist,Pit Stop,0,93,80,173
10167,2023-01-16,EL PRIMO,gemGrab,Minecart Madness,0,4,0,4
10168,2023-01-16,EL PRIMO,gemGrab,Double Swoosh,0,1,0,1
10169,2023-01-16,EL PRIMO,brawlBall,Center Stage,6,119,98,223
10170,2023-01-16,EL PRIMO,brawlBall,Backyard Bowl,0,12,4,16
10171,2023-01-15,EL PRIMO,knockout,Belle's Rock,0,2,4,6
10172,2023-01-15,EL PRIMO,hotZone,Quarter Pounder,0,18,3,21
10173,2023-01-15,EL PRIMO,heist,Bridge Too Far,0,6,2,8
10174,2023-01-15,EL PRIMO,gemGrab,Hard Rock Mine,0,5,1,6
10175,2023-01-15,EL PRIMO,gemGrab,Double Swoosh,0,13,5,18
10176,2023-01-15,EL PRIMO,brawlBall,Super Beach,0,15,6,21
10177,2023-01-15,EL PRIMO,brawlBall,Backyard Bowl,3,74,39,116
10178,2023-01-15,EL PRIMO,bounty,Canal Grande,0,3,1,4
10179,2023-01-14,EL PRIMO,knockout,Flaring Phoenix,0,1,2,3
10180,2023-01-14,EL PRIMO,hotZone,Controller Chaos,0,12,1,13
10181,2023-01-14,EL PRIMO,heist,Bridge Too Far,0,4,0,4
10182,2023-01-14,EL PRIMO,gemGrab,Hard Rock Mine,0,4,1,5
10183,2023-01-14,EL PRIMO,gemGrab,Deep Diner,0,1,1,2
10184,2023-01-14,EL PRIMO,brawlBall,Super Beach,2,93,56,151
10185,2023-01-14,EL PRIMO,brawlBall,Sneaky Fields,1,19,22,42
10186,2023-01-14,EL PRIMO,bounty,Canal Grande,0,5,1,6
10187,2023-01-13,EL PRIMO,knockout,Flaring Phoenix,0,1,3,4
10188,2023-01-13,EL PRIMO,hotZone,Controller Chaos,0,15,5,20
10189,2023-01-13,EL PRIMO,heist,Hot Potato,0,6,1,7
10190,2023-01-13,EL PRIMO,gemGrab,Deep Diner,0,4,1,5
10191,2023-01-13,EL PRIMO,brawlBall,Sneaky Fields,2,146,166,314
10192,2023-01-13,EL PRIMO,brawlBall,Pinhole Punt,0,2,0,2
10193,2023-01-12,EL PRIMO,hotZone,Open Zone,0,1,0,1
10194,2023-01-12,EL PRIMO,heist,Hot Potato,0,4,2,6
10195,2023-01-12,EL PRIMO,gemGrab,Undermine,0,2,4,6
10196,2023-01-12,EL PRIMO,gemGrab,Gem Fort,0,1,0,1
10197,2023-01-12,EL PRIMO,brawlBall,Sunny Soccer,0,8,18,26
10198,2023-01-12,EL PRIMO,brawlBall,Pinhole Punt,0,31,17,48
10199,2023-01-11,EL PRIMO,brawlBall,Sunny Soccer,0,30,19,49
10200,2023-01-11,EL PRIMO,brawlBall,Beach Ball,0,0,2,2
10201,2023-01-10,EL PRIMO,knockout,New Perspective,0,1,1,2
10202,2023-01-10,EL PRIMO,hotZone,Dueling Beetles,0,9,0,9
10203,2023-01-10,EL PRIMO,heist,Safe Zone,0,8,1,9
10204,2023-01-10,EL PRIMO,gemGrab,Minecart Madness,0,4,0,4
10205,2023-01-10,EL PRIMO,gemGrab,Crystal Arcade,0,6,3,9
10206,2023-01-10,EL PRIMO,brawlBall,Center Stage,0,10,5,15
10207,2023-01-10,EL PRIMO,brawlBall,Beach Ball,0,60,29,89
10208,2023-01-09,EL PRIMO,knockout,New Perspective,0,1,1,2
10209,2023-01-09,EL PRIMO,hotZone,Dueling Beetles,0,6,0,6
10210,2023-01-09,EL PRIMO,heist,Snaked Assault,0,48,4,52
10211,2023-01-09,EL PRIMO,gemGrab,Minecart Madness,0,7,1,8
10212,2023-01-09,EL PRIMO,gemGrab,Double Swoosh,0,1,0,1
10213,2023-01-09,EL PRIMO,brawlBall,Center Stage,4,98,92,194
10214,2023-01-09,EL PRIMO,brawlBall,Backyard Bowl,0,4,0,4
10215,2023-01-09,EL PRIMO,bounty,Layer Cake,0,4,0,4
10216,2023-01-08,EL PRIMO,knockout,X Marks the Spot,0,4,0,4
10217,2023-01-08,EL PRIMO,hotZone,Ring of Fire,0,3,0,3
10218,2023-01-08,EL PRIMO,heist,Snaked Assault,0,18,24,42
10219,2023-01-08,EL PRIMO,gemGrab,Hard Rock Mine,0,5,0,5
10220,2023-01-08,EL PRIMO,gemGrab,Double Swoosh,0,3,1,4
10221,2023-01-08,EL PRIMO,brawlBall,Super Beach,1,6,2,9
10222,2023-01-08,EL PRIMO,brawlBall,Backyard Bowl,1,39,8,48
10223,2023-01-07,EL PRIMO,knockout,X Marks the Spot,0,1,0,1
10224,2023-01-07,EL PRIMO,hotZone,Ring of Fire,0,2,2,4
10225,2023-01-07,EL PRIMO,heist,Tornado Ring,0,23,2,25
10226,2023-01-07,EL PRIMO,gemGrab,Hard Rock Mine,0,4,10,14
10227,2023-01-07,EL PRIMO,gemGrab,Deep Diner,0,6,7,13
10228,2023-01-07,EL PRIMO,brawlBall,Super Beach,0,32,30,62
10229,2023-01-07,EL PRIMO,brawlBall,Sneaky Fields,0,7,0,7
10230,2023-01-07,EL PRIMO,bounty,Dry Season,0,1,0,1
10231,2023-01-06,EL PRIMO,hotZone,Split,0,12,1,13
10232,2023-01-06,EL PRIMO,heist,Tornado Ring,0,16,6,22
10233,2023-01-06,EL PRIMO,gemGrab,Undermine,0,2,0,2
10234,2023-01-06,EL PRIMO,gemGrab,Deep Diner,0,5,1,6
10235,2023-01-06,EL PRIMO,brawlBall,Sneaky Fields,1,96,59,156
10236,2023-01-06,EL PRIMO,brawlBall,Pinhole Punt,0,5,1,6
10237,2023-01-06,EL PRIMO,bounty,Dry Season,0,1,0,1
10238,2023-01-05,EL PRIMO,knockout,Out in the Open,0,1,0,1
10239,2023-01-05,EL PRIMO,hotZone,Split,0,22,6,28
10240,2023-01-05,EL PRIMO,heist,Kaboom Canyon,0,4,2,6
10241,2023-01-05,EL PRIMO,gemGrab,Undermine,0,5,1,6
10242,2023-01-05,EL PRIMO,gemGrab,Gem Fort,0,1,0,1
10243,2023-01-05,EL PRIMO,brawlBall,Sunny Soccer,0,2,0,2
10244,2023-01-05,EL PRIMO,brawlBall,Pinhole Punt,2,67,26,95
10245,2023-01-04,EL PRIMO,knockout,Goldarm Gulch,0,2,0,2
10246,2023-01-04,EL PRIMO,hotZone,Parallel Plays,0,4,0,4
10247,2023-01-04,EL PRIMO,heist,Kaboom Canyon,0,8,1,9
10248,2023-01-04,EL PRIMO,gemGrab,Gem Fort,0,7,5,12
10249,2023-01-04,EL PRIMO,brawlBall,Sunny Soccer,3,81,65,149
10250,2023-01-04,EL PRIMO,bounty,Shooting Star,0,1,0,1
10251,2023-01-03,EL PRIMO,knockout,Goldarm Gulch,0,0,1,1
10252,2023-01-03,EL PRIMO,hotZone,Parallel Plays,0,8,0,8
10253,2023-01-03,EL PRIMO,heist,Pit Stop,0,54,71,125
10254,2023-01-03,EL PRIMO,gemGrab,Minecart Madness,0,2,0,2
10255,2023-01-03,EL PRIMO,gemGrab,Crystal Arcade,0,3,0,3
10256,2023-01-03,EL PRIMO,brawlBall,Center Stage,0,2,2,4
10257,2023-01-03,EL PRIMO,brawlBall,Beach Ball,0,73,35,108
10258,2023-01-03,EL PRIMO,bounty,Hideout,0,2,0,2
10259,2023-01-02,EL PRIMO,knockout,Belle's Rock,0,2,0,2
10260,2023-01-02,EL PRIMO,hotZone,Quarter Pounder,0,9,2,11
10261,2023-01-02,EL PRIMO,hotZone,Controller Chaos,0,2,1,3
10262,2023-01-02,EL PRIMO,heist,Pit Stop,1,85,178,264
10263,2023-01-02,EL PRIMO,heist,Kaboom Canyon,0,1,0,1
10264,2023-01-02,EL PRIMO,gemGrab,Minecart Madness,0,2,3,5
10265,2023-01-02,EL PRIMO,gemGrab,Double Swoosh,0,5,1,6
10266,2023-01-02,EL PRIMO,brawlBall,Center Stage,1,117,83,201
10267,2023-01-02,EL PRIMO,brawlBall,Backyard Bowl,0,4,0,4
10268,2023-01-02,EL PRIMO,bounty,Hideout,0,3,1,4
10269,2023-01-01,EL PRIMO,hotZone,Quarter Pounder,0,2,0,2
10270,2023-01-01,EL PRIMO,heist,Bridge Too Far,0,1,0,1
10271,2023-01-01,EL PRIMO,gemGrab,Double Swoosh,0,5,0,5
10272,2023-01-01,EL PRIMO,brawlBall,Backyard Bowl,0,17,4,21
10273,2022-12-31,EL PRIMO,knockout,Flaring Phoenix,0,0,1,1
10274,2022-12-31,EL PRIMO,hotZone,Controller Chaos,0,3,1,4
10275,2022-12-31,EL PRIMO,heist,Bridge Too Far,0,1,0,1
10276,2022-12-31,EL PRIMO,gemGrab,Minecart Madness,0,1,1,2
10277,2022-12-31,EL PRIMO,gemGrab,Hard Rock Mine,0,2,1,3
10278,2022-12-31,EL PRIMO,gemGrab,Deep Diner,0,1,2,3
10279,2022-12-31,EL PRIMO,brawlBall,Super Beach,0,11,15,26
10280,2022-12-31,EL PRIMO,brawlBall,Sneaky Fields,0,2,3,5
10281,2022-12-30,EL PRIMO,knockout,Flaring Phoenix,0,0,1,1
10282,2022-12-30,EL PRIMO,hotZone,Controller Chaos,0,1,0,1
10283,2022-12-30,EL PRIMO,gemGrab,Deep Diner,0,2,1,3
10284,2022-12-30,EL PRIMO,brawlBall,Sneaky Fields,0,8,8,16
10285,2022-12-29,EL PRIMO,heist,Hot Potato,0,1,3,4
10286,2022-12-29,EL PRIMO,brawlBall,Pinhole Punt,0,1,1,2
10287,2022-12-28,EL PRIMO,brawlBall,Sunny Soccer,0,1,0,1
10288,2022-12-27,EL PRIMO,knockout,New Perspective,0,1,0,1
10289,2022-12-27,EL PRIMO,brawlBall,Center Stage,0,1,0,1
10290,2022-12-26,EL PRIMO,heist,Kaboom Canyon,0,2,0,2
10291,2022-12-26,EL PRIMO,brawlBall,Center Stage,0,1,0,1
10292,2022-12-23,EL PRIMO,brawlBall,Sneaky Fields,0,0,1,1
10293,2022-12-22,EL PRIMO,brawlBall,Pinhole Punt,0,2,0,2
10294,2022-12-21,EL PRIMO,brawlBall,Sunny Soccer,0,1,0,1
10295,2022-12-20,EL PRIMO,brawlBall,Beach Ball,0,2,1,3
10296,2022-12-19,EL PRIMO,brawlBall,Center Stage,0,0,1,1
10297,2022-12-16,EL PRIMO,brawlBall,Sneaky Fields,0,0,2,2
10298,2022-12-13,EL PRIMO,gemGrab,Crystal Arcade,0,1,0,1
10299,2022-12-13,EL PRIMO,brawlBall,Beach Ball,0,1,0,1
10300,2022-12-11,EL PRIMO,brawlBall,Backyard Bowl,0,0,1,1
10301,2022-11-11,EL PRIMO,brawlBall,Sneaky Fields,0,1,1,2
10302,2022-10-30,EL PRIMO,hotZone,Dueling Beetles,0,1,0,1
10303,2022-10-30,EL PRIMO,heist,Safe Zone,0,1,0,1
10304,2022-10-30,EL PRIMO,bounty,Canal Grande,0,1,0,1
10305,2022-10-26,EL PRIMO,brawlBall,Sunny Soccer,0,1,2,3
10306,2023-01-30,EDGAR,knockout,Belle's Rock,1,274,169,444
10307,2023-01-30,EDGAR,hotZone,Quarter Pounder,1,66,12,79
10308,2023-01-30,EDGAR,heist,Pit Stop,0,374,495,869
10309,2023-01-30,EDGAR,gemGrab,Minecart Madness,0,44,24,68
10310,2023-01-30,EDGAR,gemGrab,Double Swoosh,0,24,14,38
10311,2023-01-30,EDGAR,brawlBall,Center Stage,4,254,173,431
10312,2023-01-30,EDGAR,brawlBall,Backyard Bowl,0,18,14,32
10313,2023-01-30,EDGAR,bounty,Hideout,0,15,4,19
10314,2023-01-29,EDGAR,knockout,Belle's Rock,0,236,148,384
10315,2023-01-29,EDGAR,hotZone,Quarter Pounder,0,35,10,45
10316,2023-01-29,EDGAR,heist,Bridge Too Far,0,25,18,43
10317,2023-01-29,EDGAR,gemGrab,Hard Rock Mine,0,8,6,14
10318,2023-01-29,EDGAR,gemGrab,Double Swoosh,0,62,46,108
10319,2023-01-29,EDGAR,brawlBall,Super Beach,0,8,4,12
10320,2023-01-29,EDGAR,brawlBall,Backyard Bowl,1,179,87,267
10321,2023-01-29,EDGAR,bounty,Canal Grande,0,38,17,55
10322,2023-01-28,EDGAR,knockout,Flaring Phoenix,0,118,70,188
10323,2023-01-28,EDGAR,hotZone,Controller Chaos,0,46,28,74
10324,2023-01-28,EDGAR,heist,Bridge Too Far,0,56,13,69
10325,2023-01-28,EDGAR,gemGrab,Hard Rock Mine,0,57,30,87
10326,2023-01-28,EDGAR,gemGrab,Deep Diner,0,23,26,49
10327,2023-01-28,EDGAR,brawlBall,Super Beach,7,370,267,644
10328,2023-01-28,EDGAR,brawlBall,Sneaky Fields,0,27,12,39
10329,2023-01-28,EDGAR,bounty,Canal Grande,0,86,73,159
10330,2023-01-27,EDGAR,knockout,Flaring Phoenix,0,46,24,70
10331,2023-01-27,EDGAR,hotZone,Controller Chaos,0,7,4,11
10332,2023-01-27,EDGAR,heist,Hot Potato,0,38,52,90
10333,2023-01-27,EDGAR,gemGrab,Undermine,0,4,3,7
10334,2023-01-27,EDGAR,gemGrab,Deep Diner,0,30,15,45
10335,2023-01-27,EDGAR,brawlBall,Sneaky Fields,5,131,111,247
10336,2023-01-27,EDGAR,brawlBall,Pinhole Punt,0,3,1,4
10337,2023-01-27,EDGAR,bounty,Temple Ruins,0,6,4,10
10338,2023-01-26,EDGAR,knockout,Riverside,1,65,20,86
10339,2023-01-26,EDGAR,hotZone,Open Zone,0,13,7,20
10340,2023-01-26,EDGAR,heist,Hot Potato,0,187,161,348
10341,2023-01-26,EDGAR,gemGrab,Undermine,0,37,23,60
10342,2023-01-26,EDGAR,gemGrab,Gem Fort,0,29,15,44
10343,2023-01-26,EDGAR,brawlBall,Sunny Soccer,0,31,38,69
10344,2023-01-26,EDGAR,brawlBall,Pinhole Punt,2,249,170,421
10345,2023-01-26,EDGAR,bounty,Temple Ruins,0,38,26,64
10346,2023-01-25,EDGAR,knockout,Riverside,0,31,20,51
10347,2023-01-25,EDGAR,hotZone,Open Zone,0,3,1,4
10348,2023-01-25,EDGAR,heist,Safe Zone,0,33,19,52
10349,2023-01-25,EDGAR,gemGrab,Gem Fort,0,27,15,42
10350,2023-01-25,EDGAR,gemGrab,Crystal Arcade,0,21,19,40
10351,2023-01-25,EDGAR,brawlBall,Sunny Soccer,2,194,150,346
10352,2023-01-25,EDGAR,brawlBall,Beach Ball,2,33,16,51
10353,2023-01-25,EDGAR,bounty,Excel,0,46,30,76
10354,2023-01-24,EDGAR,knockout,New Perspective,1,104,58,163
10355,2023-01-24,EDGAR,hotZone,Dueling Beetles,0,32,13,45
10356,2023-01-24,EDGAR,heist,Safe Zone,0,53,18,71
10357,2023-01-24,EDGAR,gemGrab,Minecart Madness,0,7,5,12
10358,2023-01-24,EDGAR,gemGrab,Crystal Arcade,0,59,48,107
10359,2023-01-24,EDGAR,brawlBall,Center Stage,1,46,40,87
10360,2023-01-24,EDGAR,brawlBall,Beach Ball,8,336,203,547
10361,2023-01-24,EDGAR,bounty,Excel,0,52,26,78
10362,2023-01-23,EDGAR,knockout,New Perspective,0,121,63,184
10363,2023-01-23,EDGAR,hotZone,Dueling Beetles,0,36,12,48
10364,2023-01-23,EDGAR,heist,Snaked Assault,2,175,109,286
10365,2023-01-23,EDGAR,gemGrab,Minecart Madness,0,74,32,106
10366,2023-01-23,EDGAR,gemGrab,Double Swoosh,0,30,12,42
10367,2023-01-23,EDGAR,brawlBall,Center Stage,8,453,361,822
10368,2023-01-23,EDGAR,brawlBall,Backyard Bowl,0,13,3,16
10369,2023-01-23,EDGAR,bounty,Layer Cake,0,82,32,114
10370,2023-01-22,EDGAR,knockout,X Marks the Spot,0,47,25,72
10371,2023-01-22,EDGAR,hotZone,Ring of Fire,0,12,4,16
10372,2023-01-22,EDGAR,heist,Snaked Assault,0,87,57,144
10373,2023-01-22,EDGAR,gemGrab,Hard Rock Mine,0,26,15,41
10374,2023-01-22,EDGAR,gemGrab,Double Swoosh,0,36,16,52
10375,2023-01-22,EDGAR,brawlBall,Super Beach,0,35,12,47
10376,2023-01-22,EDGAR,brawlBall,Backyard Bowl,1,96,46,143
10377,2023-01-22,EDGAR,bounty,Layer Cake,0,32,14,46
10378,2023-01-21,EDGAR,knockout,X Marks the Spot,0,154,65,219
10379,2023-01-21,EDGAR,hotZone,Ring of Fire,0,19,7,26
10380,2023-01-21,EDGAR,heist,Tornado Ring,0,133,89,222
10381,2023-01-21,EDGAR,gemGrab,Hard Rock Mine,0,92,47,139
10382,2023-01-21,EDGAR,gemGrab,Deep Diner,0,14,8,22
10383,2023-01-21,EDGAR,brawlBall,Super Beach,11,470,303,784
10384,2023-01-21,EDGAR,brawlBall,Sneaky Fields,0,29,19,48
10385,2023-01-21,EDGAR,bounty,Dry Season,0,33,23,56
10386,2023-01-20,EDGAR,knockout,Out in the Open,0,74,44,118
10387,2023-01-20,EDGAR,hotZone,Split,0,117,97,214
10388,2023-01-20,EDGAR,heist,Tornado Ring,2,136,102,240
10389,2023-01-20,EDGAR,gemGrab,Undermine,0,14,19,33
10390,2023-01-20,EDGAR,gemGrab,Deep Diner,0,69,50,119
10391,2023-01-20,EDGAR,brawlBall,Sneaky Fields,3,440,328,771
10392,2023-01-20,EDGAR,brawlBall,Pinhole Punt,1,24,6,31
10393,2023-01-20,EDGAR,bounty,Dry Season,0,25,14,39
10394,2023-01-19,EDGAR,knockout,Out in the Open,1,122,61,184
10395,2023-01-19,EDGAR,hotZone,Split,0,161,121,282
10396,2023-01-19,EDGAR,heist,Kaboom Canyon,0,59,32,91
10397,2023-01-19,EDGAR,gemGrab,Undermine,0,56,23,79
10398,2023-01-19,EDGAR,gemGrab,Gem Fort,0,12,10,22
10399,2023-01-19,EDGAR,brawlBall,Sunny Soccer,0,7,5,12
10400,2023-01-19,EDGAR,brawlBall,Pinhole Punt,6,260,144,410
10401,2023-01-19,EDGAR,bounty,Shooting Star,0,15,9,24
10402,2023-01-18,EDGAR,knockout,Goldarm Gulch,0,24,8,32
10403,2023-01-18,EDGAR,hotZone,Parallel Plays,0,11,3,14
10404,2023-01-18,EDGAR,heist,Kaboom Canyon,0,18,11,29
10405,2023-01-18,EDGAR,gemGrab,Gem Fort,0,18,13,31
10406,2023-01-18,EDGAR,gemGrab,Crystal Arcade,0,3,2,5
10407,2023-01-18,EDGAR,brawlBall,Sunny Soccer,3,101,75,179
10408,2023-01-18,EDGAR,brawlBall,Beach Ball,0,5,3,8
10409,2023-01-18,EDGAR,bounty,Shooting Star,0,7,1,8
10410,2023-01-17,EDGAR,knockout,Goldarm Gulch,0,29,15,44
10411,2023-01-17,EDGAR,hotZone,Parallel Plays,0,7,0,7
10412,2023-01-17,EDGAR,heist,Pit Stop,0,52,58,110
10413,2023-01-17,EDGAR,gemGrab,Minecart Madness,0,1,1,2
10414,2023-01-17,EDGAR,gemGrab,Crystal Arcade,0,1,1,2
10415,2023-01-17,EDGAR,brawlBall,Center Stage,0,4,0,4
10416,2023-01-17,EDGAR,brawlBall,Beach Ball,1,48,17,66
10417,2023-01-17,EDGAR,bounty,Hideout,0,1,1,2
10418,2023-01-16,EDGAR,knockout,Belle's Rock,0,12,6,18
10419,2023-01-16,EDGAR,hotZone,Quarter Pounder,0,5,1,6
10420,2023-01-16,EDGAR,heist,Pit Stop,0,121,132,253
10421,2023-01-16,EDGAR,gemGrab,Minecart Madness,0,10,1,11
10422,2023-01-16,EDGAR,gemGrab,Double Swoosh,0,1,0,1
10423,2023-01-16,EDGAR,brawlBall,Center Stage,0,27,23,50
10424,2023-01-16,EDGAR,brawlBall,Backyard Bowl,0,3,1,4
10425,2023-01-16,EDGAR,bounty,Hideout,0,3,0,3
10426,2023-01-15,EDGAR,knockout,Belle's Rock,0,25,16,41
10427,2023-01-15,EDGAR,hotZone,Quarter Pounder,0,16,2,18
10428,2023-01-15,EDGAR,heist,Bridge Too Far,0,4,1,5
10429,2023-01-15,EDGAR,gemGrab,Hard Rock Mine,0,1,0,1
10430,2023-01-15,EDGAR,gemGrab,Double Swoosh,0,2,2,4
10431,2023-01-15,EDGAR,brawlBall,Super Beach,0,1,0,1
10432,2023-01-15,EDGAR,brawlBall,Backyard Bowl,0,12,10,22
10433,2023-01-15,EDGAR,bounty,Canal Grande,0,2,1,3
10434,2023-01-14,EDGAR,knockout,Flaring Phoenix,0,10,9,19
10435,2023-01-14,EDGAR,hotZone,Controller Chaos,0,15,0,15
10436,2023-01-14,EDGAR,heist,Bridge Too Far,0,3,1,4
10437,2023-01-14,EDGAR,gemGrab,Hard Rock Mine,0,5,0,5
10438,2023-01-14,EDGAR,gemGrab,Deep Diner,0,2,0,2
10439,2023-01-14,EDGAR,brawlBall,Super Beach,1,25,26,52
10440,2023-01-14,EDGAR,brawlBall,Sneaky Fields,0,1,0,1
10441,2023-01-14,EDGAR,bounty,Canal Grande,0,3,0,3
10442,2023-01-13,EDGAR,knockout,Flaring Phoenix,0,8,9,17
10443,2023-01-13,EDGAR,hotZone,Controller Chaos,0,9,0,9
10444,2023-01-13,EDGAR,heist,Hot Potato,0,8,8,16
10445,2023-01-13,EDGAR,gemGrab,Deep Diner,0,3,1,4
10446,2023-01-13,EDGAR,brawlBall,Sneaky Fields,0,25,36,61
10447,2023-01-13,EDGAR,bounty,Temple Ruins,0,2,0,2
10448,2023-01-12,EDGAR,knockout,Riverside,0,8,0,8
10449,2023-01-12,EDGAR,hotZone,Open Zone,0,2,1,3
10450,2023-01-12,EDGAR,heist,Hot Potato,0,3,2,5
10451,2023-01-12,EDGAR,brawlBall,Pinhole Punt,0,6,2,8
10452,2023-01-11,EDGAR,hotZone,Open Zone,0,1,0,1
10453,2023-01-11,EDGAR,heist,Safe Zone,0,0,1,1
10454,2023-01-11,EDGAR,gemGrab,Gem Fort,0,2,0,2
10455,2023-01-11,EDGAR,brawlBall,Sunny Soccer,0,7,3,10
10456,2023-01-11,EDGAR,bounty,Excel,0,3,6,9
10457,2023-01-10,EDGAR,knockout,New Perspective,0,5,3,8
10458,2023-01-10,EDGAR,hotZone,Dueling Beetles,0,6,1,7
10459,2023-01-10,EDGAR,heist,Safe Zone,0,1,0,1
10460,2023-01-10,EDGAR,gemGrab,Minecart Madness,0,3,0,3
10461,2023-01-10,EDGAR,gemGrab,Crystal Arcade,0,4,0,4
10462,2023-01-10,EDGAR,brawlBall,Center Stage,0,1,0,1
10463,2023-01-10,EDGAR,brawlBall,Beach Ball,0,8,4,12
10464,2023-01-10,EDGAR,bounty,Excel,0,0,1,1
10465,2023-01-09,EDGAR,knockout,New Perspective,0,6,3,9
10466,2023-01-09,EDGAR,hotZone,Dueling Beetles,0,4,0,4
10467,2023-01-09,EDGAR,heist,Snaked Assault,0,34,4,38
10468,2023-01-09,EDGAR,gemGrab,Minecart Madness,0,6,1,7
10469,2023-01-09,EDGAR,gemGrab,Double Swoosh,0,3,0,3
10470,2023-01-09,EDGAR,brawlBall,Center Stage,1,27,36,64
10471,2023-01-09,EDGAR,brawlBall,Backyard Bowl,0,2,0,2
10472,2023-01-09,EDGAR,bounty,Layer Cake,0,10,1,11
10473,2023-01-08,EDGAR,knockout,X Marks the Spot,0,6,0,6
10474,2023-01-08,EDGAR,hotZone,Ring of Fire,0,1,0,1
10475,2023-01-08,EDGAR,heist,Snaked Assault,0,12,23,35
10476,2023-01-08,EDGAR,gemGrab,Hard Rock Mine,0,1,0,1
10477,2023-01-08,EDGAR,gemGrab,Double Swoosh,0,3,1,4
10478,2023-01-08,EDGAR,brawlBall,Super Beach,0,0,1,1
10479,2023-01-08,EDGAR,brawlBall,Backyard Bowl,0,4,1,5
10480,2023-01-08,EDGAR,bounty,Layer Cake,0,2,1,3
10481,2023-01-07,EDGAR,knockout,X Marks the Spot,0,0,1,1
10482,2023-01-07,EDGAR,hotZone,Ring of Fire,0,1,0,1
10483,2023-01-07,EDGAR,heist,Tornado Ring,0,14,4,18
10484,2023-01-07,EDGAR,gemGrab,Hard Rock Mine,0,5,2,7
10485,2023-01-07,EDGAR,gemGrab,Deep Diner,0,1,1,2
10486,2023-01-07,EDGAR,brawlBall,Super Beach,0,4,3,7
10487,2023-01-07,EDGAR,brawlBall,Sneaky Fields,0,1,0,1
10488,2023-01-06,EDGAR,knockout,Out in the Open,0,4,2,6
10489,2023-01-06,EDGAR,hotZone,Split,0,6,1,7
10490,2023-01-06,EDGAR,heist,Tornado Ring,1,15,13,29
10491,2023-01-06,EDGAR,gemGrab,Deep Diner,0,5,1,6
10492,2023-01-06,EDGAR,brawlBall,Sneaky Fields,0,19,13,32
10493,2023-01-06,EDGAR,brawlBall,Pinhole Punt,0,2,1,3
10494,2023-01-06,EDGAR,bounty,Dry Season,0,1,0,1
10495,2023-01-05,EDGAR,knockout,Out in the Open,0,5,1,6
10496,2023-01-05,EDGAR,hotZone,Split,0,16,16,32
10497,2023-01-05,EDGAR,heist,Kaboom Canyon,0,9,0,9
10498,2023-01-05,EDGAR,gemGrab,Undermine,0,3,1,4
10499,2023-01-05,EDGAR,gemGrab,Gem Fort,0,1,1,2
10500,2023-01-05,EDGAR,brawlBall,Pinhole Punt,0,14,5,19
10501,2023-01-05,EDGAR,bounty,Shooting Star,0,1,0,1
10502,2023-01-04,EDGAR,knockout,Goldarm Gulch,0,1,1,2
10503,2023-01-04,EDGAR,hotZone,Parallel Plays,0,3,3,6
10504,2023-01-04,EDGAR,heist,Kaboom Canyon,0,12,0,12
10505,2023-01-04,EDGAR,gemGrab,Gem Fort,0,9,20,29
10506,2023-01-04,EDGAR,gemGrab,Crystal Arcade,0,0,2,2
10507,2023-01-04,EDGAR,brawlBall,Sunny Soccer,0,10,2,12
10508,2023-01-04,EDGAR,bounty,Shooting Star,0,2,1,3
10509,2023-01-03,EDGAR,knockout,Goldarm Gulch,0,7,0,7
10510,2023-01-03,EDGAR,hotZone,Parallel Plays,0,3,1,4
10511,2023-01-03,EDGAR,heist,Pit Stop,1,41,33,75
10512,2023-01-03,EDGAR,heist,Kaboom Canyon,0,1,0,1
10513,2023-01-03,EDGAR,gemGrab,Minecart Madness,0,2,0,2
10514,2023-01-03,EDGAR,gemGrab,Crystal Arcade,0,4,0,4
10515,2023-01-03,EDGAR,brawlBall,Center Stage,0,1,0,1
10516,2023-01-03,EDGAR,brawlBall,Beach Ball,0,9,3,12
10517,2023-01-03,EDGAR,bounty,Hideout,0,2,0,2
10518,2023-01-02,EDGAR,knockout,Belle's Rock,0,10,2,12
10519,2023-01-02,EDGAR,hotZone,Quarter Pounder,0,12,0,12
10520,2023-01-02,EDGAR,heist,Pit Stop,0,96,145,241
10521,2023-01-02,EDGAR,gemGrab,Minecart Madness,0,4,2,6
10522,2023-01-02,EDGAR,brawlBall,Center Stage,0,24,17,41
10523,2023-01-02,EDGAR,bounty,Hideout,0,3,1,4
10524,2023-01-01,EDGAR,knockout,Belle's Rock,0,11,8,19
10525,2023-01-01,EDGAR,hotZone,Quarter Pounder,0,2,0,2
10526,2023-01-01,EDGAR,heist,Kaboom Canyon,0,1,0,1
10527,2023-01-01,EDGAR,gemGrab,Double Swoosh,0,3,1,4
10528,2023-01-01,EDGAR,brawlBall,Backyard Bowl,0,5,2,7
10529,2022-12-31,EDGAR,hotZone,Controller Chaos,0,0,2,2
10530,2022-12-31,EDGAR,heist,Kaboom Canyon,0,1,0,1
10531,2022-12-31,EDGAR,gemGrab,Hard Rock Mine,0,0,1,1
10532,2022-12-31,EDGAR,gemGrab,Deep Diner,0,1,0,1
10533,2022-12-31,EDGAR,brawlBall,Super Beach,0,1,0,1
10534,2022-12-30,EDGAR,hotZone,Controller Chaos,0,0,1,1
10535,2022-12-30,EDGAR,brawlBall,Sneaky Fields,0,1,0,1
10536,2022-12-29,EDGAR,heist,Kaboom Canyon,0,0,1,1
10537,2022-12-29,EDGAR,gemGrab,Minecart Madness,0,1,0,1
10538,2022-12-29,EDGAR,brawlBall,Pinhole Punt,0,1,0,1
10539,2022-12-27,EDGAR,hotZone,Dueling Beetles,0,0,1,1
10540,2022-12-27,EDGAR,brawlBall,Beach Ball,0,1,1,2
10541,2022-12-26,EDGAR,hotZone,Controller Chaos,0,0,1,1
10542,2022-12-26,EDGAR,heist,Kaboom Canyon,0,2,1,3
10543,2022-12-26,EDGAR,gemGrab,Minecart Madness,0,0,1,1
10544,2022-12-25,EDGAR,hotZone,Ring of Fire,0,0,1,1
10545,2022-12-24,EDGAR,brawlBall,Super Beach,0,0,1,1
10546,2022-12-23,EDGAR,knockout,Out in the Open,0,1,1,2
10547,2022-12-19,EDGAR,brawlBall,Center Stage,0,1,0,1
10548,2022-12-13,EDGAR,heist,Safe Zone,0,1,1,2
10549,2022-12-10,EDGAR,gemGrab,Hard Rock Mine,0,0,1,1
10550,2022-11-11,EDGAR,brawlBall,Sneaky Fields,0,1,0,1
10551,2022-11-03,EDGAR,bounty,Temple Ruins,0,0,1,1
10552,2023-01-30,DYNAMIKE,knockout,Belle's Rock,0,374,205,579
10553,2023-01-30,DYNAMIKE,hotZone,Quarter Pounder,1,387,432,820
10554,2023-01-30,DYNAMIKE,heist,Pit Stop,0,563,493,1056
10555,2023-01-30,DYNAMIKE,gemGrab,Minecart Madness,0,74,46,120
10556,2023-01-30,DYNAMIKE,gemGrab,Double Swoosh,0,51,33,84
10557,2023-01-30,DYNAMIKE,brawlBall,Center Stage,8,413,233,654
10558,2023-01-30,DYNAMIKE,brawlBall,Backyard Bowl,0,42,11,53
10559,2023-01-30,DYNAMIKE,bounty,Hideout,0,43,16,59
10560,2023-01-29,DYNAMIKE,knockout,Belle's Rock,0,325,175,500
10561,2023-01-29,DYNAMIKE,hotZone,Quarter Pounder,1,256,247,504
10562,2023-01-29,DYNAMIKE,heist,Bridge Too Far,0,35,14,49
10563,2023-01-29,DYNAMIKE,gemGrab,Hard Rock Mine,0,18,10,28
10564,2023-01-29,DYNAMIKE,gemGrab,Double Swoosh,0,92,56,148
10565,2023-01-29,DYNAMIKE,brawlBall,Super Beach,1,26,34,61
10566,2023-01-29,DYNAMIKE,brawlBall,Backyard Bowl,9,368,204,581
10567,2023-01-29,DYNAMIKE,bounty,Canal Grande,0,114,60,174
10568,2023-01-28,DYNAMIKE,knockout,Flaring Phoenix,0,121,81,202
10569,2023-01-28,DYNAMIKE,hotZone,Controller Chaos,0,298,245,543
10570,2023-01-28,DYNAMIKE,heist,Bridge Too Far,0,56,16,72
10571,2023-01-28,DYNAMIKE,gemGrab,Hard Rock Mine,0,81,48,129
10572,2023-01-28,DYNAMIKE,gemGrab,Deep Diner,0,83,86,169
10573,2023-01-28,DYNAMIKE,brawlBall,Super Beach,51,2111,1996,4158
10574,2023-01-28,DYNAMIKE,brawlBall,Sneaky Fields,0,31,21,52
10575,2023-01-28,DYNAMIKE,bounty,Canal Grande,0,155,66,221
10576,2023-01-27,DYNAMIKE,knockout,Flaring Phoenix,0,53,27,80
10577,2023-01-27,DYNAMIKE,hotZone,Controller Chaos,0,51,52,103
10578,2023-01-27,DYNAMIKE,heist,Hot Potato,0,130,98,228
10579,2023-01-27,DYNAMIKE,gemGrab,Undermine,0,8,6,14
10580,2023-01-27,DYNAMIKE,gemGrab,Deep Diner,0,109,96,205
10581,2023-01-27,DYNAMIKE,brawlBall,Sneaky Fields,0,247,162,409
10582,2023-01-27,DYNAMIKE,brawlBall,Pinhole Punt,0,5,2,7
10583,2023-01-27,DYNAMIKE,bounty,Temple Ruins,0,10,1,11
10584,2023-01-26,DYNAMIKE,knockout,Riverside,0,44,31,75
10585,2023-01-26,DYNAMIKE,hotZone,Open Zone,0,39,14,53
10586,2023-01-26,DYNAMIKE,heist,Hot Potato,2,664,760,1426
10587,2023-01-26,DYNAMIKE,gemGrab,Undermine,0,85,41,126
10588,2023-01-26,DYNAMIKE,gemGrab,Gem Fort,0,22,13,35
10589,2023-01-26,DYNAMIKE,brawlBall,Sunny Soccer,0,86,83,169
10590,2023-01-26,DYNAMIKE,brawlBall,Pinhole Punt,16,535,301,852
10591,2023-01-26,DYNAMIKE,bounty,Temple Ruins,0,22,12,34
10592,2023-01-25,DYNAMIKE,knockout,Riverside,0,22,5,27
10593,2023-01-25,DYNAMIKE,hotZone,Open Zone,0,10,0,10
10594,2023-01-25,DYNAMIKE,heist,Safe Zone,0,55,26,81
10595,2023-01-25,DYNAMIKE,gemGrab,Gem Fort,0,35,17,52
10596,2023-01-25,DYNAMIKE,gemGrab,Crystal Arcade,0,69,23,92
10597,2023-01-25,DYNAMIKE,brawlBall,Sunny Soccer,33,1163,1141,2337
10598,2023-01-25,DYNAMIKE,brawlBall,Beach Ball,6,159,114,279
10599,2023-01-25,DYNAMIKE,bounty,Excel,0,87,27,114
10600,2023-01-24,DYNAMIKE,knockout,New Perspective,0,107,82,189
10601,2023-01-24,DYNAMIKE,hotZone,Dueling Beetles,0,134,56,190
10602,2023-01-24,DYNAMIKE,heist,Safe Zone,0,67,25,92
10603,2023-01-24,DYNAMIKE,gemGrab,Minecart Madness,0,33,22,55
10604,2023-01-24,DYNAMIKE,gemGrab,Crystal Arcade,0,107,70,177
10605,2023-01-24,DYNAMIKE,brawlBall,Center Stage,2,60,32,94
10606,2023-01-24,DYNAMIKE,brawlBall,Beach Ball,49,1618,1422,3089
10607,2023-01-24,DYNAMIKE,bounty,Excel,0,117,76,193
10608,2023-01-23,DYNAMIKE,knockout,New Perspective,0,183,101,284
10609,2023-01-23,DYNAMIKE,hotZone,Dueling Beetles,1,199,77,277
10610,2023-01-23,DYNAMIKE,heist,Snaked Assault,2,239,99,340
10611,2023-01-23,DYNAMIKE,gemGrab,Minecart Madness,0,158,97,255
10612,2023-01-23,DYNAMIKE,gemGrab,Double Swoosh,0,40,12,52
10613,2023-01-23,DYNAMIKE,brawlBall,Center Stage,13,719,434,1166
10614,2023-01-23,DYNAMIKE,brawlBall,Backyard Bowl,1,26,5,32
10615,2023-01-23,DYNAMIKE,bounty,Layer Cake,0,177,130,307
10616,2023-01-22,DYNAMIKE,knockout,X Marks the Spot,0,62,31,93
10617,2023-01-22,DYNAMIKE,hotZone,Ring of Fire,0,29,7,36
10618,2023-01-22,DYNAMIKE,heist,Snaked Assault,1,91,48,140
10619,2023-01-22,DYNAMIKE,gemGrab,Hard Rock Mine,0,26,10,36
10620,2023-01-22,DYNAMIKE,gemGrab,Double Swoosh,0,42,48,90
10621,2023-01-22,DYNAMIKE,brawlBall,Super Beach,11,221,267,499
10622,2023-01-22,DYNAMIKE,brawlBall,Backyard Bowl,0,184,68,252
10623,2023-01-22,DYNAMIKE,bounty,Layer Cake,0,78,25,103
10624,2023-01-21,DYNAMIKE,knockout,X Marks the Spot,0,193,89,282
10625,2023-01-21,DYNAMIKE,hotZone,Ring of Fire,0,76,16,92
10626,2023-01-21,DYNAMIKE,heist,Tornado Ring,2,170,86,258
10627,2023-01-21,DYNAMIKE,gemGrab,Hard Rock Mine,0,114,67,181
10628,2023-01-21,DYNAMIKE,gemGrab,Deep Diner,0,80,48,128
10629,2023-01-21,DYNAMIKE,brawlBall,Super Beach,69,2903,2883,5855
10630,2023-01-21,DYNAMIKE,brawlBall,Sneaky Fields,2,32,21,55
10631,2023-01-21,DYNAMIKE,bounty,Dry Season,0,56,15,71
10632,2023-01-20,DYNAMIKE,knockout,Out in the Open,0,90,39,129
10633,2023-01-20,DYNAMIKE,hotZone,Split,0,568,595,1163
10634,2023-01-20,DYNAMIKE,heist,Tornado Ring,4,154,97,255
10635,2023-01-20,DYNAMIKE,gemGrab,Undermine,0,35,11,46
10636,2023-01-20,DYNAMIKE,gemGrab,Deep Diner,0,282,306,588
10637,2023-01-20,DYNAMIKE,brawlBall,Sneaky Fields,14,772,531,1317
10638,2023-01-20,DYNAMIKE,brawlBall,Pinhole Punt,0,28,8,36
10639,2023-01-20,DYNAMIKE,bounty,Dry Season,0,39,23,62
10640,2023-01-19,DYNAMIKE,knockout,Out in the Open,1,117,80,198
10641,2023-01-19,DYNAMIKE,hotZone,Split,0,965,976,1941
10642,2023-01-19,DYNAMIKE,heist,Kaboom Canyon,0,64,19,83
10643,2023-01-19,DYNAMIKE,gemGrab,Undermine,0,99,60,159
10644,2023-01-19,DYNAMIKE,gemGrab,Gem Fort,0,14,2,16
10645,2023-01-19,DYNAMIKE,brawlBall,Sunny Soccer,1,75,66,142
10646,2023-01-19,DYNAMIKE,brawlBall,Pinhole Punt,11,561,339,911
10647,2023-01-19,DYNAMIKE,bounty,Shooting Star,0,37,17,54
10648,2023-01-18,DYNAMIKE,knockout,Goldarm Gulch,0,19,11,30
10649,2023-01-18,DYNAMIKE,hotZone,Parallel Plays,0,20,20,40
10650,2023-01-18,DYNAMIKE,heist,Kaboom Canyon,0,18,9,27
10651,2023-01-18,DYNAMIKE,gemGrab,Gem Fort,0,12,12,24
10652,2023-01-18,DYNAMIKE,gemGrab,Crystal Arcade,0,9,10,19
10653,2023-01-18,DYNAMIKE,brawlBall,Sunny Soccer,10,551,428,989
10654,2023-01-18,DYNAMIKE,brawlBall,Beach Ball,0,30,15,45
10655,2023-01-18,DYNAMIKE,bounty,Shooting Star,0,15,2,17
10656,2023-01-17,DYNAMIKE,knockout,Goldarm Gulch,0,15,5,20
10657,2023-01-17,DYNAMIKE,hotZone,Parallel Plays,0,7,9,16
10658,2023-01-17,DYNAMIKE,heist,Pit Stop,0,67,51,118
10659,2023-01-17,DYNAMIKE,gemGrab,Minecart Madness,0,1,0,1
10660,2023-01-17,DYNAMIKE,gemGrab,Crystal Arcade,0,4,5,9
10661,2023-01-17,DYNAMIKE,brawlBall,Center Stage,0,1,1,2
10662,2023-01-17,DYNAMIKE,brawlBall,Beach Ball,5,152,154,311
10663,2023-01-17,DYNAMIKE,bounty,Hideout,0,5,2,7
10664,2023-01-16,DYNAMIKE,knockout,Belle's Rock,0,25,12,37
10665,2023-01-16,DYNAMIKE,hotZone,Quarter Pounder,0,34,35,69
10666,2023-01-16,DYNAMIKE,heist,Pit Stop,0,176,102,278
10667,2023-01-16,DYNAMIKE,gemGrab,Minecart Madness,0,15,6,21
10668,2023-01-16,DYNAMIKE,gemGrab,Double Swoosh,0,4,1,5
10669,2023-01-16,DYNAMIKE,brawlBall,Center Stage,0,39,19,58
10670,2023-01-16,DYNAMIKE,brawlBall,Backyard Bowl,0,9,10,19
10671,2023-01-16,DYNAMIKE,bounty,Hideout,0,14,8,22
10672,2023-01-15,DYNAMIKE,knockout,Belle's Rock,0,25,13,38
10673,2023-01-15,DYNAMIKE,hotZone,Quarter Pounder,0,60,58,118
10674,2023-01-15,DYNAMIKE,heist,Bridge Too Far,0,5,2,7
10675,2023-01-15,DYNAMIKE,gemGrab,Hard Rock Mine,0,3,0,3
10676,2023-01-15,DYNAMIKE,gemGrab,Double Swoosh,0,4,1,5
10677,2023-01-15,DYNAMIKE,brawlBall,Super Beach,3,34,40,77
10678,2023-01-15,DYNAMIKE,brawlBall,Backyard Bowl,1,52,19,72
10679,2023-01-15,DYNAMIKE,bounty,Canal Grande,0,9,2,11
10680,2023-01-14,DYNAMIKE,knockout,Flaring Phoenix,0,6,5,11
10681,2023-01-14,DYNAMIKE,hotZone,Controller Chaos,0,66,23,89
10682,2023-01-14,DYNAMIKE,heist,Bridge Too Far,0,7,0,7
10683,2023-01-14,DYNAMIKE,gemGrab,Hard Rock Mine,0,7,0,7
10684,2023-01-14,DYNAMIKE,gemGrab,Deep Diner,0,14,37,51
10685,2023-01-14,DYNAMIKE,brawlBall,Super Beach,7,207,187,401
10686,2023-01-14,DYNAMIKE,brawlBall,Sneaky Fields,0,6,1,7
10687,2023-01-14,DYNAMIKE,bounty,Canal Grande,0,11,0,11
10688,2023-01-13,DYNAMIKE,knockout,Flaring Phoenix,0,10,5,15
10689,2023-01-13,DYNAMIKE,hotZone,Controller Chaos,0,63,39,102
10690,2023-01-13,DYNAMIKE,heist,Hot Potato,0,31,32,63
10691,2023-01-13,DYNAMIKE,gemGrab,Deep Diner,0,27,39,66
10692,2023-01-13,DYNAMIKE,brawlBall,Sneaky Fields,0,43,25,68
10693,2023-01-13,DYNAMIKE,bounty,Temple Ruins,0,0,8,8
10694,2023-01-12,DYNAMIKE,knockout,Riverside,0,11,4,15
10695,2023-01-12,DYNAMIKE,hotZone,Open Zone,0,6,0,6
10696,2023-01-12,DYNAMIKE,heist,Hot Potato,0,22,34,56
10697,2023-01-12,DYNAMIKE,gemGrab,Undermine,0,4,1,5
10698,2023-01-12,DYNAMIKE,brawlBall,Sunny Soccer,0,5,1,6
10699,2023-01-12,DYNAMIKE,brawlBall,Pinhole Punt,0,11,3,14
10700,2023-01-11,DYNAMIKE,hotZone,Open Zone,0,1,0,1
10701,2023-01-11,DYNAMIKE,gemGrab,Gem Fort,0,1,0,1
10702,2023-01-11,DYNAMIKE,brawlBall,Sunny Soccer,1,40,25,66
10703,2023-01-11,DYNAMIKE,brawlBall,Beach Ball,0,1,0,1
10704,2023-01-11,DYNAMIKE,bounty,Excel,0,2,13,15
10705,2023-01-10,DYNAMIKE,knockout,New Perspective,0,13,3,16
10706,2023-01-10,DYNAMIKE,hotZone,Dueling Beetles,0,25,3,28
10707,2023-01-10,DYNAMIKE,heist,Safe Zone,0,4,0,4
10708,2023-01-10,DYNAMIKE,gemGrab,Minecart Madness,0,5,0,5
10709,2023-01-10,DYNAMIKE,gemGrab,Crystal Arcade,0,6,2,8
10710,2023-01-10,DYNAMIKE,brawlBall,Center Stage,0,6,0,6
10711,2023-01-10,DYNAMIKE,brawlBall,Beach Ball,3,86,99,188
10712,2023-01-10,DYNAMIKE,bounty,Excel,0,11,33,44
10713,2023-01-09,DYNAMIKE,knockout,New Perspective,0,5,1,6
10714,2023-01-09,DYNAMIKE,hotZone,Dueling Beetles,0,16,0,16
10715,2023-01-09,DYNAMIKE,heist,Snaked Assault,0,24,1,25
10716,2023-01-09,DYNAMIKE,gemGrab,Minecart Madness,0,20,14,34
10717,2023-01-09,DYNAMIKE,gemGrab,Double Swoosh,0,8,0,8
10718,2023-01-09,DYNAMIKE,brawlBall,Center Stage,1,23,6,30
10719,2023-01-09,DYNAMIKE,brawlBall,Backyard Bowl,0,2,1,3
10720,2023-01-09,DYNAMIKE,bounty,Layer Cake,0,24,10,34
10721,2023-01-08,DYNAMIKE,knockout,X Marks the Spot,0,17,4,21
10722,2023-01-08,DYNAMIKE,hotZone,Ring of Fire,0,5,1,6
10723,2023-01-08,DYNAMIKE,heist,Snaked Assault,0,18,3,21
10724,2023-01-08,DYNAMIKE,gemGrab,Hard Rock Mine,0,2,0,2
10725,2023-01-08,DYNAMIKE,gemGrab,Double Swoosh,0,1,1,2
10726,2023-01-08,DYNAMIKE,brawlBall,Super Beach,2,32,30,64
10727,2023-01-08,DYNAMIKE,brawlBall,Backyard Bowl,0,17,3,20
10728,2023-01-08,DYNAMIKE,bounty,Layer Cake,0,6,2,8
10729,2023-01-07,DYNAMIKE,knockout,X Marks the Spot,0,5,1,6
10730,2023-01-07,DYNAMIKE,heist,Tornado Ring,1,16,29,46
10731,2023-01-07,DYNAMIKE,gemGrab,Hard Rock Mine,0,1,2,3
10732,2023-01-07,DYNAMIKE,gemGrab,Deep Diner,0,21,17,38
10733,2023-01-07,DYNAMIKE,brawlBall,Super Beach,1,64,57,122
10734,2023-01-07,DYNAMIKE,brawlBall,Sneaky Fields,0,4,0,4
10735,2023-01-07,DYNAMIKE,bounty,Dry Season,0,4,0,4
10736,2023-01-06,DYNAMIKE,knockout,Out in the Open,0,6,0,6
10737,2023-01-06,DYNAMIKE,hotZone,Split,0,68,47,115
10738,2023-01-06,DYNAMIKE,heist,Tornado Ring,0,28,6,34
10739,2023-01-06,DYNAMIKE,gemGrab,Undermine,0,1,0,1
10740,2023-01-06,DYNAMIKE,gemGrab,Deep Diner,0,33,45,78
10741,2023-01-06,DYNAMIKE,brawlBall,Sneaky Fields,0,23,7,30
10742,2023-01-06,DYNAMIKE,brawlBall,Pinhole Punt,0,2,0,2
10743,2023-01-06,DYNAMIKE,bounty,Dry Season,0,2,0,2
10744,2023-01-05,DYNAMIKE,knockout,Out in the Open,0,3,3,6
10745,2023-01-05,DYNAMIKE,hotZone,Split,0,176,153,329
10746,2023-01-05,DYNAMIKE,heist,Kaboom Canyon,0,11,1,12
10747,2023-01-05,DYNAMIKE,gemGrab,Undermine,0,7,9,16
10748,2023-01-05,DYNAMIKE,gemGrab,Gem Fort,0,3,7,10
10749,2023-01-05,DYNAMIKE,brawlBall,Sunny Soccer,0,3,5,8
10750,2023-01-05,DYNAMIKE,brawlBall,Pinhole Punt,2,36,13,51
10751,2023-01-05,DYNAMIKE,bounty,Shooting Star,0,3,0,3
10752,2023-01-04,DYNAMIKE,knockout,Goldarm Gulch,0,5,2,7
10753,2023-01-04,DYNAMIKE,hotZone,Parallel Plays,0,16,3,19
10754,2023-01-04,DYNAMIKE,heist,Kaboom Canyon,0,15,1,16
10755,2023-01-04,DYNAMIKE,gemGrab,Gem Fort,0,1,1,2
10756,2023-01-04,DYNAMIKE,gemGrab,Crystal Arcade,0,3,1,4
10757,2023-01-04,DYNAMIKE,brawlBall,Sunny Soccer,1,165,170,336
10758,2023-01-04,DYNAMIKE,brawlBall,Beach Ball,0,1,0,1
10759,2023-01-04,DYNAMIKE,bounty,Shooting Star,0,3,0,3
10760,2023-01-03,DYNAMIKE,knockout,Goldarm Gulch,0,1,2,3
10761,2023-01-03,DYNAMIKE,hotZone,Parallel Plays,0,17,1,18
10762,2023-01-03,DYNAMIKE,hotZone,Controller Chaos,0,1,0,1
10763,2023-01-03,DYNAMIKE,heist,Pit Stop,0,77,38,115
10764,2023-01-03,DYNAMIKE,gemGrab,Minecart Madness,0,3,0,3
10765,2023-01-03,DYNAMIKE,gemGrab,Crystal Arcade,0,9,1,10
10766,2023-01-03,DYNAMIKE,brawlBall,Center Stage,0,2,0,2
10767,2023-01-03,DYNAMIKE,brawlBall,Beach Ball,1,114,98,213
10768,2023-01-03,DYNAMIKE,bounty,Hideout,0,8,0,8
10769,2023-01-02,DYNAMIKE,knockout,Belle's Rock,0,28,3,31
10770,2023-01-02,DYNAMIKE,hotZone,Quarter Pounder,0,47,14,61
10771,2023-01-02,DYNAMIKE,heist,Pit Stop,0,129,125,254
10772,2023-01-02,DYNAMIKE,gemGrab,Minecart Madness,0,15,3,18
10773,2023-01-02,DYNAMIKE,gemGrab,Double Swoosh,0,2,2,4
10774,2023-01-02,DYNAMIKE,brawlBall,Center Stage,0,44,28,72
10775,2023-01-02,DYNAMIKE,brawlBall,Backyard Bowl,0,5,1,6
10776,2023-01-02,DYNAMIKE,bounty,Hideout,0,13,2,15
10777,2023-01-01,DYNAMIKE,knockout,Belle's Rock,0,3,0,3
10778,2023-01-01,DYNAMIKE,hotZone,Quarter Pounder,0,18,3,21
10779,2023-01-01,DYNAMIKE,heist,Bridge Too Far,0,1,0,1
10780,2023-01-01,DYNAMIKE,gemGrab,Double Swoosh,0,9,1,10
10781,2023-01-01,DYNAMIKE,brawlBall,Backyard Bowl,0,13,6,19
10782,2023-01-01,DYNAMIKE,bounty,Canal Grande,0,3,0,3
10783,2022-12-31,DYNAMIKE,hotZone,Controller Chaos,0,4,4,8
10784,2022-12-31,DYNAMIKE,gemGrab,Hard Rock Mine,0,2,0,2
10785,2022-12-31,DYNAMIKE,gemGrab,Deep Diner,0,2,1,3
10786,2022-12-31,DYNAMIKE,brawlBall,Super Beach,1,23,27,51
10787,2022-12-30,DYNAMIKE,knockout,Flaring Phoenix,0,1,0,1
10788,2022-12-30,DYNAMIKE,hotZone,Controller Chaos,0,3,1,4
10789,2022-12-30,DYNAMIKE,heist,Hot Potato,0,2,2,4
10790,2022-12-30,DYNAMIKE,gemGrab,Minecart Madness,0,1,0,1
10791,2022-12-30,DYNAMIKE,gemGrab,Deep Diner,0,2,4,6
10792,2022-12-30,DYNAMIKE,brawlBall,Sneaky Fields,0,5,2,7
10793,2022-12-29,DYNAMIKE,hotZone,Controller Chaos,0,1,0,1
10794,2022-12-29,DYNAMIKE,heist,Hot Potato,0,2,8,10
10795,2022-12-29,DYNAMIKE,gemGrab,Minecart Madness,0,1,1,2
10796,2022-12-29,DYNAMIKE,gemGrab,Gem Fort,0,1,0,1
10797,2022-12-28,DYNAMIKE,brawlBall,Sunny Soccer,0,1,0,1
10798,2022-12-27,DYNAMIKE,hotZone,Dueling Beetles,0,0,1,1
10799,2022-12-27,DYNAMIKE,hotZone,Controller Chaos,0,1,0,1
10800,2022-12-27,DYNAMIKE,gemGrab,Minecart Madness,0,2,0,2
10801,2022-12-27,DYNAMIKE,brawlBall,Beach Ball,0,2,2,4
10802,2022-12-27,DYNAMIKE,bounty,Excel,0,1,0,1
10803,2022-12-26,DYNAMIKE,hotZone,Controller Chaos,0,1,0,1
10804,2022-12-26,DYNAMIKE,heist,Kaboom Canyon,0,1,0,1
10805,2022-12-26,DYNAMIKE,gemGrab,Minecart Madness,0,0,1,1
10806,2022-12-25,DYNAMIKE,brawlBall,Backyard Bowl,0,1,0,1
10807,2022-12-24,DYNAMIKE,brawlBall,Super Beach,0,4,2,6
10808,2022-12-23,DYNAMIKE,knockout,Out in the Open,0,1,0,1
10809,2022-12-22,DYNAMIKE,gemGrab,Gem Fort,0,0,1,1
10810,2022-12-22,DYNAMIKE,brawlBall,Pinhole Punt,0,2,0,2
10811,2022-12-21,DYNAMIKE,brawlBall,Sunny Soccer,0,0,1,1
10812,2022-12-20,DYNAMIKE,brawlBall,Beach Ball,0,2,1,3
10813,2022-12-16,DYNAMIKE,brawlBall,Sneaky Fields,0,1,3,4
10814,2022-12-13,DYNAMIKE,knockout,New Perspective,0,1,0,1
10815,2022-12-13,DYNAMIKE,heist,Safe Zone,0,0,1,1
10816,2022-12-13,DYNAMIKE,gemGrab,Crystal Arcade,0,1,0,1
10817,2022-12-13,DYNAMIKE,brawlBall,Beach Ball,0,1,2,3
10818,2022-12-10,DYNAMIKE,knockout,X Marks the Spot,0,0,1,1
10819,2022-12-10,DYNAMIKE,gemGrab,Hard Rock Mine,0,4,0,4
10820,2022-11-07,DYNAMIKE,hotZone,Quarter Pounder,0,0,1,1
10821,2022-11-03,DYNAMIKE,brawlBall,Pinhole Punt,0,1,1,2
10822,2022-11-01,DYNAMIKE,knockout,New Perspective,0,1,1,2
10823,2022-10-30,DYNAMIKE,bounty,Canal Grande,0,1,0,1
10824,2022-10-28,DYNAMIKE,bounty,Canal Grande,0,1,0,1
10825,2022-10-15,DYNAMIKE,gemGrab,Hard Rock Mine,0,0,1,1
10826,2023-01-30,DARRYL,knockout,Belle's Rock,0,30,11,41
10827,2023-01-30,DARRYL,hotZone,Quarter Pounder,0,49,17,66
10828,2023-01-30,DARRYL,heist,Pit Stop,0,415,511,926
10829,2023-01-30,DARRYL,gemGrab,Minecart Madness,0,24,23,47
10830,2023-01-30,DARRYL,gemGrab,Double Swoosh,0,27,26,53
10831,2023-01-30,DARRYL,brawlBall,Center Stage,14,383,414,811
10832,2023-01-30,DARRYL,brawlBall,Backyard Bowl,2,20,13,35
10833,2023-01-30,DARRYL,bounty,Hideout,0,6,2,8
10834,2023-01-29,DARRYL,knockout,Belle's Rock,0,41,23,64
10835,2023-01-29,DARRYL,hotZone,Quarter Pounder,0,32,9,41
10836,2023-01-29,DARRYL,heist,Bridge Too Far,0,68,93,161
10837,2023-01-29,DARRYL,gemGrab,Hard Rock Mine,0,9,7,16
10838,2023-01-29,DARRYL,gemGrab,Double Swoosh,0,61,41,102
10839,2023-01-29,DARRYL,brawlBall,Super Beach,0,9,5,14
10840,2023-01-29,DARRYL,brawlBall,Backyard Bowl,8,235,196,439
10841,2023-01-29,DARRYL,bounty,Canal Grande,0,42,38,80
10842,2023-01-28,DARRYL,knockout,Flaring Phoenix,0,20,15,35
10843,2023-01-28,DARRYL,hotZone,Controller Chaos,0,39,23,62
10844,2023-01-28,DARRYL,heist,Bridge Too Far,1,127,111,239
10845,2023-01-28,DARRYL,gemGrab,Hard Rock Mine,0,75,57,132
10846,2023-01-28,DARRYL,gemGrab,Deep Diner,0,11,17,28
10847,2023-01-28,DARRYL,brawlBall,Super Beach,8,532,551,1091
10848,2023-01-28,DARRYL,brawlBall,Sneaky Fields,1,29,19,49
10849,2023-01-28,DARRYL,bounty,Canal Grande,0,55,73,128
10850,2023-01-27,DARRYL,knockout,Flaring Phoenix,0,16,4,20
10851,2023-01-27,DARRYL,hotZone,Controller Chaos,0,8,5,13
10852,2023-01-27,DARRYL,heist,Hot Potato,0,59,88,147
10853,2023-01-27,DARRYL,gemGrab,Undermine,0,3,1,4
10854,2023-01-27,DARRYL,gemGrab,Deep Diner,0,25,29,54
10855,2023-01-27,DARRYL,brawlBall,Sneaky Fields,4,199,211,414
10856,2023-01-27,DARRYL,brawlBall,Pinhole Punt,1,6,3,10
10857,2023-01-27,DARRYL,bounty,Temple Ruins,0,8,8,16
10858,2023-01-26,DARRYL,knockout,Riverside,0,23,6,29
10859,2023-01-26,DARRYL,hotZone,Open Zone,0,16,8,24
10860,2023-01-26,DARRYL,heist,Hot Potato,0,368,405,773
10861,2023-01-26,DARRYL,gemGrab,Undermine,0,46,34,80
10862,2023-01-26,DARRYL,gemGrab,Gem Fort,0,20,17,37
10863,2023-01-26,DARRYL,brawlBall,Sunny Soccer,0,35,32,67
10864,2023-01-26,DARRYL,brawlBall,Pinhole Punt,9,435,404,848
10865,2023-01-26,DARRYL,bounty,Temple Ruins,0,10,17,27
10866,2023-01-25,DARRYL,knockout,Riverside,0,13,9,22
10867,2023-01-25,DARRYL,hotZone,Open Zone,0,4,4,8
10868,2023-01-25,DARRYL,heist,Safe Zone,1,91,72,164
10869,2023-01-25,DARRYL,gemGrab,Gem Fort,0,26,15,41
10870,2023-01-25,DARRYL,gemGrab,Crystal Arcade,0,29,16,45
10871,2023-01-25,DARRYL,brawlBall,Sunny Soccer,5,385,404,794
10872,2023-01-25,DARRYL,brawlBall,Beach Ball,2,48,59,109
10873,2023-01-25,DARRYL,bounty,Excel,0,14,11,25
10874,2023-01-24,DARRYL,knockout,New Perspective,0,28,24,52
10875,2023-01-24,DARRYL,hotZone,Dueling Beetles,0,23,7,30
10876,2023-01-24,DARRYL,heist,Safe Zone,0,96,105,201
10877,2023-01-24,DARRYL,gemGrab,Minecart Madness,0,5,3,8
10878,2023-01-24,DARRYL,gemGrab,Crystal Arcade,0,53,41,94
10879,2023-01-24,DARRYL,brawlBall,Center Stage,1,57,60,118
10880,2023-01-24,DARRYL,brawlBall,Beach Ball,11,424,474,909
10881,2023-01-24,DARRYL,bounty,Excel,0,17,12,29
10882,2023-01-23,DARRYL,knockout,New Perspective,0,39,42,81
10883,2023-01-23,DARRYL,hotZone,Dueling Beetles,0,30,25,55
10884,2023-01-23,DARRYL,heist,Snaked Assault,3,239,244,486
10885,2023-01-23,DARRYL,gemGrab,Minecart Madness,0,49,48,97
10886,2023-01-23,DARRYL,gemGrab,Double Swoosh,0,28,21,49
10887,2023-01-23,DARRYL,brawlBall,Center Stage,20,811,867,1698
10888,2023-01-23,DARRYL,brawlBall,Backyard Bowl,0,22,15,37
10889,2023-01-23,DARRYL,bounty,Layer Cake,0,34,26,60
10890,2023-01-22,DARRYL,knockout,X Marks the Spot,0,13,9,22
10891,2023-01-22,DARRYL,hotZone,Ring of Fire,0,13,16,29
10892,2023-01-22,DARRYL,heist,Snaked Assault,0,161,220,381
10893,2023-01-22,DARRYL,gemGrab,Hard Rock Mine,0,16,16,32
10894,2023-01-22,DARRYL,gemGrab,Double Swoosh,0,36,26,62
10895,2023-01-22,DARRYL,brawlBall,Super Beach,1,62,82,145
10896,2023-01-22,DARRYL,brawlBall,Backyard Bowl,3,104,93,200
10897,2023-01-22,DARRYL,bounty,Layer Cake,0,40,50,90
10898,2023-01-21,DARRYL,knockout,X Marks the Spot,0,54,27,81
10899,2023-01-21,DARRYL,hotZone,Ring of Fire,0,39,50,89
10900,2023-01-21,DARRYL,heist,Tornado Ring,1,178,211,390
10901,2023-01-21,DARRYL,gemGrab,Hard Rock Mine,0,89,89,178
10902,2023-01-21,DARRYL,gemGrab,Deep Diner,0,15,17,32
10903,2023-01-21,DARRYL,brawlBall,Super Beach,16,692,664,1372
10904,2023-01-21,DARRYL,brawlBall,Sneaky Fields,0,32,28,60
10905,2023-01-21,DARRYL,bounty,Dry Season,0,13,11,24
10906,2023-01-20,DARRYL,knockout,Out in the Open,0,34,13,47
10907,2023-01-20,DARRYL,hotZone,Split,0,44,52,96
10908,2023-01-20,DARRYL,heist,Tornado Ring,3,228,274,505
10909,2023-01-20,DARRYL,gemGrab,Undermine,0,28,21,49
10910,2023-01-20,DARRYL,gemGrab,Deep Diner,0,51,32,83
10911,2023-01-20,DARRYL,brawlBall,Sneaky Fields,10,640,619,1269
10912,2023-01-20,DARRYL,brawlBall,Pinhole Punt,0,20,15,35
10913,2023-01-20,DARRYL,bounty,Dry Season,0,9,4,13
10914,2023-01-19,DARRYL,knockout,Out in the Open,0,22,9,31
10915,2023-01-19,DARRYL,hotZone,Split,0,64,114,178
10916,2023-01-19,DARRYL,heist,Kaboom Canyon,1,69,50,120
10917,2023-01-19,DARRYL,gemGrab,Undermine,0,58,40,98
10918,2023-01-19,DARRYL,gemGrab,Gem Fort,0,18,22,40
10919,2023-01-19,DARRYL,brawlBall,Sunny Soccer,1,25,36,62
10920,2023-01-19,DARRYL,brawlBall,Pinhole Punt,10,480,503,993
10921,2023-01-19,DARRYL,bounty,Shooting Star,0,8,3,11
10922,2023-01-18,DARRYL,knockout,Goldarm Gulch,0,6,7,13
10923,2023-01-18,DARRYL,hotZone,Parallel Plays,0,5,6,11
10924,2023-01-18,DARRYL,heist,Kaboom Canyon,0,23,14,37
10925,2023-01-18,DARRYL,gemGrab,Gem Fort,0,13,6,19
10926,2023-01-18,DARRYL,gemGrab,Crystal Arcade,0,4,0,4
10927,2023-01-18,DARRYL,brawlBall,Sunny Soccer,0,166,169,335
10928,2023-01-18,DARRYL,brawlBall,Beach Ball,0,11,9,20
10929,2023-01-18,DARRYL,bounty,Shooting Star,0,2,0,2
10930,2023-01-17,DARRYL,knockout,Goldarm Gulch,0,3,9,12
10931,2023-01-17,DARRYL,hotZone,Parallel Plays,0,3,1,4
10932,2023-01-17,DARRYL,heist,Pit Stop,0,37,37,74
10933,2023-01-17,DARRYL,gemGrab,Minecart Madness,0,2,0,2
10934,2023-01-17,DARRYL,gemGrab,Crystal Arcade,0,3,1,4
10935,2023-01-17,DARRYL,brawlBall,Center Stage,0,4,2,6
10936,2023-01-17,DARRYL,brawlBall,Beach Ball,0,44,60,104
10937,2023-01-16,DARRYL,knockout,Belle's Rock,0,3,2,5
10938,2023-01-16,DARRYL,hotZone,Quarter Pounder,0,5,1,6
10939,2023-01-16,DARRYL,heist,Pit Stop,0,132,163,295
10940,2023-01-16,DARRYL,gemGrab,Minecart Madness,0,6,2,8
10941,2023-01-16,DARRYL,gemGrab,Double Swoosh,0,3,1,4
10942,2023-01-16,DARRYL,brawlBall,Center Stage,1,39,36,76
10943,2023-01-16,DARRYL,brawlBall,Backyard Bowl,0,2,0,2
10944,2023-01-15,DARRYL,knockout,Belle's Rock,0,4,2,6
10945,2023-01-15,DARRYL,hotZone,Quarter Pounder,0,3,2,5
10946,2023-01-15,DARRYL,heist,Bridge Too Far,0,16,13,29
10947,2023-01-15,DARRYL,gemGrab,Hard Rock Mine,0,2,0,2
10948,2023-01-15,DARRYL,gemGrab,Double Swoosh,0,3,17,20
10949,2023-01-15,DARRYL,brawlBall,Super Beach,0,9,2,11
10950,2023-01-15,DARRYL,brawlBall,Backyard Bowl,2,31,29,62
10951,2023-01-15,DARRYL,bounty,Canal Grande,0,4,2,6
10952,2023-01-14,DARRYL,knockout,Flaring Phoenix,0,4,5,9
10953,2023-01-14,DARRYL,hotZone,Controller Chaos,0,20,17,37
10954,2023-01-14,DARRYL,heist,Bridge Too Far,0,23,14,37
10955,2023-01-14,DARRYL,gemGrab,Hard Rock Mine,0,5,6,11
10956,2023-01-14,DARRYL,gemGrab,Deep Diner,0,2,0,2
10957,2023-01-14,DARRYL,brawlBall,Super Beach,0,39,24,63
10958,2023-01-14,DARRYL,brawlBall,Sneaky Fields,0,8,0,8
10959,2023-01-14,DARRYL,bounty,Canal Grande,0,7,8,15
10960,2023-01-13,DARRYL,knockout,Flaring Phoenix,0,2,1,3
10961,2023-01-13,DARRYL,hotZone,Controller Chaos,0,9,1,10
10962,2023-01-13,DARRYL,heist,Hot Potato,0,15,23,38
10963,2023-01-13,DARRYL,gemGrab,Deep Diner,0,2,1,3
10964,2023-01-13,DARRYL,brawlBall,Sneaky Fields,0,45,30,75
10965,2023-01-12,DARRYL,knockout,Riverside,0,4,0,4
10966,2023-01-12,DARRYL,hotZone,Open Zone,0,3,1,4
10967,2023-01-12,DARRYL,heist,Hot Potato,0,4,6,10
10968,2023-01-12,DARRYL,gemGrab,Undermine,0,0,1,1
10969,2023-01-12,DARRYL,gemGrab,Gem Fort,0,2,0,2
10970,2023-01-12,DARRYL,brawlBall,Sunny Soccer,0,2,0,2
10971,2023-01-12,DARRYL,brawlBall,Pinhole Punt,1,18,15,34
10972,2023-01-12,DARRYL,bounty,Temple Ruins,0,0,2,2
10973,2023-01-11,DARRYL,gemGrab,Gem Fort,0,1,0,1
10974,2023-01-11,DARRYL,brawlBall,Sunny Soccer,0,15,3,18
10975,2023-01-11,DARRYL,brawlBall,Beach Ball,0,1,1,2
10976,2023-01-11,DARRYL,bounty,Excel,0,3,9,12
10977,2023-01-10,DARRYL,knockout,New Perspective,0,3,5,8
10978,2023-01-10,DARRYL,hotZone,Dueling Beetles,0,8,1,9
10979,2023-01-10,DARRYL,heist,Safe Zone,0,6,3,9
10980,2023-01-10,DARRYL,gemGrab,Minecart Madness,0,1,2,3
10981,2023-01-10,DARRYL,gemGrab,Crystal Arcade,0,2,0,2
10982,2023-01-10,DARRYL,brawlBall,Center Stage,0,3,5,8
10983,2023-01-10,DARRYL,brawlBall,Beach Ball,0,20,22,42
10984,2023-01-09,DARRYL,knockout,New Perspective,0,1,3,4
10985,2023-01-09,DARRYL,hotZone,Dueling Beetles,0,12,4,16
10986,2023-01-09,DARRYL,heist,Snaked Assault,0,37,47,84
10987,2023-01-09,DARRYL,gemGrab,Minecart Madness,0,4,6,10
10988,2023-01-09,DARRYL,gemGrab,Double Swoosh,0,2,0,2
10989,2023-01-09,DARRYL,brawlBall,Center Stage,0,31,23,54
10990,2023-01-09,DARRYL,brawlBall,Backyard Bowl,0,1,7,8
10991,2023-01-09,DARRYL,bounty,Layer Cake,0,2,1,3
10992,2023-01-08,DARRYL,knockout,X Marks the Spot,0,4,1,5
10993,2023-01-08,DARRYL,hotZone,Ring of Fire,0,6,2,8
10994,2023-01-08,DARRYL,heist,Snaked Assault,0,29,44,73
10995,2023-01-08,DARRYL,gemGrab,Hard Rock Mine,0,4,7,11
10996,2023-01-08,DARRYL,gemGrab,Double Swoosh,0,1,1,2
10997,2023-01-08,DARRYL,brawlBall,Super Beach,0,2,1,3
10998,2023-01-08,DARRYL,brawlBall,Backyard Bowl,0,19,3,22
10999,2023-01-08,DARRYL,bounty,Layer Cake,0,1,1,2
11000,2023-01-07,DARRYL,hotZone,Ring of Fire,0,1,0,1
11001,2023-01-07,DARRYL,heist,Tornado Ring,0,44,95,139
11002,2023-01-07,DARRYL,gemGrab,Hard Rock Mine,0,6,11,17
11003,2023-01-07,DARRYL,gemGrab,Deep Diner,0,1,1,2
11004,2023-01-07,DARRYL,brawlBall,Super Beach,0,21,22,43
11005,2023-01-07,DARRYL,brawlBall,Sneaky Fields,0,1,1,2
11006,2023-01-07,DARRYL,bounty,Dry Season,0,2,0,2
11007,2023-01-06,DARRYL,knockout,Out in the Open,0,0,1,1
11008,2023-01-06,DARRYL,hotZone,Split,0,7,18,25
11009,2023-01-06,DARRYL,heist,Tornado Ring,0,55,62,117
11010,2023-01-06,DARRYL,gemGrab,Undermine,0,2,0,2
11011,2023-01-06,DARRYL,gemGrab,Deep Diner,0,5,2,7
11012,2023-01-06,DARRYL,brawlBall,Sneaky Fields,0,30,44,74
11013,2023-01-06,DARRYL,brawlBall,Pinhole Punt,0,7,1,8
11014,2023-01-06,DARRYL,bounty,Dry Season,0,1,0,1
11015,2023-01-05,DARRYL,knockout,Out in the Open,0,1,1,2
11016,2023-01-05,DARRYL,hotZone,Split,0,23,8,31
11017,2023-01-05,DARRYL,heist,Kaboom Canyon,0,9,12,21
11018,2023-01-05,DARRYL,gemGrab,Undermine,0,3,1,4
11019,2023-01-05,DARRYL,brawlBall,Pinhole Punt,0,35,37,72
11020,2023-01-05,DARRYL,bounty,Shooting Star,0,1,1,2
11021,2023-01-04,DARRYL,knockout,Goldarm Gulch,0,1,0,1
11022,2023-01-04,DARRYL,hotZone,Parallel Plays,0,1,0,1
11023,2023-01-04,DARRYL,heist,Kaboom Canyon,0,10,8,18
11024,2023-01-04,DARRYL,gemGrab,Gem Fort,0,2,0,2
11025,2023-01-04,DARRYL,gemGrab,Crystal Arcade,0,4,5,9
11026,2023-01-04,DARRYL,brawlBall,Sunny Soccer,0,59,65,124
11027,2023-01-04,DARRYL,brawlBall,Beach Ball,0,0,1,1
11028,2023-01-04,DARRYL,bounty,Shooting Star,0,1,0,1
11029,2023-01-03,DARRYL,knockout,Goldarm Gulch,0,2,0,2
11030,2023-01-03,DARRYL,hotZone,Parallel Plays,0,4,0,4
11031,2023-01-03,DARRYL,heist,Pit Stop,1,52,75,128
11032,2023-01-03,DARRYL,gemGrab,Minecart Madness,0,1,0,1
11033,2023-01-03,DARRYL,gemGrab,Crystal Arcade,0,10,4,14
11034,2023-01-03,DARRYL,brawlBall,Center Stage,0,2,0,2
11035,2023-01-03,DARRYL,brawlBall,Beach Ball,1,33,20,54
11036,2023-01-03,DARRYL,bounty,Hideout,0,2,0,2
11037,2023-01-02,DARRYL,knockout,Belle's Rock,0,5,2,7
11038,2023-01-02,DARRYL,hotZone,Quarter Pounder,0,9,2,11
11039,2023-01-02,DARRYL,heist,Pit Stop,1,109,155,265
11040,2023-01-02,DARRYL,gemGrab,Minecart Madness,0,5,0,5
11041,2023-01-02,DARRYL,gemGrab,Double Swoosh,0,6,0,6
11042,2023-01-02,DARRYL,brawlBall,Center Stage,0,48,36,84
11043,2023-01-02,DARRYL,brawlBall,Backyard Bowl,0,3,1,4
11044,2023-01-02,DARRYL,bounty,Hideout,0,1,0,1
11045,2023-01-01,DARRYL,hotZone,Quarter Pounder,0,1,0,1
11046,2023-01-01,DARRYL,heist,Bridge Too Far,0,4,9,13
11047,2023-01-01,DARRYL,gemGrab,Double Swoosh,0,5,2,7
11048,2023-01-01,DARRYL,brawlBall,Backyard Bowl,0,5,4,9
11049,2022-12-31,DARRYL,heist,Kaboom Canyon,0,0,1,1
11050,2022-12-31,DARRYL,heist,Bridge Too Far,0,1,1,2
11051,2022-12-31,DARRYL,gemGrab,Hard Rock Mine,0,1,0,1
11052,2022-12-31,DARRYL,gemGrab,Deep Diner,0,1,0,1
11053,2022-12-31,DARRYL,brawlBall,Super Beach,0,3,2,5
11054,2022-12-30,DARRYL,hotZone,Controller Chaos,0,3,1,4
11055,2022-12-30,DARRYL,heist,Kaboom Canyon,0,1,0,1
11056,2022-12-30,DARRYL,heist,Hot Potato,0,0,1,1
11057,2022-12-30,DARRYL,gemGrab,Deep Diner,0,3,0,3
11058,2022-12-30,DARRYL,brawlBall,Sneaky Fields,0,3,4,7
11059,2022-12-29,DARRYL,hotZone,Controller Chaos,0,0,1,1
11060,2022-12-29,DARRYL,heist,Hot Potato,0,3,0,3
11061,2022-12-29,DARRYL,gemGrab,Gem Fort,0,0,1,1
11062,2022-12-29,DARRYL,brawlBall,Pinhole Punt,0,0,12,12
11063,2022-12-27,DARRYL,hotZone,Dueling Beetles,0,0,1,1
11064,2022-12-27,DARRYL,brawlBall,Beach Ball,0,0,1,1
11065,2022-12-26,DARRYL,gemGrab,Minecart Madness,0,1,0,1
11066,2022-12-22,DARRYL,gemGrab,Gem Fort,0,0,1,1
11067,2022-12-19,DARRYL,brawlBall,Center Stage,0,1,1,2
11068,2022-12-16,DARRYL,brawlBall,Sneaky Fields,0,0,1,1
11069,2022-12-13,DARRYL,heist,Safe Zone,0,1,0,1
11070,2022-12-13,DARRYL,brawlBall,Beach Ball,0,1,0,1
11071,2022-11-11,DARRYL,brawlBall,Sneaky Fields,0,0,1,1
11072,2022-11-03,DARRYL,brawlBall,Pinhole Punt,0,1,0,1
11073,2022-10-28,DARRYL,heist,Safe Zone,0,1,0,1
11074,2022-10-28,DARRYL,bounty,Canal Grande,0,1,0,1
11075,2022-10-26,DARRYL,brawlBall,Sunny Soccer,0,1,0,1
11076,2022-10-15,DARRYL,gemGrab,Hard Rock Mine,0,1,0,1
11077,2023-01-30,CROW,knockout,Belle's Rock,0,144,50,194
11078,2023-01-30,CROW,hotZone,Quarter Pounder,0,281,95,376
11079,2023-01-30,CROW,heist,Pit Stop,0,12,4,16
11080,2023-01-30,CROW,gemGrab,Minecart Madness,0,275,241,516
11081,2023-01-30,CROW,gemGrab,Double Swoosh,0,309,353,662
11082,2023-01-30,CROW,brawlBall,Center Stage,20,713,627,1360
11083,2023-01-30,CROW,brawlBall,Backyard Bowl,10,177,193,380
11084,2023-01-30,CROW,bounty,Hideout,0,40,16,56
11085,2023-01-29,CROW,knockout,Belle's Rock,0,131,54,185
11086,2023-01-29,CROW,hotZone,Quarter Pounder,0,151,50,201
11087,2023-01-29,CROW,heist,Bridge Too Far,0,36,9,45
11088,2023-01-29,CROW,gemGrab,Hard Rock Mine,0,62,33,95
11089,2023-01-29,CROW,gemGrab,Double Swoosh,0,472,470,942
11090,2023-01-29,CROW,brawlBall,Super Beach,0,19,10,29
11091,2023-01-29,CROW,brawlBall,Backyard Bowl,101,1941,1848,3890
11092,2023-01-29,CROW,bounty,Canal Grande,0,50,24,74
11093,2023-01-28,CROW,knockout,Flaring Phoenix,2,110,49,161
11094,2023-01-28,CROW,hotZone,Controller Chaos,0,82,43,125
11095,2023-01-28,CROW,heist,Bridge Too Far,2,84,45,131
11096,2023-01-28,CROW,gemGrab,Hard Rock Mine,0,321,231,552
11097,2023-01-28,CROW,gemGrab,Deep Diner,0,125,60,185
11098,2023-01-28,CROW,brawlBall,Super Beach,23,813,696,1532
11099,2023-01-28,CROW,brawlBall,Sneaky Fields,1,29,18,48
11100,2023-01-28,CROW,bounty,Canal Grande,0,94,65,159
11101,2023-01-27,CROW,knockout,Flaring Phoenix,0,69,39,108
11102,2023-01-27,CROW,hotZone,Controller Chaos,0,24,15,39
11103,2023-01-27,CROW,heist,Hot Potato,0,19,3,22
11104,2023-01-27,CROW,gemGrab,Undermine,0,33,31,64
11105,2023-01-27,CROW,gemGrab,Deep Diner,0,152,96,248
11106,2023-01-27,CROW,brawlBall,Sneaky Fields,3,174,192,369
11107,2023-01-27,CROW,brawlBall,Pinhole Punt,0,26,28,54
11108,2023-01-27,CROW,bounty,Temple Ruins,0,47,76,123
11109,2023-01-26,CROW,knockout,Riverside,0,178,69,247
11110,2023-01-26,CROW,hotZone,Open Zone,0,482,501,983
11111,2023-01-26,CROW,heist,Hot Potato,0,28,12,40
11112,2023-01-26,CROW,gemGrab,Undermine,0,350,306,656
11113,2023-01-26,CROW,gemGrab,Gem Fort,0,107,132,239
11114,2023-01-26,CROW,brawlBall,Sunny Soccer,0,46,47,93
11115,2023-01-26,CROW,brawlBall,Pinhole Punt,57,1811,1935,3803
11116,2023-01-26,CROW,bounty,Temple Ruins,0,138,142,280
11117,2023-01-25,CROW,knockout,Riverside,0,74,30,104
11118,2023-01-25,CROW,hotZone,Open Zone,0,293,321,614
11119,2023-01-25,CROW,heist,Safe Zone,2,79,58,139
11120,2023-01-25,CROW,gemGrab,Gem Fort,0,165,190,355
11121,2023-01-25,CROW,gemGrab,Crystal Arcade,0,192,103,295
11122,2023-01-25,CROW,brawlBall,Sunny Soccer,9,463,402,874
11123,2023-01-25,CROW,brawlBall,Beach Ball,5,110,88,203
11124,2023-01-25,CROW,bounty,Excel,0,40,17,57
11125,2023-01-24,CROW,knockout,New Perspective,0,172,75,247
11126,2023-01-24,CROW,hotZone,Dueling Beetles,0,104,77,181
11127,2023-01-24,CROW,heist,Safe Zone,0,78,40,118
11128,2023-01-24,CROW,gemGrab,Minecart Madness,0,95,90,185
11129,2023-01-24,CROW,gemGrab,Crystal Arcade,0,261,160,421
11130,2023-01-24,CROW,brawlBall,Center Stage,1,127,110,238
11131,2023-01-24,CROW,brawlBall,Beach Ball,35,935,849,1819
11132,2023-01-24,CROW,bounty,Excel,0,60,39,99
11133,2023-01-23,CROW,knockout,New Perspective,3,289,150,442
11134,2023-01-23,CROW,hotZone,Dueling Beetles,0,173,78,251
11135,2023-01-23,CROW,heist,Snaked Assault,1,64,32,97
11136,2023-01-23,CROW,gemGrab,Minecart Madness,0,497,557,1054
11137,2023-01-23,CROW,gemGrab,Double Swoosh,0,289,305,594
11138,2023-01-23,CROW,brawlBall,Center Stage,35,1244,1137,2416
11139,2023-01-23,CROW,brawlBall,Backyard Bowl,10,146,128,284
11140,2023-01-23,CROW,bounty,Layer Cake,0,63,37,100
11141,2023-01-22,CROW,knockout,X Marks the Spot,0,78,73,151
11142,2023-01-22,CROW,hotZone,Ring of Fire,1,177,212,390
11143,2023-01-22,CROW,heist,Snaked Assault,0,20,7,27
11144,2023-01-22,CROW,gemGrab,Hard Rock Mine,0,69,46,115
11145,2023-01-22,CROW,gemGrab,Double Swoosh,0,312,366,678
11146,2023-01-22,CROW,brawlBall,Super Beach,4,63,49,116
11147,2023-01-22,CROW,brawlBall,Backyard Bowl,57,1000,961,2018
11148,2023-01-22,CROW,bounty,Layer Cake,0,36,17,53
11149,2023-01-21,CROW,knockout,X Marks the Spot,0,326,171,497
11150,2023-01-21,CROW,hotZone,Ring of Fire,0,476,520,996
11151,2023-01-21,CROW,heist,Tornado Ring,1,67,72,140
11152,2023-01-21,CROW,gemGrab,Hard Rock Mine,0,383,289,672
11153,2023-01-21,CROW,gemGrab,Deep Diner,0,123,84,207
11154,2023-01-21,CROW,brawlBall,Super Beach,31,1185,920,2136
11155,2023-01-21,CROW,brawlBall,Sneaky Fields,1,46,42,89
11156,2023-01-21,CROW,bounty,Dry Season,0,122,56,178
11157,2023-01-20,CROW,knockout,Out in the Open,1,291,159,451
11158,2023-01-20,CROW,hotZone,Split,0,41,10,51
11159,2023-01-20,CROW,heist,Tornado Ring,0,74,51,125
11160,2023-01-20,CROW,gemGrab,Undermine,0,209,195,404
11161,2023-01-20,CROW,gemGrab,Deep Diner,0,386,238,624
11162,2023-01-20,CROW,brawlBall,Sneaky Fields,18,739,611,1368
11163,2023-01-20,CROW,brawlBall,Pinhole Punt,1,70,70,141
11164,2023-01-20,CROW,bounty,Dry Season,0,126,64,190
11165,2023-01-19,CROW,knockout,Out in the Open,0,319,166,485
11166,2023-01-19,CROW,hotZone,Split,0,68,25,93
11167,2023-01-19,CROW,heist,Kaboom Canyon,1,98,110,209
11168,2023-01-19,CROW,gemGrab,Undermine,0,497,435,932
11169,2023-01-19,CROW,gemGrab,Gem Fort,0,86,66,152
11170,2023-01-19,CROW,brawlBall,Sunny Soccer,0,30,27,57
11171,2023-01-19,CROW,brawlBall,Pinhole Punt,57,1981,2081,4119
11172,2023-01-19,CROW,bounty,Shooting Star,0,103,43,146
11173,2023-01-18,CROW,knockout,Goldarm Gulch,0,29,16,45
11174,2023-01-18,CROW,hotZone,Parallel Plays,0,11,16,27
11175,2023-01-18,CROW,heist,Kaboom Canyon,0,65,54,119
11176,2023-01-18,CROW,gemGrab,Gem Fort,0,96,114,210
11177,2023-01-18,CROW,gemGrab,Crystal Arcade,0,26,14,40
11178,2023-01-18,CROW,brawlBall,Sunny Soccer,3,199,169,371
11179,2023-01-18,CROW,brawlBall,Beach Ball,0,19,17,36
11180,2023-01-18,CROW,bounty,Shooting Star,0,37,22,59
11181,2023-01-17,CROW,knockout,Goldarm Gulch,0,25,13,38
11182,2023-01-17,CROW,hotZone,Parallel Plays,0,5,5,10
11183,2023-01-17,CROW,heist,Pit Stop,0,4,0,4
11184,2023-01-17,CROW,gemGrab,Minecart Madness,0,5,3,8
11185,2023-01-17,CROW,gemGrab,Crystal Arcade,0,22,15,37
11186,2023-01-17,CROW,brawlBall,Center Stage,1,1,3,5
11187,2023-01-17,CROW,brawlBall,Beach Ball,7,71,72,150
11188,2023-01-17,CROW,bounty,Hideout,0,11,2,13
11189,2023-01-16,CROW,knockout,Belle's Rock,0,10,1,11
11190,2023-01-16,CROW,hotZone,Quarter Pounder,0,27,7,34
11191,2023-01-16,CROW,heist,Pit Stop,0,5,0,5
11192,2023-01-16,CROW,gemGrab,Minecart Madness,0,44,52,96
11193,2023-01-16,CROW,gemGrab,Double Swoosh,0,23,9,32
11194,2023-01-16,CROW,brawlBall,Center Stage,1,73,72,146
11195,2023-01-16,CROW,brawlBall,Backyard Bowl,0,34,30,64
11196,2023-01-16,CROW,bounty,Hideout,0,23,4,27
11197,2023-01-15,CROW,knockout,Belle's Rock,0,12,6,18
11198,2023-01-15,CROW,hotZone,Quarter Pounder,0,62,23,85
11199,2023-01-15,CROW,heist,Bridge Too Far,0,8,0,8
11200,2023-01-15,CROW,gemGrab,Hard Rock Mine,0,19,12,31
11201,2023-01-15,CROW,gemGrab,Double Swoosh,0,70,92,162
11202,2023-01-15,CROW,brawlBall,Super Beach,0,12,3,15
11203,2023-01-15,CROW,brawlBall,Backyard Bowl,15,326,374,715
11204,2023-01-15,CROW,bounty,Canal Grande,0,5,2,7
11205,2023-01-14,CROW,knockout,Flaring Phoenix,0,5,6,11
11206,2023-01-14,CROW,hotZone,Controller Chaos,0,34,14,48
11207,2023-01-14,CROW,heist,Bridge Too Far,0,12,1,13
11208,2023-01-14,CROW,gemGrab,Hard Rock Mine,0,32,4,36
11209,2023-01-14,CROW,gemGrab,Deep Diner,0,20,13,33
11210,2023-01-14,CROW,brawlBall,Super Beach,2,81,47,130
11211,2023-01-14,CROW,brawlBall,Sneaky Fields,0,6,0,6
11212,2023-01-14,CROW,bounty,Canal Grande,0,11,3,14
11213,2023-01-13,CROW,knockout,Flaring Phoenix,0,14,7,21
11214,2023-01-13,CROW,hotZone,Controller Chaos,0,22,5,27
11215,2023-01-13,CROW,heist,Hot Potato,0,1,0,1
11216,2023-01-13,CROW,gemGrab,Undermine,0,1,2,3
11217,2023-01-13,CROW,gemGrab,Deep Diner,0,52,12,64
11218,2023-01-13,CROW,brawlBall,Sneaky Fields,0,56,65,121
11219,2023-01-13,CROW,brawlBall,Pinhole Punt,3,4,9,16
11220,2023-01-13,CROW,bounty,Temple Ruins,0,5,5,10
11221,2023-01-12,CROW,knockout,Riverside,0,12,2,14
11222,2023-01-12,CROW,hotZone,Open Zone,0,68,114,182
11223,2023-01-12,CROW,heist,Hot Potato,0,0,1,1
11224,2023-01-12,CROW,gemGrab,Undermine,0,21,33,54
11225,2023-01-12,CROW,gemGrab,Gem Fort,0,3,1,4
11226,2023-01-12,CROW,brawlBall,Sunny Soccer,0,1,0,1
11227,2023-01-12,CROW,brawlBall,Pinhole Punt,1,74,55,130
11228,2023-01-12,CROW,bounty,Temple Ruins,0,1,0,1
11229,2023-01-11,CROW,hotZone,Open Zone,0,32,28,60
11230,2023-01-11,CROW,gemGrab,Gem Fort,0,10,3,13
11231,2023-01-11,CROW,brawlBall,Sunny Soccer,0,15,8,23
11232,2023-01-11,CROW,brawlBall,Beach Ball,0,1,0,1
11233,2023-01-11,CROW,bounty,Excel,0,1,0,1
11234,2023-01-10,CROW,knockout,New Perspective,0,17,1,18
11235,2023-01-10,CROW,hotZone,Dueling Beetles,0,36,19,55
11236,2023-01-10,CROW,heist,Safe Zone,0,5,2,7
11237,2023-01-10,CROW,gemGrab,Minecart Madness,0,30,25,55
11238,2023-01-10,CROW,gemGrab,Crystal Arcade,0,51,24,75
11239,2023-01-10,CROW,brawlBall,Center Stage,1,14,24,39
11240,2023-01-10,CROW,brawlBall,Beach Ball,1,86,51,138
11241,2023-01-10,CROW,bounty,Excel,0,4,0,4
11242,2023-01-09,CROW,knockout,New Perspective,0,9,2,11
11243,2023-01-09,CROW,hotZone,Dueling Beetles,0,10,8,18
11244,2023-01-09,CROW,heist,Snaked Assault,0,7,3,10
11245,2023-01-09,CROW,gemGrab,Minecart Madness,0,45,41,86
11246,2023-01-09,CROW,gemGrab,Double Swoosh,0,44,35,79
11247,2023-01-09,CROW,brawlBall,Center Stage,1,56,52,109
11248,2023-01-09,CROW,brawlBall,Backyard Bowl,0,17,2,19
11249,2023-01-09,CROW,bounty,Layer Cake,0,11,3,14
11250,2023-01-08,CROW,knockout,X Marks the Spot,0,18,0,18
11251,2023-01-08,CROW,hotZone,Ring of Fire,0,37,17,54
11252,2023-01-08,CROW,heist,Snaked Assault,0,3,3,6
11253,2023-01-08,CROW,gemGrab,Hard Rock Mine,0,5,7,12
11254,2023-01-08,CROW,gemGrab,Double Swoosh,0,27,48,75
11255,2023-01-08,CROW,brawlBall,Super Beach,0,6,5,11
11256,2023-01-08,CROW,brawlBall,Backyard Bowl,5,176,143,324
11257,2023-01-08,CROW,bounty,Layer Cake,0,2,1,3
11258,2023-01-07,CROW,knockout,X Marks the Spot,0,5,1,6
11259,2023-01-07,CROW,hotZone,Ring of Fire,0,34,17,51
11260,2023-01-07,CROW,heist,Tornado Ring,0,12,4,16
11261,2023-01-07,CROW,gemGrab,Hard Rock Mine,0,19,6,25
11262,2023-01-07,CROW,gemGrab,Deep Diner,0,14,23,37
11263,2023-01-07,CROW,brawlBall,Super Beach,0,25,11,36
11264,2023-01-07,CROW,brawlBall,Sneaky Fields,0,3,0,3
11265,2023-01-07,CROW,bounty,Dry Season,0,5,5,10
11266,2023-01-06,CROW,knockout,Out in the Open,0,22,9,31
11267,2023-01-06,CROW,hotZone,Split,0,4,0,4
11268,2023-01-06,CROW,heist,Tornado Ring,0,12,18,30
11269,2023-01-06,CROW,gemGrab,Undermine,0,14,7,21
11270,2023-01-06,CROW,gemGrab,Deep Diner,0,49,24,73
11271,2023-01-06,CROW,brawlBall,Sneaky Fields,3,45,17,65
11272,2023-01-06,CROW,brawlBall,Pinhole Punt,0,23,26,49
11273,2023-01-06,CROW,bounty,Dry Season,0,10,1,11
11274,2023-01-05,CROW,knockout,Out in the Open,1,29,16,46
11275,2023-01-05,CROW,hotZone,Split,0,18,5,23
11276,2023-01-05,CROW,heist,Kaboom Canyon,0,16,1,17
11277,2023-01-05,CROW,gemGrab,Undermine,0,73,47,120
11278,2023-01-05,CROW,gemGrab,Gem Fort,0,10,11,21
11279,2023-01-05,CROW,brawlBall,Sunny Soccer,0,1,1,2
11280,2023-01-05,CROW,brawlBall,Pinhole Punt,9,274,247,530
11281,2023-01-05,CROW,bounty,Shooting Star,0,12,3,15
11282,2023-01-04,CROW,knockout,Goldarm Gulch,0,11,6,17
11283,2023-01-04,CROW,hotZone,Parallel Plays,0,9,1,10
11284,2023-01-04,CROW,heist,Kaboom Canyon,1,42,45,88
11285,2023-01-04,CROW,gemGrab,Gem Fort,0,82,88,170
11286,2023-01-04,CROW,gemGrab,Crystal Arcade,0,18,15,33
11287,2023-01-04,CROW,brawlBall,Sunny Soccer,1,56,28,85
11288,2023-01-04,CROW,brawlBall,Beach Ball,0,1,0,1
11289,2023-01-04,CROW,bounty,Shooting Star,0,22,2,24
11290,2023-01-03,CROW,knockout,Goldarm Gulch,0,4,0,4
11291,2023-01-03,CROW,hotZone,Parallel Plays,0,18,5,23
11292,2023-01-03,CROW,heist,Pit Stop,0,3,0,3
11293,2023-01-03,CROW,gemGrab,Minecart Madness,0,17,5,22
11294,2023-01-03,CROW,gemGrab,Crystal Arcade,0,43,11,54
11295,2023-01-03,CROW,brawlBall,Center Stage,1,3,1,5
11296,2023-01-03,CROW,brawlBall,Beach Ball,0,101,72,173
11297,2023-01-03,CROW,bounty,Hideout,0,9,0,9
11298,2023-01-02,CROW,knockout,Belle's Rock,0,13,1,14
11299,2023-01-02,CROW,hotZone,Quarter Pounder,0,43,16,59
11300,2023-01-02,CROW,heist,Pit Stop,0,2,0,2
11301,2023-01-02,CROW,heist,Kaboom Canyon,0,0,1,1
11302,2023-01-02,CROW,gemGrab,Minecart Madness,0,86,99,185
11303,2023-01-02,CROW,gemGrab,Double Swoosh,0,34,21,55
11304,2023-01-02,CROW,brawlBall,Center Stage,3,92,83,178
11305,2023-01-02,CROW,brawlBall,Backyard Bowl,2,11,13,26
11306,2023-01-02,CROW,bounty,Hideout,0,20,2,22
11307,2023-01-01,CROW,knockout,Belle's Rock,0,2,2,4
11308,2023-01-01,CROW,hotZone,Quarter Pounder,0,10,1,11
11309,2023-01-01,CROW,heist,Bridge Too Far,0,1,0,1
11310,2023-01-01,CROW,gemGrab,Hard Rock Mine,0,1,0,1
11311,2023-01-01,CROW,gemGrab,Double Swoosh,0,26,18,44
11312,2023-01-01,CROW,brawlBall,Backyard Bowl,2,98,95,195
11313,2023-01-01,CROW,bounty,Canal Grande,0,2,0,2
11314,2022-12-31,CROW,hotZone,Controller Chaos,0,2,0,2
11315,2022-12-31,CROW,gemGrab,Hard Rock Mine,0,8,5,13
11316,2022-12-31,CROW,gemGrab,Deep Diner,0,10,2,12
11317,2022-12-31,CROW,brawlBall,Super Beach,0,2,3,5
11318,2022-12-31,CROW,brawlBall,Sneaky Fields,0,0,1,1
11319,2022-12-30,CROW,knockout,Flaring Phoenix,0,0,1,1
11320,2022-12-30,CROW,hotZone,Controller Chaos,0,7,0,7
11321,2022-12-30,CROW,gemGrab,Undermine,0,5,1,6
11322,2022-12-30,CROW,gemGrab,Minecart Madness,0,0,1,1
11323,2022-12-30,CROW,gemGrab,Deep Diner,0,4,1,5
11324,2022-12-30,CROW,brawlBall,Sneaky Fields,0,3,1,4
11325,2022-12-29,CROW,hotZone,Open Zone,0,1,5,6
11326,2022-12-29,CROW,gemGrab,Undermine,0,2,0,2
11327,2022-12-29,CROW,gemGrab,Gem Fort,0,1,1,2
11328,2022-12-29,CROW,brawlBall,Pinhole Punt,0,8,4,12
11329,2022-12-28,CROW,hotZone,Open Zone,0,8,5,13
11330,2022-12-27,CROW,knockout,New Perspective,0,1,0,1
11331,2022-12-27,CROW,hotZone,Controller Chaos,0,1,0,1
11332,2022-12-27,CROW,gemGrab,Minecart Madness,0,2,0,2
11333,2022-12-27,CROW,brawlBall,Beach Ball,0,0,1,1
11334,2022-12-26,CROW,gemGrab,Minecart Madness,0,1,1,2
11335,2022-12-26,CROW,brawlBall,Center Stage,0,1,0,1
11336,2022-12-25,CROW,gemGrab,Double Swoosh,0,1,2,3
11337,2022-12-25,CROW,brawlBall,Backyard Bowl,0,3,0,3
11338,2022-12-24,CROW,brawlBall,Super Beach,0,0,1,1
11339,2022-12-24,CROW,bounty,Dry Season,0,0,1,1
11340,2022-12-23,CROW,knockout,Out in the Open,0,5,0,5
11341,2022-12-22,CROW,heist,Kaboom Canyon,0,0,1,1
11342,2022-12-22,CROW,gemGrab,Gem Fort,0,5,0,5
11343,2022-12-22,CROW,brawlBall,Pinhole Punt,0,4,0,4
11344,2022-12-21,CROW,brawlBall,Sunny Soccer,0,0,1,1
11345,2022-12-20,CROW,brawlBall,Beach Ball,0,1,0,1
11346,2022-12-16,CROW,brawlBall,Sneaky Fields,0,0,2,2
11347,2022-12-13,CROW,knockout,New Perspective,0,2,0,2
11348,2022-12-13,CROW,heist,Safe Zone,0,1,0,1
11349,2022-12-13,CROW,gemGrab,Crystal Arcade,0,0,1,1
11350,2022-12-13,CROW,brawlBall,Beach Ball,0,2,1,3
11351,2022-12-11,CROW,gemGrab,Double Swoosh,0,0,1,1
11352,2022-12-10,CROW,gemGrab,Hard Rock Mine,0,0,1,1
11353,2022-11-03,CROW,bounty,Temple Ruins,0,0,1,1
11354,2022-11-01,CROW,knockout,New Perspective,0,1,0,1
11355,2022-10-30,CROW,knockout,Out in the Open,0,1,0,1
11356,2022-10-28,CROW,brawlBall,Beach Ball,0,0,2,2
11357,2022-10-28,CROW,bounty,Canal Grande,0,1,0,1
11358,2022-10-15,CROW,gemGrab,Hard Rock Mine,0,0,1,1
11359,2023-01-30,COLT,knockout,Belle's Rock,0,209,136,345
11360,2023-01-30,COLT,hotZone,Quarter Pounder,0,74,39,113
11361,2023-01-30,COLT,heist,Pit Stop,0,324,272,596
11362,2023-01-30,COLT,gemGrab,Minecart Madness,0,103,90,193
11363,2023-01-30,COLT,gemGrab,Double Swoosh,0,50,39,89
11364,2023-01-30,COLT,brawlBall,Center Stage,15,533,491,1039
11365,2023-01-30,COLT,brawlBall,Backyard Bowl,8,178,122,308
11366,2023-01-30,COLT,bounty,Hideout,0,86,57,143
11367,2023-01-29,COLT,knockout,Belle's Rock,0,210,146,356
11368,2023-01-29,COLT,hotZone,Quarter Pounder,0,49,36,85
11369,2023-01-29,COLT,heist,Bridge Too Far,4,984,976,1964
11370,2023-01-29,COLT,gemGrab,Hard Rock Mine,0,13,3,16
11371,2023-01-29,COLT,gemGrab,Double Swoosh,0,86,69,155
11372,2023-01-29,COLT,brawlBall,Super Beach,0,17,16,33
11373,2023-01-29,COLT,brawlBall,Backyard Bowl,67,1643,1430,3140
11374,2023-01-29,COLT,bounty,Canal Grande,0,17,15,32
11375,2023-01-28,COLT,knockout,Flaring Phoenix,0,80,77,157
11376,2023-01-28,COLT,hotZone,Controller Chaos,0,35,24,59
11377,2023-01-28,COLT,heist,Bridge Too Far,6,2064,2165,4235
11378,2023-01-28,COLT,gemGrab,Hard Rock Mine,0,83,45,128
11379,2023-01-28,COLT,gemGrab,Deep Diner,0,58,32,90
11380,2023-01-28,COLT,brawlBall,Super Beach,25,880,827,1732
11381,2023-01-28,COLT,brawlBall,Sneaky Fields,0,24,22,46
11382,2023-01-28,COLT,bounty,Canal Grande,0,52,24,76
11383,2023-01-27,COLT,knockout,Flaring Phoenix,0,40,27,67
11384,2023-01-27,COLT,hotZone,Controller Chaos,0,5,4,9
11385,2023-01-27,COLT,heist,Hot Potato,1,112,117,230
11386,2023-01-27,COLT,gemGrab,Undermine,0,9,2,11
11387,2023-01-27,COLT,gemGrab,Deep Diner,0,68,37,105
11388,2023-01-27,COLT,brawlBall,Sneaky Fields,8,225,208,441
11389,2023-01-27,COLT,brawlBall,Pinhole Punt,1,13,11,25
11390,2023-01-27,COLT,bounty,Temple Ruins,0,19,9,28
11391,2023-01-26,COLT,knockout,Riverside,1,289,234,524
11392,2023-01-26,COLT,hotZone,Open Zone,0,70,52,122
11393,2023-01-26,COLT,heist,Hot Potato,1,681,679,1361
11394,2023-01-26,COLT,gemGrab,Undermine,0,67,40,107
11395,2023-01-26,COLT,gemGrab,Gem Fort,0,45,42,87
11396,2023-01-26,COLT,brawlBall,Sunny Soccer,0,46,39,85
11397,2023-01-26,COLT,brawlBall,Pinhole Punt,27,1003,766,1796
11398,2023-01-26,COLT,bounty,Temple Ruins,0,49,37,86
11399,2023-01-25,COLT,knockout,Riverside,0,132,92,224
11400,2023-01-25,COLT,hotZone,Open Zone,0,36,15,51
11401,2023-01-25,COLT,heist,Safe Zone,0,547,632,1179
11402,2023-01-25,COLT,gemGrab,Gem Fort,0,43,38,81
11403,2023-01-25,COLT,gemGrab,Crystal Arcade,0,75,34,109
11404,2023-01-25,COLT,brawlBall,Sunny Soccer,9,482,414,905
11405,2023-01-25,COLT,brawlBall,Beach Ball,4,57,56,117
11406,2023-01-25,COLT,bounty,Excel,0,39,13,52
11407,2023-01-24,COLT,knockout,New Perspective,0,101,61,162
11408,2023-01-24,COLT,hotZone,Dueling Beetles,0,51,55,106
11409,2023-01-24,COLT,heist,Safe Zone,3,1177,1237,2417
11410,2023-01-24,COLT,gemGrab,Minecart Madness,0,32,44,76
11411,2023-01-24,COLT,gemGrab,Crystal Arcade,0,97,69,166
11412,2023-01-24,COLT,brawlBall,Center Stage,6,109,75,190
11413,2023-01-24,COLT,brawlBall,Beach Ball,30,862,794,1686
11414,2023-01-24,COLT,bounty,Excel,0,74,43,117
11415,2023-01-23,COLT,knockout,New Perspective,0,160,104,264
11416,2023-01-23,COLT,hotZone,Dueling Beetles,1,68,70,139
11417,2023-01-23,COLT,heist,Snaked Assault,4,948,1158,2110
11418,2023-01-23,COLT,gemGrab,Minecart Madness,0,175,115,290
11419,2023-01-23,COLT,gemGrab,Double Swoosh,0,47,53,100
11420,2023-01-23,COLT,brawlBall,Center Stage,29,1121,940,2090
11421,2023-01-23,COLT,brawlBall,Backyard Bowl,5,91,84,180
11422,2023-01-23,COLT,bounty,Layer Cake,0,56,38,94
11423,2023-01-22,COLT,knockout,X Marks the Spot,0,87,84,171
11424,2023-01-22,COLT,hotZone,Ring of Fire,0,26,11,37
11425,2023-01-22,COLT,heist,Snaked Assault,2,545,588,1135
11426,2023-01-22,COLT,gemGrab,Hard Rock Mine,0,32,15,47
11427,2023-01-22,COLT,gemGrab,Double Swoosh,0,30,29,59
11428,2023-01-22,COLT,brawlBall,Super Beach,1,82,65,148
11429,2023-01-22,COLT,brawlBall,Backyard Bowl,24,938,794,1756
11430,2023-01-22,COLT,bounty,Layer Cake,0,28,18,46
11431,2023-01-21,COLT,knockout,X Marks the Spot,0,316,246,562
11432,2023-01-21,COLT,hotZone,Ring of Fire,0,73,26,99
11433,2023-01-21,COLT,heist,Tornado Ring,1,545,558,1104
11434,2023-01-21,COLT,gemGrab,Hard Rock Mine,0,133,71,204
11435,2023-01-21,COLT,gemGrab,Deep Diner,0,40,35,75
11436,2023-01-21,COLT,brawlBall,Super Beach,34,1122,990,2146
11437,2023-01-21,COLT,brawlBall,Sneaky Fields,0,22,24,46
11438,2023-01-21,COLT,bounty,Dry Season,0,150,79,229
11439,2023-01-20,COLT,knockout,Out in the Open,0,214,160,374
11440,2023-01-20,COLT,hotZone,Split,0,31,26,57
11441,2023-01-20,COLT,heist,Tornado Ring,5,656,654,1315
11442,2023-01-20,COLT,gemGrab,Undermine,0,45,22,67
11443,2023-01-20,COLT,gemGrab,Deep Diner,0,163,129,292
11444,2023-01-20,COLT,brawlBall,Sneaky Fields,14,615,463,1092
11445,2023-01-20,COLT,brawlBall,Pinhole Punt,1,42,24,67
11446,2023-01-20,COLT,bounty,Dry Season,0,109,71,180
11447,2023-01-19,COLT,knockout,Out in the Open,0,233,216,449
11448,2023-01-19,COLT,hotZone,Split,0,63,38,101
11449,2023-01-19,COLT,heist,Kaboom Canyon,1,370,390,761
11450,2023-01-19,COLT,gemGrab,Undermine,0,80,64,144
11451,2023-01-19,COLT,gemGrab,Gem Fort,0,34,25,59
11452,2023-01-19,COLT,brawlBall,Sunny Soccer,0,31,22,53
11453,2023-01-19,COLT,brawlBall,Pinhole Punt,23,1109,1011,2143
11454,2023-01-19,COLT,bounty,Shooting Star,0,162,88,250
11455,2023-01-18,COLT,knockout,Goldarm Gulch,0,33,24,57
11456,2023-01-18,COLT,hotZone,Parallel Plays,0,4,4,8
11457,2023-01-18,COLT,heist,Kaboom Canyon,1,182,157,340
11458,2023-01-18,COLT,gemGrab,Gem Fort,0,30,23,53
11459,2023-01-18,COLT,gemGrab,Crystal Arcade,0,10,6,16
11460,2023-01-18,COLT,brawlBall,Sunny Soccer,7,204,229,440
11461,2023-01-18,COLT,brawlBall,Beach Ball,0,12,12,24
11462,2023-01-18,COLT,bounty,Shooting Star,0,74,48,122
11463,2023-01-17,COLT,knockout,Goldarm Gulch,0,19,15,34
11464,2023-01-17,COLT,hotZone,Parallel Plays,0,6,0,6
11465,2023-01-17,COLT,heist,Pit Stop,0,45,54,99
11466,2023-01-17,COLT,gemGrab,Minecart Madness,0,1,2,3
11467,2023-01-17,COLT,gemGrab,Crystal Arcade,0,8,3,11
11468,2023-01-17,COLT,brawlBall,Center Stage,0,3,1,4
11469,2023-01-17,COLT,brawlBall,Beach Ball,0,70,56,126
11470,2023-01-17,COLT,bounty,Hideout,0,11,11,22
11471,2023-01-16,COLT,knockout,Belle's Rock,0,10,11,21
11472,2023-01-16,COLT,hotZone,Quarter Pounder,0,11,1,12
11473,2023-01-16,COLT,heist,Pit Stop,0,106,93,199
11474,2023-01-16,COLT,gemGrab,Minecart Madness,0,6,4,10
11475,2023-01-16,COLT,gemGrab,Double Swoosh,0,2,1,3
11476,2023-01-16,COLT,brawlBall,Center Stage,1,40,28,69
11477,2023-01-16,COLT,brawlBall,Backyard Bowl,0,25,11,36
11478,2023-01-16,COLT,bounty,Hideout,0,16,11,27
11479,2023-01-15,COLT,knockout,Belle's Rock,0,21,11,32
11480,2023-01-15,COLT,hotZone,Quarter Pounder,0,10,0,10
11481,2023-01-15,COLT,heist,Bridge Too Far,2,227,220,449
11482,2023-01-15,COLT,gemGrab,Hard Rock Mine,0,3,1,4
11483,2023-01-15,COLT,gemGrab,Double Swoosh,0,6,2,8
11484,2023-01-15,COLT,brawlBall,Super Beach,1,21,14,36
11485,2023-01-15,COLT,brawlBall,Backyard Bowl,7,211,133,351
11486,2023-01-15,COLT,bounty,Canal Grande,0,3,0,3
11487,2023-01-14,COLT,knockout,Flaring Phoenix,0,10,1,11
11488,2023-01-14,COLT,hotZone,Controller Chaos,0,6,22,28
11489,2023-01-14,COLT,heist,Bridge Too Far,0,324,255,579
11490,2023-01-14,COLT,gemGrab,Hard Rock Mine,0,4,1,5
11491,2023-01-14,COLT,gemGrab,Deep Diner,0,7,8,15
11492,2023-01-14,COLT,brawlBall,Super Beach,3,51,36,90
11493,2023-01-14,COLT,brawlBall,Sneaky Fields,0,9,13,22
11494,2023-01-14,COLT,bounty,Canal Grande,0,3,1,4
11495,2023-01-13,COLT,knockout,Flaring Phoenix,0,4,1,5
11496,2023-01-13,COLT,hotZone,Controller Chaos,0,8,8,16
11497,2023-01-13,COLT,heist,Hot Potato,0,28,27,55
11498,2023-01-13,COLT,gemGrab,Deep Diner,0,12,13,25
11499,2023-01-13,COLT,brawlBall,Sneaky Fields,0,41,54,95
11500,2023-01-13,COLT,brawlBall,Pinhole Punt,0,3,4,7
11501,2023-01-13,COLT,bounty,Temple Ruins,0,3,0,3
11502,2023-01-12,COLT,knockout,Riverside,0,41,11,52
11503,2023-01-12,COLT,hotZone,Open Zone,0,9,5,14
11504,2023-01-12,COLT,heist,Hot Potato,0,14,10,24
11505,2023-01-12,COLT,gemGrab,Undermine,0,3,2,5
11506,2023-01-12,COLT,brawlBall,Sunny Soccer,0,1,2,3
11507,2023-01-12,COLT,brawlBall,Pinhole Punt,0,21,15,36
11508,2023-01-11,COLT,knockout,Riverside,0,4,2,6
11509,2023-01-11,COLT,hotZone,Open Zone,0,2,1,3
11510,2023-01-11,COLT,heist,Safe Zone,0,2,3,5
11511,2023-01-11,COLT,gemGrab,Gem Fort,0,1,0,1
11512,2023-01-11,COLT,brawlBall,Sunny Soccer,0,15,11,26
11513,2023-01-11,COLT,bounty,Excel,0,2,5,7
11514,2023-01-10,COLT,knockout,New Perspective,0,4,2,6
11515,2023-01-10,COLT,hotZone,Dueling Beetles,0,6,19,25
11516,2023-01-10,COLT,heist,Safe Zone,0,87,124,211
11517,2023-01-10,COLT,gemGrab,Minecart Madness,0,5,4,9
11518,2023-01-10,COLT,gemGrab,Crystal Arcade,0,5,13,18
11519,2023-01-10,COLT,brawlBall,Center Stage,0,5,3,8
11520,2023-01-10,COLT,brawlBall,Beach Ball,0,48,21,69
11521,2023-01-10,COLT,bounty,Excel,0,1,1,2
11522,2023-01-09,COLT,knockout,New Perspective,0,4,1,5
11523,2023-01-09,COLT,hotZone,Dueling Beetles,0,6,2,8
11524,2023-01-09,COLT,heist,Snaked Assault,0,101,105,206
11525,2023-01-09,COLT,gemGrab,Minecart Madness,0,12,8,20
11526,2023-01-09,COLT,gemGrab,Double Swoosh,0,3,0,3
11527,2023-01-09,COLT,brawlBall,Center Stage,0,46,23,69
11528,2023-01-09,COLT,brawlBall,Backyard Bowl,0,18,8,26
11529,2023-01-09,COLT,bounty,Layer Cake,0,13,3,16
11530,2023-01-08,COLT,knockout,X Marks the Spot,0,11,11,22
11531,2023-01-08,COLT,hotZone,Ring of Fire,0,4,6,10
11532,2023-01-08,COLT,heist,Snaked Assault,0,96,111,207
11533,2023-01-08,COLT,gemGrab,Hard Rock Mine,0,1,3,4
11534,2023-01-08,COLT,gemGrab,Double Swoosh,0,3,0,3
11535,2023-01-08,COLT,brawlBall,Super Beach,1,8,4,13
11536,2023-01-08,COLT,brawlBall,Backyard Bowl,4,132,146,282
11537,2023-01-08,COLT,bounty,Layer Cake,0,1,0,1
11538,2023-01-07,COLT,knockout,X Marks the Spot,0,6,3,9
11539,2023-01-07,COLT,hotZone,Ring of Fire,0,2,0,2
11540,2023-01-07,COLT,heist,Tornado Ring,0,48,24,72
11541,2023-01-07,COLT,gemGrab,Hard Rock Mine,0,3,0,3
11542,2023-01-07,COLT,gemGrab,Deep Diner,0,7,3,10
11543,2023-01-07,COLT,brawlBall,Super Beach,0,19,24,43
11544,2023-01-07,COLT,brawlBall,Sneaky Fields,0,2,1,3
11545,2023-01-07,COLT,bounty,Dry Season,0,13,2,15
11546,2023-01-06,COLT,knockout,Out in the Open,0,16,5,21
11547,2023-01-06,COLT,hotZone,Split,0,6,32,38
11548,2023-01-06,COLT,heist,Tornado Ring,1,148,117,266
11549,2023-01-06,COLT,gemGrab,Undermine,0,5,2,7
11550,2023-01-06,COLT,gemGrab,Deep Diner,0,12,5,17
11551,2023-01-06,COLT,brawlBall,Sneaky Fields,0,28,7,35
11552,2023-01-06,COLT,brawlBall,Pinhole Punt,0,8,6,14
11553,2023-01-06,COLT,bounty,Dry Season,0,12,6,18
11554,2023-01-05,COLT,knockout,Out in the Open,1,22,20,43
11555,2023-01-05,COLT,hotZone,Split,0,15,33,48
11556,2023-01-05,COLT,heist,Kaboom Canyon,0,48,53,101
11557,2023-01-05,COLT,gemGrab,Undermine,0,6,1,7
11558,2023-01-05,COLT,gemGrab,Gem Fort,0,0,2,2
11559,2023-01-05,COLT,brawlBall,Sunny Soccer,0,1,0,1
11560,2023-01-05,COLT,brawlBall,Pinhole Punt,5,72,59,136
11561,2023-01-05,COLT,bounty,Shooting Star,0,9,4,13
11562,2023-01-04,COLT,knockout,Goldarm Gulch,0,1,0,1
11563,2023-01-04,COLT,hotZone,Parallel Plays,0,3,0,3
11564,2023-01-04,COLT,heist,Kaboom Canyon,1,101,67,169
11565,2023-01-04,COLT,gemGrab,Gem Fort,0,6,6,12
11566,2023-01-04,COLT,gemGrab,Crystal Arcade,0,6,0,6
11567,2023-01-04,COLT,brawlBall,Sunny Soccer,2,44,17,63
11568,2023-01-04,COLT,brawlBall,Beach Ball,0,3,0,3
11569,2023-01-04,COLT,bounty,Shooting Star,0,32,9,41
11570,2023-01-03,COLT,knockout,Goldarm Gulch,0,2,2,4
11571,2023-01-03,COLT,heist,Pit Stop,0,39,55,94
11572,2023-01-03,COLT,heist,Kaboom Canyon,0,1,2,3
11573,2023-01-03,COLT,gemGrab,Minecart Madness,0,2,0,2
11574,2023-01-03,COLT,gemGrab,Crystal Arcade,0,15,1,16
11575,2023-01-03,COLT,brawlBall,Center Stage,0,4,2,6
11576,2023-01-03,COLT,brawlBall,Beach Ball,1,78,86,165
11577,2023-01-03,COLT,bounty,Hideout,0,22,1,23
11578,2023-01-02,COLT,knockout,Belle's Rock,0,16,15,31
11579,2023-01-02,COLT,hotZone,Quarter Pounder,0,12,4,16
11580,2023-01-02,COLT,hotZone,Controller Chaos,0,2,0,2
11581,2023-01-02,COLT,heist,Pit Stop,1,124,126,251
11582,2023-01-02,COLT,heist,Kaboom Canyon,0,1,3,4
11583,2023-01-02,COLT,gemGrab,Minecart Madness,0,16,3,19
11584,2023-01-02,COLT,gemGrab,Double Swoosh,0,4,1,5
11585,2023-01-02,COLT,brawlBall,Center Stage,1,62,49,112
11586,2023-01-02,COLT,brawlBall,Backyard Bowl,0,8,7,15
11587,2023-01-02,COLT,bounty,Hideout,0,32,12,44
11588,2023-01-01,COLT,knockout,Belle's Rock,0,7,1,8
11589,2023-01-01,COLT,hotZone,Quarter Pounder,0,2,2,4
11590,2023-01-01,COLT,heist,Kaboom Canyon,0,0,2,2
11591,2023-01-01,COLT,heist,Bridge Too Far,0,35,36,71
11592,2023-01-01,COLT,gemGrab,Double Swoosh,0,1,2,3
11593,2023-01-01,COLT,brawlBall,Backyard Bowl,0,46,30,76
11594,2022-12-31,COLT,heist,Kaboom Canyon,0,1,1,2
11595,2022-12-31,COLT,heist,Bridge Too Far,0,24,18,42
11596,2022-12-31,COLT,gemGrab,Minecart Madness,0,0,2,2
11597,2022-12-31,COLT,gemGrab,Deep Diner,0,4,10,14
11598,2022-12-31,COLT,brawlBall,Super Beach,0,3,5,8
11599,2022-12-30,COLT,heist,Kaboom Canyon,0,1,0,1
11600,2022-12-30,COLT,heist,Hot Potato,0,0,2,2
11601,2022-12-30,COLT,gemGrab,Undermine,0,1,0,1
11602,2022-12-30,COLT,gemGrab,Minecart Madness,0,1,0,1
11603,2022-12-30,COLT,gemGrab,Deep Diner,0,2,0,2
11604,2022-12-30,COLT,brawlBall,Sneaky Fields,0,6,2,8
11605,2022-12-29,COLT,heist,Kaboom Canyon,0,3,1,4
11606,2022-12-29,COLT,heist,Hot Potato,0,4,1,5
11607,2022-12-29,COLT,brawlBall,Pinhole Punt,0,5,0,5
11608,2022-12-28,COLT,brawlBall,Sunny Soccer,0,0,1,1
11609,2022-12-27,COLT,knockout,New Perspective,0,0,1,1
11610,2022-12-27,COLT,heist,Safe Zone,0,0,1,1
11611,2022-12-27,COLT,heist,Kaboom Canyon,0,1,1,2
11612,2022-12-27,COLT,gemGrab,Minecart Madness,0,1,0,1
11613,2022-12-27,COLT,brawlBall,Beach Ball,0,2,0,2
11614,2022-12-26,COLT,heist,Kaboom Canyon,0,1,3,4
11615,2022-12-26,COLT,brawlBall,Center Stage,0,1,0,1
11616,2022-12-25,COLT,brawlBall,Backyard Bowl,0,4,8,12
11617,2022-12-24,COLT,knockout,X Marks the Spot,0,1,0,1
11618,2022-12-24,COLT,brawlBall,Super Beach,0,0,1,1
11619,2022-12-23,COLT,knockout,Out in the Open,0,1,0,1
11620,2022-12-23,COLT,brawlBall,Sneaky Fields,0,0,1,1
11621,2022-12-22,COLT,heist,Kaboom Canyon,0,1,0,1
11622,2022-12-22,COLT,brawlBall,Pinhole Punt,0,2,0,2
11623,2022-12-20,COLT,brawlBall,Beach Ball,1,0,0,1
11624,2022-12-19,COLT,brawlBall,Center Stage,0,1,0,1
11625,2022-12-18,COLT,heist,Bridge Too Far,0,0,1,1
11626,2022-12-16,COLT,brawlBall,Sneaky Fields,0,2,1,3
11627,2022-12-16,COLT,bounty,Temple Ruins,0,1,0,1
11628,2022-12-13,COLT,heist,Safe Zone,0,4,3,7
11629,2022-12-13,COLT,gemGrab,Crystal Arcade,0,1,1,2
11630,2022-11-11,COLT,knockout,New Perspective,0,1,0,1
11631,2022-11-03,COLT,brawlBall,Pinhole Punt,0,1,1,2
11632,2022-11-03,COLT,bounty,Temple Ruins,0,1,0,1
11633,2022-11-01,COLT,knockout,New Perspective,0,2,2,4
11634,2022-10-30,COLT,heist,Safe Zone,0,0,1,1
11635,2022-10-28,COLT,brawlBall,Beach Ball,0,1,0,1
11636,2022-10-15,COLT,gemGrab,Hard Rock Mine,0,1,1,2
11637,2023-01-30,COLETTE,knockout,Belle's Rock,0,14,11,25
11638,2023-01-30,COLETTE,hotZone,Quarter Pounder,0,51,25,76
11639,2023-01-30,COLETTE,heist,Pit Stop,0,28,27,55
11640,2023-01-30,COLETTE,gemGrab,Minecart Madness,0,30,35,65
11641,2023-01-30,COLETTE,gemGrab,Double Swoosh,0,22,39,61
11642,2023-01-30,COLETTE,brawlBall,Center Stage,13,240,298,551
11643,2023-01-30,COLETTE,brawlBall,Backyard Bowl,3,48,38,89
11644,2023-01-30,COLETTE,bounty,Hideout,0,3,3,6
11645,2023-01-29,COLETTE,knockout,Belle's Rock,0,24,13,37
11646,2023-01-29,COLETTE,hotZone,Quarter Pounder,0,39,58,97
11647,2023-01-29,COLETTE,heist,Bridge Too Far,1,321,414,736
11648,2023-01-29,COLETTE,gemGrab,Hard Rock Mine,0,10,4,14
11649,2023-01-29,COLETTE,gemGrab,Double Swoosh,0,44,28,72
11650,2023-01-29,COLETTE,brawlBall,Super Beach,0,10,17,27
11651,2023-01-29,COLETTE,brawlBall,Backyard Bowl,18,441,482,941
11652,2023-01-29,COLETTE,bounty,Canal Grande,0,12,15,27
11653,2023-01-28,COLETTE,knockout,Flaring Phoenix,1,22,17,40
11654,2023-01-28,COLETTE,hotZone,Controller Chaos,0,61,67,128
11655,2023-01-28,COLETTE,heist,Bridge Too Far,2,770,803,1575
11656,2023-01-28,COLETTE,gemGrab,Hard Rock Mine,0,49,39,88
11657,2023-01-28,COLETTE,gemGrab,Deep Diner,0,13,14,27
11658,2023-01-28,COLETTE,brawlBall,Super Beach,11,298,358,667
11659,2023-01-28,COLETTE,brawlBall,Sneaky Fields,0,12,15,27
11660,2023-01-28,COLETTE,bounty,Canal Grande,0,12,7,19
11661,2023-01-27,COLETTE,knockout,Flaring Phoenix,0,11,6,17
11662,2023-01-27,COLETTE,hotZone,Controller Chaos,0,12,15,27
11663,2023-01-27,COLETTE,heist,Hot Potato,0,94,102,196
11664,2023-01-27,COLETTE,gemGrab,Undermine,0,3,5,8
11665,2023-01-27,COLETTE,gemGrab,Deep Diner,0,22,18,40
11666,2023-01-27,COLETTE,brawlBall,Sneaky Fields,3,100,86,189
11667,2023-01-27,COLETTE,brawlBall,Pinhole Punt,0,2,3,5
11668,2023-01-27,COLETTE,bounty,Temple Ruins,0,5,4,9
11669,2023-01-26,COLETTE,knockout,Riverside,1,34,25,60
11670,2023-01-26,COLETTE,hotZone,Open Zone,0,44,29,73
11671,2023-01-26,COLETTE,heist,Hot Potato,0,189,191,380
11672,2023-01-26,COLETTE,gemGrab,Undermine,0,46,53,99
11673,2023-01-26,COLETTE,gemGrab,Gem Fort,0,10,14,24
11674,2023-01-26,COLETTE,brawlBall,Sunny Soccer,0,15,10,25
11675,2023-01-26,COLETTE,brawlBall,Pinhole Punt,21,466,479,966
11676,2023-01-26,COLETTE,bounty,Temple Ruins,0,20,16,36
11677,2023-01-25,COLETTE,knockout,Riverside,0,22,12,34
11678,2023-01-25,COLETTE,hotZone,Open Zone,0,17,22,39
11679,2023-01-25,COLETTE,heist,Safe Zone,1,313,428,742
11680,2023-01-25,COLETTE,gemGrab,Gem Fort,0,14,11,25
11681,2023-01-25,COLETTE,gemGrab,Crystal Arcade,0,24,17,41
11682,2023-01-25,COLETTE,brawlBall,Sunny Soccer,7,149,204,360
11683,2023-01-25,COLETTE,brawlBall,Beach Ball,4,26,29,59
11684,2023-01-25,COLETTE,bounty,Excel,0,2,4,6
11685,2023-01-24,COLETTE,knockout,New Perspective,0,22,12,34
11686,2023-01-24,COLETTE,hotZone,Dueling Beetles,0,39,35,74
11687,2023-01-24,COLETTE,heist,Safe Zone,2,540,714,1256
11688,2023-01-24,COLETTE,gemGrab,Minecart Madness,0,11,5,16
11689,2023-01-24,COLETTE,gemGrab,Crystal Arcade,0,45,42,87
11690,2023-01-24,COLETTE,brawlBall,Center Stage,3,45,53,101
11691,2023-01-24,COLETTE,brawlBall,Beach Ball,16,280,319,615
11692,2023-01-24,COLETTE,bounty,Excel,0,8,11,19
11693,2023-01-23,COLETTE,knockout,New Perspective,0,48,34,82
11694,2023-01-23,COLETTE,hotZone,Dueling Beetles,0,27,35,62
11695,2023-01-23,COLETTE,heist,Snaked Assault,2,383,481,866
11696,2023-01-23,COLETTE,gemGrab,Minecart Madness,0,75,114,189
11697,2023-01-23,COLETTE,gemGrab,Double Swoosh,0,21,34,55
11698,2023-01-23,COLETTE,brawlBall,Center Stage,9,422,453,884
11699,2023-01-23,COLETTE,brawlBall,Backyard Bowl,3,21,36,60
11700,2023-01-23,COLETTE,bounty,Layer Cake,0,8,2,10
11701,2023-01-22,COLETTE,knockout,X Marks the Spot,0,13,21,34
11702,2023-01-22,COLETTE,hotZone,Ring of Fire,0,16,24,40
11703,2023-01-22,COLETTE,heist,Snaked Assault,1,139,187,327
11704,2023-01-22,COLETTE,gemGrab,Hard Rock Mine,0,20,13,33
11705,2023-01-22,COLETTE,gemGrab,Double Swoosh,0,23,16,39
11706,2023-01-22,COLETTE,brawlBall,Super Beach,0,17,19,36
11707,2023-01-22,COLETTE,brawlBall,Backyard Bowl,14,260,269,543
11708,2023-01-22,COLETTE,bounty,Layer Cake,0,3,6,9
11709,2023-01-21,COLETTE,knockout,X Marks the Spot,0,45,35,80
11710,2023-01-21,COLETTE,hotZone,Ring of Fire,0,50,80,130
11711,2023-01-21,COLETTE,heist,Tornado Ring,2,110,119,231
11712,2023-01-21,COLETTE,gemGrab,Hard Rock Mine,0,44,43,87
11713,2023-01-21,COLETTE,gemGrab,Deep Diner,0,10,8,18
11714,2023-01-21,COLETTE,brawlBall,Super Beach,13,377,347,737
11715,2023-01-21,COLETTE,brawlBall,Sneaky Fields,0,10,12,22
11716,2023-01-21,COLETTE,bounty,Dry Season,0,25,27,52
11717,2023-01-20,COLETTE,knockout,Out in the Open,0,49,43,92
11718,2023-01-20,COLETTE,hotZone,Split,0,9,12,21
11719,2023-01-20,COLETTE,heist,Tornado Ring,0,138,160,298
11720,2023-01-20,COLETTE,gemGrab,Undermine,0,18,15,33
11721,2023-01-20,COLETTE,gemGrab,Deep Diner,0,35,29,64
11722,2023-01-20,COLETTE,brawlBall,Sneaky Fields,9,260,334,603
11723,2023-01-20,COLETTE,brawlBall,Pinhole Punt,1,19,27,47
11724,2023-01-20,COLETTE,bounty,Dry Season,0,20,14,34
11725,2023-01-19,COLETTE,knockout,Out in the Open,1,72,48,121
11726,2023-01-19,COLETTE,hotZone,Split,0,25,19,44
11727,2023-01-19,COLETTE,heist,Kaboom Canyon,0,245,367,612
11728,2023-01-19,COLETTE,gemGrab,Undermine,0,42,53,95
11729,2023-01-19,COLETTE,gemGrab,Gem Fort,0,4,7,11
11730,2023-01-19,COLETTE,brawlBall,Sunny Soccer,0,9,10,19
11731,2023-01-19,COLETTE,brawlBall,Pinhole Punt,18,445,467,930
11732,2023-01-19,COLETTE,bounty,Shooting Star,0,24,8,32
11733,2023-01-18,COLETTE,knockout,Goldarm Gulch,0,6,9,15
11734,2023-01-18,COLETTE,hotZone,Parallel Plays,0,3,0,3
11735,2023-01-18,COLETTE,heist,Kaboom Canyon,1,130,181,312
11736,2023-01-18,COLETTE,gemGrab,Gem Fort,0,9,9,18
11737,2023-01-18,COLETTE,gemGrab,Crystal Arcade,0,4,4,8
11738,2023-01-18,COLETTE,brawlBall,Sunny Soccer,1,89,118,208
11739,2023-01-18,COLETTE,brawlBall,Beach Ball,0,2,5,7
11740,2023-01-18,COLETTE,bounty,Shooting Star,0,2,8,10
11741,2023-01-17,COLETTE,knockout,Goldarm Gulch,0,8,6,14
11742,2023-01-17,COLETTE,hotZone,Parallel Plays,0,3,4,7
11743,2023-01-17,COLETTE,heist,Pit Stop,0,7,2,9
11744,2023-01-17,COLETTE,gemGrab,Minecart Madness,0,1,0,1
11745,2023-01-17,COLETTE,gemGrab,Crystal Arcade,0,3,4,7
11746,2023-01-17,COLETTE,brawlBall,Center Stage,0,3,5,8
11747,2023-01-17,COLETTE,brawlBall,Beach Ball,1,24,27,52
11748,2023-01-17,COLETTE,bounty,Hideout,0,1,1,2
11749,2023-01-16,COLETTE,knockout,Belle's Rock,0,2,1,3
11750,2023-01-16,COLETTE,hotZone,Quarter Pounder,0,5,0,5
11751,2023-01-16,COLETTE,heist,Pit Stop,0,7,5,12
11752,2023-01-16,COLETTE,gemGrab,Minecart Madness,0,3,1,4
11753,2023-01-16,COLETTE,brawlBall,Center Stage,2,37,60,99
11754,2023-01-16,COLETTE,brawlBall,Backyard Bowl,0,8,4,12
11755,2023-01-16,COLETTE,bounty,Hideout,0,5,3,8
11756,2023-01-15,COLETTE,knockout,Belle's Rock,0,4,8,12
11757,2023-01-15,COLETTE,hotZone,Quarter Pounder,0,5,5,10
11758,2023-01-15,COLETTE,heist,Bridge Too Far,0,68,103,171
11759,2023-01-15,COLETTE,gemGrab,Hard Rock Mine,0,1,0,1
11760,2023-01-15,COLETTE,gemGrab,Double Swoosh,0,6,4,10
11761,2023-01-15,COLETTE,brawlBall,Super Beach,0,2,0,2
11762,2023-01-15,COLETTE,brawlBall,Backyard Bowl,6,48,40,94
11763,2023-01-15,COLETTE,bounty,Canal Grande,0,2,11,13
11764,2023-01-14,COLETTE,knockout,Flaring Phoenix,0,4,1,5
11765,2023-01-14,COLETTE,hotZone,Controller Chaos,0,6,5,11
11766,2023-01-14,COLETTE,heist,Bridge Too Far,0,145,196,341
11767,2023-01-14,COLETTE,gemGrab,Hard Rock Mine,0,2,2,4
11768,2023-01-14,COLETTE,brawlBall,Super Beach,0,19,16,35
11769,2023-01-14,COLETTE,brawlBall,Sneaky Fields,0,3,3,6
11770,2023-01-14,COLETTE,bounty,Canal Grande,0,1,2,3
11771,2023-01-13,COLETTE,knockout,Flaring Phoenix,0,3,5,8
11772,2023-01-13,COLETTE,hotZone,Controller Chaos,0,9,4,13
11773,2023-01-13,COLETTE,heist,Hot Potato,0,12,9,21
11774,2023-01-13,COLETTE,gemGrab,Deep Diner,0,3,1,4
11775,2023-01-13,COLETTE,brawlBall,Sneaky Fields,1,13,11,25
11776,2023-01-13,COLETTE,brawlBall,Pinhole Punt,0,3,0,3
11777,2023-01-13,COLETTE,bounty,Temple Ruins,0,0,1,1
11778,2023-01-12,COLETTE,knockout,Riverside,0,1,1,2
11779,2023-01-12,COLETTE,hotZone,Open Zone,0,2,0,2
11780,2023-01-12,COLETTE,heist,Hot Potato,0,2,2,4
11781,2023-01-12,COLETTE,gemGrab,Undermine,0,1,1,2
11782,2023-01-12,COLETTE,gemGrab,Gem Fort,0,1,0,1
11783,2023-01-12,COLETTE,brawlBall,Pinhole Punt,0,8,14,22
11784,2023-01-11,COLETTE,hotZone,Open Zone,0,1,5,6
11785,2023-01-11,COLETTE,heist,Safe Zone,0,0,2,2
11786,2023-01-11,COLETTE,gemGrab,Gem Fort,0,1,0,1
11787,2023-01-11,COLETTE,brawlBall,Sunny Soccer,0,4,0,4
11788,2023-01-10,COLETTE,hotZone,Dueling Beetles,0,6,5,11
11789,2023-01-10,COLETTE,heist,Safe Zone,0,41,34,75
11790,2023-01-10,COLETTE,gemGrab,Crystal Arcade,0,2,0,2
11791,2023-01-10,COLETTE,brawlBall,Center Stage,1,4,3,8
11792,2023-01-10,COLETTE,brawlBall,Beach Ball,0,15,4,19
11793,2023-01-09,COLETTE,hotZone,Dueling Beetles,0,6,21,27
11794,2023-01-09,COLETTE,heist,Snaked Assault,0,50,52,102
11795,2023-01-09,COLETTE,gemGrab,Minecart Madness,0,4,6,10
11796,2023-01-09,COLETTE,gemGrab,Double Swoosh,0,0,3,3
11797,2023-01-09,COLETTE,brawlBall,Center Stage,1,20,32,53
11798,2023-01-09,COLETTE,brawlBall,Backyard Bowl,0,1,0,1
11799,2023-01-08,COLETTE,knockout,X Marks the Spot,0,0,1,1
11800,2023-01-08,COLETTE,hotZone,Ring of Fire,0,4,17,21
11801,2023-01-08,COLETTE,heist,Snaked Assault,0,20,9,29
11802,2023-01-08,COLETTE,gemGrab,Hard Rock Mine,0,0,2,2
11803,2023-01-08,COLETTE,gemGrab,Double Swoosh,0,0,2,2
11804,2023-01-08,COLETTE,brawlBall,Super Beach,0,2,0,2
11805,2023-01-08,COLETTE,brawlBall,Backyard Bowl,1,28,53,82
11806,2023-01-08,COLETTE,bounty,Layer Cake,0,1,0,1
11807,2023-01-07,COLETTE,knockout,X Marks the Spot,0,0,2,2
11808,2023-01-07,COLETTE,hotZone,Ring of Fire,0,2,0,2
11809,2023-01-07,COLETTE,heist,Tornado Ring,1,19,19,39
11810,2023-01-07,COLETTE,gemGrab,Hard Rock Mine,0,3,5,8
11811,2023-01-07,COLETTE,gemGrab,Deep Diner,0,2,0,2
11812,2023-01-07,COLETTE,brawlBall,Super Beach,0,8,3,11
11813,2023-01-06,COLETTE,heist,Tornado Ring,0,17,45,62
11814,2023-01-06,COLETTE,gemGrab,Deep Diner,0,2,2,4
11815,2023-01-06,COLETTE,brawlBall,Sneaky Fields,0,7,6,13
11816,2023-01-06,COLETTE,brawlBall,Pinhole Punt,0,2,0,2
11817,2023-01-05,COLETTE,knockout,Out in the Open,0,2,5,7
11818,2023-01-05,COLETTE,hotZone,Split,0,11,21,32
11819,2023-01-05,COLETTE,heist,Kaboom Canyon,0,43,60,103
11820,2023-01-05,COLETTE,gemGrab,Undermine,0,3,0,3
11821,2023-01-05,COLETTE,brawlBall,Pinhole Punt,1,19,26,46
11822,2023-01-04,COLETTE,hotZone,Parallel Plays,0,2,4,6
11823,2023-01-04,COLETTE,heist,Kaboom Canyon,1,105,178,284
11824,2023-01-04,COLETTE,gemGrab,Gem Fort,0,3,5,8
11825,2023-01-04,COLETTE,gemGrab,Crystal Arcade,0,1,0,1
11826,2023-01-04,COLETTE,brawlBall,Sunny Soccer,0,17,36,53
11827,2023-01-03,COLETTE,knockout,Goldarm Gulch,0,1,1,2
11828,2023-01-03,COLETTE,hotZone,Parallel Plays,0,5,7,12
11829,2023-01-03,COLETTE,heist,Pit Stop,0,8,3,11
11830,2023-01-03,COLETTE,gemGrab,Crystal Arcade,0,1,2,3
11831,2023-01-03,COLETTE,brawlBall,Center Stage,0,1,1,2
11832,2023-01-03,COLETTE,brawlBall,Beach Ball,0,15,45,60
11833,2023-01-03,COLETTE,bounty,Hideout,0,3,0,3
11834,2023-01-02,COLETTE,knockout,Belle's Rock,0,1,1,2
11835,2023-01-02,COLETTE,hotZone,Quarter Pounder,0,6,21,27
11836,2023-01-02,COLETTE,heist,Pit Stop,0,16,7,23
11837,2023-01-02,COLETTE,heist,Kaboom Canyon,0,0,1,1
11838,2023-01-02,COLETTE,gemGrab,Minecart Madness,0,5,6,11
11839,2023-01-02,COLETTE,brawlBall,Center Stage,1,17,11,29
11840,2023-01-02,COLETTE,brawlBall,Backyard Bowl,0,1,1,2
11841,2023-01-02,COLETTE,bounty,Hideout,0,4,1,5
11842,2023-01-01,COLETTE,knockout,Belle's Rock,0,0,1,1
11843,2023-01-01,COLETTE,hotZone,Quarter Pounder,0,2,10,12
11844,2023-01-01,COLETTE,heist,Kaboom Canyon,0,1,0,1
11845,2023-01-01,COLETTE,heist,Bridge Too Far,0,17,7,24
11846,2023-01-01,COLETTE,gemGrab,Double Swoosh,0,1,1,2
11847,2023-01-01,COLETTE,brawlBall,Backyard Bowl,0,15,2,17
11848,2022-12-31,COLETTE,heist,Kaboom Canyon,0,0,1,1
11849,2022-12-31,COLETTE,heist,Bridge Too Far,0,7,11,18
11850,2022-12-31,COLETTE,gemGrab,Deep Diner,0,1,0,1
11851,2022-12-31,COLETTE,brawlBall,Super Beach,0,3,6,9
11852,2022-12-31,COLETTE,brawlBall,Sneaky Fields,0,1,0,1
11853,2022-12-30,COLETTE,hotZone,Controller Chaos,0,2,12,14
11854,2022-12-30,COLETTE,heist,Hot Potato,0,1,1,2
11855,2022-12-30,COLETTE,gemGrab,Undermine,0,1,0,1
11856,2022-12-30,COLETTE,gemGrab,Deep Diner,0,1,0,1
11857,2022-12-30,COLETTE,brawlBall,Sneaky Fields,0,2,2,4
11858,2022-12-29,COLETTE,heist,Kaboom Canyon,0,0,1,1
11859,2022-12-29,COLETTE,heist,Hot Potato,0,1,0,1
11860,2022-12-29,COLETTE,gemGrab,Minecart Madness,0,1,0,1
11861,2022-12-29,COLETTE,brawlBall,Pinhole Punt,0,2,1,3
11862,2022-12-27,COLETTE,hotZone,Dueling Beetles,0,1,0,1
11863,2022-12-27,COLETTE,heist,Kaboom Canyon,0,0,1,1
11864,2022-12-27,COLETTE,brawlBall,Beach Ball,0,1,0,1
11865,2022-12-26,COLETTE,heist,Kaboom Canyon,0,0,2,2
11866,2022-12-25,COLETTE,brawlBall,Backyard Bowl,0,1,0,1
11867,2022-12-24,COLETTE,brawlBall,Super Beach,0,1,1,2
11868,2022-12-22,COLETTE,heist,Kaboom Canyon,0,0,1,1
11869,2022-12-22,COLETTE,brawlBall,Pinhole Punt,0,1,0,1
11870,2022-12-18,COLETTE,heist,Bridge Too Far,0,1,2,3
11871,2022-12-16,COLETTE,brawlBall,Sneaky Fields,0,1,0,1
11872,2022-12-13,COLETTE,heist,Safe Zone,0,0,1,1
11873,2022-10-15,COLETTE,brawlBall,Super Beach,0,1,0,1
11874,2023-01-30,CHESTER,knockout,Belle's Rock,0,43,47,90
11875,2023-01-30,CHESTER,hotZone,Quarter Pounder,0,89,55,144
11876,2023-01-30,CHESTER,heist,Pit Stop,0,23,21,44
11877,2023-01-30,CHESTER,gemGrab,Minecart Madness,0,30,36,66
11878,2023-01-30,CHESTER,gemGrab,Double Swoosh,0,65,61,126
11879,2023-01-30,CHESTER,brawlBall,Center Stage,18,394,465,877
11880,2023-01-30,CHESTER,brawlBall,Backyard Bowl,5,49,32,86
11881,2023-01-30,CHESTER,bounty,Hideout,0,9,2,11
11882,2023-01-29,CHESTER,knockout,Belle's Rock,0,40,22,62
11883,2023-01-29,CHESTER,hotZone,Quarter Pounder,0,40,37,77
11884,2023-01-29,CHESTER,heist,Bridge Too Far,0,19,4,23
11885,2023-01-29,CHESTER,gemGrab,Hard Rock Mine,0,20,23,43
11886,2023-01-29,CHESTER,gemGrab,Double Swoosh,0,179,200,379
11887,2023-01-29,CHESTER,brawlBall,Super Beach,0,9,11,20
11888,2023-01-29,CHESTER,brawlBall,Backyard Bowl,17,382,474,873
11889,2023-01-29,CHESTER,bounty,Canal Grande,0,41,62,103
11890,2023-01-28,CHESTER,knockout,Flaring Phoenix,0,47,54,101
11891,2023-01-28,CHESTER,hotZone,Controller Chaos,0,93,84,177
11892,2023-01-28,CHESTER,heist,Bridge Too Far,1,31,26,58
11893,2023-01-28,CHESTER,gemGrab,Hard Rock Mine,0,98,87,185
11894,2023-01-28,CHESTER,gemGrab,Deep Diner,0,40,43,83
11895,2023-01-28,CHESTER,brawlBall,Super Beach,16,519,571,1106
11896,2023-01-28,CHESTER,brawlBall,Sneaky Fields,3,32,29,64
11897,2023-01-28,CHESTER,bounty,Canal Grande,0,57,72,129
11898,2023-01-27,CHESTER,knockout,Flaring Phoenix,0,46,30,76
11899,2023-01-27,CHESTER,hotZone,Controller Chaos,0,19,27,46
11900,2023-01-27,CHESTER,heist,Hot Potato,0,10,9,19
11901,2023-01-27,CHESTER,gemGrab,Undermine,0,6,6,12
11902,2023-01-27,CHESTER,gemGrab,Deep Diner,0,52,58,110
11903,2023-01-27,CHESTER,brawlBall,Sneaky Fields,5,185,198,388
11904,2023-01-27,CHESTER,brawlBall,Pinhole Punt,0,2,13,15
11905,2023-01-27,CHESTER,bounty,Temple Ruins,0,20,16,36
11906,2023-01-26,CHESTER,knockout,Riverside,0,61,28,89
11907,2023-01-26,CHESTER,hotZone,Open Zone,0,40,35,75
11908,2023-01-26,CHESTER,heist,Hot Potato,0,28,18,46
11909,2023-01-26,CHESTER,gemGrab,Undermine,0,134,138,272
11910,2023-01-26,CHESTER,gemGrab,Gem Fort,0,67,88,155
11911,2023-01-26,CHESTER,brawlBall,Sunny Soccer,0,37,29,66
11912,2023-01-26,CHESTER,brawlBall,Pinhole Punt,24,646,722,1392
11913,2023-01-26,CHESTER,bounty,Temple Ruins,0,59,87,146
11914,2023-01-25,CHESTER,knockout,Riverside,0,15,10,25
11915,2023-01-25,CHESTER,hotZone,Open Zone,0,36,26,62
11916,2023-01-25,CHESTER,heist,Safe Zone,0,18,9,27
11917,2023-01-25,CHESTER,gemGrab,Gem Fort,0,55,66,121
11918,2023-01-25,CHESTER,gemGrab,Crystal Arcade,0,80,111,191
11919,2023-01-25,CHESTER,brawlBall,Sunny Soccer,16,368,443,827
11920,2023-01-25,CHESTER,brawlBall,Beach Ball,3,66,83,152
11921,2023-01-25,CHESTER,bounty,Excel,0,17,16,33
11922,2023-01-24,CHESTER,knockout,New Perspective,0,71,71,142
11923,2023-01-24,CHESTER,hotZone,Dueling Beetles,0,43,25,68
11924,2023-01-24,CHESTER,heist,Safe Zone,0,25,9,34
11925,2023-01-24,CHESTER,gemGrab,Minecart Madness,0,25,17,42
11926,2023-01-24,CHESTER,gemGrab,Crystal Arcade,0,119,106,225
11927,2023-01-24,CHESTER,brawlBall,Center Stage,1,88,70,159
11928,2023-01-24,CHESTER,brawlBall,Beach Ball,18,588,646,1252
11929,2023-01-24,CHESTER,bounty,Excel,0,40,24,64
11930,2023-01-23,CHESTER,knockout,New Perspective,0,126,80,206
11931,2023-01-23,CHESTER,hotZone,Dueling Beetles,0,79,59,138
11932,2023-01-23,CHESTER,heist,Snaked Assault,1,49,31,81
11933,2023-01-23,CHESTER,gemGrab,Minecart Madness,0,121,139,260
11934,2023-01-23,CHESTER,gemGrab,Double Swoosh,0,74,101,175
11935,2023-01-23,CHESTER,brawlBall,Center Stage,31,985,1060,2076
11936,2023-01-23,CHESTER,brawlBall,Backyard Bowl,2,36,33,71
11937,2023-01-23,CHESTER,bounty,Layer Cake,0,35,34,69
11938,2023-01-22,CHESTER,knockout,X Marks the Spot,0,37,23,60
11939,2023-01-22,CHESTER,hotZone,Ring of Fire,0,15,23,38
11940,2023-01-22,CHESTER,heist,Snaked Assault,0,22,16,38
11941,2023-01-22,CHESTER,gemGrab,Hard Rock Mine,0,35,26,61
11942,2023-01-22,CHESTER,gemGrab,Double Swoosh,0,100,123,223
11943,2023-01-22,CHESTER,brawlBall,Super Beach,2,46,52,100
11944,2023-01-22,CHESTER,brawlBall,Backyard Bowl,12,246,331,589
11945,2023-01-22,CHESTER,bounty,Layer Cake,0,16,9,25
11946,2023-01-21,CHESTER,knockout,X Marks the Spot,1,122,101,224
11947,2023-01-21,CHESTER,hotZone,Ring of Fire,0,68,44,112
11948,2023-01-21,CHESTER,heist,Tornado Ring,0,38,49,87
11949,2023-01-21,CHESTER,gemGrab,Hard Rock Mine,0,155,150,305
11950,2023-01-21,CHESTER,gemGrab,Deep Diner,0,25,24,49
11951,2023-01-21,CHESTER,brawlBall,Super Beach,22,852,770,1644
11952,2023-01-21,CHESTER,brawlBall,Sneaky Fields,1,32,19,52
11953,2023-01-21,CHESTER,bounty,Dry Season,0,40,38,78
11954,2023-01-20,CHESTER,knockout,Out in the Open,0,90,112,202
11955,2023-01-20,CHESTER,hotZone,Split,0,52,58,110
11956,2023-01-20,CHESTER,heist,Tornado Ring,0,48,51,99
11957,2023-01-20,CHESTER,gemGrab,Undermine,0,81,74,155
11958,2023-01-20,CHESTER,gemGrab,Deep Diner,0,159,193,352
11959,2023-01-20,CHESTER,brawlBall,Sneaky Fields,26,676,598,1300
11960,2023-01-20,CHESTER,brawlBall,Pinhole Punt,4,23,29,56
11961,2023-01-20,CHESTER,bounty,Dry Season,0,39,27,66
11962,2023-01-19,CHESTER,knockout,Out in the Open,0,111,56,167
11963,2023-01-19,CHESTER,hotZone,Split,0,95,92,187
11964,2023-01-19,CHESTER,heist,Kaboom Canyon,0,25,21,46
11965,2023-01-19,CHESTER,gemGrab,Undermine,0,128,134,262
11966,2023-01-19,CHESTER,gemGrab,Gem Fort,0,30,22,52
11967,2023-01-19,CHESTER,brawlBall,Sunny Soccer,0,20,13,33
11968,2023-01-19,CHESTER,brawlBall,Pinhole Punt,15,689,722,1426
11969,2023-01-19,CHESTER,bounty,Shooting Star,0,11,13,24
11970,2023-01-18,CHESTER,knockout,Goldarm Gulch,0,28,13,41
11971,2023-01-18,CHESTER,hotZone,Parallel Plays,0,11,31,42
11972,2023-01-18,CHESTER,heist,Kaboom Canyon,0,6,4,10
11973,2023-01-18,CHESTER,gemGrab,Gem Fort,0,39,32,71
11974,2023-01-18,CHESTER,gemGrab,Crystal Arcade,0,20,10,30
11975,2023-01-18,CHESTER,brawlBall,Sunny Soccer,2,197,223,422
11976,2023-01-18,CHESTER,brawlBall,Beach Ball,0,8,4,12
11977,2023-01-18,CHESTER,bounty,Shooting Star,0,7,7,14
11978,2023-01-17,CHESTER,knockout,Goldarm Gulch,0,29,23,52
11979,2023-01-17,CHESTER,hotZone,Parallel Plays,0,5,12,17
11980,2023-01-17,CHESTER,heist,Pit Stop,0,5,0,5
11981,2023-01-17,CHESTER,gemGrab,Minecart Madness,0,2,0,2
11982,2023-01-17,CHESTER,gemGrab,Crystal Arcade,0,8,16,24
11983,2023-01-17,CHESTER,brawlBall,Center Stage,1,6,8,15
11984,2023-01-17,CHESTER,brawlBall,Beach Ball,2,79,81,162
11985,2023-01-17,CHESTER,bounty,Hideout,0,2,0,2
11986,2023-01-16,CHESTER,knockout,Belle's Rock,0,8,4,12
11987,2023-01-16,CHESTER,hotZone,Quarter Pounder,0,13,16,29
11988,2023-01-16,CHESTER,heist,Pit Stop,0,12,4,16
11989,2023-01-16,CHESTER,gemGrab,Minecart Madness,0,13,10,23
11990,2023-01-16,CHESTER,gemGrab,Double Swoosh,0,12,10,22
11991,2023-01-16,CHESTER,brawlBall,Center Stage,1,97,71,169
11992,2023-01-16,CHESTER,brawlBall,Backyard Bowl,0,8,2,10
11993,2023-01-16,CHESTER,bounty,Hideout,0,4,21,25
11994,2023-01-15,CHESTER,knockout,Belle's Rock,0,13,4,17
11995,2023-01-15,CHESTER,hotZone,Quarter Pounder,0,64,65,129
11996,2023-01-15,CHESTER,heist,Bridge Too Far,0,7,0,7
11997,2023-01-15,CHESTER,gemGrab,Hard Rock Mine,0,21,36,57
11998,2023-01-15,CHESTER,gemGrab,Double Swoosh,0,27,20,47
11999,2023-01-15,CHESTER,brawlBall,Super Beach,0,18,3,21
12000,2023-01-15,CHESTER,brawlBall,Backyard Bowl,9,93,113,215
12001,2023-01-15,CHESTER,bounty,Canal Grande,0,7,11,18
12002,2023-01-14,CHESTER,knockout,Flaring Phoenix,0,12,3,15
12003,2023-01-14,CHESTER,hotZone,Controller Chaos,0,40,48,88
12004,2023-01-14,CHESTER,heist,Bridge Too Far,0,11,1,12
12005,2023-01-14,CHESTER,gemGrab,Hard Rock Mine,0,15,6,21
12006,2023-01-14,CHESTER,gemGrab,Deep Diner,0,5,2,7
12007,2023-01-14,CHESTER,brawlBall,Super Beach,3,75,87,165
12008,2023-01-14,CHESTER,brawlBall,Sneaky Fields,0,5,4,9
12009,2023-01-14,CHESTER,bounty,Canal Grande,0,14,47,61
12010,2023-01-13,CHESTER,knockout,Flaring Phoenix,0,10,5,15
12011,2023-01-13,CHESTER,hotZone,Controller Chaos,0,33,5,38
12012,2023-01-13,CHESTER,heist,Hot Potato,0,6,0,6
12013,2023-01-13,CHESTER,gemGrab,Undermine,0,1,0,1
12014,2023-01-13,CHESTER,gemGrab,Deep Diner,0,22,5,27
12015,2023-01-13,CHESTER,brawlBall,Sneaky Fields,2,94,46,142
12016,2023-01-13,CHESTER,brawlBall,Pinhole Punt,0,3,2,5
12017,2023-01-13,CHESTER,bounty,Temple Ruins,0,6,1,7
12018,2023-01-12,CHESTER,knockout,Riverside,0,19,5,24
12019,2023-01-12,CHESTER,hotZone,Open Zone,0,22,10,32
12020,2023-01-12,CHESTER,heist,Hot Potato,0,1,0,1
12021,2023-01-12,CHESTER,gemGrab,Undermine,0,23,21,44
12022,2023-01-12,CHESTER,gemGrab,Gem Fort,0,2,6,8
12023,2023-01-12,CHESTER,brawlBall,Sunny Soccer,0,8,19,27
12024,2023-01-12,CHESTER,brawlBall,Pinhole Punt,3,78,81,162
12025,2023-01-12,CHESTER,bounty,Temple Ruins,0,2,1,3
12026,2023-01-11,CHESTER,knockout,Riverside,0,2,0,2
12027,2023-01-11,CHESTER,hotZone,Open Zone,0,7,2,9
12028,2023-01-11,CHESTER,gemGrab,Gem Fort,0,19,39,58
12029,2023-01-11,CHESTER,brawlBall,Sunny Soccer,2,56,44,102
12030,2023-01-11,CHESTER,brawlBall,Beach Ball,0,4,5,9
12031,2023-01-11,CHESTER,bounty,Excel,0,2,0,2
12032,2023-01-10,CHESTER,knockout,New Perspective,0,24,24,48
12033,2023-01-10,CHESTER,hotZone,Dueling Beetles,0,54,38,92
12034,2023-01-10,CHESTER,heist,Safe Zone,0,11,5,16
12035,2023-01-10,CHESTER,gemGrab,Minecart Madness,0,23,22,45
12036,2023-01-10,CHESTER,gemGrab,Crystal Arcade,0,60,50,110
12037,2023-01-10,CHESTER,brawlBall,Center Stage,1,32,37,70
12038,2023-01-10,CHESTER,brawlBall,Beach Ball,1,207,213,421
12039,2023-01-10,CHESTER,bounty,Excel,0,4,8,12
12040,2023-01-09,CHESTER,knockout,New Perspective,0,27,20,47
12041,2023-01-09,CHESTER,hotZone,Dueling Beetles,0,35,21,56
12042,2023-01-09,CHESTER,heist,Snaked Assault,0,43,47,90
12043,2023-01-09,CHESTER,gemGrab,Minecart Madness,0,63,98,161
12044,2023-01-09,CHESTER,gemGrab,Double Swoosh,0,68,53,121
12045,2023-01-09,CHESTER,brawlBall,Center Stage,7,271,254,532
12046,2023-01-09,CHESTER,brawlBall,Backyard Bowl,2,16,2,20
12047,2023-01-09,CHESTER,bounty,Layer Cake,0,21,19,40
12048,2023-01-08,CHESTER,knockout,X Marks the Spot,0,16,5,21
12049,2023-01-08,CHESTER,hotZone,Ring of Fire,0,48,73,121
12050,2023-01-08,CHESTER,heist,Snaked Assault,0,32,66,98
12051,2023-01-08,CHESTER,gemGrab,Hard Rock Mine,0,23,35,58
12052,2023-01-08,CHESTER,gemGrab,Double Swoosh,0,45,39,84
12053,2023-01-08,CHESTER,brawlBall,Super Beach,1,26,20,47
12054,2023-01-08,CHESTER,brawlBall,Backyard Bowl,4,130,121,255
12055,2023-01-08,CHESTER,bounty,Layer Cake,0,15,18,33
12056,2023-01-07,CHESTER,knockout,X Marks the Spot,0,18,18,36
12057,2023-01-07,CHESTER,hotZone,Ring of Fire,0,25,41,66
12058,2023-01-07,CHESTER,heist,Tornado Ring,0,29,26,55
12059,2023-01-07,CHESTER,gemGrab,Hard Rock Mine,0,46,42,88
12060,2023-01-07,CHESTER,gemGrab,Deep Diner,0,40,47,87
12061,2023-01-07,CHESTER,brawlBall,Super Beach,2,102,107,211
12062,2023-01-07,CHESTER,brawlBall,Sneaky Fields,3,31,20,54
12063,2023-01-07,CHESTER,bounty,Dry Season,0,6,4,10
12064,2023-01-06,CHESTER,knockout,Out in the Open,0,13,7,20
12065,2023-01-06,CHESTER,hotZone,Split,0,28,49,77
12066,2023-01-06,CHESTER,heist,Tornado Ring,1,59,56,116
12067,2023-01-06,CHESTER,gemGrab,Undermine,0,37,56,93
12068,2023-01-06,CHESTER,gemGrab,Deep Diner,0,82,99,181
12069,2023-01-06,CHESTER,brawlBall,Sneaky Fields,3,221,173,397
12070,2023-01-06,CHESTER,brawlBall,Pinhole Punt,0,30,25,55
12071,2023-01-06,CHESTER,bounty,Dry Season,0,16,2,18
12072,2023-01-05,CHESTER,knockout,Out in the Open,0,57,21,78
12073,2023-01-05,CHESTER,hotZone,Split,0,97,70,167
12074,2023-01-05,CHESTER,heist,Kaboom Canyon,0,12,14,26
12075,2023-01-05,CHESTER,gemGrab,Undermine,0,103,101,204
12076,2023-01-05,CHESTER,gemGrab,Gem Fort,0,14,11,25
12077,2023-01-05,CHESTER,brawlBall,Sunny Soccer,0,4,1,5
12078,2023-01-05,CHESTER,brawlBall,Pinhole Punt,11,444,454,909
12079,2023-01-05,CHESTER,bounty,Shooting Star,0,6,0,6
12080,2023-01-04,CHESTER,knockout,Goldarm Gulch,0,18,6,24
12081,2023-01-04,CHESTER,hotZone,Parallel Plays,0,51,70,121
12082,2023-01-04,CHESTER,heist,Kaboom Canyon,1,28,22,51
12083,2023-01-04,CHESTER,gemGrab,Gem Fort,0,102,91,193
12084,2023-01-04,CHESTER,gemGrab,Crystal Arcade,0,22,14,36
12085,2023-01-04,CHESTER,brawlBall,Sunny Soccer,7,307,376,690
12086,2023-01-04,CHESTER,brawlBall,Beach Ball,0,1,0,1
12087,2023-01-04,CHESTER,bounty,Shooting Star,0,17,2,19
12088,2023-01-03,CHESTER,knockout,Goldarm Gulch,0,21,22,43
12089,2023-01-03,CHESTER,hotZone,Parallel Plays,2,89,106,197
12090,2023-01-03,CHESTER,hotZone,Controller Chaos,0,1,1,2
12091,2023-01-03,CHESTER,heist,Pit Stop,0,30,24,54
12092,2023-01-03,CHESTER,heist,Kaboom Canyon,0,1,0,1
12093,2023-01-03,CHESTER,gemGrab,Minecart Madness,0,23,24,47
12094,2023-01-03,CHESTER,gemGrab,Crystal Arcade,0,119,103,222
12095,2023-01-03,CHESTER,brawlBall,Center Stage,0,12,13,25
12096,2023-01-03,CHESTER,brawlBall,Beach Ball,3,266,304,573
12097,2023-01-03,CHESTER,bounty,Hideout,0,13,8,21
12098,2023-01-02,CHESTER,knockout,Belle's Rock,0,18,19,37
12099,2023-01-02,CHESTER,hotZone,Quarter Pounder,1,121,221,343
12100,2023-01-02,CHESTER,hotZone,Controller Chaos,0,1,1,2
12101,2023-01-02,CHESTER,heist,Pit Stop,0,26,22,48
12102,2023-01-02,CHESTER,heist,Kaboom Canyon,0,0,1,1
12103,2023-01-02,CHESTER,gemGrab,Minecart Madness,0,78,84,162
12104,2023-01-02,CHESTER,gemGrab,Double Swoosh,0,76,93,169
12105,2023-01-02,CHESTER,brawlBall,Center Stage,11,343,416,770
12106,2023-01-02,CHESTER,brawlBall,Backyard Bowl,1,10,21,32
12107,2023-01-02,CHESTER,bounty,Hideout,0,26,11,37
12108,2023-01-01,CHESTER,knockout,Belle's Rock,0,8,6,14
12109,2023-01-01,CHESTER,hotZone,Quarter Pounder,0,67,82,149
12110,2023-01-01,CHESTER,heist,Bridge Too Far,0,5,0,5
12111,2023-01-01,CHESTER,gemGrab,Hard Rock Mine,0,1,2,3
12112,2023-01-01,CHESTER,gemGrab,Double Swoosh,0,54,86,140
12113,2023-01-01,CHESTER,brawlBall,Backyard Bowl,3,69,105,177
12114,2023-01-01,CHESTER,bounty,Canal Grande,0,3,11,14
12115,2022-12-31,CHESTER,knockout,Flaring Phoenix,0,0,1,1
12116,2022-12-31,CHESTER,hotZone,Controller Chaos,0,7,5,12
12117,2022-12-31,CHESTER,heist,Bridge Too Far,0,6,2,8
12118,2022-12-31,CHESTER,gemGrab,Hard Rock Mine,0,10,23,33
12119,2022-12-31,CHESTER,gemGrab,Deep Diner,0,11,2,13
12120,2022-12-31,CHESTER,brawlBall,Super Beach,1,22,42,65
12121,2022-12-31,CHESTER,brawlBall,Sneaky Fields,0,1,2,3
12122,2022-12-31,CHESTER,bounty,Canal Grande,0,2,3,5
12123,2022-12-30,CHESTER,knockout,Flaring Phoenix,0,0,1,1
12124,2022-12-30,CHESTER,hotZone,Controller Chaos,0,17,41,58
12125,2022-12-30,CHESTER,heist,Kaboom Canyon,0,0,2,2
12126,2022-12-30,CHESTER,heist,Hot Potato,0,4,1,5
12127,2022-12-30,CHESTER,gemGrab,Undermine,0,7,2,9
12128,2022-12-30,CHESTER,gemGrab,Minecart Madness,0,1,3,4
12129,2022-12-30,CHESTER,gemGrab,Deep Diner,0,21,34,55
12130,2022-12-30,CHESTER,brawlBall,Sneaky Fields,2,37,38,77
12131,2022-12-29,CHESTER,hotZone,Open Zone,0,4,2,6
12132,2022-12-29,CHESTER,hotZone,Controller Chaos,0,0,1,1
12133,2022-12-29,CHESTER,heist,Hot Potato,0,1,0,1
12134,2022-12-29,CHESTER,gemGrab,Undermine,0,4,1,5
12135,2022-12-29,CHESTER,gemGrab,Gem Fort,0,2,1,3
12136,2022-12-29,CHESTER,brawlBall,Pinhole Punt,0,14,19,33
12137,2022-12-28,CHESTER,hotZone,Open Zone,0,6,11,17
12138,2022-12-28,CHESTER,hotZone,Controller Chaos,0,1,1,2
12139,2022-12-28,CHESTER,gemGrab,Crystal Arcade,0,1,1,2
12140,2022-12-28,CHESTER,brawlBall,Sunny Soccer,0,2,2,4
12141,2022-12-28,CHESTER,brawlBall,Beach Ball,0,1,1,2
12142,2022-12-27,CHESTER,hotZone,Controller Chaos,0,1,1,2
12143,2022-12-27,CHESTER,heist,Safe Zone,0,0,1,1
12144,2022-12-27,CHESTER,gemGrab,Minecart Madness,0,1,0,1
12145,2022-12-27,CHESTER,brawlBall,Center Stage,0,1,2,3
12146,2022-12-27,CHESTER,brawlBall,Beach Ball,0,7,5,12
12147,2022-12-26,CHESTER,hotZone,Controller Chaos,0,1,2,3
12148,2022-12-26,CHESTER,gemGrab,Minecart Madness,0,3,1,4
12149,2022-12-26,CHESTER,brawlBall,Center Stage,0,4,4,8
12150,2022-12-25,CHESTER,hotZone,Ring of Fire,0,0,1,1
12151,2022-12-25,CHESTER,gemGrab,Double Swoosh,0,3,3,6
12152,2022-12-25,CHESTER,brawlBall,Backyard Bowl,0,3,2,5
12153,2022-12-24,CHESTER,brawlBall,Super Beach,0,1,3,4
12154,2022-12-24,CHESTER,bounty,Dry Season,0,0,1,1
12155,2022-12-23,CHESTER,knockout,Out in the Open,0,2,1,3
12156,2022-12-23,CHESTER,gemGrab,Deep Diner,0,1,1,2
12157,2022-12-23,CHESTER,brawlBall,Sneaky Fields,0,1,0,1
12158,2022-12-22,CHESTER,gemGrab,Gem Fort,0,8,14,22
12159,2022-12-22,CHESTER,brawlBall,Pinhole Punt,0,0,13,13
12160,2022-12-21,CHESTER,brawlBall,Sunny Soccer,0,3,4,7
12161,2022-12-20,CHESTER,brawlBall,Beach Ball,2,2,5,9
12162,2022-12-19,CHESTER,brawlBall,Center Stage,0,3,9,12
12163,2022-12-17,CHESTER,knockout,Flaring Phoenix,0,0,1,1
12164,2022-12-17,CHESTER,brawlBall,Super Beach,0,1,1,2
12165,2022-12-16,CHESTER,hotZone,Controller Chaos,0,0,1,1
12166,2022-12-16,CHESTER,brawlBall,Sneaky Fields,0,5,2,7
12167,2022-12-16,CHESTER,bounty,Temple Ruins,0,1,0,1
12168,2022-12-13,CHESTER,knockout,New Perspective,0,6,0,6
12169,2022-12-13,CHESTER,hotZone,Dueling Beetles,0,0,1,1
12170,2022-12-13,CHESTER,heist,Safe Zone,0,1,0,1
12171,2022-12-13,CHESTER,gemGrab,Crystal Arcade,0,4,8,12
12172,2022-12-13,CHESTER,brawlBall,Beach Ball,0,3,6,9
12173,2023-01-30,CARL,knockout,Belle's Rock,0,213,202,415
12174,2023-01-30,CARL,hotZone,Quarter Pounder,1,103,112,216
12175,2023-01-30,CARL,heist,Pit Stop,0,53,26,79
12176,2023-01-30,CARL,gemGrab,Minecart Madness,0,112,145,257
12177,2023-01-30,CARL,gemGrab,Double Swoosh,0,50,71,121
12178,2023-01-30,CARL,brawlBall,Center Stage,4,204,139,347
12179,2023-01-30,CARL,brawlBall,Backyard Bowl,6,48,53,107
12180,2023-01-30,CARL,bounty,Hideout,0,19,27,46
12181,2023-01-29,CARL,knockout,Belle's Rock,1,276,242,519
12182,2023-01-29,CARL,hotZone,Quarter Pounder,0,108,152,260
12183,2023-01-29,CARL,heist,Bridge Too Far,0,66,68,134
12184,2023-01-29,CARL,gemGrab,Hard Rock Mine,0,31,38,69
12185,2023-01-29,CARL,gemGrab,Double Swoosh,0,71,61,132
12186,2023-01-29,CARL,brawlBall,Super Beach,1,2,2,5
12187,2023-01-29,CARL,brawlBall,Backyard Bowl,16,584,536,1136
12188,2023-01-29,CARL,bounty,Canal Grande,0,71,72,143
12189,2023-01-28,CARL,knockout,Flaring Phoenix,0,56,51,107
12190,2023-01-28,CARL,hotZone,Controller Chaos,0,36,40,76
12191,2023-01-28,CARL,heist,Bridge Too Far,0,201,147,348
12192,2023-01-28,CARL,gemGrab,Hard Rock Mine,0,182,267,449
12193,2023-01-28,CARL,gemGrab,Deep Diner,0,73,101,174
12194,2023-01-28,CARL,brawlBall,Super Beach,10,426,429,865
12195,2023-01-28,CARL,brawlBall,Sneaky Fields,0,14,19,33
12196,2023-01-28,CARL,bounty,Canal Grande,0,150,206,356
12197,2023-01-27,CARL,knockout,Flaring Phoenix,0,25,13,38
12198,2023-01-27,CARL,hotZone,Controller Chaos,0,19,28,47
12199,2023-01-27,CARL,heist,Hot Potato,0,20,12,32
12200,2023-01-27,CARL,gemGrab,Undermine,0,9,10,19
12201,2023-01-27,CARL,gemGrab,Deep Diner,0,59,98,157
12202,2023-01-27,CARL,brawlBall,Sneaky Fields,1,101,92,194
12203,2023-01-27,CARL,brawlBall,Pinhole Punt,0,9,18,27
12204,2023-01-27,CARL,bounty,Temple Ruins,0,14,15,29
12205,2023-01-26,CARL,knockout,Riverside,0,118,105,223
12206,2023-01-26,CARL,hotZone,Open Zone,0,86,93,179
12207,2023-01-26,CARL,heist,Hot Potato,0,50,85,135
12208,2023-01-26,CARL,gemGrab,Undermine,0,65,58,123
12209,2023-01-26,CARL,gemGrab,Gem Fort,0,21,15,36
12210,2023-01-26,CARL,brawlBall,Sunny Soccer,0,22,42,64
12211,2023-01-26,CARL,brawlBall,Pinhole Punt,15,556,588,1159
12212,2023-01-26,CARL,bounty,Temple Ruins,0,53,51,104
12213,2023-01-25,CARL,knockout,Riverside,0,47,32,79
12214,2023-01-25,CARL,hotZone,Open Zone,0,43,54,97
12215,2023-01-25,CARL,heist,Safe Zone,1,99,114,214
12216,2023-01-25,CARL,gemGrab,Gem Fort,0,26,23,49
12217,2023-01-25,CARL,gemGrab,Crystal Arcade,0,77,138,215
12218,2023-01-25,CARL,brawlBall,Sunny Soccer,8,272,265,545
12219,2023-01-25,CARL,brawlBall,Beach Ball,1,37,55,93
12220,2023-01-25,CARL,bounty,Excel,0,82,161,243
12221,2023-01-24,CARL,knockout,New Perspective,0,56,36,92
12222,2023-01-24,CARL,hotZone,Dueling Beetles,0,74,83,157
12223,2023-01-24,CARL,heist,Safe Zone,0,163,173,336
12224,2023-01-24,CARL,gemGrab,Minecart Madness,0,61,83,144
12225,2023-01-24,CARL,gemGrab,Crystal Arcade,0,147,220,367
12226,2023-01-24,CARL,brawlBall,Center Stage,2,45,45,92
12227,2023-01-24,CARL,brawlBall,Beach Ball,23,512,610,1145
12228,2023-01-24,CARL,bounty,Excel,0,114,172,286
12229,2023-01-23,CARL,knockout,New Perspective,0,114,123,237
12230,2023-01-23,CARL,hotZone,Dueling Beetles,0,172,232,404
12231,2023-01-23,CARL,heist,Snaked Assault,0,66,34,100
12232,2023-01-23,CARL,gemGrab,Minecart Madness,0,284,375,659
12233,2023-01-23,CARL,gemGrab,Double Swoosh,0,44,58,102
12234,2023-01-23,CARL,brawlBall,Center Stage,9,417,421,847
12235,2023-01-23,CARL,brawlBall,Backyard Bowl,4,39,50,93
12236,2023-01-23,CARL,bounty,Layer Cake,0,97,103,200
12237,2023-01-22,CARL,knockout,X Marks the Spot,0,52,56,108
12238,2023-01-22,CARL,hotZone,Ring of Fire,0,42,65,107
12239,2023-01-22,CARL,heist,Snaked Assault,0,33,27,60
12240,2023-01-22,CARL,gemGrab,Hard Rock Mine,0,45,57,102
12241,2023-01-22,CARL,gemGrab,Double Swoosh,0,43,31,74
12242,2023-01-22,CARL,brawlBall,Super Beach,1,47,58,106
12243,2023-01-22,CARL,brawlBall,Backyard Bowl,10,310,352,672
12244,2023-01-22,CARL,bounty,Layer Cake,0,72,67,139
12245,2023-01-21,CARL,knockout,X Marks the Spot,0,217,160,377
12246,2023-01-21,CARL,hotZone,Ring of Fire,1,129,159,289
12247,2023-01-21,CARL,heist,Tornado Ring,0,37,43,80
12248,2023-01-21,CARL,gemGrab,Hard Rock Mine,0,184,269,453
12249,2023-01-21,CARL,gemGrab,Deep Diner,0,45,76,121
12250,2023-01-21,CARL,brawlBall,Super Beach,16,674,740,1430
12251,2023-01-21,CARL,brawlBall,Sneaky Fields,0,10,6,16
12252,2023-01-21,CARL,bounty,Dry Season,0,106,108,214
12253,2023-01-20,CARL,knockout,Out in the Open,0,174,182,356
12254,2023-01-20,CARL,hotZone,Split,0,15,22,37
12255,2023-01-20,CARL,heist,Tornado Ring,0,61,42,103
12256,2023-01-20,CARL,gemGrab,Undermine,0,29,20,49
12257,2023-01-20,CARL,gemGrab,Deep Diner,0,169,178,347
12258,2023-01-20,CARL,brawlBall,Sneaky Fields,6,272,248,526
12259,2023-01-20,CARL,brawlBall,Pinhole Punt,0,24,17,41
12260,2023-01-20,CARL,bounty,Dry Season,0,79,99,178
12261,2023-01-19,CARL,knockout,Out in the Open,2,265,259,526
12262,2023-01-19,CARL,hotZone,Split,0,26,30,56
12263,2023-01-19,CARL,heist,Kaboom Canyon,1,74,84,159
12264,2023-01-19,CARL,gemGrab,Undermine,0,122,115,237
12265,2023-01-19,CARL,gemGrab,Gem Fort,0,14,13,27
12266,2023-01-19,CARL,brawlBall,Sunny Soccer,0,20,22,42
12267,2023-01-19,CARL,brawlBall,Pinhole Punt,17,637,754,1408
12268,2023-01-19,CARL,bounty,Shooting Star,0,43,32,75
12269,2023-01-18,CARL,knockout,Goldarm Gulch,0,15,9,24
12270,2023-01-18,CARL,hotZone,Parallel Plays,0,4,4,8
12271,2023-01-18,CARL,heist,Kaboom Canyon,0,22,31,53
12272,2023-01-18,CARL,gemGrab,Gem Fort,0,19,7,26
12273,2023-01-18,CARL,gemGrab,Crystal Arcade,0,12,5,17
12274,2023-01-18,CARL,brawlBall,Sunny Soccer,6,129,143,278
12275,2023-01-18,CARL,brawlBall,Beach Ball,0,3,2,5
12276,2023-01-18,CARL,bounty,Shooting Star,0,12,23,35
12277,2023-01-17,CARL,knockout,Goldarm Gulch,0,20,13,33
12278,2023-01-17,CARL,hotZone,Parallel Plays,0,3,7,10
12279,2023-01-17,CARL,heist,Pit Stop,0,4,1,5
12280,2023-01-17,CARL,gemGrab,Minecart Madness,0,4,10,14
12281,2023-01-17,CARL,gemGrab,Crystal Arcade,0,15,18,33
12282,2023-01-17,CARL,brawlBall,Center Stage,0,2,1,3
12283,2023-01-17,CARL,brawlBall,Beach Ball,2,56,54,112
12284,2023-01-17,CARL,bounty,Hideout,0,6,5,11
12285,2023-01-16,CARL,knockout,Belle's Rock,0,20,19,39
12286,2023-01-16,CARL,hotZone,Quarter Pounder,0,6,15,21
12287,2023-01-16,CARL,heist,Pit Stop,0,19,22,41
12288,2023-01-16,CARL,gemGrab,Minecart Madness,0,23,44,67
12289,2023-01-16,CARL,gemGrab,Double Swoosh,0,3,2,5
12290,2023-01-16,CARL,brawlBall,Center Stage,0,25,18,43
12291,2023-01-16,CARL,brawlBall,Backyard Bowl,0,4,3,7
12292,2023-01-16,CARL,bounty,Hideout,0,7,13,20
12293,2023-01-15,CARL,knockout,Belle's Rock,0,27,23,50
12294,2023-01-15,CARL,hotZone,Quarter Pounder,0,23,70,93
12295,2023-01-15,CARL,heist,Bridge Too Far,0,17,24,41
12296,2023-01-15,CARL,gemGrab,Hard Rock Mine,0,13,11,24
12297,2023-01-15,CARL,gemGrab,Double Swoosh,0,6,5,11
12298,2023-01-15,CARL,brawlBall,Super Beach,1,9,18,28
12299,2023-01-15,CARL,brawlBall,Backyard Bowl,4,63,113,180
12300,2023-01-15,CARL,bounty,Canal Grande,0,12,31,43
12301,2023-01-14,CARL,knockout,Flaring Phoenix,0,4,5,9
12302,2023-01-14,CARL,hotZone,Controller Chaos,0,7,11,18
12303,2023-01-14,CARL,heist,Bridge Too Far,0,30,13,43
12304,2023-01-14,CARL,gemGrab,Hard Rock Mine,0,14,44,58
12305,2023-01-14,CARL,gemGrab,Deep Diner,0,17,15,32
12306,2023-01-14,CARL,brawlBall,Super Beach,0,43,42,85
12307,2023-01-14,CARL,brawlBall,Sneaky Fields,0,2,0,2
12308,2023-01-14,CARL,bounty,Canal Grande,0,11,9,20
12309,2023-01-13,CARL,knockout,Flaring Phoenix,0,11,29,40
12310,2023-01-13,CARL,hotZone,Controller Chaos,0,15,15,30
12311,2023-01-13,CARL,heist,Hot Potato,0,4,1,5
12312,2023-01-13,CARL,gemGrab,Undermine,0,0,1,1
12313,2023-01-13,CARL,gemGrab,Deep Diner,0,22,37,59
12314,2023-01-13,CARL,brawlBall,Sneaky Fields,0,17,11,28
12315,2023-01-13,CARL,brawlBall,Pinhole Punt,0,1,2,3
12316,2023-01-13,CARL,bounty,Temple Ruins,0,0,4,4
12317,2023-01-12,CARL,knockout,Riverside,0,13,13,26
12318,2023-01-12,CARL,hotZone,Open Zone,0,9,28,37
12319,2023-01-12,CARL,heist,Hot Potato,0,0,2,2
12320,2023-01-12,CARL,gemGrab,Undermine,0,4,2,6
12321,2023-01-12,CARL,brawlBall,Pinhole Punt,1,13,21,35
12322,2023-01-11,CARL,knockout,Riverside,0,2,0,2
12323,2023-01-11,CARL,hotZone,Open Zone,0,4,6,10
12324,2023-01-11,CARL,gemGrab,Gem Fort,0,2,0,2
12325,2023-01-11,CARL,brawlBall,Sunny Soccer,0,8,9,17
12326,2023-01-11,CARL,bounty,Excel,0,2,0,2
12327,2023-01-10,CARL,knockout,New Perspective,0,2,4,6
12328,2023-01-10,CARL,hotZone,Dueling Beetles,0,30,53,83
12329,2023-01-10,CARL,heist,Safe Zone,0,16,11,27
12330,2023-01-10,CARL,gemGrab,Minecart Madness,0,11,19,30
12331,2023-01-10,CARL,gemGrab,Crystal Arcade,0,11,8,19
12332,2023-01-10,CARL,brawlBall,Center Stage,0,5,1,6
12333,2023-01-10,CARL,brawlBall,Beach Ball,1,39,55,95
12334,2023-01-10,CARL,bounty,Excel,0,3,12,15
12335,2023-01-09,CARL,knockout,New Perspective,0,3,3,6
12336,2023-01-09,CARL,hotZone,Dueling Beetles,0,17,24,41
12337,2023-01-09,CARL,heist,Snaked Assault,0,7,3,10
12338,2023-01-09,CARL,gemGrab,Minecart Madness,0,34,44,78
12339,2023-01-09,CARL,gemGrab,Double Swoosh,0,5,3,8
12340,2023-01-09,CARL,brawlBall,Center Stage,0,17,5,22
12341,2023-01-09,CARL,brawlBall,Backyard Bowl,0,3,12,15
12342,2023-01-09,CARL,bounty,Layer Cake,0,18,28,46
12343,2023-01-08,CARL,knockout,X Marks the Spot,0,20,11,31
12344,2023-01-08,CARL,hotZone,Ring of Fire,0,6,17,23
12345,2023-01-08,CARL,heist,Snaked Assault,0,5,2,7
12346,2023-01-08,CARL,gemGrab,Hard Rock Mine,0,4,2,6
12347,2023-01-08,CARL,gemGrab,Double Swoosh,0,8,4,12
12348,2023-01-08,CARL,brawlBall,Super Beach,0,2,6,8
12349,2023-01-08,CARL,brawlBall,Backyard Bowl,2,46,53,101
12350,2023-01-08,CARL,bounty,Layer Cake,0,6,1,7
12351,2023-01-07,CARL,knockout,X Marks the Spot,0,6,8,14
12352,2023-01-07,CARL,hotZone,Ring of Fire,0,5,1,6
12353,2023-01-07,CARL,heist,Tornado Ring,0,5,0,5
12354,2023-01-07,CARL,gemGrab,Hard Rock Mine,0,18,14,32
12355,2023-01-07,CARL,gemGrab,Deep Diner,0,7,6,13
12356,2023-01-07,CARL,brawlBall,Super Beach,0,16,15,31
12357,2023-01-07,CARL,brawlBall,Sneaky Fields,0,1,0,1
12358,2023-01-07,CARL,bounty,Dry Season,0,19,32,51
12359,2023-01-06,CARL,knockout,Out in the Open,0,17,6,23
12360,2023-01-06,CARL,hotZone,Split,0,1,1,2
12361,2023-01-06,CARL,heist,Tornado Ring,0,1,1,2
12362,2023-01-06,CARL,gemGrab,Undermine,0,4,5,9
12363,2023-01-06,CARL,gemGrab,Deep Diner,0,32,44,76
12364,2023-01-06,CARL,brawlBall,Sneaky Fields,0,12,15,27
12365,2023-01-06,CARL,brawlBall,Pinhole Punt,0,6,7,13
12366,2023-01-06,CARL,bounty,Dry Season,0,29,44,73
12367,2023-01-05,CARL,knockout,Out in the Open,0,39,15,54
12368,2023-01-05,CARL,hotZone,Split,0,5,1,6
12369,2023-01-05,CARL,heist,Kaboom Canyon,0,10,15,25
12370,2023-01-05,CARL,gemGrab,Undermine,0,17,36,53
12371,2023-01-05,CARL,gemGrab,Gem Fort,0,0,1,1
12372,2023-01-05,CARL,brawlBall,Sunny Soccer,0,0,1,1
12373,2023-01-05,CARL,brawlBall,Pinhole Punt,3,102,121,226
12374,2023-01-05,CARL,bounty,Shooting Star,0,3,3,6
12375,2023-01-04,CARL,knockout,Goldarm Gulch,0,2,3,5
12376,2023-01-04,CARL,hotZone,Parallel Plays,0,5,0,5
12377,2023-01-04,CARL,heist,Kaboom Canyon,0,15,15,30
12378,2023-01-04,CARL,gemGrab,Gem Fort,0,16,49,65
12379,2023-01-04,CARL,gemGrab,Crystal Arcade,0,5,24,29
12380,2023-01-04,CARL,brawlBall,Sunny Soccer,2,68,141,211
12381,2023-01-04,CARL,brawlBall,Beach Ball,0,0,7,7
12382,2023-01-04,CARL,bounty,Shooting Star,0,12,5,17
12383,2023-01-03,CARL,knockout,Goldarm Gulch,0,5,2,7
12384,2023-01-03,CARL,hotZone,Parallel Plays,0,11,5,16
12385,2023-01-03,CARL,hotZone,Controller Chaos,0,0,1,1
12386,2023-01-03,CARL,heist,Pit Stop,0,8,19,27
12387,2023-01-03,CARL,gemGrab,Minecart Madness,0,3,6,9
12388,2023-01-03,CARL,gemGrab,Crystal Arcade,0,29,59,88
12389,2023-01-03,CARL,brawlBall,Center Stage,0,1,6,7
12390,2023-01-03,CARL,brawlBall,Beach Ball,0,55,72,127
12391,2023-01-03,CARL,bounty,Hideout,0,10,14,24
12392,2023-01-02,CARL,knockout,Belle's Rock,0,25,32,57
12393,2023-01-02,CARL,hotZone,Quarter Pounder,1,18,31,50
12394,2023-01-02,CARL,heist,Pit Stop,0,14,10,24
12395,2023-01-02,CARL,gemGrab,Minecart Madness,0,40,30,70
12396,2023-01-02,CARL,gemGrab,Double Swoosh,0,7,2,9
12397,2023-01-02,CARL,brawlBall,Center Stage,0,39,27,66
12398,2023-01-02,CARL,brawlBall,Backyard Bowl,0,1,11,12
12399,2023-01-02,CARL,bounty,Hideout,0,20,3,23
12400,2023-01-01,CARL,knockout,Belle's Rock,0,15,6,21
12401,2023-01-01,CARL,hotZone,Quarter Pounder,0,8,5,13
12402,2023-01-01,CARL,heist,Bridge Too Far,0,1,2,3
12403,2023-01-01,CARL,gemGrab,Minecart Madness,0,1,0,1
12404,2023-01-01,CARL,gemGrab,Hard Rock Mine,0,0,1,1
12405,2023-01-01,CARL,gemGrab,Double Swoosh,0,12,14,26
12406,2023-01-01,CARL,brawlBall,Backyard Bowl,1,34,8,43
12407,2023-01-01,CARL,bounty,Canal Grande,0,4,0,4
12408,2022-12-31,CARL,knockout,Flaring Phoenix,0,0,1,1
12409,2022-12-31,CARL,heist,Bridge Too Far,0,1,0,1
12410,2022-12-31,CARL,gemGrab,Hard Rock Mine,0,7,9,16
12411,2022-12-31,CARL,gemGrab,Deep Diner,0,2,0,2
12412,2022-12-31,CARL,brawlBall,Super Beach,0,3,0,3
12413,2022-12-31,CARL,bounty,Canal Grande,0,0,2,2
12414,2022-12-30,CARL,knockout,Flaring Phoenix,0,1,0,1
12415,2022-12-30,CARL,gemGrab,Deep Diner,0,9,12,21
12416,2022-12-30,CARL,brawlBall,Sneaky Fields,0,1,6,7
12417,2022-12-29,CARL,hotZone,Open Zone,0,0,1,1
12418,2022-12-29,CARL,hotZone,Controller Chaos,0,1,0,1
12419,2022-12-29,CARL,gemGrab,Undermine,0,0,1,1
12420,2022-12-29,CARL,brawlBall,Pinhole Punt,0,0,3,3
12421,2022-12-28,CARL,hotZone,Open Zone,0,2,0,2
12422,2022-12-28,CARL,brawlBall,Sunny Soccer,0,0,1,1
12423,2022-12-27,CARL,hotZone,Dueling Beetles,0,1,0,1
12424,2022-12-27,CARL,heist,Kaboom Canyon,0,0,1,1
12425,2022-12-27,CARL,gemGrab,Minecart Madness,0,1,1,2
12426,2022-12-27,CARL,brawlBall,Center Stage,0,0,1,1
12427,2022-12-27,CARL,brawlBall,Beach Ball,0,2,1,3
12428,2022-12-25,CARL,brawlBall,Backyard Bowl,0,1,0,1
12429,2022-12-25,CARL,bounty,Layer Cake,0,0,1,1
12430,2022-12-23,CARL,knockout,Out in the Open,0,5,6,11
12431,2022-12-22,CARL,brawlBall,Pinhole Punt,0,1,0,1
12432,2022-12-19,CARL,brawlBall,Center Stage,0,1,0,1
12433,2022-12-18,CARL,knockout,Belle's Rock,0,0,1,1
12434,2022-12-13,CARL,knockout,New Perspective,0,1,0,1
12435,2022-12-13,CARL,gemGrab,Crystal Arcade,0,1,0,1
12436,2022-12-13,CARL,brawlBall,Beach Ball,0,1,0,1
12437,2022-12-11,CARL,brawlBall,Backyard Bowl,0,0,1,1
12438,2022-12-10,CARL,knockout,X Marks the Spot,0,1,1,2
12439,2022-12-10,CARL,hotZone,Ring of Fire,0,1,0,1
12440,2022-12-10,CARL,gemGrab,Hard Rock Mine,0,0,1,1
12441,2022-11-11,CARL,knockout,New Perspective,0,1,0,1
12442,2022-11-11,CARL,brawlBall,Sneaky Fields,0,1,0,1
12443,2022-10-28,CARL,knockout,Out in the Open,0,3,1,4
12444,2022-10-28,CARL,hotZone,Dueling Beetles,0,0,2,2
12445,2022-10-28,CARL,heist,Safe Zone,0,0,1,1
12446,2022-10-10,CARL,knockout,Belle's Rock,0,0,1,1
12447,2023-01-30,BYRON,knockout,Belle's Rock,0,118,145,263
12448,2023-01-30,BYRON,hotZone,Quarter Pounder,0,24,24,48
12449,2023-01-30,BYRON,heist,Pit Stop,0,1,2,3
12450,2023-01-30,BYRON,gemGrab,Minecart Madness,0,84,56,140
12451,2023-01-30,BYRON,gemGrab,Double Swoosh,0,21,23,44
12452,2023-01-30,BYRON,brawlBall,Center Stage,1,59,26,86
12453,2023-01-30,BYRON,brawlBall,Backyard Bowl,1,37,40,78
12454,2023-01-30,BYRON,bounty,Hideout,0,52,73,125
12455,2023-01-29,BYRON,knockout,Belle's Rock,0,143,139,282
12456,2023-01-29,BYRON,hotZone,Quarter Pounder,0,14,26,40
12457,2023-01-29,BYRON,heist,Bridge Too Far,0,79,82,161
12458,2023-01-29,BYRON,gemGrab,Hard Rock Mine,0,19,20,39
12459,2023-01-29,BYRON,gemGrab,Double Swoosh,0,38,17,55
12460,2023-01-29,BYRON,brawlBall,Super Beach,0,1,1,2
12461,2023-01-29,BYRON,brawlBall,Backyard Bowl,21,387,421,829
12462,2023-01-29,BYRON,bounty,Canal Grande,0,22,11,33
12463,2023-01-28,BYRON,knockout,Flaring Phoenix,0,60,43,103
12464,2023-01-28,BYRON,hotZone,Controller Chaos,0,19,7,26
12465,2023-01-28,BYRON,heist,Bridge Too Far,2,199,150,351
12466,2023-01-28,BYRON,gemGrab,Hard Rock Mine,0,71,60,131
12467,2023-01-28,BYRON,gemGrab,Deep Diner,0,46,49,95
12468,2023-01-28,BYRON,brawlBall,Super Beach,0,91,86,177
12469,2023-01-28,BYRON,brawlBall,Sneaky Fields,0,4,5,9
12470,2023-01-28,BYRON,bounty,Canal Grande,0,40,31,71
12471,2023-01-27,BYRON,knockout,Flaring Phoenix,0,25,23,48
12472,2023-01-27,BYRON,hotZone,Controller Chaos,0,11,4,15
12473,2023-01-27,BYRON,heist,Hot Potato,0,3,0,3
12474,2023-01-27,BYRON,gemGrab,Undermine,0,2,4,6
12475,2023-01-27,BYRON,gemGrab,Deep Diner,0,41,37,78
12476,2023-01-27,BYRON,brawlBall,Sneaky Fields,0,41,36,77
12477,2023-01-27,BYRON,brawlBall,Pinhole Punt,0,1,2,3
12478,2023-01-27,BYRON,bounty,Temple Ruins,0,24,19,43
12479,2023-01-26,BYRON,knockout,Riverside,0,266,261,527
12480,2023-01-26,BYRON,hotZone,Open Zone,0,57,52,109
12481,2023-01-26,BYRON,heist,Hot Potato,0,9,4,13
12482,2023-01-26,BYRON,gemGrab,Undermine,0,57,33,90
12483,2023-01-26,BYRON,gemGrab,Gem Fort,0,13,10,23
12484,2023-01-26,BYRON,brawlBall,Sunny Soccer,0,8,10,18
12485,2023-01-26,BYRON,brawlBall,Pinhole Punt,7,232,194,433
12486,2023-01-26,BYRON,bounty,Temple Ruins,0,44,39,83
12487,2023-01-25,BYRON,knockout,Riverside,0,129,132,261
12488,2023-01-25,BYRON,hotZone,Open Zone,0,24,14,38
12489,2023-01-25,BYRON,heist,Safe Zone,0,47,39,86
12490,2023-01-25,BYRON,gemGrab,Gem Fort,0,12,11,23
12491,2023-01-25,BYRON,gemGrab,Crystal Arcade,0,54,47,101
12492,2023-01-25,BYRON,brawlBall,Sunny Soccer,1,65,57,123
12493,2023-01-25,BYRON,brawlBall,Beach Ball,3,18,12,33
12494,2023-01-25,BYRON,bounty,Excel,0,18,24,42
12495,2023-01-24,BYRON,knockout,New Perspective,0,86,60,146
12496,2023-01-24,BYRON,hotZone,Dueling Beetles,0,22,15,37
12497,2023-01-24,BYRON,heist,Safe Zone,1,74,58,133
12498,2023-01-24,BYRON,gemGrab,Minecart Madness,0,33,24,57
12499,2023-01-24,BYRON,gemGrab,Crystal Arcade,0,62,74,136
12500,2023-01-24,BYRON,brawlBall,Center Stage,1,7,4,12
12501,2023-01-24,BYRON,brawlBall,Beach Ball,2,106,70,178
12502,2023-01-24,BYRON,bounty,Excel,0,50,38,88
12503,2023-01-23,BYRON,knockout,New Perspective,0,118,72,190
12504,2023-01-23,BYRON,hotZone,Dueling Beetles,0,28,25,53
12505,2023-01-23,BYRON,heist,Snaked Assault,0,11,6,17
12506,2023-01-23,BYRON,gemGrab,Minecart Madness,0,136,102,238
12507,2023-01-23,BYRON,gemGrab,Double Swoosh,0,30,13,43
12508,2023-01-23,BYRON,brawlBall,Center Stage,7,103,112,222
12509,2023-01-23,BYRON,brawlBall,Backyard Bowl,1,14,19,34
12510,2023-01-23,BYRON,bounty,Layer Cake,0,29,24,53
12511,2023-01-22,BYRON,knockout,X Marks the Spot,0,61,52,113
12512,2023-01-22,BYRON,hotZone,Ring of Fire,0,17,5,22
12513,2023-01-22,BYRON,heist,Snaked Assault,0,7,0,7
12514,2023-01-22,BYRON,gemGrab,Hard Rock Mine,0,17,4,21
12515,2023-01-22,BYRON,gemGrab,Double Swoosh,0,16,11,27
12516,2023-01-22,BYRON,brawlBall,Super Beach,1,6,3,10
12517,2023-01-22,BYRON,brawlBall,Backyard Bowl,16,215,238,469
12518,2023-01-22,BYRON,bounty,Layer Cake,0,15,12,27
12519,2023-01-21,BYRON,knockout,X Marks the Spot,2,156,126,284
12520,2023-01-21,BYRON,hotZone,Ring of Fire,0,59,32,91
12521,2023-01-21,BYRON,heist,Tornado Ring,0,13,6,19
12522,2023-01-21,BYRON,gemGrab,Hard Rock Mine,0,75,91,166
12523,2023-01-21,BYRON,gemGrab,Deep Diner,0,19,17,36
12524,2023-01-21,BYRON,brawlBall,Super Beach,6,133,138,277
12525,2023-01-21,BYRON,brawlBall,Sneaky Fields,0,1,2,3
12526,2023-01-21,BYRON,bounty,Dry Season,0,183,195,378
12527,2023-01-20,BYRON,knockout,Out in the Open,0,170,112,282
12528,2023-01-20,BYRON,hotZone,Split,0,12,3,15
12529,2023-01-20,BYRON,heist,Tornado Ring,0,6,1,7
12530,2023-01-20,BYRON,gemGrab,Undermine,0,48,22,70
12531,2023-01-20,BYRON,gemGrab,Deep Diner,0,145,95,240
12532,2023-01-20,BYRON,brawlBall,Sneaky Fields,4,95,71,170
12533,2023-01-20,BYRON,brawlBall,Pinhole Punt,0,7,5,12
12534,2023-01-20,BYRON,bounty,Dry Season,0,123,96,219
12535,2023-01-19,BYRON,knockout,Out in the Open,0,191,186,377
12536,2023-01-19,BYRON,hotZone,Split,0,23,14,37
12537,2023-01-19,BYRON,heist,Kaboom Canyon,1,36,56,93
12538,2023-01-19,BYRON,gemGrab,Undermine,0,77,51,128
12539,2023-01-19,BYRON,gemGrab,Gem Fort,0,13,10,23
12540,2023-01-19,BYRON,brawlBall,Sunny Soccer,0,6,2,8
12541,2023-01-19,BYRON,brawlBall,Pinhole Punt,6,238,186,430
12542,2023-01-19,BYRON,bounty,Shooting Star,0,166,147,313
12543,2023-01-18,BYRON,knockout,Goldarm Gulch,0,16,10,26
12544,2023-01-18,BYRON,hotZone,Parallel Plays,0,1,3,4
12545,2023-01-18,BYRON,heist,Kaboom Canyon,0,14,19,33
12546,2023-01-18,BYRON,gemGrab,Gem Fort,0,14,11,25
12547,2023-01-18,BYRON,gemGrab,Crystal Arcade,0,11,4,15
12548,2023-01-18,BYRON,brawlBall,Sunny Soccer,0,27,12,39
12549,2023-01-18,BYRON,brawlBall,Beach Ball,0,1,1,2
12550,2023-01-18,BYRON,bounty,Shooting Star,0,60,91,151
12551,2023-01-17,BYRON,knockout,Goldarm Gulch,0,7,6,13
12552,2023-01-17,BYRON,hotZone,Parallel Plays,0,7,5,12
12553,2023-01-17,BYRON,heist,Pit Stop,0,1,0,1
12554,2023-01-17,BYRON,gemGrab,Minecart Madness,0,4,1,5
12555,2023-01-17,BYRON,gemGrab,Crystal Arcade,0,5,3,8
12556,2023-01-17,BYRON,brawlBall,Beach Ball,1,13,4,18
12557,2023-01-17,BYRON,bounty,Hideout,0,8,3,11
12558,2023-01-16,BYRON,knockout,Belle's Rock,0,13,30,43
12559,2023-01-16,BYRON,hotZone,Quarter Pounder,0,7,8,15
12560,2023-01-16,BYRON,gemGrab,Minecart Madness,0,9,8,17
12561,2023-01-16,BYRON,gemGrab,Double Swoosh,0,0,1,1
12562,2023-01-16,BYRON,brawlBall,Center Stage,0,2,4,6
12563,2023-01-16,BYRON,brawlBall,Backyard Bowl,0,3,15,18
12564,2023-01-16,BYRON,bounty,Hideout,0,14,11,25
12565,2023-01-15,BYRON,knockout,Belle's Rock,0,3,8,11
12566,2023-01-15,BYRON,hotZone,Quarter Pounder,0,3,21,24
12567,2023-01-15,BYRON,heist,Bridge Too Far,0,10,15,25
12568,2023-01-15,BYRON,gemGrab,Hard Rock Mine,0,6,17,23
12569,2023-01-15,BYRON,gemGrab,Double Swoosh,0,2,2,4
12570,2023-01-15,BYRON,brawlBall,Backyard Bowl,2,36,21,59
12571,2023-01-15,BYRON,bounty,Canal Grande,0,0,1,1
12572,2023-01-14,BYRON,knockout,Flaring Phoenix,0,10,4,14
12573,2023-01-14,BYRON,hotZone,Controller Chaos,0,4,0,4
12574,2023-01-14,BYRON,heist,Bridge Too Far,0,18,11,29
12575,2023-01-14,BYRON,gemGrab,Hard Rock Mine,0,4,1,5
12576,2023-01-14,BYRON,gemGrab,Deep Diner,0,3,0,3
12577,2023-01-14,BYRON,brawlBall,Super Beach,0,18,7,25
12578,2023-01-14,BYRON,brawlBall,Sneaky Fields,0,1,0,1
12579,2023-01-13,BYRON,knockout,Flaring Phoenix,0,6,5,11
12580,2023-01-13,BYRON,hotZone,Controller Chaos,0,2,1,3
12581,2023-01-13,BYRON,heist,Hot Potato,0,1,0,1
12582,2023-01-13,BYRON,gemGrab,Deep Diner,0,4,3,7
12583,2023-01-13,BYRON,brawlBall,Sneaky Fields,0,15,11,26
12584,2023-01-13,BYRON,bounty,Temple Ruins,0,2,2,4
12585,2023-01-12,BYRON,knockout,Riverside,0,23,18,41
12586,2023-01-12,BYRON,hotZone,Open Zone,0,8,18,26
12587,2023-01-12,BYRON,gemGrab,Undermine,0,1,5,6
12588,2023-01-12,BYRON,gemGrab,Gem Fort,0,1,0,1
12589,2023-01-12,BYRON,brawlBall,Sunny Soccer,0,3,1,4
12590,2023-01-12,BYRON,brawlBall,Pinhole Punt,0,2,2,4
12591,2023-01-11,BYRON,knockout,Riverside,0,4,2,6
12592,2023-01-11,BYRON,gemGrab,Gem Fort,0,1,0,1
12593,2023-01-11,BYRON,brawlBall,Sunny Soccer,0,2,1,3
12594,2023-01-11,BYRON,bounty,Excel,0,2,0,2
12595,2023-01-10,BYRON,knockout,New Perspective,0,6,3,9
12596,2023-01-10,BYRON,hotZone,Dueling Beetles,0,5,9,14
12597,2023-01-10,BYRON,heist,Safe Zone,0,2,0,2
12598,2023-01-10,BYRON,gemGrab,Minecart Madness,0,7,5,12
12599,2023-01-10,BYRON,gemGrab,Crystal Arcade,0,11,30,41
12600,2023-01-10,BYRON,brawlBall,Center Stage,0,1,0,1
12601,2023-01-10,BYRON,brawlBall,Beach Ball,0,10,52,62
12602,2023-01-09,BYRON,knockout,New Perspective,0,1,1,2
12603,2023-01-09,BYRON,hotZone,Dueling Beetles,0,2,1,3
12604,2023-01-09,BYRON,gemGrab,Minecart Madness,0,20,13,33
12605,2023-01-09,BYRON,gemGrab,Double Swoosh,0,4,1,5
12606,2023-01-09,BYRON,brawlBall,Center Stage,1,6,3,10
12607,2023-01-09,BYRON,brawlBall,Backyard Bowl,0,1,1,2
12608,2023-01-09,BYRON,bounty,Layer Cake,0,10,24,34
12609,2023-01-08,BYRON,knockout,X Marks the Spot,0,6,14,20
12610,2023-01-08,BYRON,hotZone,Ring of Fire,0,3,0,3
12611,2023-01-08,BYRON,heist,Snaked Assault,0,1,0,1
12612,2023-01-08,BYRON,brawlBall,Super Beach,0,1,5,6
12613,2023-01-08,BYRON,brawlBall,Backyard Bowl,0,17,26,43
12614,2023-01-08,BYRON,bounty,Layer Cake,0,2,0,2
12615,2023-01-07,BYRON,knockout,X Marks the Spot,0,3,12,15
12616,2023-01-07,BYRON,gemGrab,Deep Diner,0,1,0,1
12617,2023-01-07,BYRON,brawlBall,Super Beach,0,3,20,23
12618,2023-01-07,BYRON,bounty,Dry Season,0,12,10,22
12619,2023-01-06,BYRON,knockout,Out in the Open,0,4,4,8
12620,2023-01-06,BYRON,gemGrab,Undermine,0,1,0,1
12621,2023-01-06,BYRON,gemGrab,Deep Diner,0,9,44,53
12622,2023-01-06,BYRON,brawlBall,Sneaky Fields,0,2,2,4
12623,2023-01-06,BYRON,brawlBall,Pinhole Punt,0,1,3,4
12624,2023-01-06,BYRON,bounty,Dry Season,0,15,16,31
12625,2023-01-05,BYRON,knockout,Out in the Open,0,8,7,15
12626,2023-01-05,BYRON,hotZone,Split,0,1,1,2
12627,2023-01-05,BYRON,heist,Kaboom Canyon,0,2,2,4
12628,2023-01-05,BYRON,gemGrab,Undermine,0,1,1,2
12629,2023-01-05,BYRON,gemGrab,Gem Fort,0,2,0,2
12630,2023-01-05,BYRON,brawlBall,Pinhole Punt,1,9,32,42
12631,2023-01-05,BYRON,bounty,Shooting Star,0,7,4,11
12632,2023-01-04,BYRON,knockout,Goldarm Gulch,0,2,0,2
12633,2023-01-04,BYRON,heist,Kaboom Canyon,0,7,12,19
12634,2023-01-04,BYRON,gemGrab,Crystal Arcade,0,1,0,1
12635,2023-01-04,BYRON,brawlBall,Sunny Soccer,0,3,7,10
12636,2023-01-04,BYRON,bounty,Shooting Star,0,32,41,73
12637,2023-01-03,BYRON,hotZone,Parallel Plays,0,2,11,13
12638,2023-01-03,BYRON,gemGrab,Crystal Arcade,0,1,0,1
12639,2023-01-03,BYRON,brawlBall,Beach Ball,0,4,3,7
12640,2023-01-03,BYRON,bounty,Hideout,0,24,27,51
12641,2023-01-02,BYRON,knockout,Belle's Rock,0,9,10,19
12642,2023-01-02,BYRON,hotZone,Quarter Pounder,1,4,13,18
12643,2023-01-02,BYRON,hotZone,Controller Chaos,0,0,1,1
12644,2023-01-02,BYRON,heist,Kaboom Canyon,0,0,1,1
12645,2023-01-02,BYRON,gemGrab,Minecart Madness,0,12,39,51
12646,2023-01-02,BYRON,gemGrab,Double Swoosh,0,3,0,3
12647,2023-01-02,BYRON,brawlBall,Center Stage,0,2,3,5
12648,2023-01-02,BYRON,brawlBall,Backyard Bowl,0,3,4,7
12649,2023-01-02,BYRON,bounty,Hideout,0,9,3,12
12650,2023-01-01,BYRON,knockout,Belle's Rock,0,7,2,9
12651,2023-01-01,BYRON,hotZone,Quarter Pounder,0,2,0,2
12652,2023-01-01,BYRON,heist,Bridge Too Far,0,5,0,5
12653,2023-01-01,BYRON,gemGrab,Minecart Madness,0,0,1,1
12654,2023-01-01,BYRON,brawlBall,Backyard Bowl,0,11,8,19
12655,2022-12-31,BYRON,heist,Bridge Too Far,0,2,1,3
12656,2022-12-31,BYRON,gemGrab,Minecart Madness,0,1,0,1
12657,2022-12-31,BYRON,gemGrab,Hard Rock Mine,0,3,14,17
12658,2022-12-31,BYRON,gemGrab,Deep Diner,0,0,2,2
12659,2022-12-31,BYRON,brawlBall,Super Beach,0,1,0,1
12660,2022-12-30,BYRON,gemGrab,Deep Diner,0,1,0,1
12661,2022-12-29,BYRON,brawlBall,Pinhole Punt,0,0,1,1
12662,2022-12-28,BYRON,hotZone,Open Zone,0,0,1,1
12663,2022-12-27,BYRON,hotZone,Dueling Beetles,0,1,0,1
12664,2022-12-27,BYRON,gemGrab,Minecart Madness,0,1,0,1
12665,2022-12-26,BYRON,gemGrab,Minecart Madness,0,0,1,1
12666,2022-12-25,BYRON,brawlBall,Backyard Bowl,0,0,1,1
12667,2022-12-23,BYRON,knockout,Out in the Open,0,1,0,1
12668,2022-12-13,BYRON,hotZone,Dueling Beetles,0,1,0,1
12669,2022-12-13,BYRON,heist,Safe Zone,0,0,1,1
12670,2022-12-10,BYRON,knockout,X Marks the Spot,0,0,1,1
12671,2022-11-07,BYRON,hotZone,Quarter Pounder,0,0,1,1
12672,2022-11-01,BYRON,knockout,New Perspective,0,0,3,3
12673,2022-10-26,BYRON,bounty,Shooting Star,0,1,0,1
12674,2022-10-15,BYRON,gemGrab,Hard Rock Mine,0,2,0,2
12675,2022-10-15,BYRON,brawlBall,Super Beach,0,0,1,1
12676,2022-10-10,BYRON,knockout,Belle's Rock,0,1,0,1
12677,2023-01-30,BUZZ,knockout,Belle's Rock,0,114,82,196
12678,2023-01-30,BUZZ,hotZone,Quarter Pounder,0,91,86,177
12679,2023-01-30,BUZZ,heist,Pit Stop,0,318,366,684
12680,2023-01-30,BUZZ,gemGrab,Minecart Madness,0,52,33,85
12681,2023-01-30,BUZZ,gemGrab,Double Swoosh,0,70,65,135
12682,2023-01-30,BUZZ,brawlBall,Center Stage,25,1120,1089,2234
12683,2023-01-30,BUZZ,brawlBall,Backyard Bowl,1,51,41,93
12684,2023-01-30,BUZZ,bounty,Hideout,0,13,5,18
12685,2023-01-29,BUZZ,knockout,Belle's Rock,0,111,58,169
12686,2023-01-29,BUZZ,hotZone,Quarter Pounder,0,51,28,79
12687,2023-01-29,BUZZ,heist,Bridge Too Far,0,40,62,102
12688,2023-01-29,BUZZ,gemGrab,Hard Rock Mine,0,32,62,94
12689,2023-01-29,BUZZ,gemGrab,Double Swoosh,0,130,102,232
12690,2023-01-29,BUZZ,brawlBall,Super Beach,1,22,27,50
12691,2023-01-29,BUZZ,brawlBall,Backyard Bowl,13,603,524,1140
12692,2023-01-29,BUZZ,bounty,Canal Grande,0,96,78,174
12693,2023-01-28,BUZZ,knockout,Flaring Phoenix,0,60,46,106
12694,2023-01-28,BUZZ,hotZone,Controller Chaos,0,66,51,117
12695,2023-01-28,BUZZ,heist,Bridge Too Far,0,100,109,209
12696,2023-01-28,BUZZ,gemGrab,Hard Rock Mine,0,174,224,398
12697,2023-01-28,BUZZ,gemGrab,Deep Diner,0,40,34,74
12698,2023-01-28,BUZZ,brawlBall,Super Beach,25,1454,1424,2903
12699,2023-01-28,BUZZ,brawlBall,Sneaky Fields,1,55,57,113
12700,2023-01-28,BUZZ,bounty,Canal Grande,0,138,119,257
12701,2023-01-27,BUZZ,knockout,Flaring Phoenix,0,31,27,58
12702,2023-01-27,BUZZ,hotZone,Controller Chaos,0,19,14,33
12703,2023-01-27,BUZZ,heist,Hot Potato,0,45,32,77
12704,2023-01-27,BUZZ,gemGrab,Undermine,0,8,5,13
12705,2023-01-27,BUZZ,gemGrab,Deep Diner,0,47,47,94
12706,2023-01-27,BUZZ,brawlBall,Sneaky Fields,7,525,473,1005
12707,2023-01-27,BUZZ,brawlBall,Pinhole Punt,0,8,7,15
12708,2023-01-27,BUZZ,bounty,Temple Ruins,0,13,7,20
12709,2023-01-26,BUZZ,knockout,Riverside,1,51,21,73
12710,2023-01-26,BUZZ,hotZone,Open Zone,0,21,18,39
12711,2023-01-26,BUZZ,heist,Hot Potato,1,159,208,368
12712,2023-01-26,BUZZ,gemGrab,Undermine,0,83,97,180
12713,2023-01-26,BUZZ,gemGrab,Gem Fort,0,55,75,130
12714,2023-01-26,BUZZ,brawlBall,Sunny Soccer,0,64,70,134
12715,2023-01-26,BUZZ,brawlBall,Pinhole Punt,19,996,943,1958
12716,2023-01-26,BUZZ,bounty,Temple Ruins,0,58,48,106
12717,2023-01-25,BUZZ,knockout,Riverside,0,32,11,43
12718,2023-01-25,BUZZ,hotZone,Open Zone,0,11,3,14
12719,2023-01-25,BUZZ,heist,Safe Zone,0,43,54,97
12720,2023-01-25,BUZZ,gemGrab,Gem Fort,0,49,38,87
12721,2023-01-25,BUZZ,gemGrab,Crystal Arcade,0,60,63,123
12722,2023-01-25,BUZZ,brawlBall,Sunny Soccer,19,824,833,1676
12723,2023-01-25,BUZZ,brawlBall,Beach Ball,8,126,128,262
12724,2023-01-25,BUZZ,bounty,Excel,0,35,51,86
12725,2023-01-24,BUZZ,knockout,New Perspective,0,54,46,100
12726,2023-01-24,BUZZ,hotZone,Dueling Beetles,0,44,37,81
12727,2023-01-24,BUZZ,heist,Safe Zone,0,99,79,178
12728,2023-01-24,BUZZ,gemGrab,Minecart Madness,0,16,18,34
12729,2023-01-24,BUZZ,gemGrab,Crystal Arcade,0,139,145,284
12730,2023-01-24,BUZZ,brawlBall,Center Stage,2,154,175,331
12731,2023-01-24,BUZZ,brawlBall,Beach Ball,25,1059,1053,2137
12732,2023-01-24,BUZZ,bounty,Excel,0,121,167,288
12733,2023-01-23,BUZZ,knockout,New Perspective,0,107,61,168
12734,2023-01-23,BUZZ,hotZone,Dueling Beetles,0,73,45,118
12735,2023-01-23,BUZZ,heist,Snaked Assault,0,129,143,272
12736,2023-01-23,BUZZ,gemGrab,Minecart Madness,0,77,54,131
12737,2023-01-23,BUZZ,gemGrab,Double Swoosh,0,70,48,118
12738,2023-01-23,BUZZ,brawlBall,Center Stage,50,2125,2249,4424
12739,2023-01-23,BUZZ,brawlBall,Backyard Bowl,1,28,24,53
12740,2023-01-23,BUZZ,bounty,Layer Cake,0,71,92,163
12741,2023-01-22,BUZZ,knockout,X Marks the Spot,0,34,25,59
12742,2023-01-22,BUZZ,hotZone,Ring of Fire,0,20,9,29
12743,2023-01-22,BUZZ,heist,Snaked Assault,0,79,59,138
12744,2023-01-22,BUZZ,gemGrab,Hard Rock Mine,0,36,23,59
12745,2023-01-22,BUZZ,gemGrab,Double Swoosh,0,111,57,168
12746,2023-01-22,BUZZ,brawlBall,Super Beach,5,137,111,253
12747,2023-01-22,BUZZ,brawlBall,Backyard Bowl,5,250,215,470
12748,2023-01-22,BUZZ,bounty,Layer Cake,0,53,42,95
12749,2023-01-21,BUZZ,knockout,X Marks the Spot,0,116,89,205
12750,2023-01-21,BUZZ,hotZone,Ring of Fire,0,56,29,85
12751,2023-01-21,BUZZ,heist,Tornado Ring,1,133,92,226
12752,2023-01-21,BUZZ,gemGrab,Hard Rock Mine,0,203,154,357
12753,2023-01-21,BUZZ,gemGrab,Deep Diner,0,32,36,68
12754,2023-01-21,BUZZ,brawlBall,Super Beach,40,1964,1798,3802
12755,2023-01-21,BUZZ,brawlBall,Sneaky Fields,0,66,58,124
12756,2023-01-21,BUZZ,bounty,Dry Season,0,33,39,72
12757,2023-01-20,BUZZ,knockout,Out in the Open,0,55,35,90
12758,2023-01-20,BUZZ,hotZone,Split,0,95,65,160
12759,2023-01-20,BUZZ,heist,Tornado Ring,2,139,185,326
12760,2023-01-20,BUZZ,gemGrab,Undermine,0,50,38,88
12761,2023-01-20,BUZZ,gemGrab,Deep Diner,0,151,105,256
12762,2023-01-20,BUZZ,brawlBall,Sneaky Fields,34,1604,1483,3121
12763,2023-01-20,BUZZ,brawlBall,Pinhole Punt,0,43,40,83
12764,2023-01-20,BUZZ,bounty,Dry Season,0,37,21,58
12765,2023-01-19,BUZZ,knockout,Out in the Open,0,87,68,155
12766,2023-01-19,BUZZ,hotZone,Split,0,135,115,250
12767,2023-01-19,BUZZ,heist,Kaboom Canyon,1,29,42,72
12768,2023-01-19,BUZZ,gemGrab,Undermine,0,124,132,256
12769,2023-01-19,BUZZ,gemGrab,Gem Fort,0,27,13,40
12770,2023-01-19,BUZZ,brawlBall,Sunny Soccer,0,36,36,72
12771,2023-01-19,BUZZ,brawlBall,Pinhole Punt,23,1035,950,2008
12772,2023-01-19,BUZZ,bounty,Shooting Star,0,19,11,30
12773,2023-01-18,BUZZ,knockout,Goldarm Gulch,0,13,6,19
12774,2023-01-18,BUZZ,hotZone,Parallel Plays,0,7,3,10
12775,2023-01-18,BUZZ,heist,Kaboom Canyon,0,15,14,29
12776,2023-01-18,BUZZ,gemGrab,Gem Fort,0,31,25,56
12777,2023-01-18,BUZZ,gemGrab,Crystal Arcade,0,10,5,15
12778,2023-01-18,BUZZ,brawlBall,Sunny Soccer,4,320,340,664
12779,2023-01-18,BUZZ,brawlBall,Beach Ball,0,20,24,44
12780,2023-01-18,BUZZ,bounty,Shooting Star,0,6,2,8
12781,2023-01-17,BUZZ,knockout,Goldarm Gulch,0,23,20,43
12782,2023-01-17,BUZZ,hotZone,Parallel Plays,0,19,9,28
12783,2023-01-17,BUZZ,heist,Pit Stop,0,34,35,69
12784,2023-01-17,BUZZ,gemGrab,Minecart Madness,0,0,1,1
12785,2023-01-17,BUZZ,gemGrab,Crystal Arcade,0,14,14,28
12786,2023-01-17,BUZZ,brawlBall,Center Stage,0,3,6,9
12787,2023-01-17,BUZZ,brawlBall,Beach Ball,4,107,105,216
12788,2023-01-16,BUZZ,knockout,Belle's Rock,0,7,5,12
12789,2023-01-16,BUZZ,hotZone,Quarter Pounder,0,9,10,19
12790,2023-01-16,BUZZ,heist,Pit Stop,0,118,131,249
12791,2023-01-16,BUZZ,gemGrab,Minecart Madness,0,4,3,7
12792,2023-01-16,BUZZ,gemGrab,Double Swoosh,0,14,12,26
12793,2023-01-16,BUZZ,brawlBall,Center Stage,3,120,102,225
12794,2023-01-16,BUZZ,brawlBall,Backyard Bowl,0,12,6,18
12795,2023-01-16,BUZZ,bounty,Hideout,0,3,0,3
12796,2023-01-15,BUZZ,knockout,Belle's Rock,0,16,7,23
12797,2023-01-15,BUZZ,hotZone,Quarter Pounder,0,22,19,41
12798,2023-01-15,BUZZ,heist,Bridge Too Far,0,15,11,26
12799,2023-01-15,BUZZ,gemGrab,Hard Rock Mine,0,8,10,18
12800,2023-01-15,BUZZ,gemGrab,Double Swoosh,0,16,12,28
12801,2023-01-15,BUZZ,brawlBall,Super Beach,0,15,17,32
12802,2023-01-15,BUZZ,brawlBall,Backyard Bowl,1,68,42,111
12803,2023-01-15,BUZZ,bounty,Canal Grande,0,11,8,19
12804,2023-01-14,BUZZ,knockout,Flaring Phoenix,0,0,1,1
12805,2023-01-14,BUZZ,hotZone,Controller Chaos,0,22,8,30
12806,2023-01-14,BUZZ,heist,Bridge Too Far,0,19,10,29
12807,2023-01-14,BUZZ,gemGrab,Hard Rock Mine,0,6,25,31
12808,2023-01-14,BUZZ,gemGrab,Deep Diner,0,2,3,5
12809,2023-01-14,BUZZ,brawlBall,Super Beach,3,96,99,198
12810,2023-01-14,BUZZ,brawlBall,Sneaky Fields,0,13,4,17
12811,2023-01-14,BUZZ,bounty,Canal Grande,0,16,11,27
12812,2023-01-13,BUZZ,knockout,Flaring Phoenix,0,11,4,15
12813,2023-01-13,BUZZ,hotZone,Controller Chaos,0,12,3,15
12814,2023-01-13,BUZZ,heist,Hot Potato,0,8,16,24
12815,2023-01-13,BUZZ,gemGrab,Deep Diner,0,25,21,46
12816,2023-01-13,BUZZ,brawlBall,Sneaky Fields,0,120,113,233
12817,2023-01-13,BUZZ,brawlBall,Pinhole Punt,1,0,0,1
12818,2023-01-13,BUZZ,bounty,Temple Ruins,0,2,4,6
12819,2023-01-12,BUZZ,knockout,Riverside,0,2,0,2
12820,2023-01-12,BUZZ,hotZone,Open Zone,0,2,0,2
12821,2023-01-12,BUZZ,heist,Hot Potato,0,3,1,4
12822,2023-01-12,BUZZ,gemGrab,Undermine,0,7,6,13
12823,2023-01-12,BUZZ,gemGrab,Gem Fort,0,1,0,1
12824,2023-01-12,BUZZ,brawlBall,Sunny Soccer,0,4,2,6
12825,2023-01-12,BUZZ,brawlBall,Pinhole Punt,0,38,63,101
12826,2023-01-12,BUZZ,bounty,Temple Ruins,0,1,0,1
12827,2023-01-11,BUZZ,knockout,Riverside,0,0,1,1
12828,2023-01-11,BUZZ,hotZone,Open Zone,0,1,1,2
12829,2023-01-11,BUZZ,gemGrab,Gem Fort,0,4,2,6
12830,2023-01-11,BUZZ,brawlBall,Sunny Soccer,0,36,26,62
12831,2023-01-11,BUZZ,brawlBall,Beach Ball,0,2,0,2
12832,2023-01-11,BUZZ,bounty,Excel,0,3,0,3
12833,2023-01-10,BUZZ,knockout,New Perspective,0,1,1,2
12834,2023-01-10,BUZZ,hotZone,Dueling Beetles,0,12,3,15
12835,2023-01-10,BUZZ,heist,Safe Zone,0,8,6,14
12836,2023-01-10,BUZZ,gemGrab,Minecart Madness,0,4,1,5
12837,2023-01-10,BUZZ,gemGrab,Crystal Arcade,0,14,26,40
12838,2023-01-10,BUZZ,brawlBall,Center Stage,1,11,2,14
12839,2023-01-10,BUZZ,brawlBall,Beach Ball,0,59,64,123
12840,2023-01-10,BUZZ,bounty,Excel,0,3,10,13
12841,2023-01-09,BUZZ,knockout,New Perspective,0,2,0,2
12842,2023-01-09,BUZZ,hotZone,Dueling Beetles,0,2,0,2
12843,2023-01-09,BUZZ,heist,Snaked Assault,0,16,31,47
12844,2023-01-09,BUZZ,gemGrab,Minecart Madness,0,10,6,16
12845,2023-01-09,BUZZ,gemGrab,Double Swoosh,0,11,1,12
12846,2023-01-09,BUZZ,brawlBall,Center Stage,4,136,99,239
12847,2023-01-09,BUZZ,brawlBall,Backyard Bowl,1,5,20,26
12848,2023-01-09,BUZZ,bounty,Layer Cake,0,6,8,14
12849,2023-01-08,BUZZ,knockout,X Marks the Spot,0,5,0,5
12850,2023-01-08,BUZZ,hotZone,Ring of Fire,0,3,2,5
12851,2023-01-08,BUZZ,heist,Snaked Assault,0,11,21,32
12852,2023-01-08,BUZZ,gemGrab,Hard Rock Mine,0,2,1,3
12853,2023-01-08,BUZZ,gemGrab,Double Swoosh,0,10,2,12
12854,2023-01-08,BUZZ,brawlBall,Super Beach,0,18,9,27
12855,2023-01-08,BUZZ,brawlBall,Backyard Bowl,1,37,37,75
12856,2023-01-08,BUZZ,bounty,Layer Cake,0,2,3,5
12857,2023-01-07,BUZZ,heist,Tornado Ring,0,20,37,57
12858,2023-01-07,BUZZ,gemGrab,Hard Rock Mine,0,8,2,10
12859,2023-01-07,BUZZ,gemGrab,Deep Diner,0,8,9,17
12860,2023-01-07,BUZZ,brawlBall,Super Beach,0,40,27,67
12861,2023-01-07,BUZZ,brawlBall,Sneaky Fields,0,4,3,7
12862,2023-01-07,BUZZ,bounty,Dry Season,0,4,3,7
12863,2023-01-06,BUZZ,knockout,Out in the Open,0,4,0,4
12864,2023-01-06,BUZZ,hotZone,Split,0,5,19,24
12865,2023-01-06,BUZZ,heist,Tornado Ring,0,35,23,58
12866,2023-01-06,BUZZ,gemGrab,Undermine,0,3,0,3
12867,2023-01-06,BUZZ,gemGrab,Deep Diner,0,10,7,17
12868,2023-01-06,BUZZ,brawlBall,Sneaky Fields,1,76,50,127
12869,2023-01-06,BUZZ,brawlBall,Pinhole Punt,0,4,15,19
12870,2023-01-06,BUZZ,bounty,Dry Season,0,2,1,3
12871,2023-01-05,BUZZ,knockout,Out in the Open,0,4,1,5
12872,2023-01-05,BUZZ,hotZone,Split,0,24,38,62
12873,2023-01-05,BUZZ,heist,Kaboom Canyon,0,5,0,5
12874,2023-01-05,BUZZ,gemGrab,Undermine,0,17,12,29
12875,2023-01-05,BUZZ,gemGrab,Gem Fort,0,1,1,2
12876,2023-01-05,BUZZ,brawlBall,Sunny Soccer,0,3,1,4
12877,2023-01-05,BUZZ,brawlBall,Pinhole Punt,0,91,45,136
12878,2023-01-04,BUZZ,knockout,Goldarm Gulch,0,3,0,3
12879,2023-01-04,BUZZ,hotZone,Parallel Plays,0,1,2,3
12880,2023-01-04,BUZZ,heist,Kaboom Canyon,0,10,4,14
12881,2023-01-04,BUZZ,gemGrab,Gem Fort,0,18,33,51
12882,2023-01-04,BUZZ,gemGrab,Crystal Arcade,0,6,5,11
12883,2023-01-04,BUZZ,brawlBall,Sunny Soccer,3,113,136,252
12884,2023-01-04,BUZZ,brawlBall,Beach Ball,0,1,5,6
12885,2023-01-04,BUZZ,bounty,Shooting Star,0,1,0,1
12886,2023-01-03,BUZZ,knockout,Goldarm Gulch,0,1,0,1
12887,2023-01-03,BUZZ,hotZone,Parallel Plays,0,14,20,34
12888,2023-01-03,BUZZ,hotZone,Controller Chaos,0,1,0,1
12889,2023-01-03,BUZZ,heist,Pit Stop,0,50,61,111
12890,2023-01-03,BUZZ,gemGrab,Minecart Madness,0,2,0,2
12891,2023-01-03,BUZZ,gemGrab,Crystal Arcade,0,15,20,35
12892,2023-01-03,BUZZ,brawlBall,Center Stage,0,4,2,6
12893,2023-01-03,BUZZ,brawlBall,Beach Ball,2,76,56,134
12894,2023-01-02,BUZZ,knockout,Belle's Rock,0,4,0,4
12895,2023-01-02,BUZZ,hotZone,Quarter Pounder,0,15,4,19
12896,2023-01-02,BUZZ,heist,Pit Stop,0,82,158,240
12897,2023-01-02,BUZZ,gemGrab,Minecart Madness,0,6,3,9
12898,2023-01-02,BUZZ,gemGrab,Double Swoosh,0,2,2,4
12899,2023-01-02,BUZZ,brawlBall,Center Stage,3,113,130,246
12900,2023-01-02,BUZZ,brawlBall,Backyard Bowl,0,3,0,3
12901,2023-01-02,BUZZ,bounty,Hideout,0,7,0,7
12902,2023-01-01,BUZZ,knockout,Belle's Rock,0,3,1,4
12903,2023-01-01,BUZZ,hotZone,Quarter Pounder,0,5,10,15
12904,2023-01-01,BUZZ,heist,Bridge Too Far,0,3,3,6
12905,2023-01-01,BUZZ,gemGrab,Double Swoosh,0,6,0,6
12906,2023-01-01,BUZZ,brawlBall,Backyard Bowl,0,15,1,16
12907,2023-01-01,BUZZ,bounty,Canal Grande,0,2,0,2
12908,2022-12-31,BUZZ,hotZone,Controller Chaos,0,4,6,10
12909,2022-12-31,BUZZ,heist,Bridge Too Far,0,1,1,2
12910,2022-12-31,BUZZ,gemGrab,Hard Rock Mine,0,5,0,5
12911,2022-12-31,BUZZ,gemGrab,Deep Diner,0,0,2,2
12912,2022-12-31,BUZZ,brawlBall,Super Beach,0,14,6,20
12913,2022-12-31,BUZZ,bounty,Canal Grande,0,2,0,2
12914,2022-12-30,BUZZ,hotZone,Controller Chaos,0,0,1,1
12915,2022-12-30,BUZZ,gemGrab,Minecart Madness,0,0,1,1
12916,2022-12-30,BUZZ,gemGrab,Deep Diner,0,3,2,5
12917,2022-12-30,BUZZ,brawlBall,Sneaky Fields,0,5,5,10
12918,2022-12-29,BUZZ,heist,Kaboom Canyon,0,1,0,1
12919,2022-12-29,BUZZ,brawlBall,Pinhole Punt,0,0,9,9
12920,2022-12-28,BUZZ,brawlBall,Sunny Soccer,0,0,1,1
12921,2022-12-27,BUZZ,hotZone,Controller Chaos,0,1,1,2
12922,2022-12-27,BUZZ,brawlBall,Center Stage,0,0,1,1
12923,2022-12-27,BUZZ,brawlBall,Beach Ball,0,3,1,4
12924,2022-12-27,BUZZ,bounty,Excel,0,3,1,4
12925,2022-12-26,BUZZ,hotZone,Controller Chaos,0,1,0,1
12926,2022-12-26,BUZZ,gemGrab,Minecart Madness,0,2,0,2
12927,2022-12-26,BUZZ,brawlBall,Center Stage,0,1,2,3
12928,2022-12-25,BUZZ,gemGrab,Double Swoosh,0,1,0,1
12929,2022-12-24,BUZZ,brawlBall,Super Beach,0,1,0,1
12930,2022-12-23,BUZZ,brawlBall,Sneaky Fields,0,0,1,1
12931,2022-12-22,BUZZ,brawlBall,Pinhole Punt,0,3,2,5
12932,2022-12-20,BUZZ,brawlBall,Beach Ball,0,4,4,8
12933,2022-12-19,BUZZ,brawlBall,Center Stage,0,1,1,2
12934,2022-12-11,BUZZ,brawlBall,Backyard Bowl,0,1,1,2
12935,2022-11-01,BUZZ,knockout,New Perspective,0,1,0,1
12936,2022-10-30,BUZZ,brawlBall,Beach Ball,0,1,0,1
12937,2022-10-15,BUZZ,gemGrab,Hard Rock Mine,0,1,1,2
12938,2022-10-10,BUZZ,knockout,Belle's Rock,0,0,1,1
12939,2023-01-30,BUSTER,knockout,Belle's Rock,0,16,12,28
12940,2023-01-30,BUSTER,hotZone,Quarter Pounder,0,54,87,141
12941,2023-01-30,BUSTER,heist,Pit Stop,0,5,1,6
12942,2023-01-30,BUSTER,gemGrab,Minecart Madness,0,13,26,39
12943,2023-01-30,BUSTER,gemGrab,Double Swoosh,0,63,66,129
12944,2023-01-30,BUSTER,brawlBall,Center Stage,5,224,232,461
12945,2023-01-30,BUSTER,brawlBall,Backyard Bowl,0,7,17,24
12946,2023-01-30,BUSTER,bounty,Hideout,0,1,1,2
12947,2023-01-29,BUSTER,knockout,Belle's Rock,0,22,19,41
12948,2023-01-29,BUSTER,hotZone,Quarter Pounder,0,64,83,147
12949,2023-01-29,BUSTER,heist,Bridge Too Far,0,2,6,8
12950,2023-01-29,BUSTER,gemGrab,Hard Rock Mine,0,14,9,23
12951,2023-01-29,BUSTER,gemGrab,Double Swoosh,0,94,139,233
12952,2023-01-29,BUSTER,brawlBall,Super Beach,0,9,18,27
12953,2023-01-29,BUSTER,brawlBall,Backyard Bowl,4,83,87,174
12954,2023-01-29,BUSTER,bounty,Canal Grande,0,20,17,37
12955,2023-01-28,BUSTER,knockout,Flaring Phoenix,0,24,31,55
12956,2023-01-28,BUSTER,hotZone,Controller Chaos,0,80,78,158
12957,2023-01-28,BUSTER,heist,Bridge Too Far,0,5,0,5
12958,2023-01-28,BUSTER,gemGrab,Hard Rock Mine,0,53,81,134
12959,2023-01-28,BUSTER,gemGrab,Deep Diner,0,16,12,28
12960,2023-01-28,BUSTER,brawlBall,Super Beach,8,328,344,680
12961,2023-01-28,BUSTER,brawlBall,Sneaky Fields,1,28,20,49
12962,2023-01-28,BUSTER,bounty,Canal Grande,0,70,76,146
12963,2023-01-27,BUSTER,knockout,Flaring Phoenix,0,18,18,36
12964,2023-01-27,BUSTER,hotZone,Controller Chaos,0,12,10,22
12965,2023-01-27,BUSTER,heist,Hot Potato,0,5,0,5
12966,2023-01-27,BUSTER,gemGrab,Undermine,0,4,7,11
12967,2023-01-27,BUSTER,gemGrab,Deep Diner,0,27,19,46
12968,2023-01-27,BUSTER,brawlBall,Sneaky Fields,3,107,120,230
12969,2023-01-27,BUSTER,brawlBall,Pinhole Punt,0,1,0,1
12970,2023-01-27,BUSTER,bounty,Temple Ruins,0,17,33,50
12971,2023-01-26,BUSTER,knockout,Riverside,0,18,4,22
12972,2023-01-26,BUSTER,hotZone,Open Zone,0,22,16,38
12973,2023-01-26,BUSTER,heist,Hot Potato,0,6,4,10
12974,2023-01-26,BUSTER,gemGrab,Undermine,0,64,62,126
12975,2023-01-26,BUSTER,gemGrab,Gem Fort,0,22,17,39
12976,2023-01-26,BUSTER,brawlBall,Sunny Soccer,0,8,5,13
12977,2023-01-26,BUSTER,brawlBall,Pinhole Punt,11,234,309,554
12978,2023-01-26,BUSTER,bounty,Temple Ruins,0,18,17,35
12979,2023-01-25,BUSTER,knockout,Riverside,0,1,4,5
12980,2023-01-25,BUSTER,hotZone,Open Zone,0,5,8,13
12981,2023-01-25,BUSTER,heist,Safe Zone,0,3,0,3
12982,2023-01-25,BUSTER,gemGrab,Gem Fort,0,23,29,52
12983,2023-01-25,BUSTER,gemGrab,Crystal Arcade,0,35,35,70
12984,2023-01-25,BUSTER,brawlBall,Sunny Soccer,2,203,242,447
12985,2023-01-25,BUSTER,brawlBall,Beach Ball,2,30,52,84
12986,2023-01-25,BUSTER,bounty,Excel,0,2,3,5
12987,2023-01-24,BUSTER,knockout,New Perspective,0,33,59,92
12988,2023-01-24,BUSTER,hotZone,Dueling Beetles,0,73,71,144
12989,2023-01-24,BUSTER,heist,Safe Zone,0,7,3,10
12990,2023-01-24,BUSTER,gemGrab,Minecart Madness,0,4,3,7
12991,2023-01-24,BUSTER,gemGrab,Crystal Arcade,0,68,61,129
12992,2023-01-24,BUSTER,brawlBall,Center Stage,3,62,49,114
12993,2023-01-24,BUSTER,brawlBall,Beach Ball,6,238,229,473
12994,2023-01-24,BUSTER,bounty,Excel,0,18,13,31
12995,2023-01-23,BUSTER,knockout,New Perspective,0,58,66,124
12996,2023-01-23,BUSTER,hotZone,Dueling Beetles,0,108,69,177
12997,2023-01-23,BUSTER,heist,Snaked Assault,0,6,1,7
12998,2023-01-23,BUSTER,gemGrab,Minecart Madness,0,53,35,88
12999,2023-01-23,BUSTER,gemGrab,Double Swoosh,0,37,34,71
13000,2023-01-23,BUSTER,brawlBall,Center Stage,11,511,542,1064
13001,2023-01-23,BUSTER,brawlBall,Backyard Bowl,0,1,4,5
13002,2023-01-23,BUSTER,bounty,Layer Cake,0,28,31,59
13003,2023-01-22,BUSTER,knockout,X Marks the Spot,0,25,10,35
13004,2023-01-22,BUSTER,hotZone,Ring of Fire,0,39,36,75
13005,2023-01-22,BUSTER,heist,Snaked Assault,0,4,0,4
13006,2023-01-22,BUSTER,gemGrab,Hard Rock Mine,0,13,13,26
13007,2023-01-22,BUSTER,gemGrab,Double Swoosh,0,54,52,106
13008,2023-01-22,BUSTER,brawlBall,Super Beach,0,26,26,52
13009,2023-01-22,BUSTER,brawlBall,Backyard Bowl,1,47,44,92
13010,2023-01-22,BUSTER,bounty,Layer Cake,0,11,19,30
13011,2023-01-21,BUSTER,knockout,X Marks the Spot,0,91,58,149
13012,2023-01-21,BUSTER,hotZone,Ring of Fire,0,126,97,223
13013,2023-01-21,BUSTER,heist,Tornado Ring,0,9,9,18
13014,2023-01-21,BUSTER,gemGrab,Hard Rock Mine,0,95,77,172
13015,2023-01-21,BUSTER,gemGrab,Deep Diner,0,12,15,27
13016,2023-01-21,BUSTER,brawlBall,Super Beach,15,518,564,1097
13017,2023-01-21,BUSTER,brawlBall,Sneaky Fields,0,20,15,35
13018,2023-01-21,BUSTER,bounty,Dry Season,0,13,6,19
13019,2023-01-20,BUSTER,knockout,Out in the Open,0,38,24,62
13020,2023-01-20,BUSTER,hotZone,Split,0,62,56,118
13021,2023-01-20,BUSTER,heist,Tornado Ring,0,9,2,11
13022,2023-01-20,BUSTER,gemGrab,Undermine,0,21,13,34
13023,2023-01-20,BUSTER,gemGrab,Deep Diner,0,71,79,150
13024,2023-01-20,BUSTER,brawlBall,Sneaky Fields,7,463,459,929
13025,2023-01-20,BUSTER,brawlBall,Pinhole Punt,0,12,10,22
13026,2023-01-20,BUSTER,bounty,Dry Season,0,6,6,12
13027,2023-01-19,BUSTER,knockout,Out in the Open,0,48,62,110
13028,2023-01-19,BUSTER,hotZone,Split,0,84,91,175
13029,2023-01-19,BUSTER,heist,Kaboom Canyon,0,4,3,7
13030,2023-01-19,BUSTER,gemGrab,Undermine,0,75,76,151
13031,2023-01-19,BUSTER,gemGrab,Gem Fort,0,16,22,38
13032,2023-01-19,BUSTER,brawlBall,Sunny Soccer,1,8,10,19
13033,2023-01-19,BUSTER,brawlBall,Pinhole Punt,4,303,370,677
13034,2023-01-19,BUSTER,bounty,Shooting Star,0,11,5,16
13035,2023-01-18,BUSTER,knockout,Goldarm Gulch,0,8,10,18
13036,2023-01-18,BUSTER,hotZone,Parallel Plays,0,12,9,21
13037,2023-01-18,BUSTER,heist,Kaboom Canyon,0,1,1,2
13038,2023-01-18,BUSTER,gemGrab,Gem Fort,0,15,45,60
13039,2023-01-18,BUSTER,gemGrab,Crystal Arcade,0,7,2,9
13040,2023-01-18,BUSTER,brawlBall,Sunny Soccer,4,84,126,214
13041,2023-01-18,BUSTER,brawlBall,Beach Ball,0,0,2,2
13042,2023-01-18,BUSTER,bounty,Shooting Star,0,3,0,3
13043,2023-01-17,BUSTER,knockout,Goldarm Gulch,0,13,25,38
13044,2023-01-17,BUSTER,hotZone,Parallel Plays,0,7,17,24
13045,2023-01-17,BUSTER,heist,Pit Stop,0,0,3,3
13046,2023-01-17,BUSTER,gemGrab,Minecart Madness,0,1,2,3
13047,2023-01-17,BUSTER,gemGrab,Crystal Arcade,0,12,14,26
13048,2023-01-17,BUSTER,brawlBall,Center Stage,1,3,9,13
13049,2023-01-17,BUSTER,brawlBall,Beach Ball,0,25,43,68
13050,2023-01-16,BUSTER,knockout,Belle's Rock,0,2,0,2
13051,2023-01-16,BUSTER,hotZone,Quarter Pounder,0,10,8,18
13052,2023-01-16,BUSTER,heist,Pit Stop,0,1,0,1
13053,2023-01-16,BUSTER,gemGrab,Minecart Madness,0,3,2,5
13054,2023-01-16,BUSTER,gemGrab,Double Swoosh,0,5,2,7
13055,2023-01-16,BUSTER,brawlBall,Center Stage,2,38,30,70
13056,2023-01-16,BUSTER,brawlBall,Backyard Bowl,0,2,1,3
13057,2023-01-16,BUSTER,bounty,Hideout,0,2,1,3
13058,2023-01-15,BUSTER,knockout,Belle's Rock,0,5,6,11
13059,2023-01-15,BUSTER,hotZone,Quarter Pounder,0,36,7,43
13060,2023-01-15,BUSTER,heist,Bridge Too Far,0,1,0,1
13061,2023-01-15,BUSTER,gemGrab,Hard Rock Mine,0,3,4,7
13062,2023-01-15,BUSTER,gemGrab,Double Swoosh,0,27,31,58
13063,2023-01-15,BUSTER,brawlBall,Super Beach,0,5,31,36
13064,2023-01-15,BUSTER,brawlBall,Backyard Bowl,0,27,29,56
13065,2023-01-15,BUSTER,bounty,Canal Grande,0,10,4,14
13066,2023-01-14,BUSTER,knockout,Flaring Phoenix,0,7,2,9
13067,2023-01-14,BUSTER,hotZone,Controller Chaos,0,45,22,67
13068,2023-01-14,BUSTER,heist,Bridge Too Far,0,2,0,2
13069,2023-01-14,BUSTER,gemGrab,Hard Rock Mine,0,8,8,16
13070,2023-01-14,BUSTER,gemGrab,Deep Diner,0,4,3,7
13071,2023-01-14,BUSTER,brawlBall,Super Beach,2,48,28,78
13072,2023-01-14,BUSTER,brawlBall,Sneaky Fields,1,15,19,35
13073,2023-01-14,BUSTER,bounty,Canal Grande,0,9,7,16
13074,2023-01-13,BUSTER,knockout,Flaring Phoenix,0,7,4,11
13075,2023-01-13,BUSTER,hotZone,Controller Chaos,0,55,107,162
13076,2023-01-13,BUSTER,gemGrab,Undermine,0,0,2,2
13077,2023-01-13,BUSTER,gemGrab,Deep Diner,0,6,13,19
13078,2023-01-13,BUSTER,brawlBall,Sneaky Fields,1,74,105,180
13079,2023-01-13,BUSTER,brawlBall,Pinhole Punt,0,2,2,4
13080,2023-01-13,BUSTER,bounty,Temple Ruins,0,1,2,3
13081,2023-01-12,BUSTER,knockout,Riverside,0,2,0,2
13082,2023-01-12,BUSTER,hotZone,Open Zone,0,10,6,16
13083,2023-01-12,BUSTER,gemGrab,Undermine,0,11,4,15
13084,2023-01-12,BUSTER,gemGrab,Gem Fort,0,7,9,16
13085,2023-01-12,BUSTER,brawlBall,Sunny Soccer,0,4,2,6
13086,2023-01-12,BUSTER,brawlBall,Pinhole Punt,0,32,34,66
13087,2023-01-12,BUSTER,bounty,Temple Ruins,0,1,0,1
13088,2023-01-11,BUSTER,hotZone,Open Zone,0,1,0,1
13089,2023-01-11,BUSTER,gemGrab,Gem Fort,0,20,7,27
13090,2023-01-11,BUSTER,brawlBall,Sunny Soccer,0,40,36,76
13091,2023-01-11,BUSTER,brawlBall,Beach Ball,0,1,0,1
13092,2023-01-11,BUSTER,bounty,Excel,0,1,1,2
13093,2023-01-10,BUSTER,knockout,New Perspective,0,4,1,5
13094,2023-01-10,BUSTER,hotZone,Dueling Beetles,0,50,66,116
13095,2023-01-10,BUSTER,heist,Safe Zone,0,2,0,2
13096,2023-01-10,BUSTER,gemGrab,Minecart Madness,0,5,4,9
13097,2023-01-10,BUSTER,gemGrab,Crystal Arcade,0,39,36,75
13098,2023-01-10,BUSTER,brawlBall,Center Stage,0,18,19,37
13099,2023-01-10,BUSTER,brawlBall,Beach Ball,0,106,100,206
13100,2023-01-10,BUSTER,bounty,Excel,0,4,1,5
13101,2023-01-09,BUSTER,knockout,New Perspective,0,16,2,18
13102,2023-01-09,BUSTER,hotZone,Dueling Beetles,0,41,34,75
13103,2023-01-09,BUSTER,heist,Snaked Assault,0,4,0,4
13104,2023-01-09,BUSTER,gemGrab,Minecart Madness,1,19,48,68
13105,2023-01-09,BUSTER,gemGrab,Double Swoosh,0,27,31,58
13106,2023-01-09,BUSTER,brawlBall,Center Stage,2,158,166,326
13107,2023-01-09,BUSTER,brawlBall,Backyard Bowl,0,1,0,1
13108,2023-01-09,BUSTER,bounty,Layer Cake,0,10,8,18
13109,2023-01-08,BUSTER,knockout,X Marks the Spot,0,20,26,46
13110,2023-01-08,BUSTER,hotZone,Ring of Fire,0,53,29,82
13111,2023-01-08,BUSTER,heist,Snaked Assault,0,0,1,1
13112,2023-01-08,BUSTER,gemGrab,Hard Rock Mine,0,10,6,16
13113,2023-01-08,BUSTER,gemGrab,Double Swoosh,0,27,5,32
13114,2023-01-08,BUSTER,brawlBall,Super Beach,0,12,24,36
13115,2023-01-08,BUSTER,brawlBall,Backyard Bowl,0,25,25,50
13116,2023-01-08,BUSTER,bounty,Layer Cake,0,4,6,10
13117,2023-01-07,BUSTER,knockout,X Marks the Spot,0,7,7,14
13118,2023-01-07,BUSTER,hotZone,Ring of Fire,0,34,33,67
13119,2023-01-07,BUSTER,heist,Tornado Ring,0,3,0,3
13120,2023-01-07,BUSTER,gemGrab,Hard Rock Mine,0,29,5,34
13121,2023-01-07,BUSTER,gemGrab,Deep Diner,0,15,9,24
13122,2023-01-07,BUSTER,brawlBall,Super Beach,1,58,64,123
13123,2023-01-07,BUSTER,brawlBall,Sneaky Fields,2,9,30,41
13124,2023-01-07,BUSTER,bounty,Dry Season,0,0,1,1
13125,2023-01-06,BUSTER,knockout,Out in the Open,0,10,6,16
13126,2023-01-06,BUSTER,hotZone,Split,0,37,65,102
13127,2023-01-06,BUSTER,heist,Tornado Ring,0,6,1,7
13128,2023-01-06,BUSTER,gemGrab,Undermine,0,17,8,25
13129,2023-01-06,BUSTER,gemGrab,Deep Diner,0,43,84,127
13130,2023-01-06,BUSTER,brawlBall,Sneaky Fields,2,148,103,253
13131,2023-01-06,BUSTER,brawlBall,Pinhole Punt,0,12,14,26
13132,2023-01-06,BUSTER,bounty,Dry Season,0,8,5,13
13133,2023-01-05,BUSTER,knockout,Out in the Open,0,23,8,31
13134,2023-01-05,BUSTER,hotZone,Split,0,94,108,202
13135,2023-01-05,BUSTER,heist,Kaboom Canyon,0,2,0,2
13136,2023-01-05,BUSTER,gemGrab,Undermine,0,53,28,81
13137,2023-01-05,BUSTER,gemGrab,Gem Fort,0,10,3,13
13138,2023-01-05,BUSTER,brawlBall,Sunny Soccer,0,2,4,6
13139,2023-01-05,BUSTER,brawlBall,Pinhole Punt,5,206,192,403
13140,2023-01-05,BUSTER,bounty,Shooting Star,0,1,0,1
13141,2023-01-04,BUSTER,knockout,Goldarm Gulch,0,5,9,14
13142,2023-01-04,BUSTER,hotZone,Parallel Plays,0,39,54,93
13143,2023-01-04,BUSTER,heist,Kaboom Canyon,0,4,1,5
13144,2023-01-04,BUSTER,gemGrab,Gem Fort,0,63,58,121
13145,2023-01-04,BUSTER,gemGrab,Crystal Arcade,0,9,2,11
13146,2023-01-04,BUSTER,brawlBall,Sunny Soccer,5,167,106,278
13147,2023-01-04,BUSTER,brawlBall,Beach Ball,0,3,0,3
13148,2023-01-04,BUSTER,bounty,Shooting Star,0,4,1,5
13149,2023-01-03,BUSTER,knockout,Goldarm Gulch,0,13,9,22
13150,2023-01-03,BUSTER,hotZone,Parallel Plays,0,67,40,107
13151,2023-01-03,BUSTER,hotZone,Controller Chaos,0,0,1,1
13152,2023-01-03,BUSTER,gemGrab,Minecart Madness,0,7,3,10
13153,2023-01-03,BUSTER,gemGrab,Crystal Arcade,0,76,108,184
13154,2023-01-03,BUSTER,brawlBall,Center Stage,0,9,0,9
13155,2023-01-03,BUSTER,brawlBall,Beach Ball,1,128,99,228
13156,2023-01-03,BUSTER,bounty,Hideout,0,4,2,6
13157,2023-01-02,BUSTER,knockout,Belle's Rock,0,5,0,5
13158,2023-01-02,BUSTER,hotZone,Quarter Pounder,0,52,85,137
13159,2023-01-02,BUSTER,hotZone,Controller Chaos,0,0,1,1
13160,2023-01-02,BUSTER,heist,Pit Stop,0,4,0,4
13161,2023-01-02,BUSTER,gemGrab,Minecart Madness,0,26,27,53
13162,2023-01-02,BUSTER,gemGrab,Double Swoosh,0,55,48,103
13163,2023-01-02,BUSTER,brawlBall,Center Stage,3,218,280,501
13164,2023-01-02,BUSTER,brawlBall,Backyard Bowl,1,3,2,6
13165,2023-01-02,BUSTER,bounty,Hideout,0,5,6,11
13166,2023-01-01,BUSTER,knockout,Belle's Rock,0,5,2,7
13167,2023-01-01,BUSTER,hotZone,Quarter Pounder,0,27,10,37
13168,2023-01-01,BUSTER,hotZone,Controller Chaos,0,1,0,1
13169,2023-01-01,BUSTER,heist,Bridge Too Far,0,1,4,5
13170,2023-01-01,BUSTER,gemGrab,Hard Rock Mine,0,1,1,2
13171,2023-01-01,BUSTER,gemGrab,Double Swoosh,0,36,56,92
13172,2023-01-01,BUSTER,brawlBall,Backyard Bowl,0,19,12,31
13173,2023-01-01,BUSTER,bounty,Canal Grande,0,5,9,14
13174,2022-12-31,BUSTER,knockout,Flaring Phoenix,0,0,1,1
13175,2022-12-31,BUSTER,hotZone,Controller Chaos,0,10,23,33
13176,2022-12-31,BUSTER,heist,Kaboom Canyon,0,0,1,1
13177,2022-12-31,BUSTER,gemGrab,Hard Rock Mine,0,7,14,21
13178,2022-12-31,BUSTER,gemGrab,Deep Diner,0,4,2,6
13179,2022-12-31,BUSTER,brawlBall,Super Beach,0,10,16,26
13180,2022-12-31,BUSTER,brawlBall,Sneaky Fields,0,1,1,2
13181,2022-12-30,BUSTER,knockout,Flaring Phoenix,0,1,1,2
13182,2022-12-30,BUSTER,hotZone,Controller Chaos,0,8,16,24
13183,2022-12-30,BUSTER,gemGrab,Undermine,0,5,0,5
13184,2022-12-30,BUSTER,gemGrab,Deep Diner,0,7,9,16
13185,2022-12-30,BUSTER,brawlBall,Sneaky Fields,0,5,11,16
13186,2022-12-29,BUSTER,hotZone,Open Zone,0,1,1,2
13187,2022-12-29,BUSTER,hotZone,Controller Chaos,0,0,1,1
13188,2022-12-29,BUSTER,gemGrab,Undermine,0,4,2,6
13189,2022-12-29,BUSTER,gemGrab,Gem Fort,0,1,1,2
13190,2022-12-29,BUSTER,brawlBall,Pinhole Punt,0,3,4,7
13191,2022-12-28,BUSTER,hotZone,Open Zone,0,1,0,1
13192,2022-12-28,BUSTER,brawlBall,Sunny Soccer,0,0,2,2
13193,2022-12-28,BUSTER,brawlBall,Beach Ball,0,0,1,1
13194,2022-12-27,BUSTER,heist,Kaboom Canyon,0,1,0,1
13195,2022-12-27,BUSTER,gemGrab,Minecart Madness,0,0,1,1
13196,2022-12-27,BUSTER,brawlBall,Center Stage,0,2,2,4
13197,2022-12-27,BUSTER,brawlBall,Beach Ball,0,4,12,16
13198,2022-12-26,BUSTER,brawlBall,Center Stage,0,3,4,7
13199,2022-12-25,BUSTER,hotZone,Ring of Fire,0,0,2,2
13200,2022-12-25,BUSTER,bounty,Layer Cake,0,1,1,2
13201,2022-12-24,BUSTER,brawlBall,Super Beach,0,1,1,2
13202,2022-12-23,BUSTER,knockout,Out in the Open,0,3,0,3
13203,2022-12-23,BUSTER,gemGrab,Deep Diner,0,0,1,1
13204,2022-12-23,BUSTER,brawlBall,Sneaky Fields,0,1,0,1
13205,2022-12-22,BUSTER,gemGrab,Gem Fort,0,1,0,1
13206,2022-12-22,BUSTER,brawlBall,Pinhole Punt,0,2,5,7
13207,2022-12-21,BUSTER,brawlBall,Sunny Soccer,0,1,5,6
13208,2022-12-20,BUSTER,brawlBall,Beach Ball,0,0,1,1
13209,2022-12-19,BUSTER,brawlBall,Center Stage,0,1,2,3
13210,2022-12-16,BUSTER,hotZone,Controller Chaos,0,0,1,1
13211,2022-12-16,BUSTER,brawlBall,Sneaky Fields,0,8,9,17
13212,2022-12-16,BUSTER,bounty,Temple Ruins,0,0,4,4
13213,2022-12-13,BUSTER,knockout,New Perspective,0,2,0,2
13214,2022-12-13,BUSTER,hotZone,Dueling Beetles,0,0,1,1
13215,2022-12-13,BUSTER,gemGrab,Crystal Arcade,0,3,8,11
13216,2022-12-11,BUSTER,brawlBall,Backyard Bowl,0,3,2,5
13217,2022-12-10,BUSTER,gemGrab,Hard Rock Mine,0,1,1,2
13218,2022-11-11,BUSTER,brawlBall,Sneaky Fields,0,1,0,1
13219,2022-11-07,BUSTER,hotZone,Quarter Pounder,0,0,1,1
13220,2023-01-30,BULL,knockout,Belle's Rock,0,15,9,24
13221,2023-01-30,BULL,hotZone,Quarter Pounder,0,15,5,20
13222,2023-01-30,BULL,heist,Pit Stop,0,708,855,1563
13223,2023-01-30,BULL,gemGrab,Minecart Madness,0,26,18,44
13224,2023-01-30,BULL,gemGrab,Double Swoosh,0,30,10,40
13225,2023-01-30,BULL,brawlBall,Center Stage,16,632,627,1275
13226,2023-01-30,BULL,brawlBall,Backyard Bowl,0,33,30,63
13227,2023-01-30,BULL,bounty,Hideout,0,4,3,7
13228,2023-01-29,BULL,knockout,Belle's Rock,0,17,19,36
13229,2023-01-29,BULL,hotZone,Quarter Pounder,0,13,6,19
13230,2023-01-29,BULL,heist,Bridge Too Far,0,22,20,42
13231,2023-01-29,BULL,gemGrab,Hard Rock Mine,0,19,21,40
13232,2023-01-29,BULL,gemGrab,Double Swoosh,0,61,46,107
13233,2023-01-29,BULL,brawlBall,Super Beach,1,15,6,22
13234,2023-01-29,BULL,brawlBall,Backyard Bowl,5,211,196,412
13235,2023-01-29,BULL,bounty,Canal Grande,0,11,22,33
13236,2023-01-28,BULL,knockout,Flaring Phoenix,0,9,14,23
13237,2023-01-28,BULL,hotZone,Controller Chaos,0,16,9,25
13238,2023-01-28,BULL,heist,Bridge Too Far,0,41,48,89
13239,2023-01-28,BULL,gemGrab,Hard Rock Mine,0,77,69,146
13240,2023-01-28,BULL,gemGrab,Deep Diner,0,7,5,12
13241,2023-01-28,BULL,brawlBall,Super Beach,16,700,735,1451
13242,2023-01-28,BULL,brawlBall,Sneaky Fields,2,44,40,86
13243,2023-01-28,BULL,bounty,Canal Grande,0,31,45,76
13244,2023-01-27,BULL,knockout,Flaring Phoenix,0,6,3,9
13245,2023-01-27,BULL,hotZone,Controller Chaos,0,4,5,9
13246,2023-01-27,BULL,heist,Hot Potato,0,71,75,146
13247,2023-01-27,BULL,gemGrab,Undermine,0,1,1,2
13248,2023-01-27,BULL,gemGrab,Deep Diner,0,20,6,26
13249,2023-01-27,BULL,brawlBall,Sneaky Fields,7,376,357,740
13250,2023-01-27,BULL,brawlBall,Pinhole Punt,0,1,3,4
13251,2023-01-27,BULL,bounty,Temple Ruins,0,3,1,4
13252,2023-01-26,BULL,knockout,Riverside,0,9,4,13
13253,2023-01-26,BULL,hotZone,Open Zone,0,9,8,17
13254,2023-01-26,BULL,heist,Hot Potato,2,519,511,1032
13255,2023-01-26,BULL,gemGrab,Undermine,0,60,61,121
13256,2023-01-26,BULL,gemGrab,Gem Fort,0,26,18,44
13257,2023-01-26,BULL,brawlBall,Sunny Soccer,0,33,29,62
13258,2023-01-26,BULL,brawlBall,Pinhole Punt,4,412,455,871
13259,2023-01-26,BULL,bounty,Temple Ruins,0,8,9,17
13260,2023-01-25,BULL,knockout,Riverside,0,13,5,18
13261,2023-01-25,BULL,hotZone,Open Zone,0,5,1,6
13262,2023-01-25,BULL,heist,Safe Zone,0,39,32,71
13263,2023-01-25,BULL,gemGrab,Gem Fort,0,29,38,67
13264,2023-01-25,BULL,gemGrab,Crystal Arcade,0,16,9,25
13265,2023-01-25,BULL,brawlBall,Sunny Soccer,7,342,328,677
13266,2023-01-25,BULL,brawlBall,Beach Ball,2,53,68,123
13267,2023-01-25,BULL,bounty,Excel,0,7,24,31
13268,2023-01-24,BULL,knockout,New Perspective,0,13,14,27
13269,2023-01-24,BULL,hotZone,Dueling Beetles,0,10,2,12
13270,2023-01-24,BULL,heist,Safe Zone,0,56,64,120
13271,2023-01-24,BULL,gemGrab,Minecart Madness,0,7,4,11
13272,2023-01-24,BULL,gemGrab,Crystal Arcade,0,45,36,81
13273,2023-01-24,BULL,brawlBall,Center Stage,4,145,170,319
13274,2023-01-24,BULL,brawlBall,Beach Ball,13,490,461,964
13275,2023-01-24,BULL,bounty,Excel,0,14,10,24
13276,2023-01-23,BULL,knockout,New Perspective,0,24,5,29
13277,2023-01-23,BULL,hotZone,Dueling Beetles,0,15,2,17
13278,2023-01-23,BULL,heist,Snaked Assault,0,330,348,678
13279,2023-01-23,BULL,gemGrab,Minecart Madness,0,43,23,66
13280,2023-01-23,BULL,gemGrab,Double Swoosh,0,20,19,39
13281,2023-01-23,BULL,brawlBall,Center Stage,34,1483,1652,3169
13282,2023-01-23,BULL,brawlBall,Backyard Bowl,0,17,7,24
13283,2023-01-23,BULL,bounty,Layer Cake,0,11,6,17
13284,2023-01-22,BULL,knockout,X Marks the Spot,0,2,1,3
13285,2023-01-22,BULL,hotZone,Ring of Fire,0,6,5,11
13286,2023-01-22,BULL,heist,Snaked Assault,0,220,175,395
13287,2023-01-22,BULL,gemGrab,Hard Rock Mine,0,35,35,70
13288,2023-01-22,BULL,gemGrab,Double Swoosh,0,47,39,86
13289,2023-01-22,BULL,brawlBall,Super Beach,2,57,58,117
13290,2023-01-22,BULL,brawlBall,Backyard Bowl,3,92,77,172
13291,2023-01-22,BULL,bounty,Layer Cake,0,17,23,40
13292,2023-01-21,BULL,knockout,X Marks the Spot,0,17,13,30
13293,2023-01-21,BULL,hotZone,Ring of Fire,0,15,5,20
13294,2023-01-21,BULL,heist,Tornado Ring,2,412,499,913
13295,2023-01-21,BULL,gemGrab,Hard Rock Mine,0,128,128,256
13296,2023-01-21,BULL,gemGrab,Deep Diner,0,17,21,38
13297,2023-01-21,BULL,brawlBall,Super Beach,25,949,949,1923
13298,2023-01-21,BULL,brawlBall,Sneaky Fields,0,82,87,169
13299,2023-01-21,BULL,bounty,Dry Season,0,7,2,9
13300,2023-01-20,BULL,knockout,Out in the Open,0,18,3,21
13301,2023-01-20,BULL,hotZone,Split,0,41,40,81
13302,2023-01-20,BULL,heist,Tornado Ring,4,425,446,875
13303,2023-01-20,BULL,gemGrab,Undermine,0,24,17,41
13304,2023-01-20,BULL,gemGrab,Deep Diner,0,42,47,89
13305,2023-01-20,BULL,brawlBall,Sneaky Fields,17,1238,1279,2534
13306,2023-01-20,BULL,brawlBall,Pinhole Punt,0,17,24,41
13307,2023-01-20,BULL,bounty,Dry Season,0,4,5,9
13308,2023-01-19,BULL,knockout,Out in the Open,0,27,22,49
13309,2023-01-19,BULL,hotZone,Split,0,85,49,134
13310,2023-01-19,BULL,heist,Kaboom Canyon,1,45,38,84
13311,2023-01-19,BULL,gemGrab,Undermine,0,96,80,176
13312,2023-01-19,BULL,gemGrab,Gem Fort,0,22,31,53
13313,2023-01-19,BULL,brawlBall,Sunny Soccer,0,30,40,70
13314,2023-01-19,BULL,brawlBall,Pinhole Punt,9,531,529,1069
13315,2023-01-19,BULL,bounty,Shooting Star,0,3,3,6
13316,2023-01-18,BULL,knockout,Goldarm Gulch,0,5,3,8
13317,2023-01-18,BULL,hotZone,Parallel Plays,0,3,2,5
13318,2023-01-18,BULL,heist,Kaboom Canyon,0,14,8,22
13319,2023-01-18,BULL,gemGrab,Gem Fort,0,25,19,44
13320,2023-01-18,BULL,gemGrab,Crystal Arcade,0,3,8,11
13321,2023-01-18,BULL,brawlBall,Sunny Soccer,6,201,214,421
13322,2023-01-18,BULL,brawlBall,Beach Ball,0,6,6,12
13323,2023-01-18,BULL,bounty,Shooting Star,0,1,5,6
13324,2023-01-17,BULL,knockout,Goldarm Gulch,0,6,2,8
13325,2023-01-17,BULL,hotZone,Parallel Plays,0,1,2,3
13326,2023-01-17,BULL,heist,Pit Stop,0,55,60,115
13327,2023-01-17,BULL,gemGrab,Crystal Arcade,0,1,3,4
13328,2023-01-17,BULL,brawlBall,Center Stage,0,11,6,17
13329,2023-01-17,BULL,brawlBall,Beach Ball,0,63,77,140
13330,2023-01-17,BULL,bounty,Hideout,0,2,3,5
13331,2023-01-16,BULL,knockout,Belle's Rock,0,0,2,2
13332,2023-01-16,BULL,hotZone,Quarter Pounder,0,3,0,3
13333,2023-01-16,BULL,heist,Pit Stop,0,284,251,535
13334,2023-01-16,BULL,gemGrab,Minecart Madness,0,2,4,6
13335,2023-01-16,BULL,gemGrab,Double Swoosh,0,2,1,3
13336,2023-01-16,BULL,brawlBall,Center Stage,2,100,109,211
13337,2023-01-16,BULL,brawlBall,Backyard Bowl,0,1,1,2
13338,2023-01-15,BULL,knockout,Belle's Rock,0,1,0,1
13339,2023-01-15,BULL,hotZone,Quarter Pounder,0,5,13,18
13340,2023-01-15,BULL,heist,Bridge Too Far,0,6,0,6
13341,2023-01-15,BULL,gemGrab,Hard Rock Mine,0,5,0,5
13342,2023-01-15,BULL,gemGrab,Double Swoosh,0,7,9,16
13343,2023-01-15,BULL,brawlBall,Super Beach,0,9,5,14
13344,2023-01-15,BULL,brawlBall,Backyard Bowl,0,22,20,42
13345,2023-01-15,BULL,bounty,Canal Grande,0,3,2,5
13346,2023-01-14,BULL,knockout,Flaring Phoenix,0,3,0,3
13347,2023-01-14,BULL,hotZone,Controller Chaos,0,6,1,7
13348,2023-01-14,BULL,heist,Bridge Too Far,0,6,1,7
13349,2023-01-14,BULL,gemGrab,Hard Rock Mine,0,2,1,3
13350,2023-01-14,BULL,gemGrab,Deep Diner,0,1,0,1
13351,2023-01-14,BULL,brawlBall,Super Beach,1,33,45,79
13352,2023-01-14,BULL,brawlBall,Sneaky Fields,0,12,3,15
13353,2023-01-13,BULL,hotZone,Controller Chaos,0,1,1,2
13354,2023-01-13,BULL,heist,Hot Potato,0,8,20,28
13355,2023-01-13,BULL,gemGrab,Deep Diner,0,3,8,11
13356,2023-01-13,BULL,brawlBall,Sneaky Fields,2,86,56,144
13357,2023-01-12,BULL,knockout,Riverside,0,2,4,6
13358,2023-01-12,BULL,hotZone,Open Zone,0,1,0,1
13359,2023-01-12,BULL,heist,Hot Potato,0,8,7,15
13360,2023-01-12,BULL,gemGrab,Undermine,0,0,1,1
13361,2023-01-12,BULL,gemGrab,Gem Fort,0,1,0,1
13362,2023-01-12,BULL,brawlBall,Sunny Soccer,0,1,0,1
13363,2023-01-12,BULL,brawlBall,Pinhole Punt,0,12,11,23
13364,2023-01-11,BULL,heist,Safe Zone,0,1,0,1
13365,2023-01-11,BULL,gemGrab,Gem Fort,0,2,0,2
13366,2023-01-11,BULL,brawlBall,Sunny Soccer,0,6,4,10
13367,2023-01-11,BULL,bounty,Excel,0,1,0,1
13368,2023-01-10,BULL,hotZone,Dueling Beetles,0,1,0,1
13369,2023-01-10,BULL,heist,Safe Zone,0,3,2,5
13370,2023-01-10,BULL,gemGrab,Minecart Madness,0,1,0,1
13371,2023-01-10,BULL,gemGrab,Crystal Arcade,0,5,2,7
13372,2023-01-10,BULL,brawlBall,Center Stage,0,5,4,9
13373,2023-01-10,BULL,brawlBall,Beach Ball,0,22,6,28
13374,2023-01-10,BULL,bounty,Excel,0,1,0,1
13375,2023-01-09,BULL,hotZone,Dueling Beetles,0,4,1,5
13376,2023-01-09,BULL,heist,Snaked Assault,0,40,40,80
13377,2023-01-09,BULL,gemGrab,Minecart Madness,0,2,0,2
13378,2023-01-09,BULL,gemGrab,Double Swoosh,0,3,0,3
13379,2023-01-09,BULL,brawlBall,Center Stage,0,45,43,88
13380,2023-01-09,BULL,brawlBall,Backyard Bowl,0,1,0,1
13381,2023-01-09,BULL,bounty,Layer Cake,0,4,2,6
13382,2023-01-08,BULL,knockout,X Marks the Spot,0,1,1,2
13383,2023-01-08,BULL,hotZone,Ring of Fire,0,2,0,2
13384,2023-01-08,BULL,heist,Snaked Assault,0,30,36,66
13385,2023-01-08,BULL,gemGrab,Hard Rock Mine,0,3,1,4
13386,2023-01-08,BULL,gemGrab,Double Swoosh,0,2,1,3
13387,2023-01-08,BULL,brawlBall,Super Beach,0,3,0,3
13388,2023-01-08,BULL,brawlBall,Backyard Bowl,0,10,5,15
13389,2023-01-08,BULL,bounty,Layer Cake,0,1,1,2
13390,2023-01-07,BULL,hotZone,Ring of Fire,0,1,0,1
13391,2023-01-07,BULL,heist,Tornado Ring,0,37,35,72
13392,2023-01-07,BULL,gemGrab,Hard Rock Mine,0,6,2,8
13393,2023-01-07,BULL,gemGrab,Deep Diner,0,2,0,2
13394,2023-01-07,BULL,brawlBall,Super Beach,0,11,5,16
13395,2023-01-07,BULL,brawlBall,Sneaky Fields,0,2,2,4
13396,2023-01-07,BULL,bounty,Dry Season,0,2,1,3
13397,2023-01-06,BULL,hotZone,Split,0,6,3,9
13398,2023-01-06,BULL,heist,Tornado Ring,0,77,114,191
13399,2023-01-06,BULL,gemGrab,Undermine,0,1,0,1
13400,2023-01-06,BULL,gemGrab,Deep Diner,0,4,0,4
13401,2023-01-06,BULL,brawlBall,Sneaky Fields,1,54,75,130
13402,2023-01-06,BULL,brawlBall,Pinhole Punt,0,3,6,9
13403,2023-01-06,BULL,bounty,Dry Season,0,1,0,1
13404,2023-01-05,BULL,knockout,Out in the Open,0,1,0,1
13405,2023-01-05,BULL,hotZone,Split,0,18,11,29
13406,2023-01-05,BULL,heist,Kaboom Canyon,0,2,1,3
13407,2023-01-05,BULL,gemGrab,Undermine,0,1,2,3
13408,2023-01-05,BULL,gemGrab,Gem Fort,0,4,6,10
13409,2023-01-05,BULL,brawlBall,Sunny Soccer,0,1,2,3
13410,2023-01-05,BULL,brawlBall,Pinhole Punt,0,35,16,51
13411,2023-01-05,BULL,bounty,Shooting Star,0,1,0,1
13412,2023-01-04,BULL,hotZone,Parallel Plays,0,2,3,5
13413,2023-01-04,BULL,heist,Kaboom Canyon,0,13,10,23
13414,2023-01-04,BULL,gemGrab,Gem Fort,0,3,0,3
13415,2023-01-04,BULL,gemGrab,Crystal Arcade,0,1,1,2
13416,2023-01-04,BULL,brawlBall,Sunny Soccer,0,32,15,47
13417,2023-01-03,BULL,hotZone,Parallel Plays,0,1,0,1
13418,2023-01-03,BULL,heist,Pit Stop,1,126,138,265
13419,2023-01-03,BULL,gemGrab,Minecart Madness,0,1,1,2
13420,2023-01-03,BULL,gemGrab,Crystal Arcade,0,4,0,4
13421,2023-01-03,BULL,brawlBall,Center Stage,0,2,1,3
13422,2023-01-03,BULL,brawlBall,Beach Ball,0,9,18,27
13423,2023-01-03,BULL,bounty,Hideout,0,2,1,3
13424,2023-01-02,BULL,knockout,Belle's Rock,0,1,0,1
13425,2023-01-02,BULL,hotZone,Quarter Pounder,0,2,0,2
13426,2023-01-02,BULL,heist,Pit Stop,2,187,166,355
13427,2023-01-02,BULL,gemGrab,Minecart Madness,0,5,3,8
13428,2023-01-02,BULL,gemGrab,Double Swoosh,0,4,1,5
13429,2023-01-02,BULL,brawlBall,Center Stage,1,77,63,141
13430,2023-01-02,BULL,brawlBall,Backyard Bowl,0,3,2,5
13431,2023-01-02,BULL,bounty,Hideout,0,0,1,1
13432,2023-01-01,BULL,hotZone,Quarter Pounder,0,1,1,2
13433,2023-01-01,BULL,heist,Bridge Too Far,0,2,0,2
13434,2023-01-01,BULL,gemGrab,Double Swoosh,0,3,1,4
13435,2023-01-01,BULL,brawlBall,Backyard Bowl,0,5,3,8
13436,2023-01-01,BULL,bounty,Canal Grande,0,0,1,1
13437,2022-12-31,BULL,hotZone,Controller Chaos,0,1,0,1
13438,2022-12-31,BULL,heist,Bridge Too Far,0,0,1,1
13439,2022-12-31,BULL,brawlBall,Super Beach,0,5,2,7
13440,2022-12-31,BULL,brawlBall,Sneaky Fields,0,4,3,7
13441,2022-12-30,BULL,heist,Hot Potato,0,0,2,2
13442,2022-12-30,BULL,gemGrab,Undermine,0,1,0,1
13443,2022-12-30,BULL,brawlBall,Sneaky Fields,0,2,2,4
13444,2022-12-29,BULL,heist,Hot Potato,0,5,9,14
13445,2022-12-29,BULL,gemGrab,Gem Fort,0,0,1,1
13446,2022-12-27,BULL,gemGrab,Minecart Madness,0,1,0,1
13447,2022-12-27,BULL,brawlBall,Beach Ball,0,1,0,1
13448,2022-12-26,BULL,hotZone,Controller Chaos,0,0,1,1
13449,2022-12-23,BULL,knockout,Out in the Open,0,0,1,1
13450,2022-12-22,BULL,brawlBall,Pinhole Punt,0,0,1,1
13451,2022-12-19,BULL,brawlBall,Center Stage,0,1,1,2
13452,2022-12-13,BULL,hotZone,Dueling Beetles,0,1,0,1
13453,2022-10-30,BULL,heist,Safe Zone,0,0,1,1
13454,2022-10-30,BULL,brawlBall,Beach Ball,0,0,2,2
13455,2022-10-28,BULL,hotZone,Dueling Beetles,0,1,0,1
13456,2022-10-15,BULL,gemGrab,Hard Rock Mine,0,0,1,1
13457,2022-10-15,BULL,brawlBall,Super Beach,0,0,1,1
13458,2023-01-30,BROCK,knockout,Belle's Rock,0,719,673,1392
13459,2023-01-30,BROCK,hotZone,Quarter Pounder,0,76,18,94
13460,2023-01-30,BROCK,heist,Pit Stop,0,69,25,94
13461,2023-01-30,BROCK,gemGrab,Minecart Madness,0,161,88,249
13462,2023-01-30,BROCK,gemGrab,Double Swoosh,0,92,59,151
13463,2023-01-30,BROCK,brawlBall,Center Stage,10,236,180,426
13464,2023-01-30,BROCK,brawlBall,Backyard Bowl,7,97,118,222
13465,2023-01-30,BROCK,bounty,Hideout,0,184,151,335
13466,2023-01-29,BROCK,knockout,Belle's Rock,0,681,588,1269
13467,2023-01-29,BROCK,hotZone,Quarter Pounder,0,50,33,83
13468,2023-01-29,BROCK,heist,Bridge Too Far,3,434,339,776
13469,2023-01-29,BROCK,gemGrab,Hard Rock Mine,0,13,9,22
13470,2023-01-29,BROCK,gemGrab,Double Swoosh,0,116,89,205
13471,2023-01-29,BROCK,brawlBall,Super Beach,0,3,3,6
13472,2023-01-29,BROCK,brawlBall,Backyard Bowl,31,995,964,1990
13473,2023-01-29,BROCK,bounty,Canal Grande,0,135,129,264
13474,2023-01-28,BROCK,knockout,Flaring Phoenix,1,243,192,436
13475,2023-01-28,BROCK,hotZone,Controller Chaos,0,28,5,33
13476,2023-01-28,BROCK,heist,Bridge Too Far,5,882,751,1638
13477,2023-01-28,BROCK,gemGrab,Hard Rock Mine,0,102,55,157
13478,2023-01-28,BROCK,gemGrab,Deep Diner,0,48,23,71
13479,2023-01-28,BROCK,brawlBall,Super Beach,9,282,209,500
13480,2023-01-28,BROCK,brawlBall,Sneaky Fields,0,5,4,9
13481,2023-01-28,BROCK,bounty,Canal Grande,0,229,178,407
13482,2023-01-27,BROCK,knockout,Flaring Phoenix,0,96,72,168
13483,2023-01-27,BROCK,hotZone,Controller Chaos,0,11,3,14
13484,2023-01-27,BROCK,heist,Hot Potato,0,77,35,112
13485,2023-01-27,BROCK,gemGrab,Undermine,0,9,7,16
13486,2023-01-27,BROCK,gemGrab,Deep Diner,0,71,41,112
13487,2023-01-27,BROCK,brawlBall,Sneaky Fields,1,55,36,92
13488,2023-01-27,BROCK,brawlBall,Pinhole Punt,1,2,1,4
13489,2023-01-27,BROCK,bounty,Temple Ruins,0,41,24,65
13490,2023-01-26,BROCK,knockout,Riverside,1,621,409,1031
13491,2023-01-26,BROCK,hotZone,Open Zone,0,53,25,78
13492,2023-01-26,BROCK,heist,Hot Potato,0,127,87,214
13493,2023-01-26,BROCK,gemGrab,Undermine,0,90,48,138
13494,2023-01-26,BROCK,gemGrab,Gem Fort,0,17,27,44
13495,2023-01-26,BROCK,brawlBall,Sunny Soccer,0,5,2,7
13496,2023-01-26,BROCK,brawlBall,Pinhole Punt,6,343,252,601
13497,2023-01-26,BROCK,bounty,Temple Ruins,0,103,60,163
13498,2023-01-25,BROCK,knockout,Riverside,0,319,242,561
13499,2023-01-25,BROCK,hotZone,Open Zone,0,28,8,36
13500,2023-01-25,BROCK,heist,Safe Zone,2,486,461,949
13501,2023-01-25,BROCK,gemGrab,Gem Fort,0,29,34,63
13502,2023-01-25,BROCK,gemGrab,Crystal Arcade,0,51,29,80
13503,2023-01-25,BROCK,brawlBall,Sunny Soccer,3,127,122,252
13504,2023-01-25,BROCK,brawlBall,Beach Ball,0,31,33,64
13505,2023-01-25,BROCK,bounty,Excel,0,158,96,254
13506,2023-01-24,BROCK,knockout,New Perspective,0,236,163,399
13507,2023-01-24,BROCK,hotZone,Dueling Beetles,0,50,29,79
13508,2023-01-24,BROCK,heist,Safe Zone,4,739,650,1393
13509,2023-01-24,BROCK,gemGrab,Minecart Madness,0,64,45,109
13510,2023-01-24,BROCK,gemGrab,Crystal Arcade,0,113,60,173
13511,2023-01-24,BROCK,brawlBall,Center Stage,1,37,26,64
13512,2023-01-24,BROCK,brawlBall,Beach Ball,12,277,217,506
13513,2023-01-24,BROCK,bounty,Excel,0,239,173,412
13514,2023-01-23,BROCK,knockout,New Perspective,0,422,325,747
13515,2023-01-23,BROCK,hotZone,Dueling Beetles,1,64,19,84
13516,2023-01-23,BROCK,heist,Snaked Assault,0,191,94,285
13517,2023-01-23,BROCK,gemGrab,Minecart Madness,0,279,222,501
13518,2023-01-23,BROCK,gemGrab,Double Swoosh,0,71,78,149
13519,2023-01-23,BROCK,brawlBall,Center Stage,7,433,289,729
13520,2023-01-23,BROCK,brawlBall,Backyard Bowl,2,60,64,126
13521,2023-01-23,BROCK,bounty,Layer Cake,0,298,203,501
13522,2023-01-22,BROCK,knockout,X Marks the Spot,1,296,254,551
13523,2023-01-22,BROCK,hotZone,Ring of Fire,0,25,7,32
13524,2023-01-22,BROCK,heist,Snaked Assault,1,110,54,165
13525,2023-01-22,BROCK,gemGrab,Hard Rock Mine,0,24,15,39
13526,2023-01-22,BROCK,gemGrab,Double Swoosh,0,49,29,78
13527,2023-01-22,BROCK,brawlBall,Super Beach,0,34,29,63
13528,2023-01-22,BROCK,brawlBall,Backyard Bowl,21,519,485,1025
13529,2023-01-22,BROCK,bounty,Layer Cake,0,166,143,309
13530,2023-01-21,BROCK,knockout,X Marks the Spot,0,1016,841,1857
13531,2023-01-21,BROCK,hotZone,Ring of Fire,0,84,26,110
13532,2023-01-21,BROCK,heist,Tornado Ring,0,107,83,190
13533,2023-01-21,BROCK,gemGrab,Hard Rock Mine,0,125,79,204
13534,2023-01-21,BROCK,gemGrab,Deep Diner,0,32,17,49
13535,2023-01-21,BROCK,brawlBall,Super Beach,10,282,223,515
13536,2023-01-21,BROCK,brawlBall,Sneaky Fields,0,5,1,6
13537,2023-01-21,BROCK,bounty,Dry Season,0,546,490,1036
13538,2023-01-20,BROCK,knockout,Out in the Open,1,672,597,1270
13539,2023-01-20,BROCK,hotZone,Split,0,33,14,47
13540,2023-01-20,BROCK,heist,Tornado Ring,0,100,48,148
13541,2023-01-20,BROCK,gemGrab,Undermine,0,50,24,74
13542,2023-01-20,BROCK,gemGrab,Deep Diner,0,179,106,285
13543,2023-01-20,BROCK,brawlBall,Sneaky Fields,2,159,131,292
13544,2023-01-20,BROCK,brawlBall,Pinhole Punt,0,23,17,40
13545,2023-01-20,BROCK,bounty,Dry Season,0,391,259,650
13546,2023-01-19,BROCK,knockout,Out in the Open,2,844,764,1610
13547,2023-01-19,BROCK,hotZone,Split,0,47,21,68
13548,2023-01-19,BROCK,heist,Kaboom Canyon,1,251,208,460
13549,2023-01-19,BROCK,gemGrab,Undermine,0,129,110,239
13550,2023-01-19,BROCK,gemGrab,Gem Fort,0,17,24,41
13551,2023-01-19,BROCK,brawlBall,Sunny Soccer,0,9,3,12
13552,2023-01-19,BROCK,brawlBall,Pinhole Punt,10,330,274,614
13553,2023-01-19,BROCK,bounty,Shooting Star,0,389,294,683
13554,2023-01-18,BROCK,knockout,Goldarm Gulch,0,70,40,110
13555,2023-01-18,BROCK,hotZone,Parallel Plays,0,9,6,15
13556,2023-01-18,BROCK,heist,Kaboom Canyon,1,95,120,216
13557,2023-01-18,BROCK,gemGrab,Gem Fort,0,21,21,42
13558,2023-01-18,BROCK,gemGrab,Crystal Arcade,0,9,4,13
13559,2023-01-18,BROCK,brawlBall,Sunny Soccer,1,64,48,113
13560,2023-01-18,BROCK,brawlBall,Beach Ball,0,3,5,8
13561,2023-01-18,BROCK,bounty,Shooting Star,0,156,119,275
13562,2023-01-17,BROCK,knockout,Goldarm Gulch,0,52,32,84
13563,2023-01-17,BROCK,hotZone,Parallel Plays,0,4,1,5
13564,2023-01-17,BROCK,heist,Pit Stop,0,6,8,14
13565,2023-01-17,BROCK,gemGrab,Minecart Madness,0,6,2,8
13566,2023-01-17,BROCK,gemGrab,Crystal Arcade,0,10,5,15
13567,2023-01-17,BROCK,brawlBall,Center Stage,1,1,1,3
13568,2023-01-17,BROCK,brawlBall,Beach Ball,1,21,21,43
13569,2023-01-17,BROCK,bounty,Hideout,0,22,24,46
13570,2023-01-16,BROCK,knockout,Belle's Rock,0,53,31,84
13571,2023-01-16,BROCK,hotZone,Quarter Pounder,0,4,2,6
13572,2023-01-16,BROCK,heist,Pit Stop,0,9,8,17
13573,2023-01-16,BROCK,gemGrab,Minecart Madness,0,17,11,28
13574,2023-01-16,BROCK,gemGrab,Double Swoosh,0,3,5,8
13575,2023-01-16,BROCK,brawlBall,Center Stage,0,21,26,47
13576,2023-01-16,BROCK,brawlBall,Backyard Bowl,0,10,7,17
13577,2023-01-16,BROCK,bounty,Hideout,0,52,35,87
13578,2023-01-15,BROCK,knockout,Belle's Rock,0,96,80,176
13579,2023-01-15,BROCK,hotZone,Quarter Pounder,0,18,2,20
13580,2023-01-15,BROCK,heist,Bridge Too Far,1,107,73,181
13581,2023-01-15,BROCK,gemGrab,Hard Rock Mine,0,4,1,5
13582,2023-01-15,BROCK,gemGrab,Double Swoosh,0,7,1,8
13583,2023-01-15,BROCK,brawlBall,Super Beach,0,2,0,2
13584,2023-01-15,BROCK,brawlBall,Backyard Bowl,10,100,133,243
13585,2023-01-15,BROCK,bounty,Canal Grande,0,20,8,28
13586,2023-01-14,BROCK,knockout,Flaring Phoenix,0,18,9,27
13587,2023-01-14,BROCK,hotZone,Controller Chaos,0,13,1,14
13588,2023-01-14,BROCK,heist,Bridge Too Far,0,133,94,227
13589,2023-01-14,BROCK,gemGrab,Hard Rock Mine,0,10,2,12
13590,2023-01-14,BROCK,gemGrab,Deep Diner,0,7,2,9
13591,2023-01-14,BROCK,brawlBall,Super Beach,0,21,8,29
13592,2023-01-14,BROCK,brawlBall,Sneaky Fields,0,1,1,2
13593,2023-01-14,BROCK,bounty,Canal Grande,0,32,23,55
13594,2023-01-13,BROCK,knockout,Flaring Phoenix,0,20,21,41
13595,2023-01-13,BROCK,hotZone,Controller Chaos,0,6,0,6
13596,2023-01-13,BROCK,heist,Hot Potato,0,4,1,5
13597,2023-01-13,BROCK,gemGrab,Deep Diner,0,13,2,15
13598,2023-01-13,BROCK,brawlBall,Sneaky Fields,0,8,2,10
13599,2023-01-13,BROCK,brawlBall,Pinhole Punt,2,1,3,6
13600,2023-01-13,BROCK,bounty,Temple Ruins,0,6,2,8
13601,2023-01-12,BROCK,knockout,Riverside,0,100,68,168
13602,2023-01-12,BROCK,hotZone,Open Zone,0,8,0,8
13603,2023-01-12,BROCK,gemGrab,Undermine,0,4,1,5
13604,2023-01-12,BROCK,brawlBall,Sunny Soccer,0,1,0,1
13605,2023-01-12,BROCK,brawlBall,Pinhole Punt,0,9,6,15
13606,2023-01-12,BROCK,bounty,Temple Ruins,0,1,0,1
13607,2023-01-11,BROCK,knockout,Riverside,0,15,5,20
13608,2023-01-11,BROCK,hotZone,Open Zone,0,1,0,1
13609,2023-01-11,BROCK,heist,Safe Zone,0,2,1,3
13610,2023-01-11,BROCK,gemGrab,Gem Fort,0,0,1,1
13611,2023-01-11,BROCK,brawlBall,Sunny Soccer,0,7,0,7
13612,2023-01-11,BROCK,brawlBall,Beach Ball,0,0,1,1
13613,2023-01-11,BROCK,bounty,Excel,0,3,0,3
13614,2023-01-10,BROCK,knockout,New Perspective,0,24,20,44
13615,2023-01-10,BROCK,hotZone,Dueling Beetles,0,10,16,26
13616,2023-01-10,BROCK,heist,Safe Zone,0,63,54,117
13617,2023-01-10,BROCK,gemGrab,Minecart Madness,0,15,8,23
13618,2023-01-10,BROCK,gemGrab,Crystal Arcade,0,9,9,18
13619,2023-01-10,BROCK,brawlBall,Center Stage,0,6,2,8
13620,2023-01-10,BROCK,brawlBall,Beach Ball,0,13,11,24
13621,2023-01-10,BROCK,bounty,Excel,0,8,1,9
13622,2023-01-09,BROCK,knockout,New Perspective,0,16,4,20
13623,2023-01-09,BROCK,hotZone,Dueling Beetles,0,5,0,5
13624,2023-01-09,BROCK,heist,Snaked Assault,0,19,18,37
13625,2023-01-09,BROCK,gemGrab,Minecart Madness,0,19,7,26
13626,2023-01-09,BROCK,gemGrab,Double Swoosh,0,12,4,16
13627,2023-01-09,BROCK,brawlBall,Center Stage,1,14,11,26
13628,2023-01-09,BROCK,brawlBall,Backyard Bowl,0,8,2,10
13629,2023-01-09,BROCK,bounty,Layer Cake,0,37,29,66
13630,2023-01-08,BROCK,knockout,X Marks the Spot,0,67,55,122
13631,2023-01-08,BROCK,hotZone,Ring of Fire,0,8,9,17
13632,2023-01-08,BROCK,heist,Snaked Assault,0,14,9,23
13633,2023-01-08,BROCK,gemGrab,Hard Rock Mine,0,1,0,1
13634,2023-01-08,BROCK,gemGrab,Double Swoosh,0,1,2,3
13635,2023-01-08,BROCK,brawlBall,Super Beach,0,3,5,8
13636,2023-01-08,BROCK,brawlBall,Backyard Bowl,4,78,74,156
13637,2023-01-08,BROCK,bounty,Layer Cake,0,18,8,26
13638,2023-01-07,BROCK,knockout,X Marks the Spot,0,43,23,66
13639,2023-01-07,BROCK,hotZone,Ring of Fire,0,2,0,2
13640,2023-01-07,BROCK,heist,Tornado Ring,0,9,5,14
13641,2023-01-07,BROCK,gemGrab,Hard Rock Mine,0,6,1,7
13642,2023-01-07,BROCK,gemGrab,Deep Diner,0,6,5,11
13643,2023-01-07,BROCK,brawlBall,Super Beach,0,4,2,6
13644,2023-01-07,BROCK,brawlBall,Sneaky Fields,0,1,0,1
13645,2023-01-07,BROCK,bounty,Dry Season,0,50,62,112
13646,2023-01-06,BROCK,knockout,Out in the Open,0,45,31,76
13647,2023-01-06,BROCK,hotZone,Split,0,4,0,4
13648,2023-01-06,BROCK,heist,Tornado Ring,0,15,2,17
13649,2023-01-06,BROCK,gemGrab,Undermine,0,2,2,4
13650,2023-01-06,BROCK,gemGrab,Deep Diner,0,9,5,14
13651,2023-01-06,BROCK,brawlBall,Sneaky Fields,0,5,5,10
13652,2023-01-06,BROCK,brawlBall,Pinhole Punt,0,0,1,1
13653,2023-01-06,BROCK,bounty,Dry Season,0,77,31,108
13654,2023-01-05,BROCK,knockout,Out in the Open,0,115,100,215
13655,2023-01-05,BROCK,hotZone,Split,0,9,0,9
13656,2023-01-05,BROCK,heist,Kaboom Canyon,0,42,28,70
13657,2023-01-05,BROCK,gemGrab,Undermine,0,6,3,9
13658,2023-01-05,BROCK,gemGrab,Gem Fort,0,5,1,6
13659,2023-01-05,BROCK,brawlBall,Sunny Soccer,0,1,0,1
13660,2023-01-05,BROCK,brawlBall,Pinhole Punt,1,20,10,31
13661,2023-01-05,BROCK,bounty,Shooting Star,0,53,54,107
13662,2023-01-04,BROCK,knockout,Goldarm Gulch,0,18,29,47
13663,2023-01-04,BROCK,hotZone,Parallel Plays,0,0,1,1
13664,2023-01-04,BROCK,heist,Kaboom Canyon,0,84,145,229
13665,2023-01-04,BROCK,gemGrab,Gem Fort,0,6,4,10
13666,2023-01-04,BROCK,gemGrab,Crystal Arcade,0,3,0,3
13667,2023-01-04,BROCK,brawlBall,Sunny Soccer,0,11,19,30
13668,2023-01-04,BROCK,bounty,Shooting Star,0,136,131,267
13669,2023-01-03,BROCK,knockout,Goldarm Gulch,0,14,13,27
13670,2023-01-03,BROCK,hotZone,Parallel Plays,0,3,0,3
13671,2023-01-03,BROCK,heist,Pit Stop,0,7,1,8
13672,2023-01-03,BROCK,heist,Kaboom Canyon,0,2,1,3
13673,2023-01-03,BROCK,gemGrab,Minecart Madness,0,0,1,1
13674,2023-01-03,BROCK,gemGrab,Crystal Arcade,0,15,39,54
13675,2023-01-03,BROCK,brawlBall,Center Stage,0,1,0,1
13676,2023-01-03,BROCK,brawlBall,Beach Ball,1,22,30,53
13677,2023-01-03,BROCK,bounty,Hideout,0,54,20,74
13678,2023-01-02,BROCK,knockout,Belle's Rock,0,55,58,113
13679,2023-01-02,BROCK,hotZone,Quarter Pounder,0,9,0,9
13680,2023-01-02,BROCK,heist,Pit Stop,0,8,0,8
13681,2023-01-02,BROCK,heist,Kaboom Canyon,0,0,2,2
13682,2023-01-02,BROCK,gemGrab,Minecart Madness,0,26,6,32
13683,2023-01-02,BROCK,gemGrab,Double Swoosh,0,9,4,13
13684,2023-01-02,BROCK,brawlBall,Center Stage,1,22,16,39
13685,2023-01-02,BROCK,brawlBall,Backyard Bowl,0,4,2,6
13686,2023-01-02,BROCK,bounty,Hideout,0,128,87,215
13687,2023-01-01,BROCK,knockout,Belle's Rock,0,34,15,49
13688,2023-01-01,BROCK,hotZone,Quarter Pounder,0,3,1,4
13689,2023-01-01,BROCK,heist,Kaboom Canyon,0,1,1,2
13690,2023-01-01,BROCK,heist,Bridge Too Far,0,15,9,24
13691,2023-01-01,BROCK,gemGrab,Double Swoosh,0,3,1,4
13692,2023-01-01,BROCK,brawlBall,Backyard Bowl,0,41,30,71
13693,2023-01-01,BROCK,bounty,Canal Grande,0,5,4,9
13694,2022-12-31,BROCK,knockout,Flaring Phoenix,0,1,0,1
13695,2022-12-31,BROCK,heist,Bridge Too Far,0,13,19,32
13696,2022-12-31,BROCK,gemGrab,Hard Rock Mine,0,1,0,1
13697,2022-12-31,BROCK,gemGrab,Deep Diner,0,7,12,19
13698,2022-12-31,BROCK,brawlBall,Super Beach,0,2,3,5
13699,2022-12-30,BROCK,knockout,Flaring Phoenix,0,3,2,5
13700,2022-12-30,BROCK,heist,Kaboom Canyon,0,0,1,1
13701,2022-12-30,BROCK,gemGrab,Deep Diner,0,2,0,2
13702,2022-12-30,BROCK,brawlBall,Sneaky Fields,0,0,2,2
13703,2022-12-29,BROCK,heist,Kaboom Canyon,0,1,1,2
13704,2022-12-27,BROCK,knockout,New Perspective,0,2,3,5
13705,2022-12-27,BROCK,hotZone,Dueling Beetles,0,0,1,1
13706,2022-12-27,BROCK,heist,Safe Zone,0,1,1,2
13707,2022-12-27,BROCK,heist,Kaboom Canyon,0,1,0,1
13708,2022-12-27,BROCK,bounty,Excel,0,0,1,1
13709,2022-12-26,BROCK,heist,Kaboom Canyon,0,1,0,1
13710,2022-12-26,BROCK,gemGrab,Minecart Madness,0,2,0,2
13711,2022-12-25,BROCK,hotZone,Ring of Fire,0,1,0,1
13712,2022-12-25,BROCK,gemGrab,Double Swoosh,0,1,1,2
13713,2022-12-25,BROCK,brawlBall,Backyard Bowl,0,2,10,12
13714,2022-12-24,BROCK,knockout,X Marks the Spot,0,0,1,1
13715,2022-12-23,BROCK,knockout,Out in the Open,0,5,9,14
13716,2022-12-22,BROCK,heist,Kaboom Canyon,0,0,1,1
13717,2022-12-22,BROCK,brawlBall,Pinhole Punt,0,2,0,2
13718,2022-12-20,BROCK,brawlBall,Beach Ball,0,4,2,6
13719,2022-12-19,BROCK,brawlBall,Center Stage,0,1,1,2
13720,2022-12-18,BROCK,heist,Bridge Too Far,0,1,0,1
13721,2022-12-16,BROCK,bounty,Temple Ruins,0,2,0,2
13722,2022-12-13,BROCK,heist,Safe Zone,0,3,2,5
13723,2022-12-13,BROCK,gemGrab,Crystal Arcade,0,2,1,3
13724,2022-12-10,BROCK,knockout,X Marks the Spot,0,1,1,2
13725,2022-11-11,BROCK,knockout,New Perspective,0,0,2,2
13726,2022-11-03,BROCK,brawlBall,Pinhole Punt,0,1,0,1
13727,2022-11-03,BROCK,bounty,Temple Ruins,0,1,0,1
13728,2022-11-01,BROCK,knockout,New Perspective,0,4,4,8
13729,2022-10-28,BROCK,knockout,Out in the Open,0,1,0,1
13730,2022-10-28,BROCK,heist,Safe Zone,0,1,1,2
13731,2022-10-28,BROCK,bounty,Canal Grande,0,0,2,2
13732,2022-10-26,BROCK,bounty,Shooting Star,0,1,0,1
13733,2022-10-15,BROCK,gemGrab,Hard Rock Mine,0,1,0,1
13734,2022-10-15,BROCK,brawlBall,Super Beach,0,1,0,1
13735,2022-10-10,BROCK,knockout,Belle's Rock,0,3,2,5
13736,2023-01-30,BONNIE,knockout,Belle's Rock,0,136,176,312
13737,2023-01-30,BONNIE,hotZone,Quarter Pounder,0,17,28,45
13738,2023-01-30,BONNIE,heist,Pit Stop,0,4,5,9
13739,2023-01-30,BONNIE,gemGrab,Minecart Madness,0,48,67,115
13740,2023-01-30,BONNIE,gemGrab,Double Swoosh,0,15,10,25
13741,2023-01-30,BONNIE,brawlBall,Center Stage,1,48,24,73
13742,2023-01-30,BONNIE,brawlBall,Backyard Bowl,1,30,43,74
13743,2023-01-30,BONNIE,bounty,Hideout,0,28,18,46
13744,2023-01-29,BONNIE,knockout,Belle's Rock,0,166,237,403
13745,2023-01-29,BONNIE,hotZone,Quarter Pounder,0,11,4,15
13746,2023-01-29,BONNIE,heist,Bridge Too Far,1,90,87,178
13747,2023-01-29,BONNIE,gemGrab,Hard Rock Mine,0,2,12,14
13748,2023-01-29,BONNIE,gemGrab,Double Swoosh,0,17,13,30
13749,2023-01-29,BONNIE,brawlBall,Super Beach,0,0,4,4
13750,2023-01-29,BONNIE,brawlBall,Backyard Bowl,17,309,459,785
13751,2023-01-29,BONNIE,bounty,Canal Grande,0,8,10,18
13752,2023-01-28,BONNIE,knockout,Flaring Phoenix,1,49,44,94
13753,2023-01-28,BONNIE,hotZone,Controller Chaos,0,11,8,19
13754,2023-01-28,BONNIE,heist,Bridge Too Far,0,263,329,592
13755,2023-01-28,BONNIE,gemGrab,Hard Rock Mine,0,47,74,121
13756,2023-01-28,BONNIE,gemGrab,Deep Diner,0,7,9,16
13757,2023-01-28,BONNIE,brawlBall,Super Beach,1,93,89,183
13758,2023-01-28,BONNIE,brawlBall,Sneaky Fields,0,0,1,1
13759,2023-01-28,BONNIE,bounty,Canal Grande,0,14,6,20
13760,2023-01-27,BONNIE,knockout,Flaring Phoenix,1,24,12,37
13761,2023-01-27,BONNIE,hotZone,Controller Chaos,0,3,3,6
13762,2023-01-27,BONNIE,heist,Hot Potato,0,6,1,7
13763,2023-01-27,BONNIE,gemGrab,Undermine,0,5,2,7
13764,2023-01-27,BONNIE,gemGrab,Deep Diner,0,14,14,28
13765,2023-01-27,BONNIE,brawlBall,Sneaky Fields,0,28,36,64
13766,2023-01-27,BONNIE,bounty,Temple Ruins,0,11,14,25
13767,2023-01-26,BONNIE,knockout,Riverside,1,124,162,287
13768,2023-01-26,BONNIE,hotZone,Open Zone,0,41,54,95
13769,2023-01-26,BONNIE,heist,Hot Potato,0,15,16,31
13770,2023-01-26,BONNIE,gemGrab,Undermine,0,26,27,53
13771,2023-01-26,BONNIE,gemGrab,Gem Fort,0,7,6,13
13772,2023-01-26,BONNIE,brawlBall,Sunny Soccer,0,2,15,17
13773,2023-01-26,BONNIE,brawlBall,Pinhole Punt,3,170,227,400
13774,2023-01-26,BONNIE,bounty,Temple Ruins,0,25,22,47
13775,2023-01-25,BONNIE,knockout,Riverside,0,57,58,115
13776,2023-01-25,BONNIE,hotZone,Open Zone,0,28,37,65
13777,2023-01-25,BONNIE,heist,Safe Zone,0,83,116,199
13778,2023-01-25,BONNIE,gemGrab,Gem Fort,0,8,3,11
13779,2023-01-25,BONNIE,gemGrab,Crystal Arcade,0,9,17,26
13780,2023-01-25,BONNIE,brawlBall,Sunny Soccer,0,49,40,89
13781,2023-01-25,BONNIE,brawlBall,Beach Ball,1,16,9,26
13782,2023-01-25,BONNIE,bounty,Excel,0,28,80,108
13783,2023-01-24,BONNIE,knockout,New Perspective,0,59,84,143
13784,2023-01-24,BONNIE,hotZone,Dueling Beetles,0,10,13,23
13785,2023-01-24,BONNIE,heist,Safe Zone,2,117,245,364
13786,2023-01-24,BONNIE,gemGrab,Minecart Madness,0,14,21,35
13787,2023-01-24,BONNIE,gemGrab,Crystal Arcade,0,25,33,58
13788,2023-01-24,BONNIE,brawlBall,Center Stage,2,12,15,29
13789,2023-01-24,BONNIE,brawlBall,Beach Ball,2,117,138,257
13790,2023-01-24,BONNIE,bounty,Excel,0,30,41,71
13791,2023-01-23,BONNIE,knockout,New Perspective,0,87,95,182
13792,2023-01-23,BONNIE,hotZone,Dueling Beetles,0,30,61,91
13793,2023-01-23,BONNIE,heist,Snaked Assault,0,12,14,26
13794,2023-01-23,BONNIE,gemGrab,Minecart Madness,0,89,154,243
13795,2023-01-23,BONNIE,gemGrab,Double Swoosh,0,4,3,7
13796,2023-01-23,BONNIE,brawlBall,Center Stage,4,80,76,160
13797,2023-01-23,BONNIE,brawlBall,Backyard Bowl,0,31,31,62
13798,2023-01-23,BONNIE,bounty,Layer Cake,0,38,50,88
13799,2023-01-22,BONNIE,knockout,X Marks the Spot,0,35,26,61
13800,2023-01-22,BONNIE,hotZone,Ring of Fire,0,7,6,13
13801,2023-01-22,BONNIE,heist,Snaked Assault,0,10,8,18
13802,2023-01-22,BONNIE,gemGrab,Hard Rock Mine,0,16,5,21
13803,2023-01-22,BONNIE,gemGrab,Double Swoosh,0,13,8,21
13804,2023-01-22,BONNIE,brawlBall,Super Beach,1,8,22,31
13805,2023-01-22,BONNIE,brawlBall,Backyard Bowl,6,131,210,347
13806,2023-01-22,BONNIE,bounty,Layer Cake,0,18,21,39
13807,2023-01-21,BONNIE,knockout,X Marks the Spot,0,150,157,307
13808,2023-01-21,BONNIE,hotZone,Ring of Fire,0,19,18,37
13809,2023-01-21,BONNIE,heist,Tornado Ring,0,11,7,18
13810,2023-01-21,BONNIE,gemGrab,Hard Rock Mine,0,48,42,90
13811,2023-01-21,BONNIE,gemGrab,Deep Diner,0,18,18,36
13812,2023-01-21,BONNIE,brawlBall,Super Beach,2,129,169,300
13813,2023-01-21,BONNIE,brawlBall,Sneaky Fields,0,2,17,19
13814,2023-01-21,BONNIE,bounty,Dry Season,0,74,108,182
13815,2023-01-20,BONNIE,knockout,Out in the Open,0,101,128,229
13816,2023-01-20,BONNIE,hotZone,Split,0,1,4,5
13817,2023-01-20,BONNIE,heist,Tornado Ring,0,16,3,19
13818,2023-01-20,BONNIE,gemGrab,Undermine,0,17,17,34
13819,2023-01-20,BONNIE,gemGrab,Deep Diner,0,47,76,123
13820,2023-01-20,BONNIE,brawlBall,Sneaky Fields,0,66,57,123
13821,2023-01-20,BONNIE,brawlBall,Pinhole Punt,1,9,5,15
13822,2023-01-20,BONNIE,bounty,Dry Season,0,58,76,134
13823,2023-01-19,BONNIE,knockout,Out in the Open,1,148,143,292
13824,2023-01-19,BONNIE,hotZone,Split,0,10,9,19
13825,2023-01-19,BONNIE,heist,Kaboom Canyon,0,37,52,89
13826,2023-01-19,BONNIE,gemGrab,Undermine,0,24,30,54
13827,2023-01-19,BONNIE,gemGrab,Gem Fort,0,2,1,3
13828,2023-01-19,BONNIE,brawlBall,Sunny Soccer,0,3,0,3
13829,2023-01-19,BONNIE,brawlBall,Pinhole Punt,2,137,191,330
13830,2023-01-19,BONNIE,bounty,Shooting Star,0,44,70,114
13831,2023-01-18,BONNIE,knockout,Goldarm Gulch,0,15,21,36
13832,2023-01-18,BONNIE,hotZone,Parallel Plays,0,2,0,2
13833,2023-01-18,BONNIE,heist,Kaboom Canyon,0,12,31,43
13834,2023-01-18,BONNIE,gemGrab,Gem Fort,0,1,3,4
13835,2023-01-18,BONNIE,gemGrab,Crystal Arcade,0,5,3,8
13836,2023-01-18,BONNIE,brawlBall,Sunny Soccer,0,14,18,32
13837,2023-01-18,BONNIE,brawlBall,Beach Ball,0,1,3,4
13838,2023-01-18,BONNIE,bounty,Shooting Star,0,19,21,40
13839,2023-01-17,BONNIE,knockout,Goldarm Gulch,0,6,7,13
13840,2023-01-17,BONNIE,hotZone,Parallel Plays,0,1,1,2
13841,2023-01-17,BONNIE,heist,Pit Stop,0,3,2,5
13842,2023-01-17,BONNIE,gemGrab,Crystal Arcade,0,5,1,6
13843,2023-01-17,BONNIE,brawlBall,Beach Ball,1,11,16,28
13844,2023-01-17,BONNIE,bounty,Hideout,0,4,3,7
13845,2023-01-16,BONNIE,knockout,Belle's Rock,0,11,3,14
13846,2023-01-16,BONNIE,hotZone,Quarter Pounder,0,2,0,2
13847,2023-01-16,BONNIE,heist,Pit Stop,0,2,0,2
13848,2023-01-16,BONNIE,gemGrab,Minecart Madness,0,1,9,10
13849,2023-01-16,BONNIE,gemGrab,Double Swoosh,0,1,1,2
13850,2023-01-16,BONNIE,brawlBall,Center Stage,0,2,2,4
13851,2023-01-16,BONNIE,brawlBall,Backyard Bowl,0,0,4,4
13852,2023-01-16,BONNIE,bounty,Hideout,0,2,0,2
13853,2023-01-15,BONNIE,knockout,Belle's Rock,0,27,50,77
13854,2023-01-15,BONNIE,hotZone,Quarter Pounder,0,5,3,8
13855,2023-01-15,BONNIE,heist,Bridge Too Far,0,34,43,77
13856,2023-01-15,BONNIE,gemGrab,Double Swoosh,0,3,4,7
13857,2023-01-15,BONNIE,brawlBall,Super Beach,0,4,13,17
13858,2023-01-15,BONNIE,brawlBall,Backyard Bowl,1,40,42,83
13859,2023-01-15,BONNIE,bounty,Canal Grande,0,2,1,3
13860,2023-01-14,BONNIE,knockout,Flaring Phoenix,0,3,4,7
13861,2023-01-14,BONNIE,hotZone,Controller Chaos,0,4,3,7
13862,2023-01-14,BONNIE,heist,Bridge Too Far,0,56,88,144
13863,2023-01-14,BONNIE,gemGrab,Hard Rock Mine,0,2,0,2
13864,2023-01-14,BONNIE,gemGrab,Deep Diner,0,3,4,7
13865,2023-01-14,BONNIE,brawlBall,Super Beach,0,12,7,19
13866,2023-01-13,BONNIE,knockout,Flaring Phoenix,0,6,2,8
13867,2023-01-13,BONNIE,hotZone,Controller Chaos,0,2,1,3
13868,2023-01-13,BONNIE,gemGrab,Deep Diner,0,1,0,1
13869,2023-01-13,BONNIE,brawlBall,Sneaky Fields,0,15,14,29
13870,2023-01-13,BONNIE,brawlBall,Pinhole Punt,0,1,0,1
13871,2023-01-12,BONNIE,knockout,Riverside,0,29,46,75
13872,2023-01-12,BONNIE,hotZone,Open Zone,0,8,1,9
13873,2023-01-12,BONNIE,brawlBall,Pinhole Punt,0,4,4,8
13874,2023-01-11,BONNIE,knockout,Riverside,0,2,0,2
13875,2023-01-11,BONNIE,hotZone,Open Zone,0,2,0,2
13876,2023-01-11,BONNIE,gemGrab,Gem Fort,0,1,0,1
13877,2023-01-11,BONNIE,brawlBall,Sunny Soccer,0,1,0,1
13878,2023-01-11,BONNIE,bounty,Excel,0,0,1,1
13879,2023-01-10,BONNIE,knockout,New Perspective,0,2,1,3
13880,2023-01-10,BONNIE,hotZone,Dueling Beetles,0,2,1,3
13881,2023-01-10,BONNIE,heist,Safe Zone,0,9,54,63
13882,2023-01-10,BONNIE,gemGrab,Minecart Madness,0,1,1,2
13883,2023-01-10,BONNIE,gemGrab,Crystal Arcade,0,4,2,6
13884,2023-01-10,BONNIE,brawlBall,Beach Ball,0,3,3,6
13885,2023-01-09,BONNIE,knockout,New Perspective,0,3,9,12
13886,2023-01-09,BONNIE,hotZone,Dueling Beetles,0,2,7,9
13887,2023-01-09,BONNIE,gemGrab,Minecart Madness,0,2,23,25
13888,2023-01-09,BONNIE,gemGrab,Double Swoosh,0,5,4,9
13889,2023-01-09,BONNIE,brawlBall,Center Stage,0,4,2,6
13890,2023-01-09,BONNIE,brawlBall,Backyard Bowl,1,1,0,2
13891,2023-01-09,BONNIE,bounty,Layer Cake,0,6,1,7
13892,2023-01-08,BONNIE,knockout,X Marks the Spot,0,7,7,14
13893,2023-01-08,BONNIE,hotZone,Ring of Fire,0,2,2,4
13894,2023-01-08,BONNIE,heist,Snaked Assault,0,6,2,8
13895,2023-01-08,BONNIE,gemGrab,Double Swoosh,0,1,0,1
13896,2023-01-08,BONNIE,brawlBall,Super Beach,0,0,2,2
13897,2023-01-08,BONNIE,brawlBall,Backyard Bowl,2,15,29,46
13898,2023-01-08,BONNIE,bounty,Layer Cake,0,7,3,10
13899,2023-01-07,BONNIE,knockout,X Marks the Spot,0,4,7,11
13900,2023-01-07,BONNIE,hotZone,Ring of Fire,0,0,1,1
13901,2023-01-07,BONNIE,heist,Tornado Ring,0,0,2,2
13902,2023-01-07,BONNIE,gemGrab,Hard Rock Mine,0,1,0,1
13903,2023-01-07,BONNIE,brawlBall,Super Beach,1,3,4,8
13904,2023-01-07,BONNIE,bounty,Dry Season,0,5,10,15
13905,2023-01-06,BONNIE,knockout,Out in the Open,0,4,0,4
13906,2023-01-06,BONNIE,hotZone,Split,0,1,0,1
13907,2023-01-06,BONNIE,heist,Tornado Ring,0,3,2,5
13908,2023-01-06,BONNIE,gemGrab,Undermine,0,1,3,4
13909,2023-01-06,BONNIE,gemGrab,Deep Diner,0,2,0,2
13910,2023-01-06,BONNIE,brawlBall,Sneaky Fields,0,4,8,12
13911,2023-01-06,BONNIE,brawlBall,Pinhole Punt,0,3,4,7
13912,2023-01-06,BONNIE,bounty,Dry Season,0,8,15,23
13913,2023-01-05,BONNIE,knockout,Out in the Open,0,18,28,46
13914,2023-01-05,BONNIE,hotZone,Split,0,2,0,2
13915,2023-01-05,BONNIE,heist,Kaboom Canyon,0,6,5,11
13916,2023-01-05,BONNIE,gemGrab,Undermine,0,0,2,2
13917,2023-01-05,BONNIE,gemGrab,Gem Fort,0,1,0,1
13918,2023-01-05,BONNIE,brawlBall,Pinhole Punt,0,17,30,47
13919,2023-01-05,BONNIE,bounty,Shooting Star,0,9,5,14
13920,2023-01-04,BONNIE,knockout,Goldarm Gulch,0,4,2,6
13921,2023-01-04,BONNIE,hotZone,Parallel Plays,0,1,0,1
13922,2023-01-04,BONNIE,heist,Kaboom Canyon,0,7,6,13
13923,2023-01-04,BONNIE,gemGrab,Gem Fort,0,1,0,1
13924,2023-01-04,BONNIE,gemGrab,Crystal Arcade,0,1,0,1
13925,2023-01-04,BONNIE,brawlBall,Sunny Soccer,0,0,3,3
13926,2023-01-04,BONNIE,bounty,Shooting Star,0,23,14,37
13927,2023-01-03,BONNIE,knockout,Goldarm Gulch,0,1,1,2
13928,2023-01-03,BONNIE,hotZone,Parallel Plays,0,3,0,3
13929,2023-01-03,BONNIE,gemGrab,Minecart Madness,0,1,0,1
13930,2023-01-03,BONNIE,gemGrab,Crystal Arcade,0,6,6,12
13931,2023-01-03,BONNIE,brawlBall,Beach Ball,0,6,12,18
13932,2023-01-03,BONNIE,bounty,Hideout,0,13,52,65
13933,2023-01-02,BONNIE,knockout,Belle's Rock,0,17,34,51
13934,2023-01-02,BONNIE,hotZone,Quarter Pounder,0,6,0,6
13935,2023-01-02,BONNIE,heist,Pit Stop,0,3,1,4
13936,2023-01-02,BONNIE,gemGrab,Minecart Madness,0,12,38,50
13937,2023-01-02,BONNIE,gemGrab,Double Swoosh,0,1,0,1
13938,2023-01-02,BONNIE,brawlBall,Center Stage,0,6,2,8
13939,2023-01-02,BONNIE,brawlBall,Backyard Bowl,1,7,13,21
13940,2023-01-02,BONNIE,bounty,Hideout,0,24,36,60
13941,2023-01-01,BONNIE,knockout,Belle's Rock,0,4,5,9
13942,2023-01-01,BONNIE,hotZone,Quarter Pounder,0,1,0,1
13943,2023-01-01,BONNIE,heist,Bridge Too Far,0,3,9,12
13944,2023-01-01,BONNIE,gemGrab,Hard Rock Mine,0,0,1,1
13945,2023-01-01,BONNIE,brawlBall,Backyard Bowl,0,11,7,18
13946,2022-12-31,BONNIE,heist,Bridge Too Far,0,2,6,8
13947,2022-12-31,BONNIE,gemGrab,Hard Rock Mine,0,1,4,5
13948,2022-12-31,BONNIE,brawlBall,Super Beach,0,2,0,2
13949,2022-12-30,BONNIE,gemGrab,Minecart Madness,0,1,0,1
13950,2022-12-30,BONNIE,brawlBall,Sneaky Fields,0,1,0,1
13951,2022-12-29,BONNIE,gemGrab,Minecart Madness,0,1,1,2
13952,2022-12-26,BONNIE,heist,Kaboom Canyon,0,0,1,1
13953,2022-12-26,BONNIE,gemGrab,Minecart Madness,0,1,0,1
13954,2022-12-25,BONNIE,brawlBall,Backyard Bowl,0,1,0,1
13955,2022-12-24,BONNIE,knockout,X Marks the Spot,0,1,1,2
13956,2022-12-24,BONNIE,brawlBall,Super Beach,0,0,1,1
13957,2022-12-23,BONNIE,knockout,Out in the Open,0,0,1,1
13958,2022-12-19,BONNIE,brawlBall,Center Stage,0,0,1,1
13959,2022-12-13,BONNIE,brawlBall,Beach Ball,0,1,0,1
13960,2022-12-11,BONNIE,brawlBall,Backyard Bowl,0,1,0,1
13961,2022-11-03,BONNIE,brawlBall,Pinhole Punt,0,1,1,2
13962,2022-10-15,BONNIE,hotZone,Ring of Fire,0,0,1,1
13963,2022-10-15,BONNIE,bounty,Dry Season,0,1,0,1
13964,2022-10-10,BONNIE,knockout,Belle's Rock,0,0,3,3
13965,2023-01-30,BO,knockout,Belle's Rock,1,283,355,639
13966,2023-01-30,BO,hotZone,Quarter Pounder,1,290,177,468
13967,2023-01-30,BO,heist,Pit Stop,0,16,12,28
13968,2023-01-30,BO,gemGrab,Minecart Madness,0,348,244,592
13969,2023-01-30,BO,gemGrab,Double Swoosh,0,253,218,471
13970,2023-01-30,BO,brawlBall,Center Stage,7,238,218,463
13971,2023-01-30,BO,brawlBall,Backyard Bowl,0,45,31,76
13972,2023-01-30,BO,bounty,Hideout,0,56,39,95
13973,2023-01-29,BO,knockout,Belle's Rock,2,575,691,1268
13974,2023-01-29,BO,hotZone,Quarter Pounder,2,254,147,403
13975,2023-01-29,BO,heist,Bridge Too Far,2,75,62,139
13976,2023-01-29,BO,gemGrab,Hard Rock Mine,0,33,42,75
13977,2023-01-29,BO,gemGrab,Double Swoosh,0,375,383,758
13978,2023-01-29,BO,brawlBall,Super Beach,0,5,7,12
13979,2023-01-29,BO,brawlBall,Backyard Bowl,32,501,454,987
13980,2023-01-29,BO,bounty,Canal Grande,0,79,55,134
13981,2023-01-28,BO,knockout,Flaring Phoenix,5,693,949,1647
13982,2023-01-28,BO,hotZone,Controller Chaos,0,122,33,155
13983,2023-01-28,BO,heist,Bridge Too Far,1,158,102,261
13984,2023-01-28,BO,gemGrab,Hard Rock Mine,0,271,207,478
13985,2023-01-28,BO,gemGrab,Deep Diner,0,116,71,187
13986,2023-01-28,BO,brawlBall,Super Beach,14,289,212,515
13987,2023-01-28,BO,brawlBall,Sneaky Fields,0,13,13,26
13988,2023-01-28,BO,bounty,Canal Grande,0,158,81,239
13989,2023-01-27,BO,knockout,Flaring Phoenix,3,382,470,855
13990,2023-01-27,BO,hotZone,Controller Chaos,0,35,24,59
13991,2023-01-27,BO,heist,Hot Potato,0,14,13,27
13992,2023-01-27,BO,gemGrab,Undermine,0,21,11,32
13993,2023-01-27,BO,gemGrab,Deep Diner,0,128,90,218
13994,2023-01-27,BO,brawlBall,Sneaky Fields,4,103,93,200
13995,2023-01-27,BO,brawlBall,Pinhole Punt,0,6,9,15
13996,2023-01-27,BO,bounty,Temple Ruins,0,27,18,45
13997,2023-01-26,BO,knockout,Riverside,0,127,81,208
13998,2023-01-26,BO,hotZone,Open Zone,0,294,188,482
13999,2023-01-26,BO,heist,Hot Potato,0,47,18,65
14000,2023-01-26,BO,gemGrab,Undermine,0,149,139,288
14001,2023-01-26,BO,gemGrab,Gem Fort,0,100,76,176
14002,2023-01-26,BO,brawlBall,Sunny Soccer,0,8,9,17
14003,2023-01-26,BO,brawlBall,Pinhole Punt,11,342,318,671
14004,2023-01-26,BO,bounty,Temple Ruins,0,107,79,186
14005,2023-01-25,BO,knockout,Riverside,0,64,46,110
14006,2023-01-25,BO,hotZone,Open Zone,0,139,92,231
14007,2023-01-25,BO,heist,Safe Zone,0,86,39,125
14008,2023-01-25,BO,gemGrab,Gem Fort,0,104,98,202
14009,2023-01-25,BO,gemGrab,Crystal Arcade,0,123,80,203
14010,2023-01-25,BO,brawlBall,Sunny Soccer,2,174,134,310
14011,2023-01-25,BO,brawlBall,Beach Ball,0,24,27,51
14012,2023-01-25,BO,bounty,Excel,0,57,25,82
14013,2023-01-24,BO,knockout,New Perspective,1,304,429,734
14014,2023-01-24,BO,hotZone,Dueling Beetles,0,272,160,432
14015,2023-01-24,BO,heist,Safe Zone,1,142,82,225
14016,2023-01-24,BO,gemGrab,Minecart Madness,0,145,96,241
14017,2023-01-24,BO,gemGrab,Crystal Arcade,0,300,267,567
14018,2023-01-24,BO,brawlBall,Center Stage,2,60,34,96
14019,2023-01-24,BO,brawlBall,Beach Ball,7,234,188,429
14020,2023-01-24,BO,bounty,Excel,0,144,123,267
14021,2023-01-23,BO,knockout,New Perspective,5,1149,1519,2673
14022,2023-01-23,BO,hotZone,Dueling Beetles,0,379,256,635
14023,2023-01-23,BO,heist,Snaked Assault,0,47,24,71
14024,2023-01-23,BO,gemGrab,Minecart Madness,0,621,524,1145
14025,2023-01-23,BO,gemGrab,Double Swoosh,0,190,232,422
14026,2023-01-23,BO,brawlBall,Center Stage,17,434,301,752
14027,2023-01-23,BO,brawlBall,Backyard Bowl,1,23,48,72
14028,2023-01-23,BO,bounty,Layer Cake,0,177,158,335
14029,2023-01-22,BO,knockout,X Marks the Spot,2,377,469,848
14030,2023-01-22,BO,hotZone,Ring of Fire,0,239,158,397
14031,2023-01-22,BO,heist,Snaked Assault,0,22,13,35
14032,2023-01-22,BO,gemGrab,Hard Rock Mine,0,84,70,154
14033,2023-01-22,BO,gemGrab,Double Swoosh,0,234,232,466
14034,2023-01-22,BO,brawlBall,Super Beach,1,37,28,66
14035,2023-01-22,BO,brawlBall,Backyard Bowl,8,223,188,419
14036,2023-01-22,BO,bounty,Layer Cake,0,122,123,245
14037,2023-01-21,BO,knockout,X Marks the Spot,6,1392,1716,3114
14038,2023-01-21,BO,hotZone,Ring of Fire,1,541,453,995
14039,2023-01-21,BO,heist,Tornado Ring,0,43,17,60
14040,2023-01-21,BO,gemGrab,Hard Rock Mine,0,405,303,708
14041,2023-01-21,BO,gemGrab,Deep Diner,0,107,88,195
14042,2023-01-21,BO,brawlBall,Super Beach,12,403,332,747
14043,2023-01-21,BO,brawlBall,Sneaky Fields,0,10,16,26
14044,2023-01-21,BO,bounty,Dry Season,0,254,152,406
14045,2023-01-20,BO,knockout,Out in the Open,10,591,813,1414
14046,2023-01-20,BO,hotZone,Split,0,79,32,111
14047,2023-01-20,BO,heist,Tornado Ring,0,48,26,74
14048,2023-01-20,BO,gemGrab,Undermine,0,110,121,231
14049,2023-01-20,BO,gemGrab,Deep Diner,0,362,277,639
14050,2023-01-20,BO,brawlBall,Sneaky Fields,7,235,200,442
14051,2023-01-20,BO,brawlBall,Pinhole Punt,0,21,21,42
14052,2023-01-20,BO,bounty,Dry Season,0,146,96,242
14053,2023-01-19,BO,knockout,Out in the Open,15,1230,1545,2790
14054,2023-01-19,BO,hotZone,Split,0,81,25,106
14055,2023-01-19,BO,heist,Kaboom Canyon,0,59,28,87
14056,2023-01-19,BO,gemGrab,Undermine,0,282,222,504
14057,2023-01-19,BO,gemGrab,Gem Fort,0,54,61,115
14058,2023-01-19,BO,brawlBall,Sunny Soccer,0,5,6,11
14059,2023-01-19,BO,brawlBall,Pinhole Punt,11,368,353,732
14060,2023-01-19,BO,bounty,Shooting Star,0,129,89,218
14061,2023-01-18,BO,knockout,Goldarm Gulch,3,100,132,235
14062,2023-01-18,BO,hotZone,Parallel Plays,0,22,24,46
14063,2023-01-18,BO,heist,Kaboom Canyon,0,22,4,26
14064,2023-01-18,BO,gemGrab,Gem Fort,0,45,40,85
14065,2023-01-18,BO,gemGrab,Crystal Arcade,0,19,11,30
14066,2023-01-18,BO,brawlBall,Sunny Soccer,0,53,49,102
14067,2023-01-18,BO,brawlBall,Beach Ball,0,4,7,11
14068,2023-01-18,BO,bounty,Shooting Star,0,53,44,97
14069,2023-01-17,BO,knockout,Goldarm Gulch,0,95,129,224
14070,2023-01-17,BO,hotZone,Parallel Plays,0,9,4,13
14071,2023-01-17,BO,heist,Pit Stop,0,6,0,6
14072,2023-01-17,BO,gemGrab,Minecart Madness,0,3,3,6
14073,2023-01-17,BO,gemGrab,Crystal Arcade,0,25,28,53
14074,2023-01-17,BO,brawlBall,Center Stage,0,4,1,5
14075,2023-01-17,BO,brawlBall,Beach Ball,1,12,13,26
14076,2023-01-17,BO,bounty,Hideout,0,5,1,6
14077,2023-01-16,BO,knockout,Belle's Rock,0,22,55,77
14078,2023-01-16,BO,hotZone,Quarter Pounder,0,48,31,79
14079,2023-01-16,BO,heist,Pit Stop,0,5,0,5
14080,2023-01-16,BO,gemGrab,Minecart Madness,0,40,27,67
14081,2023-01-16,BO,gemGrab,Double Swoosh,0,24,17,41
14082,2023-01-16,BO,brawlBall,Center Stage,0,15,19,34
14083,2023-01-16,BO,brawlBall,Backyard Bowl,0,5,3,8
14084,2023-01-16,BO,bounty,Hideout,0,21,11,32
14085,2023-01-15,BO,knockout,Belle's Rock,0,71,64,135
14086,2023-01-15,BO,hotZone,Quarter Pounder,0,57,25,82
14087,2023-01-15,BO,heist,Bridge Too Far,0,18,5,23
14088,2023-01-15,BO,gemGrab,Hard Rock Mine,0,13,10,23
14089,2023-01-15,BO,gemGrab,Double Swoosh,0,53,46,99
14090,2023-01-15,BO,brawlBall,Super Beach,0,11,25,36
14091,2023-01-15,BO,brawlBall,Backyard Bowl,4,60,60,124
14092,2023-01-15,BO,bounty,Canal Grande,0,11,9,20
14093,2023-01-14,BO,knockout,Flaring Phoenix,2,58,98,158
14094,2023-01-14,BO,hotZone,Controller Chaos,0,31,3,34
14095,2023-01-14,BO,heist,Bridge Too Far,0,25,25,50
14096,2023-01-14,BO,gemGrab,Hard Rock Mine,0,22,9,31
14097,2023-01-14,BO,gemGrab,Deep Diner,0,16,3,19
14098,2023-01-14,BO,brawlBall,Super Beach,0,23,31,54
14099,2023-01-14,BO,brawlBall,Sneaky Fields,0,3,0,3
14100,2023-01-14,BO,bounty,Canal Grande,0,12,11,23
14101,2023-01-13,BO,knockout,Flaring Phoenix,0,65,72,137
14102,2023-01-13,BO,hotZone,Controller Chaos,0,24,3,27
14103,2023-01-13,BO,heist,Hot Potato,0,4,1,5
14104,2023-01-13,BO,gemGrab,Deep Diner,0,35,18,53
14105,2023-01-13,BO,brawlBall,Sneaky Fields,2,29,21,52
14106,2023-01-13,BO,bounty,Temple Ruins,0,5,2,7
14107,2023-01-12,BO,knockout,Riverside,0,12,5,17
14108,2023-01-12,BO,hotZone,Open Zone,0,48,9,57
14109,2023-01-12,BO,heist,Hot Potato,0,3,0,3
14110,2023-01-12,BO,gemGrab,Undermine,0,13,3,16
14111,2023-01-12,BO,gemGrab,Gem Fort,0,3,1,4
14112,2023-01-12,BO,brawlBall,Pinhole Punt,0,13,3,16
14113,2023-01-12,BO,bounty,Temple Ruins,0,1,0,1
14114,2023-01-11,BO,knockout,Riverside,0,1,0,1
14115,2023-01-11,BO,hotZone,Open Zone,0,14,18,32
14116,2023-01-11,BO,heist,Safe Zone,0,1,2,3
14117,2023-01-11,BO,gemGrab,Gem Fort,0,10,21,31
14118,2023-01-11,BO,brawlBall,Sunny Soccer,0,6,3,9
14119,2023-01-11,BO,brawlBall,Beach Ball,0,0,1,1
14120,2023-01-11,BO,bounty,Excel,0,3,0,3
14121,2023-01-10,BO,knockout,New Perspective,0,16,34,50
14122,2023-01-10,BO,hotZone,Dueling Beetles,0,61,30,91
14123,2023-01-10,BO,heist,Safe Zone,0,14,26,40
14124,2023-01-10,BO,gemGrab,Minecart Madness,0,35,7,42
14125,2023-01-10,BO,gemGrab,Crystal Arcade,0,27,12,39
14126,2023-01-10,BO,brawlBall,Center Stage,0,1,0,1
14127,2023-01-10,BO,brawlBall,Beach Ball,2,16,2,20
14128,2023-01-10,BO,bounty,Excel,0,7,2,9
14129,2023-01-09,BO,knockout,New Perspective,0,65,82,147
14130,2023-01-09,BO,hotZone,Dueling Beetles,0,40,32,72
14131,2023-01-09,BO,heist,Snaked Assault,0,11,0,11
14132,2023-01-09,BO,gemGrab,Minecart Madness,0,70,45,115
14133,2023-01-09,BO,gemGrab,Double Swoosh,0,31,26,57
14134,2023-01-09,BO,brawlBall,Center Stage,1,10,11,22
14135,2023-01-09,BO,brawlBall,Backyard Bowl,0,1,0,1
14136,2023-01-09,BO,bounty,Layer Cake,0,25,28,53
14137,2023-01-08,BO,knockout,X Marks the Spot,0,59,100,159
14138,2023-01-08,BO,hotZone,Ring of Fire,0,60,44,104
14139,2023-01-08,BO,heist,Snaked Assault,0,4,0,4
14140,2023-01-08,BO,gemGrab,Hard Rock Mine,0,5,5,10
14141,2023-01-08,BO,gemGrab,Double Swoosh,0,17,8,25
14142,2023-01-08,BO,brawlBall,Super Beach,0,4,0,4
14143,2023-01-08,BO,brawlBall,Backyard Bowl,2,30,35,67
14144,2023-01-08,BO,bounty,Layer Cake,0,8,6,14
14145,2023-01-07,BO,knockout,X Marks the Spot,0,44,43,87
14146,2023-01-07,BO,hotZone,Ring of Fire,0,36,27,63
14147,2023-01-07,BO,heist,Tornado Ring,0,8,8,16
14148,2023-01-07,BO,gemGrab,Hard Rock Mine,0,15,23,38
14149,2023-01-07,BO,gemGrab,Deep Diner,0,20,25,45
14150,2023-01-07,BO,brawlBall,Super Beach,0,11,11,22
14151,2023-01-07,BO,brawlBall,Sneaky Fields,0,1,0,1
14152,2023-01-07,BO,bounty,Dry Season,0,27,11,38
14153,2023-01-06,BO,knockout,Out in the Open,0,71,119,190
14154,2023-01-06,BO,hotZone,Split,0,5,1,6
14155,2023-01-06,BO,heist,Tornado Ring,0,6,3,9
14156,2023-01-06,BO,gemGrab,Undermine,0,18,16,34
14157,2023-01-06,BO,gemGrab,Deep Diner,0,48,29,77
14158,2023-01-06,BO,brawlBall,Sneaky Fields,0,12,6,18
14159,2023-01-06,BO,brawlBall,Pinhole Punt,0,4,3,7
14160,2023-01-06,BO,bounty,Dry Season,0,18,13,31
14161,2023-01-05,BO,knockout,Out in the Open,3,136,160,299
14162,2023-01-05,BO,hotZone,Split,0,15,0,15
14163,2023-01-05,BO,heist,Kaboom Canyon,0,9,0,9
14164,2023-01-05,BO,gemGrab,Undermine,0,49,63,112
14165,2023-01-05,BO,gemGrab,Gem Fort,0,2,0,2
14166,2023-01-05,BO,brawlBall,Pinhole Punt,2,51,67,120
14167,2023-01-05,BO,bounty,Shooting Star,0,12,2,14
14168,2023-01-04,BO,knockout,Goldarm Gulch,0,26,35,61
14169,2023-01-04,BO,hotZone,Parallel Plays,0,12,2,14
14170,2023-01-04,BO,heist,Kaboom Canyon,0,15,1,16
14171,2023-01-04,BO,gemGrab,Gem Fort,0,19,9,28
14172,2023-01-04,BO,gemGrab,Crystal Arcade,0,12,11,23
14173,2023-01-04,BO,brawlBall,Sunny Soccer,0,6,4,10
14174,2023-01-04,BO,bounty,Shooting Star,0,30,6,36
14175,2023-01-03,BO,knockout,Goldarm Gulch,0,25,36,61
14176,2023-01-03,BO,hotZone,Parallel Plays,0,9,0,9
14177,2023-01-03,BO,hotZone,Controller Chaos,0,1,0,1
14178,2023-01-03,BO,heist,Pit Stop,1,4,0,5
14179,2023-01-03,BO,gemGrab,Minecart Madness,0,18,5,23
14180,2023-01-03,BO,gemGrab,Crystal Arcade,0,35,8,43
14181,2023-01-03,BO,brawlBall,Beach Ball,0,21,23,44
14182,2023-01-03,BO,bounty,Hideout,0,13,0,13
14183,2023-01-02,BO,knockout,Belle's Rock,0,23,30,53
14184,2023-01-02,BO,hotZone,Quarter Pounder,0,51,9,60
14185,2023-01-02,BO,hotZone,Controller Chaos,0,1,0,1
14186,2023-01-02,BO,heist,Pit Stop,0,1,1,2
14187,2023-01-02,BO,heist,Kaboom Canyon,0,1,0,1
14188,2023-01-02,BO,gemGrab,Minecart Madness,0,71,85,156
14189,2023-01-02,BO,gemGrab,Double Swoosh,0,45,36,81
14190,2023-01-02,BO,brawlBall,Center Stage,0,19,8,27
14191,2023-01-02,BO,brawlBall,Backyard Bowl,0,3,0,3
14192,2023-01-02,BO,bounty,Hideout,0,34,10,44
14193,2023-01-01,BO,knockout,Belle's Rock,0,10,21,31
14194,2023-01-01,BO,hotZone,Quarter Pounder,0,13,1,14
14195,2023-01-01,BO,heist,Bridge Too Far,0,1,0,1
14196,2023-01-01,BO,gemGrab,Hard Rock Mine,0,0,1,1
14197,2023-01-01,BO,gemGrab,Double Swoosh,0,15,14,29
14198,2023-01-01,BO,brawlBall,Backyard Bowl,1,17,13,31
14199,2022-12-31,BO,knockout,Flaring Phoenix,0,2,2,4
14200,2022-12-31,BO,hotZone,Controller Chaos,0,2,1,3
14201,2022-12-31,BO,heist,Bridge Too Far,0,3,1,4
14202,2022-12-31,BO,gemGrab,Minecart Madness,0,1,0,1
14203,2022-12-31,BO,gemGrab,Hard Rock Mine,0,7,2,9
14204,2022-12-31,BO,gemGrab,Deep Diner,0,10,0,10
14205,2022-12-31,BO,brawlBall,Super Beach,0,0,1,1
14206,2022-12-31,BO,brawlBall,Sneaky Fields,0,1,0,1
14207,2022-12-30,BO,knockout,Flaring Phoenix,0,3,4,7
14208,2022-12-30,BO,hotZone,Controller Chaos,0,3,1,4
14209,2022-12-30,BO,gemGrab,Undermine,0,2,0,2
14210,2022-12-30,BO,gemGrab,Minecart Madness,0,0,1,1
14211,2022-12-30,BO,gemGrab,Deep Diner,0,5,2,7
14212,2022-12-30,BO,brawlBall,Sneaky Fields,0,2,1,3
14213,2022-12-29,BO,hotZone,Open Zone,0,5,2,7
14214,2022-12-29,BO,heist,Hot Potato,0,1,0,1
14215,2022-12-29,BO,gemGrab,Undermine,0,2,1,3
14216,2022-12-29,BO,gemGrab,Minecart Madness,0,1,0,1
14217,2022-12-29,BO,gemGrab,Gem Fort,0,2,2,4
14218,2022-12-29,BO,brawlBall,Pinhole Punt,0,4,11,15
14219,2022-12-28,BO,hotZone,Open Zone,0,1,0,1
14220,2022-12-28,BO,hotZone,Controller Chaos,0,1,0,1
14221,2022-12-28,BO,gemGrab,Crystal Arcade,0,0,1,1
14222,2022-12-28,BO,brawlBall,Sunny Soccer,0,0,1,1
14223,2022-12-27,BO,knockout,New Perspective,0,2,3,5
14224,2022-12-27,BO,hotZone,Dueling Beetles,0,0,1,1
14225,2022-12-27,BO,hotZone,Controller Chaos,0,1,0,1
14226,2022-12-27,BO,heist,Safe Zone,0,0,1,1
14227,2022-12-27,BO,heist,Kaboom Canyon,0,1,0,1
14228,2022-12-27,BO,gemGrab,Minecart Madness,0,0,1,1
14229,2022-12-27,BO,bounty,Excel,0,0,1,1
14230,2022-12-26,BO,heist,Kaboom Canyon,0,1,0,1
14231,2022-12-25,BO,gemGrab,Double Swoosh,0,1,0,1
14232,2022-12-25,BO,brawlBall,Backyard Bowl,0,1,0,1
14233,2022-12-24,BO,bounty,Dry Season,0,1,0,1
14234,2022-12-23,BO,knockout,Out in the Open,0,0,1,1
14235,2022-12-22,BO,gemGrab,Gem Fort,0,1,1,2
14236,2022-12-20,BO,brawlBall,Beach Ball,0,1,0,1
14237,2022-12-17,BO,knockout,Flaring Phoenix,0,2,4,6
14238,2022-12-16,BO,bounty,Temple Ruins,0,1,0,1
14239,2022-12-13,BO,knockout,New Perspective,0,2,1,3
14240,2022-12-13,BO,gemGrab,Crystal Arcade,0,3,1,4
14241,2022-12-10,BO,gemGrab,Hard Rock Mine,0,0,1,1
14242,2022-10-28,BO,bounty,Canal Grande,0,1,0,1
14243,2022-10-26,BO,bounty,Shooting Star,0,2,0,2
14244,2022-10-15,BO,gemGrab,Hard Rock Mine,0,1,2,3
14245,2023-01-30,BIBI,knockout,Belle's Rock,0,57,26,83
14246,2023-01-30,BIBI,hotZone,Quarter Pounder,0,152,105,257
14247,2023-01-30,BIBI,heist,Pit Stop,0,693,861,1554
14248,2023-01-30,BIBI,gemGrab,Minecart Madness,0,52,42,94
14249,2023-01-30,BIBI,gemGrab,Double Swoosh,0,57,41,98
14250,2023-01-30,BIBI,brawlBall,Center Stage,16,832,719,1567
14251,2023-01-30,BIBI,brawlBall,Backyard Bowl,4,64,59,127
14252,2023-01-30,BIBI,bounty,Hideout,0,4,5,9
14253,2023-01-29,BIBI,knockout,Belle's Rock,0,52,35,87
14254,2023-01-29,BIBI,hotZone,Quarter Pounder,1,81,64,146
14255,2023-01-29,BIBI,heist,Bridge Too Far,0,32,44,76
14256,2023-01-29,BIBI,gemGrab,Hard Rock Mine,0,29,22,51
14257,2023-01-29,BIBI,gemGrab,Double Swoosh,0,100,71,171
14258,2023-01-29,BIBI,brawlBall,Super Beach,0,23,28,51
14259,2023-01-29,BIBI,brawlBall,Backyard Bowl,11,615,471,1097
14260,2023-01-29,BIBI,bounty,Canal Grande,0,51,30,81
14261,2023-01-28,BIBI,knockout,Flaring Phoenix,1,25,18,44
14262,2023-01-28,BIBI,hotZone,Controller Chaos,0,164,110,274
14263,2023-01-28,BIBI,heist,Bridge Too Far,0,74,57,131
14264,2023-01-28,BIBI,gemGrab,Hard Rock Mine,0,110,119,229
14265,2023-01-28,BIBI,gemGrab,Deep Diner,0,24,14,38
14266,2023-01-28,BIBI,brawlBall,Super Beach,31,1697,1574,3302
14267,2023-01-28,BIBI,brawlBall,Sneaky Fields,1,57,40,98
14268,2023-01-28,BIBI,bounty,Canal Grande,0,64,36,100
14269,2023-01-27,BIBI,knockout,Flaring Phoenix,0,9,4,13
14270,2023-01-27,BIBI,hotZone,Controller Chaos,0,35,37,72
14271,2023-01-27,BIBI,heist,Hot Potato,2,116,148,266
14272,2023-01-27,BIBI,gemGrab,Undermine,0,5,4,9
14273,2023-01-27,BIBI,gemGrab,Deep Diner,0,29,21,50
14274,2023-01-27,BIBI,brawlBall,Sneaky Fields,9,458,435,902
14275,2023-01-27,BIBI,brawlBall,Pinhole Punt,0,9,9,18
14276,2023-01-27,BIBI,bounty,Temple Ruins,0,5,13,18
14277,2023-01-26,BIBI,knockout,Riverside,0,14,6,20
14278,2023-01-26,BIBI,hotZone,Open Zone,0,36,20,56
14279,2023-01-26,BIBI,heist,Hot Potato,2,694,721,1417
14280,2023-01-26,BIBI,gemGrab,Undermine,0,58,51,109
14281,2023-01-26,BIBI,gemGrab,Gem Fort,0,30,21,51
14282,2023-01-26,BIBI,brawlBall,Sunny Soccer,0,74,61,135
14283,2023-01-26,BIBI,brawlBall,Pinhole Punt,26,1025,932,1983
14284,2023-01-26,BIBI,bounty,Temple Ruins,0,22,9,31
14285,2023-01-25,BIBI,knockout,Riverside,0,10,6,16
14286,2023-01-25,BIBI,hotZone,Open Zone,0,13,8,21
14287,2023-01-25,BIBI,heist,Safe Zone,1,72,113,186
14288,2023-01-25,BIBI,gemGrab,Gem Fort,0,37,45,82
14289,2023-01-25,BIBI,gemGrab,Crystal Arcade,0,55,59,114
14290,2023-01-25,BIBI,brawlBall,Sunny Soccer,14,861,743,1618
14291,2023-01-25,BIBI,brawlBall,Beach Ball,1,97,83,181
14292,2023-01-25,BIBI,bounty,Excel,0,27,40,67
14293,2023-01-24,BIBI,knockout,New Perspective,0,24,9,33
14294,2023-01-24,BIBI,hotZone,Dueling Beetles,0,81,42,123
14295,2023-01-24,BIBI,heist,Safe Zone,0,160,181,341
14296,2023-01-24,BIBI,gemGrab,Minecart Madness,0,19,19,38
14297,2023-01-24,BIBI,gemGrab,Crystal Arcade,0,80,72,152
14298,2023-01-24,BIBI,brawlBall,Center Stage,4,128,81,213
14299,2023-01-24,BIBI,brawlBall,Beach Ball,28,1216,1039,2283
14300,2023-01-24,BIBI,bounty,Excel,0,51,40,91
14301,2023-01-23,BIBI,knockout,New Perspective,0,42,26,68
14302,2023-01-23,BIBI,hotZone,Dueling Beetles,0,101,123,224
14303,2023-01-23,BIBI,heist,Snaked Assault,1,482,556,1039
14304,2023-01-23,BIBI,gemGrab,Minecart Madness,0,113,65,178
14305,2023-01-23,BIBI,gemGrab,Double Swoosh,0,34,23,57
14306,2023-01-23,BIBI,brawlBall,Center Stage,43,1619,1348,3010
14307,2023-01-23,BIBI,brawlBall,Backyard Bowl,0,38,23,61
14308,2023-01-23,BIBI,bounty,Layer Cake,0,60,38,98
14309,2023-01-22,BIBI,knockout,X Marks the Spot,0,17,8,25
14310,2023-01-22,BIBI,hotZone,Ring of Fire,0,16,11,27
14311,2023-01-22,BIBI,heist,Snaked Assault,3,287,284,574
14312,2023-01-22,BIBI,gemGrab,Hard Rock Mine,0,34,19,53
14313,2023-01-22,BIBI,gemGrab,Double Swoosh,0,52,38,90
14314,2023-01-22,BIBI,brawlBall,Super Beach,6,166,159,331
14315,2023-01-22,BIBI,brawlBall,Backyard Bowl,9,288,260,557
14316,2023-01-22,BIBI,bounty,Layer Cake,0,25,30,55
14317,2023-01-21,BIBI,knockout,X Marks the Spot,1,63,34,98
14318,2023-01-21,BIBI,hotZone,Ring of Fire,0,38,34,72
14319,2023-01-21,BIBI,heist,Tornado Ring,2,535,614,1151
14320,2023-01-21,BIBI,gemGrab,Hard Rock Mine,0,129,113,242
14321,2023-01-21,BIBI,gemGrab,Deep Diner,0,25,10,35
14322,2023-01-21,BIBI,brawlBall,Super Beach,43,2166,2053,4262
14323,2023-01-21,BIBI,brawlBall,Sneaky Fields,0,70,65,135
14324,2023-01-21,BIBI,bounty,Dry Season,0,23,15,38
14325,2023-01-20,BIBI,knockout,Out in the Open,0,32,19,51
14326,2023-01-20,BIBI,hotZone,Split,0,179,198,377
14327,2023-01-20,BIBI,heist,Tornado Ring,4,713,826,1543
14328,2023-01-20,BIBI,gemGrab,Undermine,0,27,14,41
14329,2023-01-20,BIBI,gemGrab,Deep Diner,0,99,92,191
14330,2023-01-20,BIBI,brawlBall,Sneaky Fields,24,1690,1510,3224
14331,2023-01-20,BIBI,brawlBall,Pinhole Punt,0,38,44,82
14332,2023-01-20,BIBI,bounty,Dry Season,0,15,14,29
14333,2023-01-19,BIBI,knockout,Out in the Open,0,35,24,59
14334,2023-01-19,BIBI,hotZone,Split,0,300,291,591
14335,2023-01-19,BIBI,heist,Kaboom Canyon,0,71,62,133
14336,2023-01-19,BIBI,gemGrab,Undermine,0,91,81,172
14337,2023-01-19,BIBI,gemGrab,Gem Fort,0,18,10,28
14338,2023-01-19,BIBI,brawlBall,Sunny Soccer,0,54,44,98
14339,2023-01-19,BIBI,brawlBall,Pinhole Punt,23,1135,962,2120
14340,2023-01-19,BIBI,bounty,Shooting Star,0,13,5,18
14341,2023-01-18,BIBI,knockout,Goldarm Gulch,0,4,2,6
14342,2023-01-18,BIBI,hotZone,Parallel Plays,0,12,11,23
14343,2023-01-18,BIBI,heist,Kaboom Canyon,0,22,15,37
14344,2023-01-18,BIBI,gemGrab,Gem Fort,0,15,12,27
14345,2023-01-18,BIBI,gemGrab,Crystal Arcade,0,5,1,6
14346,2023-01-18,BIBI,brawlBall,Sunny Soccer,9,396,392,797
14347,2023-01-18,BIBI,brawlBall,Beach Ball,0,16,15,31
14348,2023-01-18,BIBI,bounty,Shooting Star,0,5,3,8
14349,2023-01-17,BIBI,knockout,Goldarm Gulch,0,3,6,9
14350,2023-01-17,BIBI,hotZone,Parallel Plays,0,11,10,21
14351,2023-01-17,BIBI,heist,Pit Stop,0,53,74,127
14352,2023-01-17,BIBI,gemGrab,Minecart Madness,0,1,1,2
14353,2023-01-17,BIBI,gemGrab,Crystal Arcade,0,11,5,16
14354,2023-01-17,BIBI,brawlBall,Center Stage,0,7,2,9
14355,2023-01-17,BIBI,brawlBall,Beach Ball,2,125,105,232
14356,2023-01-17,BIBI,bounty,Hideout,0,2,3,5
14357,2023-01-16,BIBI,knockout,Belle's Rock,0,1,3,4
14358,2023-01-16,BIBI,hotZone,Quarter Pounder,0,13,10,23
14359,2023-01-16,BIBI,heist,Pit Stop,0,247,295,542
14360,2023-01-16,BIBI,gemGrab,Minecart Madness,0,10,5,15
14361,2023-01-16,BIBI,gemGrab,Double Swoosh,0,3,0,3
14362,2023-01-16,BIBI,brawlBall,Center Stage,1,104,87,192
14363,2023-01-16,BIBI,brawlBall,Backyard Bowl,0,9,5,14
14364,2023-01-16,BIBI,bounty,Hideout,0,4,2,6
14365,2023-01-15,BIBI,knockout,Belle's Rock,0,9,2,11
14366,2023-01-15,BIBI,hotZone,Quarter Pounder,0,40,8,48
14367,2023-01-15,BIBI,heist,Bridge Too Far,0,14,15,29
14368,2023-01-15,BIBI,gemGrab,Hard Rock Mine,0,6,0,6
14369,2023-01-15,BIBI,gemGrab,Double Swoosh,0,13,4,17
14370,2023-01-15,BIBI,brawlBall,Super Beach,0,22,23,45
14371,2023-01-15,BIBI,brawlBall,Backyard Bowl,2,79,39,120
14372,2023-01-15,BIBI,bounty,Canal Grande,0,8,2,10
14373,2023-01-14,BIBI,hotZone,Controller Chaos,0,36,39,75
14374,2023-01-14,BIBI,heist,Bridge Too Far,0,18,17,35
14375,2023-01-14,BIBI,gemGrab,Hard Rock Mine,0,4,0,4
14376,2023-01-14,BIBI,gemGrab,Deep Diner,0,2,1,3
14377,2023-01-14,BIBI,brawlBall,Super Beach,1,129,98,228
14378,2023-01-14,BIBI,brawlBall,Sneaky Fields,0,12,13,25
14379,2023-01-14,BIBI,bounty,Canal Grande,0,7,4,11
14380,2023-01-13,BIBI,knockout,Flaring Phoenix,0,1,1,2
14381,2023-01-13,BIBI,hotZone,Controller Chaos,0,22,19,41
14382,2023-01-13,BIBI,heist,Hot Potato,0,25,23,48
14383,2023-01-13,BIBI,gemGrab,Undermine,0,1,0,1
14384,2023-01-13,BIBI,gemGrab,Deep Diner,0,11,1,12
14385,2023-01-13,BIBI,brawlBall,Sneaky Fields,1,83,54,138
14386,2023-01-13,BIBI,brawlBall,Pinhole Punt,0,3,0,3
14387,2023-01-13,BIBI,bounty,Temple Ruins,0,2,0,2
14388,2023-01-12,BIBI,knockout,Riverside,0,1,0,1
14389,2023-01-12,BIBI,hotZone,Open Zone,0,3,0,3
14390,2023-01-12,BIBI,heist,Hot Potato,0,19,5,24
14391,2023-01-12,BIBI,gemGrab,Undermine,0,0,1,1
14392,2023-01-12,BIBI,brawlBall,Sunny Soccer,0,2,2,4
14393,2023-01-12,BIBI,brawlBall,Pinhole Punt,1,34,34,69
14394,2023-01-11,BIBI,hotZone,Open Zone,0,2,0,2
14395,2023-01-11,BIBI,gemGrab,Gem Fort,0,1,0,1
14396,2023-01-11,BIBI,brawlBall,Sunny Soccer,1,29,27,57
14397,2023-01-11,BIBI,brawlBall,Beach Ball,0,0,1,1
14398,2023-01-11,BIBI,bounty,Excel,0,4,0,4
14399,2023-01-10,BIBI,hotZone,Dueling Beetles,0,19,5,24
14400,2023-01-10,BIBI,heist,Safe Zone,0,9,3,12
14401,2023-01-10,BIBI,gemGrab,Minecart Madness,0,5,0,5
14402,2023-01-10,BIBI,gemGrab,Crystal Arcade,0,11,8,19
14403,2023-01-10,BIBI,brawlBall,Center Stage,0,10,0,10
14404,2023-01-10,BIBI,brawlBall,Beach Ball,1,69,32,102
14405,2023-01-10,BIBI,bounty,Excel,0,2,0,2
14406,2023-01-09,BIBI,knockout,New Perspective,0,3,0,3
14407,2023-01-09,BIBI,hotZone,Dueling Beetles,0,12,2,14
14408,2023-01-09,BIBI,heist,Snaked Assault,0,44,129,173
14409,2023-01-09,BIBI,gemGrab,Minecart Madness,0,8,1,9
14410,2023-01-09,BIBI,gemGrab,Double Swoosh,0,2,1,3
14411,2023-01-09,BIBI,brawlBall,Center Stage,0,90,50,140
14412,2023-01-09,BIBI,brawlBall,Backyard Bowl,0,3,3,6
14413,2023-01-09,BIBI,bounty,Layer Cake,0,4,0,4
14414,2023-01-08,BIBI,knockout,X Marks the Spot,0,7,0,7
14415,2023-01-08,BIBI,hotZone,Ring of Fire,0,4,2,6
14416,2023-01-08,BIBI,heist,Snaked Assault,0,61,52,113
14417,2023-01-08,BIBI,gemGrab,Hard Rock Mine,0,4,1,5
14418,2023-01-08,BIBI,gemGrab,Double Swoosh,0,1,0,1
14419,2023-01-08,BIBI,brawlBall,Super Beach,2,19,17,38
14420,2023-01-08,BIBI,brawlBall,Backyard Bowl,0,39,14,53
14421,2023-01-08,BIBI,bounty,Layer Cake,0,2,0,2
14422,2023-01-07,BIBI,hotZone,Ring of Fire,0,1,0,1
14423,2023-01-07,BIBI,heist,Tornado Ring,1,48,67,116
14424,2023-01-07,BIBI,gemGrab,Hard Rock Mine,0,4,2,6
14425,2023-01-07,BIBI,gemGrab,Deep Diner,0,1,1,2
14426,2023-01-07,BIBI,brawlBall,Super Beach,0,44,41,85
14427,2023-01-07,BIBI,brawlBall,Sneaky Fields,0,3,1,4
14428,2023-01-07,BIBI,bounty,Dry Season,0,2,0,2
14429,2023-01-06,BIBI,hotZone,Split,0,20,26,46
14430,2023-01-06,BIBI,heist,Tornado Ring,2,133,132,267
14431,2023-01-06,BIBI,gemGrab,Deep Diner,0,12,1,13
14432,2023-01-06,BIBI,brawlBall,Sneaky Fields,0,71,25,96
14433,2023-01-06,BIBI,brawlBall,Pinhole Punt,0,9,4,13
14434,2023-01-06,BIBI,bounty,Dry Season,0,4,0,4
14435,2023-01-05,BIBI,knockout,Out in the Open,0,1,0,1
14436,2023-01-05,BIBI,hotZone,Split,0,69,60,129
14437,2023-01-05,BIBI,heist,Kaboom Canyon,0,16,4,20
14438,2023-01-05,BIBI,gemGrab,Undermine,0,9,3,12
14439,2023-01-05,BIBI,gemGrab,Gem Fort,0,0,1,1
14440,2023-01-05,BIBI,brawlBall,Sunny Soccer,0,2,1,3
14441,2023-01-05,BIBI,brawlBall,Pinhole Punt,0,102,57,159
14442,2023-01-04,BIBI,knockout,Goldarm Gulch,0,4,2,6
14443,2023-01-04,BIBI,hotZone,Parallel Plays,0,11,9,20
14444,2023-01-04,BIBI,heist,Kaboom Canyon,0,12,2,14
14445,2023-01-04,BIBI,gemGrab,Gem Fort,0,5,1,6
14446,2023-01-04,BIBI,gemGrab,Crystal Arcade,0,4,1,5
14447,2023-01-04,BIBI,brawlBall,Sunny Soccer,1,116,57,174
14448,2023-01-04,BIBI,brawlBall,Beach Ball,0,1,0,1
14449,2023-01-04,BIBI,bounty,Shooting Star,0,7,3,10
14450,2023-01-03,BIBI,knockout,Goldarm Gulch,0,3,0,3
14451,2023-01-03,BIBI,hotZone,Parallel Plays,0,26,6,32
14452,2023-01-03,BIBI,heist,Pit Stop,0,113,93,206
14453,2023-01-03,BIBI,gemGrab,Minecart Madness,0,3,0,3
14454,2023-01-03,BIBI,gemGrab,Crystal Arcade,0,5,3,8
14455,2023-01-03,BIBI,brawlBall,Center Stage,0,3,1,4
14456,2023-01-03,BIBI,brawlBall,Beach Ball,3,98,73,174
14457,2023-01-03,BIBI,bounty,Hideout,0,1,2,3
14458,2023-01-02,BIBI,knockout,Belle's Rock,0,5,1,6
14459,2023-01-02,BIBI,hotZone,Quarter Pounder,0,14,3,17
14460,2023-01-02,BIBI,heist,Pit Stop,0,221,176,397
14461,2023-01-02,BIBI,gemGrab,Minecart Madness,0,14,0,14
14462,2023-01-02,BIBI,gemGrab,Double Swoosh,0,2,2,4
14463,2023-01-02,BIBI,brawlBall,Center Stage,2,73,56,131
14464,2023-01-02,BIBI,brawlBall,Backyard Bowl,0,6,6,12
14465,2023-01-02,BIBI,bounty,Hideout,0,5,0,5
14466,2023-01-01,BIBI,knockout,Belle's Rock,0,4,11,15
14467,2023-01-01,BIBI,hotZone,Quarter Pounder,0,10,10,20
14468,2023-01-01,BIBI,hotZone,Controller Chaos,0,0,1,1
14469,2023-01-01,BIBI,heist,Kaboom Canyon,0,0,1,1
14470,2023-01-01,BIBI,heist,Bridge Too Far,0,3,0,3
14471,2023-01-01,BIBI,gemGrab,Double Swoosh,0,1,4,5
14472,2023-01-01,BIBI,brawlBall,Backyard Bowl,1,16,16,33
14473,2023-01-01,BIBI,bounty,Canal Grande,0,2,0,2
14474,2022-12-31,BIBI,hotZone,Controller Chaos,0,3,2,5
14475,2022-12-31,BIBI,heist,Bridge Too Far,0,1,0,1
14476,2022-12-31,BIBI,gemGrab,Hard Rock Mine,0,1,0,1
14477,2022-12-31,BIBI,gemGrab,Deep Diner,0,5,1,6
14478,2022-12-31,BIBI,brawlBall,Super Beach,0,7,4,11
14479,2022-12-31,BIBI,brawlBall,Sneaky Fields,0,1,0,1
14480,2022-12-30,BIBI,hotZone,Controller Chaos,0,3,0,3
14481,2022-12-30,BIBI,heist,Hot Potato,0,1,2,3
14482,2022-12-30,BIBI,gemGrab,Deep Diner,0,1,1,2
14483,2022-12-30,BIBI,brawlBall,Sneaky Fields,0,14,8,22
14484,2022-12-29,BIBI,heist,Hot Potato,0,6,0,6
14485,2022-12-29,BIBI,brawlBall,Pinhole Punt,0,3,4,7
14486,2022-12-28,BIBI,brawlBall,Sunny Soccer,0,4,0,4
14487,2022-12-27,BIBI,heist,Safe Zone,0,0,1,1
14488,2022-12-27,BIBI,brawlBall,Beach Ball,0,3,6,9
14489,2022-12-26,BIBI,hotZone,Controller Chaos,0,1,0,1
14490,2022-12-26,BIBI,heist,Kaboom Canyon,0,1,0,1
14491,2022-12-25,BIBI,brawlBall,Backyard Bowl,0,1,0,1
14492,2022-12-24,BIBI,brawlBall,Super Beach,0,0,2,2
14493,2022-12-22,BIBI,heist,Kaboom Canyon,0,1,0,1
14494,2022-12-21,BIBI,brawlBall,Sunny Soccer,0,1,0,1
14495,2022-12-20,BIBI,brawlBall,Beach Ball,0,2,3,5
14496,2022-12-19,BIBI,brawlBall,Center Stage,0,2,0,2
14497,2022-12-13,BIBI,heist,Safe Zone,0,0,1,1
14498,2022-12-13,BIBI,gemGrab,Crystal Arcade,0,1,1,2
14499,2022-12-13,BIBI,brawlBall,Beach Ball,0,1,0,1
14500,2022-11-11,BIBI,brawlBall,Sneaky Fields,0,2,0,2
14501,2022-10-28,BIBI,brawlBall,Beach Ball,0,1,0,1
14502,2022-10-26,BIBI,brawlBall,Sunny Soccer,0,0,1,1
14503,2023-01-30,BELLE,knockout,Belle's Rock,0,294,301,595
14504,2023-01-30,BELLE,hotZone,Quarter Pounder,0,51,121,172
14505,2023-01-30,BELLE,heist,Pit Stop,0,3,0,3
14506,2023-01-30,BELLE,gemGrab,Minecart Madness,0,113,173,286
14507,2023-01-30,BELLE,gemGrab,Double Swoosh,0,18,14,32
14508,2023-01-30,BELLE,brawlBall,Center Stage,2,43,41,86
14509,2023-01-30,BELLE,brawlBall,Backyard Bowl,3,40,48,91
14510,2023-01-30,BELLE,bounty,Hideout,0,85,103,188
14511,2023-01-29,BELLE,knockout,Belle's Rock,0,318,368,686
14512,2023-01-29,BELLE,hotZone,Quarter Pounder,1,33,27,61
14513,2023-01-29,BELLE,heist,Bridge Too Far,1,253,239,493
14514,2023-01-29,BELLE,gemGrab,Hard Rock Mine,0,13,13,26
14515,2023-01-29,BELLE,gemGrab,Double Swoosh,0,42,33,75
14516,2023-01-29,BELLE,brawlBall,Super Beach,0,2,0,2
14517,2023-01-29,BELLE,brawlBall,Backyard Bowl,45,602,726,1373
14518,2023-01-29,BELLE,bounty,Canal Grande,0,14,13,27
14519,2023-01-28,BELLE,knockout,Flaring Phoenix,0,90,81,171
14520,2023-01-28,BELLE,hotZone,Controller Chaos,0,9,7,16
14521,2023-01-28,BELLE,heist,Bridge Too Far,6,652,620,1278
14522,2023-01-28,BELLE,gemGrab,Hard Rock Mine,0,125,142,267
14523,2023-01-28,BELLE,gemGrab,Deep Diner,0,42,69,111
14524,2023-01-28,BELLE,brawlBall,Super Beach,5,170,189,364
14525,2023-01-28,BELLE,brawlBall,Sneaky Fields,0,4,0,4
14526,2023-01-28,BELLE,bounty,Canal Grande,0,30,27,57
14527,2023-01-27,BELLE,knockout,Flaring Phoenix,0,31,31,62
14528,2023-01-27,BELLE,hotZone,Controller Chaos,0,1,4,5
14529,2023-01-27,BELLE,heist,Hot Potato,0,8,8,16
14530,2023-01-27,BELLE,gemGrab,Undermine,0,5,1,6
14531,2023-01-27,BELLE,gemGrab,Deep Diner,0,41,45,86
14532,2023-01-27,BELLE,brawlBall,Sneaky Fields,3,37,41,81
14533,2023-01-27,BELLE,brawlBall,Pinhole Punt,0,6,1,7
14534,2023-01-27,BELLE,bounty,Temple Ruins,0,13,4,17
14535,2023-01-26,BELLE,knockout,Riverside,1,435,446,882
14536,2023-01-26,BELLE,hotZone,Open Zone,0,100,135,235
14537,2023-01-26,BELLE,heist,Hot Potato,0,6,4,10
14538,2023-01-26,BELLE,gemGrab,Undermine,0,46,59,105
14539,2023-01-26,BELLE,gemGrab,Gem Fort,0,9,4,13
14540,2023-01-26,BELLE,brawlBall,Sunny Soccer,0,6,4,10
14541,2023-01-26,BELLE,brawlBall,Pinhole Punt,6,165,196,367
14542,2023-01-26,BELLE,bounty,Temple Ruins,0,43,59,102
14543,2023-01-25,BELLE,knockout,Riverside,0,221,198,419
14544,2023-01-25,BELLE,hotZone,Open Zone,0,53,62,115
14545,2023-01-25,BELLE,heist,Safe Zone,1,163,174,338
14546,2023-01-25,BELLE,gemGrab,Gem Fort,0,12,11,23
14547,2023-01-25,BELLE,gemGrab,Crystal Arcade,0,58,45,103
14548,2023-01-25,BELLE,brawlBall,Sunny Soccer,2,36,49,87
14549,2023-01-25,BELLE,brawlBall,Beach Ball,0,7,7,14
14550,2023-01-25,BELLE,bounty,Excel,0,32,90,122
14551,2023-01-24,BELLE,knockout,New Perspective,0,101,113,214
14552,2023-01-24,BELLE,hotZone,Dueling Beetles,0,41,62,103
14553,2023-01-24,BELLE,heist,Safe Zone,4,253,263,520
14554,2023-01-24,BELLE,gemGrab,Minecart Madness,0,42,55,97
14555,2023-01-24,BELLE,gemGrab,Crystal Arcade,0,87,89,176
14556,2023-01-24,BELLE,brawlBall,Center Stage,0,7,6,13
14557,2023-01-24,BELLE,brawlBall,Beach Ball,1,92,86,179
14558,2023-01-24,BELLE,bounty,Excel,0,61,121,182
14559,2023-01-23,BELLE,knockout,New Perspective,0,157,168,325
14560,2023-01-23,BELLE,hotZone,Dueling Beetles,1,72,87,160
14561,2023-01-23,BELLE,heist,Snaked Assault,0,13,5,18
14562,2023-01-23,BELLE,gemGrab,Minecart Madness,0,179,233,412
14563,2023-01-23,BELLE,gemGrab,Double Swoosh,0,11,12,23
14564,2023-01-23,BELLE,brawlBall,Center Stage,6,83,68,157
14565,2023-01-23,BELLE,brawlBall,Backyard Bowl,0,58,51,109
14566,2023-01-23,BELLE,bounty,Layer Cake,0,51,73,124
14567,2023-01-22,BELLE,knockout,X Marks the Spot,1,102,105,208
14568,2023-01-22,BELLE,hotZone,Ring of Fire,0,31,36,67
14569,2023-01-22,BELLE,heist,Snaked Assault,0,13,5,18
14570,2023-01-22,BELLE,gemGrab,Hard Rock Mine,0,28,11,39
14571,2023-01-22,BELLE,gemGrab,Double Swoosh,0,15,18,33
14572,2023-01-22,BELLE,brawlBall,Super Beach,0,24,15,39
14573,2023-01-22,BELLE,brawlBall,Backyard Bowl,28,316,358,702
14574,2023-01-22,BELLE,bounty,Layer Cake,0,43,39,82
14575,2023-01-21,BELLE,knockout,X Marks the Spot,1,366,387,754
14576,2023-01-21,BELLE,hotZone,Ring of Fire,0,104,96,200
14577,2023-01-21,BELLE,heist,Tornado Ring,0,11,2,13
14578,2023-01-21,BELLE,gemGrab,Hard Rock Mine,0,176,196,372
14579,2023-01-21,BELLE,gemGrab,Deep Diner,0,15,20,35
14580,2023-01-21,BELLE,brawlBall,Super Beach,10,207,255,472
14581,2023-01-21,BELLE,brawlBall,Sneaky Fields,0,4,3,7
14582,2023-01-21,BELLE,bounty,Dry Season,0,238,195,433
14583,2023-01-20,BELLE,knockout,Out in the Open,0,276,272,548
14584,2023-01-20,BELLE,hotZone,Split,0,3,5,8
14585,2023-01-20,BELLE,heist,Tornado Ring,0,6,8,14
14586,2023-01-20,BELLE,gemGrab,Undermine,0,20,29,49
14587,2023-01-20,BELLE,gemGrab,Deep Diner,0,92,121,213
14588,2023-01-20,BELLE,brawlBall,Sneaky Fields,1,75,69,145
14589,2023-01-20,BELLE,brawlBall,Pinhole Punt,0,17,23,40
14590,2023-01-20,BELLE,bounty,Dry Season,0,186,190,376
14591,2023-01-19,BELLE,knockout,Out in the Open,0,319,303,622
14592,2023-01-19,BELLE,hotZone,Split,0,8,3,11
14593,2023-01-19,BELLE,heist,Kaboom Canyon,0,71,61,132
14594,2023-01-19,BELLE,gemGrab,Undermine,0,75,84,159
14595,2023-01-19,BELLE,gemGrab,Gem Fort,0,8,6,14
14596,2023-01-19,BELLE,brawlBall,Sunny Soccer,0,3,8,11
14597,2023-01-19,BELLE,brawlBall,Pinhole Punt,10,207,226,443
14598,2023-01-19,BELLE,bounty,Shooting Star,0,229,247,476
14599,2023-01-18,BELLE,knockout,Goldarm Gulch,0,23,38,61
14600,2023-01-18,BELLE,hotZone,Parallel Plays,0,2,0,2
14601,2023-01-18,BELLE,heist,Kaboom Canyon,1,35,34,70
14602,2023-01-18,BELLE,gemGrab,Gem Fort,0,6,8,14
14603,2023-01-18,BELLE,gemGrab,Crystal Arcade,0,6,7,13
14604,2023-01-18,BELLE,brawlBall,Sunny Soccer,0,12,17,29
14605,2023-01-18,BELLE,bounty,Shooting Star,0,108,93,201
14606,2023-01-17,BELLE,knockout,Goldarm Gulch,0,20,37,57
14607,2023-01-17,BELLE,hotZone,Parallel Plays,0,5,3,8
14608,2023-01-17,BELLE,gemGrab,Minecart Madness,0,1,5,6
14609,2023-01-17,BELLE,gemGrab,Crystal Arcade,0,9,10,19
14610,2023-01-17,BELLE,brawlBall,Beach Ball,0,8,5,13
14611,2023-01-17,BELLE,bounty,Hideout,0,7,41,48
14612,2023-01-16,BELLE,knockout,Belle's Rock,0,34,30,64
14613,2023-01-16,BELLE,hotZone,Quarter Pounder,0,4,11,15
14614,2023-01-16,BELLE,gemGrab,Minecart Madness,0,15,26,41
14615,2023-01-16,BELLE,gemGrab,Double Swoosh,0,0,1,1
14616,2023-01-16,BELLE,brawlBall,Center Stage,0,4,0,4
14617,2023-01-16,BELLE,brawlBall,Backyard Bowl,0,10,14,24
14618,2023-01-16,BELLE,bounty,Hideout,0,28,45,73
14619,2023-01-15,BELLE,knockout,Belle's Rock,0,41,46,87
14620,2023-01-15,BELLE,hotZone,Quarter Pounder,0,15,45,60
14621,2023-01-15,BELLE,heist,Bridge Too Far,0,70,48,118
14622,2023-01-15,BELLE,gemGrab,Hard Rock Mine,0,7,1,8
14623,2023-01-15,BELLE,gemGrab,Double Swoosh,0,4,4,8
14624,2023-01-15,BELLE,brawlBall,Super Beach,0,1,1,2
14625,2023-01-15,BELLE,brawlBall,Backyard Bowl,4,105,120,229
14626,2023-01-15,BELLE,bounty,Canal Grande,0,3,9,12
14627,2023-01-14,BELLE,knockout,Flaring Phoenix,0,6,2,8
14628,2023-01-14,BELLE,hotZone,Controller Chaos,0,2,2,4
14629,2023-01-14,BELLE,heist,Bridge Too Far,0,61,97,158
14630,2023-01-14,BELLE,gemGrab,Hard Rock Mine,0,16,20,36
14631,2023-01-14,BELLE,gemGrab,Deep Diner,0,2,2,4
14632,2023-01-14,BELLE,brawlBall,Super Beach,1,2,13,16
14633,2023-01-14,BELLE,brawlBall,Sneaky Fields,0,3,0,3
14634,2023-01-14,BELLE,bounty,Canal Grande,0,4,0,4
14635,2023-01-13,BELLE,knockout,Flaring Phoenix,0,9,1,10
14636,2023-01-13,BELLE,hotZone,Controller Chaos,0,0,2,2
14637,2023-01-13,BELLE,gemGrab,Deep Diner,0,3,5,8
14638,2023-01-13,BELLE,brawlBall,Sneaky Fields,0,7,2,9
14639,2023-01-13,BELLE,bounty,Temple Ruins,0,0,1,1
14640,2023-01-12,BELLE,knockout,Riverside,0,45,74,119
14641,2023-01-12,BELLE,hotZone,Open Zone,0,10,6,16
14642,2023-01-12,BELLE,gemGrab,Undermine,0,0,1,1
14643,2023-01-12,BELLE,gemGrab,Gem Fort,0,0,1,1
14644,2023-01-12,BELLE,brawlBall,Pinhole Punt,0,11,16,27
14645,2023-01-11,BELLE,knockout,Riverside,0,6,1,7
14646,2023-01-11,BELLE,hotZone,Open Zone,0,2,1,3
14647,2023-01-11,BELLE,heist,Safe Zone,0,0,3,3
14648,2023-01-11,BELLE,gemGrab,Gem Fort,0,1,4,5
14649,2023-01-11,BELLE,brawlBall,Beach Ball,0,0,1,1
14650,2023-01-11,BELLE,bounty,Excel,0,1,0,1
14651,2023-01-10,BELLE,knockout,New Perspective,0,7,21,28
14652,2023-01-10,BELLE,hotZone,Dueling Beetles,0,13,9,22
14653,2023-01-10,BELLE,heist,Safe Zone,0,26,23,49
14654,2023-01-10,BELLE,gemGrab,Minecart Madness,0,7,2,9
14655,2023-01-10,BELLE,gemGrab,Crystal Arcade,0,20,15,35
14656,2023-01-10,BELLE,brawlBall,Center Stage,0,0,3,3
14657,2023-01-10,BELLE,brawlBall,Beach Ball,0,7,3,10
14658,2023-01-10,BELLE,bounty,Excel,0,1,0,1
14659,2023-01-09,BELLE,knockout,New Perspective,0,3,13,16
14660,2023-01-09,BELLE,hotZone,Dueling Beetles,0,7,20,27
14661,2023-01-09,BELLE,heist,Snaked Assault,0,2,0,2
14662,2023-01-09,BELLE,gemGrab,Minecart Madness,0,33,20,53
14663,2023-01-09,BELLE,gemGrab,Double Swoosh,0,1,6,7
14664,2023-01-09,BELLE,brawlBall,Center Stage,0,1,8,9
14665,2023-01-09,BELLE,brawlBall,Backyard Bowl,0,6,3,9
14666,2023-01-09,BELLE,bounty,Layer Cake,0,17,17,34
14667,2023-01-08,BELLE,knockout,X Marks the Spot,0,16,30,46
14668,2023-01-08,BELLE,hotZone,Ring of Fire,0,10,26,36
14669,2023-01-08,BELLE,heist,Snaked Assault,0,1,0,1
14670,2023-01-08,BELLE,gemGrab,Hard Rock Mine,0,6,2,8
14671,2023-01-08,BELLE,brawlBall,Super Beach,1,3,13,17
14672,2023-01-08,BELLE,brawlBall,Backyard Bowl,0,54,63,117
14673,2023-01-08,BELLE,bounty,Layer Cake,0,7,10,17
14674,2023-01-07,BELLE,knockout,X Marks the Spot,0,22,23,45
14675,2023-01-07,BELLE,hotZone,Ring of Fire,0,5,13,18
14676,2023-01-07,BELLE,gemGrab,Hard Rock Mine,0,8,11,19
14677,2023-01-07,BELLE,gemGrab,Deep Diner,0,4,5,9
14678,2023-01-07,BELLE,brawlBall,Super Beach,0,8,4,12
14679,2023-01-07,BELLE,bounty,Dry Season,0,25,39,64
14680,2023-01-06,BELLE,knockout,Out in the Open,0,25,23,48
14681,2023-01-06,BELLE,hotZone,Split,0,2,0,2
14682,2023-01-06,BELLE,heist,Tornado Ring,0,3,12,15
14683,2023-01-06,BELLE,gemGrab,Undermine,0,4,10,14
14684,2023-01-06,BELLE,gemGrab,Deep Diner,0,11,8,19
14685,2023-01-06,BELLE,brawlBall,Sneaky Fields,0,4,2,6
14686,2023-01-06,BELLE,bounty,Dry Season,0,39,50,89
14687,2023-01-05,BELLE,knockout,Out in the Open,0,46,69,115
14688,2023-01-05,BELLE,hotZone,Split,0,1,0,1
14689,2023-01-05,BELLE,heist,Kaboom Canyon,0,2,3,5
14690,2023-01-05,BELLE,gemGrab,Undermine,0,8,14,22
14691,2023-01-05,BELLE,brawlBall,Pinhole Punt,0,35,41,76
14692,2023-01-05,BELLE,bounty,Shooting Star,0,32,46,78
14693,2023-01-04,BELLE,knockout,Goldarm Gulch,0,8,4,12
14694,2023-01-04,BELLE,heist,Kaboom Canyon,0,19,19,38
14695,2023-01-04,BELLE,gemGrab,Gem Fort,0,4,1,5
14696,2023-01-04,BELLE,gemGrab,Crystal Arcade,0,2,0,2
14697,2023-01-04,BELLE,brawlBall,Sunny Soccer,0,5,1,6
14698,2023-01-04,BELLE,brawlBall,Beach Ball,0,1,0,1
14699,2023-01-04,BELLE,bounty,Shooting Star,0,86,76,162
14700,2023-01-03,BELLE,knockout,Goldarm Gulch,0,4,1,5
14701,2023-01-03,BELLE,hotZone,Parallel Plays,0,4,1,5
14702,2023-01-03,BELLE,gemGrab,Minecart Madness,0,8,8,16
14703,2023-01-03,BELLE,gemGrab,Crystal Arcade,0,14,1,15
14704,2023-01-03,BELLE,brawlBall,Beach Ball,0,12,6,18
14705,2023-01-03,BELLE,bounty,Hideout,0,29,48,77
14706,2023-01-02,BELLE,knockout,Belle's Rock,0,39,64,103
14707,2023-01-02,BELLE,hotZone,Quarter Pounder,0,4,7,11
14708,2023-01-02,BELLE,gemGrab,Minecart Madness,0,16,19,35
14709,2023-01-02,BELLE,gemGrab,Double Swoosh,0,1,0,1
14710,2023-01-02,BELLE,brawlBall,Center Stage,0,8,1,9
14711,2023-01-02,BELLE,brawlBall,Backyard Bowl,1,5,10,16
14712,2023-01-02,BELLE,bounty,Hideout,0,68,98,166
14713,2023-01-01,BELLE,knockout,Belle's Rock,0,10,7,17
14714,2023-01-01,BELLE,hotZone,Quarter Pounder,0,9,1,10
14715,2023-01-01,BELLE,heist,Bridge Too Far,0,15,25,40
14716,2023-01-01,BELLE,gemGrab,Double Swoosh,0,1,0,1
14717,2023-01-01,BELLE,brawlBall,Backyard Bowl,0,23,29,52
14718,2022-12-31,BELLE,heist,Kaboom Canyon,0,0,1,1
14719,2022-12-31,BELLE,heist,Bridge Too Far,0,6,17,23
14720,2022-12-31,BELLE,gemGrab,Minecart Madness,0,1,0,1
14721,2022-12-31,BELLE,gemGrab,Hard Rock Mine,0,2,0,2
14722,2022-12-31,BELLE,gemGrab,Deep Diner,0,1,0,1
14723,2022-12-30,BELLE,heist,Kaboom Canyon,0,1,1,2
14724,2022-12-30,BELLE,gemGrab,Undermine,0,1,0,1
14725,2022-12-30,BELLE,gemGrab,Deep Diner,0,5,17,22
14726,2022-12-30,BELLE,brawlBall,Sneaky Fields,0,1,0,1
14727,2022-12-29,BELLE,heist,Kaboom Canyon,0,0,1,1
14728,2022-12-28,BELLE,hotZone,Open Zone,0,1,1,2
14729,2022-12-27,BELLE,knockout,New Perspective,0,1,0,1
14730,2022-12-27,BELLE,heist,Kaboom Canyon,0,0,1,1
14731,2022-12-27,BELLE,brawlBall,Beach Ball,0,1,0,1
14732,2022-12-26,BELLE,gemGrab,Minecart Madness,0,0,2,2
14733,2022-12-25,BELLE,brawlBall,Backyard Bowl,0,2,0,2
14734,2022-12-23,BELLE,knockout,Out in the Open,0,0,1,1
14735,2022-12-19,BELLE,brawlBall,Center Stage,0,1,0,1
14736,2022-12-18,BELLE,heist,Bridge Too Far,0,1,0,1
14737,2022-12-16,BELLE,brawlBall,Sneaky Fields,0,0,1,1
14738,2022-12-13,BELLE,heist,Safe Zone,0,0,2,2
14739,2022-12-11,BELLE,brawlBall,Backyard Bowl,0,0,1,1
14740,2022-12-10,BELLE,hotZone,Ring of Fire,0,1,0,1
14741,2022-11-07,BELLE,hotZone,Quarter Pounder,0,0,1,1
14742,2022-11-01,BELLE,knockout,New Perspective,0,4,2,6
14743,2022-10-30,BELLE,knockout,Out in the Open,0,1,0,1
14744,2022-10-28,BELLE,knockout,Out in the Open,0,1,2,3
14745,2022-10-26,BELLE,bounty,Shooting Star,0,1,1,2
14746,2022-10-15,BELLE,gemGrab,Hard Rock Mine,0,2,2,4
14747,2022-10-10,BELLE,knockout,Belle's Rock,0,4,1,5
14748,2023-01-30,BEA,knockout,Belle's Rock,1,153,113,267
14749,2023-01-30,BEA,hotZone,Quarter Pounder,1,372,717,1090
14750,2023-01-30,BEA,heist,Pit Stop,0,30,27,57
14751,2023-01-30,BEA,gemGrab,Minecart Madness,0,115,123,238
14752,2023-01-30,BEA,gemGrab,Double Swoosh,0,38,33,71
14753,2023-01-30,BEA,brawlBall,Center Stage,8,315,264,587
14754,2023-01-30,BEA,brawlBall,Backyard Bowl,11,172,190,373
14755,2023-01-30,BEA,bounty,Hideout,0,53,45,98
14756,2023-01-29,BEA,knockout,Belle's Rock,0,156,81,237
14757,2023-01-29,BEA,hotZone,Quarter Pounder,3,450,534,987
14758,2023-01-29,BEA,heist,Bridge Too Far,1,170,126,297
14759,2023-01-29,BEA,gemGrab,Hard Rock Mine,0,17,33,50
14760,2023-01-29,BEA,gemGrab,Double Swoosh,0,56,70,126
14761,2023-01-29,BEA,brawlBall,Super Beach,0,34,35,69
14762,2023-01-29,BEA,brawlBall,Backyard Bowl,121,2238,2139,4498
14763,2023-01-29,BEA,bounty,Canal Grande,0,25,32,57
14764,2023-01-28,BEA,knockout,Flaring Phoenix,0,74,28,102
14765,2023-01-28,BEA,hotZone,Controller Chaos,0,119,234,353
14766,2023-01-28,BEA,heist,Bridge Too Far,1,448,409,858
14767,2023-01-28,BEA,gemGrab,Hard Rock Mine,0,140,127,267
14768,2023-01-28,BEA,gemGrab,Deep Diner,0,37,22,59
14769,2023-01-28,BEA,brawlBall,Super Beach,52,1620,1956,3628
14770,2023-01-28,BEA,brawlBall,Sneaky Fields,5,94,128,227
14771,2023-01-28,BEA,bounty,Canal Grande,0,46,46,92
14772,2023-01-27,BEA,knockout,Flaring Phoenix,0,22,16,38
14773,2023-01-27,BEA,hotZone,Controller Chaos,0,46,49,95
14774,2023-01-27,BEA,heist,Hot Potato,0,9,8,17
14775,2023-01-27,BEA,gemGrab,Undermine,0,6,1,7
14776,2023-01-27,BEA,gemGrab,Deep Diner,0,58,71,129
14777,2023-01-27,BEA,brawlBall,Sneaky Fields,6,409,497,912
14778,2023-01-27,BEA,brawlBall,Pinhole Punt,0,20,14,34
14779,2023-01-27,BEA,bounty,Temple Ruins,0,17,9,26
14780,2023-01-26,BEA,knockout,Riverside,0,404,259,663
14781,2023-01-26,BEA,hotZone,Open Zone,0,361,397,758
14782,2023-01-26,BEA,heist,Hot Potato,0,79,108,187
14783,2023-01-26,BEA,gemGrab,Undermine,0,115,117,232
14784,2023-01-26,BEA,gemGrab,Gem Fort,0,31,14,45
14785,2023-01-26,BEA,brawlBall,Sunny Soccer,0,24,18,42
14786,2023-01-26,BEA,brawlBall,Pinhole Punt,47,1413,1560,3020
14787,2023-01-26,BEA,bounty,Temple Ruins,0,50,35,85
14788,2023-01-25,BEA,knockout,Riverside,0,231,124,355
14789,2023-01-25,BEA,hotZone,Open Zone,0,230,255,485
14790,2023-01-25,BEA,heist,Safe Zone,0,70,97,167
14791,2023-01-25,BEA,gemGrab,Gem Fort,0,28,20,48
14792,2023-01-25,BEA,gemGrab,Crystal Arcade,0,74,58,132
14793,2023-01-25,BEA,brawlBall,Sunny Soccer,12,324,365,701
14794,2023-01-25,BEA,brawlBall,Beach Ball,4,75,95,174
14795,2023-01-25,BEA,bounty,Excel,0,32,27,59
14796,2023-01-24,BEA,knockout,New Perspective,0,150,88,238
14797,2023-01-24,BEA,hotZone,Dueling Beetles,0,105,158,263
14798,2023-01-24,BEA,heist,Safe Zone,1,194,153,348
14799,2023-01-24,BEA,gemGrab,Minecart Madness,0,53,69,122
14800,2023-01-24,BEA,gemGrab,Crystal Arcade,0,131,135,266
14801,2023-01-24,BEA,brawlBall,Center Stage,3,51,82,136
14802,2023-01-24,BEA,brawlBall,Beach Ball,39,764,893,1696
14803,2023-01-24,BEA,bounty,Excel,0,53,19,72
14804,2023-01-23,BEA,knockout,New Perspective,0,223,154,377
14805,2023-01-23,BEA,hotZone,Dueling Beetles,2,353,402,757
14806,2023-01-23,BEA,heist,Snaked Assault,0,231,471,702
14807,2023-01-23,BEA,gemGrab,Minecart Madness,0,238,197,435
14808,2023-01-23,BEA,gemGrab,Double Swoosh,0,43,41,84
14809,2023-01-23,BEA,brawlBall,Center Stage,24,554,462,1040
14810,2023-01-23,BEA,brawlBall,Backyard Bowl,2,118,94,214
14811,2023-01-23,BEA,bounty,Layer Cake,0,58,68,126
14812,2023-01-22,BEA,knockout,X Marks the Spot,0,74,53,127
14813,2023-01-22,BEA,hotZone,Ring of Fire,0,145,174,319
14814,2023-01-22,BEA,heist,Snaked Assault,2,184,253,439
14815,2023-01-22,BEA,gemGrab,Hard Rock Mine,0,47,31,78
14816,2023-01-22,BEA,gemGrab,Double Swoosh,0,49,50,99
14817,2023-01-22,BEA,brawlBall,Super Beach,5,168,142,315
14818,2023-01-22,BEA,brawlBall,Backyard Bowl,69,1154,1109,2332
14819,2023-01-22,BEA,bounty,Layer Cake,0,26,13,39
14820,2023-01-21,BEA,knockout,X Marks the Spot,0,293,190,483
14821,2023-01-21,BEA,hotZone,Ring of Fire,2,467,554,1023
14822,2023-01-21,BEA,heist,Tornado Ring,1,120,166,287
14823,2023-01-21,BEA,gemGrab,Hard Rock Mine,0,199,206,405
14824,2023-01-21,BEA,gemGrab,Deep Diner,0,39,36,75
14825,2023-01-21,BEA,brawlBall,Super Beach,86,2165,2483,4734
14826,2023-01-21,BEA,brawlBall,Sneaky Fields,3,74,111,188
14827,2023-01-21,BEA,bounty,Dry Season,0,224,174,398
14828,2023-01-20,BEA,knockout,Out in the Open,1,269,168,438
14829,2023-01-20,BEA,hotZone,Split,0,10,4,14
14830,2023-01-20,BEA,heist,Tornado Ring,5,156,221,382
14831,2023-01-20,BEA,gemGrab,Undermine,0,55,51,106
14832,2023-01-20,BEA,gemGrab,Deep Diner,0,196,198,394
14833,2023-01-20,BEA,brawlBall,Sneaky Fields,44,1054,1438,2536
14834,2023-01-20,BEA,brawlBall,Pinhole Punt,3,48,51,102
14835,2023-01-20,BEA,bounty,Dry Season,0,178,117,295
14836,2023-01-19,BEA,knockout,Out in the Open,0,349,263,612
14837,2023-01-19,BEA,hotZone,Split,0,20,20,40
14838,2023-01-19,BEA,heist,Kaboom Canyon,0,85,110,195
14839,2023-01-19,BEA,gemGrab,Undermine,0,127,131,258
14840,2023-01-19,BEA,gemGrab,Gem Fort,0,18,23,41
14841,2023-01-19,BEA,brawlBall,Sunny Soccer,1,18,26,45
14842,2023-01-19,BEA,brawlBall,Pinhole Punt,60,1637,1823,3520
14843,2023-01-19,BEA,bounty,Shooting Star,0,241,187,428
14844,2023-01-18,BEA,knockout,Goldarm Gulch,0,18,12,30
14845,2023-01-18,BEA,hotZone,Parallel Plays,0,5,4,9
14846,2023-01-18,BEA,heist,Kaboom Canyon,1,34,36,71
14847,2023-01-18,BEA,gemGrab,Gem Fort,0,13,14,27
14848,2023-01-18,BEA,gemGrab,Crystal Arcade,0,6,10,16
14849,2023-01-18,BEA,brawlBall,Sunny Soccer,4,166,157,327
14850,2023-01-18,BEA,brawlBall,Beach Ball,0,12,9,21
14851,2023-01-18,BEA,bounty,Shooting Star,0,104,73,177
14852,2023-01-17,BEA,knockout,Goldarm Gulch,0,15,7,22
14853,2023-01-17,BEA,hotZone,Parallel Plays,0,12,17,29
14854,2023-01-17,BEA,gemGrab,Minecart Madness,0,2,6,8
14855,2023-01-17,BEA,gemGrab,Crystal Arcade,0,18,19,37
14856,2023-01-17,BEA,brawlBall,Center Stage,0,2,4,6
14857,2023-01-17,BEA,brawlBall,Beach Ball,3,68,88,159
14858,2023-01-17,BEA,bounty,Hideout,0,9,2,11
14859,2023-01-16,BEA,knockout,Belle's Rock,0,14,13,27
14860,2023-01-16,BEA,hotZone,Quarter Pounder,0,28,82,110
14861,2023-01-16,BEA,heist,Pit Stop,0,1,1,2
14862,2023-01-16,BEA,gemGrab,Minecart Madness,0,13,13,26
14863,2023-01-16,BEA,gemGrab,Double Swoosh,0,3,2,5
14864,2023-01-16,BEA,brawlBall,Center Stage,3,33,26,62
14865,2023-01-16,BEA,brawlBall,Backyard Bowl,1,30,41,72
14866,2023-01-16,BEA,bounty,Hideout,0,27,15,42
14867,2023-01-15,BEA,knockout,Belle's Rock,0,26,12,38
14868,2023-01-15,BEA,hotZone,Quarter Pounder,0,138,135,273
14869,2023-01-15,BEA,heist,Bridge Too Far,0,48,32,80
14870,2023-01-15,BEA,gemGrab,Hard Rock Mine,0,5,0,5
14871,2023-01-15,BEA,gemGrab,Double Swoosh,0,6,14,20
14872,2023-01-15,BEA,brawlBall,Super Beach,1,27,52,80
14873,2023-01-15,BEA,brawlBall,Backyard Bowl,20,343,322,685
14874,2023-01-15,BEA,bounty,Canal Grande,0,4,1,5
14875,2023-01-14,BEA,knockout,Flaring Phoenix,0,5,2,7
14876,2023-01-14,BEA,hotZone,Controller Chaos,0,43,92,135
14877,2023-01-14,BEA,heist,Bridge Too Far,0,99,78,177
14878,2023-01-14,BEA,gemGrab,Hard Rock Mine,0,11,12,23
14879,2023-01-14,BEA,gemGrab,Deep Diner,0,10,18,28
14880,2023-01-14,BEA,brawlBall,Super Beach,8,169,194,371
14881,2023-01-14,BEA,brawlBall,Sneaky Fields,1,35,36,72
14882,2023-01-14,BEA,bounty,Canal Grande,0,4,0,4
14883,2023-01-13,BEA,knockout,Flaring Phoenix,0,10,0,10
14884,2023-01-13,BEA,hotZone,Controller Chaos,0,76,119,195
14885,2023-01-13,BEA,heist,Hot Potato,0,1,1,2
14886,2023-01-13,BEA,gemGrab,Deep Diner,0,13,7,20
14887,2023-01-13,BEA,brawlBall,Sneaky Fields,2,179,185,366
14888,2023-01-13,BEA,brawlBall,Pinhole Punt,1,8,2,11
14889,2023-01-13,BEA,bounty,Temple Ruins,0,2,3,5
14890,2023-01-12,BEA,knockout,Riverside,0,53,25,78
14891,2023-01-12,BEA,hotZone,Open Zone,0,51,71,122
14892,2023-01-12,BEA,heist,Hot Potato,0,1,0,1
14893,2023-01-12,BEA,gemGrab,Undermine,0,7,5,12
14894,2023-01-12,BEA,gemGrab,Gem Fort,0,3,11,14
14895,2023-01-12,BEA,brawlBall,Sunny Soccer,0,3,1,4
14896,2023-01-12,BEA,brawlBall,Pinhole Punt,2,56,71,129
14897,2023-01-12,BEA,bounty,Temple Ruins,0,0,1,1
14898,2023-01-11,BEA,knockout,Riverside,0,15,24,39
14899,2023-01-11,BEA,hotZone,Open Zone,0,28,23,51
14900,2023-01-11,BEA,heist,Safe Zone,0,1,0,1
14901,2023-01-11,BEA,gemGrab,Gem Fort,0,1,0,1
14902,2023-01-11,BEA,brawlBall,Sunny Soccer,1,26,30,57
14903,2023-01-11,BEA,brawlBall,Beach Ball,0,1,1,2
14904,2023-01-11,BEA,bounty,Excel,0,1,0,1
14905,2023-01-10,BEA,knockout,New Perspective,0,7,3,10
14906,2023-01-10,BEA,hotZone,Dueling Beetles,0,43,29,72
14907,2023-01-10,BEA,heist,Safe Zone,0,17,20,37
14908,2023-01-10,BEA,gemGrab,Minecart Madness,0,11,36,47
14909,2023-01-10,BEA,gemGrab,Crystal Arcade,0,32,45,77
14910,2023-01-10,BEA,brawlBall,Center Stage,0,5,0,5
14911,2023-01-10,BEA,brawlBall,Beach Ball,1,85,76,162
14912,2023-01-10,BEA,bounty,Excel,0,4,21,25
14913,2023-01-09,BEA,knockout,New Perspective,0,7,4,11
14914,2023-01-09,BEA,hotZone,Dueling Beetles,0,30,50,80
14915,2023-01-09,BEA,heist,Snaked Assault,0,16,46,62
14916,2023-01-09,BEA,gemGrab,Minecart Madness,0,24,26,50
14917,2023-01-09,BEA,gemGrab,Double Swoosh,0,7,32,39
14918,2023-01-09,BEA,brawlBall,Center Stage,2,38,20,60
14919,2023-01-09,BEA,brawlBall,Backyard Bowl,3,25,11,39
14920,2023-01-09,BEA,bounty,Layer Cake,0,6,4,10
14921,2023-01-08,BEA,knockout,X Marks the Spot,0,19,18,37
14922,2023-01-08,BEA,hotZone,Ring of Fire,0,42,67,109
14923,2023-01-08,BEA,heist,Snaked Assault,0,27,67,94
14924,2023-01-08,BEA,gemGrab,Hard Rock Mine,0,9,12,21
14925,2023-01-08,BEA,gemGrab,Double Swoosh,0,5,9,14
14926,2023-01-08,BEA,brawlBall,Super Beach,2,30,22,54
14927,2023-01-08,BEA,brawlBall,Backyard Bowl,9,183,254,446
14928,2023-01-08,BEA,bounty,Layer Cake,0,4,2,6
14929,2023-01-07,BEA,knockout,X Marks the Spot,0,8,4,12
14930,2023-01-07,BEA,hotZone,Ring of Fire,0,15,12,27
14931,2023-01-07,BEA,heist,Tornado Ring,0,4,10,14
14932,2023-01-07,BEA,gemGrab,Hard Rock Mine,0,13,5,18
14933,2023-01-07,BEA,gemGrab,Deep Diner,0,14,26,40
14934,2023-01-07,BEA,brawlBall,Super Beach,1,80,107,188
14935,2023-01-07,BEA,brawlBall,Sneaky Fields,2,13,15,30
14936,2023-01-07,BEA,bounty,Dry Season,0,24,9,33
14937,2023-01-06,BEA,knockout,Out in the Open,0,19,9,28
14938,2023-01-06,BEA,hotZone,Split,0,2,10,12
14939,2023-01-06,BEA,heist,Tornado Ring,0,33,83,116
14940,2023-01-06,BEA,gemGrab,Undermine,0,8,10,18
14941,2023-01-06,BEA,gemGrab,Deep Diner,0,29,24,53
14942,2023-01-06,BEA,brawlBall,Sneaky Fields,2,137,221,360
14943,2023-01-06,BEA,brawlBall,Pinhole Punt,0,18,17,35
14944,2023-01-06,BEA,bounty,Dry Season,0,18,17,35
14945,2023-01-05,BEA,knockout,Out in the Open,0,45,53,98
14946,2023-01-05,BEA,hotZone,Split,0,29,42,71
14947,2023-01-05,BEA,heist,Kaboom Canyon,0,16,30,46
14948,2023-01-05,BEA,gemGrab,Undermine,0,28,23,51
14949,2023-01-05,BEA,gemGrab,Gem Fort,0,2,2,4
14950,2023-01-05,BEA,brawlBall,Sunny Soccer,0,1,4,5
14951,2023-01-05,BEA,brawlBall,Pinhole Punt,9,285,290,584
14952,2023-01-05,BEA,bounty,Shooting Star,0,26,7,33
14953,2023-01-04,BEA,knockout,Goldarm Gulch,0,2,0,2
14954,2023-01-04,BEA,hotZone,Parallel Plays,0,12,12,24
14955,2023-01-04,BEA,heist,Kaboom Canyon,0,31,33,64
14956,2023-01-04,BEA,gemGrab,Gem Fort,0,16,11,27
14957,2023-01-04,BEA,gemGrab,Crystal Arcade,0,12,8,20
14958,2023-01-04,BEA,brawlBall,Sunny Soccer,5,89,94,188
14959,2023-01-04,BEA,brawlBall,Beach Ball,0,0,4,4
14960,2023-01-04,BEA,bounty,Shooting Star,0,57,25,82
14961,2023-01-03,BEA,knockout,Goldarm Gulch,0,1,0,1
14962,2023-01-03,BEA,hotZone,Parallel Plays,0,24,30,54
14963,2023-01-03,BEA,heist,Pit Stop,0,1,15,16
14964,2023-01-03,BEA,gemGrab,Minecart Madness,0,8,0,8
14965,2023-01-03,BEA,gemGrab,Crystal Arcade,0,34,53,87
14966,2023-01-03,BEA,brawlBall,Center Stage,0,1,4,5
14967,2023-01-03,BEA,brawlBall,Beach Ball,0,104,144,248
14968,2023-01-03,BEA,bounty,Hideout,0,36,5,41
14969,2023-01-02,BEA,knockout,Belle's Rock,0,11,10,21
14970,2023-01-02,BEA,hotZone,Quarter Pounder,2,73,121,196
14971,2023-01-02,BEA,heist,Pit Stop,0,15,40,55
14972,2023-01-02,BEA,gemGrab,Minecart Madness,0,24,28,52
14973,2023-01-02,BEA,gemGrab,Double Swoosh,0,11,22,33
14974,2023-01-02,BEA,brawlBall,Center Stage,0,47,58,105
14975,2023-01-02,BEA,brawlBall,Backyard Bowl,1,24,12,37
14976,2023-01-02,BEA,bounty,Hideout,0,39,17,56
14977,2023-01-01,BEA,knockout,Belle's Rock,0,4,1,5
14978,2023-01-01,BEA,hotZone,Quarter Pounder,0,69,93,162
14979,2023-01-01,BEA,heist,Bridge Too Far,0,5,5,10
14980,2023-01-01,BEA,gemGrab,Double Swoosh,0,6,5,11
14981,2023-01-01,BEA,brawlBall,Backyard Bowl,2,110,128,240
14982,2023-01-01,BEA,bounty,Canal Grande,0,2,0,2
14983,2022-12-31,BEA,hotZone,Controller Chaos,0,4,5,9
14984,2022-12-31,BEA,heist,Bridge Too Far,0,12,4,16
14985,2022-12-31,BEA,gemGrab,Hard Rock Mine,0,5,1,6
14986,2022-12-31,BEA,gemGrab,Deep Diner,0,2,1,3
14987,2022-12-31,BEA,brawlBall,Super Beach,0,12,9,21
14988,2022-12-31,BEA,bounty,Canal Grande,0,0,1,1
14989,2022-12-30,BEA,knockout,Flaring Phoenix,0,0,1,1
14990,2022-12-30,BEA,hotZone,Controller Chaos,0,2,2,4
14991,2022-12-30,BEA,gemGrab,Undermine,0,1,1,2
14992,2022-12-30,BEA,gemGrab,Deep Diner,0,9,17,26
14993,2022-12-30,BEA,brawlBall,Sneaky Fields,0,10,11,21
14994,2022-12-29,BEA,hotZone,Open Zone,0,3,2,5
14995,2022-12-29,BEA,gemGrab,Undermine,0,1,0,1
14996,2022-12-29,BEA,brawlBall,Pinhole Punt,0,16,5,21
14997,2022-12-28,BEA,hotZone,Open Zone,0,9,1,10
14998,2022-12-27,BEA,knockout,New Perspective,0,0,1,1
14999,2022-12-27,BEA,gemGrab,Minecart Madness,0,0,1,1
15000,2022-12-27,BEA,brawlBall,Center Stage,0,4,1,5
15001,2022-12-27,BEA,brawlBall,Beach Ball,0,1,1,2
15002,2022-12-26,BEA,heist,Kaboom Canyon,0,0,1,1
15003,2022-12-26,BEA,gemGrab,Minecart Madness,0,1,1,2
15004,2022-12-26,BEA,brawlBall,Center Stage,0,1,0,1
15005,2022-12-25,BEA,brawlBall,Backyard Bowl,0,3,1,4
15006,2022-12-25,BEA,bounty,Layer Cake,0,1,1,2
15007,2022-12-24,BEA,knockout,X Marks the Spot,0,0,1,1
15008,2022-12-24,BEA,brawlBall,Super Beach,0,1,3,4
15009,2022-12-24,BEA,bounty,Dry Season,0,0,1,1
15010,2022-12-23,BEA,knockout,Out in the Open,0,0,1,1
15011,2022-12-22,BEA,brawlBall,Pinhole Punt,0,3,0,3
15012,2022-12-21,BEA,brawlBall,Sunny Soccer,0,2,2,4
15013,2022-12-20,BEA,brawlBall,Beach Ball,0,1,2,3
15014,2022-12-19,BEA,brawlBall,Center Stage,0,2,0,2
15015,2022-12-18,BEA,heist,Bridge Too Far,0,1,0,1
15016,2022-12-17,BEA,knockout,Flaring Phoenix,0,1,0,1
15017,2022-12-16,BEA,brawlBall,Sneaky Fields,0,1,1,2
15018,2022-12-13,BEA,knockout,New Perspective,0,3,13,16
15019,2022-12-13,BEA,heist,Safe Zone,0,0,1,1
15020,2022-12-13,BEA,gemGrab,Crystal Arcade,0,0,1,1
15021,2022-11-03,BEA,bounty,Temple Ruins,0,1,0,1
15022,2022-11-01,BEA,knockout,New Perspective,0,0,1,1
15023,2022-10-28,BEA,bounty,Canal Grande,0,1,0,1
15024,2022-10-15,BEA,hotZone,Ring of Fire,0,1,0,1
15025,2022-10-15,BEA,gemGrab,Hard Rock Mine,0,2,0,2
15026,2023-01-30,BARLEY,knockout,Belle's Rock,0,65,44,109
15027,2023-01-30,BARLEY,hotZone,Quarter Pounder,0,171,410,581
15028,2023-01-30,BARLEY,heist,Pit Stop,0,255,233,488
15029,2023-01-30,BARLEY,gemGrab,Minecart Madness,0,29,20,49
15030,2023-01-30,BARLEY,gemGrab,Double Swoosh,0,6,6,12
15031,2023-01-30,BARLEY,brawlBall,Center Stage,1,24,21,46
15032,2023-01-30,BARLEY,brawlBall,Backyard Bowl,0,2,1,3
15033,2023-01-30,BARLEY,bounty,Hideout,0,6,4,10
15034,2023-01-29,BARLEY,knockout,Belle's Rock,0,62,38,100
15035,2023-01-29,BARLEY,hotZone,Quarter Pounder,2,305,458,765
15036,2023-01-29,BARLEY,heist,Bridge Too Far,0,12,7,19
15037,2023-01-29,BARLEY,gemGrab,Hard Rock Mine,0,5,3,8
15038,2023-01-29,BARLEY,gemGrab,Double Swoosh,0,18,9,27
15039,2023-01-29,BARLEY,brawlBall,Super Beach,1,18,16,35
15040,2023-01-29,BARLEY,brawlBall,Backyard Bowl,0,25,9,34
15041,2023-01-29,BARLEY,bounty,Canal Grande,0,19,6,25
15042,2023-01-28,BARLEY,knockout,Flaring Phoenix,0,34,24,58
15043,2023-01-28,BARLEY,hotZone,Controller Chaos,0,50,58,108
15044,2023-01-28,BARLEY,heist,Bridge Too Far,0,20,14,34
15045,2023-01-28,BARLEY,gemGrab,Hard Rock Mine,0,16,19,35
15046,2023-01-28,BARLEY,gemGrab,Deep Diner,0,30,50,80
15047,2023-01-28,BARLEY,brawlBall,Super Beach,15,449,595,1059
15048,2023-01-28,BARLEY,brawlBall,Sneaky Fields,0,1,3,4
15049,2023-01-28,BARLEY,bounty,Canal Grande,0,39,35,74
15050,2023-01-27,BARLEY,knockout,Flaring Phoenix,0,10,5,15
15051,2023-01-27,BARLEY,hotZone,Controller Chaos,0,35,17,52
15052,2023-01-27,BARLEY,heist,Hot Potato,0,62,112,174
15053,2023-01-27,BARLEY,gemGrab,Undermine,0,4,0,4
15054,2023-01-27,BARLEY,gemGrab,Deep Diner,0,78,92,170
15055,2023-01-27,BARLEY,brawlBall,Sneaky Fields,0,45,43,88
15056,2023-01-27,BARLEY,bounty,Temple Ruins,0,1,1,2
15057,2023-01-26,BARLEY,knockout,Riverside,1,16,2,19
15058,2023-01-26,BARLEY,hotZone,Open Zone,0,18,7,25
15059,2023-01-26,BARLEY,heist,Hot Potato,0,282,364,646
15060,2023-01-26,BARLEY,gemGrab,Undermine,0,3,10,13
15061,2023-01-26,BARLEY,gemGrab,Gem Fort,0,3,1,4
15062,2023-01-26,BARLEY,brawlBall,Sunny Soccer,0,5,4,9
15063,2023-01-26,BARLEY,brawlBall,Pinhole Punt,2,65,40,107
15064,2023-01-26,BARLEY,bounty,Temple Ruins,0,6,7,13
15065,2023-01-25,BARLEY,knockout,Riverside,0,4,3,7
15066,2023-01-25,BARLEY,hotZone,Open Zone,0,3,0,3
15067,2023-01-25,BARLEY,heist,Safe Zone,0,22,7,29
15068,2023-01-25,BARLEY,gemGrab,Gem Fort,0,4,5,9
15069,2023-01-25,BARLEY,gemGrab,Crystal Arcade,0,2,10,12
15070,2023-01-25,BARLEY,brawlBall,Sunny Soccer,1,138,134,273
15071,2023-01-25,BARLEY,brawlBall,Beach Ball,0,13,10,23
15072,2023-01-25,BARLEY,bounty,Excel,0,16,15,31
15073,2023-01-24,BARLEY,knockout,New Perspective,0,19,10,29
15074,2023-01-24,BARLEY,hotZone,Dueling Beetles,0,49,20,69
15075,2023-01-24,BARLEY,heist,Safe Zone,0,32,16,48
15076,2023-01-24,BARLEY,gemGrab,Minecart Madness,0,6,13,19
15077,2023-01-24,BARLEY,gemGrab,Crystal Arcade,0,22,10,32
15078,2023-01-24,BARLEY,brawlBall,Center Stage,0,6,3,9
15079,2023-01-24,BARLEY,brawlBall,Beach Ball,10,154,163,327
15080,2023-01-24,BARLEY,bounty,Excel,0,31,23,54
15081,2023-01-23,BARLEY,knockout,New Perspective,0,23,7,30
15082,2023-01-23,BARLEY,hotZone,Dueling Beetles,0,76,82,158
15083,2023-01-23,BARLEY,heist,Snaked Assault,1,56,25,82
15084,2023-01-23,BARLEY,gemGrab,Minecart Madness,0,33,25,58
15085,2023-01-23,BARLEY,gemGrab,Double Swoosh,0,4,2,6
15086,2023-01-23,BARLEY,brawlBall,Center Stage,4,72,55,131
15087,2023-01-23,BARLEY,bounty,Layer Cake,0,30,9,39
15088,2023-01-22,BARLEY,knockout,X Marks the Spot,0,14,7,21
15089,2023-01-22,BARLEY,hotZone,Ring of Fire,0,5,0,5
15090,2023-01-22,BARLEY,heist,Snaked Assault,0,35,22,57
15091,2023-01-22,BARLEY,gemGrab,Hard Rock Mine,0,7,1,8
15092,2023-01-22,BARLEY,gemGrab,Double Swoosh,0,10,14,24
15093,2023-01-22,BARLEY,brawlBall,Super Beach,2,34,38,74
15094,2023-01-22,BARLEY,brawlBall,Backyard Bowl,2,16,5,23
15095,2023-01-22,BARLEY,bounty,Layer Cake,0,9,5,14
15096,2023-01-21,BARLEY,knockout,X Marks the Spot,0,17,17,34
15097,2023-01-21,BARLEY,hotZone,Ring of Fire,0,26,7,33
15098,2023-01-21,BARLEY,heist,Tornado Ring,0,58,35,93
15099,2023-01-21,BARLEY,gemGrab,Hard Rock Mine,0,26,13,39
15100,2023-01-21,BARLEY,gemGrab,Deep Diner,0,44,56,100
15101,2023-01-21,BARLEY,brawlBall,Super Beach,31,554,895,1480
15102,2023-01-21,BARLEY,brawlBall,Sneaky Fields,0,7,4,11
15103,2023-01-21,BARLEY,bounty,Dry Season,0,13,9,22
15104,2023-01-20,BARLEY,knockout,Out in the Open,0,21,10,31
15105,2023-01-20,BARLEY,hotZone,Split,0,130,189,319
15106,2023-01-20,BARLEY,heist,Tornado Ring,1,40,34,75
15107,2023-01-20,BARLEY,gemGrab,Undermine,0,8,1,9
15108,2023-01-20,BARLEY,gemGrab,Deep Diner,0,153,227,380
15109,2023-01-20,BARLEY,brawlBall,Sneaky Fields,4,85,66,155
15110,2023-01-20,BARLEY,brawlBall,Pinhole Punt,0,5,4,9
15111,2023-01-20,BARLEY,bounty,Dry Season,0,13,13,26
15112,2023-01-19,BARLEY,knockout,Out in the Open,0,16,24,40
15113,2023-01-19,BARLEY,hotZone,Split,0,212,325,537
15114,2023-01-19,BARLEY,heist,Kaboom Canyon,0,23,14,37
15115,2023-01-19,BARLEY,gemGrab,Undermine,0,15,5,20
15116,2023-01-19,BARLEY,gemGrab,Gem Fort,0,1,0,1
15117,2023-01-19,BARLEY,brawlBall,Sunny Soccer,0,9,3,12
15118,2023-01-19,BARLEY,brawlBall,Pinhole Punt,1,35,19,55
15119,2023-01-19,BARLEY,bounty,Shooting Star,0,10,6,16
15120,2023-01-18,BARLEY,knockout,Goldarm Gulch,0,2,1,3
15121,2023-01-18,BARLEY,hotZone,Parallel Plays,0,26,55,81
15122,2023-01-18,BARLEY,heist,Kaboom Canyon,0,9,3,12
15123,2023-01-18,BARLEY,gemGrab,Gem Fort,0,1,3,4
15124,2023-01-18,BARLEY,gemGrab,Crystal Arcade,0,1,2,3
15125,2023-01-18,BARLEY,brawlBall,Sunny Soccer,1,74,64,139
15126,2023-01-18,BARLEY,brawlBall,Beach Ball,1,2,2,5
15127,2023-01-18,BARLEY,bounty,Shooting Star,0,0,2,2
15128,2023-01-17,BARLEY,knockout,Goldarm Gulch,0,2,10,12
15129,2023-01-17,BARLEY,hotZone,Parallel Plays,0,26,31,57
15130,2023-01-17,BARLEY,heist,Pit Stop,0,24,20,44
15131,2023-01-17,BARLEY,gemGrab,Minecart Madness,0,2,0,2
15132,2023-01-17,BARLEY,gemGrab,Crystal Arcade,0,4,11,15
15133,2023-01-17,BARLEY,brawlBall,Beach Ball,0,23,10,33
15134,2023-01-16,BARLEY,knockout,Belle's Rock,0,3,2,5
15135,2023-01-16,BARLEY,hotZone,Quarter Pounder,0,10,15,25
15136,2023-01-16,BARLEY,heist,Pit Stop,0,72,110,182
15137,2023-01-16,BARLEY,gemGrab,Minecart Madness,0,1,2,3
15138,2023-01-16,BARLEY,gemGrab,Double Swoosh,0,1,0,1
15139,2023-01-16,BARLEY,brawlBall,Center Stage,0,3,2,5
15140,2023-01-15,BARLEY,knockout,Belle's Rock,0,4,6,10
15141,2023-01-15,BARLEY,hotZone,Quarter Pounder,0,47,82,129
15142,2023-01-15,BARLEY,heist,Bridge Too Far,0,1,0,1
15143,2023-01-15,BARLEY,gemGrab,Double Swoosh,0,1,1,2
15144,2023-01-15,BARLEY,brawlBall,Super Beach,0,4,15,19
15145,2023-01-15,BARLEY,brawlBall,Backyard Bowl,0,2,0,2
15146,2023-01-15,BARLEY,bounty,Canal Grande,0,1,1,2
15147,2023-01-14,BARLEY,hotZone,Controller Chaos,0,11,0,11
15148,2023-01-14,BARLEY,heist,Bridge Too Far,0,1,0,1
15149,2023-01-14,BARLEY,gemGrab,Deep Diner,0,8,2,10
15150,2023-01-14,BARLEY,brawlBall,Super Beach,0,26,63,89
15151,2023-01-14,BARLEY,bounty,Canal Grande,0,3,0,3
15152,2023-01-13,BARLEY,hotZone,Controller Chaos,0,18,37,55
15153,2023-01-13,BARLEY,heist,Hot Potato,0,11,5,16
15154,2023-01-13,BARLEY,gemGrab,Deep Diner,0,10,15,25
15155,2023-01-13,BARLEY,brawlBall,Sneaky Fields,0,7,17,24
15156,2023-01-12,BARLEY,knockout,Riverside,0,1,0,1
15157,2023-01-12,BARLEY,hotZone,Open Zone,0,1,0,1
15158,2023-01-12,BARLEY,heist,Hot Potato,0,5,4,9
15159,2023-01-11,BARLEY,heist,Safe Zone,0,0,1,1
15160,2023-01-11,BARLEY,brawlBall,Sunny Soccer,0,3,7,10
15161,2023-01-10,BARLEY,hotZone,Dueling Beetles,0,10,17,27
15162,2023-01-10,BARLEY,gemGrab,Crystal Arcade,0,1,0,1
15163,2023-01-10,BARLEY,brawlBall,Beach Ball,0,5,8,13
15164,2023-01-09,BARLEY,knockout,New Perspective,0,1,1,2
15165,2023-01-09,BARLEY,hotZone,Dueling Beetles,0,5,3,8
15166,2023-01-09,BARLEY,heist,Snaked Assault,0,5,0,5
15167,2023-01-09,BARLEY,gemGrab,Minecart Madness,0,1,2,3
15168,2023-01-09,BARLEY,brawlBall,Center Stage,1,0,0,1
15169,2023-01-09,BARLEY,bounty,Layer Cake,0,2,0,2
15170,2023-01-08,BARLEY,hotZone,Ring of Fire,0,1,0,1
15171,2023-01-08,BARLEY,heist,Snaked Assault,0,2,3,5
15172,2023-01-08,BARLEY,gemGrab,Hard Rock Mine,0,1,0,1
15173,2023-01-08,BARLEY,brawlBall,Super Beach,0,9,13,22
15174,2023-01-08,BARLEY,brawlBall,Backyard Bowl,0,1,1,2
15175,2023-01-08,BARLEY,bounty,Layer Cake,0,1,0,1
15176,2023-01-07,BARLEY,hotZone,Ring of Fire,0,1,0,1
15177,2023-01-07,BARLEY,heist,Tornado Ring,0,6,0,6
15178,2023-01-07,BARLEY,gemGrab,Deep Diner,0,12,36,48
15179,2023-01-07,BARLEY,brawlBall,Super Beach,1,17,41,59
15180,2023-01-06,BARLEY,hotZone,Split,0,13,21,34
15181,2023-01-06,BARLEY,heist,Tornado Ring,0,6,2,8
15182,2023-01-06,BARLEY,gemGrab,Deep Diner,0,20,58,78
15183,2023-01-06,BARLEY,brawlBall,Sneaky Fields,0,1,0,1
15184,2023-01-06,BARLEY,bounty,Dry Season,0,1,0,1
15185,2023-01-05,BARLEY,hotZone,Split,0,35,37,72
15186,2023-01-05,BARLEY,gemGrab,Undermine,0,1,0,1
15187,2023-01-05,BARLEY,gemGrab,Gem Fort,0,2,0,2
15188,2023-01-05,BARLEY,brawlBall,Pinhole Punt,0,1,0,1
15189,2023-01-04,BARLEY,hotZone,Parallel Plays,0,23,35,58
15190,2023-01-04,BARLEY,heist,Kaboom Canyon,0,2,0,2
15191,2023-01-04,BARLEY,brawlBall,Sunny Soccer,0,26,54,80
15192,2023-01-03,BARLEY,hotZone,Parallel Plays,2,27,77,106
15193,2023-01-03,BARLEY,heist,Pit Stop,0,26,63,89
15194,2023-01-03,BARLEY,gemGrab,Crystal Arcade,0,1,0,1
15195,2023-01-03,BARLEY,brawlBall,Beach Ball,0,10,6,16
15196,2023-01-03,BARLEY,bounty,Hideout,0,2,0,2
15197,2023-01-02,BARLEY,knockout,Belle's Rock,0,4,0,4
15198,2023-01-02,BARLEY,hotZone,Quarter Pounder,0,47,83,130
15199,2023-01-02,BARLEY,heist,Pit Stop,0,44,60,104
15200,2023-01-02,BARLEY,gemGrab,Minecart Madness,0,1,0,1
15201,2023-01-02,BARLEY,brawlBall,Center Stage,0,1,0,1
15202,2023-01-02,BARLEY,bounty,Hideout,0,2,1,3
15203,2023-01-01,BARLEY,hotZone,Quarter Pounder,0,31,48,79
15204,2023-01-01,BARLEY,gemGrab,Double Swoosh,0,1,0,1
15205,2023-01-01,BARLEY,brawlBall,Backyard Bowl,0,1,0,1
15206,2022-12-31,BARLEY,hotZone,Controller Chaos,0,1,0,1
15207,2022-12-31,BARLEY,gemGrab,Minecart Madness,0,0,2,2
15208,2022-12-31,BARLEY,gemGrab,Hard Rock Mine,0,1,0,1
15209,2022-12-31,BARLEY,gemGrab,Deep Diner,0,1,11,12
15210,2022-12-31,BARLEY,brawlBall,Super Beach,0,1,6,7
15211,2022-12-30,BARLEY,hotZone,Controller Chaos,0,1,0,1
15212,2022-12-30,BARLEY,heist,Hot Potato,0,1,0,1
15213,2022-12-30,BARLEY,gemGrab,Minecart Madness,0,1,0,1
15214,2022-12-30,BARLEY,gemGrab,Deep Diner,0,3,11,14
15215,2022-12-30,BARLEY,brawlBall,Sneaky Fields,0,1,0,1
15216,2022-12-29,BARLEY,heist,Hot Potato,0,2,0,2
15217,2022-12-25,BARLEY,hotZone,Ring of Fire,0,1,0,1
15218,2022-12-24,BARLEY,brawlBall,Super Beach,0,1,0,1
15219,2022-12-21,BARLEY,brawlBall,Sunny Soccer,0,2,0,2
15220,2022-12-13,BARLEY,brawlBall,Beach Ball,0,1,0,1
15221,2022-11-07,BARLEY,hotZone,Quarter Pounder,0,0,1,1
15222,2022-11-01,BARLEY,knockout,New Perspective,0,0,1,1
15223,2023-01-30,ASH,knockout,Belle's Rock,0,10,9,19
15224,2023-01-30,ASH,hotZone,Quarter Pounder,0,37,27,64
15225,2023-01-30,ASH,heist,Pit Stop,0,7,3,10
15226,2023-01-30,ASH,gemGrab,Minecart Madness,0,9,20,29
15227,2023-01-30,ASH,gemGrab,Double Swoosh,0,175,233,408
15228,2023-01-30,ASH,brawlBall,Center Stage,16,391,522,929
15229,2023-01-30,ASH,brawlBall,Backyard Bowl,0,5,5,10
15230,2023-01-30,ASH,bounty,Hideout,0,1,0,1
15231,2023-01-29,ASH,knockout,Belle's Rock,0,12,16,28
15232,2023-01-29,ASH,hotZone,Quarter Pounder,0,31,21,52
15233,2023-01-29,ASH,heist,Bridge Too Far,0,1,0,1
15234,2023-01-29,ASH,gemGrab,Hard Rock Mine,0,58,84,142
15235,2023-01-29,ASH,gemGrab,Double Swoosh,0,234,351,585
15236,2023-01-29,ASH,brawlBall,Super Beach,0,10,16,26
15237,2023-01-29,ASH,brawlBall,Backyard Bowl,0,68,79,147
15238,2023-01-29,ASH,bounty,Canal Grande,0,77,111,188
15239,2023-01-28,ASH,knockout,Flaring Phoenix,0,11,15,26
15240,2023-01-28,ASH,hotZone,Controller Chaos,0,114,179,293
15241,2023-01-28,ASH,heist,Bridge Too Far,0,6,2,8
15242,2023-01-28,ASH,gemGrab,Hard Rock Mine,0,270,358,628
15243,2023-01-28,ASH,gemGrab,Deep Diner,0,29,47,76
15244,2023-01-28,ASH,brawlBall,Super Beach,19,639,889,1547
15245,2023-01-28,ASH,brawlBall,Sneaky Fields,1,69,98,168
15246,2023-01-28,ASH,bounty,Canal Grande,0,136,221,357
15247,2023-01-27,ASH,knockout,Flaring Phoenix,0,8,2,10
15248,2023-01-27,ASH,hotZone,Controller Chaos,0,39,55,94
15249,2023-01-27,ASH,heist,Hot Potato,1,7,16,24
15250,2023-01-27,ASH,gemGrab,Undermine,0,13,9,22
15251,2023-01-27,ASH,gemGrab,Deep Diner,0,22,26,48
15252,2023-01-27,ASH,brawlBall,Sneaky Fields,6,324,390,720
15253,2023-01-27,ASH,brawlBall,Pinhole Punt,0,2,1,3
15254,2023-01-27,ASH,bounty,Temple Ruins,0,9,4,13
15255,2023-01-26,ASH,knockout,Riverside,0,1,0,1
15256,2023-01-26,ASH,hotZone,Open Zone,0,9,7,16
15257,2023-01-26,ASH,heist,Hot Potato,0,4,3,7
15258,2023-01-26,ASH,gemGrab,Undermine,0,80,114,194
15259,2023-01-26,ASH,gemGrab,Gem Fort,0,67,123,190
15260,2023-01-26,ASH,brawlBall,Sunny Soccer,0,34,49,83
15261,2023-01-26,ASH,brawlBall,Pinhole Punt,10,331,485,826
15262,2023-01-26,ASH,bounty,Temple Ruins,0,54,81,135
15263,2023-01-25,ASH,knockout,Riverside,0,3,4,7
15264,2023-01-25,ASH,hotZone,Open Zone,0,4,1,5
15265,2023-01-25,ASH,heist,Safe Zone,0,1,1,2
15266,2023-01-25,ASH,gemGrab,Gem Fort,0,70,133,203
15267,2023-01-25,ASH,gemGrab,Crystal Arcade,0,118,198,316
15268,2023-01-25,ASH,brawlBall,Sunny Soccer,6,279,361,646
15269,2023-01-25,ASH,brawlBall,Beach Ball,0,45,66,111
15270,2023-01-25,ASH,bounty,Excel,0,5,4,9
15271,2023-01-24,ASH,knockout,New Perspective,0,6,9,15
15272,2023-01-24,ASH,hotZone,Dueling Beetles,0,38,27,65
15273,2023-01-24,ASH,heist,Safe Zone,0,2,2,4
15274,2023-01-24,ASH,gemGrab,Minecart Madness,0,3,2,5
15275,2023-01-24,ASH,gemGrab,Crystal Arcade,0,197,282,479
15276,2023-01-24,ASH,brawlBall,Center Stage,5,84,106,195
15277,2023-01-24,ASH,brawlBall,Beach Ball,12,389,501,902
15278,2023-01-24,ASH,bounty,Excel,0,13,22,35
15279,2023-01-23,ASH,knockout,New Perspective,0,11,15,26
15280,2023-01-23,ASH,hotZone,Dueling Beetles,0,39,47,86
15281,2023-01-23,ASH,heist,Snaked Assault,0,24,14,38
15282,2023-01-23,ASH,gemGrab,Minecart Madness,0,22,20,42
15283,2023-01-23,ASH,gemGrab,Double Swoosh,0,106,120,226
15284,2023-01-23,ASH,brawlBall,Center Stage,20,835,1223,2078
15285,2023-01-23,ASH,brawlBall,Backyard Bowl,1,2,0,3
15286,2023-01-23,ASH,bounty,Layer Cake,0,34,40,74
15287,2023-01-22,ASH,knockout,X Marks the Spot,0,4,3,7
15288,2023-01-22,ASH,hotZone,Ring of Fire,0,39,72,111
15289,2023-01-22,ASH,heist,Snaked Assault,0,12,10,22
15290,2023-01-22,ASH,gemGrab,Hard Rock Mine,0,86,123,209
15291,2023-01-22,ASH,gemGrab,Double Swoosh,0,120,157,277
15292,2023-01-22,ASH,brawlBall,Super Beach,1,36,55,92
15293,2023-01-22,ASH,brawlBall,Backyard Bowl,0,26,23,49
15294,2023-01-22,ASH,bounty,Layer Cake,0,24,49,73
15295,2023-01-21,ASH,knockout,X Marks the Spot,0,29,36,65
15296,2023-01-21,ASH,hotZone,Ring of Fire,0,94,117,211
15297,2023-01-21,ASH,heist,Tornado Ring,0,18,9,27
15298,2023-01-21,ASH,gemGrab,Hard Rock Mine,0,324,464,788
15299,2023-01-21,ASH,gemGrab,Deep Diner,0,19,46,65
15300,2023-01-21,ASH,brawlBall,Super Beach,30,847,1127,2004
15301,2023-01-21,ASH,brawlBall,Sneaky Fields,0,58,73,131
15302,2023-01-21,ASH,bounty,Dry Season,0,10,3,13
15303,2023-01-20,ASH,knockout,Out in the Open,0,8,5,13
15304,2023-01-20,ASH,hotZone,Split,0,54,86,140
15305,2023-01-20,ASH,heist,Tornado Ring,0,19,21,40
15306,2023-01-20,ASH,gemGrab,Undermine,0,79,141,220
15307,2023-01-20,ASH,gemGrab,Deep Diner,0,81,97,178
15308,2023-01-20,ASH,brawlBall,Sneaky Fields,32,915,1328,2275
15309,2023-01-20,ASH,brawlBall,Pinhole Punt,0,11,25,36
15310,2023-01-20,ASH,bounty,Dry Season,0,4,3,7
15311,2023-01-19,ASH,knockout,Out in the Open,0,9,20,29
15312,2023-01-19,ASH,hotZone,Split,0,113,274,387
15313,2023-01-19,ASH,heist,Kaboom Canyon,0,7,3,10
15314,2023-01-19,ASH,gemGrab,Undermine,0,160,181,341
15315,2023-01-19,ASH,gemGrab,Gem Fort,0,52,104,156
15316,2023-01-19,ASH,brawlBall,Sunny Soccer,1,15,47,63
15317,2023-01-19,ASH,brawlBall,Pinhole Punt,18,356,537,911
15318,2023-01-19,ASH,bounty,Shooting Star,0,5,19,24
15319,2023-01-18,ASH,knockout,Goldarm Gulch,0,1,3,4
15320,2023-01-18,ASH,hotZone,Parallel Plays,0,13,22,35
15321,2023-01-18,ASH,heist,Kaboom Canyon,0,2,0,2
15322,2023-01-18,ASH,gemGrab,Gem Fort,0,29,41,70
15323,2023-01-18,ASH,gemGrab,Crystal Arcade,0,14,28,42
15324,2023-01-18,ASH,brawlBall,Sunny Soccer,1,148,188,337
15325,2023-01-18,ASH,brawlBall,Beach Ball,0,3,4,7
15326,2023-01-17,ASH,knockout,Goldarm Gulch,0,2,0,2
15327,2023-01-17,ASH,hotZone,Parallel Plays,0,21,26,47
15328,2023-01-17,ASH,heist,Pit Stop,0,2,0,2
15329,2023-01-17,ASH,gemGrab,Minecart Madness,0,0,2,2
15330,2023-01-17,ASH,gemGrab,Crystal Arcade,0,22,25,47
15331,2023-01-17,ASH,brawlBall,Center Stage,1,3,6,10
15332,2023-01-17,ASH,brawlBall,Beach Ball,2,23,31,56
15333,2023-01-16,ASH,knockout,Belle's Rock,0,1,0,1
15334,2023-01-16,ASH,hotZone,Quarter Pounder,0,11,11,22
15335,2023-01-16,ASH,heist,Pit Stop,0,2,1,3
15336,2023-01-16,ASH,gemGrab,Minecart Madness,0,1,1,2
15337,2023-01-16,ASH,gemGrab,Double Swoosh,0,8,12,20
15338,2023-01-16,ASH,brawlBall,Center Stage,0,57,62,119
15339,2023-01-16,ASH,brawlBall,Backyard Bowl,0,1,2,3
15340,2023-01-16,ASH,bounty,Hideout,0,2,1,3
15341,2023-01-15,ASH,hotZone,Quarter Pounder,0,18,14,32
15342,2023-01-15,ASH,heist,Bridge Too Far,0,2,0,2
15343,2023-01-15,ASH,gemGrab,Hard Rock Mine,0,17,18,35
15344,2023-01-15,ASH,gemGrab,Double Swoosh,0,20,10,30
15345,2023-01-15,ASH,brawlBall,Super Beach,2,12,31,45
15346,2023-01-15,ASH,brawlBall,Backyard Bowl,0,10,11,21
15347,2023-01-15,ASH,bounty,Canal Grande,0,12,40,52
15348,2023-01-14,ASH,knockout,Flaring Phoenix,0,3,10,13
15349,2023-01-14,ASH,hotZone,Controller Chaos,0,36,68,104
15350,2023-01-14,ASH,heist,Bridge Too Far,0,1,0,1
15351,2023-01-14,ASH,gemGrab,Hard Rock Mine,0,25,30,55
15352,2023-01-14,ASH,gemGrab,Deep Diner,0,8,3,11
15353,2023-01-14,ASH,brawlBall,Super Beach,0,68,98,166
15354,2023-01-14,ASH,brawlBall,Sneaky Fields,1,16,18,35
15355,2023-01-14,ASH,bounty,Canal Grande,0,7,12,19
15356,2023-01-13,ASH,knockout,Flaring Phoenix,0,2,0,2
15357,2023-01-13,ASH,hotZone,Controller Chaos,0,33,58,91
15358,2023-01-13,ASH,gemGrab,Deep Diner,0,11,7,18
15359,2023-01-13,ASH,brawlBall,Sneaky Fields,1,110,184,295
15360,2023-01-13,ASH,brawlBall,Pinhole Punt,0,2,1,3
15361,2023-01-13,ASH,bounty,Temple Ruins,0,1,1,2
15362,2023-01-12,ASH,hotZone,Open Zone,0,0,1,1
15363,2023-01-12,ASH,gemGrab,Undermine,0,14,22,36
15364,2023-01-12,ASH,gemGrab,Gem Fort,0,5,7,12
15365,2023-01-12,ASH,brawlBall,Sunny Soccer,0,3,2,5
15366,2023-01-12,ASH,brawlBall,Pinhole Punt,2,16,26,44
15367,2023-01-11,ASH,gemGrab,Gem Fort,0,6,14,20
15368,2023-01-11,ASH,brawlBall,Sunny Soccer,1,13,9,23
15369,2023-01-11,ASH,brawlBall,Beach Ball,0,0,2,2
15370,2023-01-10,ASH,hotZone,Dueling Beetles,0,10,5,15
15371,2023-01-10,ASH,gemGrab,Minecart Madness,0,3,0,3
15372,2023-01-10,ASH,gemGrab,Crystal Arcade,0,21,54,75
15373,2023-01-10,ASH,brawlBall,Center Stage,0,11,15,26
15374,2023-01-10,ASH,brawlBall,Beach Ball,1,24,82,107
15375,2023-01-09,ASH,hotZone,Dueling Beetles,0,8,1,9
15376,2023-01-09,ASH,heist,Snaked Assault,0,5,1,6
15377,2023-01-09,ASH,gemGrab,Minecart Madness,0,5,19,24
15378,2023-01-09,ASH,gemGrab,Double Swoosh,0,31,60,91
15379,2023-01-09,ASH,brawlBall,Center Stage,3,35,77,115
15380,2023-01-09,ASH,bounty,Layer Cake,0,3,18,21
15381,2023-01-08,ASH,knockout,X Marks the Spot,0,0,4,4
15382,2023-01-08,ASH,hotZone,Ring of Fire,0,8,5,13
15383,2023-01-08,ASH,heist,Snaked Assault,0,1,0,1
15384,2023-01-08,ASH,gemGrab,Hard Rock Mine,0,6,4,10
15385,2023-01-08,ASH,gemGrab,Double Swoosh,0,7,1,8
15386,2023-01-08,ASH,brawlBall,Super Beach,1,4,2,7
15387,2023-01-08,ASH,brawlBall,Backyard Bowl,1,7,5,13
15388,2023-01-08,ASH,bounty,Layer Cake,0,3,6,9
15389,2023-01-07,ASH,hotZone,Ring of Fire,0,2,0,2
15390,2023-01-07,ASH,heist,Tornado Ring,0,1,0,1
15391,2023-01-07,ASH,gemGrab,Hard Rock Mine,0,13,25,38
15392,2023-01-07,ASH,gemGrab,Deep Diner,0,4,1,5
15393,2023-01-07,ASH,brawlBall,Super Beach,1,14,34,49
15394,2023-01-07,ASH,brawlBall,Sneaky Fields,1,14,32,47
15395,2023-01-06,ASH,hotZone,Split,0,10,8,18
15396,2023-01-06,ASH,heist,Tornado Ring,0,2,5,7
15397,2023-01-06,ASH,gemGrab,Undermine,0,6,3,9
15398,2023-01-06,ASH,gemGrab,Deep Diner,0,8,15,23
15399,2023-01-06,ASH,brawlBall,Sneaky Fields,3,96,147,246
15400,2023-01-06,ASH,bounty,Dry Season,0,0,3,3
15401,2023-01-05,ASH,knockout,Out in the Open,0,1,0,1
15402,2023-01-05,ASH,hotZone,Split,1,19,41,61
15403,2023-01-05,ASH,gemGrab,Undermine,0,22,28,50
15404,2023-01-05,ASH,gemGrab,Gem Fort,0,4,1,5
15405,2023-01-05,ASH,brawlBall,Sunny Soccer,0,0,1,1
15406,2023-01-05,ASH,brawlBall,Pinhole Punt,3,65,66,134
15407,2023-01-04,ASH,knockout,Goldarm Gulch,0,1,0,1
15408,2023-01-04,ASH,hotZone,Parallel Plays,0,12,8,20
15409,2023-01-04,ASH,heist,Kaboom Canyon,0,2,1,3
15410,2023-01-04,ASH,gemGrab,Gem Fort,0,28,41,69
15411,2023-01-04,ASH,gemGrab,Crystal Arcade,0,12,38,50
15412,2023-01-04,ASH,brawlBall,Sunny Soccer,1,45,55,101
15413,2023-01-04,ASH,bounty,Shooting Star,0,2,1,3
15414,2023-01-03,ASH,knockout,Goldarm Gulch,0,0,1,1
15415,2023-01-03,ASH,hotZone,Parallel Plays,0,14,6,20
15416,2023-01-03,ASH,heist,Pit Stop,0,2,1,3
15417,2023-01-03,ASH,gemGrab,Crystal Arcade,0,19,28,47
15418,2023-01-03,ASH,brawlBall,Center Stage,0,1,0,1
15419,2023-01-03,ASH,brawlBall,Beach Ball,0,22,16,38
15420,2023-01-03,ASH,bounty,Hideout,0,1,0,1
15421,2023-01-02,ASH,knockout,Belle's Rock,0,0,5,5
15422,2023-01-02,ASH,hotZone,Quarter Pounder,0,10,4,14
15423,2023-01-02,ASH,heist,Pit Stop,0,0,1,1
15424,2023-01-02,ASH,gemGrab,Minecart Madness,0,3,0,3
15425,2023-01-02,ASH,gemGrab,Double Swoosh,0,7,12,19
15426,2023-01-02,ASH,brawlBall,Center Stage,1,60,82,143
15427,2023-01-02,ASH,bounty,Hideout,0,1,1,2
15428,2023-01-01,ASH,hotZone,Quarter Pounder,0,2,0,2
15429,2023-01-01,ASH,gemGrab,Hard Rock Mine,0,4,4,8
15430,2023-01-01,ASH,gemGrab,Double Swoosh,0,13,20,33
15431,2023-01-01,ASH,brawlBall,Backyard Bowl,0,0,1,1
15432,2022-12-31,ASH,hotZone,Controller Chaos,0,1,0,1
15433,2022-12-31,ASH,gemGrab,Hard Rock Mine,0,2,0,2
15434,2022-12-31,ASH,gemGrab,Deep Diner,0,1,0,1
15435,2022-12-31,ASH,brawlBall,Super Beach,0,4,4,8
15436,2022-12-31,ASH,brawlBall,Sneaky Fields,0,1,1,2
15437,2022-12-30,ASH,hotZone,Controller Chaos,0,4,3,7
15438,2022-12-30,ASH,gemGrab,Undermine,0,1,1,2
15439,2022-12-30,ASH,gemGrab,Minecart Madness,0,1,0,1
15440,2022-12-30,ASH,gemGrab,Deep Diner,0,1,0,1
15441,2022-12-30,ASH,brawlBall,Sneaky Fields,0,4,5,9
15442,2022-12-29,ASH,heist,Kaboom Canyon,0,1,0,1
15443,2022-12-29,ASH,gemGrab,Undermine,0,0,1,1
15444,2022-12-29,ASH,brawlBall,Pinhole Punt,0,2,4,6
15445,2022-12-24,ASH,brawlBall,Super Beach,0,1,0,1
15446,2022-12-22,ASH,gemGrab,Gem Fort,0,0,1,1
15447,2022-12-21,ASH,brawlBall,Sunny Soccer,0,1,0,1
15448,2022-12-19,ASH,brawlBall,Center Stage,0,3,2,5
15449,2022-12-16,ASH,brawlBall,Sneaky Fields,0,2,5,7
15450,2022-12-13,ASH,gemGrab,Crystal Arcade,0,0,1,1
15451,2022-12-10,ASH,gemGrab,Hard Rock Mine,0,1,0,1
15452,2022-11-01,ASH,knockout,New Perspective,0,1,0,1
15453,2023-01-30,AMBER,knockout,Belle's Rock,0,19,17,36
15454,2023-01-30,AMBER,hotZone,Quarter Pounder,0,72,74,146
15455,2023-01-30,AMBER,heist,Pit Stop,0,12,4,16
15456,2023-01-30,AMBER,gemGrab,Minecart Madness,0,36,43,79
15457,2023-01-30,AMBER,gemGrab,Double Swoosh,0,98,106,204
15458,2023-01-30,AMBER,brawlBall,Center Stage,5,109,131,245
15459,2023-01-30,AMBER,brawlBall,Backyard Bowl,1,26,36,63
15460,2023-01-30,AMBER,bounty,Hideout,0,1,7,8
15461,2023-01-29,AMBER,knockout,Belle's Rock,0,15,9,24
15462,2023-01-29,AMBER,hotZone,Quarter Pounder,0,39,36,75
15463,2023-01-29,AMBER,heist,Bridge Too Far,0,75,67,142
15464,2023-01-29,AMBER,gemGrab,Hard Rock Mine,0,8,3,11
15465,2023-01-29,AMBER,gemGrab,Double Swoosh,0,182,223,405
15466,2023-01-29,AMBER,brawlBall,Super Beach,0,0,1,1
15467,2023-01-29,AMBER,brawlBall,Backyard Bowl,19,241,278,538
15468,2023-01-29,AMBER,bounty,Canal Grande,0,9,3,12
15469,2023-01-28,AMBER,knockout,Flaring Phoenix,0,9,8,17
15470,2023-01-28,AMBER,hotZone,Controller Chaos,0,54,90,144
15471,2023-01-28,AMBER,heist,Bridge Too Far,0,146,162,308
15472,2023-01-28,AMBER,gemGrab,Hard Rock Mine,0,20,13,33
15473,2023-01-28,AMBER,gemGrab,Deep Diner,0,5,5,10
15474,2023-01-28,AMBER,brawlBall,Super Beach,7,121,138,266
15475,2023-01-28,AMBER,brawlBall,Sneaky Fields,0,4,1,5
15476,2023-01-28,AMBER,bounty,Canal Grande,0,5,8,13
15477,2023-01-27,AMBER,knockout,Flaring Phoenix,0,6,3,9
15478,2023-01-27,AMBER,hotZone,Controller Chaos,0,17,16,33
15479,2023-01-27,AMBER,heist,Hot Potato,0,12,10,22
15480,2023-01-27,AMBER,gemGrab,Undermine,0,8,10,18
15481,2023-01-27,AMBER,gemGrab,Deep Diner,0,20,21,41
15482,2023-01-27,AMBER,brawlBall,Sneaky Fields,2,41,62,105
15483,2023-01-27,AMBER,brawlBall,Pinhole Punt,0,1,3,4
15484,2023-01-27,AMBER,bounty,Temple Ruins,0,8,26,34
15485,2023-01-26,AMBER,knockout,Riverside,0,24,13,37
15486,2023-01-26,AMBER,hotZone,Open Zone,0,119,222,341
15487,2023-01-26,AMBER,heist,Hot Potato,0,33,31,64
15488,2023-01-26,AMBER,gemGrab,Undermine,0,55,78,133
15489,2023-01-26,AMBER,gemGrab,Gem Fort,0,8,8,16
15490,2023-01-26,AMBER,brawlBall,Sunny Soccer,0,6,3,9
15491,2023-01-26,AMBER,brawlBall,Pinhole Punt,6,187,251,444
15492,2023-01-26,AMBER,bounty,Temple Ruins,0,23,39,62
15493,2023-01-25,AMBER,knockout,Riverside,0,14,7,21
15494,2023-01-25,AMBER,hotZone,Open Zone,0,69,80,149
15495,2023-01-25,AMBER,heist,Safe Zone,0,23,22,45
15496,2023-01-25,AMBER,gemGrab,Gem Fort,0,28,39,67
15497,2023-01-25,AMBER,gemGrab,Crystal Arcade,0,15,13,28
15498,2023-01-25,AMBER,brawlBall,Sunny Soccer,4,71,86,161
15499,2023-01-25,AMBER,brawlBall,Beach Ball,0,15,9,24
15500,2023-01-25,AMBER,bounty,Excel,0,5,0,5
15501,2023-01-24,AMBER,knockout,New Perspective,0,20,18,38
15502,2023-01-24,AMBER,hotZone,Dueling Beetles,0,54,61,115
15503,2023-01-24,AMBER,heist,Safe Zone,1,67,55,123
15504,2023-01-24,AMBER,gemGrab,Minecart Madness,0,17,16,33
15505,2023-01-24,AMBER,gemGrab,Crystal Arcade,0,55,55,110
15506,2023-01-24,AMBER,brawlBall,Center Stage,1,15,22,38
15507,2023-01-24,AMBER,brawlBall,Beach Ball,5,116,112,233
15508,2023-01-24,AMBER,bounty,Excel,0,11,8,19
15509,2023-01-23,AMBER,knockout,New Perspective,0,40,26,66
15510,2023-01-23,AMBER,hotZone,Dueling Beetles,0,91,112,203
15511,2023-01-23,AMBER,heist,Snaked Assault,1,106,85,192
15512,2023-01-23,AMBER,gemGrab,Minecart Madness,0,89,108,197
15513,2023-01-23,AMBER,gemGrab,Double Swoosh,0,82,142,224
15514,2023-01-23,AMBER,brawlBall,Center Stage,9,181,182,372
15515,2023-01-23,AMBER,brawlBall,Backyard Bowl,0,8,38,46
15516,2023-01-23,AMBER,bounty,Layer Cake,0,13,5,18
15517,2023-01-22,AMBER,knockout,X Marks the Spot,0,8,3,11
15518,2023-01-22,AMBER,hotZone,Ring of Fire,0,58,89,147
15519,2023-01-22,AMBER,heist,Snaked Assault,0,48,39,87
15520,2023-01-22,AMBER,gemGrab,Hard Rock Mine,0,11,9,20
15521,2023-01-22,AMBER,gemGrab,Double Swoosh,0,83,133,216
15522,2023-01-22,AMBER,brawlBall,Super Beach,0,13,7,20
15523,2023-01-22,AMBER,brawlBall,Backyard Bowl,6,104,128,238
15524,2023-01-22,AMBER,bounty,Layer Cake,0,7,6,13
15525,2023-01-21,AMBER,knockout,X Marks the Spot,0,34,21,55
15526,2023-01-21,AMBER,hotZone,Ring of Fire,0,137,210,347
15527,2023-01-21,AMBER,heist,Tornado Ring,1,32,20,53
15528,2023-01-21,AMBER,gemGrab,Hard Rock Mine,0,56,39,95
15529,2023-01-21,AMBER,gemGrab,Deep Diner,0,24,13,37
15530,2023-01-21,AMBER,brawlBall,Super Beach,7,110,118,235
15531,2023-01-21,AMBER,brawlBall,Sneaky Fields,0,2,0,2
15532,2023-01-21,AMBER,bounty,Dry Season,0,18,12,30
15533,2023-01-20,AMBER,knockout,Out in the Open,0,35,21,56
15534,2023-01-20,AMBER,hotZone,Split,0,20,9,29
15535,2023-01-20,AMBER,heist,Tornado Ring,0,34,35,69
15536,2023-01-20,AMBER,gemGrab,Undermine,0,24,51,75
15537,2023-01-20,AMBER,gemGrab,Deep Diner,0,55,37,92
15538,2023-01-20,AMBER,brawlBall,Sneaky Fields,3,111,101,215
15539,2023-01-20,AMBER,brawlBall,Pinhole Punt,1,3,4,8
15540,2023-01-20,AMBER,bounty,Dry Season,0,6,10,16
15541,2023-01-19,AMBER,knockout,Out in the Open,0,33,19,52
15542,2023-01-19,AMBER,hotZone,Split,0,19,13,32
15543,2023-01-19,AMBER,heist,Kaboom Canyon,0,39,73,112
15544,2023-01-19,AMBER,gemGrab,Undermine,0,94,134,228
15545,2023-01-19,AMBER,gemGrab,Gem Fort,0,8,21,29
15546,2023-01-19,AMBER,brawlBall,Sunny Soccer,1,3,3,7
15547,2023-01-19,AMBER,brawlBall,Pinhole Punt,8,203,255,466
15548,2023-01-19,AMBER,bounty,Shooting Star,0,15,7,22
15549,2023-01-18,AMBER,knockout,Goldarm Gulch,0,3,2,5
15550,2023-01-18,AMBER,hotZone,Parallel Plays,0,5,10,15
15551,2023-01-18,AMBER,heist,Kaboom Canyon,0,26,41,67
15552,2023-01-18,AMBER,gemGrab,Gem Fort,0,14,14,28
15553,2023-01-18,AMBER,gemGrab,Crystal Arcade,0,3,3,6
15554,2023-01-18,AMBER,brawlBall,Sunny Soccer,2,35,31,68
15555,2023-01-18,AMBER,brawlBall,Beach Ball,0,1,0,1
15556,2023-01-18,AMBER,bounty,Shooting Star,0,6,8,14
15557,2023-01-17,AMBER,knockout,Goldarm Gulch,0,3,5,8
15558,2023-01-17,AMBER,hotZone,Parallel Plays,0,5,6,11
15559,2023-01-17,AMBER,heist,Pit Stop,0,1,1,2
15560,2023-01-17,AMBER,gemGrab,Crystal Arcade,0,4,3,7
15561,2023-01-17,AMBER,brawlBall,Center Stage,0,0,1,1
15562,2023-01-17,AMBER,brawlBall,Beach Ball,1,13,11,25
15563,2023-01-17,AMBER,bounty,Hideout,0,1,0,1
15564,2023-01-16,AMBER,knockout,Belle's Rock,0,1,1,2
15565,2023-01-16,AMBER,hotZone,Quarter Pounder,0,12,12,24
15566,2023-01-16,AMBER,heist,Pit Stop,0,0,2,2
15567,2023-01-16,AMBER,gemGrab,Minecart Madness,0,2,2,4
15568,2023-01-16,AMBER,gemGrab,Double Swoosh,0,10,18,28
15569,2023-01-16,AMBER,brawlBall,Center Stage,0,5,6,11
15570,2023-01-16,AMBER,brawlBall,Backyard Bowl,0,2,2,4
15571,2023-01-15,AMBER,knockout,Belle's Rock,0,2,1,3
15572,2023-01-15,AMBER,hotZone,Quarter Pounder,0,12,6,18
15573,2023-01-15,AMBER,heist,Bridge Too Far,0,18,42,60
15574,2023-01-15,AMBER,gemGrab,Hard Rock Mine,0,0,2,2
15575,2023-01-15,AMBER,gemGrab,Double Swoosh,0,20,38,58
15576,2023-01-15,AMBER,brawlBall,Super Beach,0,1,1,2
15577,2023-01-15,AMBER,brawlBall,Backyard Bowl,1,29,29,59
15578,2023-01-14,AMBER,hotZone,Controller Chaos,0,17,27,44
15579,2023-01-14,AMBER,heist,Bridge Too Far,0,27,29,56
15580,2023-01-14,AMBER,gemGrab,Hard Rock Mine,0,1,1,2
15581,2023-01-14,AMBER,gemGrab,Deep Diner,0,1,2,3
15582,2023-01-14,AMBER,brawlBall,Super Beach,0,10,2,12
15583,2023-01-14,AMBER,bounty,Canal Grande,0,1,0,1
15584,2023-01-13,AMBER,knockout,Flaring Phoenix,0,2,1,3
15585,2023-01-13,AMBER,hotZone,Controller Chaos,0,19,12,31
15586,2023-01-13,AMBER,heist,Hot Potato,0,2,0,2
15587,2023-01-13,AMBER,gemGrab,Deep Diner,0,5,1,6
15588,2023-01-13,AMBER,brawlBall,Sneaky Fields,0,5,7,12
15589,2023-01-13,AMBER,brawlBall,Pinhole Punt,0,2,5,7
15590,2023-01-13,AMBER,bounty,Temple Ruins,0,4,2,6
15591,2023-01-12,AMBER,knockout,Riverside,0,16,23,39
15592,2023-01-12,AMBER,hotZone,Open Zone,0,15,36,51
15593,2023-01-12,AMBER,heist,Hot Potato,0,2,0,2
15594,2023-01-12,AMBER,gemGrab,Undermine,0,11,15,26
15595,2023-01-12,AMBER,gemGrab,Gem Fort,0,0,4,4
15596,2023-01-12,AMBER,brawlBall,Pinhole Punt,0,6,6,12
15597,2023-01-11,AMBER,knockout,Riverside,0,2,0,2
15598,2023-01-11,AMBER,hotZone,Open Zone,0,8,14,22
15599,2023-01-11,AMBER,gemGrab,Gem Fort,0,3,1,4
15600,2023-01-11,AMBER,brawlBall,Sunny Soccer,0,1,0,1
15601,2023-01-10,AMBER,hotZone,Dueling Beetles,0,9,9,18
15602,2023-01-10,AMBER,heist,Safe Zone,0,2,1,3
15603,2023-01-10,AMBER,gemGrab,Minecart Madness,0,4,6,10
15604,2023-01-10,AMBER,gemGrab,Crystal Arcade,0,4,0,4
15605,2023-01-10,AMBER,brawlBall,Center Stage,1,2,2,5
15606,2023-01-10,AMBER,brawlBall,Beach Ball,0,2,6,8
15607,2023-01-09,AMBER,knockout,New Perspective,0,0,1,1
15608,2023-01-09,AMBER,hotZone,Dueling Beetles,0,12,7,19
15609,2023-01-09,AMBER,heist,Snaked Assault,0,6,6,12
15610,2023-01-09,AMBER,gemGrab,Minecart Madness,0,5,3,8
15611,2023-01-09,AMBER,gemGrab,Double Swoosh,0,12,35,47
15612,2023-01-09,AMBER,brawlBall,Center Stage,0,16,30,46
15613,2023-01-09,AMBER,brawlBall,Backyard Bowl,0,2,0,2
15614,2023-01-09,AMBER,bounty,Layer Cake,0,2,0,2
15615,2023-01-08,AMBER,hotZone,Ring of Fire,0,17,20,37
15616,2023-01-08,AMBER,heist,Snaked Assault,0,10,6,16
15617,2023-01-08,AMBER,gemGrab,Double Swoosh,0,4,6,10
15618,2023-01-08,AMBER,brawlBall,Backyard Bowl,1,25,62,88
15619,2023-01-08,AMBER,bounty,Layer Cake,0,1,13,14
15620,2023-01-07,AMBER,knockout,X Marks the Spot,0,2,0,2
15621,2023-01-07,AMBER,hotZone,Ring of Fire,0,0,2,2
15622,2023-01-07,AMBER,heist,Tornado Ring,0,3,0,3
15623,2023-01-07,AMBER,gemGrab,Hard Rock Mine,0,1,1,2
15624,2023-01-07,AMBER,brawlBall,Super Beach,0,0,2,2
15625,2023-01-07,AMBER,bounty,Dry Season,0,0,10,10
15626,2023-01-06,AMBER,knockout,Out in the Open,0,1,0,1
15627,2023-01-06,AMBER,hotZone,Split,0,1,8,9
15628,2023-01-06,AMBER,heist,Tornado Ring,0,2,1,3
15629,2023-01-06,AMBER,gemGrab,Undermine,0,4,12,16
15630,2023-01-06,AMBER,gemGrab,Deep Diner,0,4,1,5
15631,2023-01-06,AMBER,brawlBall,Sneaky Fields,0,5,8,13
15632,2023-01-06,AMBER,brawlBall,Pinhole Punt,0,1,0,1
15633,2023-01-05,AMBER,knockout,Out in the Open,0,1,2,3
15634,2023-01-05,AMBER,hotZone,Split,0,4,16,20
15635,2023-01-05,AMBER,heist,Kaboom Canyon,0,10,29,39
15636,2023-01-05,AMBER,gemGrab,Undermine,0,16,23,39
15637,2023-01-05,AMBER,brawlBall,Pinhole Punt,0,6,37,43
15638,2023-01-05,AMBER,bounty,Shooting Star,0,2,0,2
15639,2023-01-04,AMBER,hotZone,Parallel Plays,0,6,8,14
15640,2023-01-04,AMBER,heist,Kaboom Canyon,0,24,18,42
15641,2023-01-04,AMBER,gemGrab,Gem Fort,0,6,4,10
15642,2023-01-04,AMBER,brawlBall,Sunny Soccer,0,4,4,8
15643,2023-01-04,AMBER,bounty,Shooting Star,0,2,0,2
15644,2023-01-03,AMBER,hotZone,Parallel Plays,0,5,10,15
15645,2023-01-03,AMBER,heist,Pit Stop,0,2,0,2
15646,2023-01-03,AMBER,gemGrab,Minecart Madness,0,2,0,2
15647,2023-01-03,AMBER,gemGrab,Crystal Arcade,0,3,2,5
15648,2023-01-03,AMBER,brawlBall,Center Stage,0,1,0,1
15649,2023-01-03,AMBER,brawlBall,Beach Ball,0,13,10,23
15650,2023-01-03,AMBER,bounty,Hideout,0,0,1,1
15651,2023-01-02,AMBER,knockout,Belle's Rock,0,2,1,3
15652,2023-01-02,AMBER,hotZone,Quarter Pounder,1,12,2,15
15653,2023-01-02,AMBER,hotZone,Controller Chaos,0,1,0,1
15654,2023-01-02,AMBER,heist,Pit Stop,0,1,0,1
15655,2023-01-02,AMBER,gemGrab,Minecart Madness,0,11,1,12
15656,2023-01-02,AMBER,gemGrab,Double Swoosh,0,22,39,61
15657,2023-01-02,AMBER,brawlBall,Center Stage,0,16,23,39
15658,2023-01-02,AMBER,bounty,Hideout,0,2,0,2
15659,2023-01-01,AMBER,knockout,Belle's Rock,0,0,1,1
15660,2023-01-01,AMBER,hotZone,Quarter Pounder,0,4,11,15
15661,2023-01-01,AMBER,heist,Bridge Too Far,0,5,5,10
15662,2023-01-01,AMBER,gemGrab,Double Swoosh,0,16,17,33
15663,2023-01-01,AMBER,brawlBall,Backyard Bowl,0,11,9,20
15664,2022-12-31,AMBER,hotZone,Controller Chaos,0,1,0,1
15665,2022-12-31,AMBER,heist,Bridge Too Far,0,2,1,3
15666,2022-12-31,AMBER,gemGrab,Hard Rock Mine,0,2,0,2
15667,2022-12-31,AMBER,gemGrab,Deep Diner,0,4,10,14
15668,2022-12-30,AMBER,hotZone,Controller Chaos,0,1,0,1
15669,2022-12-30,AMBER,brawlBall,Sneaky Fields,0,2,0,2
15670,2022-12-29,AMBER,hotZone,Open Zone,0,0,2,2
15671,2022-12-29,AMBER,gemGrab,Undermine,0,6,13,19
15672,2022-12-29,AMBER,gemGrab,Gem Fort,0,1,0,1
15673,2022-12-29,AMBER,brawlBall,Pinhole Punt,0,1,1,2
15674,2022-12-28,AMBER,hotZone,Open Zone,0,2,3,5
15675,2022-12-27,AMBER,hotZone,Controller Chaos,0,1,0,1
15676,2022-12-27,AMBER,brawlBall,Beach Ball,0,1,0,1
15677,2022-12-26,AMBER,gemGrab,Minecart Madness,0,0,1,1
15678,2022-12-25,AMBER,hotZone,Ring of Fire,0,1,0,1
15679,2022-12-25,AMBER,brawlBall,Backyard Bowl,0,3,2,5
15680,2022-12-24,AMBER,brawlBall,Super Beach,0,2,1,3
15681,2022-12-18,AMBER,heist,Bridge Too Far,0,0,1,1
15682,2022-12-16,AMBER,brawlBall,Sneaky Fields,0,1,0,1
15683,2022-12-10,AMBER,hotZone,Ring of Fire,0,0,1,1
15684,2023-01-30,8-BIT,knockout,Belle's Rock,0,11,11,22
15685,2023-01-30,8-BIT,hotZone,Quarter Pounder,0,37,29,66
15686,2023-01-30,8-BIT,heist,Pit Stop,0,3,6,9
15687,2023-01-30,8-BIT,gemGrab,Minecart Madness,0,15,50,65
15688,2023-01-30,8-BIT,gemGrab,Double Swoosh,0,31,32,63
15689,2023-01-30,8-BIT,brawlBall,Center Stage,4,37,34,75
15690,2023-01-30,8-BIT,brawlBall,Backyard Bowl,1,29,46,76
15691,2023-01-30,8-BIT,bounty,Hideout,0,5,2,7
15692,2023-01-29,8-BIT,knockout,Belle's Rock,0,13,8,21
15693,2023-01-29,8-BIT,hotZone,Quarter Pounder,0,19,12,31
15694,2023-01-29,8-BIT,heist,Bridge Too Far,0,267,271,538
15695,2023-01-29,8-BIT,gemGrab,Hard Rock Mine,0,21,23,44
15696,2023-01-29,8-BIT,gemGrab,Double Swoosh,0,36,42,78
15697,2023-01-29,8-BIT,brawlBall,Super Beach,0,2,1,3
15698,2023-01-29,8-BIT,brawlBall,Backyard Bowl,20,223,369,612
15699,2023-01-29,8-BIT,bounty,Canal Grande,0,0,1,1
15700,2023-01-28,8-BIT,knockout,Flaring Phoenix,1,38,60,99
15701,2023-01-28,8-BIT,hotZone,Controller Chaos,0,7,3,10
15702,2023-01-28,8-BIT,heist,Bridge Too Far,4,615,754,1373
15703,2023-01-28,8-BIT,gemGrab,Hard Rock Mine,0,167,269,436
15704,2023-01-28,8-BIT,gemGrab,Deep Diner,0,26,30,56
15705,2023-01-28,8-BIT,brawlBall,Super Beach,2,35,46,83
15706,2023-01-28,8-BIT,brawlBall,Sneaky Fields,0,0,4,4
15707,2023-01-28,8-BIT,bounty,Canal Grande,0,8,3,11
15708,2023-01-27,8-BIT,knockout,Flaring Phoenix,0,22,27,49
15709,2023-01-27,8-BIT,hotZone,Controller Chaos,0,3,1,4
15710,2023-01-27,8-BIT,heist,Hot Potato,0,20,9,29
15711,2023-01-27,8-BIT,gemGrab,Undermine,0,6,20,26
15712,2023-01-27,8-BIT,gemGrab,Deep Diner,0,20,39,59
15713,2023-01-27,8-BIT,brawlBall,Sneaky Fields,1,16,18,35
15714,2023-01-27,8-BIT,brawlBall,Pinhole Punt,0,2,0,2
15715,2023-01-27,8-BIT,bounty,Temple Ruins,0,9,14,23
15716,2023-01-26,8-BIT,knockout,Riverside,0,56,52,108
15717,2023-01-26,8-BIT,hotZone,Open Zone,0,32,30,62
15718,2023-01-26,8-BIT,heist,Hot Potato,0,67,62,129
15719,2023-01-26,8-BIT,gemGrab,Undermine,0,48,57,105
15720,2023-01-26,8-BIT,gemGrab,Gem Fort,0,22,27,49
15721,2023-01-26,8-BIT,brawlBall,Sunny Soccer,0,2,2,4
15722,2023-01-26,8-BIT,brawlBall,Pinhole Punt,7,104,168,279
15723,2023-01-26,8-BIT,bounty,Temple Ruins,0,12,5,17
15724,2023-01-25,8-BIT,knockout,Riverside,0,20,27,47
15725,2023-01-25,8-BIT,hotZone,Open Zone,0,34,30,64
15726,2023-01-25,8-BIT,heist,Safe Zone,0,102,131,233
15727,2023-01-25,8-BIT,gemGrab,Gem Fort,0,16,18,34
15728,2023-01-25,8-BIT,gemGrab,Crystal Arcade,0,27,47,74
15729,2023-01-25,8-BIT,brawlBall,Sunny Soccer,0,15,33,48
15730,2023-01-25,8-BIT,brawlBall,Beach Ball,0,4,3,7
15731,2023-01-25,8-BIT,bounty,Excel,0,5,5,10
15732,2023-01-24,8-BIT,knockout,New Perspective,0,17,12,29
15733,2023-01-24,8-BIT,hotZone,Dueling Beetles,0,17,7,24
15734,2023-01-24,8-BIT,heist,Safe Zone,3,172,253,428
15735,2023-01-24,8-BIT,gemGrab,Minecart Madness,0,20,14,34
15736,2023-01-24,8-BIT,gemGrab,Crystal Arcade,0,52,102,154
15737,2023-01-24,8-BIT,brawlBall,Center Stage,1,2,3,6
15738,2023-01-24,8-BIT,brawlBall,Beach Ball,1,54,43,98
15739,2023-01-24,8-BIT,bounty,Excel,0,8,12,20
15740,2023-01-23,8-BIT,knockout,New Perspective,0,40,60,100
15741,2023-01-23,8-BIT,hotZone,Dueling Beetles,0,15,9,24
15742,2023-01-23,8-BIT,heist,Snaked Assault,0,119,113,232
15743,2023-01-23,8-BIT,gemGrab,Minecart Madness,0,121,151,272
15744,2023-01-23,8-BIT,gemGrab,Double Swoosh,0,14,13,27
15745,2023-01-23,8-BIT,brawlBall,Center Stage,3,69,57,129
15746,2023-01-23,8-BIT,brawlBall,Backyard Bowl,0,10,7,17
15747,2023-01-23,8-BIT,bounty,Layer Cake,0,6,4,10
15748,2023-01-22,8-BIT,knockout,X Marks the Spot,0,47,78,125
15749,2023-01-22,8-BIT,hotZone,Ring of Fire,0,13,8,21
15750,2023-01-22,8-BIT,heist,Snaked Assault,0,53,93,146
15751,2023-01-22,8-BIT,gemGrab,Hard Rock Mine,0,28,63,91
15752,2023-01-22,8-BIT,gemGrab,Double Swoosh,0,19,10,29
15753,2023-01-22,8-BIT,brawlBall,Super Beach,0,2,2,4
15754,2023-01-22,8-BIT,brawlBall,Backyard Bowl,7,121,133,261
15755,2023-01-22,8-BIT,bounty,Layer Cake,0,3,7,10
15756,2023-01-21,8-BIT,knockout,X Marks the Spot,3,164,253,420
15757,2023-01-21,8-BIT,hotZone,Ring of Fire,0,53,40,93
15758,2023-01-21,8-BIT,heist,Tornado Ring,0,43,28,71
15759,2023-01-21,8-BIT,gemGrab,Hard Rock Mine,0,213,416,629
15760,2023-01-21,8-BIT,gemGrab,Deep Diner,0,10,17,27
15761,2023-01-21,8-BIT,brawlBall,Super Beach,8,76,122,206
15762,2023-01-21,8-BIT,brawlBall,Sneaky Fields,0,2,0,2
15763,2023-01-21,8-BIT,bounty,Dry Season,0,29,26,55
15764,2023-01-20,8-BIT,knockout,Out in the Open,0,31,42,73
15765,2023-01-20,8-BIT,hotZone,Split,0,3,5,8
15766,2023-01-20,8-BIT,heist,Tornado Ring,0,61,39,100
15767,2023-01-20,8-BIT,gemGrab,Undermine,0,21,59,80
15768,2023-01-20,8-BIT,gemGrab,Deep Diner,0,61,57,118
15769,2023-01-20,8-BIT,brawlBall,Sneaky Fields,2,41,52,95
15770,2023-01-20,8-BIT,brawlBall,Pinhole Punt,0,2,2,4
15771,2023-01-20,8-BIT,bounty,Dry Season,0,26,46,72
15772,2023-01-19,8-BIT,knockout,Out in the Open,0,42,61,103
15773,2023-01-19,8-BIT,hotZone,Split,0,9,4,13
15774,2023-01-19,8-BIT,heist,Kaboom Canyon,0,84,82,166
15775,2023-01-19,8-BIT,gemGrab,Undermine,0,67,122,189
15776,2023-01-19,8-BIT,gemGrab,Gem Fort,0,17,28,45
15777,2023-01-19,8-BIT,brawlBall,Sunny Soccer,0,0,2,2
15778,2023-01-19,8-BIT,brawlBall,Pinhole Punt,7,95,100,202
15779,2023-01-19,8-BIT,bounty,Shooting Star,0,21,15,36
15780,2023-01-18,8-BIT,knockout,Goldarm Gulch,0,3,17,20
15781,2023-01-18,8-BIT,hotZone,Parallel Plays,0,1,1,2
15782,2023-01-18,8-BIT,heist,Kaboom Canyon,1,42,35,78
15783,2023-01-18,8-BIT,gemGrab,Gem Fort,0,5,8,13
15784,2023-01-18,8-BIT,gemGrab,Crystal Arcade,0,10,27,37
15785,2023-01-18,8-BIT,brawlBall,Sunny Soccer,1,7,7,15
15786,2023-01-18,8-BIT,bounty,Shooting Star,0,20,19,39
15787,2023-01-17,8-BIT,knockout,Goldarm Gulch,0,2,0,2
15788,2023-01-17,8-BIT,hotZone,Parallel Plays,0,1,1,2
15789,2023-01-17,8-BIT,gemGrab,Minecart Madness,0,1,1,2
15790,2023-01-17,8-BIT,gemGrab,Crystal Arcade,0,3,6,9
15791,2023-01-17,8-BIT,brawlBall,Center Stage,0,1,0,1
15792,2023-01-17,8-BIT,brawlBall,Beach Ball,0,5,1,6
15793,2023-01-17,8-BIT,bounty,Hideout,0,1,0,1
15794,2023-01-16,8-BIT,knockout,Belle's Rock,0,3,1,4
15795,2023-01-16,8-BIT,hotZone,Quarter Pounder,0,3,3,6
15796,2023-01-16,8-BIT,gemGrab,Minecart Madness,0,8,5,13
15797,2023-01-16,8-BIT,gemGrab,Double Swoosh,0,1,0,1
15798,2023-01-16,8-BIT,brawlBall,Center Stage,0,7,5,12
15799,2023-01-16,8-BIT,brawlBall,Backyard Bowl,0,3,2,5
15800,2023-01-15,8-BIT,hotZone,Quarter Pounder,0,8,3,11
15801,2023-01-15,8-BIT,heist,Bridge Too Far,0,76,102,178
15802,2023-01-15,8-BIT,gemGrab,Hard Rock Mine,0,6,14,20
15803,2023-01-15,8-BIT,gemGrab,Double Swoosh,0,2,0,2
15804,2023-01-15,8-BIT,brawlBall,Backyard Bowl,2,34,37,73
15805,2023-01-15,8-BIT,bounty,Canal Grande,0,2,0,2
15806,2023-01-14,8-BIT,knockout,Flaring Phoenix,0,0,2,2
15807,2023-01-14,8-BIT,hotZone,Controller Chaos,0,2,0,2
15808,2023-01-14,8-BIT,heist,Bridge Too Far,0,103,184,287
15809,2023-01-14,8-BIT,gemGrab,Hard Rock Mine,0,17,55,72
15810,2023-01-14,8-BIT,gemGrab,Deep Diner,0,5,5,10
15811,2023-01-14,8-BIT,brawlBall,Super Beach,0,2,0,2
15812,2023-01-14,8-BIT,bounty,Canal Grande,0,2,0,2
15813,2023-01-13,8-BIT,heist,Hot Potato,0,1,0,1
15814,2023-01-13,8-BIT,gemGrab,Deep Diner,0,5,54,59
15815,2023-01-13,8-BIT,brawlBall,Sneaky Fields,0,2,0,2
15816,2023-01-13,8-BIT,bounty,Temple Ruins,0,0,1,1
15817,2023-01-12,8-BIT,knockout,Riverside,0,8,2,10
15818,2023-01-12,8-BIT,hotZone,Open Zone,0,4,0,4
15819,2023-01-12,8-BIT,gemGrab,Undermine,0,1,0,1
15820,2023-01-12,8-BIT,gemGrab,Gem Fort,0,1,3,4
15821,2023-01-12,8-BIT,brawlBall,Pinhole Punt,0,2,3,5
15822,2023-01-11,8-BIT,knockout,Riverside,0,2,0,2
15823,2023-01-11,8-BIT,heist,Safe Zone,0,1,1,2
15824,2023-01-10,8-BIT,knockout,New Perspective,0,0,1,1
15825,2023-01-10,8-BIT,hotZone,Dueling Beetles,0,2,1,3
15826,2023-01-10,8-BIT,heist,Safe Zone,0,10,3,13
15827,2023-01-10,8-BIT,gemGrab,Minecart Madness,0,2,11,13
15828,2023-01-10,8-BIT,gemGrab,Crystal Arcade,0,1,1,2
15829,2023-01-10,8-BIT,brawlBall,Beach Ball,0,2,5,7
15830,2023-01-09,8-BIT,knockout,New Perspective,0,0,3,3
15831,2023-01-09,8-BIT,heist,Snaked Assault,0,14,62,76
15832,2023-01-09,8-BIT,gemGrab,Minecart Madness,0,5,42,47
15833,2023-01-09,8-BIT,gemGrab,Double Swoosh,0,2,0,2
15834,2023-01-09,8-BIT,brawlBall,Center Stage,0,2,1,3
15835,2023-01-09,8-BIT,brawlBall,Backyard Bowl,0,2,0,2
15836,2023-01-09,8-BIT,bounty,Layer Cake,0,2,0,2
15837,2023-01-08,8-BIT,knockout,X Marks the Spot,0,3,0,3
15838,2023-01-08,8-BIT,hotZone,Ring of Fire,0,1,0,1
15839,2023-01-08,8-BIT,heist,Snaked Assault,0,6,4,10
15840,2023-01-08,8-BIT,gemGrab,Hard Rock Mine,0,2,10,12
15841,2023-01-08,8-BIT,brawlBall,Backyard Bowl,3,10,36,49
15842,2023-01-08,8-BIT,bounty,Layer Cake,0,1,0,1
15843,2023-01-07,8-BIT,knockout,X Marks the Spot,0,6,3,9
15844,2023-01-07,8-BIT,hotZone,Ring of Fire,0,1,3,4
15845,2023-01-07,8-BIT,heist,Tornado Ring,0,5,22,27
15846,2023-01-07,8-BIT,gemGrab,Hard Rock Mine,0,9,25,34
15847,2023-01-07,8-BIT,gemGrab,Deep Diner,0,2,24,26
15848,2023-01-07,8-BIT,bounty,Dry Season,0,1,0,1
15849,2023-01-06,8-BIT,heist,Tornado Ring,0,14,24,38
15850,2023-01-06,8-BIT,gemGrab,Undermine,0,1,0,1
15851,2023-01-06,8-BIT,gemGrab,Deep Diner,0,10,45,55
15852,2023-01-06,8-BIT,brawlBall,Sneaky Fields,0,2,1,3
15853,2023-01-06,8-BIT,brawlBall,Pinhole Punt,0,1,0,1
15854,2023-01-06,8-BIT,bounty,Dry Season,0,2,0,2
15855,2023-01-05,8-BIT,knockout,Out in the Open,0,1,2,3
15856,2023-01-05,8-BIT,heist,Kaboom Canyon,0,10,31,41
15857,2023-01-05,8-BIT,gemGrab,Undermine,0,3,5,8
15858,2023-01-05,8-BIT,brawlBall,Pinhole Punt,0,1,2,3
15859,2023-01-05,8-BIT,bounty,Shooting Star,0,3,0,3
15860,2023-01-04,8-BIT,knockout,Goldarm Gulch,0,2,10,12
15861,2023-01-04,8-BIT,hotZone,Parallel Plays,0,2,0,2
15862,2023-01-04,8-BIT,heist,Kaboom Canyon,0,10,11,21
15863,2023-01-04,8-BIT,gemGrab,Gem Fort,0,1,1,2
15864,2023-01-04,8-BIT,gemGrab,Crystal Arcade,0,1,1,2
15865,2023-01-04,8-BIT,brawlBall,Sunny Soccer,1,4,9,14
15866,2023-01-04,8-BIT,bounty,Shooting Star,0,2,0,2
15867,2023-01-03,8-BIT,heist,Pit Stop,0,4,1,5
15868,2023-01-03,8-BIT,gemGrab,Crystal Arcade,0,11,24,35
15869,2023-01-03,8-BIT,brawlBall,Beach Ball,0,2,0,2
15870,2023-01-03,8-BIT,bounty,Hideout,0,3,0,3
15871,2023-01-02,8-BIT,hotZone,Quarter Pounder,0,3,1,4
15872,2023-01-02,8-BIT,heist,Pit Stop,0,2,0,2
15873,2023-01-02,8-BIT,heist,Kaboom Canyon,0,1,0,1
15874,2023-01-02,8-BIT,gemGrab,Minecart Madness,0,11,12,23
15875,2023-01-02,8-BIT,gemGrab,Double Swoosh,0,8,22,30
15876,2023-01-02,8-BIT,brawlBall,Center Stage,0,2,3,5
15877,2023-01-02,8-BIT,bounty,Hideout,0,2,3,5
15878,2023-01-01,8-BIT,knockout,Belle's Rock,0,0,1,1
15879,2023-01-01,8-BIT,heist,Bridge Too Far,0,16,26,42
15880,2023-01-01,8-BIT,gemGrab,Hard Rock Mine,0,5,3,8
15881,2023-01-01,8-BIT,gemGrab,Double Swoosh,0,6,12,18
15882,2023-01-01,8-BIT,brawlBall,Backyard Bowl,0,7,16,23
15883,2022-12-31,8-BIT,heist,Bridge Too Far,0,6,7,13
15884,2022-12-31,8-BIT,gemGrab,Hard Rock Mine,0,4,9,13
15885,2022-12-30,8-BIT,hotZone,Controller Chaos,0,0,1,1
15886,2022-12-30,8-BIT,heist,Kaboom Canyon,0,2,0,2
15887,2022-12-30,8-BIT,gemGrab,Undermine,0,0,1,1
15888,2022-12-30,8-BIT,gemGrab,Minecart Madness,0,1,1,2
15889,2022-12-30,8-BIT,gemGrab,Deep Diner,0,2,7,9
15890,2022-12-30,8-BIT,brawlBall,Sneaky Fields,0,1,0,1
15891,2022-12-29,8-BIT,gemGrab,Undermine,0,1,0,1
15892,2022-12-28,8-BIT,hotZone,Controller Chaos,0,0,1,1
15893,2022-12-27,8-BIT,heist,Kaboom Canyon,0,1,0,1
15894,2022-12-27,8-BIT,gemGrab,Minecart Madness,0,1,0,1
15895,2022-12-26,8-BIT,gemGrab,Minecart Madness,0,2,0,2
15896,2022-10-30,8-BIT,heist,Safe Zone,0,1,0,1
15897,2022-10-15,8-BIT,gemGrab,Hard Rock Mine,0,0,2,2
15898,2022-10-15,8-BIT,brawlBall,Super Beach,0,1,0,1
