,battleTime,brawlername,event.mode,event.map,d,n,y,total_games,total_games_event
0,2023-01-28,TICK,knockout,Flaring Phoenix,2,318,232,552,12366
1,2023-01-28,TICK,hotZone,Controller Chaos,0,211,46,257,10134
2,2023-01-28,TICK,heist,Bridge Too Far,0,30,11,41,24240
3,2023-01-28,TICK,gemGrab,Hard Rock Mine,0,146,68,214,16638
4,2023-01-28,TICK,gemGrab,Deep Diner,0,95,58,153,5478
5,2023-01-28,TICK,brawlBall,Super Beach,12,482,324,818,74430
6,2023-01-28,TICK,brawlBall,Sneaky Fields,0,19,8,27,3582
7,2023-01-28,TICK,bounty,Canal Grande,0,533,336,869,10902
8,2023-01-27,TICK,knockout,Flaring Phoenix,0,132,94,226,5928
9,2023-01-27,TICK,hotZone,Controller Chaos,0,60,20,80,2676
10,2023-01-27,TICK,heist,Hot Potato,0,8,1,9,3486
11,2023-01-27,TICK,gemGrab,Undermine,0,9,5,14,942
12,2023-01-27,TICK,gemGrab,Deep Diner,0,123,71,194,6846
13,2023-01-27,TICK,brawlBall,Sneaky Fields,4,110,84,198,23514
14,2023-01-27,TICK,brawlBall,Pinhole Punt,0,5,3,8,738
15,2023-01-27,TICK,bounty,Temple Ruins,0,46,20,66,1890
16,2023-01-26,TICK,knockout,Riverside,0,305,186,491,19008
17,2023-01-26,TICK,hotZone,Open Zone,0,212,58,270,10182
18,2023-01-26,TICK,heist,Hot Potato,0,17,5,22,14610
19,2023-01-26,TICK,gemGrab,Undermine,0,71,35,106,10062
20,2023-01-26,TICK,gemGrab,Gem Fort,0,23,16,39,4674
21,2023-01-26,TICK,brawlBall,Sunny Soccer,0,36,20,56,3660
22,2023-01-26,TICK,brawlBall,Pinhole Punt,12,410,235,657,67338
23,2023-01-26,TICK,bounty,Temple Ruins,0,146,97,243,5610
24,2023-01-25,TICK,knockout,Riverside,0,123,102,225,9906
25,2023-01-25,TICK,hotZone,Open Zone,0,84,40,124,5262
26,2023-01-25,TICK,heist,Safe Zone,0,28,5,33,9156
27,2023-01-25,TICK,gemGrab,Gem Fort,0,43,26,69,5556
28,2023-01-25,TICK,gemGrab,Crystal Arcade,0,101,29,130,7866
29,2023-01-25,TICK,brawlBall,Sunny Soccer,9,375,276,660,40830
30,2023-01-25,TICK,brawlBall,Beach Ball,1,63,46,110,6408
31,2023-01-25,TICK,bounty,Excel,0,496,305,801,5790
32,2023-01-24,TICK,knockout,New Perspective,0,194,177,371,10542
33,2023-01-24,TICK,hotZone,Dueling Beetles,0,388,144,532,10662
34,2023-01-24,TICK,heist,Safe Zone,0,80,23,103,15750
35,2023-01-24,TICK,gemGrab,Minecart Madness,0,213,118,331,4002
36,2023-01-24,TICK,gemGrab,Crystal Arcade,0,148,69,217,14460
37,2023-01-24,TICK,brawlBall,Center Stage,2,41,39,82,7860
38,2023-01-24,TICK,brawlBall,Beach Ball,13,554,345,912,64614
39,2023-01-24,TICK,bounty,Excel,0,816,558,1374,10896
40,2023-01-23,TICK,knockout,New Perspective,1,339,229,569,20676
41,2023-01-23,TICK,hotZone,Dueling Beetles,3,548,175,726,17502
42,2023-01-23,TICK,heist,Snaked Assault,0,24,2,26,15762
43,2023-01-23,TICK,gemGrab,Minecart Madness,0,889,518,1407,19062
44,2023-01-23,TICK,gemGrab,Double Swoosh,0,51,27,78,7578
45,2023-01-23,TICK,brawlBall,Center Stage,15,564,409,988,92862
46,2023-01-23,TICK,brawlBall,Backyard Bowl,1,27,15,43,4224
47,2023-01-23,TICK,bounty,Layer Cake,0,845,599,1444,11142
48,2023-01-22,TICK,knockout,X Marks the Spot,0,204,146,350,9174
49,2023-01-22,TICK,hotZone,Ring of Fire,2,186,55,243,5730
50,2023-01-22,TICK,heist,Snaked Assault,0,15,2,17,8232
51,2023-01-22,TICK,gemGrab,Hard Rock Mine,0,36,16,52,4722
52,2023-01-22,TICK,gemGrab,Double Swoosh,0,67,39,106,9426
53,2023-01-22,TICK,brawlBall,Super Beach,0,55,29,84,7386
54,2023-01-22,TICK,brawlBall,Backyard Bowl,1,169,96,266,34788
55,2023-01-22,TICK,bounty,Layer Cake,0,397,322,719,6654
56,2023-01-21,TICK,knockout,X Marks the Spot,2,737,571,1310,31698
57,2023-01-21,TICK,hotZone,Ring of Fire,2,513,206,721,16632
58,2023-01-21,TICK,heist,Tornado Ring,0,14,9,23,11664
59,2023-01-21,TICK,gemGrab,Hard Rock Mine,0,213,98,311,22980
60,2023-01-21,TICK,gemGrab,Deep Diner,0,68,63,131,4470
61,2023-01-21,TICK,brawlBall,Super Beach,19,666,417,1102,101364
62,2023-01-21,TICK,brawlBall,Sneaky Fields,0,19,18,37,3750
63,2023-01-21,TICK,bounty,Dry Season,0,739,603,1342,14538
64,2023-01-20,TICK,knockout,Out in the Open,0,376,298,674,20106
65,2023-01-20,TICK,hotZone,Split,0,459,190,649,9678
66,2023-01-20,TICK,heist,Tornado Ring,0,12,1,13,12672
67,2023-01-20,TICK,gemGrab,Undermine,0,51,23,74,5442
68,2023-01-20,TICK,gemGrab,Deep Diner,0,428,258,686,19050
69,2023-01-20,TICK,brawlBall,Sneaky Fields,11,389,226,626,74778
70,2023-01-20,TICK,brawlBall,Pinhole Punt,0,28,15,43,2886
71,2023-01-20,TICK,bounty,Dry Season,0,506,470,976,11640
72,2023-01-19,TICK,knockout,Out in the Open,1,482,420,903,26574
73,2023-01-19,TICK,hotZone,Split,0,596,297,893,14856
74,2023-01-19,TICK,heist,Kaboom Canyon,0,25,6,31,6732
75,2023-01-19,TICK,gemGrab,Undermine,0,158,70,228,14154
76,2023-01-19,TICK,gemGrab,Gem Fort,0,26,14,40,2934
77,2023-01-19,TICK,brawlBall,Sunny Soccer,0,27,21,48,2274
78,2023-01-19,TICK,brawlBall,Pinhole Punt,12,440,310,762,72498
79,2023-01-19,TICK,bounty,Shooting Star,0,520,361,881,11124
80,2023-01-18,TICK,knockout,Goldarm Gulch,0,46,46,92,2784
81,2023-01-18,TICK,hotZone,Parallel Plays,0,49,16,65,1158
82,2023-01-18,TICK,heist,Kaboom Canyon,0,5,0,5,2592
83,2023-01-18,TICK,gemGrab,Gem Fort,0,22,17,39,3006
84,2023-01-18,TICK,gemGrab,Crystal Arcade,0,5,3,8,990
85,2023-01-18,TICK,brawlBall,Sunny Soccer,5,185,136,326,18941
86,2023-01-18,TICK,brawlBall,Beach Ball,0,5,7,12,774
87,2023-01-18,TICK,bounty,Shooting Star,0,213,176,389,5088
88,2023-01-17,TICK,knockout,Goldarm Gulch,0,29,12,41,2520
89,2023-01-17,TICK,hotZone,Parallel Plays,0,7,7,14,1038
90,2023-01-17,TICK,heist,Pit Stop,0,1,1,2,1290
91,2023-01-17,TICK,gemGrab,Minecart Madness,0,9,4,13,216
92,2023-01-17,TICK,gemGrab,Crystal Arcade,0,13,4,17,1266
93,2023-01-17,TICK,brawlBall,Center Stage,0,1,1,2,288
94,2023-01-17,TICK,brawlBall,Beach Ball,1,45,24,70,5886
95,2023-01-17,TICK,bounty,Hideout,0,26,27,53,750
96,2023-01-16,TICK,knockout,Belle's Rock,0,61,44,105,1788
97,2023-01-16,TICK,hotZone,Quarter Pounder,0,59,2,61,1494
98,2023-01-16,TICK,heist,Pit Stop,0,0,1,1,4044
99,2023-01-16,TICK,gemGrab,Minecart Madness,0,66,38,104,1422
100,2023-01-16,TICK,gemGrab,Double Swoosh,0,3,1,4,708
101,2023-01-16,TICK,brawlBall,Center Stage,0,24,19,43,5778
102,2023-01-16,TICK,brawlBall,Backyard Bowl,0,6,1,7,852
103,2023-01-16,TICK,bounty,Hideout,0,79,55,134,1470
104,2023-01-15,TICK,knockout,Belle's Rock,0,118,79,197,2904
105,2023-01-15,TICK,hotZone,Quarter Pounder,0,85,4,89,3318
106,2023-01-15,TICK,heist,Bridge Too Far,0,4,1,5,2736
107,2023-01-15,TICK,gemGrab,Hard Rock Mine,0,3,1,4,1014
108,2023-01-15,TICK,gemGrab,Double Swoosh,0,12,6,18,2178
109,2023-01-15,TICK,brawlBall,Super Beach,0,6,2,8,1074
110,2023-01-15,TICK,brawlBall,Backyard Bowl,1,39,13,53,8946
111,2023-01-15,TICK,bounty,Canal Grande,0,39,11,50,960
112,2023-01-14,TICK,knockout,Flaring Phoenix,0,23,12,35,1080
113,2023-01-14,TICK,hotZone,Controller Chaos,0,61,7,68,2772
114,2023-01-14,TICK,heist,Bridge Too Far,0,4,1,5,4020
115,2023-01-14,TICK,gemGrab,Hard Rock Mine,0,6,0,6,1272
116,2023-01-14,TICK,gemGrab,Deep Diner,0,14,4,18,858
117,2023-01-14,TICK,brawlBall,Super Beach,1,39,22,62,6336
118,2023-01-14,TICK,brawlBall,Sneaky Fields,0,4,1,5,918
119,2023-01-14,TICK,bounty,Canal Grande,0,41,12,53,1014
120,2023-01-13,TICK,knockout,Flaring Phoenix,0,28,9,37,1182
121,2023-01-13,TICK,hotZone,Controller Chaos,0,43,15,58,2928
122,2023-01-13,TICK,heist,Hot Potato,0,1,0,1,600
123,2023-01-13,TICK,gemGrab,Deep Diner,0,28,6,34,1650
124,2023-01-13,TICK,brawlBall,Sneaky Fields,1,15,6,22,6144
125,2023-01-13,TICK,bounty,Temple Ruins,0,8,5,13,270
126,2023-01-12,TICK,knockout,Riverside,0,25,13,38,2532
127,2023-01-12,TICK,hotZone,Open Zone,0,23,0,23,1488
128,2023-01-12,TICK,gemGrab,Undermine,0,5,2,7,690
129,2023-01-12,TICK,brawlBall,Sunny Soccer,0,1,0,1,240
130,2023-01-12,TICK,brawlBall,Pinhole Punt,0,13,2,15,2292
131,2023-01-11,TICK,knockout,Riverside,0,2,2,4,528
132,2023-01-11,TICK,hotZone,Open Zone,0,6,1,7,462
133,2023-01-11,TICK,heist,Safe Zone,0,1,0,1,48
134,2023-01-11,TICK,gemGrab,Gem Fort,0,2,0,2,414
135,2023-01-11,TICK,brawlBall,Sunny Soccer,0,14,9,23,1638
136,2023-01-11,TICK,brawlBall,Beach Ball,0,2,0,2,48
137,2023-01-11,TICK,bounty,Excel,0,33,9,42,282
138,2023-01-10,TICK,knockout,New Perspective,0,9,3,12,720
139,2023-01-10,TICK,hotZone,Dueling Beetles,0,63,11,74,2424
140,2023-01-10,TICK,heist,Safe Zone,0,2,0,2,1176
141,2023-01-10,TICK,gemGrab,Minecart Madness,0,31,5,36,828
142,2023-01-10,TICK,gemGrab,Crystal Arcade,0,15,1,16,1746
143,2023-01-10,TICK,brawlBall,Center Stage,0,7,1,8,708
144,2023-01-10,TICK,brawlBall,Beach Ball,1,16,8,25,4392
145,2023-01-10,TICK,bounty,Excel,0,19,4,23,330
146,2023-01-09,TICK,knockout,New Perspective,0,17,1,18,876
147,2023-01-09,TICK,hotZone,Dueling Beetles,0,35,11,46,1554
148,2023-01-09,TICK,gemGrab,Minecart Madness,0,58,14,72,1884
149,2023-01-09,TICK,gemGrab,Double Swoosh,0,5,0,5,1320
150,2023-01-09,TICK,brawlBall,Center Stage,1,36,27,64,5460
151,2023-01-09,TICK,brawlBall,Backyard Bowl,0,2,0,2,474
152,2023-01-09,TICK,bounty,Layer Cake,0,99,42,141,1512
153,2023-01-08,TICK,knockout,X Marks the Spot,0,42,9,51,1692
154,2023-01-08,TICK,hotZone,Ring of Fire,0,49,1,50,1644
155,2023-01-08,TICK,heist,Snaked Assault,0,1,0,1,1494
156,2023-01-08,TICK,gemGrab,Hard Rock Mine,0,2,0,2,630
157,2023-01-08,TICK,gemGrab,Double Swoosh,0,5,0,5,864
158,2023-01-08,TICK,brawlBall,Super Beach,0,4,2,6,732
159,2023-01-08,TICK,brawlBall,Backyard Bowl,0,18,4,22,4830
160,2023-01-08,TICK,bounty,Layer Cake,0,21,6,27,528
161,2023-01-07,TICK,knockout,X Marks the Spot,0,27,9,36,1014
162,2023-01-07,TICK,hotZone,Ring of Fire,0,16,4,20,846
163,2023-01-07,TICK,gemGrab,Hard Rock Mine,0,6,1,7,1158
164,2023-01-07,TICK,gemGrab,Deep Diner,0,6,1,7,918
165,2023-01-07,TICK,brawlBall,Super Beach,0,11,3,14,2622
166,2023-01-07,TICK,brawlBall,Sneaky Fields,0,3,0,3,402
167,2023-01-07,TICK,bounty,Dry Season,0,47,17,64,1320
168,2023-01-06,TICK,knockout,Out in the Open,0,25,4,29,1446
169,2023-01-06,TICK,hotZone,Split,0,40,4,44,1158
170,2023-01-06,TICK,heist,Tornado Ring,0,2,1,3,2538
171,2023-01-06,TICK,gemGrab,Undermine,0,1,2,3,540
172,2023-01-06,TICK,gemGrab,Deep Diner,0,32,1,33,2226
173,2023-01-06,TICK,brawlBall,Sneaky Fields,0,10,7,17,4896
174,2023-01-06,TICK,bounty,Dry Season,0,59,43,102,1944
175,2023-01-05,TICK,knockout,Out in the Open,0,44,24,68,2958
176,2023-01-05,TICK,hotZone,Split,1,83,10,94,3552
177,2023-01-05,TICK,heist,Kaboom Canyon,0,1,0,1,954
178,2023-01-05,TICK,gemGrab,Undermine,0,5,1,6,1812
179,2023-01-05,TICK,brawlBall,Sunny Soccer,0,3,0,3,84
180,2023-01-05,TICK,brawlBall,Pinhole Punt,0,20,3,23,8118
181,2023-01-05,TICK,bounty,Shooting Star,0,49,23,72,1362
182,2023-01-04,TICK,knockout,Goldarm Gulch,0,13,5,18,696
183,2023-01-04,TICK,hotZone,Parallel Plays,0,19,0,19,864
184,2023-01-04,TICK,gemGrab,Gem Fort,0,4,1,5,1788
185,2023-01-04,TICK,gemGrab,Crystal Arcade,0,3,0,3,642
186,2023-01-04,TICK,brawlBall,Sunny Soccer,2,29,7,38,6312
187,2023-01-04,TICK,brawlBall,Beach Ball,0,2,0,2,54
188,2023-01-04,TICK,bounty,Shooting Star,0,131,188,319,3570
189,2023-01-03,TICK,knockout,Goldarm Gulch,0,10,15,25,720
190,2023-01-03,TICK,hotZone,Parallel Plays,0,24,1,25,1542
191,2023-01-03,TICK,heist,Kaboom Canyon,0,1,0,1,12
192,2023-01-03,TICK,gemGrab,Minecart Madness,0,16,1,17,456
193,2023-01-03,TICK,gemGrab,Crystal Arcade,0,14,4,18,2406
194,2023-01-03,TICK,brawlBall,Center Stage,1,1,1,3,294
195,2023-01-03,TICK,brawlBall,Beach Ball,0,28,5,33,5580
196,2023-01-03,TICK,bounty,Hideout,0,72,55,127,1638
197,2023-01-02,TICK,knockout,Belle's Rock,0,76,56,132,1794
198,2023-01-02,TICK,hotZone,Quarter Pounder,0,72,2,74,2652
199,2023-01-02,TICK,heist,Pit Stop,0,1,0,1,3498
200,2023-01-02,TICK,gemGrab,Minecart Madness,0,61,7,68,2352
201,2023-01-02,TICK,gemGrab,Double Swoosh,0,2,1,3,1512
202,2023-01-02,TICK,brawlBall,Center Stage,0,11,6,17,7110
203,2023-01-02,TICK,brawlBall,Backyard Bowl,0,2,1,3,492
204,2023-01-02,TICK,bounty,Hideout,0,96,80,176,3090
205,2023-01-01,TICK,knockout,Belle's Rock,0,18,19,37,858
206,2023-01-01,TICK,hotZone,Quarter Pounder,0,22,1,23,1188
207,2023-01-01,TICK,hotZone,Controller Chaos,0,1,0,1,12
208,2023-01-01,TICK,heist,Bridge Too Far,0,1,0,1,462
209,2023-01-01,TICK,gemGrab,Minecart Madness,0,0,1,1,12
210,2023-01-01,TICK,gemGrab,Double Swoosh,0,3,1,4,1140
211,2023-01-01,TICK,brawlBall,Backyard Bowl,0,6,4,10,2658
212,2023-01-01,TICK,bounty,Canal Grande,0,7,5,12,132
213,2022-12-31,TICK,hotZone,Controller Chaos,0,5,0,5,198
214,2022-12-31,TICK,gemGrab,Minecart Madness,0,1,0,1,24
215,2022-12-31,TICK,gemGrab,Hard Rock Mine,0,2,1,3,384
216,2022-12-31,TICK,gemGrab,Deep Diner,0,8,2,10,306
217,2022-12-31,TICK,brawlBall,Super Beach,0,1,0,1,618
218,2022-12-31,TICK,bounty,Canal Grande,0,3,1,4,54
219,2022-12-30,TICK,knockout,Flaring Phoenix,0,1,2,3,72
220,2022-12-30,TICK,hotZone,Controller Chaos,0,5,0,5,288
221,2022-12-30,TICK,gemGrab,Deep Diner,0,7,1,8,438
222,2022-12-30,TICK,brawlBall,Sneaky Fields,0,1,1,2,552
223,2022-12-29,TICK,gemGrab,Minecart Madness,0,1,1,2,24
224,2022-12-29,TICK,brawlBall,Pinhole Punt,0,2,6,8,282
225,2022-12-27,TICK,hotZone,Dueling Beetles,0,1,1,2,36
226,2022-12-27,TICK,gemGrab,Minecart Madness,0,0,2,2,30
227,2022-12-27,TICK,brawlBall,Beach Ball,0,1,1,2,144
228,2022-12-27,TICK,bounty,Excel,0,2,2,4,18
229,2022-12-26,TICK,hotZone,Controller Chaos,0,1,0,1,30
230,2022-12-26,TICK,gemGrab,Minecart Madness,0,1,0,1,60
231,2022-12-25,TICK,bounty,Layer Cake,0,1,0,1,12
232,2022-12-23,TICK,knockout,Out in the Open,0,2,1,3,132
233,2022-12-22,TICK,brawlBall,Pinhole Punt,0,0,1,1,132
234,2022-12-21,TICK,brawlBall,Sunny Soccer,0,1,1,2,54
235,2022-12-20,TICK,brawlBall,Beach Ball,0,0,2,2,96
236,2022-12-19,TICK,brawlBall,Center Stage,0,0,1,1,102
237,2022-12-18,TICK,knockout,Belle's Rock,0,1,1,2,6
238,2022-12-16,TICK,brawlBall,Sneaky Fields,0,0,1,1,84
239,2022-12-16,TICK,bounty,Temple Ruins,0,2,0,2,24
240,2022-12-13,TICK,knockout,New Perspective,0,1,0,1,84
241,2022-12-13,TICK,heist,Safe Zone,0,1,0,1,42
242,2022-12-11,TICK,gemGrab,Double Swoosh,0,2,0,2,12
243,2022-12-10,TICK,hotZone,Ring of Fire,0,1,0,1,6
244,2022-11-11,TICK,knockout,New Perspective,0,2,0,2,12
245,2022-11-11,TICK,brawlBall,Sneaky Fields,0,1,0,1,42
246,2022-11-01,TICK,knockout,New Perspective,0,2,0,2,54
247,2022-10-30,TICK,hotZone,Dueling Beetles,0,1,2,3,12
248,2022-10-28,TICK,knockout,Out in the Open,0,0,2,2,18
249,2022-10-28,TICK,hotZone,Dueling Beetles,0,0,2,2,12
250,2022-10-28,TICK,heist,Safe Zone,0,1,0,1,6
251,2022-10-26,TICK,brawlBall,Sunny Soccer,0,0,1,1,18
252,2022-10-26,TICK,bounty,Shooting Star,0,1,1,2,36
253,2022-10-15,TICK,hotZone,Ring of Fire,0,2,0,2,24
254,2022-10-15,TICK,gemGrab,Hard Rock Mine,0,2,0,2,90
255,2022-10-10,TICK,knockout,Belle's Rock,0,1,3,4,48
256,2023-01-28,TARA,knockout,Flaring Phoenix,2,333,365,700,12366
257,2023-01-28,TARA,hotZone,Controller Chaos,0,65,42,107,10134
258,2023-01-28,TARA,heist,Bridge Too Far,0,8,8,16,24240
259,2023-01-28,TARA,gemGrab,Hard Rock Mine,0,292,242,534,16638
260,2023-01-28,TARA,gemGrab,Deep Diner,0,43,38,81,5478
261,2023-01-28,TARA,brawlBall,Super Beach,13,564,503,1080,74430
262,2023-01-28,TARA,brawlBall,Sneaky Fields,1,24,26,51,3582
263,2023-01-28,TARA,bounty,Canal Grande,0,63,65,128,10902
264,2023-01-27,TARA,knockout,Flaring Phoenix,1,160,204,365,5928
265,2023-01-27,TARA,hotZone,Controller Chaos,0,14,8,22,2676
266,2023-01-27,TARA,heist,Hot Potato,0,17,16,33,3486
267,2023-01-27,TARA,gemGrab,Undermine,0,17,42,59,942
268,2023-01-27,TARA,gemGrab,Deep Diner,0,48,48,96,6846
269,2023-01-27,TARA,brawlBall,Sneaky Fields,7,237,231,475,23514
270,2023-01-27,TARA,brawlBall,Pinhole Punt,0,4,6,10,738
271,2023-01-27,TARA,bounty,Temple Ruins,0,14,15,29,1890
272,2023-01-26,TARA,knockout,Riverside,0,12,9,21,19008
273,2023-01-26,TARA,hotZone,Open Zone,0,38,14,52,10182
274,2023-01-26,TARA,heist,Hot Potato,0,72,58,130,14610
275,2023-01-26,TARA,gemGrab,Undermine,0,281,276,557,10062
276,2023-01-26,TARA,gemGrab,Gem Fort,0,135,172,307,4674
277,2023-01-26,TARA,brawlBall,Sunny Soccer,0,28,37,65,3660
278,2023-01-26,TARA,brawlBall,Pinhole Punt,18,557,592,1167,67338
279,2023-01-26,TARA,bounty,Temple Ruins,0,74,82,156,5610
280,2023-01-25,TARA,knockout,Riverside,0,7,6,13,9906
281,2023-01-25,TARA,hotZone,Open Zone,0,17,8,25,5262
282,2023-01-25,TARA,heist,Safe Zone,0,11,9,20,9156
283,2023-01-25,TARA,gemGrab,Gem Fort,0,155,162,317,5556
284,2023-01-25,TARA,gemGrab,Crystal Arcade,0,124,138,262,7866
285,2023-01-25,TARA,brawlBall,Sunny Soccer,10,321,317,648,40830
286,2023-01-25,TARA,brawlBall,Beach Ball,0,39,30,69,6408
287,2023-01-25,TARA,bounty,Excel,0,7,1,8,5790
288,2023-01-24,TARA,knockout,New Perspective,0,72,134,206,10542
289,2023-01-24,TARA,hotZone,Dueling Beetles,0,54,14,68,10662
290,2023-01-24,TARA,heist,Safe Zone,0,14,8,22,15750
291,2023-01-24,TARA,gemGrab,Minecart Madness,0,9,9,18,4002
292,2023-01-24,TARA,gemGrab,Crystal Arcade,0,277,242,519,14460
293,2023-01-24,TARA,brawlBall,Center Stage,1,95,100,196,7860
294,2023-01-24,TARA,brawlBall,Beach Ball,11,525,456,992,64614
295,2023-01-24,TARA,bounty,Excel,0,16,3,19,10896
296,2023-01-23,TARA,knockout,New Perspective,3,360,524,887,20676
297,2023-01-23,TARA,hotZone,Dueling Beetles,0,52,19,71,17502
298,2023-01-23,TARA,heist,Snaked Assault,1,110,143,254,15762
299,2023-01-23,TARA,gemGrab,Minecart Madness,0,88,46,134,19062
300,2023-01-23,TARA,gemGrab,Double Swoosh,0,228,324,552,7578
301,2023-01-23,TARA,brawlBall,Center Stage,34,1139,1158,2331,92862
302,2023-01-23,TARA,brawlBall,Backyard Bowl,0,20,10,30,4224
303,2023-01-23,TARA,bounty,Layer Cake,0,25,20,45,11142
304,2023-01-22,TARA,knockout,X Marks the Spot,0,14,17,31,9174
305,2023-01-22,TARA,hotZone,Ring of Fire,0,29,17,46,5730
306,2023-01-22,TARA,heist,Snaked Assault,1,78,89,168,8232
307,2023-01-22,TARA,gemGrab,Hard Rock Mine,0,75,51,126,4722
308,2023-01-22,TARA,gemGrab,Double Swoosh,0,320,318,638,9426
309,2023-01-22,TARA,brawlBall,Super Beach,1,57,34,92,7386
310,2023-01-22,TARA,brawlBall,Backyard Bowl,5,124,106,235,34788
311,2023-01-22,TARA,bounty,Layer Cake,0,22,33,55,6654
312,2023-01-21,TARA,knockout,X Marks the Spot,0,72,38,110,31698
313,2023-01-21,TARA,hotZone,Ring of Fire,0,73,30,103,16632
314,2023-01-21,TARA,heist,Tornado Ring,1,98,127,226,11664
315,2023-01-21,TARA,gemGrab,Hard Rock Mine,0,372,320,692,22980
316,2023-01-21,TARA,gemGrab,Deep Diner,0,43,39,82,4470
317,2023-01-21,TARA,brawlBall,Super Beach,18,747,688,1453,101364
318,2023-01-21,TARA,brawlBall,Sneaky Fields,0,22,29,51,3750
319,2023-01-21,TARA,bounty,Dry Season,0,8,3,11,14538
320,2023-01-20,TARA,knockout,Out in the Open,0,72,71,143,20106
321,2023-01-20,TARA,hotZone,Split,0,19,9,28,9678
322,2023-01-20,TARA,heist,Tornado Ring,3,86,65,154,12672
323,2023-01-20,TARA,gemGrab,Undermine,0,100,96,196,5442
324,2023-01-20,TARA,gemGrab,Deep Diner,0,207,161,368,19050
325,2023-01-20,TARA,brawlBall,Sneaky Fields,21,799,775,1595,74778
326,2023-01-20,TARA,brawlBall,Pinhole Punt,0,14,17,31,2886
327,2023-01-20,TARA,bounty,Dry Season,0,13,7,20,11640
328,2023-01-19,TARA,knockout,Out in the Open,1,171,166,338,26574
329,2023-01-19,TARA,hotZone,Split,0,37,20,57,14856
330,2023-01-19,TARA,heist,Kaboom Canyon,0,18,15,33,6732
331,2023-01-19,TARA,gemGrab,Undermine,0,399,471,870,14154
332,2023-01-19,TARA,gemGrab,Gem Fort,0,103,81,184,2934
333,2023-01-19,TARA,brawlBall,Sunny Soccer,0,19,17,36,2274
334,2023-01-19,TARA,brawlBall,Pinhole Punt,12,536,582,1130,72498
335,2023-01-19,TARA,bounty,Shooting Star,0,9,2,11,11124
336,2023-01-18,TARA,knockout,Goldarm Gulch,0,11,6,17,2784
337,2023-01-18,TARA,hotZone,Parallel Plays,0,5,4,9,1158
338,2023-01-18,TARA,heist,Kaboom Canyon,0,3,0,3,2592
339,2023-01-18,TARA,gemGrab,Gem Fort,0,69,109,178,3006
340,2023-01-18,TARA,gemGrab,Crystal Arcade,0,13,8,21,990
341,2023-01-18,TARA,brawlBall,Sunny Soccer,3,142,128,273,18941
342,2023-01-18,TARA,brawlBall,Beach Ball,0,2,8,10,774
343,2023-01-18,TARA,bounty,Shooting Star,0,1,1,2,5088
344,2023-01-17,TARA,knockout,Goldarm Gulch,0,18,6,24,2520
345,2023-01-17,TARA,hotZone,Parallel Plays,0,2,2,4,1038
346,2023-01-17,TARA,heist,Pit Stop,0,8,8,16,1290
347,2023-01-17,TARA,gemGrab,Crystal Arcade,0,24,32,56,1266
348,2023-01-17,TARA,brawlBall,Center Stage,0,2,2,4,288
349,2023-01-17,TARA,brawlBall,Beach Ball,1,34,40,75,5886
350,2023-01-17,TARA,bounty,Hideout,0,1,0,1,750
351,2023-01-16,TARA,knockout,Belle's Rock,0,0,3,3,1788
352,2023-01-16,TARA,hotZone,Quarter Pounder,0,6,3,9,1494
353,2023-01-16,TARA,heist,Pit Stop,0,16,12,28,4044
354,2023-01-16,TARA,gemGrab,Minecart Madness,0,5,5,10,1422
355,2023-01-16,TARA,gemGrab,Double Swoosh,0,30,47,77,708
356,2023-01-16,TARA,brawlBall,Center Stage,2,65,75,142,5778
357,2023-01-16,TARA,brawlBall,Backyard Bowl,0,5,0,5,852
358,2023-01-16,TARA,bounty,Hideout,0,1,0,1,1470
359,2023-01-15,TARA,knockout,Belle's Rock,0,5,2,7,2904
360,2023-01-15,TARA,hotZone,Quarter Pounder,0,21,2,23,3318
361,2023-01-15,TARA,heist,Bridge Too Far,0,3,1,4,2736
362,2023-01-15,TARA,gemGrab,Hard Rock Mine,0,19,8,27,1014
363,2023-01-15,TARA,gemGrab,Double Swoosh,0,95,66,161,2178
364,2023-01-15,TARA,brawlBall,Super Beach,0,12,0,12,1074
365,2023-01-15,TARA,brawlBall,Backyard Bowl,1,30,20,51,8946
366,2023-01-15,TARA,bounty,Canal Grande,0,4,2,6,960
367,2023-01-14,TARA,knockout,Flaring Phoenix,0,18,27,45,1080
368,2023-01-14,TARA,hotZone,Controller Chaos,0,26,2,28,2772
369,2023-01-14,TARA,heist,Bridge Too Far,0,4,1,5,4020
370,2023-01-14,TARA,gemGrab,Hard Rock Mine,0,23,7,30,1272
371,2023-01-14,TARA,gemGrab,Deep Diner,0,17,6,23,858
372,2023-01-14,TARA,brawlBall,Super Beach,2,44,21,67,6336
373,2023-01-14,TARA,brawlBall,Sneaky Fields,0,11,8,19,918
374,2023-01-14,TARA,bounty,Canal Grande,0,7,17,24,1014
375,2023-01-13,TARA,knockout,Flaring Phoenix,0,21,31,52,1182
376,2023-01-13,TARA,hotZone,Controller Chaos,0,9,5,14,2928
377,2023-01-13,TARA,heist,Hot Potato,0,3,0,3,600
378,2023-01-13,TARA,gemGrab,Undermine,0,1,0,1,18
379,2023-01-13,TARA,gemGrab,Deep Diner,0,16,10,26,1650
380,2023-01-13,TARA,brawlBall,Sneaky Fields,1,52,20,73,6144
381,2023-01-13,TARA,brawlBall,Pinhole Punt,0,4,0,4,156
382,2023-01-13,TARA,bounty,Temple Ruins,0,5,0,5,270
383,2023-01-12,TARA,knockout,Riverside,0,1,0,1,2532
384,2023-01-12,TARA,hotZone,Open Zone,0,7,1,8,1488
385,2023-01-12,TARA,heist,Hot Potato,0,1,1,2,330
386,2023-01-12,TARA,gemGrab,Undermine,0,24,17,41,690
387,2023-01-12,TARA,gemGrab,Gem Fort,0,6,1,7,162
388,2023-01-12,TARA,brawlBall,Sunny Soccer,0,1,0,1,240
389,2023-01-12,TARA,brawlBall,Pinhole Punt,0,20,4,24,2292
390,2023-01-12,TARA,bounty,Temple Ruins,0,0,2,2,24
391,2023-01-11,TARA,hotZone,Open Zone,0,1,0,1,462
392,2023-01-11,TARA,gemGrab,Gem Fort,0,18,13,31,414
393,2023-01-11,TARA,brawlBall,Sunny Soccer,0,6,10,16,1638
394,2023-01-10,TARA,knockout,New Perspective,0,4,1,5,720
395,2023-01-10,TARA,hotZone,Dueling Beetles,0,7,0,7,2424
396,2023-01-10,TARA,heist,Safe Zone,0,1,0,1,1176
397,2023-01-10,TARA,gemGrab,Minecart Madness,0,3,2,5,828
398,2023-01-10,TARA,gemGrab,Crystal Arcade,0,43,39,82,1746
399,2023-01-10,TARA,brawlBall,Center Stage,0,6,1,7,708
400,2023-01-10,TARA,brawlBall,Beach Ball,0,24,14,38,4392
401,2023-01-10,TARA,bounty,Excel,0,1,0,1,330
402,2023-01-09,TARA,knockout,New Perspective,0,24,26,50,876
403,2023-01-09,TARA,hotZone,Dueling Beetles,0,1,0,1,1554
404,2023-01-09,TARA,heist,Snaked Assault,0,10,7,17,2022
405,2023-01-09,TARA,gemGrab,Minecart Madness,0,7,1,8,1884
406,2023-01-09,TARA,gemGrab,Double Swoosh,0,43,55,98,1320
407,2023-01-09,TARA,brawlBall,Center Stage,3,70,60,133,5460
408,2023-01-09,TARA,brawlBall,Backyard Bowl,0,4,0,4,474
409,2023-01-09,TARA,bounty,Layer Cake,0,0,1,1,1512
410,2023-01-08,TARA,knockout,X Marks the Spot,0,1,0,1,1692
411,2023-01-08,TARA,hotZone,Ring of Fire,0,7,23,30,1644
412,2023-01-08,TARA,heist,Snaked Assault,0,12,14,26,1494
413,2023-01-08,TARA,gemGrab,Hard Rock Mine,0,12,9,21,630
414,2023-01-08,TARA,gemGrab,Double Swoosh,0,39,18,57,864
415,2023-01-08,TARA,brawlBall,Super Beach,0,8,2,10,732
416,2023-01-08,TARA,brawlBall,Backyard Bowl,0,15,4,19,4830
417,2023-01-08,TARA,bounty,Layer Cake,0,0,2,2,528
418,2023-01-07,TARA,knockout,X Marks the Spot,0,0,1,1,1014
419,2023-01-07,TARA,hotZone,Ring of Fire,0,6,11,17,846
420,2023-01-07,TARA,heist,Tornado Ring,0,11,12,23,1350
421,2023-01-07,TARA,gemGrab,Hard Rock Mine,0,32,36,68,1158
422,2023-01-07,TARA,gemGrab,Deep Diner,0,21,3,24,918
423,2023-01-07,TARA,brawlBall,Super Beach,1,18,15,34,2622
424,2023-01-07,TARA,brawlBall,Sneaky Fields,0,5,1,6,402
425,2023-01-07,TARA,bounty,Dry Season,0,2,1,3,1320
426,2023-01-06,TARA,knockout,Out in the Open,0,9,23,32,1446
427,2023-01-06,TARA,heist,Tornado Ring,0,11,4,15,2538
428,2023-01-06,TARA,gemGrab,Undermine,0,19,14,33,540
429,2023-01-06,TARA,gemGrab,Deep Diner,0,29,7,36,2226
430,2023-01-06,TARA,brawlBall,Sneaky Fields,1,48,36,85,4896
431,2023-01-06,TARA,brawlBall,Pinhole Punt,0,5,1,6,510
432,2023-01-06,TARA,bounty,Dry Season,0,0,1,1,1944
433,2023-01-05,TARA,knockout,Out in the Open,1,23,9,33,2958
434,2023-01-05,TARA,hotZone,Split,0,12,0,12,3552
435,2023-01-05,TARA,heist,Kaboom Canyon,0,3,0,3,954
436,2023-01-05,TARA,gemGrab,Undermine,0,66,52,118,1812
437,2023-01-05,TARA,gemGrab,Gem Fort,0,12,7,19,252
438,2023-01-05,TARA,brawlBall,Sunny Soccer,0,0,1,1,84
439,2023-01-05,TARA,brawlBall,Pinhole Punt,1,65,31,97,8118
440,2023-01-04,TARA,knockout,Goldarm Gulch,0,3,0,3,696
441,2023-01-04,TARA,hotZone,Parallel Plays,0,1,0,1,864
442,2023-01-04,TARA,heist,Kaboom Canyon,0,1,1,2,1848
443,2023-01-04,TARA,gemGrab,Gem Fort,0,85,62,147,1788
444,2023-01-04,TARA,gemGrab,Crystal Arcade,0,16,2,18,642
445,2023-01-04,TARA,brawlBall,Sunny Soccer,0,45,27,72,6312
446,2023-01-04,TARA,bounty,Shooting Star,0,1,0,1,3570
447,2023-01-03,TARA,knockout,Goldarm Gulch,0,8,1,9,720
448,2023-01-03,TARA,hotZone,Parallel Plays,0,2,1,3,1542
449,2023-01-03,TARA,heist,Pit Stop,1,4,0,5,1956
450,2023-01-03,TARA,gemGrab,Crystal Arcade,0,63,19,82,2406
451,2023-01-03,TARA,brawlBall,Center Stage,0,2,0,2,294
452,2023-01-03,TARA,brawlBall,Beach Ball,1,56,45,102,5580
453,2023-01-03,TARA,bounty,Hideout,0,1,0,1,1638
454,2023-01-02,TARA,knockout,Belle's Rock,0,4,0,4,1794
455,2023-01-02,TARA,hotZone,Quarter Pounder,0,10,2,12,2652
456,2023-01-02,TARA,heist,Pit Stop,0,7,1,8,3498
457,2023-01-02,TARA,gemGrab,Minecart Madness,0,14,4,18,2352
458,2023-01-02,TARA,gemGrab,Double Swoosh,0,39,14,53,1512
459,2023-01-02,TARA,brawlBall,Center Stage,5,95,71,171,7110
460,2023-01-02,TARA,brawlBall,Backyard Bowl,0,1,1,2,492
461,2023-01-02,TARA,bounty,Hideout,0,3,0,3,3090
462,2023-01-01,TARA,hotZone,Quarter Pounder,0,3,1,4,1188
463,2023-01-01,TARA,heist,Bridge Too Far,0,0,1,1,462
464,2023-01-01,TARA,gemGrab,Minecart Madness,0,1,0,1,12
465,2023-01-01,TARA,gemGrab,Hard Rock Mine,0,1,2,3,48
466,2023-01-01,TARA,gemGrab,Double Swoosh,0,36,41,77,1140
467,2023-01-01,TARA,brawlBall,Backyard Bowl,0,8,3,11,2658
468,2022-12-31,TARA,knockout,Flaring Phoenix,0,2,0,2,18
469,2022-12-31,TARA,hotZone,Controller Chaos,0,1,0,1,198
470,2022-12-31,TARA,gemGrab,Hard Rock Mine,0,9,6,15,384
471,2022-12-31,TARA,gemGrab,Deep Diner,0,3,2,5,306
472,2022-12-31,TARA,brawlBall,Super Beach,1,2,3,6,618
473,2022-12-30,TARA,knockout,Flaring Phoenix,0,3,2,5,72
474,2022-12-30,TARA,hotZone,Controller Chaos,0,2,1,3,288
475,2022-12-30,TARA,heist,Kaboom Canyon,0,0,1,1,18
476,2022-12-30,TARA,heist,Hot Potato,0,1,0,1,30
477,2022-12-30,TARA,gemGrab,Undermine,0,3,0,3,102
478,2022-12-30,TARA,gemGrab,Deep Diner,0,2,1,3,438
479,2022-12-30,TARA,brawlBall,Sneaky Fields,0,4,10,14,552
480,2022-12-29,TARA,hotZone,Controller Chaos,0,1,0,1,12
481,2022-12-29,TARA,gemGrab,Undermine,0,1,0,1,102
482,2022-12-29,TARA,gemGrab,Gem Fort,0,0,1,1,30
483,2022-12-29,TARA,brawlBall,Pinhole Punt,0,3,2,5,282
484,2022-12-28,TARA,brawlBall,Sunny Soccer,0,0,1,1,42
485,2022-12-28,TARA,brawlBall,Beach Ball,0,0,1,1,6
486,2022-12-27,TARA,knockout,New Perspective,0,2,3,5,30
487,2022-12-27,TARA,brawlBall,Beach Ball,0,0,2,2,144
488,2022-12-26,TARA,gemGrab,Minecart Madness,0,0,1,1,60
489,2022-12-26,TARA,brawlBall,Center Stage,0,1,2,3,78
490,2022-12-23,TARA,knockout,Out in the Open,0,1,0,1,132
491,2022-12-22,TARA,gemGrab,Gem Fort,0,7,12,19,90
492,2022-12-22,TARA,brawlBall,Pinhole Punt,0,4,2,6,132
493,2022-12-20,TARA,brawlBall,Beach Ball,0,1,2,3,96
494,2022-12-19,TARA,brawlBall,Center Stage,0,0,1,1,102
495,2022-12-17,TARA,knockout,Flaring Phoenix,0,2,4,6,30
496,2022-12-16,TARA,brawlBall,Sneaky Fields,0,0,1,1,84
497,2022-12-13,TARA,knockout,New Perspective,0,2,1,3,84
498,2022-12-13,TARA,gemGrab,Crystal Arcade,0,1,0,1,72
499,2022-12-10,TARA,gemGrab,Hard Rock Mine,0,0,1,1,24
500,2022-11-11,TARA,brawlBall,Sneaky Fields,0,1,3,4,42
501,2022-10-28,TARA,hotZone,Dueling Beetles,0,1,0,1,12
502,2022-10-15,TARA,hotZone,Ring of Fire,0,1,0,1,24
503,2023-01-28,SURGE,knockout,Flaring Phoenix,0,60,40,100,12366
504,2023-01-28,SURGE,hotZone,Controller Chaos,0,210,201,411,10134
505,2023-01-28,SURGE,heist,Bridge Too Far,0,17,6,23,24240
506,2023-01-28,SURGE,gemGrab,Hard Rock Mine,0,304,278,582,16638
507,2023-01-28,SURGE,gemGrab,Deep Diner,0,92,91,183,5478
508,2023-01-28,SURGE,brawlBall,Super Beach,65,1899,1827,3791,74430
509,2023-01-28,SURGE,brawlBall,Sneaky Fields,2,117,159,278,3582
510,2023-01-28,SURGE,bounty,Canal Grande,0,254,259,513,10902
511,2023-01-27,SURGE,knockout,Flaring Phoenix,1,19,9,29,5928
512,2023-01-27,SURGE,hotZone,Controller Chaos,0,75,91,166,2676
513,2023-01-27,SURGE,heist,Hot Potato,0,10,6,16,3486
514,2023-01-27,SURGE,gemGrab,Undermine,0,12,24,36,942
515,2023-01-27,SURGE,gemGrab,Deep Diner,0,102,84,186,6846
516,2023-01-27,SURGE,brawlBall,Sneaky Fields,16,606,636,1258,23514
517,2023-01-27,SURGE,brawlBall,Pinhole Punt,0,14,16,30,738
518,2023-01-27,SURGE,bounty,Temple Ruins,0,21,20,41,1890
519,2023-01-26,SURGE,knockout,Riverside,1,24,5,30,19008
520,2023-01-26,SURGE,hotZone,Open Zone,0,34,15,49,10182
521,2023-01-26,SURGE,heist,Hot Potato,0,72,76,148,14610
522,2023-01-26,SURGE,gemGrab,Undermine,0,191,137,328,10062
523,2023-01-26,SURGE,gemGrab,Gem Fort,0,109,103,212,4674
524,2023-01-26,SURGE,brawlBall,Sunny Soccer,0,108,129,237,3660
525,2023-01-26,SURGE,brawlBall,Pinhole Punt,28,1034,866,1928,67338
526,2023-01-26,SURGE,bounty,Temple Ruins,0,87,88,175,5610
527,2023-01-25,SURGE,knockout,Riverside,0,11,3,14,9906
528,2023-01-25,SURGE,hotZone,Open Zone,0,12,5,17,5262
529,2023-01-25,SURGE,heist,Safe Zone,0,7,1,8,9156
530,2023-01-25,SURGE,gemGrab,Gem Fort,0,118,78,196,5556
531,2023-01-25,SURGE,gemGrab,Crystal Arcade,0,198,258,456,7866
532,2023-01-25,SURGE,brawlBall,Sunny Soccer,36,1003,1024,2063,40830
533,2023-01-25,SURGE,brawlBall,Beach Ball,6,128,143,277,6408
534,2023-01-25,SURGE,bounty,Excel,0,34,68,102,5790
535,2023-01-24,SURGE,knockout,New Perspective,0,51,28,79,10542
536,2023-01-24,SURGE,hotZone,Dueling Beetles,0,79,32,111,10662
537,2023-01-24,SURGE,heist,Safe Zone,0,13,7,20,15750
538,2023-01-24,SURGE,gemGrab,Minecart Madness,0,24,16,40,4002
539,2023-01-24,SURGE,gemGrab,Crystal Arcade,0,300,330,630,14460
540,2023-01-24,SURGE,brawlBall,Center Stage,4,162,164,330,7860
541,2023-01-24,SURGE,brawlBall,Beach Ball,57,1375,1472,2904,64614
542,2023-01-24,SURGE,bounty,Excel,0,42,13,55,10896
543,2023-01-23,SURGE,knockout,New Perspective,0,85,48,133,20676
544,2023-01-23,SURGE,hotZone,Dueling Beetles,0,93,47,140,17502
545,2023-01-23,SURGE,heist,Snaked Assault,0,66,32,98,15762
546,2023-01-23,SURGE,gemGrab,Minecart Madness,0,103,62,165,19062
547,2023-01-23,SURGE,gemGrab,Double Swoosh,0,200,168,368,7578
548,2023-01-23,SURGE,brawlBall,Center Stage,57,1653,1518,3228,92862
549,2023-01-23,SURGE,brawlBall,Backyard Bowl,0,33,21,54,4224
550,2023-01-23,SURGE,bounty,Layer Cake,0,113,86,199,11142
551,2023-01-22,SURGE,knockout,X Marks the Spot,0,29,14,43,9174
552,2023-01-22,SURGE,hotZone,Ring of Fire,0,56,46,102,5730
553,2023-01-22,SURGE,heist,Snaked Assault,0,28,16,44,8232
554,2023-01-22,SURGE,gemGrab,Hard Rock Mine,0,92,128,220,4722
555,2023-01-22,SURGE,gemGrab,Double Swoosh,0,193,146,339,9426
556,2023-01-22,SURGE,brawlBall,Super Beach,5,178,149,332,7386
557,2023-01-22,SURGE,brawlBall,Backyard Bowl,8,233,192,433,34788
558,2023-01-22,SURGE,bounty,Layer Cake,0,46,39,85,6654
559,2023-01-21,SURGE,knockout,X Marks the Spot,0,102,71,173,31698
560,2023-01-21,SURGE,hotZone,Ring of Fire,0,63,34,97,16632
561,2023-01-21,SURGE,heist,Tornado Ring,1,43,27,71,11664
562,2023-01-21,SURGE,gemGrab,Hard Rock Mine,0,444,424,868,22980
563,2023-01-21,SURGE,gemGrab,Deep Diner,0,62,65,127,4470
564,2023-01-21,SURGE,brawlBall,Super Beach,73,2533,2464,5070,101364
565,2023-01-21,SURGE,brawlBall,Sneaky Fields,3,115,104,222,3750
566,2023-01-21,SURGE,bounty,Dry Season,0,28,9,37,14538
567,2023-01-20,SURGE,knockout,Out in the Open,0,63,29,92,20106
568,2023-01-20,SURGE,hotZone,Split,0,208,214,422,9678
569,2023-01-20,SURGE,heist,Tornado Ring,0,56,45,101,12672
570,2023-01-20,SURGE,gemGrab,Undermine,0,106,115,221,5442
571,2023-01-20,SURGE,gemGrab,Deep Diner,0,286,338,624,19050
572,2023-01-20,SURGE,brawlBall,Sneaky Fields,60,1845,1848,3753,74778
573,2023-01-20,SURGE,brawlBall,Pinhole Punt,0,40,24,64,2886
574,2023-01-20,SURGE,bounty,Dry Season,0,19,11,30,11640
575,2023-01-19,SURGE,knockout,Out in the Open,0,83,38,121,26574
576,2023-01-19,SURGE,hotZone,Split,0,422,489,911,14856
577,2023-01-19,SURGE,heist,Kaboom Canyon,1,13,14,28,6732
578,2023-01-19,SURGE,gemGrab,Undermine,0,208,166,374,14154
579,2023-01-19,SURGE,gemGrab,Gem Fort,0,55,63,118,2934
580,2023-01-19,SURGE,brawlBall,Sunny Soccer,1,57,47,105,2274
581,2023-01-19,SURGE,brawlBall,Pinhole Punt,27,1179,989,2195,72498
582,2023-01-19,SURGE,bounty,Shooting Star,0,19,10,29,11124
583,2023-01-18,SURGE,knockout,Goldarm Gulch,0,12,6,18,2784
584,2023-01-18,SURGE,hotZone,Parallel Plays,0,31,16,47,1158
585,2023-01-18,SURGE,heist,Kaboom Canyon,0,2,1,3,2592
586,2023-01-18,SURGE,gemGrab,Gem Fort,0,48,39,87,3006
587,2023-01-18,SURGE,gemGrab,Crystal Arcade,0,26,38,64,990
588,2023-01-18,SURGE,brawlBall,Sunny Soccer,16,420,473,909,18941
589,2023-01-18,SURGE,brawlBall,Beach Ball,0,12,17,29,774
590,2023-01-18,SURGE,bounty,Shooting Star,0,4,3,7,5088
591,2023-01-17,SURGE,knockout,Goldarm Gulch,0,12,4,16,2520
592,2023-01-17,SURGE,hotZone,Parallel Plays,0,34,41,75,1038
593,2023-01-17,SURGE,heist,Pit Stop,0,10,15,25,1290
594,2023-01-17,SURGE,gemGrab,Minecart Madness,0,1,0,1,216
595,2023-01-17,SURGE,gemGrab,Crystal Arcade,0,29,30,59,1266
596,2023-01-17,SURGE,brawlBall,Center Stage,0,6,6,12,288
597,2023-01-17,SURGE,brawlBall,Beach Ball,1,131,126,258,5886
598,2023-01-17,SURGE,bounty,Hideout,0,0,1,1,750
599,2023-01-16,SURGE,knockout,Belle's Rock,0,1,1,2,1788
600,2023-01-16,SURGE,hotZone,Quarter Pounder,0,21,21,42,1494
601,2023-01-16,SURGE,heist,Pit Stop,0,26,63,89,4044
602,2023-01-16,SURGE,gemGrab,Minecart Madness,0,9,2,11,1422
603,2023-01-16,SURGE,gemGrab,Double Swoosh,0,23,21,44,708
604,2023-01-16,SURGE,brawlBall,Center Stage,2,107,100,209,5778
605,2023-01-16,SURGE,brawlBall,Backyard Bowl,0,9,4,13,852
606,2023-01-16,SURGE,bounty,Hideout,0,5,2,7,1470
607,2023-01-15,SURGE,knockout,Belle's Rock,0,3,0,3,2904
608,2023-01-15,SURGE,hotZone,Quarter Pounder,0,52,8,60,3318
609,2023-01-15,SURGE,heist,Bridge Too Far,0,1,0,1,2736
610,2023-01-15,SURGE,gemGrab,Hard Rock Mine,0,23,27,50,1014
611,2023-01-15,SURGE,gemGrab,Double Swoosh,0,55,48,103,2178
612,2023-01-15,SURGE,brawlBall,Super Beach,1,41,36,78,1074
613,2023-01-15,SURGE,brawlBall,Backyard Bowl,1,66,41,108,8946
614,2023-01-15,SURGE,bounty,Canal Grande,0,25,8,33,960
615,2023-01-14,SURGE,knockout,Flaring Phoenix,0,1,3,4,1080
616,2023-01-14,SURGE,hotZone,Controller Chaos,0,76,62,138,2772
617,2023-01-14,SURGE,gemGrab,Hard Rock Mine,0,28,23,51,1272
618,2023-01-14,SURGE,gemGrab,Deep Diner,0,20,14,34,858
619,2023-01-14,SURGE,brawlBall,Super Beach,7,186,169,362,6336
620,2023-01-14,SURGE,brawlBall,Sneaky Fields,2,37,24,63,918
621,2023-01-14,SURGE,bounty,Canal Grande,0,21,17,38,1014
622,2023-01-13,SURGE,knockout,Flaring Phoenix,0,2,2,4,1182
623,2023-01-13,SURGE,hotZone,Controller Chaos,0,87,75,162,2928
624,2023-01-13,SURGE,heist,Hot Potato,0,5,2,7,600
625,2023-01-13,SURGE,gemGrab,Deep Diner,0,24,66,90,1650
626,2023-01-13,SURGE,brawlBall,Sneaky Fields,5,201,151,357,6144
627,2023-01-13,SURGE,brawlBall,Pinhole Punt,0,1,6,7,156
628,2023-01-13,SURGE,bounty,Temple Ruins,0,4,2,6,270
629,2023-01-12,SURGE,knockout,Riverside,0,3,0,3,2532
630,2023-01-12,SURGE,hotZone,Open Zone,0,10,0,10,1488
631,2023-01-12,SURGE,heist,Hot Potato,0,3,0,3,330
632,2023-01-12,SURGE,gemGrab,Undermine,0,6,6,12,690
633,2023-01-12,SURGE,gemGrab,Gem Fort,0,2,0,2,162
634,2023-01-12,SURGE,brawlBall,Sunny Soccer,0,4,0,4,240
635,2023-01-12,SURGE,brawlBall,Pinhole Punt,0,22,18,40,2292
636,2023-01-11,SURGE,gemGrab,Gem Fort,0,8,3,11,414
637,2023-01-11,SURGE,brawlBall,Sunny Soccer,1,43,57,101,1638
638,2023-01-11,SURGE,brawlBall,Beach Ball,0,1,0,1,48
639,2023-01-11,SURGE,bounty,Excel,0,1,0,1,282
640,2023-01-10,SURGE,knockout,New Perspective,0,2,0,2,720
641,2023-01-10,SURGE,hotZone,Dueling Beetles,0,17,7,24,2424
642,2023-01-10,SURGE,heist,Safe Zone,0,0,1,1,1176
643,2023-01-10,SURGE,gemGrab,Minecart Madness,0,4,5,9,828
644,2023-01-10,SURGE,gemGrab,Crystal Arcade,0,34,44,78,1746
645,2023-01-10,SURGE,brawlBall,Center Stage,0,9,11,20,708
646,2023-01-10,SURGE,brawlBall,Beach Ball,2,89,84,175,4392
647,2023-01-09,SURGE,knockout,New Perspective,0,3,0,3,876
648,2023-01-09,SURGE,hotZone,Dueling Beetles,0,7,0,7,1554
649,2023-01-09,SURGE,heist,Snaked Assault,0,8,9,17,2022
650,2023-01-09,SURGE,gemGrab,Minecart Madness,0,9,3,12,1884
651,2023-01-09,SURGE,gemGrab,Double Swoosh,0,33,12,45,1320
652,2023-01-09,SURGE,brawlBall,Center Stage,6,83,78,167,5460
653,2023-01-09,SURGE,brawlBall,Backyard Bowl,2,3,1,6,474
654,2023-01-09,SURGE,bounty,Layer Cake,0,11,2,13,1512
655,2023-01-08,SURGE,knockout,X Marks the Spot,0,3,0,3,1692
656,2023-01-08,SURGE,hotZone,Ring of Fire,0,7,1,8,1644
657,2023-01-08,SURGE,heist,Snaked Assault,0,2,2,4,1494
658,2023-01-08,SURGE,gemGrab,Hard Rock Mine,0,11,19,30,630
659,2023-01-08,SURGE,gemGrab,Double Swoosh,0,17,4,21,864
660,2023-01-08,SURGE,brawlBall,Super Beach,1,20,14,35,732
661,2023-01-08,SURGE,brawlBall,Backyard Bowl,1,19,4,24,4830
662,2023-01-08,SURGE,bounty,Layer Cake,0,4,0,4,528
663,2023-01-07,SURGE,hotZone,Ring of Fire,0,3,2,5,846
664,2023-01-07,SURGE,heist,Tornado Ring,0,5,0,5,1350
665,2023-01-07,SURGE,gemGrab,Hard Rock Mine,0,16,10,26,1158
666,2023-01-07,SURGE,gemGrab,Deep Diner,0,10,30,40,918
667,2023-01-07,SURGE,brawlBall,Super Beach,0,61,99,160,2622
668,2023-01-07,SURGE,brawlBall,Sneaky Fields,0,7,10,17,402
669,2023-01-07,SURGE,bounty,Dry Season,0,1,0,1,1320
670,2023-01-06,SURGE,hotZone,Split,0,31,33,64,1158
671,2023-01-06,SURGE,heist,Tornado Ring,0,14,4,18,2538
672,2023-01-06,SURGE,gemGrab,Undermine,0,4,7,11,540
673,2023-01-06,SURGE,gemGrab,Deep Diner,0,30,46,76,2226
674,2023-01-06,SURGE,brawlBall,Sneaky Fields,3,109,100,212,4896
675,2023-01-06,SURGE,brawlBall,Pinhole Punt,0,3,7,10,510
676,2023-01-06,SURGE,bounty,Dry Season,0,1,0,1,1944
677,2023-01-05,SURGE,knockout,Out in the Open,0,4,1,5,2958
678,2023-01-05,SURGE,hotZone,Split,0,106,98,204,3552
679,2023-01-05,SURGE,heist,Kaboom Canyon,0,1,0,1,954
680,2023-01-05,SURGE,gemGrab,Undermine,0,21,45,66,1812
681,2023-01-05,SURGE,gemGrab,Gem Fort,0,2,10,12,252
682,2023-01-05,SURGE,brawlBall,Sunny Soccer,0,3,4,7,84
683,2023-01-05,SURGE,brawlBall,Pinhole Punt,3,87,105,195,8118
684,2023-01-04,SURGE,hotZone,Parallel Plays,0,18,14,32,864
685,2023-01-04,SURGE,heist,Kaboom Canyon,0,4,0,4,1848
686,2023-01-04,SURGE,gemGrab,Gem Fort,0,32,9,41,1788
687,2023-01-04,SURGE,gemGrab,Crystal Arcade,0,16,6,22,642
688,2023-01-04,SURGE,brawlBall,Sunny Soccer,8,149,111,268,6312
689,2023-01-04,SURGE,brawlBall,Beach Ball,0,1,1,2,54
690,2023-01-04,SURGE,bounty,Shooting Star,0,3,0,3,3570
691,2023-01-03,SURGE,knockout,Goldarm Gulch,0,2,0,2,720
692,2023-01-03,SURGE,hotZone,Parallel Plays,1,34,38,73,1542
693,2023-01-03,SURGE,heist,Pit Stop,0,16,10,26,1956
694,2023-01-03,SURGE,heist,Kaboom Canyon,0,0,1,1,12
695,2023-01-03,SURGE,gemGrab,Minecart Madness,0,7,0,7,456
696,2023-01-03,SURGE,gemGrab,Crystal Arcade,0,44,26,70,2406
697,2023-01-03,SURGE,brawlBall,Center Stage,0,1,5,6,294
698,2023-01-03,SURGE,brawlBall,Beach Ball,0,104,100,204,5580
699,2023-01-03,SURGE,bounty,Hideout,0,2,1,3,1638
700,2023-01-02,SURGE,knockout,Belle's Rock,0,2,0,2,1794
701,2023-01-02,SURGE,hotZone,Quarter Pounder,0,30,7,37,2652
702,2023-01-02,SURGE,heist,Pit Stop,0,23,12,35,3498
703,2023-01-02,SURGE,gemGrab,Minecart Madness,0,12,0,12,2352
704,2023-01-02,SURGE,gemGrab,Double Swoosh,0,42,43,85,1512
705,2023-01-02,SURGE,brawlBall,Center Stage,2,130,111,243,7110
706,2023-01-02,SURGE,brawlBall,Backyard Bowl,0,5,0,5,492
707,2023-01-02,SURGE,bounty,Hideout,0,1,3,4,3090
708,2023-01-01,SURGE,knockout,Belle's Rock,0,1,0,1,858
709,2023-01-01,SURGE,hotZone,Quarter Pounder,0,9,4,13,1188
710,2023-01-01,SURGE,hotZone,Controller Chaos,0,1,1,2,12
711,2023-01-01,SURGE,gemGrab,Double Swoosh,0,24,27,51,1140
712,2023-01-01,SURGE,brawlBall,Backyard Bowl,0,11,3,14,2658
713,2023-01-01,SURGE,bounty,Canal Grande,0,3,0,3,132
714,2022-12-31,SURGE,hotZone,Controller Chaos,0,4,4,8,198
715,2022-12-31,SURGE,gemGrab,Hard Rock Mine,0,9,4,13,384
716,2022-12-31,SURGE,gemGrab,Deep Diner,0,3,2,5,306
717,2022-12-31,SURGE,brawlBall,Super Beach,1,16,25,42,618
718,2022-12-31,SURGE,brawlBall,Sneaky Fields,0,2,0,2,60
719,2022-12-31,SURGE,bounty,Canal Grande,0,0,1,1,54
720,2022-12-30,SURGE,hotZone,Controller Chaos,0,2,2,4,288
721,2022-12-30,SURGE,gemGrab,Undermine,0,2,0,2,102
722,2022-12-30,SURGE,gemGrab,Deep Diner,0,3,2,5,438
723,2022-12-30,SURGE,brawlBall,Sneaky Fields,0,6,4,10,552
724,2022-12-29,SURGE,heist,Hot Potato,0,0,2,2,72
725,2022-12-29,SURGE,gemGrab,Undermine,0,1,0,1,102
726,2022-12-29,SURGE,brawlBall,Pinhole Punt,0,4,0,4,282
727,2022-12-28,SURGE,brawlBall,Sunny Soccer,0,0,2,2,42
728,2022-12-27,SURGE,hotZone,Dueling Beetles,0,0,1,1,36
729,2022-12-27,SURGE,hotZone,Controller Chaos,0,0,1,1,24
730,2022-12-27,SURGE,gemGrab,Minecart Madness,0,1,0,1,30
731,2022-12-27,SURGE,brawlBall,Center Stage,0,0,1,1,30
732,2022-12-27,SURGE,brawlBall,Beach Ball,0,1,1,2,144
733,2022-12-26,SURGE,hotZone,Controller Chaos,0,0,1,1,30
734,2022-12-26,SURGE,heist,Kaboom Canyon,0,1,0,1,36
735,2022-12-26,SURGE,brawlBall,Center Stage,0,0,1,1,78
736,2022-12-25,SURGE,gemGrab,Double Swoosh,0,0,1,1,30
737,2022-12-24,SURGE,brawlBall,Super Beach,0,0,1,1,48
738,2022-12-21,SURGE,brawlBall,Sunny Soccer,0,3,1,4,54
739,2022-12-20,SURGE,brawlBall,Beach Ball,0,0,1,1,96
740,2022-12-19,SURGE,brawlBall,Center Stage,0,1,1,2,102
741,2022-12-16,SURGE,hotZone,Controller Chaos,0,1,0,1,6
742,2022-12-16,SURGE,brawlBall,Sneaky Fields,0,0,2,2,84
743,2022-12-16,SURGE,bounty,Temple Ruins,0,1,0,1,24
744,2022-12-13,SURGE,brawlBall,Beach Ball,0,1,0,1,54
745,2022-12-11,SURGE,gemGrab,Double Swoosh,0,1,0,1,12
746,2022-11-11,SURGE,brawlBall,Sneaky Fields,0,0,1,1,42
747,2022-10-30,SURGE,brawlBall,Beach Ball,0,0,2,2,12
748,2022-10-26,SURGE,brawlBall,Sunny Soccer,0,1,0,1,18
749,2022-10-15,SURGE,gemGrab,Hard Rock Mine,0,1,0,1,90
750,2022-10-15,SURGE,brawlBall,Super Beach,0,0,1,1,12
751,2023-01-28,STU,knockout,Flaring Phoenix,0,43,40,83,12366
752,2023-01-28,STU,hotZone,Controller Chaos,0,208,308,516,10134
753,2023-01-28,STU,heist,Bridge Too Far,0,16,4,20,24240
754,2023-01-28,STU,gemGrab,Hard Rock Mine,0,157,155,312,16638
755,2023-01-28,STU,gemGrab,Deep Diner,0,99,153,252,5478
756,2023-01-28,STU,brawlBall,Super Beach,38,1310,1389,2737,74430
757,2023-01-28,STU,brawlBall,Sneaky Fields,0,24,14,38,3582
758,2023-01-28,STU,bounty,Canal Grande,0,46,57,103,10902
759,2023-01-27,STU,knockout,Flaring Phoenix,0,35,21,56,5928
760,2023-01-27,STU,hotZone,Controller Chaos,0,45,71,116,2676
761,2023-01-27,STU,heist,Hot Potato,0,9,5,14,3486
762,2023-01-27,STU,gemGrab,Undermine,0,9,7,16,942
763,2023-01-27,STU,gemGrab,Deep Diner,0,128,171,299,6846
764,2023-01-27,STU,brawlBall,Sneaky Fields,5,162,125,292,23514
765,2023-01-27,STU,brawlBall,Pinhole Punt,0,12,15,27,738
766,2023-01-27,STU,bounty,Temple Ruins,0,17,8,25,1890
767,2023-01-26,STU,knockout,Riverside,0,47,19,66,19008
768,2023-01-26,STU,hotZone,Open Zone,0,200,245,445,10182
769,2023-01-26,STU,heist,Hot Potato,0,16,12,28,14610
770,2023-01-26,STU,gemGrab,Undermine,0,62,56,118,10062
771,2023-01-26,STU,gemGrab,Gem Fort,0,28,13,41,4674
772,2023-01-26,STU,brawlBall,Sunny Soccer,0,51,46,97,3660
773,2023-01-26,STU,brawlBall,Pinhole Punt,39,1114,1118,2271,67338
774,2023-01-26,STU,bounty,Temple Ruins,0,25,21,46,5610
775,2023-01-25,STU,knockout,Riverside,0,10,2,12,9906
776,2023-01-25,STU,hotZone,Open Zone,0,123,111,234,5262
777,2023-01-25,STU,heist,Safe Zone,0,6,10,16,9156
778,2023-01-25,STU,gemGrab,Gem Fort,0,36,30,66,5556
779,2023-01-25,STU,gemGrab,Crystal Arcade,0,102,106,208,7866
780,2023-01-25,STU,brawlBall,Sunny Soccer,23,713,717,1453,40830
781,2023-01-25,STU,brawlBall,Beach Ball,8,108,121,237,6408
782,2023-01-25,STU,bounty,Excel,0,36,42,78,5790
783,2023-01-24,STU,knockout,New Perspective,0,99,77,176,10542
784,2023-01-24,STU,hotZone,Dueling Beetles,0,114,161,275,10662
785,2023-01-24,STU,heist,Safe Zone,0,24,11,35,15750
786,2023-01-24,STU,gemGrab,Minecart Madness,0,35,44,79,4002
787,2023-01-24,STU,gemGrab,Crystal Arcade,0,171,126,297,14460
788,2023-01-24,STU,brawlBall,Center Stage,0,54,35,89,7860
789,2023-01-24,STU,brawlBall,Beach Ball,40,1256,1453,2749,64614
790,2023-01-24,STU,bounty,Excel,0,53,55,108,10896
791,2023-01-23,STU,knockout,New Perspective,0,143,85,228,20676
792,2023-01-23,STU,hotZone,Dueling Beetles,0,264,264,528,17502
793,2023-01-23,STU,heist,Snaked Assault,0,13,3,16,15762
794,2023-01-23,STU,gemGrab,Minecart Madness,0,166,205,371,19062
795,2023-01-23,STU,gemGrab,Double Swoosh,0,35,25,60,7578
796,2023-01-23,STU,brawlBall,Center Stage,28,716,614,1358,92862
797,2023-01-23,STU,brawlBall,Backyard Bowl,3,100,81,184,4224
798,2023-01-23,STU,bounty,Layer Cake,0,86,47,133,11142
799,2023-01-22,STU,knockout,X Marks the Spot,0,41,13,54,9174
800,2023-01-22,STU,hotZone,Ring of Fire,0,31,61,92,5730
801,2023-01-22,STU,heist,Snaked Assault,0,3,3,6,8232
802,2023-01-22,STU,gemGrab,Hard Rock Mine,0,48,58,106,4722
803,2023-01-22,STU,gemGrab,Double Swoosh,0,46,50,96,9426
804,2023-01-22,STU,brawlBall,Super Beach,5,124,158,287,7386
805,2023-01-22,STU,brawlBall,Backyard Bowl,45,784,792,1621,34788
806,2023-01-22,STU,bounty,Layer Cake,0,45,33,78,6654
807,2023-01-21,STU,knockout,X Marks the Spot,0,112,45,157,31698
808,2023-01-21,STU,hotZone,Ring of Fire,1,120,143,264,16632
809,2023-01-21,STU,heist,Tornado Ring,0,11,9,20,11664
810,2023-01-21,STU,gemGrab,Hard Rock Mine,0,257,302,559,22980
811,2023-01-21,STU,gemGrab,Deep Diner,0,71,83,154,4470
812,2023-01-21,STU,brawlBall,Super Beach,53,1780,1884,3717,101364
813,2023-01-21,STU,brawlBall,Sneaky Fields,0,29,28,57,3750
814,2023-01-21,STU,bounty,Dry Season,0,81,107,188,14538
815,2023-01-20,STU,knockout,Out in the Open,0,106,63,169,20106
816,2023-01-20,STU,hotZone,Split,0,207,316,523,9678
817,2023-01-20,STU,heist,Tornado Ring,0,6,8,14,12672
818,2023-01-20,STU,gemGrab,Undermine,0,25,40,65,5442
819,2023-01-20,STU,gemGrab,Deep Diner,0,364,506,870,19050
820,2023-01-20,STU,brawlBall,Sneaky Fields,11,504,424,939,74778
821,2023-01-20,STU,brawlBall,Pinhole Punt,0,66,72,138,2886
822,2023-01-20,STU,bounty,Dry Season,0,61,29,90,11640
823,2023-01-19,STU,knockout,Out in the Open,0,114,66,180,26574
824,2023-01-19,STU,hotZone,Split,0,348,541,889,14856
825,2023-01-19,STU,heist,Kaboom Canyon,0,18,20,38,6732
826,2023-01-19,STU,gemGrab,Undermine,0,88,66,154,14154
827,2023-01-19,STU,gemGrab,Gem Fort,0,19,14,33,2934
828,2023-01-19,STU,brawlBall,Sunny Soccer,2,40,51,93,2274
829,2023-01-19,STU,brawlBall,Pinhole Punt,43,1198,1166,2407,72498
830,2023-01-19,STU,bounty,Shooting Star,0,30,16,46,11124
831,2023-01-18,STU,knockout,Goldarm Gulch,0,12,10,22,2784
832,2023-01-18,STU,hotZone,Parallel Plays,0,28,29,57,1158
833,2023-01-18,STU,heist,Kaboom Canyon,0,3,0,3,2592
834,2023-01-18,STU,gemGrab,Gem Fort,0,17,35,52,3006
835,2023-01-18,STU,gemGrab,Crystal Arcade,0,10,40,50,990
836,2023-01-18,STU,brawlBall,Sunny Soccer,7,288,264,559,18941
837,2023-01-18,STU,brawlBall,Beach Ball,0,10,15,25,774
838,2023-01-18,STU,bounty,Shooting Star,0,11,10,21,5088
839,2023-01-17,STU,knockout,Goldarm Gulch,0,7,8,15,2520
840,2023-01-17,STU,hotZone,Parallel Plays,0,31,40,71,1038
841,2023-01-17,STU,heist,Pit Stop,0,3,0,3,1290
842,2023-01-17,STU,gemGrab,Minecart Madness,0,2,0,2,216
843,2023-01-17,STU,gemGrab,Crystal Arcade,0,26,21,47,1266
844,2023-01-17,STU,brawlBall,Center Stage,0,2,0,2,288
845,2023-01-17,STU,brawlBall,Beach Ball,5,106,98,209,5886
846,2023-01-17,STU,bounty,Hideout,0,3,1,4,750
847,2023-01-16,STU,knockout,Belle's Rock,0,13,9,22,1788
848,2023-01-16,STU,hotZone,Quarter Pounder,0,32,90,122,1494
849,2023-01-16,STU,heist,Pit Stop,0,4,0,4,4044
850,2023-01-16,STU,gemGrab,Minecart Madness,0,20,14,34,1422
851,2023-01-16,STU,gemGrab,Double Swoosh,0,5,1,6,708
852,2023-01-16,STU,brawlBall,Center Stage,1,43,37,81,5778
853,2023-01-16,STU,brawlBall,Backyard Bowl,0,24,34,58,852
854,2023-01-16,STU,bounty,Hideout,0,10,2,12,1470
855,2023-01-15,STU,knockout,Belle's Rock,0,17,5,22,2904
856,2023-01-15,STU,hotZone,Quarter Pounder,0,64,143,207,3318
857,2023-01-15,STU,gemGrab,Hard Rock Mine,0,16,8,24,1014
858,2023-01-15,STU,gemGrab,Double Swoosh,0,8,1,9,2178
859,2023-01-15,STU,brawlBall,Super Beach,1,18,14,33,1074
860,2023-01-15,STU,brawlBall,Backyard Bowl,16,235,280,531,8946
861,2023-01-15,STU,bounty,Canal Grande,0,7,9,16,960
862,2023-01-14,STU,knockout,Flaring Phoenix,0,5,1,6,1080
863,2023-01-14,STU,hotZone,Controller Chaos,0,39,62,101,2772
864,2023-01-14,STU,gemGrab,Hard Rock Mine,0,23,21,44,1272
865,2023-01-14,STU,gemGrab,Deep Diner,0,13,13,26,858
866,2023-01-14,STU,brawlBall,Super Beach,4,107,89,200,6336
867,2023-01-14,STU,brawlBall,Sneaky Fields,0,11,7,18,918
868,2023-01-14,STU,bounty,Canal Grande,0,2,0,2,1014
869,2023-01-13,STU,knockout,Flaring Phoenix,0,10,0,10,1182
870,2023-01-13,STU,hotZone,Controller Chaos,0,41,55,96,2928
871,2023-01-13,STU,gemGrab,Deep Diner,0,37,24,61,1650
872,2023-01-13,STU,brawlBall,Sneaky Fields,0,24,14,38,6144
873,2023-01-13,STU,brawlBall,Pinhole Punt,0,3,3,6,156
874,2023-01-13,STU,bounty,Temple Ruins,0,2,0,2,270
875,2023-01-12,STU,knockout,Riverside,0,1,0,1,2532
876,2023-01-12,STU,hotZone,Open Zone,0,32,17,49,1488
877,2023-01-12,STU,gemGrab,Undermine,0,3,3,6,690
878,2023-01-12,STU,brawlBall,Sunny Soccer,0,4,0,4,240
879,2023-01-12,STU,brawlBall,Pinhole Punt,1,42,40,83,2292
880,2023-01-11,STU,knockout,Riverside,0,1,0,1,528
881,2023-01-11,STU,hotZone,Open Zone,0,8,12,20,462
882,2023-01-11,STU,gemGrab,Gem Fort,0,2,3,5,414
883,2023-01-11,STU,brawlBall,Sunny Soccer,1,32,43,76,1638
884,2023-01-11,STU,bounty,Excel,0,3,7,10,282
885,2023-01-10,STU,knockout,New Perspective,0,8,1,9,720
886,2023-01-10,STU,hotZone,Dueling Beetles,0,27,10,37,2424
887,2023-01-10,STU,heist,Safe Zone,0,0,2,2,1176
888,2023-01-10,STU,gemGrab,Minecart Madness,0,5,4,9,828
889,2023-01-10,STU,gemGrab,Crystal Arcade,0,24,12,36,1746
890,2023-01-10,STU,brawlBall,Center Stage,0,5,0,5,708
891,2023-01-10,STU,brawlBall,Beach Ball,2,99,97,198,4392
892,2023-01-10,STU,bounty,Excel,0,1,1,2,330
893,2023-01-09,STU,knockout,New Perspective,0,3,1,4,876
894,2023-01-09,STU,hotZone,Dueling Beetles,0,16,25,41,1554
895,2023-01-09,STU,heist,Snaked Assault,0,1,0,1,2022
896,2023-01-09,STU,gemGrab,Minecart Madness,0,20,12,32,1884
897,2023-01-09,STU,gemGrab,Double Swoosh,0,10,9,19,1320
898,2023-01-09,STU,brawlBall,Center Stage,2,35,14,51,5460
899,2023-01-09,STU,brawlBall,Backyard Bowl,0,3,5,8,474
900,2023-01-09,STU,bounty,Layer Cake,0,7,20,27,1512
901,2023-01-08,STU,knockout,X Marks the Spot,0,3,2,5,1692
902,2023-01-08,STU,hotZone,Ring of Fire,0,7,17,24,1644
903,2023-01-08,STU,heist,Snaked Assault,0,2,0,2,1494
904,2023-01-08,STU,gemGrab,Hard Rock Mine,0,5,7,12,630
905,2023-01-08,STU,gemGrab,Double Swoosh,0,3,5,8,864
906,2023-01-08,STU,brawlBall,Super Beach,0,7,8,15,732
907,2023-01-08,STU,brawlBall,Backyard Bowl,6,99,94,199,4830
908,2023-01-08,STU,bounty,Layer Cake,0,1,3,4,528
909,2023-01-07,STU,knockout,X Marks the Spot,0,2,0,2,1014
910,2023-01-07,STU,hotZone,Ring of Fire,0,5,19,24,846
911,2023-01-07,STU,gemGrab,Hard Rock Mine,0,13,38,51,1158
912,2023-01-07,STU,gemGrab,Deep Diner,0,13,1,14,918
913,2023-01-07,STU,brawlBall,Super Beach,0,38,35,73,2622
914,2023-01-07,STU,brawlBall,Sneaky Fields,0,2,7,9,402
915,2023-01-07,STU,bounty,Dry Season,0,3,0,3,1320
916,2023-01-06,STU,knockout,Out in the Open,0,5,4,9,1446
917,2023-01-06,STU,hotZone,Split,0,24,67,91,1158
918,2023-01-06,STU,heist,Tornado Ring,0,1,0,1,2538
919,2023-01-06,STU,gemGrab,Undermine,0,2,1,3,540
920,2023-01-06,STU,gemGrab,Deep Diner,0,49,42,91,2226
921,2023-01-06,STU,brawlBall,Sneaky Fields,2,32,22,56,4896
922,2023-01-06,STU,brawlBall,Pinhole Punt,0,5,6,11,510
923,2023-01-06,STU,bounty,Dry Season,0,6,2,8,1944
924,2023-01-05,STU,knockout,Out in the Open,0,10,4,14,2958
925,2023-01-05,STU,hotZone,Split,0,75,111,186,3552
926,2023-01-05,STU,heist,Kaboom Canyon,0,1,0,1,954
927,2023-01-05,STU,gemGrab,Undermine,0,10,4,14,1812
928,2023-01-05,STU,gemGrab,Gem Fort,0,1,1,2,252
929,2023-01-05,STU,brawlBall,Sunny Soccer,0,1,6,7,84
930,2023-01-05,STU,brawlBall,Pinhole Punt,5,116,143,264,8118
931,2023-01-04,STU,knockout,Goldarm Gulch,0,0,2,2,696
932,2023-01-04,STU,hotZone,Parallel Plays,0,18,29,47,864
933,2023-01-04,STU,heist,Kaboom Canyon,0,4,1,5,1848
934,2023-01-04,STU,gemGrab,Gem Fort,0,10,5,15,1788
935,2023-01-04,STU,gemGrab,Crystal Arcade,0,7,12,19,642
936,2023-01-04,STU,brawlBall,Sunny Soccer,2,109,134,245,6312
937,2023-01-04,STU,brawlBall,Beach Ball,0,1,1,2,54
938,2023-01-04,STU,bounty,Shooting Star,0,3,2,5,3570
939,2023-01-03,STU,knockout,Goldarm Gulch,0,4,0,4,720
940,2023-01-03,STU,hotZone,Parallel Plays,0,29,22,51,1542
941,2023-01-03,STU,heist,Pit Stop,0,1,0,1,1956
942,2023-01-03,STU,gemGrab,Minecart Madness,0,3,6,9,456
943,2023-01-03,STU,gemGrab,Crystal Arcade,0,29,78,107,2406
944,2023-01-03,STU,brawlBall,Center Stage,0,2,11,13,294
945,2023-01-03,STU,brawlBall,Beach Ball,2,150,178,330,5580
946,2023-01-03,STU,bounty,Hideout,0,9,1,10,1638
947,2023-01-02,STU,knockout,Belle's Rock,0,8,1,9,1794
948,2023-01-02,STU,hotZone,Quarter Pounder,2,52,65,119,2652
949,2023-01-02,STU,heist,Pit Stop,0,2,0,2,3498
950,2023-01-02,STU,gemGrab,Minecart Madness,0,25,28,53,2352
951,2023-01-02,STU,gemGrab,Double Swoosh,0,7,2,9,1512
952,2023-01-02,STU,brawlBall,Center Stage,0,46,37,83,7110
953,2023-01-02,STU,brawlBall,Backyard Bowl,3,17,12,32,492
954,2023-01-02,STU,bounty,Hideout,0,7,9,16,3090
955,2023-01-01,STU,knockout,Belle's Rock,0,3,0,3,858
956,2023-01-01,STU,hotZone,Quarter Pounder,0,20,17,37,1188
957,2023-01-01,STU,hotZone,Controller Chaos,0,0,1,1,12
958,2023-01-01,STU,heist,Kaboom Canyon,0,0,1,1,12
959,2023-01-01,STU,heist,Bridge Too Far,0,0,1,1,462
960,2023-01-01,STU,gemGrab,Minecart Madness,0,0,1,1,12
961,2023-01-01,STU,gemGrab,Double Swoosh,0,5,4,9,1140
962,2023-01-01,STU,brawlBall,Backyard Bowl,0,55,91,146,2658
963,2023-01-01,STU,bounty,Canal Grande,0,1,0,1,132
964,2022-12-31,STU,knockout,Flaring Phoenix,0,1,0,1,18
965,2022-12-31,STU,hotZone,Controller Chaos,0,2,1,3,198
966,2022-12-31,STU,gemGrab,Minecart Madness,0,1,0,1,24
967,2022-12-31,STU,gemGrab,Hard Rock Mine,0,8,23,31,384
968,2022-12-31,STU,gemGrab,Deep Diner,0,5,8,13,306
969,2022-12-31,STU,brawlBall,Super Beach,0,13,9,22,618
970,2022-12-31,STU,brawlBall,Sneaky Fields,0,1,0,1,60
971,2022-12-30,STU,knockout,Flaring Phoenix,0,1,0,1,72
972,2022-12-30,STU,hotZone,Controller Chaos,0,4,1,5,288
973,2022-12-30,STU,gemGrab,Undermine,0,0,1,1,102
974,2022-12-30,STU,gemGrab,Minecart Madness,0,1,0,1,24
975,2022-12-30,STU,gemGrab,Deep Diner,0,10,7,17,438
976,2022-12-30,STU,brawlBall,Sneaky Fields,0,6,2,8,552
977,2022-12-29,STU,hotZone,Open Zone,0,1,1,2,54
978,2022-12-29,STU,gemGrab,Minecart Madness,0,0,1,1,24
979,2022-12-29,STU,brawlBall,Pinhole Punt,0,6,1,7,282
980,2022-12-28,STU,hotZone,Open Zone,0,4,0,4,108
981,2022-12-27,STU,hotZone,Controller Chaos,0,0,2,2,24
982,2022-12-27,STU,brawlBall,Center Stage,0,1,0,1,30
983,2022-12-27,STU,brawlBall,Beach Ball,0,3,3,6,144
984,2022-12-26,STU,hotZone,Controller Chaos,0,1,1,2,30
985,2022-12-26,STU,brawlBall,Center Stage,0,1,0,1,78
986,2022-12-25,STU,hotZone,Ring of Fire,0,1,0,1,12
987,2022-12-25,STU,brawlBall,Backyard Bowl,0,2,0,2,78
988,2022-12-24,STU,brawlBall,Super Beach,0,1,0,1,48
989,2022-12-23,STU,knockout,Out in the Open,0,2,1,3,132
990,2022-12-22,STU,brawlBall,Pinhole Punt,0,3,2,5,132
991,2022-12-21,STU,brawlBall,Sunny Soccer,0,0,1,1,54
992,2022-12-19,STU,brawlBall,Center Stage,0,1,1,2,102
993,2022-12-16,STU,brawlBall,Sneaky Fields,0,0,2,2,84
994,2022-12-13,STU,brawlBall,Beach Ball,0,0,1,1,54
995,2022-11-03,STU,brawlBall,Pinhole Punt,0,0,1,1,12
996,2022-10-30,STU,brawlBall,Beach Ball,0,0,2,2,12
997,2022-10-15,STU,gemGrab,Hard Rock Mine,0,4,2,6,90
998,2022-10-10,STU,knockout,Belle's Rock,0,1,0,1,48
999,2023-01-28,SQUEAK,knockout,Flaring Phoenix,1,37,24,62,12366
1000,2023-01-28,SQUEAK,hotZone,Controller Chaos,0,119,196,315,10134
1001,2023-01-28,SQUEAK,heist,Bridge Too Far,1,55,46,102,24240
1002,2023-01-28,SQUEAK,gemGrab,Hard Rock Mine,0,39,35,74,16638
1003,2023-01-28,SQUEAK,gemGrab,Deep Diner,0,47,53,100,5478
1004,2023-01-28,SQUEAK,brawlBall,Super Beach,4,181,220,405,74430
1005,2023-01-28,SQUEAK,brawlBall,Sneaky Fields,1,4,8,13,3582
1006,2023-01-28,SQUEAK,bounty,Canal Grande,0,60,98,158,10902
1007,2023-01-27,SQUEAK,knockout,Flaring Phoenix,0,14,16,30,5928
1008,2023-01-27,SQUEAK,hotZone,Controller Chaos,0,27,14,41,2676
1009,2023-01-27,SQUEAK,heist,Hot Potato,0,11,6,17,3486
1010,2023-01-27,SQUEAK,gemGrab,Undermine,0,4,2,6,942
1011,2023-01-27,SQUEAK,gemGrab,Deep Diner,0,41,24,65,6846
1012,2023-01-27,SQUEAK,brawlBall,Sneaky Fields,0,71,75,146,23514
1013,2023-01-27,SQUEAK,brawlBall,Pinhole Punt,0,2,2,4,738
1014,2023-01-27,SQUEAK,bounty,Temple Ruins,0,9,5,14,1890
1015,2023-01-26,SQUEAK,knockout,Riverside,0,64,53,117,19008
1016,2023-01-26,SQUEAK,hotZone,Open Zone,0,36,37,73,10182
1017,2023-01-26,SQUEAK,heist,Hot Potato,0,21,13,34,14610
1018,2023-01-26,SQUEAK,gemGrab,Undermine,0,40,15,55,10062
1019,2023-01-26,SQUEAK,gemGrab,Gem Fort,0,16,14,30,4674
1020,2023-01-26,SQUEAK,brawlBall,Sunny Soccer,0,17,16,33,3660
1021,2023-01-26,SQUEAK,brawlBall,Pinhole Punt,4,212,243,459,67338
1022,2023-01-26,SQUEAK,bounty,Temple Ruins,0,16,10,26,5610
1023,2023-01-25,SQUEAK,knockout,Riverside,0,26,24,50,9906
1024,2023-01-25,SQUEAK,hotZone,Open Zone,0,10,12,22,5262
1025,2023-01-25,SQUEAK,heist,Safe Zone,0,30,21,51,9156
1026,2023-01-25,SQUEAK,gemGrab,Gem Fort,0,20,16,36,5556
1027,2023-01-25,SQUEAK,gemGrab,Crystal Arcade,0,43,31,74,7866
1028,2023-01-25,SQUEAK,brawlBall,Sunny Soccer,4,125,151,280,40830
1029,2023-01-25,SQUEAK,brawlBall,Beach Ball,1,13,12,26,6408
1030,2023-01-25,SQUEAK,bounty,Excel,0,27,20,47,5790
1031,2023-01-24,SQUEAK,knockout,New Perspective,0,47,38,85,10542
1032,2023-01-24,SQUEAK,hotZone,Dueling Beetles,0,204,313,517,10662
1033,2023-01-24,SQUEAK,heist,Safe Zone,0,49,44,93,15750
1034,2023-01-24,SQUEAK,gemGrab,Minecart Madness,0,39,52,91,4002
1035,2023-01-24,SQUEAK,gemGrab,Crystal Arcade,0,79,93,172,14460
1036,2023-01-24,SQUEAK,brawlBall,Center Stage,1,25,33,59,7860
1037,2023-01-24,SQUEAK,brawlBall,Beach Ball,5,232,238,475,64614
1038,2023-01-24,SQUEAK,bounty,Excel,0,35,43,78,10896
1039,2023-01-23,SQUEAK,knockout,New Perspective,0,67,76,143,20676
1040,2023-01-23,SQUEAK,hotZone,Dueling Beetles,1,361,547,909,17502
1041,2023-01-23,SQUEAK,heist,Snaked Assault,0,25,26,51,15762
1042,2023-01-23,SQUEAK,gemGrab,Minecart Madness,0,196,210,406,19062
1043,2023-01-23,SQUEAK,gemGrab,Double Swoosh,0,41,30,71,7578
1044,2023-01-23,SQUEAK,brawlBall,Center Stage,5,350,412,767,92862
1045,2023-01-23,SQUEAK,brawlBall,Backyard Bowl,1,5,5,11,4224
1046,2023-01-23,SQUEAK,bounty,Layer Cake,0,58,64,122,11142
1047,2023-01-22,SQUEAK,knockout,X Marks the Spot,0,36,38,74,9174
1048,2023-01-22,SQUEAK,hotZone,Ring of Fire,0,33,24,57,5730
1049,2023-01-22,SQUEAK,heist,Snaked Assault,0,8,2,10,8232
1050,2023-01-22,SQUEAK,gemGrab,Hard Rock Mine,0,18,10,28,4722
1051,2023-01-22,SQUEAK,gemGrab,Double Swoosh,0,51,58,109,9426
1052,2023-01-22,SQUEAK,brawlBall,Super Beach,0,18,15,33,7386
1053,2023-01-22,SQUEAK,brawlBall,Backyard Bowl,2,56,27,85,34788
1054,2023-01-22,SQUEAK,bounty,Layer Cake,0,36,45,81,6654
1055,2023-01-21,SQUEAK,knockout,X Marks the Spot,0,127,97,224,31698
1056,2023-01-21,SQUEAK,hotZone,Ring of Fire,0,119,122,241,16632
1057,2023-01-21,SQUEAK,heist,Tornado Ring,0,22,7,29,11664
1058,2023-01-21,SQUEAK,gemGrab,Hard Rock Mine,0,95,59,154,22980
1059,2023-01-21,SQUEAK,gemGrab,Deep Diner,0,24,34,58,4470
1060,2023-01-21,SQUEAK,brawlBall,Super Beach,6,312,289,607,101364
1061,2023-01-21,SQUEAK,brawlBall,Sneaky Fields,0,10,7,17,3750
1062,2023-01-21,SQUEAK,bounty,Dry Season,0,42,58,100,14538
1063,2023-01-20,SQUEAK,knockout,Out in the Open,1,123,148,272,20106
1064,2023-01-20,SQUEAK,hotZone,Split,0,47,53,100,9678
1065,2023-01-20,SQUEAK,heist,Tornado Ring,0,12,13,25,12672
1066,2023-01-20,SQUEAK,gemGrab,Undermine,0,28,21,49,5442
1067,2023-01-20,SQUEAK,gemGrab,Deep Diner,0,122,181,303,19050
1068,2023-01-20,SQUEAK,brawlBall,Sneaky Fields,10,260,249,519,74778
1069,2023-01-20,SQUEAK,brawlBall,Pinhole Punt,0,11,14,25,2886
1070,2023-01-20,SQUEAK,bounty,Dry Season,0,49,61,110,11640
1071,2023-01-19,SQUEAK,knockout,Out in the Open,0,136,120,256,26574
1072,2023-01-19,SQUEAK,hotZone,Split,0,44,21,65,14856
1073,2023-01-19,SQUEAK,heist,Kaboom Canyon,0,19,13,32,6732
1074,2023-01-19,SQUEAK,gemGrab,Undermine,0,60,58,118,14154
1075,2023-01-19,SQUEAK,gemGrab,Gem Fort,0,14,4,18,2934
1076,2023-01-19,SQUEAK,brawlBall,Sunny Soccer,0,7,13,20,2274
1077,2023-01-19,SQUEAK,brawlBall,Pinhole Punt,5,195,202,402,72498
1078,2023-01-19,SQUEAK,bounty,Shooting Star,0,24,19,43,11124
1079,2023-01-18,SQUEAK,knockout,Goldarm Gulch,0,7,12,19,2784
1080,2023-01-18,SQUEAK,hotZone,Parallel Plays,0,4,5,9,1158
1081,2023-01-18,SQUEAK,heist,Kaboom Canyon,0,5,9,14,2592
1082,2023-01-18,SQUEAK,gemGrab,Gem Fort,0,12,5,17,3006
1083,2023-01-18,SQUEAK,gemGrab,Crystal Arcade,0,6,0,6,990
1084,2023-01-18,SQUEAK,brawlBall,Sunny Soccer,1,99,87,187,18941
1085,2023-01-18,SQUEAK,brawlBall,Beach Ball,0,3,1,4,774
1086,2023-01-18,SQUEAK,bounty,Shooting Star,0,11,8,19,5088
1087,2023-01-17,SQUEAK,knockout,Goldarm Gulch,0,7,7,14,2520
1088,2023-01-17,SQUEAK,hotZone,Parallel Plays,0,9,4,13,1038
1089,2023-01-17,SQUEAK,heist,Pit Stop,0,3,1,4,1290
1090,2023-01-17,SQUEAK,gemGrab,Minecart Madness,0,1,3,4,216
1091,2023-01-17,SQUEAK,gemGrab,Crystal Arcade,0,6,9,15,1266
1092,2023-01-17,SQUEAK,brawlBall,Beach Ball,1,31,18,50,5886
1093,2023-01-17,SQUEAK,bounty,Hideout,0,2,0,2,750
1094,2023-01-16,SQUEAK,knockout,Belle's Rock,0,5,3,8,1788
1095,2023-01-16,SQUEAK,hotZone,Quarter Pounder,0,9,0,9,1494
1096,2023-01-16,SQUEAK,heist,Pit Stop,0,3,0,3,4044
1097,2023-01-16,SQUEAK,gemGrab,Minecart Madness,0,15,16,31,1422
1098,2023-01-16,SQUEAK,gemGrab,Double Swoosh,0,3,12,15,708
1099,2023-01-16,SQUEAK,brawlBall,Center Stage,0,27,44,71,5778
1100,2023-01-16,SQUEAK,brawlBall,Backyard Bowl,0,2,7,9,852
1101,2023-01-16,SQUEAK,bounty,Hideout,0,5,3,8,1470
1102,2023-01-15,SQUEAK,knockout,Belle's Rock,0,8,3,11,2904
1103,2023-01-15,SQUEAK,hotZone,Quarter Pounder,0,16,38,54,3318
1104,2023-01-15,SQUEAK,heist,Bridge Too Far,0,8,3,11,2736
1105,2023-01-15,SQUEAK,gemGrab,Hard Rock Mine,0,4,0,4,1014
1106,2023-01-15,SQUEAK,gemGrab,Double Swoosh,0,4,4,8,2178
1107,2023-01-15,SQUEAK,brawlBall,Super Beach,0,3,4,7,1074
1108,2023-01-15,SQUEAK,brawlBall,Backyard Bowl,0,11,9,20,8946
1109,2023-01-15,SQUEAK,bounty,Canal Grande,0,4,8,12,960
1110,2023-01-14,SQUEAK,knockout,Flaring Phoenix,0,5,0,5,1080
1111,2023-01-14,SQUEAK,hotZone,Controller Chaos,0,17,35,52,2772
1112,2023-01-14,SQUEAK,heist,Bridge Too Far,0,6,6,12,4020
1113,2023-01-14,SQUEAK,gemGrab,Hard Rock Mine,0,2,0,2,1272
1114,2023-01-14,SQUEAK,gemGrab,Deep Diner,0,2,0,2,858
1115,2023-01-14,SQUEAK,brawlBall,Super Beach,0,11,20,31,6336
1116,2023-01-14,SQUEAK,brawlBall,Sneaky Fields,0,4,4,8,918
1117,2023-01-14,SQUEAK,bounty,Canal Grande,0,5,0,5,1014
1118,2023-01-13,SQUEAK,knockout,Flaring Phoenix,0,3,1,4,1182
1119,2023-01-13,SQUEAK,hotZone,Controller Chaos,0,32,74,106,2928
1120,2023-01-13,SQUEAK,heist,Hot Potato,0,1,1,2,600
1121,2023-01-13,SQUEAK,gemGrab,Deep Diner,0,11,34,45,1650
1122,2023-01-13,SQUEAK,brawlBall,Sneaky Fields,1,11,9,21,6144
1123,2023-01-13,SQUEAK,bounty,Temple Ruins,0,0,1,1,270
1124,2023-01-12,SQUEAK,knockout,Riverside,0,6,0,6,2532
1125,2023-01-12,SQUEAK,hotZone,Open Zone,0,8,5,13,1488
1126,2023-01-12,SQUEAK,heist,Hot Potato,0,1,1,2,330
1127,2023-01-12,SQUEAK,gemGrab,Undermine,0,1,0,1,690
1128,2023-01-12,SQUEAK,brawlBall,Pinhole Punt,0,4,3,7,2292
1129,2023-01-11,SQUEAK,brawlBall,Sunny Soccer,0,3,3,6,1638
1130,2023-01-11,SQUEAK,bounty,Excel,0,3,14,17,282
1131,2023-01-10,SQUEAK,knockout,New Perspective,0,6,0,6,720
1132,2023-01-10,SQUEAK,hotZone,Dueling Beetles,0,29,53,82,2424
1133,2023-01-10,SQUEAK,gemGrab,Minecart Madness,0,5,2,7,828
1134,2023-01-10,SQUEAK,gemGrab,Crystal Arcade,0,3,0,3,1746
1135,2023-01-10,SQUEAK,brawlBall,Center Stage,0,2,7,9,708
1136,2023-01-10,SQUEAK,brawlBall,Beach Ball,0,17,44,61,4392
1137,2023-01-10,SQUEAK,bounty,Excel,0,1,0,1,330
1138,2023-01-09,SQUEAK,knockout,New Perspective,0,1,0,1,876
1139,2023-01-09,SQUEAK,hotZone,Dueling Beetles,0,33,66,99,1554
1140,2023-01-09,SQUEAK,heist,Snaked Assault,0,2,2,4,2022
1141,2023-01-09,SQUEAK,gemGrab,Minecart Madness,0,6,4,10,1884
1142,2023-01-09,SQUEAK,gemGrab,Double Swoosh,0,8,8,16,1320
1143,2023-01-09,SQUEAK,brawlBall,Center Stage,0,9,7,16,5460
1144,2023-01-09,SQUEAK,brawlBall,Backyard Bowl,0,2,2,4,474
1145,2023-01-09,SQUEAK,bounty,Layer Cake,0,2,1,3,1512
1146,2023-01-08,SQUEAK,knockout,X Marks the Spot,0,5,1,6,1692
1147,2023-01-08,SQUEAK,hotZone,Ring of Fire,0,14,5,19,1644
1148,2023-01-08,SQUEAK,heist,Snaked Assault,0,2,1,3,1494
1149,2023-01-08,SQUEAK,gemGrab,Hard Rock Mine,0,3,0,3,630
1150,2023-01-08,SQUEAK,gemGrab,Double Swoosh,0,4,2,6,864
1151,2023-01-08,SQUEAK,brawlBall,Super Beach,0,5,3,8,732
1152,2023-01-08,SQUEAK,brawlBall,Backyard Bowl,0,10,2,12,4830
1153,2023-01-08,SQUEAK,bounty,Layer Cake,0,6,8,14,528
1154,2023-01-07,SQUEAK,knockout,X Marks the Spot,0,1,0,1,1014
1155,2023-01-07,SQUEAK,hotZone,Ring of Fire,0,2,1,3,846
1156,2023-01-07,SQUEAK,gemGrab,Deep Diner,0,2,2,4,918
1157,2023-01-07,SQUEAK,brawlBall,Super Beach,0,7,9,16,2622
1158,2023-01-07,SQUEAK,bounty,Dry Season,0,6,0,6,1320
1159,2023-01-06,SQUEAK,knockout,Out in the Open,0,4,2,6,1446
1160,2023-01-06,SQUEAK,heist,Tornado Ring,0,2,0,2,2538
1161,2023-01-06,SQUEAK,gemGrab,Undermine,0,2,14,16,540
1162,2023-01-06,SQUEAK,gemGrab,Deep Diner,0,9,15,24,2226
1163,2023-01-06,SQUEAK,brawlBall,Sneaky Fields,0,13,12,25,4896
1164,2023-01-06,SQUEAK,brawlBall,Pinhole Punt,0,0,2,2,510
1165,2023-01-06,SQUEAK,bounty,Dry Season,0,1,2,3,1944
1166,2023-01-05,SQUEAK,knockout,Out in the Open,0,6,2,8,2958
1167,2023-01-05,SQUEAK,hotZone,Split,0,11,19,30,3552
1168,2023-01-05,SQUEAK,heist,Kaboom Canyon,0,2,1,3,954
1169,2023-01-05,SQUEAK,gemGrab,Undermine,0,4,10,14,1812
1170,2023-01-05,SQUEAK,gemGrab,Gem Fort,0,1,0,1,252
1171,2023-01-05,SQUEAK,brawlBall,Pinhole Punt,0,16,15,31,8118
1172,2023-01-04,SQUEAK,hotZone,Parallel Plays,0,4,1,5,864
1173,2023-01-04,SQUEAK,heist,Kaboom Canyon,0,3,0,3,1848
1174,2023-01-04,SQUEAK,gemGrab,Gem Fort,0,1,0,1,1788
1175,2023-01-04,SQUEAK,gemGrab,Crystal Arcade,0,1,0,1,642
1176,2023-01-04,SQUEAK,brawlBall,Sunny Soccer,0,22,26,48,6312
1177,2023-01-04,SQUEAK,bounty,Shooting Star,0,1,1,2,3570
1178,2023-01-03,SQUEAK,knockout,Goldarm Gulch,0,0,2,2,720
1179,2023-01-03,SQUEAK,hotZone,Parallel Plays,0,4,1,5,1542
1180,2023-01-03,SQUEAK,heist,Pit Stop,0,4,17,21,1956
1181,2023-01-03,SQUEAK,gemGrab,Minecart Madness,0,4,11,15,456
1182,2023-01-03,SQUEAK,gemGrab,Crystal Arcade,0,7,5,12,2406
1183,2023-01-03,SQUEAK,brawlBall,Center Stage,0,0,1,1,294
1184,2023-01-03,SQUEAK,brawlBall,Beach Ball,2,8,25,35,5580
1185,2023-01-03,SQUEAK,bounty,Hideout,0,2,1,3,1638
1186,2023-01-02,SQUEAK,knockout,Belle's Rock,0,4,3,7,1794
1187,2023-01-02,SQUEAK,hotZone,Quarter Pounder,0,11,19,30,2652
1188,2023-01-02,SQUEAK,heist,Pit Stop,0,5,0,5,3498
1189,2023-01-02,SQUEAK,heist,Kaboom Canyon,0,1,0,1,30
1190,2023-01-02,SQUEAK,gemGrab,Minecart Madness,0,16,10,26,2352
1191,2023-01-02,SQUEAK,gemGrab,Double Swoosh,0,3,2,5,1512
1192,2023-01-02,SQUEAK,brawlBall,Center Stage,1,19,12,32,7110
1193,2023-01-02,SQUEAK,brawlBall,Backyard Bowl,0,0,1,1,492
1194,2023-01-02,SQUEAK,bounty,Hideout,0,6,0,6,3090
1195,2023-01-01,SQUEAK,knockout,Belle's Rock,0,1,2,3,858
1196,2023-01-01,SQUEAK,hotZone,Quarter Pounder,0,8,14,22,1188
1197,2023-01-01,SQUEAK,heist,Bridge Too Far,0,1,0,1,462
1198,2023-01-01,SQUEAK,gemGrab,Minecart Madness,0,1,0,1,12
1199,2023-01-01,SQUEAK,gemGrab,Double Swoosh,0,2,5,7,1140
1200,2023-01-01,SQUEAK,brawlBall,Backyard Bowl,0,2,0,2,2658
1201,2023-01-01,SQUEAK,bounty,Canal Grande,0,0,1,1,132
1202,2022-12-31,SQUEAK,heist,Bridge Too Far,0,1,0,1,276
1203,2022-12-31,SQUEAK,gemGrab,Minecart Madness,0,1,0,1,24
1204,2022-12-31,SQUEAK,gemGrab,Hard Rock Mine,0,2,0,2,384
1205,2022-12-31,SQUEAK,gemGrab,Deep Diner,0,1,5,6,306
1206,2022-12-31,SQUEAK,brawlBall,Super Beach,0,5,0,5,618
1207,2022-12-30,SQUEAK,hotZone,Controller Chaos,0,2,1,3,288
1208,2022-12-30,SQUEAK,gemGrab,Undermine,0,4,14,18,102
1209,2022-12-30,SQUEAK,gemGrab,Deep Diner,0,4,0,4,438
1210,2022-12-30,SQUEAK,brawlBall,Sneaky Fields,0,3,0,3,552
1211,2022-12-29,SQUEAK,hotZone,Open Zone,0,0,1,1,54
1212,2022-12-29,SQUEAK,gemGrab,Minecart Madness,0,0,1,1,24
1213,2022-12-27,SQUEAK,hotZone,Dueling Beetles,0,1,1,2,36
1214,2022-12-27,SQUEAK,hotZone,Controller Chaos,0,0,1,1,24
1215,2022-12-27,SQUEAK,heist,Kaboom Canyon,0,0,1,1,18
1216,2022-12-27,SQUEAK,brawlBall,Beach Ball,0,1,0,1,144
1217,2022-12-26,SQUEAK,hotZone,Controller Chaos,0,0,1,1,30
1218,2022-12-26,SQUEAK,heist,Kaboom Canyon,0,0,1,1,36
1219,2022-12-26,SQUEAK,gemGrab,Minecart Madness,0,1,0,1,60
1220,2022-12-23,SQUEAK,knockout,Out in the Open,0,1,0,1,132
1221,2022-12-21,SQUEAK,brawlBall,Sunny Soccer,0,1,0,1,54
1222,2022-12-20,SQUEAK,brawlBall,Beach Ball,1,1,0,2,96
1223,2022-12-16,SQUEAK,hotZone,Controller Chaos,0,1,0,1,6
1224,2022-12-13,SQUEAK,gemGrab,Crystal Arcade,0,1,0,1,72
1225,2022-12-11,SQUEAK,brawlBall,Backyard Bowl,0,1,0,1,24
1226,2022-11-07,SQUEAK,hotZone,Quarter Pounder,0,2,2,4,24
1227,2022-10-15,SQUEAK,gemGrab,Hard Rock Mine,0,1,0,1,90
1228,2023-01-28,SPROUT,knockout,Flaring Phoenix,2,98,114,214,12366
1229,2023-01-28,SPROUT,hotZone,Controller Chaos,0,25,21,46,10134
1230,2023-01-28,SPROUT,heist,Bridge Too Far,0,24,7,31,24240
1231,2023-01-28,SPROUT,gemGrab,Hard Rock Mine,0,31,21,52,16638
1232,2023-01-28,SPROUT,gemGrab,Deep Diner,0,18,20,38,5478
1233,2023-01-28,SPROUT,brawlBall,Super Beach,1,86,42,129,74430
1234,2023-01-28,SPROUT,brawlBall,Sneaky Fields,0,2,0,2,3582
1235,2023-01-28,SPROUT,bounty,Canal Grande,0,52,54,106,10902
1236,2023-01-27,SPROUT,knockout,Flaring Phoenix,0,36,39,75,5928
1237,2023-01-27,SPROUT,hotZone,Controller Chaos,0,8,4,12,2676
1238,2023-01-27,SPROUT,heist,Hot Potato,0,2,1,3,3486
1239,2023-01-27,SPROUT,gemGrab,Undermine,0,1,0,1,942
1240,2023-01-27,SPROUT,gemGrab,Deep Diner,0,23,29,52,6846
1241,2023-01-27,SPROUT,brawlBall,Sneaky Fields,1,37,20,58,23514
1242,2023-01-27,SPROUT,brawlBall,Pinhole Punt,0,1,0,1,738
1243,2023-01-27,SPROUT,bounty,Temple Ruins,0,4,7,11,1890
1244,2023-01-26,SPROUT,knockout,Riverside,0,60,69,129,19008
1245,2023-01-26,SPROUT,hotZone,Open Zone,0,7,3,10,10182
1246,2023-01-26,SPROUT,heist,Hot Potato,0,6,3,9,14610
1247,2023-01-26,SPROUT,gemGrab,Undermine,0,17,13,30,10062
1248,2023-01-26,SPROUT,gemGrab,Gem Fort,0,7,2,9,4674
1249,2023-01-26,SPROUT,brawlBall,Sunny Soccer,0,7,4,11,3660
1250,2023-01-26,SPROUT,brawlBall,Pinhole Punt,1,52,45,98,67338
1251,2023-01-26,SPROUT,bounty,Temple Ruins,0,5,10,15,5610
1252,2023-01-25,SPROUT,knockout,Riverside,0,30,40,70,9906
1253,2023-01-25,SPROUT,hotZone,Open Zone,0,3,0,3,5262
1254,2023-01-25,SPROUT,heist,Safe Zone,0,10,8,18,9156
1255,2023-01-25,SPROUT,gemGrab,Gem Fort,0,9,13,22,5556
1256,2023-01-25,SPROUT,gemGrab,Crystal Arcade,0,18,12,30,7866
1257,2023-01-25,SPROUT,brawlBall,Sunny Soccer,4,64,56,124,40830
1258,2023-01-25,SPROUT,brawlBall,Beach Ball,1,10,13,24,6408
1259,2023-01-25,SPROUT,bounty,Excel,0,43,44,87,5790
1260,2023-01-24,SPROUT,knockout,New Perspective,0,50,56,106,10542
1261,2023-01-24,SPROUT,hotZone,Dueling Beetles,0,76,76,152,10662
1262,2023-01-24,SPROUT,heist,Safe Zone,0,17,3,20,15750
1263,2023-01-24,SPROUT,gemGrab,Minecart Madness,0,24,29,53,4002
1264,2023-01-24,SPROUT,gemGrab,Crystal Arcade,0,20,2,22,14460
1265,2023-01-24,SPROUT,brawlBall,Center Stage,1,1,4,6,7860
1266,2023-01-24,SPROUT,brawlBall,Beach Ball,1,94,87,182,64614
1267,2023-01-24,SPROUT,bounty,Excel,0,106,108,214,10896
1268,2023-01-23,SPROUT,knockout,New Perspective,0,77,76,153,20676
1269,2023-01-23,SPROUT,hotZone,Dueling Beetles,1,112,135,248,17502
1270,2023-01-23,SPROUT,heist,Snaked Assault,0,2,0,2,15762
1271,2023-01-23,SPROUT,gemGrab,Minecart Madness,0,83,87,170,19062
1272,2023-01-23,SPROUT,gemGrab,Double Swoosh,0,3,1,4,7578
1273,2023-01-23,SPROUT,brawlBall,Center Stage,3,89,65,157,92862
1274,2023-01-23,SPROUT,brawlBall,Backyard Bowl,0,11,29,40,4224
1275,2023-01-23,SPROUT,bounty,Layer Cake,0,106,155,261,11142
1276,2023-01-22,SPROUT,knockout,X Marks the Spot,0,49,57,106,9174
1277,2023-01-22,SPROUT,hotZone,Ring of Fire,0,10,3,13,5730
1278,2023-01-22,SPROUT,heist,Snaked Assault,0,0,1,1,8232
1279,2023-01-22,SPROUT,gemGrab,Hard Rock Mine,0,5,1,6,4722
1280,2023-01-22,SPROUT,gemGrab,Double Swoosh,0,3,4,7,9426
1281,2023-01-22,SPROUT,brawlBall,Super Beach,0,10,14,24,7386
1282,2023-01-22,SPROUT,brawlBall,Backyard Bowl,2,36,32,70,34788
1283,2023-01-22,SPROUT,bounty,Layer Cake,0,67,64,131,6654
1284,2023-01-21,SPROUT,knockout,X Marks the Spot,1,165,180,346,31698
1285,2023-01-21,SPROUT,hotZone,Ring of Fire,0,24,9,33,16632
1286,2023-01-21,SPROUT,heist,Tornado Ring,0,1,3,4,11664
1287,2023-01-21,SPROUT,gemGrab,Hard Rock Mine,0,34,11,45,22980
1288,2023-01-21,SPROUT,gemGrab,Deep Diner,0,14,11,25,4470
1289,2023-01-21,SPROUT,brawlBall,Super Beach,2,94,68,164,101364
1290,2023-01-21,SPROUT,brawlBall,Sneaky Fields,0,4,3,7,3750
1291,2023-01-21,SPROUT,bounty,Dry Season,0,139,187,326,14538
1292,2023-01-20,SPROUT,knockout,Out in the Open,0,89,113,202,20106
1293,2023-01-20,SPROUT,hotZone,Split,0,80,51,131,9678
1294,2023-01-20,SPROUT,heist,Tornado Ring,0,5,2,7,12672
1295,2023-01-20,SPROUT,gemGrab,Undermine,0,8,8,16,5442
1296,2023-01-20,SPROUT,gemGrab,Deep Diner,0,43,23,66,19050
1297,2023-01-20,SPROUT,brawlBall,Sneaky Fields,2,65,58,125,74778
1298,2023-01-20,SPROUT,brawlBall,Pinhole Punt,0,1,0,1,2886
1299,2023-01-20,SPROUT,bounty,Dry Season,0,108,101,209,11640
1300,2023-01-19,SPROUT,knockout,Out in the Open,0,110,136,246,26574
1301,2023-01-19,SPROUT,hotZone,Split,0,120,138,258,14856
1302,2023-01-19,SPROUT,heist,Kaboom Canyon,0,4,7,11,6732
1303,2023-01-19,SPROUT,gemGrab,Undermine,0,10,16,26,14154
1304,2023-01-19,SPROUT,gemGrab,Gem Fort,0,3,1,4,2934
1305,2023-01-19,SPROUT,brawlBall,Sunny Soccer,0,3,5,8,2274
1306,2023-01-19,SPROUT,brawlBall,Pinhole Punt,1,55,56,112,72498
1307,2023-01-19,SPROUT,bounty,Shooting Star,0,99,132,231,11124
1308,2023-01-18,SPROUT,knockout,Goldarm Gulch,0,17,22,39,2784
1309,2023-01-18,SPROUT,hotZone,Parallel Plays,0,3,2,5,1158
1310,2023-01-18,SPROUT,heist,Kaboom Canyon,0,2,3,5,2592
1311,2023-01-18,SPROUT,gemGrab,Gem Fort,0,2,0,2,3006
1312,2023-01-18,SPROUT,gemGrab,Crystal Arcade,0,1,1,2,990
1313,2023-01-18,SPROUT,brawlBall,Sunny Soccer,1,17,25,43,18941
1314,2023-01-18,SPROUT,brawlBall,Beach Ball,0,4,3,7,774
1315,2023-01-18,SPROUT,bounty,Shooting Star,0,60,70,130,5088
1316,2023-01-17,SPROUT,knockout,Goldarm Gulch,0,17,18,35,2520
1317,2023-01-17,SPROUT,gemGrab,Minecart Madness,0,0,1,1,216
1318,2023-01-17,SPROUT,gemGrab,Crystal Arcade,0,2,1,3,1266
1319,2023-01-17,SPROUT,brawlBall,Beach Ball,0,11,5,16,5886
1320,2023-01-17,SPROUT,bounty,Hideout,0,3,8,11,750
1321,2023-01-16,SPROUT,knockout,Belle's Rock,0,49,55,104,1788
1322,2023-01-16,SPROUT,hotZone,Quarter Pounder,0,1,0,1,1494
1323,2023-01-16,SPROUT,gemGrab,Minecart Madness,0,8,6,14,1422
1324,2023-01-16,SPROUT,brawlBall,Center Stage,0,10,13,23,5778
1325,2023-01-16,SPROUT,brawlBall,Backyard Bowl,0,2,4,6,852
1326,2023-01-16,SPROUT,bounty,Hideout,0,8,11,19,1470
1327,2023-01-15,SPROUT,knockout,Belle's Rock,0,38,60,98,2904
1328,2023-01-15,SPROUT,hotZone,Quarter Pounder,0,18,51,69,3318
1329,2023-01-15,SPROUT,heist,Bridge Too Far,0,4,1,5,2736
1330,2023-01-15,SPROUT,gemGrab,Hard Rock Mine,0,2,0,2,1014
1331,2023-01-15,SPROUT,gemGrab,Double Swoosh,0,1,1,2,2178
1332,2023-01-15,SPROUT,brawlBall,Backyard Bowl,4,24,27,55,8946
1333,2023-01-15,SPROUT,bounty,Canal Grande,0,0,2,2,960
1334,2023-01-14,SPROUT,knockout,Flaring Phoenix,0,12,10,22,1080
1335,2023-01-14,SPROUT,hotZone,Controller Chaos,0,2,0,2,2772
1336,2023-01-14,SPROUT,heist,Bridge Too Far,0,1,0,1,4020
1337,2023-01-14,SPROUT,gemGrab,Hard Rock Mine,0,1,0,1,1272
1338,2023-01-14,SPROUT,gemGrab,Deep Diner,0,3,10,13,858
1339,2023-01-14,SPROUT,brawlBall,Super Beach,0,6,6,12,6336
1340,2023-01-14,SPROUT,bounty,Canal Grande,0,4,0,4,1014
1341,2023-01-13,SPROUT,knockout,Flaring Phoenix,0,13,8,21,1182
1342,2023-01-13,SPROUT,hotZone,Controller Chaos,0,7,23,30,2928
1343,2023-01-13,SPROUT,gemGrab,Deep Diner,0,4,28,32,1650
1344,2023-01-13,SPROUT,brawlBall,Sneaky Fields,0,6,4,10,6144
1345,2023-01-12,SPROUT,knockout,Riverside,0,16,28,44,2532
1346,2023-01-12,SPROUT,gemGrab,Undermine,0,1,0,1,690
1347,2023-01-12,SPROUT,brawlBall,Pinhole Punt,0,4,8,12,2292
1348,2023-01-11,SPROUT,gemGrab,Gem Fort,0,0,1,1,414
1349,2023-01-11,SPROUT,brawlBall,Sunny Soccer,0,1,0,1,1638
1350,2023-01-11,SPROUT,bounty,Excel,0,1,0,1,282
1351,2023-01-10,SPROUT,knockout,New Perspective,0,5,5,10,720
1352,2023-01-10,SPROUT,hotZone,Dueling Beetles,0,34,61,95,2424
1353,2023-01-10,SPROUT,heist,Safe Zone,0,1,0,1,1176
1354,2023-01-10,SPROUT,gemGrab,Minecart Madness,0,0,1,1,828
1355,2023-01-10,SPROUT,brawlBall,Beach Ball,0,11,13,24,4392
1356,2023-01-10,SPROUT,bounty,Excel,0,1,1,2,330
1357,2023-01-09,SPROUT,knockout,New Perspective,0,0,1,1,876
1358,2023-01-09,SPROUT,hotZone,Dueling Beetles,0,18,16,34,1554
1359,2023-01-09,SPROUT,gemGrab,Minecart Madness,0,3,3,6,1884
1360,2023-01-09,SPROUT,brawlBall,Center Stage,0,1,0,1,5460
1361,2023-01-09,SPROUT,brawlBall,Backyard Bowl,0,2,0,2,474
1362,2023-01-09,SPROUT,bounty,Layer Cake,0,20,16,36,1512
1363,2023-01-08,SPROUT,knockout,X Marks the Spot,0,5,1,6,1692
1364,2023-01-08,SPROUT,hotZone,Ring of Fire,0,2,14,16,1644
1365,2023-01-08,SPROUT,heist,Snaked Assault,0,1,0,1,1494
1366,2023-01-08,SPROUT,gemGrab,Double Swoosh,0,1,0,1,864
1367,2023-01-08,SPROUT,brawlBall,Super Beach,0,0,3,3,732
1368,2023-01-08,SPROUT,brawlBall,Backyard Bowl,0,2,4,6,4830
1369,2023-01-08,SPROUT,bounty,Layer Cake,0,4,3,7,528
1370,2023-01-07,SPROUT,knockout,X Marks the Spot,0,8,6,14,1014
1371,2023-01-07,SPROUT,gemGrab,Hard Rock Mine,0,1,1,2,1158
1372,2023-01-07,SPROUT,brawlBall,Super Beach,0,2,1,3,2622
1373,2023-01-07,SPROUT,bounty,Dry Season,0,11,10,21,1320
1374,2023-01-06,SPROUT,knockout,Out in the Open,0,3,5,8,1446
1375,2023-01-06,SPROUT,hotZone,Split,0,4,0,4,1158
1376,2023-01-06,SPROUT,brawlBall,Sneaky Fields,0,4,1,5,4896
1377,2023-01-06,SPROUT,brawlBall,Pinhole Punt,0,1,2,3,510
1378,2023-01-06,SPROUT,bounty,Dry Season,0,18,13,31,1944
1379,2023-01-05,SPROUT,knockout,Out in the Open,0,3,3,6,2958
1380,2023-01-05,SPROUT,hotZone,Split,0,17,8,25,3552
1381,2023-01-05,SPROUT,gemGrab,Undermine,0,0,2,2,1812
1382,2023-01-05,SPROUT,gemGrab,Gem Fort,0,1,0,1,252
1383,2023-01-05,SPROUT,brawlBall,Pinhole Punt,1,0,0,1,8118
1384,2023-01-05,SPROUT,bounty,Shooting Star,0,8,2,10,1362
1385,2023-01-04,SPROUT,knockout,Goldarm Gulch,0,5,4,9,696
1386,2023-01-04,SPROUT,gemGrab,Gem Fort,0,1,0,1,1788
1387,2023-01-04,SPROUT,brawlBall,Sunny Soccer,0,5,11,16,6312
1388,2023-01-04,SPROUT,bounty,Shooting Star,0,27,53,80,3570
1389,2023-01-03,SPROUT,knockout,Goldarm Gulch,0,1,2,3,720
1390,2023-01-03,SPROUT,hotZone,Parallel Plays,0,2,0,2,1542
1391,2023-01-03,SPROUT,gemGrab,Crystal Arcade,0,1,0,1,2406
1392,2023-01-03,SPROUT,brawlBall,Beach Ball,1,1,0,2,5580
1393,2023-01-03,SPROUT,bounty,Hideout,0,5,17,22,1638
1394,2023-01-02,SPROUT,knockout,Belle's Rock,0,25,24,49,1794
1395,2023-01-02,SPROUT,hotZone,Quarter Pounder,0,10,18,28,2652
1396,2023-01-02,SPROUT,gemGrab,Minecart Madness,0,3,3,6,2352
1397,2023-01-02,SPROUT,brawlBall,Center Stage,0,3,0,3,7110
1398,2023-01-02,SPROUT,bounty,Hideout,0,14,5,19,3090
1399,2023-01-01,SPROUT,knockout,Belle's Rock,0,22,11,33,858
1400,2023-01-01,SPROUT,hotZone,Quarter Pounder,0,3,9,12,1188
1401,2023-01-01,SPROUT,hotZone,Controller Chaos,0,1,0,1,12
1402,2023-01-01,SPROUT,heist,Kaboom Canyon,0,1,0,1,12
1403,2023-01-01,SPROUT,brawlBall,Backyard Bowl,1,7,19,27,2658
1404,2022-12-31,SPROUT,hotZone,Controller Chaos,0,1,0,1,198
1405,2022-12-31,SPROUT,gemGrab,Deep Diner,0,0,1,1,306
1406,2022-12-31,SPROUT,brawlBall,Super Beach,0,0,2,2,618
1407,2022-12-29,SPROUT,hotZone,Controller Chaos,0,0,1,1,12
1408,2022-12-29,SPROUT,brawlBall,Pinhole Punt,0,0,1,1,282
1409,2022-12-28,SPROUT,brawlBall,Sunny Soccer,0,1,0,1,42
1410,2022-12-27,SPROUT,hotZone,Dueling Beetles,0,2,0,2,36
1411,2022-12-26,SPROUT,gemGrab,Minecart Madness,0,1,0,1,60
1412,2022-12-24,SPROUT,knockout,X Marks the Spot,0,2,1,3,12
1413,2022-12-24,SPROUT,bounty,Dry Season,0,1,0,1,12
1414,2022-12-23,SPROUT,knockout,Out in the Open,0,9,9,18,132
1415,2022-12-22,SPROUT,brawlBall,Pinhole Punt,0,0,10,10,132
1416,2022-12-13,SPROUT,knockout,New Perspective,0,1,0,1,84
1417,2022-11-01,SPROUT,knockout,New Perspective,0,0,1,1,54
1418,2022-10-28,SPROUT,brawlBall,Beach Ball,0,1,0,1,12
1419,2022-10-26,SPROUT,bounty,Shooting Star,0,0,1,1,36
1420,2022-10-15,SPROUT,gemGrab,Hard Rock Mine,0,1,0,1,90
1421,2022-10-10,SPROUT,knockout,Belle's Rock,0,4,5,9,48
1422,2023-01-28,SPIKE,knockout,Flaring Phoenix,0,78,41,119,12366
1423,2023-01-28,SPIKE,hotZone,Controller Chaos,0,120,165,285,10134
1424,2023-01-28,SPIKE,heist,Bridge Too Far,0,182,149,331,24240
1425,2023-01-28,SPIKE,gemGrab,Hard Rock Mine,0,120,100,220,16638
1426,2023-01-28,SPIKE,gemGrab,Deep Diner,0,64,51,115,5478
1427,2023-01-28,SPIKE,brawlBall,Super Beach,21,709,675,1405,74430
1428,2023-01-28,SPIKE,brawlBall,Sneaky Fields,1,41,38,80,3582
1429,2023-01-28,SPIKE,bounty,Canal Grande,0,70,48,118,10902
1430,2023-01-27,SPIKE,knockout,Flaring Phoenix,0,39,19,58,5928
1431,2023-01-27,SPIKE,hotZone,Controller Chaos,0,36,23,59,2676
1432,2023-01-27,SPIKE,heist,Hot Potato,0,30,24,54,3486
1433,2023-01-27,SPIKE,gemGrab,Undermine,0,16,11,27,942
1434,2023-01-27,SPIKE,gemGrab,Deep Diner,0,84,99,183,6846
1435,2023-01-27,SPIKE,brawlBall,Sneaky Fields,6,214,207,427,23514
1436,2023-01-27,SPIKE,brawlBall,Pinhole Punt,0,11,7,18,738
1437,2023-01-27,SPIKE,bounty,Temple Ruins,0,27,21,48,1890
1438,2023-01-26,SPIKE,knockout,Riverside,0,129,73,202,19008
1439,2023-01-26,SPIKE,hotZone,Open Zone,0,132,90,222,10182
1440,2023-01-26,SPIKE,heist,Hot Potato,0,88,80,168,14610
1441,2023-01-26,SPIKE,gemGrab,Undermine,0,96,151,247,10062
1442,2023-01-26,SPIKE,gemGrab,Gem Fort,0,36,35,71,4674
1443,2023-01-26,SPIKE,brawlBall,Sunny Soccer,0,40,40,80,3660
1444,2023-01-26,SPIKE,brawlBall,Pinhole Punt,31,794,809,1634,67338
1445,2023-01-26,SPIKE,bounty,Temple Ruins,0,59,47,106,5610
1446,2023-01-25,SPIKE,knockout,Riverside,0,56,36,92,9906
1447,2023-01-25,SPIKE,hotZone,Open Zone,0,58,65,123,5262
1448,2023-01-25,SPIKE,heist,Safe Zone,0,65,37,102,9156
1449,2023-01-25,SPIKE,gemGrab,Gem Fort,0,40,32,72,5556
1450,2023-01-25,SPIKE,gemGrab,Crystal Arcade,0,97,116,213,7866
1451,2023-01-25,SPIKE,brawlBall,Sunny Soccer,28,522,515,1065,40830
1452,2023-01-25,SPIKE,brawlBall,Beach Ball,3,90,94,187,6408
1453,2023-01-25,SPIKE,bounty,Excel,0,40,22,62,5790
1454,2023-01-24,SPIKE,knockout,New Perspective,0,104,107,211,10542
1455,2023-01-24,SPIKE,hotZone,Dueling Beetles,0,109,109,218,10662
1456,2023-01-24,SPIKE,heist,Safe Zone,0,97,69,166,15750
1457,2023-01-24,SPIKE,gemGrab,Minecart Madness,0,61,75,136,4002
1458,2023-01-24,SPIKE,gemGrab,Crystal Arcade,0,182,253,435,14460
1459,2023-01-24,SPIKE,brawlBall,Center Stage,5,86,95,186,7860
1460,2023-01-24,SPIKE,brawlBall,Beach Ball,38,711,753,1502,64614
1461,2023-01-24,SPIKE,bounty,Excel,0,69,35,104,10896
1462,2023-01-23,SPIKE,knockout,New Perspective,1,167,87,255,20676
1463,2023-01-23,SPIKE,hotZone,Dueling Beetles,0,192,155,347,17502
1464,2023-01-23,SPIKE,heist,Snaked Assault,2,135,75,212,15762
1465,2023-01-23,SPIKE,gemGrab,Minecart Madness,0,302,401,703,19062
1466,2023-01-23,SPIKE,gemGrab,Double Swoosh,0,107,92,199,7578
1467,2023-01-23,SPIKE,brawlBall,Center Stage,43,980,839,1862,92862
1468,2023-01-23,SPIKE,brawlBall,Backyard Bowl,2,47,63,112,4224
1469,2023-01-23,SPIKE,bounty,Layer Cake,0,56,32,88,11142
1470,2023-01-22,SPIKE,knockout,X Marks the Spot,0,86,57,143,9174
1471,2023-01-22,SPIKE,hotZone,Ring of Fire,0,48,43,91,5730
1472,2023-01-22,SPIKE,heist,Snaked Assault,0,82,52,134,8232
1473,2023-01-22,SPIKE,gemGrab,Hard Rock Mine,0,33,26,59,4722
1474,2023-01-22,SPIKE,gemGrab,Double Swoosh,0,111,136,247,9426
1475,2023-01-22,SPIKE,brawlBall,Super Beach,6,81,104,191,7386
1476,2023-01-22,SPIKE,brawlBall,Backyard Bowl,30,484,450,964,34788
1477,2023-01-22,SPIKE,bounty,Layer Cake,0,20,10,30,6654
1478,2023-01-21,SPIKE,knockout,X Marks the Spot,3,264,155,422,31698
1479,2023-01-21,SPIKE,hotZone,Ring of Fire,2,215,202,419,16632
1480,2023-01-21,SPIKE,heist,Tornado Ring,0,122,75,197,11664
1481,2023-01-21,SPIKE,gemGrab,Hard Rock Mine,0,168,154,322,22980
1482,2023-01-21,SPIKE,gemGrab,Deep Diner,0,45,26,71,4470
1483,2023-01-21,SPIKE,brawlBall,Super Beach,32,1076,1055,2163,101364
1484,2023-01-21,SPIKE,brawlBall,Sneaky Fields,2,35,23,60,3750
1485,2023-01-21,SPIKE,bounty,Dry Season,0,99,56,155,14538
1486,2023-01-20,SPIKE,knockout,Out in the Open,0,194,113,307,20106
1487,2023-01-20,SPIKE,hotZone,Split,0,55,50,105,9678
1488,2023-01-20,SPIKE,heist,Tornado Ring,1,106,92,199,12672
1489,2023-01-20,SPIKE,gemGrab,Undermine,0,66,69,135,5442
1490,2023-01-20,SPIKE,gemGrab,Deep Diner,0,221,204,425,19050
1491,2023-01-20,SPIKE,brawlBall,Sneaky Fields,28,676,755,1459,74778
1492,2023-01-20,SPIKE,brawlBall,Pinhole Punt,1,45,56,102,2886
1493,2023-01-20,SPIKE,bounty,Dry Season,0,83,49,132,11640
1494,2023-01-19,SPIKE,knockout,Out in the Open,0,221,138,359,26574
1495,2023-01-19,SPIKE,hotZone,Split,0,63,24,87,14856
1496,2023-01-19,SPIKE,heist,Kaboom Canyon,0,90,71,161,6732
1497,2023-01-19,SPIKE,gemGrab,Undermine,0,187,190,377,14154
1498,2023-01-19,SPIKE,gemGrab,Gem Fort,0,33,20,53,2934
1499,2023-01-19,SPIKE,brawlBall,Sunny Soccer,2,30,42,74,2274
1500,2023-01-19,SPIKE,brawlBall,Pinhole Punt,32,876,907,1815,72498
1501,2023-01-19,SPIKE,bounty,Shooting Star,0,59,36,95,11124
1502,2023-01-18,SPIKE,knockout,Goldarm Gulch,0,24,17,41,2784
1503,2023-01-18,SPIKE,hotZone,Parallel Plays,0,16,22,38,1158
1504,2023-01-18,SPIKE,heist,Kaboom Canyon,0,20,19,39,2592
1505,2023-01-18,SPIKE,gemGrab,Gem Fort,0,22,17,39,3006
1506,2023-01-18,SPIKE,gemGrab,Crystal Arcade,0,11,21,32,990
1507,2023-01-18,SPIKE,brawlBall,Sunny Soccer,9,230,258,497,18941
1508,2023-01-18,SPIKE,brawlBall,Beach Ball,0,12,4,16,774
1509,2023-01-18,SPIKE,bounty,Shooting Star,0,26,19,45,5088
1510,2023-01-17,SPIKE,knockout,Goldarm Gulch,0,19,15,34,2520
1511,2023-01-17,SPIKE,hotZone,Parallel Plays,0,13,13,26,1038
1512,2023-01-17,SPIKE,heist,Pit Stop,0,11,7,18,1290
1513,2023-01-17,SPIKE,gemGrab,Minecart Madness,0,7,3,10,216
1514,2023-01-17,SPIKE,gemGrab,Crystal Arcade,0,25,47,72,1266
1515,2023-01-17,SPIKE,brawlBall,Center Stage,0,2,3,5,288
1516,2023-01-17,SPIKE,brawlBall,Beach Ball,5,83,83,171,5886
1517,2023-01-17,SPIKE,bounty,Hideout,0,7,2,9,750
1518,2023-01-16,SPIKE,knockout,Belle's Rock,0,13,7,20,1788
1519,2023-01-16,SPIKE,hotZone,Quarter Pounder,0,19,12,31,1494
1520,2023-01-16,SPIKE,heist,Pit Stop,0,27,13,40,4044
1521,2023-01-16,SPIKE,gemGrab,Minecart Madness,0,15,20,35,1422
1522,2023-01-16,SPIKE,gemGrab,Double Swoosh,0,7,2,9,708
1523,2023-01-16,SPIKE,brawlBall,Center Stage,4,90,51,145,5778
1524,2023-01-16,SPIKE,brawlBall,Backyard Bowl,0,10,11,21,852
1525,2023-01-16,SPIKE,bounty,Hideout,0,10,2,12,1470
1526,2023-01-15,SPIKE,knockout,Belle's Rock,0,24,8,32,2904
1527,2023-01-15,SPIKE,hotZone,Quarter Pounder,0,37,21,58,3318
1528,2023-01-15,SPIKE,heist,Bridge Too Far,0,18,30,48,2736
1529,2023-01-15,SPIKE,gemGrab,Hard Rock Mine,0,5,1,6,1014
1530,2023-01-15,SPIKE,gemGrab,Double Swoosh,0,17,6,23,2178
1531,2023-01-15,SPIKE,brawlBall,Super Beach,1,22,22,45,1074
1532,2023-01-15,SPIKE,brawlBall,Backyard Bowl,6,110,94,210,8946
1533,2023-01-15,SPIKE,bounty,Canal Grande,0,3,5,8,960
1534,2023-01-14,SPIKE,knockout,Flaring Phoenix,0,3,0,3,1080
1535,2023-01-14,SPIKE,hotZone,Controller Chaos,0,27,11,38,2772
1536,2023-01-14,SPIKE,heist,Bridge Too Far,0,12,2,14,4020
1537,2023-01-14,SPIKE,gemGrab,Hard Rock Mine,0,6,1,7,1272
1538,2023-01-14,SPIKE,gemGrab,Deep Diner,0,7,23,30,858
1539,2023-01-14,SPIKE,brawlBall,Super Beach,1,51,76,128,6336
1540,2023-01-14,SPIKE,brawlBall,Sneaky Fields,1,5,22,28,918
1541,2023-01-14,SPIKE,bounty,Canal Grande,0,7,2,9,1014
1542,2023-01-13,SPIKE,knockout,Flaring Phoenix,0,13,2,15,1182
1543,2023-01-13,SPIKE,hotZone,Controller Chaos,0,64,59,123,2928
1544,2023-01-13,SPIKE,heist,Hot Potato,0,5,0,5,600
1545,2023-01-13,SPIKE,gemGrab,Deep Diner,0,15,21,36,1650
1546,2023-01-13,SPIKE,brawlBall,Sneaky Fields,4,60,75,139,6144
1547,2023-01-13,SPIKE,brawlBall,Pinhole Punt,0,1,2,3,156
1548,2023-01-13,SPIKE,bounty,Temple Ruins,0,5,2,7,270
1549,2023-01-12,SPIKE,knockout,Riverside,0,15,6,21,2532
1550,2023-01-12,SPIKE,hotZone,Open Zone,0,14,23,37,1488
1551,2023-01-12,SPIKE,gemGrab,Undermine,0,3,4,7,690
1552,2023-01-12,SPIKE,brawlBall,Sunny Soccer,0,5,2,7,240
1553,2023-01-12,SPIKE,brawlBall,Pinhole Punt,0,28,35,63,2292
1554,2023-01-11,SPIKE,knockout,Riverside,0,1,0,1,528
1555,2023-01-11,SPIKE,hotZone,Open Zone,0,5,2,7,462
1556,2023-01-11,SPIKE,brawlBall,Sunny Soccer,1,21,37,59,1638
1557,2023-01-11,SPIKE,brawlBall,Beach Ball,0,2,2,4,48
1558,2023-01-10,SPIKE,knockout,New Perspective,0,3,2,5,720
1559,2023-01-10,SPIKE,hotZone,Dueling Beetles,0,27,36,63,2424
1560,2023-01-10,SPIKE,heist,Safe Zone,0,9,0,9,1176
1561,2023-01-10,SPIKE,gemGrab,Minecart Madness,0,8,11,19,828
1562,2023-01-10,SPIKE,gemGrab,Crystal Arcade,0,9,7,16,1746
1563,2023-01-10,SPIKE,brawlBall,Center Stage,0,3,2,5,708
1564,2023-01-10,SPIKE,brawlBall,Beach Ball,1,54,54,109,4392
1565,2023-01-10,SPIKE,bounty,Excel,0,2,0,2,330
1566,2023-01-09,SPIKE,knockout,New Perspective,0,6,2,8,876
1567,2023-01-09,SPIKE,hotZone,Dueling Beetles,0,13,17,30,1554
1568,2023-01-09,SPIKE,heist,Snaked Assault,0,24,34,58,2022
1569,2023-01-09,SPIKE,gemGrab,Minecart Madness,1,23,50,74,1884
1570,2023-01-09,SPIKE,gemGrab,Double Swoosh,0,9,5,14,1320
1571,2023-01-09,SPIKE,brawlBall,Center Stage,1,26,16,43,5460
1572,2023-01-09,SPIKE,brawlBall,Backyard Bowl,1,10,29,40,474
1573,2023-01-09,SPIKE,bounty,Layer Cake,0,6,0,6,1512
1574,2023-01-08,SPIKE,knockout,X Marks the Spot,0,11,35,46,1692
1575,2023-01-08,SPIKE,hotZone,Ring of Fire,0,19,26,45,1644
1576,2023-01-08,SPIKE,heist,Snaked Assault,0,11,8,19,1494
1577,2023-01-08,SPIKE,gemGrab,Hard Rock Mine,0,5,5,10,630
1578,2023-01-08,SPIKE,gemGrab,Double Swoosh,0,6,28,34,864
1579,2023-01-08,SPIKE,brawlBall,Super Beach,0,7,23,30,732
1580,2023-01-08,SPIKE,brawlBall,Backyard Bowl,4,50,49,103,4830
1581,2023-01-08,SPIKE,bounty,Layer Cake,0,3,0,3,528
1582,2023-01-07,SPIKE,knockout,X Marks the Spot,0,10,5,15,1014
1583,2023-01-07,SPIKE,hotZone,Ring of Fire,0,7,8,15,846
1584,2023-01-07,SPIKE,heist,Tornado Ring,0,9,19,28,1350
1585,2023-01-07,SPIKE,gemGrab,Hard Rock Mine,0,10,5,15,1158
1586,2023-01-07,SPIKE,gemGrab,Deep Diner,0,4,4,8,918
1587,2023-01-07,SPIKE,brawlBall,Super Beach,1,25,21,47,2622
1588,2023-01-07,SPIKE,brawlBall,Sneaky Fields,0,2,1,3,402
1589,2023-01-07,SPIKE,bounty,Dry Season,0,10,0,10,1320
1590,2023-01-06,SPIKE,knockout,Out in the Open,0,9,2,11,1446
1591,2023-01-06,SPIKE,hotZone,Split,0,3,0,3,1158
1592,2023-01-06,SPIKE,heist,Tornado Ring,1,24,19,44,2538
1593,2023-01-06,SPIKE,gemGrab,Undermine,0,5,2,7,540
1594,2023-01-06,SPIKE,gemGrab,Deep Diner,0,21,3,24,2226
1595,2023-01-06,SPIKE,brawlBall,Sneaky Fields,1,54,68,123,4896
1596,2023-01-06,SPIKE,brawlBall,Pinhole Punt,0,7,4,11,510
1597,2023-01-06,SPIKE,bounty,Dry Season,0,3,5,8,1944
1598,2023-01-05,SPIKE,knockout,Out in the Open,0,12,4,16,2958
1599,2023-01-05,SPIKE,hotZone,Split,0,28,37,65,3552
1600,2023-01-05,SPIKE,heist,Kaboom Canyon,0,11,3,14,954
1601,2023-01-05,SPIKE,gemGrab,Undermine,0,12,18,30,1812
1602,2023-01-05,SPIKE,gemGrab,Gem Fort,0,2,0,2,252
1603,2023-01-05,SPIKE,brawlBall,Pinhole Punt,2,115,131,248,8118
1604,2023-01-05,SPIKE,bounty,Shooting Star,0,5,0,5,1362
1605,2023-01-04,SPIKE,knockout,Goldarm Gulch,0,2,13,15,696
1606,2023-01-04,SPIKE,hotZone,Parallel Plays,0,3,2,5,864
1607,2023-01-04,SPIKE,heist,Kaboom Canyon,0,17,33,50,1848
1608,2023-01-04,SPIKE,gemGrab,Gem Fort,0,5,17,22,1788
1609,2023-01-04,SPIKE,gemGrab,Crystal Arcade,0,8,11,19,642
1610,2023-01-04,SPIKE,brawlBall,Sunny Soccer,4,87,85,176,6312
1611,2023-01-04,SPIKE,bounty,Shooting Star,0,11,5,16,3570
1612,2023-01-03,SPIKE,knockout,Goldarm Gulch,0,7,3,10,720
1613,2023-01-03,SPIKE,hotZone,Parallel Plays,0,19,9,28,1542
1614,2023-01-03,SPIKE,heist,Pit Stop,0,7,12,19,1956
1615,2023-01-03,SPIKE,gemGrab,Minecart Madness,0,4,1,5,456
1616,2023-01-03,SPIKE,gemGrab,Crystal Arcade,0,26,15,41,2406
1617,2023-01-03,SPIKE,brawlBall,Center Stage,0,2,0,2,294
1618,2023-01-03,SPIKE,brawlBall,Beach Ball,1,54,48,103,5580
1619,2023-01-03,SPIKE,bounty,Hideout,0,10,2,12,1638
1620,2023-01-02,SPIKE,knockout,Belle's Rock,0,5,8,13,1794
1621,2023-01-02,SPIKE,hotZone,Quarter Pounder,0,30,44,74,2652
1622,2023-01-02,SPIKE,heist,Pit Stop,0,16,17,33,3498
1623,2023-01-02,SPIKE,gemGrab,Minecart Madness,0,44,32,76,2352
1624,2023-01-02,SPIKE,gemGrab,Double Swoosh,0,15,31,46,1512
1625,2023-01-02,SPIKE,brawlBall,Center Stage,0,57,51,108,7110
1626,2023-01-02,SPIKE,brawlBall,Backyard Bowl,0,6,1,7,492
1627,2023-01-02,SPIKE,bounty,Hideout,0,23,30,53,3090
1628,2023-01-01,SPIKE,knockout,Belle's Rock,0,5,2,7,858
1629,2023-01-01,SPIKE,hotZone,Quarter Pounder,0,14,3,17,1188
1630,2023-01-01,SPIKE,hotZone,Controller Chaos,0,0,1,1,12
1631,2023-01-01,SPIKE,heist,Bridge Too Far,0,1,2,3,462
1632,2023-01-01,SPIKE,gemGrab,Minecart Madness,0,1,0,1,12
1633,2023-01-01,SPIKE,gemGrab,Double Swoosh,0,8,7,15,1140
1634,2023-01-01,SPIKE,brawlBall,Backyard Bowl,0,38,12,50,2658
1635,2023-01-01,SPIKE,bounty,Canal Grande,0,1,0,1,132
1636,2022-12-31,SPIKE,hotZone,Controller Chaos,0,1,0,1,198
1637,2022-12-31,SPIKE,heist,Kaboom Canyon,0,1,0,1,12
1638,2022-12-31,SPIKE,heist,Bridge Too Far,0,2,0,2,276
1639,2022-12-31,SPIKE,gemGrab,Hard Rock Mine,0,1,0,1,384
1640,2022-12-31,SPIKE,gemGrab,Deep Diner,0,4,3,7,306
1641,2022-12-31,SPIKE,brawlBall,Super Beach,0,7,3,10,618
1642,2022-12-31,SPIKE,bounty,Canal Grande,0,1,0,1,54
1643,2022-12-30,SPIKE,knockout,Flaring Phoenix,0,1,0,1,72
1644,2022-12-30,SPIKE,hotZone,Controller Chaos,0,3,1,4,288
1645,2022-12-30,SPIKE,heist,Kaboom Canyon,0,1,0,1,18
1646,2022-12-30,SPIKE,gemGrab,Undermine,0,1,1,2,102
1647,2022-12-30,SPIKE,gemGrab,Deep Diner,0,2,0,2,438
1648,2022-12-30,SPIKE,brawlBall,Sneaky Fields,0,3,1,4,552
1649,2022-12-29,SPIKE,hotZone,Controller Chaos,0,1,1,2,12
1650,2022-12-29,SPIKE,heist,Hot Potato,0,1,0,1,72
1651,2022-12-29,SPIKE,gemGrab,Undermine,0,1,1,2,102
1652,2022-12-29,SPIKE,gemGrab,Minecart Madness,0,2,0,2,24
1653,2022-12-29,SPIKE,brawlBall,Pinhole Punt,0,6,2,8,282
1654,2022-12-28,SPIKE,brawlBall,Sunny Soccer,0,1,0,1,42
1655,2022-12-27,SPIKE,knockout,New Perspective,0,0,1,1,30
1656,2022-12-27,SPIKE,hotZone,Dueling Beetles,0,0,1,1,36
1657,2022-12-27,SPIKE,hotZone,Controller Chaos,0,1,1,2,24
1658,2022-12-27,SPIKE,gemGrab,Minecart Madness,0,0,1,1,30
1659,2022-12-27,SPIKE,brawlBall,Beach Ball,0,1,0,1,144
1660,2022-12-26,SPIKE,hotZone,Controller Chaos,0,0,1,1,30
1661,2022-12-26,SPIKE,heist,Kaboom Canyon,0,2,0,2,36
1662,2022-12-26,SPIKE,gemGrab,Minecart Madness,0,2,1,3,60
1663,2022-12-26,SPIKE,brawlBall,Center Stage,0,1,1,2,78
1664,2022-12-25,SPIKE,hotZone,Ring of Fire,0,0,1,1,12
1665,2022-12-25,SPIKE,gemGrab,Double Swoosh,0,2,0,2,30
1666,2022-12-25,SPIKE,brawlBall,Backyard Bowl,0,1,0,1,78
1667,2022-12-24,SPIKE,knockout,X Marks the Spot,0,1,0,1,12
1668,2022-12-23,SPIKE,knockout,Out in the Open,0,3,2,5,132
1669,2022-12-21,SPIKE,brawlBall,Sunny Soccer,0,0,1,1,54
1670,2022-12-20,SPIKE,brawlBall,Beach Ball,1,0,0,1,96
1671,2022-12-19,SPIKE,brawlBall,Center Stage,0,2,1,3,102
1672,2022-12-16,SPIKE,brawlBall,Sneaky Fields,0,1,0,1,84
1673,2022-12-13,SPIKE,knockout,New Perspective,0,1,0,1,84
1674,2022-12-13,SPIKE,gemGrab,Crystal Arcade,0,1,0,1,72
1675,2022-12-11,SPIKE,brawlBall,Backyard Bowl,0,1,1,2,24
1676,2022-12-10,SPIKE,gemGrab,Hard Rock Mine,0,0,1,1,24
1677,2022-11-07,SPIKE,hotZone,Quarter Pounder,0,0,1,1,24
1678,2022-10-30,SPIKE,hotZone,Dueling Beetles,0,1,0,1,12
1679,2022-10-30,SPIKE,bounty,Canal Grande,0,1,0,1,12
1680,2022-10-28,SPIKE,knockout,Out in the Open,0,0,1,1,18
1681,2022-10-28,SPIKE,brawlBall,Beach Ball,0,0,1,1,12
1682,2023-01-28,SHELLY,knockout,Flaring Phoenix,1,81,126,208,12366
1683,2023-01-28,SHELLY,hotZone,Controller Chaos,0,37,9,46,10134
1684,2023-01-28,SHELLY,heist,Bridge Too Far,0,16,4,20,24240
1685,2023-01-28,SHELLY,gemGrab,Hard Rock Mine,0,48,39,87,16638
1686,2023-01-28,SHELLY,gemGrab,Deep Diner,0,8,2,10,5478
1687,2023-01-28,SHELLY,brawlBall,Super Beach,15,523,429,967,74430
1688,2023-01-28,SHELLY,brawlBall,Sneaky Fields,0,49,39,88,3582
1689,2023-01-28,SHELLY,bounty,Canal Grande,0,32,5,37,10902
1690,2023-01-27,SHELLY,knockout,Flaring Phoenix,1,31,53,85,5928
1691,2023-01-27,SHELLY,hotZone,Controller Chaos,0,9,0,9,2676
1692,2023-01-27,SHELLY,heist,Hot Potato,0,6,5,11,3486
1693,2023-01-27,SHELLY,gemGrab,Undermine,0,3,2,5,942
1694,2023-01-27,SHELLY,gemGrab,Deep Diner,0,10,4,14,6846
1695,2023-01-27,SHELLY,brawlBall,Sneaky Fields,5,329,259,593,23514
1696,2023-01-27,SHELLY,brawlBall,Pinhole Punt,0,3,4,7,738
1697,2023-01-27,SHELLY,bounty,Temple Ruins,0,4,2,6,1890
1698,2023-01-26,SHELLY,knockout,Riverside,0,10,7,17,19008
1699,2023-01-26,SHELLY,hotZone,Open Zone,0,19,2,21,10182
1700,2023-01-26,SHELLY,heist,Hot Potato,0,18,14,32,14610
1701,2023-01-26,SHELLY,gemGrab,Undermine,0,31,13,44,10062
1702,2023-01-26,SHELLY,gemGrab,Gem Fort,0,48,34,82,4674
1703,2023-01-26,SHELLY,brawlBall,Sunny Soccer,1,22,45,68,3660
1704,2023-01-26,SHELLY,brawlBall,Pinhole Punt,12,424,325,761,67338
1705,2023-01-26,SHELLY,bounty,Temple Ruins,0,22,27,49,5610
1706,2023-01-25,SHELLY,knockout,Riverside,0,14,8,22,9906
1707,2023-01-25,SHELLY,hotZone,Open Zone,0,6,0,6,5262
1708,2023-01-25,SHELLY,heist,Safe Zone,0,7,2,9,9156
1709,2023-01-25,SHELLY,gemGrab,Gem Fort,0,37,32,69,5556
1710,2023-01-25,SHELLY,gemGrab,Crystal Arcade,0,29,6,35,7866
1711,2023-01-25,SHELLY,brawlBall,Sunny Soccer,11,299,235,545,40830
1712,2023-01-25,SHELLY,brawlBall,Beach Ball,3,31,51,85,6408
1713,2023-01-25,SHELLY,bounty,Excel,0,3,1,4,5790
1714,2023-01-24,SHELLY,knockout,New Perspective,0,27,31,58,10542
1715,2023-01-24,SHELLY,hotZone,Dueling Beetles,0,10,3,13,10662
1716,2023-01-24,SHELLY,heist,Safe Zone,0,8,1,9,15750
1717,2023-01-24,SHELLY,gemGrab,Minecart Madness,0,2,1,3,4002
1718,2023-01-24,SHELLY,gemGrab,Crystal Arcade,0,28,24,52,14460
1719,2023-01-24,SHELLY,brawlBall,Center Stage,3,87,94,184,7860
1720,2023-01-24,SHELLY,brawlBall,Beach Ball,10,419,372,801,64614
1721,2023-01-24,SHELLY,bounty,Excel,0,17,15,32,10896
1722,2023-01-23,SHELLY,knockout,New Perspective,0,151,159,310,20676
1723,2023-01-23,SHELLY,hotZone,Dueling Beetles,0,22,10,32,17502
1724,2023-01-23,SHELLY,heist,Snaked Assault,0,27,5,32,15762
1725,2023-01-23,SHELLY,gemGrab,Minecart Madness,0,31,15,46,19062
1726,2023-01-23,SHELLY,gemGrab,Double Swoosh,0,38,23,61,7578
1727,2023-01-23,SHELLY,brawlBall,Center Stage,36,1213,1152,2401,92862
1728,2023-01-23,SHELLY,brawlBall,Backyard Bowl,1,21,8,30,4224
1729,2023-01-23,SHELLY,bounty,Layer Cake,0,19,2,21,11142
1730,2023-01-22,SHELLY,knockout,X Marks the Spot,0,76,93,169,9174
1731,2023-01-22,SHELLY,hotZone,Ring of Fire,0,9,3,12,5730
1732,2023-01-22,SHELLY,heist,Snaked Assault,0,9,4,13,8232
1733,2023-01-22,SHELLY,gemGrab,Hard Rock Mine,0,16,14,30,4722
1734,2023-01-22,SHELLY,gemGrab,Double Swoosh,0,53,45,98,9426
1735,2023-01-22,SHELLY,brawlBall,Super Beach,0,38,25,63,7386
1736,2023-01-22,SHELLY,brawlBall,Backyard Bowl,4,100,70,174,34788
1737,2023-01-22,SHELLY,bounty,Layer Cake,0,7,1,8,6654
1738,2023-01-21,SHELLY,knockout,X Marks the Spot,0,190,259,449,31698
1739,2023-01-21,SHELLY,hotZone,Ring of Fire,0,16,6,22,16632
1740,2023-01-21,SHELLY,heist,Tornado Ring,0,19,5,24,11664
1741,2023-01-21,SHELLY,gemGrab,Hard Rock Mine,0,56,23,79,22980
1742,2023-01-21,SHELLY,gemGrab,Deep Diner,0,7,3,10,4470
1743,2023-01-21,SHELLY,brawlBall,Super Beach,15,667,524,1206,101364
1744,2023-01-21,SHELLY,brawlBall,Sneaky Fields,1,39,42,82,3750
1745,2023-01-21,SHELLY,bounty,Dry Season,0,15,4,19,14538
1746,2023-01-20,SHELLY,knockout,Out in the Open,0,65,72,137,20106
1747,2023-01-20,SHELLY,hotZone,Split,0,33,40,73,9678
1748,2023-01-20,SHELLY,heist,Tornado Ring,0,18,9,27,12672
1749,2023-01-20,SHELLY,gemGrab,Undermine,0,19,11,30,5442
1750,2023-01-20,SHELLY,gemGrab,Deep Diner,0,34,9,43,19050
1751,2023-01-20,SHELLY,brawlBall,Sneaky Fields,29,1079,1074,2182,74778
1752,2023-01-20,SHELLY,brawlBall,Pinhole Punt,2,15,10,27,2886
1753,2023-01-20,SHELLY,bounty,Dry Season,0,8,5,13,11640
1754,2023-01-19,SHELLY,knockout,Out in the Open,2,114,140,256,26574
1755,2023-01-19,SHELLY,hotZone,Split,0,37,9,46,14856
1756,2023-01-19,SHELLY,heist,Kaboom Canyon,0,8,7,15,6732
1757,2023-01-19,SHELLY,gemGrab,Undermine,0,51,47,98,14154
1758,2023-01-19,SHELLY,gemGrab,Gem Fort,0,26,16,42,2934
1759,2023-01-19,SHELLY,brawlBall,Sunny Soccer,0,16,14,30,2274
1760,2023-01-19,SHELLY,brawlBall,Pinhole Punt,5,439,310,754,72498
1761,2023-01-19,SHELLY,bounty,Shooting Star,0,15,4,19,11124
1762,2023-01-18,SHELLY,knockout,Goldarm Gulch,0,28,34,62,2784
1763,2023-01-18,SHELLY,hotZone,Parallel Plays,0,2,1,3,1158
1764,2023-01-18,SHELLY,heist,Kaboom Canyon,0,1,1,2,2592
1765,2023-01-18,SHELLY,gemGrab,Gem Fort,0,18,15,33,3006
1766,2023-01-18,SHELLY,gemGrab,Crystal Arcade,0,1,1,2,990
1767,2023-01-18,SHELLY,brawlBall,Sunny Soccer,2,117,103,222,18941
1768,2023-01-18,SHELLY,brawlBall,Beach Ball,0,3,6,9,774
1769,2023-01-18,SHELLY,bounty,Shooting Star,0,1,1,2,5088
1770,2023-01-17,SHELLY,knockout,Goldarm Gulch,0,21,24,45,2520
1771,2023-01-17,SHELLY,hotZone,Parallel Plays,0,1,1,2,1038
1772,2023-01-17,SHELLY,heist,Pit Stop,0,3,4,7,1290
1773,2023-01-17,SHELLY,gemGrab,Crystal Arcade,0,5,2,7,1266
1774,2023-01-17,SHELLY,brawlBall,Center Stage,0,6,5,11,288
1775,2023-01-17,SHELLY,brawlBall,Beach Ball,0,34,26,60,5886
1776,2023-01-16,SHELLY,knockout,Belle's Rock,0,5,0,5,1788
1777,2023-01-16,SHELLY,hotZone,Quarter Pounder,0,6,0,6,1494
1778,2023-01-16,SHELLY,heist,Pit Stop,0,8,8,16,4044
1779,2023-01-16,SHELLY,gemGrab,Minecart Madness,0,1,0,1,1422
1780,2023-01-16,SHELLY,gemGrab,Double Swoosh,0,4,2,6,708
1781,2023-01-16,SHELLY,brawlBall,Center Stage,2,85,63,150,5778
1782,2023-01-16,SHELLY,brawlBall,Backyard Bowl,0,3,1,4,852
1783,2023-01-16,SHELLY,bounty,Hideout,0,1,0,1,1470
1784,2023-01-15,SHELLY,knockout,Belle's Rock,0,9,20,29,2904
1785,2023-01-15,SHELLY,hotZone,Quarter Pounder,0,6,0,6,3318
1786,2023-01-15,SHELLY,heist,Bridge Too Far,0,2,0,2,2736
1787,2023-01-15,SHELLY,gemGrab,Hard Rock Mine,0,5,0,5,1014
1788,2023-01-15,SHELLY,gemGrab,Double Swoosh,0,7,3,10,2178
1789,2023-01-15,SHELLY,brawlBall,Super Beach,0,8,2,10,1074
1790,2023-01-15,SHELLY,brawlBall,Backyard Bowl,0,32,12,44,8946
1791,2023-01-15,SHELLY,bounty,Canal Grande,0,7,1,8,960
1792,2023-01-14,SHELLY,knockout,Flaring Phoenix,0,11,8,19,1080
1793,2023-01-14,SHELLY,hotZone,Controller Chaos,0,10,1,11,2772
1794,2023-01-14,SHELLY,heist,Bridge Too Far,0,3,0,3,4020
1795,2023-01-14,SHELLY,gemGrab,Hard Rock Mine,0,3,1,4,1272
1796,2023-01-14,SHELLY,gemGrab,Deep Diner,0,2,1,3,858
1797,2023-01-14,SHELLY,brawlBall,Super Beach,1,42,34,77,6336
1798,2023-01-14,SHELLY,brawlBall,Sneaky Fields,0,3,16,19,918
1799,2023-01-14,SHELLY,bounty,Canal Grande,0,3,8,11,1014
1800,2023-01-13,SHELLY,knockout,Flaring Phoenix,0,6,6,12,1182
1801,2023-01-13,SHELLY,hotZone,Controller Chaos,0,5,3,8,2928
1802,2023-01-13,SHELLY,gemGrab,Deep Diner,0,5,3,8,1650
1803,2023-01-13,SHELLY,brawlBall,Sneaky Fields,1,63,91,155,6144
1804,2023-01-13,SHELLY,bounty,Temple Ruins,0,3,0,3,270
1805,2023-01-12,SHELLY,knockout,Riverside,0,4,0,4,2532
1806,2023-01-12,SHELLY,hotZone,Open Zone,0,1,1,2,1488
1807,2023-01-12,SHELLY,gemGrab,Undermine,0,2,0,2,690
1808,2023-01-12,SHELLY,gemGrab,Gem Fort,0,2,1,3,162
1809,2023-01-12,SHELLY,brawlBall,Sunny Soccer,0,2,0,2,240
1810,2023-01-12,SHELLY,brawlBall,Pinhole Punt,0,7,1,8,2292
1811,2023-01-12,SHELLY,bounty,Temple Ruins,0,0,1,1,24
1812,2023-01-11,SHELLY,knockout,Riverside,0,1,0,1,528
1813,2023-01-11,SHELLY,gemGrab,Gem Fort,0,3,1,4,414
1814,2023-01-11,SHELLY,brawlBall,Sunny Soccer,0,11,11,22,1638
1815,2023-01-11,SHELLY,brawlBall,Beach Ball,0,1,1,2,48
1816,2023-01-10,SHELLY,knockout,New Perspective,0,5,15,20,720
1817,2023-01-10,SHELLY,hotZone,Dueling Beetles,0,2,0,2,2424
1818,2023-01-10,SHELLY,heist,Safe Zone,0,1,0,1,1176
1819,2023-01-10,SHELLY,gemGrab,Minecart Madness,0,3,0,3,828
1820,2023-01-10,SHELLY,gemGrab,Crystal Arcade,0,3,0,3,1746
1821,2023-01-10,SHELLY,brawlBall,Center Stage,1,5,3,9,708
1822,2023-01-10,SHELLY,brawlBall,Beach Ball,0,23,8,31,4392
1823,2023-01-10,SHELLY,bounty,Excel,0,2,0,2,330
1824,2023-01-09,SHELLY,knockout,New Perspective,0,6,23,29,876
1825,2023-01-09,SHELLY,hotZone,Dueling Beetles,0,1,4,5,1554
1826,2023-01-09,SHELLY,heist,Snaked Assault,0,4,1,5,2022
1827,2023-01-09,SHELLY,gemGrab,Minecart Madness,0,2,0,2,1884
1828,2023-01-09,SHELLY,gemGrab,Double Swoosh,0,8,0,8,1320
1829,2023-01-09,SHELLY,brawlBall,Center Stage,1,80,68,149,5460
1830,2023-01-09,SHELLY,brawlBall,Backyard Bowl,0,2,0,2,474
1831,2023-01-09,SHELLY,bounty,Layer Cake,0,5,0,5,1512
1832,2023-01-08,SHELLY,knockout,X Marks the Spot,0,3,3,6,1692
1833,2023-01-08,SHELLY,hotZone,Ring of Fire,0,1,0,1,1644
1834,2023-01-08,SHELLY,heist,Snaked Assault,0,5,0,5,1494
1835,2023-01-08,SHELLY,gemGrab,Hard Rock Mine,0,4,2,6,630
1836,2023-01-08,SHELLY,gemGrab,Double Swoosh,0,7,3,10,864
1837,2023-01-08,SHELLY,brawlBall,Super Beach,0,2,1,3,732
1838,2023-01-08,SHELLY,brawlBall,Backyard Bowl,0,21,4,25,4830
1839,2023-01-08,SHELLY,bounty,Layer Cake,0,1,0,1,528
1840,2023-01-07,SHELLY,hotZone,Ring of Fire,0,1,0,1,846
1841,2023-01-07,SHELLY,heist,Tornado Ring,0,2,0,2,1350
1842,2023-01-07,SHELLY,gemGrab,Hard Rock Mine,0,1,0,1,1158
1843,2023-01-07,SHELLY,gemGrab,Deep Diner,0,3,0,3,918
1844,2023-01-07,SHELLY,brawlBall,Super Beach,0,7,2,9,2622
1845,2023-01-07,SHELLY,brawlBall,Sneaky Fields,0,3,0,3,402
1846,2023-01-07,SHELLY,bounty,Dry Season,0,2,0,2,1320
1847,2023-01-06,SHELLY,knockout,Out in the Open,0,12,24,36,1446
1848,2023-01-06,SHELLY,hotZone,Split,0,5,0,5,1158
1849,2023-01-06,SHELLY,heist,Tornado Ring,0,3,0,3,2538
1850,2023-01-06,SHELLY,gemGrab,Deep Diner,0,2,0,2,2226
1851,2023-01-06,SHELLY,brawlBall,Sneaky Fields,2,46,60,108,4896
1852,2023-01-06,SHELLY,brawlBall,Pinhole Punt,0,4,1,5,510
1853,2023-01-06,SHELLY,bounty,Dry Season,0,1,0,1,1944
1854,2023-01-05,SHELLY,knockout,Out in the Open,0,16,13,29,2958
1855,2023-01-05,SHELLY,hotZone,Split,0,8,0,8,3552
1856,2023-01-05,SHELLY,heist,Kaboom Canyon,0,3,1,4,954
1857,2023-01-05,SHELLY,gemGrab,Undermine,0,5,1,6,1812
1858,2023-01-05,SHELLY,gemGrab,Gem Fort,0,0,1,1,252
1859,2023-01-05,SHELLY,brawlBall,Pinhole Punt,0,31,13,44,8118
1860,2023-01-05,SHELLY,bounty,Shooting Star,0,1,0,1,1362
1861,2023-01-04,SHELLY,knockout,Goldarm Gulch,0,7,5,12,696
1862,2023-01-04,SHELLY,hotZone,Parallel Plays,0,3,0,3,864
1863,2023-01-04,SHELLY,heist,Kaboom Canyon,0,3,0,3,1848
1864,2023-01-04,SHELLY,gemGrab,Gem Fort,0,5,2,7,1788
1865,2023-01-04,SHELLY,gemGrab,Crystal Arcade,0,1,3,4,642
1866,2023-01-04,SHELLY,brawlBall,Sunny Soccer,1,46,27,74,6312
1867,2023-01-04,SHELLY,brawlBall,Beach Ball,0,1,0,1,54
1868,2023-01-03,SHELLY,knockout,Goldarm Gulch,0,3,0,3,720
1869,2023-01-03,SHELLY,hotZone,Parallel Plays,0,3,0,3,1542
1870,2023-01-03,SHELLY,heist,Pit Stop,0,3,0,3,1956
1871,2023-01-03,SHELLY,gemGrab,Minecart Madness,0,1,0,1,456
1872,2023-01-03,SHELLY,gemGrab,Crystal Arcade,0,2,1,3,2406
1873,2023-01-03,SHELLY,brawlBall,Center Stage,1,4,10,15,294
1874,2023-01-03,SHELLY,brawlBall,Beach Ball,0,24,1,25,5580
1875,2023-01-02,SHELLY,knockout,Belle's Rock,0,4,0,4,1794
1876,2023-01-02,SHELLY,hotZone,Quarter Pounder,0,10,1,11,2652
1877,2023-01-02,SHELLY,heist,Pit Stop,0,5,1,6,3498
1878,2023-01-02,SHELLY,heist,Kaboom Canyon,0,0,1,1,30
1879,2023-01-02,SHELLY,gemGrab,Minecart Madness,0,1,0,1,2352
1880,2023-01-02,SHELLY,gemGrab,Double Swoosh,0,9,15,24,1512
1881,2023-01-02,SHELLY,brawlBall,Center Stage,1,68,79,148,7110
1882,2023-01-02,SHELLY,brawlBall,Backyard Bowl,0,2,3,5,492
1883,2023-01-02,SHELLY,bounty,Hideout,0,4,0,4,3090
1884,2023-01-01,SHELLY,knockout,Belle's Rock,0,2,4,6,858
1885,2023-01-01,SHELLY,hotZone,Quarter Pounder,0,1,0,1,1188
1886,2023-01-01,SHELLY,gemGrab,Hard Rock Mine,0,0,1,1,48
1887,2023-01-01,SHELLY,gemGrab,Double Swoosh,0,5,1,6,1140
1888,2023-01-01,SHELLY,brawlBall,Backyard Bowl,1,6,6,13,2658
1889,2022-12-31,SHELLY,knockout,Flaring Phoenix,0,0,1,1,18
1890,2022-12-31,SHELLY,hotZone,Controller Chaos,0,2,0,2,198
1891,2022-12-31,SHELLY,gemGrab,Deep Diner,0,1,0,1,306
1892,2022-12-31,SHELLY,brawlBall,Super Beach,1,5,2,8,618
1893,2022-12-31,SHELLY,brawlBall,Sneaky Fields,0,0,1,1,60
1894,2022-12-30,SHELLY,knockout,Flaring Phoenix,0,2,1,3,72
1895,2022-12-30,SHELLY,hotZone,Controller Chaos,0,3,0,3,288
1896,2022-12-30,SHELLY,gemGrab,Minecart Madness,0,0,1,1,24
1897,2022-12-30,SHELLY,gemGrab,Deep Diner,0,1,0,1,438
1898,2022-12-30,SHELLY,brawlBall,Sneaky Fields,1,3,1,5,552
1899,2022-12-29,SHELLY,gemGrab,Undermine,0,1,0,1,102
1900,2022-12-29,SHELLY,brawlBall,Pinhole Punt,0,0,1,1,282
1901,2022-12-28,SHELLY,hotZone,Controller Chaos,0,0,1,1,6
1902,2022-12-28,SHELLY,gemGrab,Crystal Arcade,0,1,0,1,6
1903,2022-12-28,SHELLY,brawlBall,Beach Ball,0,1,0,1,6
1904,2022-12-27,SHELLY,brawlBall,Beach Ball,0,1,1,2,144
1905,2022-12-26,SHELLY,hotZone,Controller Chaos,0,0,1,1,30
1906,2022-12-26,SHELLY,heist,Kaboom Canyon,0,0,1,1,36
1907,2022-12-26,SHELLY,gemGrab,Minecart Madness,0,1,1,2,60
1908,2022-12-26,SHELLY,brawlBall,Center Stage,0,1,0,1,78
1909,2022-12-24,SHELLY,brawlBall,Super Beach,0,1,0,1,48
1910,2022-12-23,SHELLY,brawlBall,Sneaky Fields,0,0,1,1,12
1911,2022-12-22,SHELLY,brawlBall,Pinhole Punt,0,1,0,1,132
1912,2022-12-20,SHELLY,brawlBall,Beach Ball,0,1,1,2,96
1913,2022-12-13,SHELLY,brawlBall,Beach Ball,0,0,1,1,54
1914,2022-10-26,SHELLY,brawlBall,Sunny Soccer,0,0,1,1,18
1915,2023-01-28,SANDY,knockout,Flaring Phoenix,0,6,7,13,12366
1916,2023-01-28,SANDY,hotZone,Controller Chaos,0,36,54,90,10134
1917,2023-01-28,SANDY,heist,Bridge Too Far,1,3,0,4,24240
1918,2023-01-28,SANDY,gemGrab,Hard Rock Mine,0,64,72,136,16638
1919,2023-01-28,SANDY,gemGrab,Deep Diner,0,20,43,63,5478
1920,2023-01-28,SANDY,brawlBall,Super Beach,12,290,329,631,74430
1921,2023-01-28,SANDY,brawlBall,Sneaky Fields,0,7,9,16,3582
1922,2023-01-28,SANDY,bounty,Canal Grande,0,21,26,47,10902
1923,2023-01-27,SANDY,knockout,Flaring Phoenix,0,1,2,3,5928
1924,2023-01-27,SANDY,hotZone,Controller Chaos,0,14,16,30,2676
1925,2023-01-27,SANDY,gemGrab,Undermine,0,5,6,11,942
1926,2023-01-27,SANDY,gemGrab,Deep Diner,0,38,57,95,6846
1927,2023-01-27,SANDY,brawlBall,Sneaky Fields,4,62,69,135,23514
1928,2023-01-27,SANDY,brawlBall,Pinhole Punt,0,1,1,2,738
1929,2023-01-27,SANDY,bounty,Temple Ruins,0,3,7,10,1890
1930,2023-01-26,SANDY,knockout,Riverside,0,8,9,17,19008
1931,2023-01-26,SANDY,hotZone,Open Zone,0,28,12,40,10182
1932,2023-01-26,SANDY,heist,Hot Potato,0,3,1,4,14610
1933,2023-01-26,SANDY,gemGrab,Undermine,0,61,86,147,10062
1934,2023-01-26,SANDY,gemGrab,Gem Fort,0,29,24,53,4674
1935,2023-01-26,SANDY,brawlBall,Sunny Soccer,0,16,4,20,3660
1936,2023-01-26,SANDY,brawlBall,Pinhole Punt,8,257,273,538,67338
1937,2023-01-26,SANDY,bounty,Temple Ruins,0,13,10,23,5610
1938,2023-01-25,SANDY,hotZone,Open Zone,0,1,6,7,5262
1939,2023-01-25,SANDY,heist,Safe Zone,0,2,0,2,9156
1940,2023-01-25,SANDY,gemGrab,Gem Fort,0,24,22,46,5556
1941,2023-01-25,SANDY,gemGrab,Crystal Arcade,0,52,58,110,7866
1942,2023-01-25,SANDY,brawlBall,Sunny Soccer,4,133,194,331,40830
1943,2023-01-25,SANDY,brawlBall,Beach Ball,3,24,17,44,6408
1944,2023-01-25,SANDY,bounty,Excel,0,2,1,3,5790
1945,2023-01-24,SANDY,knockout,New Perspective,0,12,6,18,10542
1946,2023-01-24,SANDY,hotZone,Dueling Beetles,0,57,41,98,10662
1947,2023-01-24,SANDY,gemGrab,Minecart Madness,0,16,13,29,4002
1948,2023-01-24,SANDY,gemGrab,Crystal Arcade,0,136,183,319,14460
1949,2023-01-24,SANDY,brawlBall,Center Stage,2,23,35,60,7860
1950,2023-01-24,SANDY,brawlBall,Beach Ball,12,273,320,605,64614
1951,2023-01-24,SANDY,bounty,Excel,0,9,2,11,10896
1952,2023-01-23,SANDY,knockout,New Perspective,0,18,7,25,20676
1953,2023-01-23,SANDY,hotZone,Dueling Beetles,0,64,52,116,17502
1954,2023-01-23,SANDY,heist,Snaked Assault,0,1,2,3,15762
1955,2023-01-23,SANDY,gemGrab,Minecart Madness,0,41,35,76,19062
1956,2023-01-23,SANDY,gemGrab,Double Swoosh,0,52,61,113,7578
1957,2023-01-23,SANDY,brawlBall,Center Stage,7,242,329,578,92862
1958,2023-01-23,SANDY,brawlBall,Backyard Bowl,1,5,3,9,4224
1959,2023-01-23,SANDY,bounty,Layer Cake,0,3,7,10,11142
1960,2023-01-22,SANDY,knockout,X Marks the Spot,0,3,3,6,9174
1961,2023-01-22,SANDY,hotZone,Ring of Fire,0,22,17,39,5730
1962,2023-01-22,SANDY,heist,Snaked Assault,0,1,0,1,8232
1963,2023-01-22,SANDY,gemGrab,Hard Rock Mine,0,19,21,40,4722
1964,2023-01-22,SANDY,gemGrab,Double Swoosh,0,92,112,204,9426
1965,2023-01-22,SANDY,brawlBall,Super Beach,0,27,28,55,7386
1966,2023-01-22,SANDY,brawlBall,Backyard Bowl,2,36,42,80,34788
1967,2023-01-22,SANDY,bounty,Layer Cake,0,5,4,9,6654
1968,2023-01-21,SANDY,knockout,X Marks the Spot,1,20,9,30,31698
1969,2023-01-21,SANDY,hotZone,Ring of Fire,0,76,77,153,16632
1970,2023-01-21,SANDY,heist,Tornado Ring,0,2,0,2,11664
1971,2023-01-21,SANDY,gemGrab,Hard Rock Mine,0,113,101,214,22980
1972,2023-01-21,SANDY,gemGrab,Deep Diner,0,16,10,26,4470
1973,2023-01-21,SANDY,brawlBall,Super Beach,15,415,485,915,101364
1974,2023-01-21,SANDY,brawlBall,Sneaky Fields,1,6,8,15,3750
1975,2023-01-21,SANDY,bounty,Dry Season,0,1,4,5,14538
1976,2023-01-20,SANDY,knockout,Out in the Open,0,14,21,35,20106
1977,2023-01-20,SANDY,hotZone,Split,0,17,17,34,9678
1978,2023-01-20,SANDY,heist,Tornado Ring,0,0,2,2,12672
1979,2023-01-20,SANDY,gemGrab,Undermine,0,35,31,66,5442
1980,2023-01-20,SANDY,gemGrab,Deep Diner,0,83,90,173,19050
1981,2023-01-20,SANDY,brawlBall,Sneaky Fields,13,300,297,610,74778
1982,2023-01-20,SANDY,brawlBall,Pinhole Punt,0,3,6,9,2886
1983,2023-01-20,SANDY,bounty,Dry Season,0,5,11,16,11640
1984,2023-01-19,SANDY,knockout,Out in the Open,0,20,9,29,26574
1985,2023-01-19,SANDY,hotZone,Split,0,18,16,34,14856
1986,2023-01-19,SANDY,heist,Kaboom Canyon,0,3,4,7,6732
1987,2023-01-19,SANDY,gemGrab,Undermine,0,68,122,190,14154
1988,2023-01-19,SANDY,gemGrab,Gem Fort,0,10,12,22,2934
1989,2023-01-19,SANDY,brawlBall,Sunny Soccer,0,7,7,14,2274
1990,2023-01-19,SANDY,brawlBall,Pinhole Punt,9,240,285,534,72498
1991,2023-01-19,SANDY,bounty,Shooting Star,0,3,2,5,11124
1992,2023-01-18,SANDY,knockout,Goldarm Gulch,0,4,4,8,2784
1993,2023-01-18,SANDY,hotZone,Parallel Plays,0,5,12,17,1158
1994,2023-01-18,SANDY,heist,Kaboom Canyon,0,0,1,1,2592
1995,2023-01-18,SANDY,gemGrab,Gem Fort,0,17,14,31,3006
1996,2023-01-18,SANDY,gemGrab,Crystal Arcade,0,9,15,24,990
1997,2023-01-18,SANDY,brawlBall,Sunny Soccer,2,88,95,185,18941
1998,2023-01-18,SANDY,brawlBall,Beach Ball,1,4,2,7,774
1999,2023-01-18,SANDY,bounty,Shooting Star,0,2,0,2,5088
2000,2023-01-17,SANDY,knockout,Goldarm Gulch,0,5,8,13,2520
2001,2023-01-17,SANDY,hotZone,Parallel Plays,0,5,4,9,1038
2002,2023-01-17,SANDY,heist,Pit Stop,0,0,1,1,1290
2003,2023-01-17,SANDY,gemGrab,Crystal Arcade,0,7,8,15,1266
2004,2023-01-17,SANDY,brawlBall,Beach Ball,3,23,31,57,5886
2005,2023-01-17,SANDY,bounty,Hideout,0,4,4,8,750
2006,2023-01-16,SANDY,knockout,Belle's Rock,0,1,0,1,1788
2007,2023-01-16,SANDY,hotZone,Quarter Pounder,0,7,3,10,1494
2008,2023-01-16,SANDY,heist,Pit Stop,0,1,1,2,4044
2009,2023-01-16,SANDY,gemGrab,Minecart Madness,0,1,0,1,1422
2010,2023-01-16,SANDY,gemGrab,Double Swoosh,0,7,4,11,708
2011,2023-01-16,SANDY,brawlBall,Center Stage,2,13,4,19,5778
2012,2023-01-16,SANDY,brawlBall,Backyard Bowl,0,1,0,1,852
2013,2023-01-15,SANDY,hotZone,Quarter Pounder,0,2,0,2,3318
2014,2023-01-15,SANDY,heist,Bridge Too Far,0,0,1,1,2736
2015,2023-01-15,SANDY,gemGrab,Hard Rock Mine,0,7,22,29,1014
2016,2023-01-15,SANDY,gemGrab,Double Swoosh,0,16,17,33,2178
2017,2023-01-15,SANDY,brawlBall,Super Beach,1,5,8,14,1074
2018,2023-01-15,SANDY,brawlBall,Backyard Bowl,1,11,3,15,8946
2019,2023-01-15,SANDY,bounty,Canal Grande,0,1,1,2,960
2020,2023-01-14,SANDY,hotZone,Controller Chaos,0,16,32,48,2772
2021,2023-01-14,SANDY,gemGrab,Hard Rock Mine,0,4,2,6,1272
2022,2023-01-14,SANDY,gemGrab,Deep Diner,0,1,4,5,858
2023,2023-01-14,SANDY,brawlBall,Super Beach,0,21,30,51,6336
2024,2023-01-14,SANDY,brawlBall,Sneaky Fields,0,0,5,5,918
2025,2023-01-14,SANDY,bounty,Canal Grande,0,9,8,17,1014
2026,2023-01-13,SANDY,knockout,Flaring Phoenix,0,1,0,1,1182
2027,2023-01-13,SANDY,hotZone,Controller Chaos,0,3,0,3,2928
2028,2023-01-13,SANDY,gemGrab,Undermine,0,0,1,1,18
2029,2023-01-13,SANDY,gemGrab,Deep Diner,0,6,2,8,1650
2030,2023-01-13,SANDY,brawlBall,Sneaky Fields,0,10,6,16,6144
2031,2023-01-13,SANDY,brawlBall,Pinhole Punt,0,0,1,1,156
2032,2023-01-12,SANDY,hotZone,Open Zone,0,4,0,4,1488
2033,2023-01-12,SANDY,gemGrab,Undermine,0,4,5,9,690
2034,2023-01-12,SANDY,gemGrab,Gem Fort,0,2,3,5,162
2035,2023-01-12,SANDY,brawlBall,Sunny Soccer,0,2,13,15,240
2036,2023-01-12,SANDY,brawlBall,Pinhole Punt,0,10,11,21,2292
2037,2023-01-11,SANDY,hotZone,Open Zone,0,0,3,3,462
2038,2023-01-11,SANDY,gemGrab,Gem Fort,0,1,0,1,414
2039,2023-01-11,SANDY,brawlBall,Sunny Soccer,0,6,2,8,1638
2040,2023-01-11,SANDY,brawlBall,Beach Ball,0,0,1,1,48
2041,2023-01-10,SANDY,knockout,New Perspective,0,1,1,2,720
2042,2023-01-10,SANDY,hotZone,Dueling Beetles,0,13,12,25,2424
2043,2023-01-10,SANDY,gemGrab,Crystal Arcade,0,15,43,58,1746
2044,2023-01-10,SANDY,brawlBall,Center Stage,0,0,1,1,708
2045,2023-01-10,SANDY,brawlBall,Beach Ball,0,24,8,32,4392
2046,2023-01-09,SANDY,knockout,New Perspective,0,2,0,2,876
2047,2023-01-09,SANDY,hotZone,Dueling Beetles,0,12,14,26,1554
2048,2023-01-09,SANDY,gemGrab,Minecart Madness,0,2,1,3,1884
2049,2023-01-09,SANDY,gemGrab,Double Swoosh,0,7,4,11,1320
2050,2023-01-09,SANDY,brawlBall,Center Stage,0,7,15,22,5460
2051,2023-01-09,SANDY,brawlBall,Backyard Bowl,0,2,0,2,474
2052,2023-01-08,SANDY,knockout,X Marks the Spot,0,2,0,2,1692
2053,2023-01-08,SANDY,hotZone,Ring of Fire,0,3,4,7,1644
2054,2023-01-08,SANDY,gemGrab,Hard Rock Mine,0,1,0,1,630
2055,2023-01-08,SANDY,gemGrab,Double Swoosh,0,7,22,29,864
2056,2023-01-08,SANDY,brawlBall,Super Beach,0,2,0,2,732
2057,2023-01-08,SANDY,brawlBall,Backyard Bowl,0,2,5,7,4830
2058,2023-01-07,SANDY,hotZone,Ring of Fire,0,4,6,10,846
2059,2023-01-07,SANDY,gemGrab,Hard Rock Mine,0,6,3,9,1158
2060,2023-01-07,SANDY,gemGrab,Deep Diner,0,4,7,11,918
2061,2023-01-07,SANDY,brawlBall,Super Beach,0,13,18,31,2622
2062,2023-01-07,SANDY,brawlBall,Sneaky Fields,0,1,0,1,402
2063,2023-01-06,SANDY,hotZone,Split,0,2,4,6,1158
2064,2023-01-06,SANDY,heist,Tornado Ring,0,1,0,1,2538
2065,2023-01-06,SANDY,gemGrab,Undermine,0,4,1,5,540
2066,2023-01-06,SANDY,gemGrab,Deep Diner,0,12,7,19,2226
2067,2023-01-06,SANDY,brawlBall,Sneaky Fields,0,11,11,22,4896
2068,2023-01-06,SANDY,brawlBall,Pinhole Punt,0,4,1,5,510
2069,2023-01-06,SANDY,bounty,Dry Season,0,1,0,1,1944
2070,2023-01-05,SANDY,hotZone,Split,0,6,13,19,3552
2071,2023-01-05,SANDY,gemGrab,Undermine,0,5,3,8,1812
2072,2023-01-05,SANDY,gemGrab,Gem Fort,0,2,12,14,252
2073,2023-01-05,SANDY,brawlBall,Pinhole Punt,0,24,23,47,8118
2074,2023-01-04,SANDY,knockout,Goldarm Gulch,0,1,0,1,696
2075,2023-01-04,SANDY,hotZone,Parallel Plays,0,1,1,2,864
2076,2023-01-04,SANDY,gemGrab,Gem Fort,0,6,17,23,1788
2077,2023-01-04,SANDY,gemGrab,Crystal Arcade,0,5,5,10,642
2078,2023-01-04,SANDY,brawlBall,Sunny Soccer,0,19,22,41,6312
2079,2023-01-03,SANDY,gemGrab,Minecart Madness,0,1,0,1,456
2080,2023-01-03,SANDY,gemGrab,Crystal Arcade,0,22,5,27,2406
2081,2023-01-03,SANDY,brawlBall,Beach Ball,0,13,11,24,5580
2082,2023-01-02,SANDY,knockout,Belle's Rock,0,1,0,1,1794
2083,2023-01-02,SANDY,hotZone,Quarter Pounder,0,2,1,3,2652
2084,2023-01-02,SANDY,gemGrab,Minecart Madness,0,7,0,7,2352
2085,2023-01-02,SANDY,gemGrab,Double Swoosh,0,8,16,24,1512
2086,2023-01-02,SANDY,brawlBall,Center Stage,0,10,10,20,7110
2087,2023-01-02,SANDY,brawlBall,Backyard Bowl,0,0,1,1,492
2088,2023-01-01,SANDY,hotZone,Quarter Pounder,0,6,11,17,1188
2089,2023-01-01,SANDY,gemGrab,Double Swoosh,0,14,18,32,1140
2090,2023-01-01,SANDY,brawlBall,Backyard Bowl,0,3,6,9,2658
2091,2022-12-31,SANDY,hotZone,Controller Chaos,0,0,1,1,198
2092,2022-12-31,SANDY,gemGrab,Deep Diner,0,1,0,1,306
2093,2022-12-31,SANDY,brawlBall,Super Beach,0,5,2,7,618
2094,2022-12-30,SANDY,hotZone,Controller Chaos,0,1,2,3,288
2095,2022-12-30,SANDY,gemGrab,Minecart Madness,0,1,0,1,24
2096,2022-12-30,SANDY,gemGrab,Deep Diner,0,0,2,2,438
2097,2022-12-30,SANDY,brawlBall,Sneaky Fields,0,5,8,13,552
2098,2022-12-29,SANDY,brawlBall,Pinhole Punt,0,4,4,8,282
2099,2022-12-28,SANDY,gemGrab,Crystal Arcade,0,0,1,1,6
2100,2022-12-27,SANDY,hotZone,Dueling Beetles,0,1,0,1,36
2101,2022-12-27,SANDY,brawlBall,Beach Ball,0,0,1,1,144
2102,2022-12-21,SANDY,brawlBall,Sunny Soccer,0,0,1,1,54
2103,2022-12-20,SANDY,brawlBall,Beach Ball,0,0,1,1,96
2104,2022-12-19,SANDY,brawlBall,Center Stage,0,0,1,1,102
2105,2022-12-13,SANDY,knockout,New Perspective,0,1,0,1,84
2106,2022-12-13,SANDY,brawlBall,Beach Ball,0,0,1,1,54
2107,2022-10-30,SANDY,brawlBall,Beach Ball,0,1,0,1,12
2108,2022-10-15,SANDY,gemGrab,Hard Rock Mine,0,1,2,3,90
2109,2023-01-28,SAM,knockout,Flaring Phoenix,0,45,32,77,12366
2110,2023-01-28,SAM,hotZone,Controller Chaos,0,73,143,216,10134
2111,2023-01-28,SAM,heist,Bridge Too Far,0,288,406,694,24240
2112,2023-01-28,SAM,gemGrab,Hard Rock Mine,0,98,158,256,16638
2113,2023-01-28,SAM,gemGrab,Deep Diner,0,27,19,46,5478
2114,2023-01-28,SAM,brawlBall,Super Beach,15,618,808,1441,74430
2115,2023-01-28,SAM,brawlBall,Sneaky Fields,2,31,39,72,3582
2116,2023-01-28,SAM,bounty,Canal Grande,0,39,33,72,10902
2117,2023-01-27,SAM,knockout,Flaring Phoenix,1,15,29,45,5928
2118,2023-01-27,SAM,hotZone,Controller Chaos,0,20,38,58,2676
2119,2023-01-27,SAM,heist,Hot Potato,0,46,74,120,3486
2120,2023-01-27,SAM,gemGrab,Undermine,0,5,6,11,942
2121,2023-01-27,SAM,gemGrab,Deep Diner,0,32,52,84,6846
2122,2023-01-27,SAM,brawlBall,Sneaky Fields,4,203,207,414,23514
2123,2023-01-27,SAM,brawlBall,Pinhole Punt,0,6,8,14,738
2124,2023-01-27,SAM,bounty,Temple Ruins,0,8,7,15,1890
2125,2023-01-26,SAM,knockout,Riverside,0,29,24,53,19008
2126,2023-01-26,SAM,hotZone,Open Zone,0,30,24,54,10182
2127,2023-01-26,SAM,heist,Hot Potato,1,117,133,251,14610
2128,2023-01-26,SAM,gemGrab,Undermine,0,68,67,135,10062
2129,2023-01-26,SAM,gemGrab,Gem Fort,0,33,41,74,4674
2130,2023-01-26,SAM,brawlBall,Sunny Soccer,0,33,43,76,3660
2131,2023-01-26,SAM,brawlBall,Pinhole Punt,7,481,620,1108,67338
2132,2023-01-26,SAM,bounty,Temple Ruins,0,28,32,60,5610
2133,2023-01-25,SAM,knockout,Riverside,0,6,9,15,9906
2134,2023-01-25,SAM,hotZone,Open Zone,0,7,1,8,5262
2135,2023-01-25,SAM,heist,Safe Zone,1,41,53,95,9156
2136,2023-01-25,SAM,gemGrab,Gem Fort,0,44,38,82,5556
2137,2023-01-25,SAM,gemGrab,Crystal Arcade,0,30,23,53,7866
2138,2023-01-25,SAM,brawlBall,Sunny Soccer,5,381,463,849,40830
2139,2023-01-25,SAM,brawlBall,Beach Ball,3,72,78,153,6408
2140,2023-01-25,SAM,bounty,Excel,0,17,27,44,5790
2141,2023-01-24,SAM,knockout,New Perspective,0,37,29,66,10542
2142,2023-01-24,SAM,hotZone,Dueling Beetles,0,82,108,190,10662
2143,2023-01-24,SAM,heist,Safe Zone,0,54,112,166,15750
2144,2023-01-24,SAM,gemGrab,Minecart Madness,0,15,23,38,4002
2145,2023-01-24,SAM,gemGrab,Crystal Arcade,0,75,101,176,14460
2146,2023-01-24,SAM,brawlBall,Center Stage,2,77,82,161,7860
2147,2023-01-24,SAM,brawlBall,Beach Ball,10,473,629,1112,64614
2148,2023-01-24,SAM,bounty,Excel,0,73,130,203,10896
2149,2023-01-23,SAM,knockout,New Perspective,0,48,61,109,20676
2150,2023-01-23,SAM,hotZone,Dueling Beetles,0,93,120,213,17502
2151,2023-01-23,SAM,heist,Snaked Assault,0,123,97,220,15762
2152,2023-01-23,SAM,gemGrab,Minecart Madness,0,71,80,151,19062
2153,2023-01-23,SAM,gemGrab,Double Swoosh,0,16,28,44,7578
2154,2023-01-23,SAM,brawlBall,Center Stage,23,648,823,1494,92862
2155,2023-01-23,SAM,brawlBall,Backyard Bowl,0,15,22,37,4224
2156,2023-01-23,SAM,bounty,Layer Cake,0,25,41,66,11142
2157,2023-01-22,SAM,knockout,X Marks the Spot,0,18,21,39,9174
2158,2023-01-22,SAM,hotZone,Ring of Fire,0,37,38,75,5730
2159,2023-01-22,SAM,heist,Snaked Assault,0,43,48,91,8232
2160,2023-01-22,SAM,gemGrab,Hard Rock Mine,0,26,33,59,4722
2161,2023-01-22,SAM,gemGrab,Double Swoosh,0,47,53,100,9426
2162,2023-01-22,SAM,brawlBall,Super Beach,1,60,99,160,7386
2163,2023-01-22,SAM,brawlBall,Backyard Bowl,6,133,210,349,34788
2164,2023-01-22,SAM,bounty,Layer Cake,0,16,18,34,6654
2165,2023-01-21,SAM,knockout,X Marks the Spot,0,82,68,150,31698
2166,2023-01-21,SAM,hotZone,Ring of Fire,0,74,76,150,16632
2167,2023-01-21,SAM,heist,Tornado Ring,0,109,101,210,11664
2168,2023-01-21,SAM,gemGrab,Hard Rock Mine,0,110,214,324,22980
2169,2023-01-21,SAM,gemGrab,Deep Diner,0,21,34,55,4470
2170,2023-01-21,SAM,brawlBall,Super Beach,29,735,997,1761,101364
2171,2023-01-21,SAM,brawlBall,Sneaky Fields,2,52,65,119,3750
2172,2023-01-21,SAM,bounty,Dry Season,0,20,32,52,14538
2173,2023-01-20,SAM,knockout,Out in the Open,0,41,59,100,20106
2174,2023-01-20,SAM,hotZone,Split,0,78,120,198,9678
2175,2023-01-20,SAM,heist,Tornado Ring,0,69,85,154,12672
2176,2023-01-20,SAM,gemGrab,Undermine,0,43,55,98,5442
2177,2023-01-20,SAM,gemGrab,Deep Diner,0,84,93,177,19050
2178,2023-01-20,SAM,brawlBall,Sneaky Fields,15,606,716,1337,74778
2179,2023-01-20,SAM,brawlBall,Pinhole Punt,1,22,24,47,2886
2180,2023-01-20,SAM,bounty,Dry Season,0,24,20,44,11640
2181,2023-01-19,SAM,knockout,Out in the Open,0,46,49,95,26574
2182,2023-01-19,SAM,hotZone,Split,0,195,296,491,14856
2183,2023-01-19,SAM,heist,Kaboom Canyon,0,32,33,65,6732
2184,2023-01-19,SAM,gemGrab,Undermine,0,55,69,124,14154
2185,2023-01-19,SAM,gemGrab,Gem Fort,0,24,21,45,2934
2186,2023-01-19,SAM,brawlBall,Sunny Soccer,0,23,16,39,2274
2187,2023-01-19,SAM,brawlBall,Pinhole Punt,10,434,611,1055,72498
2188,2023-01-19,SAM,bounty,Shooting Star,0,6,12,18,11124
2189,2023-01-18,SAM,knockout,Goldarm Gulch,0,7,7,14,2784
2190,2023-01-18,SAM,hotZone,Parallel Plays,0,21,16,37,1158
2191,2023-01-18,SAM,heist,Kaboom Canyon,0,9,5,14,2592
2192,2023-01-18,SAM,gemGrab,Gem Fort,0,12,8,20,3006
2193,2023-01-18,SAM,gemGrab,Crystal Arcade,0,9,11,20,990
2194,2023-01-18,SAM,brawlBall,Sunny Soccer,4,161,210,375,18941
2195,2023-01-18,SAM,brawlBall,Beach Ball,0,4,3,7,774
2196,2023-01-18,SAM,bounty,Shooting Star,0,2,6,8,5088
2197,2023-01-17,SAM,knockout,Goldarm Gulch,0,19,12,31,2520
2198,2023-01-17,SAM,hotZone,Parallel Plays,0,12,24,36,1038
2199,2023-01-17,SAM,heist,Pit Stop,0,21,18,39,1290
2200,2023-01-17,SAM,gemGrab,Minecart Madness,0,1,3,4,216
2201,2023-01-17,SAM,gemGrab,Crystal Arcade,0,7,5,12,1266
2202,2023-01-17,SAM,brawlBall,Center Stage,0,0,2,2,288
2203,2023-01-17,SAM,brawlBall,Beach Ball,0,42,31,73,5886
2204,2023-01-16,SAM,knockout,Belle's Rock,0,1,2,3,1788
2205,2023-01-16,SAM,hotZone,Quarter Pounder,0,19,5,24,1494
2206,2023-01-16,SAM,heist,Pit Stop,0,63,68,131,4044
2207,2023-01-16,SAM,gemGrab,Minecart Madness,0,9,12,21,1422
2208,2023-01-16,SAM,gemGrab,Double Swoosh,0,4,3,7,708
2209,2023-01-16,SAM,brawlBall,Center Stage,0,45,42,87,5778
2210,2023-01-16,SAM,brawlBall,Backyard Bowl,0,5,1,6,852
2211,2023-01-16,SAM,bounty,Hideout,0,1,4,5,1470
2212,2023-01-15,SAM,knockout,Belle's Rock,0,4,0,4,2904
2213,2023-01-15,SAM,hotZone,Quarter Pounder,0,20,28,48,3318
2214,2023-01-15,SAM,heist,Bridge Too Far,2,20,32,54,2736
2215,2023-01-15,SAM,gemGrab,Hard Rock Mine,0,6,5,11,1014
2216,2023-01-15,SAM,gemGrab,Double Swoosh,0,4,3,7,2178
2217,2023-01-15,SAM,brawlBall,Super Beach,0,7,27,34,1074
2218,2023-01-15,SAM,brawlBall,Backyard Bowl,1,17,25,43,8946
2219,2023-01-15,SAM,bounty,Canal Grande,0,6,4,10,960
2220,2023-01-14,SAM,knockout,Flaring Phoenix,0,3,0,3,1080
2221,2023-01-14,SAM,hotZone,Controller Chaos,0,24,12,36,2772
2222,2023-01-14,SAM,heist,Bridge Too Far,0,25,17,42,4020
2223,2023-01-14,SAM,gemGrab,Hard Rock Mine,0,4,2,6,1272
2224,2023-01-14,SAM,gemGrab,Deep Diner,0,2,4,6,858
2225,2023-01-14,SAM,brawlBall,Super Beach,1,53,56,110,6336
2226,2023-01-14,SAM,brawlBall,Sneaky Fields,0,3,1,4,918
2227,2023-01-14,SAM,bounty,Canal Grande,0,1,3,4,1014
2228,2023-01-13,SAM,knockout,Flaring Phoenix,0,4,6,10,1182
2229,2023-01-13,SAM,hotZone,Controller Chaos,0,9,4,13,2928
2230,2023-01-13,SAM,heist,Hot Potato,0,7,18,25,600
2231,2023-01-13,SAM,gemGrab,Deep Diner,0,10,7,17,1650
2232,2023-01-13,SAM,brawlBall,Sneaky Fields,0,20,38,58,6144
2233,2023-01-12,SAM,hotZone,Open Zone,0,4,3,7,1488
2234,2023-01-12,SAM,heist,Hot Potato,0,1,1,2,330
2235,2023-01-12,SAM,gemGrab,Undermine,0,2,0,2,690
2236,2023-01-12,SAM,gemGrab,Gem Fort,0,1,0,1,162
2237,2023-01-12,SAM,brawlBall,Sunny Soccer,0,1,5,6,240
2238,2023-01-12,SAM,brawlBall,Pinhole Punt,0,6,13,19,2292
2239,2023-01-11,SAM,knockout,Riverside,0,1,0,1,528
2240,2023-01-11,SAM,hotZone,Open Zone,0,1,1,2,462
2241,2023-01-11,SAM,gemGrab,Gem Fort,0,1,2,3,414
2242,2023-01-11,SAM,brawlBall,Sunny Soccer,1,9,19,29,1638
2243,2023-01-11,SAM,brawlBall,Beach Ball,0,0,2,2,48
2244,2023-01-11,SAM,bounty,Excel,0,1,0,1,282
2245,2023-01-10,SAM,knockout,New Perspective,0,0,1,1,720
2246,2023-01-10,SAM,hotZone,Dueling Beetles,0,11,4,15,2424
2247,2023-01-10,SAM,gemGrab,Minecart Madness,0,2,8,10,828
2248,2023-01-10,SAM,gemGrab,Crystal Arcade,0,2,3,5,1746
2249,2023-01-10,SAM,brawlBall,Center Stage,0,4,0,4,708
2250,2023-01-10,SAM,brawlBall,Beach Ball,0,18,9,27,4392
2251,2023-01-09,SAM,knockout,New Perspective,0,0,1,1,876
2252,2023-01-09,SAM,hotZone,Dueling Beetles,0,1,7,8,1554
2253,2023-01-09,SAM,heist,Snaked Assault,0,12,21,33,2022
2254,2023-01-09,SAM,gemGrab,Minecart Madness,0,5,0,5,1884
2255,2023-01-09,SAM,gemGrab,Double Swoosh,0,5,0,5,1320
2256,2023-01-09,SAM,brawlBall,Center Stage,0,22,39,61,5460
2257,2023-01-09,SAM,bounty,Layer Cake,0,2,4,6,1512
2258,2023-01-08,SAM,knockout,X Marks the Spot,0,3,0,3,1692
2259,2023-01-08,SAM,hotZone,Ring of Fire,0,2,8,10,1644
2260,2023-01-08,SAM,heist,Snaked Assault,0,4,1,5,1494
2261,2023-01-08,SAM,gemGrab,Hard Rock Mine,0,4,2,6,630
2262,2023-01-08,SAM,gemGrab,Double Swoosh,0,1,0,1,864
2263,2023-01-08,SAM,brawlBall,Backyard Bowl,2,15,3,20,4830
2264,2023-01-07,SAM,hotZone,Ring of Fire,0,3,2,5,846
2265,2023-01-07,SAM,heist,Tornado Ring,0,7,1,8,1350
2266,2023-01-07,SAM,gemGrab,Hard Rock Mine,0,0,4,4,1158
2267,2023-01-07,SAM,gemGrab,Deep Diner,0,3,0,3,918
2268,2023-01-07,SAM,brawlBall,Super Beach,0,7,4,11,2622
2269,2023-01-07,SAM,brawlBall,Sneaky Fields,0,4,0,4,402
2270,2023-01-07,SAM,bounty,Dry Season,0,0,1,1,1320
2271,2023-01-06,SAM,hotZone,Split,0,8,14,22,1158
2272,2023-01-06,SAM,heist,Tornado Ring,0,6,1,7,2538
2273,2023-01-06,SAM,gemGrab,Deep Diner,0,3,2,5,2226
2274,2023-01-06,SAM,brawlBall,Sneaky Fields,0,28,65,93,4896
2275,2023-01-06,SAM,brawlBall,Pinhole Punt,0,1,0,1,510
2276,2023-01-06,SAM,bounty,Dry Season,0,2,9,11,1944
2277,2023-01-05,SAM,knockout,Out in the Open,0,2,0,2,2958
2278,2023-01-05,SAM,hotZone,Split,1,14,2,17,3552
2279,2023-01-05,SAM,heist,Kaboom Canyon,0,7,0,7,954
2280,2023-01-05,SAM,gemGrab,Undermine,0,5,11,16,1812
2281,2023-01-05,SAM,brawlBall,Sunny Soccer,0,1,0,1,84
2282,2023-01-05,SAM,brawlBall,Pinhole Punt,0,21,9,30,8118
2283,2023-01-04,SAM,hotZone,Parallel Plays,0,2,1,3,864
2284,2023-01-04,SAM,heist,Kaboom Canyon,0,8,1,9,1848
2285,2023-01-04,SAM,gemGrab,Gem Fort,0,7,2,9,1788
2286,2023-01-04,SAM,gemGrab,Crystal Arcade,0,2,1,3,642
2287,2023-01-04,SAM,brawlBall,Sunny Soccer,2,36,31,69,6312
2288,2023-01-04,SAM,bounty,Shooting Star,0,4,15,19,3570
2289,2023-01-03,SAM,knockout,Goldarm Gulch,0,3,1,4,720
2290,2023-01-03,SAM,hotZone,Parallel Plays,0,5,14,19,1542
2291,2023-01-03,SAM,heist,Pit Stop,0,21,44,65,1956
2292,2023-01-03,SAM,gemGrab,Minecart Madness,0,1,0,1,456
2293,2023-01-03,SAM,gemGrab,Crystal Arcade,0,5,0,5,2406
2294,2023-01-03,SAM,brawlBall,Center Stage,0,1,0,1,294
2295,2023-01-03,SAM,brawlBall,Beach Ball,0,18,36,54,5580
2296,2023-01-03,SAM,bounty,Hideout,0,1,2,3,1638
2297,2023-01-02,SAM,knockout,Belle's Rock,0,2,1,3,1794
2298,2023-01-02,SAM,hotZone,Quarter Pounder,0,9,24,33,2652
2299,2023-01-02,SAM,heist,Pit Stop,0,24,33,57,3498
2300,2023-01-02,SAM,gemGrab,Minecart Madness,0,8,1,9,2352
2301,2023-01-02,SAM,brawlBall,Center Stage,0,27,50,77,7110
2302,2023-01-02,SAM,brawlBall,Backyard Bowl,0,1,2,3,492
2303,2023-01-02,SAM,bounty,Hideout,0,2,2,4,3090
2304,2023-01-01,SAM,knockout,Belle's Rock,0,1,0,1,858
2305,2023-01-01,SAM,hotZone,Quarter Pounder,0,1,0,1,1188
2306,2023-01-01,SAM,heist,Bridge Too Far,0,5,3,8,462
2307,2023-01-01,SAM,gemGrab,Double Swoosh,0,3,0,3,1140
2308,2023-01-01,SAM,brawlBall,Backyard Bowl,0,1,3,4,2658
2309,2023-01-01,SAM,bounty,Canal Grande,0,0,1,1,132
2310,2022-12-31,SAM,hotZone,Controller Chaos,0,3,0,3,198
2311,2022-12-31,SAM,heist,Bridge Too Far,0,2,3,5,276
2312,2022-12-31,SAM,gemGrab,Hard Rock Mine,0,1,0,1,384
2313,2022-12-31,SAM,brawlBall,Super Beach,0,6,6,12,618
2314,2022-12-31,SAM,brawlBall,Sneaky Fields,0,1,0,1,60
2315,2022-12-30,SAM,hotZone,Controller Chaos,0,1,0,1,288
2316,2022-12-30,SAM,gemGrab,Deep Diner,0,2,6,8,438
2317,2022-12-30,SAM,brawlBall,Sneaky Fields,0,2,2,4,552
2318,2022-12-29,SAM,gemGrab,Undermine,0,1,0,1,102
2319,2022-12-29,SAM,brawlBall,Pinhole Punt,0,1,1,2,282
2320,2022-12-28,SAM,gemGrab,Crystal Arcade,0,1,0,1,6
2321,2022-12-28,SAM,brawlBall,Beach Ball,0,1,0,1,6
2322,2022-12-27,SAM,brawlBall,Center Stage,0,0,1,1,30
2323,2022-12-26,SAM,brawlBall,Center Stage,0,1,0,1,78
2324,2022-12-23,SAM,knockout,Out in the Open,0,0,1,1,132
2325,2022-12-21,SAM,brawlBall,Sunny Soccer,0,1,0,1,54
2326,2022-12-20,SAM,brawlBall,Beach Ball,0,1,1,2,96
2327,2022-12-18,SAM,heist,Bridge Too Far,0,0,1,1,12
2328,2022-12-16,SAM,brawlBall,Sneaky Fields,0,0,1,1,84
2329,2022-12-13,SAM,brawlBall,Beach Ball,0,1,0,1,54
2330,2022-11-07,SAM,hotZone,Quarter Pounder,0,0,1,1,24
2331,2022-10-28,SAM,brawlBall,Beach Ball,0,0,1,1,12
2332,2022-10-15,SAM,brawlBall,Super Beach,0,0,1,1,12
2333,2022-10-10,SAM,knockout,Belle's Rock,0,0,1,1,48
2334,2023-01-28,RUFFS,knockout,Flaring Phoenix,0,28,26,54,12366
2335,2023-01-28,RUFFS,hotZone,Controller Chaos,0,18,28,46,10134
2336,2023-01-28,RUFFS,heist,Bridge Too Far,0,16,5,21,24240
2337,2023-01-28,RUFFS,gemGrab,Hard Rock Mine,0,178,299,477,16638
2338,2023-01-28,RUFFS,gemGrab,Deep Diner,0,67,103,170,5478
2339,2023-01-28,RUFFS,brawlBall,Super Beach,7,206,237,450,74430
2340,2023-01-28,RUFFS,brawlBall,Sneaky Fields,0,11,15,26,3582
2341,2023-01-28,RUFFS,bounty,Canal Grande,0,31,59,90,10902
2342,2023-01-27,RUFFS,knockout,Flaring Phoenix,0,19,26,45,5928
2343,2023-01-27,RUFFS,hotZone,Controller Chaos,0,6,4,10,2676
2344,2023-01-27,RUFFS,heist,Hot Potato,0,9,7,16,3486
2345,2023-01-27,RUFFS,gemGrab,Undermine,0,5,1,6,942
2346,2023-01-27,RUFFS,gemGrab,Deep Diner,0,67,99,166,6846
2347,2023-01-27,RUFFS,brawlBall,Sneaky Fields,1,62,65,128,23514
2348,2023-01-27,RUFFS,brawlBall,Pinhole Punt,0,3,1,4,738
2349,2023-01-27,RUFFS,bounty,Temple Ruins,0,4,4,8,1890
2350,2023-01-26,RUFFS,knockout,Riverside,0,18,34,52,19008
2351,2023-01-26,RUFFS,hotZone,Open Zone,0,7,9,16,10182
2352,2023-01-26,RUFFS,heist,Hot Potato,0,29,26,55,14610
2353,2023-01-26,RUFFS,gemGrab,Undermine,0,12,19,31,10062
2354,2023-01-26,RUFFS,gemGrab,Gem Fort,0,19,24,43,4674
2355,2023-01-26,RUFFS,brawlBall,Sunny Soccer,0,5,10,15,3660
2356,2023-01-26,RUFFS,brawlBall,Pinhole Punt,11,226,286,523,67338
2357,2023-01-26,RUFFS,bounty,Temple Ruins,0,14,10,24,5610
2358,2023-01-25,RUFFS,knockout,Riverside,0,7,8,15,9906
2359,2023-01-25,RUFFS,hotZone,Open Zone,0,12,6,18,5262
2360,2023-01-25,RUFFS,heist,Safe Zone,0,19,23,42,9156
2361,2023-01-25,RUFFS,gemGrab,Gem Fort,0,15,12,27,5556
2362,2023-01-25,RUFFS,gemGrab,Crystal Arcade,0,48,71,119,7866
2363,2023-01-25,RUFFS,brawlBall,Sunny Soccer,3,135,139,277,40830
2364,2023-01-25,RUFFS,brawlBall,Beach Ball,2,25,22,49,6408
2365,2023-01-25,RUFFS,bounty,Excel,0,27,51,78,5790
2366,2023-01-24,RUFFS,knockout,New Perspective,0,47,32,79,10542
2367,2023-01-24,RUFFS,hotZone,Dueling Beetles,0,34,14,48,10662
2368,2023-01-24,RUFFS,heist,Safe Zone,0,24,43,67,15750
2369,2023-01-24,RUFFS,gemGrab,Minecart Madness,0,10,6,16,4002
2370,2023-01-24,RUFFS,gemGrab,Crystal Arcade,0,79,88,167,14460
2371,2023-01-24,RUFFS,brawlBall,Center Stage,1,19,30,50,7860
2372,2023-01-24,RUFFS,brawlBall,Beach Ball,8,193,304,505,64614
2373,2023-01-24,RUFFS,bounty,Excel,0,42,70,112,10896
2374,2023-01-23,RUFFS,knockout,New Perspective,0,45,53,98,20676
2375,2023-01-23,RUFFS,hotZone,Dueling Beetles,0,34,27,61,17502
2376,2023-01-23,RUFFS,heist,Snaked Assault,0,6,3,9,15762
2377,2023-01-23,RUFFS,gemGrab,Minecart Madness,0,44,86,130,19062
2378,2023-01-23,RUFFS,gemGrab,Double Swoosh,0,13,14,27,7578
2379,2023-01-23,RUFFS,brawlBall,Center Stage,7,265,338,610,92862
2380,2023-01-23,RUFFS,brawlBall,Backyard Bowl,0,15,10,25,4224
2381,2023-01-23,RUFFS,bounty,Layer Cake,0,25,15,40,11142
2382,2023-01-22,RUFFS,knockout,X Marks the Spot,0,5,7,12,9174
2383,2023-01-22,RUFFS,hotZone,Ring of Fire,0,21,25,46,5730
2384,2023-01-22,RUFFS,heist,Snaked Assault,0,6,4,10,8232
2385,2023-01-22,RUFFS,gemGrab,Hard Rock Mine,0,43,93,136,4722
2386,2023-01-22,RUFFS,gemGrab,Double Swoosh,0,18,21,39,9426
2387,2023-01-22,RUFFS,brawlBall,Super Beach,3,13,24,40,7386
2388,2023-01-22,RUFFS,brawlBall,Backyard Bowl,7,75,125,207,34788
2389,2023-01-22,RUFFS,bounty,Layer Cake,0,27,53,80,6654
2390,2023-01-21,RUFFS,knockout,X Marks the Spot,0,40,45,85,31698
2391,2023-01-21,RUFFS,hotZone,Ring of Fire,1,87,111,199,16632
2392,2023-01-21,RUFFS,heist,Tornado Ring,0,5,10,15,11664
2393,2023-01-21,RUFFS,gemGrab,Hard Rock Mine,0,271,474,745,22980
2394,2023-01-21,RUFFS,gemGrab,Deep Diner,0,20,46,66,4470
2395,2023-01-21,RUFFS,brawlBall,Super Beach,9,236,266,511,101364
2396,2023-01-21,RUFFS,brawlBall,Sneaky Fields,0,2,7,9,3750
2397,2023-01-21,RUFFS,bounty,Dry Season,0,48,63,111,14538
2398,2023-01-20,RUFFS,knockout,Out in the Open,1,59,66,126,20106
2399,2023-01-20,RUFFS,hotZone,Split,0,74,130,204,9678
2400,2023-01-20,RUFFS,heist,Tornado Ring,0,8,12,20,12672
2401,2023-01-20,RUFFS,gemGrab,Undermine,0,6,14,20,5442
2402,2023-01-20,RUFFS,gemGrab,Deep Diner,0,168,338,506,19050
2403,2023-01-20,RUFFS,brawlBall,Sneaky Fields,2,162,212,376,74778
2404,2023-01-20,RUFFS,brawlBall,Pinhole Punt,0,5,4,9,2886
2405,2023-01-20,RUFFS,bounty,Dry Season,0,74,140,214,11640
2406,2023-01-19,RUFFS,knockout,Out in the Open,0,51,55,106,26574
2407,2023-01-19,RUFFS,hotZone,Split,0,97,189,286,14856
2408,2023-01-19,RUFFS,heist,Kaboom Canyon,0,10,6,16,6732
2409,2023-01-19,RUFFS,gemGrab,Undermine,0,19,29,48,14154
2410,2023-01-19,RUFFS,gemGrab,Gem Fort,0,6,17,23,2934
2411,2023-01-19,RUFFS,brawlBall,Sunny Soccer,0,6,7,13,2274
2412,2023-01-19,RUFFS,brawlBall,Pinhole Punt,10,242,366,618,72498
2413,2023-01-19,RUFFS,bounty,Shooting Star,0,12,13,25,11124
2414,2023-01-18,RUFFS,knockout,Goldarm Gulch,0,10,11,21,2784
2415,2023-01-18,RUFFS,hotZone,Parallel Plays,0,7,3,10,1158
2416,2023-01-18,RUFFS,heist,Kaboom Canyon,0,1,0,1,2592
2417,2023-01-18,RUFFS,gemGrab,Gem Fort,0,9,18,27,3006
2418,2023-01-18,RUFFS,gemGrab,Crystal Arcade,0,5,6,11,990
2419,2023-01-18,RUFFS,brawlBall,Sunny Soccer,2,64,76,142,18941
2420,2023-01-18,RUFFS,brawlBall,Beach Ball,0,1,4,5,774
2421,2023-01-18,RUFFS,bounty,Shooting Star,0,3,7,10,5088
2422,2023-01-17,RUFFS,knockout,Goldarm Gulch,0,11,9,20,2520
2423,2023-01-17,RUFFS,hotZone,Parallel Plays,0,14,7,21,1038
2424,2023-01-17,RUFFS,heist,Pit Stop,0,2,3,5,1290
2425,2023-01-17,RUFFS,gemGrab,Crystal Arcade,0,7,8,15,1266
2426,2023-01-17,RUFFS,brawlBall,Center Stage,0,1,0,1,288
2427,2023-01-17,RUFFS,brawlBall,Beach Ball,3,18,20,41,5886
2428,2023-01-17,RUFFS,bounty,Hideout,0,1,1,2,750
2429,2023-01-16,RUFFS,knockout,Belle's Rock,0,1,2,3,1788
2430,2023-01-16,RUFFS,hotZone,Quarter Pounder,0,7,7,14,1494
2431,2023-01-16,RUFFS,heist,Pit Stop,0,11,14,25,4044
2432,2023-01-16,RUFFS,gemGrab,Minecart Madness,0,3,6,9,1422
2433,2023-01-16,RUFFS,gemGrab,Double Swoosh,0,1,0,1,708
2434,2023-01-16,RUFFS,brawlBall,Center Stage,0,15,13,28,5778
2435,2023-01-16,RUFFS,brawlBall,Backyard Bowl,0,0,1,1,852
2436,2023-01-16,RUFFS,bounty,Hideout,0,1,0,1,1470
2437,2023-01-15,RUFFS,knockout,Belle's Rock,0,3,2,5,2904
2438,2023-01-15,RUFFS,hotZone,Quarter Pounder,0,7,9,16,3318
2439,2023-01-15,RUFFS,heist,Bridge Too Far,0,1,1,2,2736
2440,2023-01-15,RUFFS,gemGrab,Hard Rock Mine,0,13,11,24,1014
2441,2023-01-15,RUFFS,gemGrab,Double Swoosh,0,3,4,7,2178
2442,2023-01-15,RUFFS,brawlBall,Super Beach,0,0,1,1,1074
2443,2023-01-15,RUFFS,brawlBall,Backyard Bowl,1,16,24,41,8946
2444,2023-01-15,RUFFS,bounty,Canal Grande,0,3,2,5,960
2445,2023-01-14,RUFFS,knockout,Flaring Phoenix,1,0,2,3,1080
2446,2023-01-14,RUFFS,hotZone,Controller Chaos,0,3,4,7,2772
2447,2023-01-14,RUFFS,heist,Bridge Too Far,0,1,0,1,4020
2448,2023-01-14,RUFFS,gemGrab,Hard Rock Mine,0,18,43,61,1272
2449,2023-01-14,RUFFS,gemGrab,Deep Diner,0,1,4,5,858
2450,2023-01-14,RUFFS,brawlBall,Super Beach,0,14,18,32,6336
2451,2023-01-14,RUFFS,bounty,Canal Grande,0,3,2,5,1014
2452,2023-01-13,RUFFS,knockout,Flaring Phoenix,0,5,6,11,1182
2453,2023-01-13,RUFFS,hotZone,Controller Chaos,0,8,9,17,2928
2454,2023-01-13,RUFFS,heist,Hot Potato,0,1,0,1,600
2455,2023-01-13,RUFFS,gemGrab,Deep Diner,0,5,21,26,1650
2456,2023-01-13,RUFFS,brawlBall,Sneaky Fields,0,8,9,17,6144
2457,2023-01-13,RUFFS,bounty,Temple Ruins,0,1,0,1,270
2458,2023-01-12,RUFFS,knockout,Riverside,0,1,0,1,2532
2459,2023-01-12,RUFFS,gemGrab,Undermine,0,4,2,6,690
2460,2023-01-12,RUFFS,gemGrab,Gem Fort,0,1,0,1,162
2461,2023-01-12,RUFFS,brawlBall,Pinhole Punt,0,3,19,22,2292
2462,2023-01-11,RUFFS,hotZone,Open Zone,0,1,0,1,462
2463,2023-01-11,RUFFS,gemGrab,Gem Fort,0,1,1,2,414
2464,2023-01-11,RUFFS,brawlBall,Sunny Soccer,0,13,20,33,1638
2465,2023-01-11,RUFFS,bounty,Excel,0,2,3,5,282
2466,2023-01-10,RUFFS,knockout,New Perspective,0,2,8,10,720
2467,2023-01-10,RUFFS,hotZone,Dueling Beetles,0,6,6,12,2424
2468,2023-01-10,RUFFS,heist,Safe Zone,0,9,20,29,1176
2469,2023-01-10,RUFFS,gemGrab,Minecart Madness,0,2,6,8,828
2470,2023-01-10,RUFFS,gemGrab,Crystal Arcade,0,1,0,1,1746
2471,2023-01-10,RUFFS,brawlBall,Center Stage,0,2,0,2,708
2472,2023-01-10,RUFFS,brawlBall,Beach Ball,1,17,60,78,4392
2473,2023-01-10,RUFFS,bounty,Excel,0,3,0,3,330
2474,2023-01-09,RUFFS,knockout,New Perspective,0,1,0,1,876
2475,2023-01-09,RUFFS,hotZone,Dueling Beetles,0,2,4,6,1554
2476,2023-01-09,RUFFS,heist,Snaked Assault,0,1,1,2,2022
2477,2023-01-09,RUFFS,gemGrab,Minecart Madness,1,6,6,13,1884
2478,2023-01-09,RUFFS,gemGrab,Double Swoosh,0,2,0,2,1320
2479,2023-01-09,RUFFS,brawlBall,Center Stage,1,6,15,22,5460
2480,2023-01-09,RUFFS,bounty,Layer Cake,0,1,3,4,1512
2481,2023-01-08,RUFFS,knockout,X Marks the Spot,0,3,2,5,1692
2482,2023-01-08,RUFFS,hotZone,Ring of Fire,0,5,21,26,1644
2483,2023-01-08,RUFFS,gemGrab,Hard Rock Mine,0,7,16,23,630
2484,2023-01-08,RUFFS,brawlBall,Backyard Bowl,1,6,4,11,4830
2485,2023-01-08,RUFFS,bounty,Layer Cake,0,2,0,2,528
2486,2023-01-07,RUFFS,knockout,X Marks the Spot,0,2,5,7,1014
2487,2023-01-07,RUFFS,hotZone,Ring of Fire,0,5,8,13,846
2488,2023-01-07,RUFFS,heist,Tornado Ring,0,1,0,1,1350
2489,2023-01-07,RUFFS,gemGrab,Hard Rock Mine,0,7,25,32,1158
2490,2023-01-07,RUFFS,gemGrab,Deep Diner,0,7,6,13,918
2491,2023-01-07,RUFFS,brawlBall,Super Beach,0,2,2,4,2622
2492,2023-01-07,RUFFS,bounty,Dry Season,0,13,11,24,1320
2493,2023-01-06,RUFFS,hotZone,Split,0,7,12,19,1158
2494,2023-01-06,RUFFS,heist,Tornado Ring,0,2,1,3,2538
2495,2023-01-06,RUFFS,gemGrab,Deep Diner,0,23,15,38,2226
2496,2023-01-06,RUFFS,brawlBall,Sneaky Fields,0,2,0,2,4896
2497,2023-01-06,RUFFS,brawlBall,Pinhole Punt,0,2,0,2,510
2498,2023-01-06,RUFFS,bounty,Dry Season,0,13,24,37,1944
2499,2023-01-05,RUFFS,knockout,Out in the Open,0,6,3,9,2958
2500,2023-01-05,RUFFS,hotZone,Split,0,28,67,95,3552
2501,2023-01-05,RUFFS,heist,Kaboom Canyon,0,1,3,4,954
2502,2023-01-05,RUFFS,gemGrab,Undermine,0,2,1,3,1812
2503,2023-01-05,RUFFS,brawlBall,Sunny Soccer,0,1,0,1,84
2504,2023-01-05,RUFFS,brawlBall,Pinhole Punt,0,49,63,112,8118
2505,2023-01-04,RUFFS,knockout,Goldarm Gulch,0,1,1,2,696
2506,2023-01-04,RUFFS,hotZone,Parallel Plays,0,1,2,3,864
2507,2023-01-04,RUFFS,gemGrab,Crystal Arcade,0,3,0,3,642
2508,2023-01-04,RUFFS,brawlBall,Sunny Soccer,1,27,35,63,6312
2509,2023-01-04,RUFFS,bounty,Shooting Star,0,1,0,1,3570
2510,2023-01-03,RUFFS,knockout,Goldarm Gulch,0,6,2,8,720
2511,2023-01-03,RUFFS,hotZone,Parallel Plays,0,8,2,10,1542
2512,2023-01-03,RUFFS,heist,Pit Stop,0,4,1,5,1956
2513,2023-01-03,RUFFS,gemGrab,Crystal Arcade,0,9,18,27,2406
2514,2023-01-03,RUFFS,brawlBall,Center Stage,0,3,0,3,294
2515,2023-01-03,RUFFS,brawlBall,Beach Ball,0,24,26,50,5580
2516,2023-01-02,RUFFS,knockout,Belle's Rock,0,7,2,9,1794
2517,2023-01-02,RUFFS,hotZone,Quarter Pounder,0,10,5,15,2652
2518,2023-01-02,RUFFS,heist,Pit Stop,0,3,5,8,3498
2519,2023-01-02,RUFFS,gemGrab,Minecart Madness,0,4,6,10,2352
2520,2023-01-02,RUFFS,gemGrab,Double Swoosh,0,6,5,11,1512
2521,2023-01-02,RUFFS,brawlBall,Center Stage,1,15,11,27,7110
2522,2023-01-02,RUFFS,brawlBall,Backyard Bowl,0,2,0,2,492
2523,2023-01-02,RUFFS,bounty,Hideout,0,1,1,2,3090
2524,2023-01-01,RUFFS,knockout,Belle's Rock,0,1,0,1,858
2525,2023-01-01,RUFFS,hotZone,Quarter Pounder,0,3,16,19,1188
2526,2023-01-01,RUFFS,gemGrab,Hard Rock Mine,0,1,1,2,48
2527,2023-01-01,RUFFS,brawlBall,Backyard Bowl,0,5,5,10,2658
2528,2022-12-31,RUFFS,gemGrab,Minecart Madness,0,0,1,1,24
2529,2022-12-31,RUFFS,gemGrab,Hard Rock Mine,0,2,3,5,384
2530,2022-12-31,RUFFS,brawlBall,Super Beach,0,1,0,1,618
2531,2022-12-31,RUFFS,brawlBall,Sneaky Fields,0,1,0,1,60
2532,2022-12-30,RUFFS,hotZone,Controller Chaos,0,1,0,1,288
2533,2022-12-30,RUFFS,gemGrab,Undermine,0,0,1,1,102
2534,2022-12-30,RUFFS,gemGrab,Deep Diner,0,1,0,1,438
2535,2022-12-30,RUFFS,brawlBall,Sneaky Fields,0,2,0,2,552
2536,2022-12-29,RUFFS,brawlBall,Pinhole Punt,0,1,0,1,282
2537,2022-12-25,RUFFS,brawlBall,Backyard Bowl,0,1,1,2,78
2538,2022-12-22,RUFFS,brawlBall,Pinhole Punt,0,0,1,1,132
2539,2022-12-19,RUFFS,brawlBall,Center Stage,0,2,1,3,102
2540,2022-11-01,RUFFS,knockout,New Perspective,0,1,0,1,54
2541,2022-10-30,RUFFS,knockout,Out in the Open,0,1,0,1,12
2542,2022-10-15,RUFFS,gemGrab,Hard Rock Mine,0,7,8,15,90
2543,2022-10-15,RUFFS,brawlBall,Super Beach,0,2,0,2,12
2544,2023-01-28,ROSA,knockout,Flaring Phoenix,0,15,48,63,12366
2545,2023-01-28,ROSA,hotZone,Controller Chaos,0,45,61,106,10134
2546,2023-01-28,ROSA,heist,Bridge Too Far,0,8,2,10,24240
2547,2023-01-28,ROSA,gemGrab,Hard Rock Mine,0,102,98,200,16638
2548,2023-01-28,ROSA,gemGrab,Deep Diner,0,8,7,15,5478
2549,2023-01-28,ROSA,brawlBall,Super Beach,3,108,77,188,74430
2550,2023-01-28,ROSA,brawlBall,Sneaky Fields,0,36,33,69,3582
2551,2023-01-28,ROSA,bounty,Canal Grande,0,65,103,168,10902
2552,2023-01-27,ROSA,knockout,Flaring Phoenix,0,2,1,3,5928
2553,2023-01-27,ROSA,hotZone,Controller Chaos,0,13,20,33,2676
2554,2023-01-27,ROSA,heist,Hot Potato,0,2,0,2,3486
2555,2023-01-27,ROSA,gemGrab,Undermine,0,1,1,2,942
2556,2023-01-27,ROSA,gemGrab,Deep Diner,0,6,14,20,6846
2557,2023-01-27,ROSA,brawlBall,Sneaky Fields,5,214,279,498,23514
2558,2023-01-27,ROSA,brawlBall,Pinhole Punt,0,1,0,1,738
2559,2023-01-27,ROSA,bounty,Temple Ruins,0,7,19,26,1890
2560,2023-01-26,ROSA,knockout,Riverside,0,3,0,3,19008
2561,2023-01-26,ROSA,hotZone,Open Zone,0,13,4,17,10182
2562,2023-01-26,ROSA,heist,Hot Potato,0,2,6,8,14610
2563,2023-01-26,ROSA,gemGrab,Undermine,0,68,59,127,10062
2564,2023-01-26,ROSA,gemGrab,Gem Fort,0,73,106,179,4674
2565,2023-01-26,ROSA,brawlBall,Sunny Soccer,0,3,1,4,3660
2566,2023-01-26,ROSA,brawlBall,Pinhole Punt,7,120,165,292,67338
2567,2023-01-26,ROSA,bounty,Temple Ruins,0,17,24,41,5610
2568,2023-01-25,ROSA,knockout,Riverside,0,0,1,1,9906
2569,2023-01-25,ROSA,hotZone,Open Zone,0,1,5,6,5262
2570,2023-01-25,ROSA,heist,Safe Zone,0,1,2,3,9156
2571,2023-01-25,ROSA,gemGrab,Gem Fort,0,71,123,194,5556
2572,2023-01-25,ROSA,gemGrab,Crystal Arcade,0,29,33,62,7866
2573,2023-01-25,ROSA,brawlBall,Sunny Soccer,1,48,53,102,40830
2574,2023-01-25,ROSA,brawlBall,Beach Ball,0,2,4,6,6408
2575,2023-01-25,ROSA,bounty,Excel,0,1,2,3,5790
2576,2023-01-24,ROSA,knockout,New Perspective,0,13,15,28,10542
2577,2023-01-24,ROSA,hotZone,Dueling Beetles,0,19,15,34,10662
2578,2023-01-24,ROSA,heist,Safe Zone,0,6,0,6,15750
2579,2023-01-24,ROSA,gemGrab,Minecart Madness,0,1,1,2,4002
2580,2023-01-24,ROSA,gemGrab,Crystal Arcade,0,56,119,175,14460
2581,2023-01-24,ROSA,brawlBall,Center Stage,1,39,55,95,7860
2582,2023-01-24,ROSA,brawlBall,Beach Ball,2,72,82,156,64614
2583,2023-01-24,ROSA,bounty,Excel,0,1,5,6,10896
2584,2023-01-23,ROSA,knockout,New Perspective,0,11,14,25,20676
2585,2023-01-23,ROSA,hotZone,Dueling Beetles,0,33,40,73,17502
2586,2023-01-23,ROSA,heist,Snaked Assault,0,14,3,17,15762
2587,2023-01-23,ROSA,gemGrab,Minecart Madness,0,9,12,21,19062
2588,2023-01-23,ROSA,gemGrab,Double Swoosh,0,60,82,142,7578
2589,2023-01-23,ROSA,brawlBall,Center Stage,19,615,947,1581,92862
2590,2023-01-23,ROSA,brawlBall,Backyard Bowl,0,1,1,2,4224
2591,2023-01-23,ROSA,bounty,Layer Cake,0,12,11,23,11142
2592,2023-01-22,ROSA,knockout,X Marks the Spot,0,1,2,3,9174
2593,2023-01-22,ROSA,hotZone,Ring of Fire,0,15,12,27,5730
2594,2023-01-22,ROSA,heist,Snaked Assault,0,5,2,7,8232
2595,2023-01-22,ROSA,gemGrab,Hard Rock Mine,0,41,38,79,4722
2596,2023-01-22,ROSA,gemGrab,Double Swoosh,0,90,121,211,9426
2597,2023-01-22,ROSA,brawlBall,Super Beach,0,4,6,10,7386
2598,2023-01-22,ROSA,brawlBall,Backyard Bowl,0,7,21,28,34788
2599,2023-01-22,ROSA,bounty,Layer Cake,0,8,19,27,6654
2600,2023-01-21,ROSA,knockout,X Marks the Spot,0,9,7,16,31698
2601,2023-01-21,ROSA,hotZone,Ring of Fire,0,35,66,101,16632
2602,2023-01-21,ROSA,heist,Tornado Ring,0,23,14,37,11664
2603,2023-01-21,ROSA,gemGrab,Hard Rock Mine,0,153,166,319,22980
2604,2023-01-21,ROSA,gemGrab,Deep Diner,0,3,1,4,4470
2605,2023-01-21,ROSA,brawlBall,Super Beach,6,102,125,233,101364
2606,2023-01-21,ROSA,brawlBall,Sneaky Fields,0,40,51,91,3750
2607,2023-01-21,ROSA,bounty,Dry Season,0,4,2,6,14538
2608,2023-01-20,ROSA,knockout,Out in the Open,0,6,10,16,20106
2609,2023-01-20,ROSA,hotZone,Split,0,32,41,73,9678
2610,2023-01-20,ROSA,heist,Tornado Ring,0,12,12,24,12672
2611,2023-01-20,ROSA,gemGrab,Undermine,0,20,48,68,5442
2612,2023-01-20,ROSA,gemGrab,Deep Diner,0,19,12,31,19050
2613,2023-01-20,ROSA,brawlBall,Sneaky Fields,23,649,876,1548,74778
2614,2023-01-20,ROSA,brawlBall,Pinhole Punt,0,7,4,11,2886
2615,2023-01-20,ROSA,bounty,Dry Season,0,2,1,3,11640
2616,2023-01-19,ROSA,knockout,Out in the Open,0,11,18,29,26574
2617,2023-01-19,ROSA,hotZone,Split,0,51,65,116,14856
2618,2023-01-19,ROSA,heist,Kaboom Canyon,0,3,3,6,6732
2619,2023-01-19,ROSA,gemGrab,Undermine,0,68,108,176,14154
2620,2023-01-19,ROSA,gemGrab,Gem Fort,0,39,56,95,2934
2621,2023-01-19,ROSA,brawlBall,Sunny Soccer,0,0,4,4,2274
2622,2023-01-19,ROSA,brawlBall,Pinhole Punt,3,94,160,257,72498
2623,2023-01-19,ROSA,bounty,Shooting Star,0,2,1,3,11124
2624,2023-01-18,ROSA,knockout,Goldarm Gulch,0,2,2,4,2784
2625,2023-01-18,ROSA,hotZone,Parallel Plays,0,2,2,4,1158
2626,2023-01-18,ROSA,heist,Kaboom Canyon,0,3,0,3,2592
2627,2023-01-18,ROSA,gemGrab,Gem Fort,0,44,52,96,3006
2628,2023-01-18,ROSA,gemGrab,Crystal Arcade,0,1,0,1,990
2629,2023-01-18,ROSA,brawlBall,Sunny Soccer,1,39,46,86,18941
2630,2023-01-18,ROSA,brawlBall,Beach Ball,0,0,1,1,774
2631,2023-01-18,ROSA,bounty,Shooting Star,0,2,2,4,5088
2632,2023-01-17,ROSA,knockout,Goldarm Gulch,0,4,0,4,2520
2633,2023-01-17,ROSA,hotZone,Parallel Plays,0,3,7,10,1038
2634,2023-01-17,ROSA,heist,Pit Stop,0,0,1,1,1290
2635,2023-01-17,ROSA,gemGrab,Crystal Arcade,0,2,2,4,1266
2636,2023-01-17,ROSA,brawlBall,Center Stage,0,1,2,3,288
2637,2023-01-17,ROSA,brawlBall,Beach Ball,0,6,8,14,5886
2638,2023-01-17,ROSA,bounty,Hideout,0,0,1,1,750
2639,2023-01-16,ROSA,knockout,Belle's Rock,0,2,0,2,1788
2640,2023-01-16,ROSA,hotZone,Quarter Pounder,0,1,1,2,1494
2641,2023-01-16,ROSA,gemGrab,Double Swoosh,0,2,1,3,708
2642,2023-01-16,ROSA,brawlBall,Center Stage,1,30,61,92,5778
2643,2023-01-16,ROSA,bounty,Hideout,0,1,0,1,1470
2644,2023-01-15,ROSA,hotZone,Quarter Pounder,0,2,0,2,3318
2645,2023-01-15,ROSA,gemGrab,Hard Rock Mine,0,8,24,32,1014
2646,2023-01-15,ROSA,gemGrab,Double Swoosh,0,21,47,68,2178
2647,2023-01-15,ROSA,brawlBall,Backyard Bowl,0,3,0,3,8946
2648,2023-01-15,ROSA,bounty,Canal Grande,0,8,22,30,960
2649,2023-01-14,ROSA,knockout,Flaring Phoenix,0,2,0,2,1080
2650,2023-01-14,ROSA,hotZone,Controller Chaos,0,13,32,45,2772
2651,2023-01-14,ROSA,gemGrab,Hard Rock Mine,0,7,33,40,1272
2652,2023-01-14,ROSA,gemGrab,Deep Diner,0,1,0,1,858
2653,2023-01-14,ROSA,brawlBall,Super Beach,0,5,2,7,6336
2654,2023-01-14,ROSA,brawlBall,Sneaky Fields,0,8,9,17,918
2655,2023-01-14,ROSA,bounty,Canal Grande,0,3,3,6,1014
2656,2023-01-13,ROSA,hotZone,Controller Chaos,0,11,16,27,2928
2657,2023-01-13,ROSA,gemGrab,Deep Diner,0,7,0,7,1650
2658,2023-01-13,ROSA,brawlBall,Sneaky Fields,0,75,98,173,6144
2659,2023-01-13,ROSA,bounty,Temple Ruins,0,0,1,1,270
2660,2023-01-12,ROSA,hotZone,Open Zone,0,2,0,2,1488
2661,2023-01-12,ROSA,gemGrab,Undermine,0,0,1,1,690
2662,2023-01-12,ROSA,gemGrab,Gem Fort,0,3,5,8,162
2663,2023-01-12,ROSA,brawlBall,Pinhole Punt,0,4,0,4,2292
2664,2023-01-11,ROSA,gemGrab,Gem Fort,0,4,4,8,414
2665,2023-01-11,ROSA,brawlBall,Sunny Soccer,0,2,0,2,1638
2666,2023-01-10,ROSA,hotZone,Dueling Beetles,0,4,3,7,2424
2667,2023-01-10,ROSA,heist,Safe Zone,0,0,1,1,1176
2668,2023-01-10,ROSA,gemGrab,Crystal Arcade,0,7,2,9,1746
2669,2023-01-10,ROSA,brawlBall,Center Stage,0,5,2,7,708
2670,2023-01-10,ROSA,brawlBall,Beach Ball,0,5,1,6,4392
2671,2023-01-09,ROSA,hotZone,Dueling Beetles,0,8,3,11,1554
2672,2023-01-09,ROSA,gemGrab,Double Swoosh,0,3,3,6,1320
2673,2023-01-09,ROSA,brawlBall,Center Stage,0,35,57,92,5460
2674,2023-01-09,ROSA,bounty,Layer Cake,0,3,4,7,1512
2675,2023-01-08,ROSA,hotZone,Ring of Fire,0,3,5,8,1644
2676,2023-01-08,ROSA,heist,Snaked Assault,0,0,1,1,1494
2677,2023-01-08,ROSA,gemGrab,Hard Rock Mine,0,5,1,6,630
2678,2023-01-08,ROSA,gemGrab,Double Swoosh,0,7,5,12,864
2679,2023-01-08,ROSA,brawlBall,Super Beach,0,1,0,1,732
2680,2023-01-08,ROSA,bounty,Layer Cake,0,1,6,7,528
2681,2023-01-07,ROSA,hotZone,Ring of Fire,0,2,0,2,846
2682,2023-01-07,ROSA,heist,Tornado Ring,0,3,1,4,1350
2683,2023-01-07,ROSA,gemGrab,Hard Rock Mine,0,4,2,6,1158
2684,2023-01-07,ROSA,gemGrab,Deep Diner,0,2,0,2,918
2685,2023-01-07,ROSA,brawlBall,Super Beach,0,2,0,2,2622
2686,2023-01-07,ROSA,brawlBall,Sneaky Fields,0,4,1,5,402
2687,2023-01-06,ROSA,hotZone,Split,0,2,0,2,1158
2688,2023-01-06,ROSA,heist,Tornado Ring,0,1,0,1,2538
2689,2023-01-06,ROSA,gemGrab,Undermine,0,3,1,4,540
2690,2023-01-06,ROSA,brawlBall,Sneaky Fields,2,51,46,99,4896
2691,2023-01-06,ROSA,brawlBall,Pinhole Punt,0,1,0,1,510
2692,2023-01-05,ROSA,knockout,Out in the Open,0,1,0,1,2958
2693,2023-01-05,ROSA,hotZone,Split,0,6,5,11,3552
2694,2023-01-05,ROSA,gemGrab,Undermine,0,2,0,2,1812
2695,2023-01-05,ROSA,gemGrab,Gem Fort,0,2,1,3,252
2696,2023-01-05,ROSA,brawlBall,Pinhole Punt,0,12,6,18,8118
2697,2023-01-04,ROSA,hotZone,Parallel Plays,0,1,1,2,864
2698,2023-01-04,ROSA,gemGrab,Gem Fort,0,20,22,42,1788
2699,2023-01-04,ROSA,brawlBall,Sunny Soccer,0,5,3,8,6312
2700,2023-01-04,ROSA,bounty,Shooting Star,0,1,0,1,3570
2701,2023-01-03,ROSA,knockout,Goldarm Gulch,0,1,0,1,720
2702,2023-01-03,ROSA,hotZone,Parallel Plays,0,2,0,2,1542
2703,2023-01-03,ROSA,heist,Pit Stop,0,2,1,3,1956
2704,2023-01-03,ROSA,gemGrab,Crystal Arcade,0,13,1,14,2406
2705,2023-01-03,ROSA,brawlBall,Center Stage,0,1,1,2,294
2706,2023-01-03,ROSA,brawlBall,Beach Ball,0,8,1,9,5580
2707,2023-01-02,ROSA,hotZone,Quarter Pounder,0,1,0,1,2652
2708,2023-01-02,ROSA,heist,Pit Stop,0,1,0,1,3498
2709,2023-01-02,ROSA,heist,Kaboom Canyon,0,1,0,1,30
2710,2023-01-02,ROSA,gemGrab,Double Swoosh,0,10,2,12,1512
2711,2023-01-02,ROSA,brawlBall,Center Stage,1,52,53,106,7110
2712,2023-01-02,ROSA,bounty,Hideout,0,1,0,1,3090
2713,2023-01-01,ROSA,hotZone,Quarter Pounder,0,7,10,17,1188
2714,2023-01-01,ROSA,gemGrab,Double Swoosh,0,8,2,10,1140
2715,2023-01-01,ROSA,brawlBall,Backyard Bowl,0,0,1,1,2658
2716,2023-01-01,ROSA,bounty,Canal Grande,0,2,0,2,132
2717,2022-12-31,ROSA,hotZone,Controller Chaos,0,0,1,1,198
2718,2022-12-31,ROSA,gemGrab,Minecart Madness,0,1,0,1,24
2719,2022-12-31,ROSA,gemGrab,Hard Rock Mine,0,2,0,2,384
2720,2022-12-30,ROSA,hotZone,Controller Chaos,0,0,1,1,288
2721,2022-12-30,ROSA,gemGrab,Undermine,0,1,0,1,102
2722,2022-12-30,ROSA,brawlBall,Sneaky Fields,0,3,5,8,552
2723,2022-12-29,ROSA,heist,Hot Potato,0,0,3,3,72
2724,2022-12-27,ROSA,brawlBall,Center Stage,0,0,1,1,30
2725,2022-12-26,ROSA,brawlBall,Center Stage,0,0,2,2,78
2726,2022-12-22,ROSA,gemGrab,Gem Fort,0,6,1,7,90
2727,2022-12-19,ROSA,brawlBall,Center Stage,0,1,0,1,102
2728,2022-12-16,ROSA,brawlBall,Sneaky Fields,0,0,1,1,84
2729,2022-12-13,ROSA,gemGrab,Crystal Arcade,0,0,1,1,72
2730,2022-12-10,ROSA,gemGrab,Hard Rock Mine,0,0,1,1,24
2731,2022-10-30,ROSA,bounty,Canal Grande,0,1,1,2,12
2732,2023-01-28,RICO,knockout,Flaring Phoenix,0,13,13,26,12366
2733,2023-01-28,RICO,hotZone,Controller Chaos,0,17,4,21,10134
2734,2023-01-28,RICO,heist,Bridge Too Far,0,84,28,112,24240
2735,2023-01-28,RICO,gemGrab,Hard Rock Mine,0,799,896,1695,16638
2736,2023-01-28,RICO,gemGrab,Deep Diner,0,36,27,63,5478
2737,2023-01-28,RICO,brawlBall,Super Beach,13,318,302,633,74430
2738,2023-01-28,RICO,brawlBall,Sneaky Fields,2,55,58,115,3582
2739,2023-01-28,RICO,bounty,Canal Grande,0,18,8,26,10902
2740,2023-01-27,RICO,knockout,Flaring Phoenix,0,5,6,11,5928
2741,2023-01-27,RICO,hotZone,Controller Chaos,0,11,3,14,2676
2742,2023-01-27,RICO,heist,Hot Potato,0,67,94,161,3486
2743,2023-01-27,RICO,gemGrab,Undermine,0,8,3,11,942
2744,2023-01-27,RICO,gemGrab,Deep Diner,0,33,48,81,6846
2745,2023-01-27,RICO,brawlBall,Sneaky Fields,9,354,350,713,23514
2746,2023-01-27,RICO,brawlBall,Pinhole Punt,0,5,6,11,738
2747,2023-01-27,RICO,bounty,Temple Ruins,0,14,45,59,1890
2748,2023-01-26,RICO,knockout,Riverside,0,32,27,59,19008
2749,2023-01-26,RICO,hotZone,Open Zone,0,12,4,16,10182
2750,2023-01-26,RICO,heist,Hot Potato,0,362,311,673,14610
2751,2023-01-26,RICO,gemGrab,Undermine,0,56,76,132,10062
2752,2023-01-26,RICO,gemGrab,Gem Fort,0,68,80,148,4674
2753,2023-01-26,RICO,brawlBall,Sunny Soccer,0,18,32,50,3660
2754,2023-01-26,RICO,brawlBall,Pinhole Punt,16,490,568,1074,67338
2755,2023-01-26,RICO,bounty,Temple Ruins,0,55,77,132,5610
2756,2023-01-25,RICO,knockout,Riverside,0,8,5,13,9906
2757,2023-01-25,RICO,hotZone,Open Zone,0,5,2,7,5262
2758,2023-01-25,RICO,heist,Safe Zone,3,229,321,553,9156
2759,2023-01-25,RICO,gemGrab,Gem Fort,0,80,72,152,5556
2760,2023-01-25,RICO,gemGrab,Crystal Arcade,0,26,31,57,7866
2761,2023-01-25,RICO,brawlBall,Sunny Soccer,10,272,291,573,40830
2762,2023-01-25,RICO,brawlBall,Beach Ball,2,26,26,54,6408
2763,2023-01-25,RICO,bounty,Excel,0,82,70,152,5790
2764,2023-01-24,RICO,knockout,New Perspective,0,63,56,119,10542
2765,2023-01-24,RICO,hotZone,Dueling Beetles,0,18,10,28,10662
2766,2023-01-24,RICO,heist,Safe Zone,1,519,677,1197,15750
2767,2023-01-24,RICO,gemGrab,Minecart Madness,0,7,1,8,4002
2768,2023-01-24,RICO,gemGrab,Crystal Arcade,0,52,52,104,14460
2769,2023-01-24,RICO,brawlBall,Center Stage,7,208,172,387,7860
2770,2023-01-24,RICO,brawlBall,Beach Ball,16,437,496,949,64614
2771,2023-01-24,RICO,bounty,Excel,0,218,287,505,10896
2772,2023-01-23,RICO,knockout,New Perspective,0,110,108,218,20676
2773,2023-01-23,RICO,hotZone,Dueling Beetles,1,28,9,38,17502
2774,2023-01-23,RICO,heist,Snaked Assault,0,24,12,36,15762
2775,2023-01-23,RICO,gemGrab,Minecart Madness,0,57,27,84,19062
2776,2023-01-23,RICO,gemGrab,Double Swoosh,0,12,8,20,7578
2777,2023-01-23,RICO,brawlBall,Center Stage,66,2205,2146,4417,92862
2778,2023-01-23,RICO,brawlBall,Backyard Bowl,0,16,18,34,4224
2779,2023-01-23,RICO,bounty,Layer Cake,0,31,30,61,11142
2780,2023-01-22,RICO,knockout,X Marks the Spot,0,12,6,18,9174
2781,2023-01-22,RICO,hotZone,Ring of Fire,0,54,65,119,5730
2782,2023-01-22,RICO,heist,Snaked Assault,0,14,8,22,8232
2783,2023-01-22,RICO,gemGrab,Hard Rock Mine,0,204,202,406,4722
2784,2023-01-22,RICO,gemGrab,Double Swoosh,0,24,19,43,9426
2785,2023-01-22,RICO,brawlBall,Super Beach,0,45,25,70,7386
2786,2023-01-22,RICO,brawlBall,Backyard Bowl,2,79,64,145,34788
2787,2023-01-22,RICO,bounty,Layer Cake,0,33,48,81,6654
2788,2023-01-21,RICO,knockout,X Marks the Spot,0,34,16,50,31698
2789,2023-01-21,RICO,hotZone,Ring of Fire,0,194,159,353,16632
2790,2023-01-21,RICO,heist,Tornado Ring,0,23,16,39,11664
2791,2023-01-21,RICO,gemGrab,Hard Rock Mine,0,994,1132,2126,22980
2792,2023-01-21,RICO,gemGrab,Deep Diner,0,31,18,49,4470
2793,2023-01-21,RICO,brawlBall,Super Beach,14,467,413,894,101364
2794,2023-01-21,RICO,brawlBall,Sneaky Fields,1,56,54,111,3750
2795,2023-01-21,RICO,bounty,Dry Season,0,18,9,27,14538
2796,2023-01-20,RICO,knockout,Out in the Open,0,44,23,67,20106
2797,2023-01-20,RICO,hotZone,Split,0,556,691,1247,9678
2798,2023-01-20,RICO,heist,Tornado Ring,0,25,9,34,12672
2799,2023-01-20,RICO,gemGrab,Undermine,0,29,51,80,5442
2800,2023-01-20,RICO,gemGrab,Deep Diner,0,91,72,163,19050
2801,2023-01-20,RICO,brawlBall,Sneaky Fields,33,922,956,1911,74778
2802,2023-01-20,RICO,brawlBall,Pinhole Punt,0,20,33,53,2886
2803,2023-01-20,RICO,bounty,Dry Season,0,22,18,40,11640
2804,2023-01-19,RICO,knockout,Out in the Open,0,43,43,86,26574
2805,2023-01-19,RICO,hotZone,Split,0,972,1034,2006,14856
2806,2023-01-19,RICO,heist,Kaboom Canyon,0,23,8,31,6732
2807,2023-01-19,RICO,gemGrab,Undermine,0,73,99,172,14154
2808,2023-01-19,RICO,gemGrab,Gem Fort,0,61,98,159,2934
2809,2023-01-19,RICO,brawlBall,Sunny Soccer,0,18,17,35,2274
2810,2023-01-19,RICO,brawlBall,Pinhole Punt,23,529,639,1191,72498
2811,2023-01-19,RICO,bounty,Shooting Star,0,12,7,19,11124
2812,2023-01-18,RICO,knockout,Goldarm Gulch,0,87,72,159,2784
2813,2023-01-18,RICO,hotZone,Parallel Plays,0,1,0,1,1158
2814,2023-01-18,RICO,heist,Kaboom Canyon,0,10,4,14,2592
2815,2023-01-18,RICO,gemGrab,Gem Fort,0,35,40,75,3006
2816,2023-01-18,RICO,gemGrab,Crystal Arcade,0,1,3,4,990
2817,2023-01-18,RICO,brawlBall,Sunny Soccer,4,98,88,190,18941
2818,2023-01-18,RICO,brawlBall,Beach Ball,1,1,7,9,774
2819,2023-01-18,RICO,bounty,Shooting Star,0,4,1,5,5088
2820,2023-01-17,RICO,knockout,Goldarm Gulch,0,68,69,137,2520
2821,2023-01-17,RICO,hotZone,Parallel Plays,0,2,1,3,1038
2822,2023-01-17,RICO,heist,Pit Stop,0,19,22,41,1290
2823,2023-01-17,RICO,gemGrab,Crystal Arcade,0,2,3,5,1266
2824,2023-01-17,RICO,brawlBall,Center Stage,0,4,3,7,288
2825,2023-01-17,RICO,brawlBall,Beach Ball,0,30,51,81,5886
2826,2023-01-17,RICO,bounty,Hideout,0,2,0,2,750
2827,2023-01-16,RICO,knockout,Belle's Rock,0,12,7,19,1788
2828,2023-01-16,RICO,hotZone,Quarter Pounder,0,13,39,52,1494
2829,2023-01-16,RICO,heist,Pit Stop,0,54,43,97,4044
2830,2023-01-16,RICO,gemGrab,Minecart Madness,0,1,1,2,1422
2831,2023-01-16,RICO,gemGrab,Double Swoosh,0,4,0,4,708
2832,2023-01-16,RICO,brawlBall,Center Stage,4,157,166,327,5778
2833,2023-01-16,RICO,brawlBall,Backyard Bowl,0,1,0,1,852
2834,2023-01-16,RICO,bounty,Hideout,0,2,3,5,1470
2835,2023-01-15,RICO,knockout,Belle's Rock,0,21,28,49,2904
2836,2023-01-15,RICO,hotZone,Quarter Pounder,0,25,23,48,3318
2837,2023-01-15,RICO,heist,Bridge Too Far,0,5,14,19,2736
2838,2023-01-15,RICO,gemGrab,Hard Rock Mine,0,39,43,82,1014
2839,2023-01-15,RICO,gemGrab,Double Swoosh,0,6,2,8,2178
2840,2023-01-15,RICO,brawlBall,Super Beach,0,2,1,3,1074
2841,2023-01-15,RICO,brawlBall,Backyard Bowl,0,16,6,22,8946
2842,2023-01-15,RICO,bounty,Canal Grande,0,1,6,7,960
2843,2023-01-14,RICO,knockout,Flaring Phoenix,0,0,2,2,1080
2844,2023-01-14,RICO,hotZone,Controller Chaos,0,8,5,13,2772
2845,2023-01-14,RICO,heist,Bridge Too Far,0,7,0,7,4020
2846,2023-01-14,RICO,gemGrab,Hard Rock Mine,0,73,74,147,1272
2847,2023-01-14,RICO,gemGrab,Deep Diner,0,5,6,11,858
2848,2023-01-14,RICO,brawlBall,Super Beach,1,28,16,45,6336
2849,2023-01-14,RICO,brawlBall,Sneaky Fields,2,19,42,63,918
2850,2023-01-14,RICO,bounty,Canal Grande,0,2,0,2,1014
2851,2023-01-13,RICO,knockout,Flaring Phoenix,0,2,0,2,1182
2852,2023-01-13,RICO,hotZone,Controller Chaos,0,5,4,9,2928
2853,2023-01-13,RICO,heist,Hot Potato,0,15,9,24,600
2854,2023-01-13,RICO,gemGrab,Deep Diner,0,9,3,12,1650
2855,2023-01-13,RICO,brawlBall,Sneaky Fields,1,122,116,239,6144
2856,2023-01-13,RICO,brawlBall,Pinhole Punt,0,1,1,2,156
2857,2023-01-13,RICO,bounty,Temple Ruins,0,3,19,22,270
2858,2023-01-12,RICO,knockout,Riverside,0,2,1,3,2532
2859,2023-01-12,RICO,heist,Hot Potato,0,8,32,40,330
2860,2023-01-12,RICO,gemGrab,Undermine,0,2,3,5,690
2861,2023-01-12,RICO,gemGrab,Gem Fort,0,6,5,11,162
2862,2023-01-12,RICO,brawlBall,Sunny Soccer,0,4,2,6,240
2863,2023-01-12,RICO,brawlBall,Pinhole Punt,0,30,40,70,2292
2864,2023-01-12,RICO,bounty,Temple Ruins,0,1,0,1,24
2865,2023-01-11,RICO,heist,Safe Zone,0,2,1,3,48
2866,2023-01-11,RICO,gemGrab,Gem Fort,0,5,2,7,414
2867,2023-01-11,RICO,brawlBall,Sunny Soccer,0,12,11,23,1638
2868,2023-01-11,RICO,brawlBall,Beach Ball,0,2,0,2,48
2869,2023-01-11,RICO,bounty,Excel,0,1,5,6,282
2870,2023-01-10,RICO,knockout,New Perspective,0,6,4,10,720
2871,2023-01-10,RICO,hotZone,Dueling Beetles,0,2,0,2,2424
2872,2023-01-10,RICO,heist,Safe Zone,0,38,75,113,1176
2873,2023-01-10,RICO,gemGrab,Minecart Madness,0,1,0,1,828
2874,2023-01-10,RICO,gemGrab,Crystal Arcade,0,7,2,9,1746
2875,2023-01-10,RICO,brawlBall,Center Stage,0,12,7,19,708
2876,2023-01-10,RICO,brawlBall,Beach Ball,2,26,41,69,4392
2877,2023-01-10,RICO,bounty,Excel,0,3,6,9,330
2878,2023-01-09,RICO,knockout,New Perspective,0,2,2,4,876
2879,2023-01-09,RICO,hotZone,Dueling Beetles,0,2,0,2,1554
2880,2023-01-09,RICO,heist,Snaked Assault,0,9,4,13,2022
2881,2023-01-09,RICO,gemGrab,Minecart Madness,0,3,1,4,1884
2882,2023-01-09,RICO,gemGrab,Double Swoosh,0,3,1,4,1320
2883,2023-01-09,RICO,brawlBall,Center Stage,5,122,129,256,5460
2884,2023-01-09,RICO,bounty,Layer Cake,0,5,15,20,1512
2885,2023-01-08,RICO,knockout,X Marks the Spot,0,1,0,1,1692
2886,2023-01-08,RICO,hotZone,Ring of Fire,0,10,0,10,1644
2887,2023-01-08,RICO,heist,Snaked Assault,0,3,1,4,1494
2888,2023-01-08,RICO,gemGrab,Hard Rock Mine,0,35,50,85,630
2889,2023-01-08,RICO,gemGrab,Double Swoosh,0,1,0,1,864
2890,2023-01-08,RICO,brawlBall,Super Beach,0,4,1,5,732
2891,2023-01-08,RICO,brawlBall,Backyard Bowl,0,12,9,21,4830
2892,2023-01-08,RICO,bounty,Layer Cake,0,0,1,1,528
2893,2023-01-07,RICO,knockout,X Marks the Spot,0,1,0,1,1014
2894,2023-01-07,RICO,hotZone,Ring of Fire,0,14,9,23,846
2895,2023-01-07,RICO,heist,Tornado Ring,0,1,0,1,1350
2896,2023-01-07,RICO,gemGrab,Hard Rock Mine,0,58,73,131,1158
2897,2023-01-07,RICO,gemGrab,Deep Diner,0,4,3,7,918
2898,2023-01-07,RICO,brawlBall,Super Beach,1,6,3,10,2622
2899,2023-01-07,RICO,brawlBall,Sneaky Fields,0,4,1,5,402
2900,2023-01-06,RICO,knockout,Out in the Open,0,1,0,1,1446
2901,2023-01-06,RICO,hotZone,Split,0,67,42,109,1158
2902,2023-01-06,RICO,heist,Tornado Ring,0,3,2,5,2538
2903,2023-01-06,RICO,gemGrab,Undermine,0,1,0,1,540
2904,2023-01-06,RICO,gemGrab,Deep Diner,0,16,27,43,2226
2905,2023-01-06,RICO,brawlBall,Sneaky Fields,0,71,77,148,4896
2906,2023-01-06,RICO,brawlBall,Pinhole Punt,0,9,11,20,510
2907,2023-01-05,RICO,knockout,Out in the Open,0,3,1,4,2958
2908,2023-01-05,RICO,hotZone,Split,1,203,232,436,3552
2909,2023-01-05,RICO,heist,Kaboom Canyon,0,2,1,3,954
2910,2023-01-05,RICO,gemGrab,Undermine,0,7,5,12,1812
2911,2023-01-05,RICO,gemGrab,Gem Fort,0,0,11,11,252
2912,2023-01-05,RICO,brawlBall,Sunny Soccer,0,2,3,5,84
2913,2023-01-05,RICO,brawlBall,Pinhole Punt,2,77,88,167,8118
2914,2023-01-05,RICO,bounty,Shooting Star,0,3,0,3,1362
2915,2023-01-04,RICO,knockout,Goldarm Gulch,0,21,34,55,696
2916,2023-01-04,RICO,hotZone,Parallel Plays,0,1,1,2,864
2917,2023-01-04,RICO,heist,Kaboom Canyon,0,1,1,2,1848
2918,2023-01-04,RICO,gemGrab,Gem Fort,0,23,30,53,1788
2919,2023-01-04,RICO,gemGrab,Crystal Arcade,0,4,1,5,642
2920,2023-01-04,RICO,brawlBall,Sunny Soccer,3,45,59,107,6312
2921,2023-01-04,RICO,brawlBall,Beach Ball,0,1,0,1,54
2922,2023-01-04,RICO,bounty,Shooting Star,0,1,0,1,3570
2923,2023-01-03,RICO,knockout,Goldarm Gulch,0,23,23,46,720
2924,2023-01-03,RICO,hotZone,Controller Chaos,0,0,1,1,12
2925,2023-01-03,RICO,heist,Pit Stop,0,37,36,73,1956
2926,2023-01-03,RICO,gemGrab,Crystal Arcade,0,7,2,9,2406
2927,2023-01-03,RICO,brawlBall,Center Stage,0,6,2,8,294
2928,2023-01-03,RICO,brawlBall,Beach Ball,0,30,29,59,5580
2929,2023-01-03,RICO,bounty,Hideout,0,1,0,1,1638
2930,2023-01-02,RICO,knockout,Belle's Rock,0,17,10,27,1794
2931,2023-01-02,RICO,hotZone,Quarter Pounder,0,11,16,27,2652
2932,2023-01-02,RICO,heist,Pit Stop,1,57,25,83,3498
2933,2023-01-02,RICO,heist,Kaboom Canyon,0,1,0,1,30
2934,2023-01-02,RICO,gemGrab,Minecart Madness,0,6,3,9,2352
2935,2023-01-02,RICO,gemGrab,Double Swoosh,0,2,0,2,1512
2936,2023-01-02,RICO,brawlBall,Center Stage,6,150,101,257,7110
2937,2023-01-02,RICO,bounty,Hideout,0,2,0,2,3090
2938,2023-01-01,RICO,knockout,Belle's Rock,0,10,5,15,858
2939,2023-01-01,RICO,hotZone,Quarter Pounder,0,5,1,6,1188
2940,2023-01-01,RICO,gemGrab,Double Swoosh,0,3,0,3,1140
2941,2023-01-01,RICO,brawlBall,Backyard Bowl,0,2,2,4,2658
2942,2022-12-31,RICO,hotZone,Controller Chaos,0,1,0,1,198
2943,2022-12-31,RICO,gemGrab,Hard Rock Mine,0,15,11,26,384
2944,2022-12-31,RICO,gemGrab,Deep Diner,0,5,3,8,306
2945,2022-12-31,RICO,brawlBall,Super Beach,0,2,0,2,618
2946,2022-12-31,RICO,brawlBall,Sneaky Fields,0,1,1,2,60
2947,2022-12-30,RICO,heist,Hot Potato,0,0,1,1,30
2948,2022-12-30,RICO,gemGrab,Undermine,0,1,0,1,102
2949,2022-12-30,RICO,gemGrab,Deep Diner,0,4,0,4,438
2950,2022-12-30,RICO,brawlBall,Sneaky Fields,0,3,11,14,552
2951,2022-12-29,RICO,heist,Hot Potato,0,1,1,2,72
2952,2022-12-29,RICO,gemGrab,Gem Fort,0,2,0,2,30
2953,2022-12-29,RICO,brawlBall,Pinhole Punt,0,2,0,2,282
2954,2022-12-28,RICO,brawlBall,Sunny Soccer,0,3,1,4,42
2955,2022-12-27,RICO,hotZone,Dueling Beetles,0,0,1,1,36
2956,2022-12-27,RICO,hotZone,Controller Chaos,0,0,1,1,24
2957,2022-12-27,RICO,brawlBall,Center Stage,0,2,1,3,30
2958,2022-12-27,RICO,bounty,Excel,0,0,1,1,18
2959,2022-12-26,RICO,brawlBall,Center Stage,0,2,2,4,78
2960,2022-12-25,RICO,brawlBall,Backyard Bowl,0,1,0,1,78
2961,2022-12-20,RICO,brawlBall,Beach Ball,0,2,1,3,96
2962,2022-12-19,RICO,brawlBall,Center Stage,0,4,7,11,102
2963,2022-12-18,RICO,knockout,Belle's Rock,0,1,0,1,6
2964,2022-12-16,RICO,brawlBall,Sneaky Fields,0,2,0,2,84
2965,2022-12-13,RICO,heist,Safe Zone,0,2,0,2,42
2966,2022-12-13,RICO,gemGrab,Crystal Arcade,0,1,0,1,72
2967,2022-12-11,RICO,gemGrab,Double Swoosh,0,0,1,1,12
2968,2022-12-10,RICO,gemGrab,Hard Rock Mine,0,2,1,3,24
2969,2022-11-11,RICO,knockout,New Perspective,0,0,2,2,12
2970,2022-11-11,RICO,brawlBall,Sneaky Fields,0,1,1,2,42
2971,2022-11-01,RICO,knockout,New Perspective,0,2,0,2,54
2972,2022-10-15,RICO,gemGrab,Hard Rock Mine,0,2,3,5,90
2973,2023-01-28,POCO,knockout,Flaring Phoenix,0,19,12,31,12366
2974,2023-01-28,POCO,hotZone,Controller Chaos,0,301,318,619,10134
2975,2023-01-28,POCO,heist,Bridge Too Far,0,14,5,19,24240
2976,2023-01-28,POCO,gemGrab,Hard Rock Mine,0,140,93,233,16638
2977,2023-01-28,POCO,gemGrab,Deep Diner,0,69,61,130,5478
2978,2023-01-28,POCO,brawlBall,Super Beach,13,691,756,1460,74430
2979,2023-01-28,POCO,brawlBall,Sneaky Fields,1,50,45,96,3582
2980,2023-01-28,POCO,bounty,Canal Grande,0,44,44,88,10902
2981,2023-01-27,POCO,knockout,Flaring Phoenix,0,10,6,16,5928
2982,2023-01-27,POCO,hotZone,Controller Chaos,0,83,105,188,2676
2983,2023-01-27,POCO,heist,Hot Potato,0,6,3,9,3486
2984,2023-01-27,POCO,gemGrab,Undermine,0,12,10,22,942
2985,2023-01-27,POCO,gemGrab,Deep Diner,0,69,44,113,6846
2986,2023-01-27,POCO,brawlBall,Sneaky Fields,4,270,285,559,23514
2987,2023-01-27,POCO,brawlBall,Pinhole Punt,0,17,16,33,738
2988,2023-01-27,POCO,bounty,Temple Ruins,0,9,2,11,1890
2989,2023-01-26,POCO,knockout,Riverside,0,45,22,67,19008
2990,2023-01-26,POCO,hotZone,Open Zone,0,451,578,1029,10182
2991,2023-01-26,POCO,heist,Hot Potato,0,26,15,41,14610
2992,2023-01-26,POCO,gemGrab,Undermine,0,125,97,222,10062
2993,2023-01-26,POCO,gemGrab,Gem Fort,0,69,91,160,4674
2994,2023-01-26,POCO,brawlBall,Sunny Soccer,1,41,43,85,3660
2995,2023-01-26,POCO,brawlBall,Pinhole Punt,16,946,979,1941,67338
2996,2023-01-26,POCO,bounty,Temple Ruins,0,31,24,55,5610
2997,2023-01-25,POCO,knockout,Riverside,0,17,6,23,9906
2998,2023-01-25,POCO,hotZone,Open Zone,0,213,260,473,5262
2999,2023-01-25,POCO,heist,Safe Zone,0,17,7,24,9156
3000,2023-01-25,POCO,gemGrab,Gem Fort,0,106,132,238,5556
3001,2023-01-25,POCO,gemGrab,Crystal Arcade,0,117,80,197,7866
3002,2023-01-25,POCO,brawlBall,Sunny Soccer,7,344,393,744,40830
3003,2023-01-25,POCO,brawlBall,Beach Ball,5,60,54,119,6408
3004,2023-01-25,POCO,bounty,Excel,0,19,6,25,5790
3005,2023-01-24,POCO,knockout,New Perspective,0,36,19,55,10542
3006,2023-01-24,POCO,hotZone,Dueling Beetles,0,520,684,1204,10662
3007,2023-01-24,POCO,heist,Safe Zone,0,20,20,40,15750
3008,2023-01-24,POCO,gemGrab,Minecart Madness,0,33,29,62,4002
3009,2023-01-24,POCO,gemGrab,Crystal Arcade,0,189,129,318,14460
3010,2023-01-24,POCO,brawlBall,Center Stage,2,46,57,105,7860
3011,2023-01-24,POCO,brawlBall,Beach Ball,19,561,625,1205,64614
3012,2023-01-24,POCO,bounty,Excel,0,46,41,87,10896
3013,2023-01-23,POCO,knockout,New Perspective,1,52,24,77,20676
3014,2023-01-23,POCO,hotZone,Dueling Beetles,0,805,1061,1866,17502
3015,2023-01-23,POCO,heist,Snaked Assault,1,18,3,22,15762
3016,2023-01-23,POCO,gemGrab,Minecart Madness,0,170,137,307,19062
3017,2023-01-23,POCO,gemGrab,Double Swoosh,0,116,88,204,7578
3018,2023-01-23,POCO,brawlBall,Center Stage,12,643,622,1277,92862
3019,2023-01-23,POCO,brawlBall,Backyard Bowl,0,17,10,27,4224
3020,2023-01-23,POCO,bounty,Layer Cake,0,38,44,82,11142
3021,2023-01-22,POCO,knockout,X Marks the Spot,0,18,9,27,9174
3022,2023-01-22,POCO,hotZone,Ring of Fire,1,239,250,490,5730
3023,2023-01-22,POCO,heist,Snaked Assault,0,9,10,19,8232
3024,2023-01-22,POCO,gemGrab,Hard Rock Mine,0,36,49,85,4722
3025,2023-01-22,POCO,gemGrab,Double Swoosh,0,135,88,223,9426
3026,2023-01-22,POCO,brawlBall,Super Beach,4,76,70,150,7386
3027,2023-01-22,POCO,brawlBall,Backyard Bowl,3,176,140,319,34788
3028,2023-01-22,POCO,bounty,Layer Cake,0,40,67,107,6654
3029,2023-01-21,POCO,knockout,X Marks the Spot,1,70,43,114,31698
3030,2023-01-21,POCO,hotZone,Ring of Fire,0,776,961,1737,16632
3031,2023-01-21,POCO,heist,Tornado Ring,0,19,6,25,11664
3032,2023-01-21,POCO,gemGrab,Hard Rock Mine,0,207,183,390,22980
3033,2023-01-21,POCO,gemGrab,Deep Diner,0,66,26,92,4470
3034,2023-01-21,POCO,brawlBall,Super Beach,23,863,940,1826,101364
3035,2023-01-21,POCO,brawlBall,Sneaky Fields,1,47,43,91,3750
3036,2023-01-21,POCO,bounty,Dry Season,0,48,18,66,14538
3037,2023-01-20,POCO,knockout,Out in the Open,0,81,48,129,20106
3038,2023-01-20,POCO,hotZone,Split,0,88,44,132,9678
3039,2023-01-20,POCO,heist,Tornado Ring,0,25,10,35,12672
3040,2023-01-20,POCO,gemGrab,Undermine,0,64,49,113,5442
3041,2023-01-20,POCO,gemGrab,Deep Diner,0,218,197,415,19050
3042,2023-01-20,POCO,brawlBall,Sneaky Fields,20,789,868,1677,74778
3043,2023-01-20,POCO,brawlBall,Pinhole Punt,1,36,43,80,2886
3044,2023-01-20,POCO,bounty,Dry Season,0,25,19,44,11640
3045,2023-01-19,POCO,knockout,Out in the Open,1,78,49,128,26574
3046,2023-01-19,POCO,hotZone,Split,0,103,65,168,14856
3047,2023-01-19,POCO,heist,Kaboom Canyon,0,29,19,48,6732
3048,2023-01-19,POCO,gemGrab,Undermine,0,199,149,348,14154
3049,2023-01-19,POCO,gemGrab,Gem Fort,0,36,43,79,2934
3050,2023-01-19,POCO,brawlBall,Sunny Soccer,0,17,16,33,2274
3051,2023-01-19,POCO,brawlBall,Pinhole Punt,27,915,1117,2059,72498
3052,2023-01-19,POCO,bounty,Shooting Star,0,44,38,82,11124
3053,2023-01-18,POCO,knockout,Goldarm Gulch,0,7,1,8,2784
3054,2023-01-18,POCO,hotZone,Parallel Plays,0,21,13,34,1158
3055,2023-01-18,POCO,heist,Kaboom Canyon,0,2,3,5,2592
3056,2023-01-18,POCO,gemGrab,Gem Fort,0,49,42,91,3006
3057,2023-01-18,POCO,gemGrab,Crystal Arcade,0,18,11,29,990
3058,2023-01-18,POCO,brawlBall,Sunny Soccer,2,146,143,291,18941
3059,2023-01-18,POCO,brawlBall,Beach Ball,0,3,5,8,774
3060,2023-01-18,POCO,bounty,Shooting Star,0,10,11,21,5088
3061,2023-01-17,POCO,knockout,Goldarm Gulch,0,7,2,9,2520
3062,2023-01-17,POCO,hotZone,Parallel Plays,0,7,8,15,1038
3063,2023-01-17,POCO,heist,Pit Stop,0,3,0,3,1290
3064,2023-01-17,POCO,gemGrab,Minecart Madness,0,1,0,1,216
3065,2023-01-17,POCO,gemGrab,Crystal Arcade,0,13,9,22,1266
3066,2023-01-17,POCO,brawlBall,Center Stage,0,1,4,5,288
3067,2023-01-17,POCO,brawlBall,Beach Ball,1,48,45,94,5886
3068,2023-01-17,POCO,bounty,Hideout,0,4,3,7,750
3069,2023-01-16,POCO,knockout,Belle's Rock,0,1,1,2,1788
3070,2023-01-16,POCO,hotZone,Quarter Pounder,0,36,13,49,1494
3071,2023-01-16,POCO,heist,Pit Stop,0,4,0,4,4044
3072,2023-01-16,POCO,gemGrab,Minecart Madness,0,18,9,27,1422
3073,2023-01-16,POCO,gemGrab,Double Swoosh,0,10,4,14,708
3074,2023-01-16,POCO,brawlBall,Center Stage,1,40,38,79,5778
3075,2023-01-16,POCO,brawlBall,Backyard Bowl,0,2,1,3,852
3076,2023-01-16,POCO,bounty,Hideout,0,1,1,2,1470
3077,2023-01-15,POCO,knockout,Belle's Rock,0,1,0,1,2904
3078,2023-01-15,POCO,hotZone,Quarter Pounder,0,60,35,95,3318
3079,2023-01-15,POCO,heist,Bridge Too Far,0,3,0,3,2736
3080,2023-01-15,POCO,gemGrab,Hard Rock Mine,0,3,2,5,1014
3081,2023-01-15,POCO,gemGrab,Double Swoosh,0,38,35,73,2178
3082,2023-01-15,POCO,brawlBall,Super Beach,0,9,7,16,1074
3083,2023-01-15,POCO,brawlBall,Backyard Bowl,1,39,31,71,8946
3084,2023-01-15,POCO,bounty,Canal Grande,0,3,1,4,960
3085,2023-01-14,POCO,knockout,Flaring Phoenix,0,2,0,2,1080
3086,2023-01-14,POCO,hotZone,Controller Chaos,0,58,117,175,2772
3087,2023-01-14,POCO,heist,Bridge Too Far,0,4,1,5,4020
3088,2023-01-14,POCO,gemGrab,Hard Rock Mine,0,10,7,17,1272
3089,2023-01-14,POCO,gemGrab,Deep Diner,0,11,4,15,858
3090,2023-01-14,POCO,brawlBall,Super Beach,0,55,53,108,6336
3091,2023-01-14,POCO,brawlBall,Sneaky Fields,1,12,1,14,918
3092,2023-01-14,POCO,bounty,Canal Grande,0,8,14,22,1014
3093,2023-01-13,POCO,knockout,Flaring Phoenix,0,2,1,3,1182
3094,2023-01-13,POCO,hotZone,Controller Chaos,0,104,89,193,2928
3095,2023-01-13,POCO,gemGrab,Undermine,0,0,2,2,18
3096,2023-01-13,POCO,gemGrab,Deep Diner,0,19,14,33,1650
3097,2023-01-13,POCO,brawlBall,Sneaky Fields,0,96,136,232,6144
3098,2023-01-13,POCO,brawlBall,Pinhole Punt,0,3,2,5,156
3099,2023-01-13,POCO,bounty,Temple Ruins,0,2,1,3,270
3100,2023-01-12,POCO,knockout,Riverside,0,6,2,8,2532
3101,2023-01-12,POCO,hotZone,Open Zone,0,89,102,191,1488
3102,2023-01-12,POCO,gemGrab,Undermine,0,3,1,4,690
3103,2023-01-12,POCO,gemGrab,Gem Fort,0,2,5,7,162
3104,2023-01-12,POCO,brawlBall,Sunny Soccer,0,2,1,3,240
3105,2023-01-12,POCO,brawlBall,Pinhole Punt,1,33,39,73,2292
3106,2023-01-12,POCO,bounty,Temple Ruins,0,0,1,1,24
3107,2023-01-11,POCO,hotZone,Open Zone,0,22,21,43,462
3108,2023-01-11,POCO,heist,Safe Zone,0,0,1,1,48
3109,2023-01-11,POCO,gemGrab,Gem Fort,0,5,1,6,414
3110,2023-01-11,POCO,brawlBall,Sunny Soccer,1,7,7,15,1638
3111,2023-01-11,POCO,brawlBall,Beach Ball,0,1,0,1,48
3112,2023-01-11,POCO,bounty,Excel,0,1,0,1,282
3113,2023-01-10,POCO,knockout,New Perspective,0,2,2,4,720
3114,2023-01-10,POCO,hotZone,Dueling Beetles,0,101,130,231,2424
3115,2023-01-10,POCO,heist,Safe Zone,0,1,3,4,1176
3116,2023-01-10,POCO,gemGrab,Minecart Madness,0,9,1,10,828
3117,2023-01-10,POCO,gemGrab,Crystal Arcade,0,21,6,27,1746
3118,2023-01-10,POCO,brawlBall,Center Stage,0,6,0,6,708
3119,2023-01-10,POCO,brawlBall,Beach Ball,0,44,32,76,4392
3120,2023-01-09,POCO,knockout,New Perspective,0,2,2,4,876
3121,2023-01-09,POCO,hotZone,Dueling Beetles,0,57,38,95,1554
3122,2023-01-09,POCO,heist,Snaked Assault,0,2,0,2,2022
3123,2023-01-09,POCO,gemGrab,Minecart Madness,0,11,3,14,1884
3124,2023-01-09,POCO,gemGrab,Double Swoosh,0,34,47,81,1320
3125,2023-01-09,POCO,brawlBall,Center Stage,0,28,20,48,5460
3126,2023-01-09,POCO,brawlBall,Backyard Bowl,0,3,1,4,474
3127,2023-01-09,POCO,bounty,Layer Cake,0,1,0,1,1512
3128,2023-01-08,POCO,knockout,X Marks the Spot,0,7,0,7,1692
3129,2023-01-08,POCO,hotZone,Ring of Fire,0,82,87,169,1644
3130,2023-01-08,POCO,heist,Snaked Assault,0,1,0,1,1494
3131,2023-01-08,POCO,gemGrab,Hard Rock Mine,0,6,1,7,630
3132,2023-01-08,POCO,gemGrab,Double Swoosh,0,8,6,14,864
3133,2023-01-08,POCO,brawlBall,Super Beach,0,4,4,8,732
3134,2023-01-08,POCO,brawlBall,Backyard Bowl,3,33,10,46,4830
3135,2023-01-08,POCO,bounty,Layer Cake,0,1,6,7,528
3136,2023-01-07,POCO,knockout,X Marks the Spot,0,1,0,1,1014
3137,2023-01-07,POCO,hotZone,Ring of Fire,0,46,29,75,846
3138,2023-01-07,POCO,heist,Tornado Ring,0,1,0,1,1350
3139,2023-01-07,POCO,gemGrab,Hard Rock Mine,0,10,8,18,1158
3140,2023-01-07,POCO,gemGrab,Deep Diner,0,7,2,9,918
3141,2023-01-07,POCO,brawlBall,Super Beach,0,23,15,38,2622
3142,2023-01-07,POCO,brawlBall,Sneaky Fields,0,3,3,6,402
3143,2023-01-07,POCO,bounty,Dry Season,0,1,0,1,1320
3144,2023-01-06,POCO,knockout,Out in the Open,0,2,0,2,1446
3145,2023-01-06,POCO,hotZone,Split,0,7,1,8,1158
3146,2023-01-06,POCO,gemGrab,Undermine,0,3,0,3,540
3147,2023-01-06,POCO,gemGrab,Deep Diner,0,28,8,36,2226
3148,2023-01-06,POCO,brawlBall,Sneaky Fields,2,78,85,165,4896
3149,2023-01-06,POCO,brawlBall,Pinhole Punt,0,2,9,11,510
3150,2023-01-06,POCO,bounty,Dry Season,0,3,4,7,1944
3151,2023-01-05,POCO,knockout,Out in the Open,0,3,0,3,2958
3152,2023-01-05,POCO,hotZone,Split,0,22,23,45,3552
3153,2023-01-05,POCO,heist,Kaboom Canyon,0,2,0,2,954
3154,2023-01-05,POCO,gemGrab,Undermine,0,10,3,13,1812
3155,2023-01-05,POCO,gemGrab,Gem Fort,0,4,5,9,252
3156,2023-01-05,POCO,brawlBall,Sunny Soccer,0,1,0,1,84
3157,2023-01-05,POCO,brawlBall,Pinhole Punt,1,112,72,185,8118
3158,2023-01-05,POCO,bounty,Shooting Star,0,0,1,1,1362
3159,2023-01-04,POCO,hotZone,Parallel Plays,0,15,4,19,864
3160,2023-01-04,POCO,heist,Kaboom Canyon,0,2,0,2,1848
3161,2023-01-04,POCO,gemGrab,Gem Fort,0,44,41,85,1788
3162,2023-01-04,POCO,gemGrab,Crystal Arcade,0,8,13,21,642
3163,2023-01-04,POCO,brawlBall,Sunny Soccer,0,43,50,93,6312
3164,2023-01-04,POCO,brawlBall,Beach Ball,0,1,1,2,54
3165,2023-01-04,POCO,bounty,Shooting Star,0,3,15,18,3570
3166,2023-01-03,POCO,knockout,Goldarm Gulch,0,1,0,1,720
3167,2023-01-03,POCO,hotZone,Parallel Plays,0,24,27,51,1542
3168,2023-01-03,POCO,heist,Pit Stop,0,0,1,1,1956
3169,2023-01-03,POCO,gemGrab,Minecart Madness,0,4,0,4,456
3170,2023-01-03,POCO,gemGrab,Crystal Arcade,0,32,6,38,2406
3171,2023-01-03,POCO,brawlBall,Center Stage,0,1,0,1,294
3172,2023-01-03,POCO,brawlBall,Beach Ball,0,45,39,84,5580
3173,2023-01-03,POCO,bounty,Hideout,0,3,0,3,1638
3174,2023-01-02,POCO,knockout,Belle's Rock,0,1,0,1,1794
3175,2023-01-02,POCO,hotZone,Quarter Pounder,1,68,75,144,2652
3176,2023-01-02,POCO,hotZone,Controller Chaos,0,0,2,2,18
3177,2023-01-02,POCO,heist,Pit Stop,0,0,1,1,3498
3178,2023-01-02,POCO,gemGrab,Minecart Madness,0,28,7,35,2352
3179,2023-01-02,POCO,gemGrab,Double Swoosh,0,24,16,40,1512
3180,2023-01-02,POCO,brawlBall,Center Stage,0,63,66,129,7110
3181,2023-01-02,POCO,brawlBall,Backyard Bowl,0,2,1,3,492
3182,2023-01-02,POCO,bounty,Hideout,0,3,0,3,3090
3183,2023-01-01,POCO,knockout,Belle's Rock,0,1,0,1,858
3184,2023-01-01,POCO,hotZone,Quarter Pounder,0,11,1,12,1188
3185,2023-01-01,POCO,heist,Bridge Too Far,0,1,0,1,462
3186,2023-01-01,POCO,gemGrab,Minecart Madness,0,1,0,1,12
3187,2023-01-01,POCO,gemGrab,Double Swoosh,0,15,12,27,1140
3188,2023-01-01,POCO,brawlBall,Backyard Bowl,0,10,4,14,2658
3189,2023-01-01,POCO,bounty,Canal Grande,0,2,2,4,132
3190,2022-12-31,POCO,hotZone,Controller Chaos,0,7,2,9,198
3191,2022-12-31,POCO,gemGrab,Hard Rock Mine,0,3,1,4,384
3192,2022-12-31,POCO,gemGrab,Deep Diner,0,2,0,2,306
3193,2022-12-31,POCO,brawlBall,Super Beach,0,7,3,10,618
3194,2022-12-31,POCO,brawlBall,Sneaky Fields,0,0,1,1,60
3195,2022-12-31,POCO,bounty,Canal Grande,0,2,2,4,54
3196,2022-12-30,POCO,hotZone,Controller Chaos,0,5,2,7,288
3197,2022-12-30,POCO,gemGrab,Deep Diner,0,6,3,9,438
3198,2022-12-30,POCO,brawlBall,Sneaky Fields,0,4,3,7,552
3199,2022-12-29,POCO,hotZone,Open Zone,0,1,2,3,54
3200,2022-12-29,POCO,gemGrab,Gem Fort,0,1,0,1,30
3201,2022-12-29,POCO,brawlBall,Pinhole Punt,0,3,1,4,282
3202,2022-12-28,POCO,hotZone,Open Zone,0,4,3,7,108
3203,2022-12-27,POCO,hotZone,Dueling Beetles,0,2,0,2,36
3204,2022-12-26,POCO,brawlBall,Center Stage,0,1,0,1,78
3205,2022-12-23,POCO,knockout,Out in the Open,0,0,1,1,132
3206,2022-12-23,POCO,gemGrab,Deep Diner,0,1,0,1,6
3207,2022-12-22,POCO,gemGrab,Gem Fort,0,3,0,3,90
3208,2022-12-22,POCO,brawlBall,Pinhole Punt,0,3,0,3,132
3209,2022-12-21,POCO,brawlBall,Sunny Soccer,0,1,0,1,54
3210,2022-12-16,POCO,hotZone,Controller Chaos,0,1,0,1,6
3211,2022-12-13,POCO,knockout,New Perspective,0,1,0,1,84
3212,2022-12-13,POCO,heist,Safe Zone,0,2,0,2,42
3213,2022-12-11,POCO,gemGrab,Double Swoosh,0,0,1,1,12
3214,2022-12-10,POCO,gemGrab,Hard Rock Mine,0,0,1,1,24
3215,2022-11-11,POCO,brawlBall,Sneaky Fields,0,0,1,1,42
3216,2022-10-30,POCO,bounty,Canal Grande,0,1,0,1,12
3217,2022-10-28,POCO,knockout,Out in the Open,0,1,0,1,18
3218,2022-10-15,POCO,hotZone,Ring of Fire,0,1,2,3,24
3219,2022-10-15,POCO,gemGrab,Hard Rock Mine,0,0,3,3,90
3220,2022-10-10,POCO,knockout,Belle's Rock,0,1,0,1,48
3221,2023-01-28,PIPER,knockout,Flaring Phoenix,1,214,148,363,12366
3222,2023-01-28,PIPER,hotZone,Controller Chaos,0,11,1,12,10134
3223,2023-01-28,PIPER,heist,Bridge Too Far,7,865,816,1688,24240
3224,2023-01-28,PIPER,gemGrab,Hard Rock Mine,0,251,272,523,16638
3225,2023-01-28,PIPER,gemGrab,Deep Diner,0,46,56,102,5478
3226,2023-01-28,PIPER,brawlBall,Super Beach,2,77,61,140,74430
3227,2023-01-28,PIPER,brawlBall,Sneaky Fields,0,3,0,3,3582
3228,2023-01-28,PIPER,bounty,Canal Grande,0,83,47,130,10902
3229,2023-01-27,PIPER,knockout,Flaring Phoenix,0,91,87,178,5928
3230,2023-01-27,PIPER,hotZone,Controller Chaos,0,4,2,6,2676
3231,2023-01-27,PIPER,heist,Hot Potato,0,12,4,16,3486
3232,2023-01-27,PIPER,gemGrab,Undermine,0,11,9,20,942
3233,2023-01-27,PIPER,gemGrab,Deep Diner,0,66,58,124,6846
3234,2023-01-27,PIPER,brawlBall,Sneaky Fields,0,14,11,25,23514
3235,2023-01-27,PIPER,brawlBall,Pinhole Punt,0,6,8,14,738
3236,2023-01-27,PIPER,bounty,Temple Ruins,0,42,44,86,1890
3237,2023-01-26,PIPER,knockout,Riverside,2,1503,1603,3108,19008
3238,2023-01-26,PIPER,hotZone,Open Zone,0,77,47,124,10182
3239,2023-01-26,PIPER,heist,Hot Potato,0,15,22,37,14610
3240,2023-01-26,PIPER,gemGrab,Undermine,0,132,156,288,10062
3241,2023-01-26,PIPER,gemGrab,Gem Fort,0,13,9,22,4674
3242,2023-01-26,PIPER,brawlBall,Sunny Soccer,0,6,2,8,3660
3243,2023-01-26,PIPER,brawlBall,Pinhole Punt,0,170,97,267,67338
3244,2023-01-26,PIPER,bounty,Temple Ruins,0,133,120,253,5610
3245,2023-01-25,PIPER,knockout,Riverside,0,789,837,1626,9906
3246,2023-01-25,PIPER,hotZone,Open Zone,0,33,15,48,5262
3247,2023-01-25,PIPER,heist,Safe Zone,1,175,153,329,9156
3248,2023-01-25,PIPER,gemGrab,Gem Fort,0,29,17,46,5556
3249,2023-01-25,PIPER,gemGrab,Crystal Arcade,0,75,76,151,7866
3250,2023-01-25,PIPER,brawlBall,Sunny Soccer,0,27,20,47,40830
3251,2023-01-25,PIPER,brawlBall,Beach Ball,0,12,6,18,6408
3252,2023-01-25,PIPER,bounty,Excel,0,68,81,149,5790
3253,2023-01-24,PIPER,knockout,New Perspective,0,268,254,522,10542
3254,2023-01-24,PIPER,hotZone,Dueling Beetles,0,20,3,23,10662
3255,2023-01-24,PIPER,heist,Safe Zone,0,313,237,550,15750
3256,2023-01-24,PIPER,gemGrab,Minecart Madness,0,75,106,181,4002
3257,2023-01-24,PIPER,gemGrab,Crystal Arcade,0,178,173,351,14460
3258,2023-01-24,PIPER,brawlBall,Center Stage,0,3,7,10,7860
3259,2023-01-24,PIPER,brawlBall,Beach Ball,0,68,47,115,64614
3260,2023-01-24,PIPER,bounty,Excel,0,105,71,176,10896
3261,2023-01-23,PIPER,knockout,New Perspective,1,392,330,723,20676
3262,2023-01-23,PIPER,hotZone,Dueling Beetles,0,29,25,54,17502
3263,2023-01-23,PIPER,heist,Snaked Assault,0,26,8,34,15762
3264,2023-01-23,PIPER,gemGrab,Minecart Madness,0,317,371,688,19062
3265,2023-01-23,PIPER,gemGrab,Double Swoosh,0,42,49,91,7578
3266,2023-01-23,PIPER,brawlBall,Center Stage,0,90,53,143,92862
3267,2023-01-23,PIPER,brawlBall,Backyard Bowl,3,69,71,143,4224
3268,2023-01-23,PIPER,bounty,Layer Cake,0,205,201,406,11142
3269,2023-01-22,PIPER,knockout,X Marks the Spot,0,264,224,488,9174
3270,2023-01-22,PIPER,hotZone,Ring of Fire,0,22,4,26,5730
3271,2023-01-22,PIPER,heist,Snaked Assault,0,5,4,9,8232
3272,2023-01-22,PIPER,gemGrab,Hard Rock Mine,0,66,97,163,4722
3273,2023-01-22,PIPER,gemGrab,Double Swoosh,0,37,29,66,9426
3274,2023-01-22,PIPER,brawlBall,Super Beach,0,6,2,8,7386
3275,2023-01-22,PIPER,brawlBall,Backyard Bowl,34,680,594,1308,34788
3276,2023-01-22,PIPER,bounty,Layer Cake,0,125,143,268,6654
3277,2023-01-21,PIPER,knockout,X Marks the Spot,1,832,834,1667,31698
3278,2023-01-21,PIPER,hotZone,Ring of Fire,0,79,31,110,16632
3279,2023-01-21,PIPER,heist,Tornado Ring,0,21,6,27,11664
3280,2023-01-21,PIPER,gemGrab,Hard Rock Mine,0,365,368,733,22980
3281,2023-01-21,PIPER,gemGrab,Deep Diner,0,42,14,56,4470
3282,2023-01-21,PIPER,brawlBall,Super Beach,3,126,98,227,101364
3283,2023-01-21,PIPER,brawlBall,Sneaky Fields,0,1,0,1,3750
3284,2023-01-21,PIPER,bounty,Dry Season,0,706,723,1429,14538
3285,2023-01-20,PIPER,knockout,Out in the Open,0,682,580,1262,20106
3286,2023-01-20,PIPER,hotZone,Split,0,5,2,7,9678
3287,2023-01-20,PIPER,heist,Tornado Ring,0,10,8,18,12672
3288,2023-01-20,PIPER,gemGrab,Undermine,0,54,47,101,5442
3289,2023-01-20,PIPER,gemGrab,Deep Diner,0,148,122,270,19050
3290,2023-01-20,PIPER,brawlBall,Sneaky Fields,1,55,39,95,74778
3291,2023-01-20,PIPER,brawlBall,Pinhole Punt,0,9,8,17,2886
3292,2023-01-20,PIPER,bounty,Dry Season,0,581,498,1079,11640
3293,2023-01-19,PIPER,knockout,Out in the Open,0,808,689,1497,26574
3294,2023-01-19,PIPER,hotZone,Split,0,6,3,9,14856
3295,2023-01-19,PIPER,heist,Kaboom Canyon,0,55,68,123,6732
3296,2023-01-19,PIPER,gemGrab,Undermine,0,171,214,385,14154
3297,2023-01-19,PIPER,gemGrab,Gem Fort,0,14,6,20,2934
3298,2023-01-19,PIPER,brawlBall,Sunny Soccer,0,2,1,3,2274
3299,2023-01-19,PIPER,brawlBall,Pinhole Punt,4,184,128,316,72498
3300,2023-01-19,PIPER,bounty,Shooting Star,0,759,774,1533,11124
3301,2023-01-18,PIPER,knockout,Goldarm Gulch,0,47,33,80,2784
3302,2023-01-18,PIPER,hotZone,Parallel Plays,0,0,2,2,1158
3303,2023-01-18,PIPER,heist,Kaboom Canyon,0,22,17,39,2592
3304,2023-01-18,PIPER,gemGrab,Gem Fort,0,12,6,18,3006
3305,2023-01-18,PIPER,gemGrab,Crystal Arcade,0,4,4,8,990
3306,2023-01-18,PIPER,brawlBall,Sunny Soccer,0,28,15,43,18941
3307,2023-01-18,PIPER,bounty,Shooting Star,0,351,353,704,5088
3308,2023-01-17,PIPER,knockout,Goldarm Gulch,0,69,54,123,2520
3309,2023-01-17,PIPER,hotZone,Parallel Plays,0,2,0,2,1038
3310,2023-01-17,PIPER,gemGrab,Minecart Madness,0,6,1,7,216
3311,2023-01-17,PIPER,gemGrab,Crystal Arcade,0,12,8,20,1266
3312,2023-01-17,PIPER,brawlBall,Beach Ball,1,7,2,10,5886
3313,2023-01-17,PIPER,bounty,Hideout,0,49,54,103,750
3314,2023-01-16,PIPER,knockout,Belle's Rock,0,50,61,111,1788
3315,2023-01-16,PIPER,hotZone,Quarter Pounder,0,2,1,3,1494
3316,2023-01-16,PIPER,heist,Pit Stop,0,1,0,1,4044
3317,2023-01-16,PIPER,gemGrab,Minecart Madness,0,24,27,51,1422
3318,2023-01-16,PIPER,gemGrab,Double Swoosh,0,2,0,2,708
3319,2023-01-16,PIPER,brawlBall,Center Stage,0,5,0,5,5778
3320,2023-01-16,PIPER,brawlBall,Backyard Bowl,1,8,10,19,852
3321,2023-01-16,PIPER,bounty,Hideout,0,74,70,144,1470
3322,2023-01-15,PIPER,knockout,Belle's Rock,0,58,100,158,2904
3323,2023-01-15,PIPER,hotZone,Quarter Pounder,0,7,14,21,3318
3324,2023-01-15,PIPER,heist,Bridge Too Far,0,103,97,200,2736
3325,2023-01-15,PIPER,gemGrab,Hard Rock Mine,0,18,18,36,1014
3326,2023-01-15,PIPER,gemGrab,Double Swoosh,0,10,2,12,2178
3327,2023-01-15,PIPER,brawlBall,Super Beach,0,0,1,1,1074
3328,2023-01-15,PIPER,brawlBall,Backyard Bowl,4,154,180,338,8946
3329,2023-01-15,PIPER,bounty,Canal Grande,0,11,3,14,960
3330,2023-01-14,PIPER,knockout,Flaring Phoenix,0,22,5,27,1080
3331,2023-01-14,PIPER,hotZone,Controller Chaos,0,1,1,2,2772
3332,2023-01-14,PIPER,heist,Bridge Too Far,0,164,136,300,4020
3333,2023-01-14,PIPER,gemGrab,Hard Rock Mine,0,16,23,39,1272
3334,2023-01-14,PIPER,gemGrab,Deep Diner,0,7,11,18,858
3335,2023-01-14,PIPER,brawlBall,Super Beach,0,4,8,12,6336
3336,2023-01-14,PIPER,bounty,Canal Grande,0,4,0,4,1014
3337,2023-01-13,PIPER,knockout,Flaring Phoenix,0,13,3,16,1182
3338,2023-01-13,PIPER,hotZone,Controller Chaos,0,1,6,7,2928
3339,2023-01-13,PIPER,gemGrab,Deep Diner,0,18,13,31,1650
3340,2023-01-13,PIPER,brawlBall,Sneaky Fields,0,8,2,10,6144
3341,2023-01-13,PIPER,bounty,Temple Ruins,0,8,9,17,270
3342,2023-01-12,PIPER,knockout,Riverside,0,223,240,463,2532
3343,2023-01-12,PIPER,hotZone,Open Zone,0,13,16,29,1488
3344,2023-01-12,PIPER,gemGrab,Undermine,0,16,23,39,690
3345,2023-01-12,PIPER,brawlBall,Pinhole Punt,0,8,3,11,2292
3346,2023-01-12,PIPER,bounty,Temple Ruins,0,1,0,1,24
3347,2023-01-11,PIPER,knockout,Riverside,0,68,73,141,528
3348,2023-01-11,PIPER,hotZone,Open Zone,0,0,1,1,462
3349,2023-01-11,PIPER,brawlBall,Sunny Soccer,0,1,0,1,1638
3350,2023-01-11,PIPER,bounty,Excel,0,1,1,2,282
3351,2023-01-10,PIPER,knockout,New Perspective,0,19,10,29,720
3352,2023-01-10,PIPER,hotZone,Dueling Beetles,0,1,1,2,2424
3353,2023-01-10,PIPER,heist,Safe Zone,0,32,38,70,1176
3354,2023-01-10,PIPER,gemGrab,Minecart Madness,0,16,34,50,828
3355,2023-01-10,PIPER,gemGrab,Crystal Arcade,0,22,16,38,1746
3356,2023-01-10,PIPER,brawlBall,Beach Ball,0,6,7,13,4392
3357,2023-01-10,PIPER,bounty,Excel,0,4,0,4,330
3358,2023-01-09,PIPER,knockout,New Perspective,0,15,7,22,876
3359,2023-01-09,PIPER,hotZone,Dueling Beetles,0,1,1,2,1554
3360,2023-01-09,PIPER,heist,Snaked Assault,0,2,1,3,2022
3361,2023-01-09,PIPER,gemGrab,Minecart Madness,0,46,39,85,1884
3362,2023-01-09,PIPER,gemGrab,Double Swoosh,0,4,1,5,1320
3363,2023-01-09,PIPER,brawlBall,Center Stage,0,9,0,9,5460
3364,2023-01-09,PIPER,brawlBall,Backyard Bowl,0,4,8,12,474
3365,2023-01-09,PIPER,bounty,Layer Cake,0,26,18,44,1512
3366,2023-01-08,PIPER,knockout,X Marks the Spot,0,48,33,81,1692
3367,2023-01-08,PIPER,hotZone,Ring of Fire,0,11,11,22,1644
3368,2023-01-08,PIPER,heist,Snaked Assault,0,7,10,17,1494
3369,2023-01-08,PIPER,gemGrab,Hard Rock Mine,0,9,20,29,630
3370,2023-01-08,PIPER,gemGrab,Double Swoosh,0,2,1,3,864
3371,2023-01-08,PIPER,brawlBall,Super Beach,0,0,1,1,732
3372,2023-01-08,PIPER,brawlBall,Backyard Bowl,5,116,104,225,4830
3373,2023-01-08,PIPER,bounty,Layer Cake,0,10,5,15,528
3374,2023-01-07,PIPER,knockout,X Marks the Spot,0,54,56,110,1014
3375,2023-01-07,PIPER,hotZone,Ring of Fire,0,4,1,5,846
3376,2023-01-07,PIPER,heist,Tornado Ring,0,0,1,1,1350
3377,2023-01-07,PIPER,gemGrab,Hard Rock Mine,0,18,5,23,1158
3378,2023-01-07,PIPER,gemGrab,Deep Diner,0,15,14,29,918
3379,2023-01-07,PIPER,brawlBall,Super Beach,0,5,0,5,2622
3380,2023-01-07,PIPER,bounty,Dry Season,0,57,69,126,1320
3381,2023-01-06,PIPER,knockout,Out in the Open,0,60,56,116,1446
3382,2023-01-06,PIPER,hotZone,Split,0,4,0,4,1158
3383,2023-01-06,PIPER,heist,Tornado Ring,0,3,0,3,2538
3384,2023-01-06,PIPER,gemGrab,Undermine,0,13,15,28,540
3385,2023-01-06,PIPER,gemGrab,Deep Diner,0,27,17,44,2226
3386,2023-01-06,PIPER,brawlBall,Sneaky Fields,0,7,1,8,4896
3387,2023-01-06,PIPER,brawlBall,Pinhole Punt,0,4,7,11,510
3388,2023-01-06,PIPER,bounty,Dry Season,0,110,72,182,1944
3389,2023-01-05,PIPER,knockout,Out in the Open,0,81,84,165,2958
3390,2023-01-05,PIPER,heist,Kaboom Canyon,0,9,21,30,954
3391,2023-01-05,PIPER,gemGrab,Undermine,0,45,32,77,1812
3392,2023-01-05,PIPER,brawlBall,Pinhole Punt,2,23,15,40,8118
3393,2023-01-05,PIPER,bounty,Shooting Star,0,119,131,250,1362
3394,2023-01-04,PIPER,knockout,Goldarm Gulch,0,14,5,19,696
3395,2023-01-04,PIPER,hotZone,Parallel Plays,0,1,1,2,864
3396,2023-01-04,PIPER,heist,Kaboom Canyon,0,35,30,65,1848
3397,2023-01-04,PIPER,gemGrab,Gem Fort,0,1,0,1,1788
3398,2023-01-04,PIPER,gemGrab,Crystal Arcade,0,6,2,8,642
3399,2023-01-04,PIPER,brawlBall,Sunny Soccer,0,2,2,4,6312
3400,2023-01-04,PIPER,bounty,Shooting Star,0,326,294,620,3570
3401,2023-01-03,PIPER,knockout,Goldarm Gulch,0,13,14,27,720
3402,2023-01-03,PIPER,hotZone,Parallel Plays,0,2,0,2,1542
3403,2023-01-03,PIPER,heist,Kaboom Canyon,0,0,1,1,12
3404,2023-01-03,PIPER,gemGrab,Minecart Madness,0,5,11,16,456
3405,2023-01-03,PIPER,gemGrab,Crystal Arcade,0,22,18,40,2406
3406,2023-01-03,PIPER,brawlBall,Center Stage,0,1,0,1,294
3407,2023-01-03,PIPER,brawlBall,Beach Ball,0,8,1,9,5580
3408,2023-01-03,PIPER,bounty,Hideout,0,112,100,212,1638
3409,2023-01-02,PIPER,knockout,Belle's Rock,0,49,84,133,1794
3410,2023-01-02,PIPER,hotZone,Quarter Pounder,0,7,11,18,2652
3411,2023-01-02,PIPER,heist,Pit Stop,0,2,0,2,3498
3412,2023-01-02,PIPER,heist,Kaboom Canyon,0,1,0,1,30
3413,2023-01-02,PIPER,gemGrab,Minecart Madness,0,51,38,89,2352
3414,2023-01-02,PIPER,gemGrab,Double Swoosh,0,2,1,3,1512
3415,2023-01-02,PIPER,brawlBall,Center Stage,0,9,7,16,7110
3416,2023-01-02,PIPER,brawlBall,Backyard Bowl,1,3,11,15,492
3417,2023-01-02,PIPER,bounty,Hideout,0,193,228,421,3090
3418,2023-01-01,PIPER,knockout,Belle's Rock,0,44,66,110,858
3419,2023-01-01,PIPER,hotZone,Quarter Pounder,0,2,0,2,1188
3420,2023-01-01,PIPER,heist,Bridge Too Far,0,20,10,30,462
3421,2023-01-01,PIPER,gemGrab,Hard Rock Mine,0,2,2,4,48
3422,2023-01-01,PIPER,gemGrab,Double Swoosh,0,2,0,2,1140
3423,2023-01-01,PIPER,brawlBall,Backyard Bowl,2,66,45,113,2658
3424,2023-01-01,PIPER,bounty,Canal Grande,0,1,0,1,132
3425,2022-12-31,PIPER,heist,Bridge Too Far,0,14,17,31,276
3426,2022-12-31,PIPER,gemGrab,Hard Rock Mine,0,3,1,4,384
3427,2022-12-31,PIPER,gemGrab,Deep Diner,0,4,1,5,306
3428,2022-12-31,PIPER,brawlBall,Super Beach,0,0,1,1,618
3429,2022-12-31,PIPER,bounty,Canal Grande,0,0,1,1,54
3430,2022-12-30,PIPER,knockout,Flaring Phoenix,0,3,4,7,72
3431,2022-12-30,PIPER,gemGrab,Deep Diner,0,2,1,3,438
3432,2022-12-30,PIPER,brawlBall,Sneaky Fields,0,1,0,1,552
3433,2022-12-29,PIPER,gemGrab,Undermine,0,1,1,2,102
3434,2022-12-29,PIPER,gemGrab,Minecart Madness,0,1,2,3,24
3435,2022-12-29,PIPER,gemGrab,Gem Fort,0,1,2,3,30
3436,2022-12-29,PIPER,brawlBall,Pinhole Punt,0,0,1,1,282
3437,2022-12-27,PIPER,knockout,New Perspective,0,1,1,2,30
3438,2022-12-27,PIPER,brawlBall,Beach Ball,0,0,1,1,144
3439,2022-12-26,PIPER,heist,Kaboom Canyon,0,0,2,2,36
3440,2022-12-26,PIPER,gemGrab,Minecart Madness,0,1,4,5,60
3441,2022-12-26,PIPER,brawlBall,Center Stage,0,1,2,3,78
3442,2022-12-25,PIPER,brawlBall,Backyard Bowl,0,3,12,15,78
3443,2022-12-25,PIPER,bounty,Layer Cake,0,0,1,1,12
3444,2022-12-24,PIPER,bounty,Dry Season,0,1,1,2,12
3445,2022-12-23,PIPER,knockout,Out in the Open,0,3,2,5,132
3446,2022-12-21,PIPER,bounty,Shooting Star,0,1,1,2,6
3447,2022-12-20,PIPER,brawlBall,Beach Ball,0,1,0,1,96
3448,2022-12-18,PIPER,heist,Bridge Too Far,0,1,1,2,12
3449,2022-12-17,PIPER,knockout,Flaring Phoenix,0,1,0,1,30
3450,2022-12-16,PIPER,bounty,Temple Ruins,0,1,0,1,24
3451,2022-12-13,PIPER,knockout,New Perspective,0,1,0,1,84
3452,2022-11-11,PIPER,knockout,New Perspective,0,1,0,1,12
3453,2022-11-01,PIPER,knockout,New Perspective,0,2,4,6,54
3454,2022-10-30,PIPER,knockout,Out in the Open,0,1,0,1,12
3455,2022-10-28,PIPER,knockout,Out in the Open,0,1,1,2,18
3456,2022-10-26,PIPER,bounty,Shooting Star,0,6,3,9,36
3457,2022-10-15,PIPER,gemGrab,Hard Rock Mine,0,1,2,3,90
3458,2022-10-10,PIPER,knockout,Belle's Rock,0,0,2,2,48
3459,2023-01-28,PENNY,knockout,Flaring Phoenix,0,95,85,180,12366
3460,2023-01-28,PENNY,hotZone,Controller Chaos,0,132,134,266,10134
3461,2023-01-28,PENNY,heist,Bridge Too Far,0,78,42,120,24240
3462,2023-01-28,PENNY,gemGrab,Hard Rock Mine,0,180,181,361,16638
3463,2023-01-28,PENNY,gemGrab,Deep Diner,0,100,122,222,5478
3464,2023-01-28,PENNY,brawlBall,Super Beach,10,362,405,777,74430
3465,2023-01-28,PENNY,brawlBall,Sneaky Fields,0,12,6,18,3582
3466,2023-01-28,PENNY,bounty,Canal Grande,0,201,266,467,10902
3467,2023-01-27,PENNY,knockout,Flaring Phoenix,1,38,52,91,5928
3468,2023-01-27,PENNY,hotZone,Controller Chaos,0,31,18,49,2676
3469,2023-01-27,PENNY,heist,Hot Potato,0,28,25,53,3486
3470,2023-01-27,PENNY,gemGrab,Undermine,0,14,18,32,942
3471,2023-01-27,PENNY,gemGrab,Deep Diner,0,132,191,323,6846
3472,2023-01-27,PENNY,brawlBall,Sneaky Fields,2,59,71,132,23514
3473,2023-01-27,PENNY,brawlBall,Pinhole Punt,0,1,2,3,738
3474,2023-01-27,PENNY,bounty,Temple Ruins,0,6,3,9,1890
3475,2023-01-26,PENNY,knockout,Riverside,0,32,38,70,19008
3476,2023-01-26,PENNY,hotZone,Open Zone,0,113,133,246,10182
3477,2023-01-26,PENNY,heist,Hot Potato,0,62,29,91,14610
3478,2023-01-26,PENNY,gemGrab,Undermine,0,94,79,173,10062
3479,2023-01-26,PENNY,gemGrab,Gem Fort,0,25,20,45,4674
3480,2023-01-26,PENNY,brawlBall,Sunny Soccer,0,13,21,34,3660
3481,2023-01-26,PENNY,brawlBall,Pinhole Punt,12,282,339,633,67338
3482,2023-01-26,PENNY,bounty,Temple Ruins,0,47,77,124,5610
3483,2023-01-25,PENNY,knockout,Riverside,0,19,20,39,9906
3484,2023-01-25,PENNY,hotZone,Open Zone,0,52,66,118,5262
3485,2023-01-25,PENNY,heist,Safe Zone,0,140,95,235,9156
3486,2023-01-25,PENNY,gemGrab,Gem Fort,0,35,30,65,5556
3487,2023-01-25,PENNY,gemGrab,Crystal Arcade,0,96,144,240,7866
3488,2023-01-25,PENNY,brawlBall,Sunny Soccer,4,180,207,391,40830
3489,2023-01-25,PENNY,brawlBall,Beach Ball,1,39,51,91,6408
3490,2023-01-25,PENNY,bounty,Excel,0,53,62,115,5790
3491,2023-01-24,PENNY,knockout,New Perspective,0,31,30,61,10542
3492,2023-01-24,PENNY,hotZone,Dueling Beetles,0,385,416,801,10662
3493,2023-01-24,PENNY,heist,Safe Zone,0,173,157,330,15750
3494,2023-01-24,PENNY,gemGrab,Minecart Madness,0,41,49,90,4002
3495,2023-01-24,PENNY,gemGrab,Crystal Arcade,0,165,204,369,14460
3496,2023-01-24,PENNY,brawlBall,Center Stage,2,22,27,51,7860
3497,2023-01-24,PENNY,brawlBall,Beach Ball,12,285,375,672,64614
3498,2023-01-24,PENNY,bounty,Excel,0,114,205,319,10896
3499,2023-01-23,PENNY,knockout,New Perspective,0,72,52,124,20676
3500,2023-01-23,PENNY,hotZone,Dueling Beetles,2,640,860,1502,17502
3501,2023-01-23,PENNY,heist,Snaked Assault,0,71,24,95,15762
3502,2023-01-23,PENNY,gemGrab,Minecart Madness,0,247,250,497,19062
3503,2023-01-23,PENNY,gemGrab,Double Swoosh,0,84,149,233,7578
3504,2023-01-23,PENNY,brawlBall,Center Stage,10,225,267,502,92862
3505,2023-01-23,PENNY,brawlBall,Backyard Bowl,2,17,25,44,4224
3506,2023-01-23,PENNY,bounty,Layer Cake,0,202,303,505,11142
3507,2023-01-22,PENNY,knockout,X Marks the Spot,0,37,28,65,9174
3508,2023-01-22,PENNY,hotZone,Ring of Fire,0,155,169,324,5730
3509,2023-01-22,PENNY,heist,Snaked Assault,0,46,18,64,8232
3510,2023-01-22,PENNY,gemGrab,Hard Rock Mine,0,42,31,73,4722
3511,2023-01-22,PENNY,gemGrab,Double Swoosh,0,112,174,286,9426
3512,2023-01-22,PENNY,brawlBall,Super Beach,3,35,41,79,7386
3513,2023-01-22,PENNY,brawlBall,Backyard Bowl,10,140,197,347,34788
3514,2023-01-22,PENNY,bounty,Layer Cake,0,133,172,305,6654
3515,2023-01-21,PENNY,knockout,X Marks the Spot,1,86,101,188,31698
3516,2023-01-21,PENNY,hotZone,Ring of Fire,1,447,562,1010,16632
3517,2023-01-21,PENNY,heist,Tornado Ring,0,59,27,86,11664
3518,2023-01-21,PENNY,gemGrab,Hard Rock Mine,0,241,340,581,22980
3519,2023-01-21,PENNY,gemGrab,Deep Diner,0,61,81,142,4470
3520,2023-01-21,PENNY,brawlBall,Super Beach,14,415,551,980,101364
3521,2023-01-21,PENNY,brawlBall,Sneaky Fields,0,18,11,29,3750
3522,2023-01-21,PENNY,bounty,Dry Season,0,135,177,312,14538
3523,2023-01-20,PENNY,knockout,Out in the Open,1,94,95,190,20106
3524,2023-01-20,PENNY,hotZone,Split,0,61,54,115,9678
3525,2023-01-20,PENNY,heist,Tornado Ring,0,45,23,68,12672
3526,2023-01-20,PENNY,gemGrab,Undermine,0,58,64,122,5442
3527,2023-01-20,PENNY,gemGrab,Deep Diner,0,306,393,699,19050
3528,2023-01-20,PENNY,brawlBall,Sneaky Fields,8,167,222,397,74778
3529,2023-01-20,PENNY,brawlBall,Pinhole Punt,0,8,10,18,2886
3530,2023-01-20,PENNY,bounty,Dry Season,0,111,159,270,11640
3531,2023-01-19,PENNY,knockout,Out in the Open,0,137,162,299,26574
3532,2023-01-19,PENNY,hotZone,Split,0,74,43,117,14856
3533,2023-01-19,PENNY,heist,Kaboom Canyon,1,67,42,110,6732
3534,2023-01-19,PENNY,gemGrab,Undermine,0,160,222,382,14154
3535,2023-01-19,PENNY,gemGrab,Gem Fort,0,17,31,48,2934
3536,2023-01-19,PENNY,brawlBall,Sunny Soccer,0,7,7,14,2274
3537,2023-01-19,PENNY,brawlBall,Pinhole Punt,11,225,272,508,72498
3538,2023-01-19,PENNY,bounty,Shooting Star,0,59,25,84,11124
3539,2023-01-18,PENNY,knockout,Goldarm Gulch,0,7,7,14,2784
3540,2023-01-18,PENNY,hotZone,Parallel Plays,0,14,14,28,1158
3541,2023-01-18,PENNY,heist,Kaboom Canyon,0,20,19,39,2592
3542,2023-01-18,PENNY,gemGrab,Gem Fort,0,27,32,59,3006
3543,2023-01-18,PENNY,gemGrab,Crystal Arcade,0,15,22,37,990
3544,2023-01-18,PENNY,brawlBall,Sunny Soccer,4,72,92,168,18941
3545,2023-01-18,PENNY,brawlBall,Beach Ball,0,2,1,3,774
3546,2023-01-18,PENNY,bounty,Shooting Star,0,10,16,26,5088
3547,2023-01-17,PENNY,knockout,Goldarm Gulch,0,9,11,20,2520
3548,2023-01-17,PENNY,hotZone,Parallel Plays,0,11,25,36,1038
3549,2023-01-17,PENNY,heist,Pit Stop,0,7,3,10,1290
3550,2023-01-17,PENNY,gemGrab,Minecart Madness,0,1,5,6,216
3551,2023-01-17,PENNY,gemGrab,Crystal Arcade,0,17,13,30,1266
3552,2023-01-17,PENNY,brawlBall,Center Stage,0,0,2,2,288
3553,2023-01-17,PENNY,brawlBall,Beach Ball,4,20,24,48,5886
3554,2023-01-17,PENNY,bounty,Hideout,0,2,6,8,750
3555,2023-01-16,PENNY,knockout,Belle's Rock,0,18,30,48,1788
3556,2023-01-16,PENNY,hotZone,Quarter Pounder,0,16,37,53,1494
3557,2023-01-16,PENNY,heist,Pit Stop,0,11,5,16,4044
3558,2023-01-16,PENNY,gemGrab,Minecart Madness,0,7,16,23,1422
3559,2023-01-16,PENNY,gemGrab,Double Swoosh,0,3,3,6,708
3560,2023-01-16,PENNY,brawlBall,Center Stage,0,8,5,13,5778
3561,2023-01-16,PENNY,brawlBall,Backyard Bowl,1,3,30,34,852
3562,2023-01-16,PENNY,bounty,Hideout,0,4,1,5,1470
3563,2023-01-15,PENNY,knockout,Belle's Rock,0,17,7,24,2904
3564,2023-01-15,PENNY,hotZone,Quarter Pounder,0,35,68,103,3318
3565,2023-01-15,PENNY,heist,Bridge Too Far,0,11,17,28,2736
3566,2023-01-15,PENNY,gemGrab,Hard Rock Mine,0,10,7,17,1014
3567,2023-01-15,PENNY,gemGrab,Double Swoosh,0,29,58,87,2178
3568,2023-01-15,PENNY,brawlBall,Super Beach,1,4,3,8,1074
3569,2023-01-15,PENNY,brawlBall,Backyard Bowl,2,39,97,138,8946
3570,2023-01-15,PENNY,bounty,Canal Grande,0,12,30,42,960
3571,2023-01-14,PENNY,knockout,Flaring Phoenix,0,3,2,5,1080
3572,2023-01-14,PENNY,hotZone,Controller Chaos,0,35,37,72,2772
3573,2023-01-14,PENNY,heist,Bridge Too Far,0,10,18,28,4020
3574,2023-01-14,PENNY,gemGrab,Hard Rock Mine,0,13,14,27,1272
3575,2023-01-14,PENNY,gemGrab,Deep Diner,0,14,3,17,858
3576,2023-01-14,PENNY,brawlBall,Super Beach,0,15,43,58,6336
3577,2023-01-14,PENNY,brawlBall,Sneaky Fields,0,1,6,7,918
3578,2023-01-14,PENNY,bounty,Canal Grande,0,15,22,37,1014
3579,2023-01-13,PENNY,knockout,Flaring Phoenix,0,5,16,21,1182
3580,2023-01-13,PENNY,hotZone,Controller Chaos,0,33,69,102,2928
3581,2023-01-13,PENNY,heist,Hot Potato,0,1,0,1,600
3582,2023-01-13,PENNY,gemGrab,Deep Diner,0,28,31,59,1650
3583,2023-01-13,PENNY,brawlBall,Sneaky Fields,0,11,10,21,6144
3584,2023-01-13,PENNY,bounty,Temple Ruins,0,3,0,3,270
3585,2023-01-12,PENNY,knockout,Riverside,0,5,1,6,2532
3586,2023-01-12,PENNY,hotZone,Open Zone,0,14,26,40,1488
3587,2023-01-12,PENNY,heist,Hot Potato,0,1,0,1,330
3588,2023-01-12,PENNY,gemGrab,Undermine,0,10,9,19,690
3589,2023-01-12,PENNY,gemGrab,Gem Fort,0,1,1,2,162
3590,2023-01-12,PENNY,brawlBall,Sunny Soccer,0,2,1,3,240
3591,2023-01-12,PENNY,brawlBall,Pinhole Punt,1,8,9,18,2292
3592,2023-01-11,PENNY,knockout,Riverside,0,1,0,1,528
3593,2023-01-11,PENNY,hotZone,Open Zone,0,2,0,2,462
3594,2023-01-11,PENNY,heist,Safe Zone,0,0,1,1,48
3595,2023-01-11,PENNY,gemGrab,Gem Fort,0,2,3,5,414
3596,2023-01-11,PENNY,brawlBall,Sunny Soccer,1,8,11,20,1638
3597,2023-01-11,PENNY,brawlBall,Beach Ball,0,1,0,1,48
3598,2023-01-11,PENNY,bounty,Excel,0,6,0,6,282
3599,2023-01-10,PENNY,knockout,New Perspective,0,2,1,3,720
3600,2023-01-10,PENNY,hotZone,Dueling Beetles,0,63,84,147,2424
3601,2023-01-10,PENNY,heist,Safe Zone,0,10,3,13,1176
3602,2023-01-10,PENNY,gemGrab,Minecart Madness,0,10,2,12,828
3603,2023-01-10,PENNY,gemGrab,Crystal Arcade,0,34,53,87,1746
3604,2023-01-10,PENNY,brawlBall,Beach Ball,0,20,42,62,4392
3605,2023-01-10,PENNY,bounty,Excel,0,2,6,8,330
3606,2023-01-09,PENNY,knockout,New Perspective,0,2,1,3,876
3607,2023-01-09,PENNY,hotZone,Dueling Beetles,0,44,62,106,1554
3608,2023-01-09,PENNY,heist,Snaked Assault,0,12,2,14,2022
3609,2023-01-09,PENNY,gemGrab,Minecart Madness,0,17,11,28,1884
3610,2023-01-09,PENNY,gemGrab,Double Swoosh,0,15,6,21,1320
3611,2023-01-09,PENNY,brawlBall,Center Stage,0,4,5,9,5460
3612,2023-01-09,PENNY,brawlBall,Backyard Bowl,0,2,0,2,474
3613,2023-01-09,PENNY,bounty,Layer Cake,0,25,30,55,1512
3614,2023-01-08,PENNY,knockout,X Marks the Spot,0,4,2,6,1692
3615,2023-01-08,PENNY,hotZone,Ring of Fire,0,25,48,73,1644
3616,2023-01-08,PENNY,heist,Snaked Assault,0,6,2,8,1494
3617,2023-01-08,PENNY,gemGrab,Hard Rock Mine,0,11,13,24,630
3618,2023-01-08,PENNY,gemGrab,Double Swoosh,0,3,8,11,864
3619,2023-01-08,PENNY,brawlBall,Super Beach,0,4,8,12,732
3620,2023-01-08,PENNY,brawlBall,Backyard Bowl,0,14,28,42,4830
3621,2023-01-08,PENNY,bounty,Layer Cake,0,5,5,10,528
3622,2023-01-07,PENNY,knockout,X Marks the Spot,0,3,1,4,1014
3623,2023-01-07,PENNY,hotZone,Ring of Fire,0,14,40,54,846
3624,2023-01-07,PENNY,heist,Tornado Ring,0,5,2,7,1350
3625,2023-01-07,PENNY,gemGrab,Hard Rock Mine,0,6,18,24,1158
3626,2023-01-07,PENNY,gemGrab,Deep Diner,0,8,2,10,918
3627,2023-01-07,PENNY,brawlBall,Super Beach,0,12,20,32,2622
3628,2023-01-07,PENNY,brawlBall,Sneaky Fields,0,0,1,1,402
3629,2023-01-07,PENNY,bounty,Dry Season,0,10,14,24,1320
3630,2023-01-06,PENNY,knockout,Out in the Open,0,12,13,25,1446
3631,2023-01-06,PENNY,hotZone,Split,0,3,1,4,1158
3632,2023-01-06,PENNY,heist,Tornado Ring,0,6,2,8,2538
3633,2023-01-06,PENNY,gemGrab,Undermine,0,3,0,3,540
3634,2023-01-06,PENNY,gemGrab,Deep Diner,0,49,49,98,2226
3635,2023-01-06,PENNY,brawlBall,Sneaky Fields,0,7,19,26,4896
3636,2023-01-06,PENNY,bounty,Dry Season,0,21,20,41,1944
3637,2023-01-05,PENNY,knockout,Out in the Open,0,15,21,36,2958
3638,2023-01-05,PENNY,hotZone,Split,0,12,10,22,3552
3639,2023-01-05,PENNY,heist,Kaboom Canyon,0,11,14,25,954
3640,2023-01-05,PENNY,gemGrab,Undermine,0,13,47,60,1812
3641,2023-01-05,PENNY,gemGrab,Gem Fort,0,0,2,2,252
3642,2023-01-05,PENNY,brawlBall,Sunny Soccer,0,1,0,1,84
3643,2023-01-05,PENNY,brawlBall,Pinhole Punt,2,24,35,61,8118
3644,2023-01-05,PENNY,bounty,Shooting Star,0,7,0,7,1362
3645,2023-01-04,PENNY,knockout,Goldarm Gulch,0,3,15,18,696
3646,2023-01-04,PENNY,hotZone,Parallel Plays,0,7,6,13,864
3647,2023-01-04,PENNY,heist,Kaboom Canyon,0,14,2,16,1848
3648,2023-01-04,PENNY,gemGrab,Gem Fort,0,21,32,53,1788
3649,2023-01-04,PENNY,gemGrab,Crystal Arcade,0,6,4,10,642
3650,2023-01-04,PENNY,brawlBall,Sunny Soccer,2,29,36,67,6312
3651,2023-01-04,PENNY,bounty,Shooting Star,0,14,2,16,3570
3652,2023-01-03,PENNY,knockout,Goldarm Gulch,0,4,5,9,720
3653,2023-01-03,PENNY,hotZone,Parallel Plays,0,6,11,17,1542
3654,2023-01-03,PENNY,hotZone,Controller Chaos,0,1,1,2,12
3655,2023-01-03,PENNY,heist,Pit Stop,0,5,0,5,1956
3656,2023-01-03,PENNY,gemGrab,Minecart Madness,0,10,18,28,456
3657,2023-01-03,PENNY,gemGrab,Crystal Arcade,0,23,23,46,2406
3658,2023-01-03,PENNY,brawlBall,Center Stage,0,1,0,1,294
3659,2023-01-03,PENNY,brawlBall,Beach Ball,0,11,35,46,5580
3660,2023-01-03,PENNY,bounty,Hideout,0,11,2,13,1638
3661,2023-01-02,PENNY,knockout,Belle's Rock,0,6,3,9,1794
3662,2023-01-02,PENNY,hotZone,Quarter Pounder,0,21,23,44,2652
3663,2023-01-02,PENNY,heist,Pit Stop,0,3,3,6,3498
3664,2023-01-02,PENNY,heist,Kaboom Canyon,0,0,1,1,30
3665,2023-01-02,PENNY,gemGrab,Minecart Madness,0,27,42,69,2352
3666,2023-01-02,PENNY,gemGrab,Double Swoosh,0,25,36,61,1512
3667,2023-01-02,PENNY,brawlBall,Center Stage,0,12,5,17,7110
3668,2023-01-02,PENNY,brawlBall,Backyard Bowl,0,3,7,10,492
3669,2023-01-02,PENNY,bounty,Hideout,0,17,7,24,3090
3670,2023-01-01,PENNY,knockout,Belle's Rock,0,2,2,4,858
3671,2023-01-01,PENNY,hotZone,Quarter Pounder,0,5,9,14,1188
3672,2023-01-01,PENNY,heist,Kaboom Canyon,0,1,0,1,12
3673,2023-01-01,PENNY,heist,Bridge Too Far,0,1,0,1,462
3674,2023-01-01,PENNY,gemGrab,Minecart Madness,0,1,1,2,12
3675,2023-01-01,PENNY,gemGrab,Double Swoosh,0,15,38,53,1140
3676,2023-01-01,PENNY,brawlBall,Backyard Bowl,0,11,5,16,2658
3677,2023-01-01,PENNY,bounty,Canal Grande,0,0,1,1,132
3678,2022-12-31,PENNY,hotZone,Controller Chaos,0,0,1,1,198
3679,2022-12-31,PENNY,heist,Bridge Too Far,0,1,1,2,276
3680,2022-12-31,PENNY,gemGrab,Minecart Madness,0,1,2,3,24
3681,2022-12-31,PENNY,gemGrab,Hard Rock Mine,0,6,5,11,384
3682,2022-12-31,PENNY,gemGrab,Deep Diner,0,6,20,26,306
3683,2022-12-31,PENNY,brawlBall,Super Beach,0,4,7,11,618
3684,2022-12-31,PENNY,bounty,Canal Grande,0,1,2,3,54
3685,2022-12-30,PENNY,heist,Hot Potato,0,1,0,1,30
3686,2022-12-30,PENNY,gemGrab,Minecart Madness,0,0,1,1,24
3687,2022-12-30,PENNY,gemGrab,Deep Diner,0,10,16,26,438
3688,2022-12-30,PENNY,brawlBall,Sneaky Fields,0,1,0,1,552
3689,2022-12-29,PENNY,hotZone,Controller Chaos,0,1,0,1,12
3690,2022-12-29,PENNY,heist,Kaboom Canyon,0,0,1,1,18
3691,2022-12-29,PENNY,gemGrab,Undermine,0,1,0,1,102
3692,2022-12-29,PENNY,brawlBall,Pinhole Punt,0,3,0,3,282
3693,2022-12-27,PENNY,hotZone,Dueling Beetles,0,2,1,3,36
3694,2022-12-27,PENNY,heist,Kaboom Canyon,0,0,1,1,18
3695,2022-12-27,PENNY,gemGrab,Minecart Madness,0,1,0,1,30
3696,2022-12-27,PENNY,bounty,Excel,0,1,0,1,18
3697,2022-12-26,PENNY,brawlBall,Center Stage,0,2,1,3,78
3698,2022-12-25,PENNY,gemGrab,Double Swoosh,0,2,4,6,30
3699,2022-12-24,PENNY,bounty,Dry Season,0,1,1,2,12
3700,2022-12-23,PENNY,knockout,Out in the Open,0,2,0,2,132
3701,2022-12-22,PENNY,gemGrab,Gem Fort,0,1,0,1,90
3702,2022-12-20,PENNY,brawlBall,Beach Ball,0,1,1,2,96
3703,2022-12-18,PENNY,heist,Bridge Too Far,0,1,0,1,12
3704,2022-12-17,PENNY,brawlBall,Super Beach,0,0,1,1,6
3705,2022-12-16,PENNY,gemGrab,Undermine,0,0,1,1,6
3706,2022-12-16,PENNY,brawlBall,Sneaky Fields,0,1,0,1,84
3707,2022-12-16,PENNY,bounty,Temple Ruins,0,1,4,5,24
3708,2022-12-13,PENNY,heist,Safe Zone,0,1,1,2,42
3709,2022-12-13,PENNY,gemGrab,Crystal Arcade,0,0,2,2,72
3710,2022-10-30,PENNY,hotZone,Dueling Beetles,0,0,2,2,12
3711,2022-10-28,PENNY,hotZone,Dueling Beetles,0,1,0,1,12
3712,2022-10-26,PENNY,bounty,Shooting Star,0,0,1,1,36
3713,2022-10-15,PENNY,hotZone,Ring of Fire,0,2,2,4,24
3714,2022-10-15,PENNY,gemGrab,Hard Rock Mine,0,1,0,1,90
3715,2022-10-15,PENNY,bounty,Dry Season,0,1,0,1,6
3716,2022-10-10,PENNY,knockout,Belle's Rock,0,1,0,1,48
3717,2023-01-28,PAM,knockout,Flaring Phoenix,0,18,8,26,12366
3718,2023-01-28,PAM,hotZone,Controller Chaos,0,81,71,152,10134
3719,2023-01-28,PAM,heist,Bridge Too Far,0,30,27,57,24240
3720,2023-01-28,PAM,gemGrab,Hard Rock Mine,0,63,87,150,16638
3721,2023-01-28,PAM,gemGrab,Deep Diner,0,22,18,40,5478
3722,2023-01-28,PAM,brawlBall,Super Beach,1,88,96,185,74430
3723,2023-01-28,PAM,brawlBall,Sneaky Fields,0,4,3,7,3582
3724,2023-01-28,PAM,bounty,Canal Grande,0,13,18,31,10902
3725,2023-01-27,PAM,knockout,Flaring Phoenix,0,4,4,8,5928
3726,2023-01-27,PAM,hotZone,Controller Chaos,0,36,40,76,2676
3727,2023-01-27,PAM,heist,Hot Potato,0,4,4,8,3486
3728,2023-01-27,PAM,gemGrab,Undermine,0,2,11,13,942
3729,2023-01-27,PAM,gemGrab,Deep Diner,0,33,32,65,6846
3730,2023-01-27,PAM,brawlBall,Sneaky Fields,2,37,61,100,23514
3731,2023-01-27,PAM,brawlBall,Pinhole Punt,0,3,2,5,738
3732,2023-01-27,PAM,bounty,Temple Ruins,0,4,3,7,1890
3733,2023-01-26,PAM,knockout,Riverside,1,12,17,30,19008
3734,2023-01-26,PAM,hotZone,Open Zone,0,137,208,345,10182
3735,2023-01-26,PAM,heist,Hot Potato,0,19,15,34,14610
3736,2023-01-26,PAM,gemGrab,Undermine,0,76,146,222,10062
3737,2023-01-26,PAM,gemGrab,Gem Fort,0,37,54,91,4674
3738,2023-01-26,PAM,brawlBall,Sunny Soccer,0,5,1,6,3660
3739,2023-01-26,PAM,brawlBall,Pinhole Punt,10,193,255,458,67338
3740,2023-01-26,PAM,bounty,Temple Ruins,0,17,14,31,5610
3741,2023-01-25,PAM,knockout,Riverside,0,6,2,8,9906
3742,2023-01-25,PAM,hotZone,Open Zone,0,73,115,188,5262
3743,2023-01-25,PAM,heist,Safe Zone,0,5,3,8,9156
3744,2023-01-25,PAM,gemGrab,Gem Fort,0,29,28,57,5556
3745,2023-01-25,PAM,gemGrab,Crystal Arcade,0,34,33,67,7866
3746,2023-01-25,PAM,brawlBall,Sunny Soccer,3,67,56,126,40830
3747,2023-01-25,PAM,brawlBall,Beach Ball,0,7,7,14,6408
3748,2023-01-25,PAM,bounty,Excel,0,3,2,5,5790
3749,2023-01-24,PAM,knockout,New Perspective,0,15,22,37,10542
3750,2023-01-24,PAM,hotZone,Dueling Beetles,0,66,79,145,10662
3751,2023-01-24,PAM,heist,Safe Zone,0,15,25,40,15750
3752,2023-01-24,PAM,gemGrab,Minecart Madness,0,13,12,25,4002
3753,2023-01-24,PAM,gemGrab,Crystal Arcade,0,54,68,122,14460
3754,2023-01-24,PAM,brawlBall,Center Stage,2,13,27,42,7860
3755,2023-01-24,PAM,brawlBall,Beach Ball,3,120,161,284,64614
3756,2023-01-24,PAM,bounty,Excel,0,5,18,23,10896
3757,2023-01-23,PAM,knockout,New Perspective,0,13,8,21,20676
3758,2023-01-23,PAM,hotZone,Dueling Beetles,0,77,66,143,17502
3759,2023-01-23,PAM,heist,Snaked Assault,1,13,5,19,15762
3760,2023-01-23,PAM,gemGrab,Minecart Madness,0,55,79,134,19062
3761,2023-01-23,PAM,gemGrab,Double Swoosh,0,43,40,83,7578
3762,2023-01-23,PAM,brawlBall,Center Stage,6,123,128,257,92862
3763,2023-01-23,PAM,brawlBall,Backyard Bowl,1,18,38,57,4224
3764,2023-01-23,PAM,bounty,Layer Cake,0,3,3,6,11142
3765,2023-01-22,PAM,knockout,X Marks the Spot,0,6,11,17,9174
3766,2023-01-22,PAM,hotZone,Ring of Fire,0,27,38,65,5730
3767,2023-01-22,PAM,heist,Snaked Assault,0,8,10,18,8232
3768,2023-01-22,PAM,gemGrab,Hard Rock Mine,0,6,12,18,4722
3769,2023-01-22,PAM,gemGrab,Double Swoosh,0,58,68,126,9426
3770,2023-01-22,PAM,brawlBall,Super Beach,0,3,5,8,7386
3771,2023-01-22,PAM,brawlBall,Backyard Bowl,10,146,256,412,34788
3772,2023-01-22,PAM,bounty,Layer Cake,0,3,1,4,6654
3773,2023-01-21,PAM,knockout,X Marks the Spot,0,25,25,50,31698
3774,2023-01-21,PAM,hotZone,Ring of Fire,0,118,128,246,16632
3775,2023-01-21,PAM,heist,Tornado Ring,0,22,20,42,11664
3776,2023-01-21,PAM,gemGrab,Hard Rock Mine,0,66,84,150,22980
3777,2023-01-21,PAM,gemGrab,Deep Diner,0,21,30,51,4470
3778,2023-01-21,PAM,brawlBall,Super Beach,7,102,101,210,101364
3779,2023-01-21,PAM,brawlBall,Sneaky Fields,0,7,9,16,3750
3780,2023-01-21,PAM,bounty,Dry Season,0,13,8,21,14538
3781,2023-01-20,PAM,knockout,Out in the Open,0,31,19,50,20106
3782,2023-01-20,PAM,hotZone,Split,0,26,18,44,9678
3783,2023-01-20,PAM,heist,Tornado Ring,0,20,5,25,12672
3784,2023-01-20,PAM,gemGrab,Undermine,0,52,110,162,5442
3785,2023-01-20,PAM,gemGrab,Deep Diner,0,76,81,157,19050
3786,2023-01-20,PAM,brawlBall,Sneaky Fields,2,97,114,213,74778
3787,2023-01-20,PAM,brawlBall,Pinhole Punt,1,11,22,34,2886
3788,2023-01-20,PAM,bounty,Dry Season,0,10,8,18,11640
3789,2023-01-19,PAM,knockout,Out in the Open,0,30,23,53,26574
3790,2023-01-19,PAM,hotZone,Split,0,51,62,113,14856
3791,2023-01-19,PAM,heist,Kaboom Canyon,0,29,18,47,6732
3792,2023-01-19,PAM,gemGrab,Undermine,0,94,163,257,14154
3793,2023-01-19,PAM,gemGrab,Gem Fort,0,15,11,26,2934
3794,2023-01-19,PAM,brawlBall,Sunny Soccer,0,0,3,3,2274
3795,2023-01-19,PAM,brawlBall,Pinhole Punt,12,226,323,561,72498
3796,2023-01-19,PAM,bounty,Shooting Star,0,18,11,29,11124
3797,2023-01-18,PAM,knockout,Goldarm Gulch,0,2,2,4,2784
3798,2023-01-18,PAM,hotZone,Parallel Plays,0,11,6,17,1158
3799,2023-01-18,PAM,heist,Kaboom Canyon,0,7,17,24,2592
3800,2023-01-18,PAM,gemGrab,Gem Fort,0,28,39,67,3006
3801,2023-01-18,PAM,gemGrab,Crystal Arcade,0,2,1,3,990
3802,2023-01-18,PAM,brawlBall,Sunny Soccer,0,30,33,63,18941
3803,2023-01-18,PAM,brawlBall,Beach Ball,1,4,3,8,774
3804,2023-01-18,PAM,bounty,Shooting Star,0,6,3,9,5088
3805,2023-01-17,PAM,knockout,Goldarm Gulch,0,3,1,4,2520
3806,2023-01-17,PAM,hotZone,Parallel Plays,0,17,12,29,1038
3807,2023-01-17,PAM,heist,Pit Stop,0,0,1,1,1290
3808,2023-01-17,PAM,gemGrab,Crystal Arcade,0,1,5,6,1266
3809,2023-01-17,PAM,brawlBall,Beach Ball,1,16,12,29,5886
3810,2023-01-16,PAM,hotZone,Quarter Pounder,0,3,4,7,1494
3811,2023-01-16,PAM,heist,Pit Stop,0,1,0,1,4044
3812,2023-01-16,PAM,gemGrab,Minecart Madness,0,8,5,13,1422
3813,2023-01-16,PAM,gemGrab,Double Swoosh,0,6,18,24,708
3814,2023-01-16,PAM,brawlBall,Center Stage,0,8,27,35,5778
3815,2023-01-16,PAM,brawlBall,Backyard Bowl,0,8,0,8,852
3816,2023-01-15,PAM,hotZone,Quarter Pounder,0,20,24,44,3318
3817,2023-01-15,PAM,heist,Bridge Too Far,0,2,1,3,2736
3818,2023-01-15,PAM,gemGrab,Hard Rock Mine,0,1,16,17,1014
3819,2023-01-15,PAM,gemGrab,Double Swoosh,0,10,7,17,2178
3820,2023-01-15,PAM,brawlBall,Super Beach,0,1,0,1,1074
3821,2023-01-15,PAM,brawlBall,Backyard Bowl,0,38,59,97,8946
3822,2023-01-14,PAM,knockout,Flaring Phoenix,0,1,0,1,1080
3823,2023-01-14,PAM,hotZone,Controller Chaos,0,18,43,61,2772
3824,2023-01-14,PAM,heist,Bridge Too Far,0,4,2,6,4020
3825,2023-01-14,PAM,gemGrab,Hard Rock Mine,0,1,11,12,1272
3826,2023-01-14,PAM,gemGrab,Deep Diner,0,2,1,3,858
3827,2023-01-14,PAM,brawlBall,Super Beach,0,4,8,12,6336
3828,2023-01-14,PAM,bounty,Canal Grande,0,1,0,1,1014
3829,2023-01-13,PAM,hotZone,Controller Chaos,0,9,9,18,2928
3830,2023-01-13,PAM,gemGrab,Deep Diner,0,3,5,8,1650
3831,2023-01-13,PAM,brawlBall,Sneaky Fields,0,12,7,19,6144
3832,2023-01-13,PAM,brawlBall,Pinhole Punt,0,0,1,1,156
3833,2023-01-13,PAM,bounty,Temple Ruins,0,1,1,2,270
3834,2023-01-12,PAM,knockout,Riverside,0,7,7,14,2532
3835,2023-01-12,PAM,hotZone,Open Zone,0,17,14,31,1488
3836,2023-01-12,PAM,gemGrab,Undermine,0,10,14,24,690
3837,2023-01-12,PAM,gemGrab,Gem Fort,0,2,1,3,162
3838,2023-01-12,PAM,brawlBall,Pinhole Punt,0,7,13,20,2292
3839,2023-01-11,PAM,hotZone,Open Zone,0,7,4,11,462
3840,2023-01-11,PAM,gemGrab,Gem Fort,0,1,1,2,414
3841,2023-01-10,PAM,knockout,New Perspective,0,1,0,1,720
3842,2023-01-10,PAM,hotZone,Dueling Beetles,0,9,14,23,2424
3843,2023-01-10,PAM,heist,Safe Zone,0,10,14,24,1176
3844,2023-01-10,PAM,gemGrab,Minecart Madness,0,2,5,7,828
3845,2023-01-10,PAM,gemGrab,Crystal Arcade,0,6,3,9,1746
3846,2023-01-10,PAM,brawlBall,Beach Ball,0,1,1,2,4392
3847,2023-01-10,PAM,bounty,Excel,0,1,0,1,330
3848,2023-01-09,PAM,hotZone,Dueling Beetles,0,4,1,5,1554
3849,2023-01-09,PAM,heist,Snaked Assault,0,2,0,2,2022
3850,2023-01-09,PAM,gemGrab,Minecart Madness,0,6,10,16,1884
3851,2023-01-09,PAM,gemGrab,Double Swoosh,0,5,10,15,1320
3852,2023-01-09,PAM,brawlBall,Center Stage,0,7,2,9,5460
3853,2023-01-09,PAM,brawlBall,Backyard Bowl,0,0,11,11,474
3854,2023-01-09,PAM,bounty,Layer Cake,0,1,0,1,1512
3855,2023-01-08,PAM,hotZone,Ring of Fire,0,19,23,42,1644
3856,2023-01-08,PAM,heist,Snaked Assault,0,2,0,2,1494
3857,2023-01-08,PAM,gemGrab,Hard Rock Mine,0,1,0,1,630
3858,2023-01-08,PAM,gemGrab,Double Swoosh,0,2,1,3,864
3859,2023-01-08,PAM,brawlBall,Super Beach,0,0,2,2,732
3860,2023-01-08,PAM,brawlBall,Backyard Bowl,0,11,41,52,4830
3861,2023-01-07,PAM,hotZone,Ring of Fire,0,7,22,29,846
3862,2023-01-07,PAM,heist,Tornado Ring,0,1,3,4,1350
3863,2023-01-07,PAM,gemGrab,Hard Rock Mine,0,2,2,4,1158
3864,2023-01-07,PAM,gemGrab,Deep Diner,0,1,0,1,918
3865,2023-01-07,PAM,brawlBall,Super Beach,0,1,7,8,2622
3866,2023-01-07,PAM,brawlBall,Sneaky Fields,0,1,0,1,402
3867,2023-01-06,PAM,heist,Tornado Ring,0,3,1,4,2538
3868,2023-01-06,PAM,gemGrab,Undermine,0,1,0,1,540
3869,2023-01-06,PAM,gemGrab,Deep Diner,0,1,2,3,2226
3870,2023-01-06,PAM,brawlBall,Sneaky Fields,0,2,6,8,4896
3871,2023-01-06,PAM,bounty,Dry Season,0,1,0,1,1944
3872,2023-01-05,PAM,knockout,Out in the Open,0,1,0,1,2958
3873,2023-01-05,PAM,hotZone,Split,0,3,0,3,3552
3874,2023-01-05,PAM,heist,Kaboom Canyon,0,2,0,2,954
3875,2023-01-05,PAM,gemGrab,Undermine,0,10,5,15,1812
3876,2023-01-05,PAM,gemGrab,Gem Fort,0,3,9,12,252
3877,2023-01-05,PAM,brawlBall,Pinhole Punt,0,23,42,65,8118
3878,2023-01-04,PAM,knockout,Goldarm Gulch,0,1,0,1,696
3879,2023-01-04,PAM,hotZone,Parallel Plays,0,3,5,8,864
3880,2023-01-04,PAM,heist,Kaboom Canyon,0,1,0,1,1848
3881,2023-01-04,PAM,gemGrab,Gem Fort,0,2,9,11,1788
3882,2023-01-04,PAM,gemGrab,Crystal Arcade,0,2,0,2,642
3883,2023-01-04,PAM,brawlBall,Sunny Soccer,1,10,12,23,6312
3884,2023-01-04,PAM,bounty,Shooting Star,0,4,1,5,3570
3885,2023-01-03,PAM,knockout,Goldarm Gulch,0,1,0,1,720
3886,2023-01-03,PAM,hotZone,Parallel Plays,0,5,8,13,1542
3887,2023-01-03,PAM,heist,Pit Stop,0,1,0,1,1956
3888,2023-01-03,PAM,gemGrab,Minecart Madness,0,1,2,3,456
3889,2023-01-03,PAM,gemGrab,Crystal Arcade,0,6,0,6,2406
3890,2023-01-03,PAM,brawlBall,Center Stage,0,2,0,2,294
3891,2023-01-03,PAM,brawlBall,Beach Ball,1,6,4,11,5580
3892,2023-01-03,PAM,bounty,Hideout,0,1,0,1,1638
3893,2023-01-02,PAM,knockout,Belle's Rock,0,1,0,1,1794
3894,2023-01-02,PAM,hotZone,Quarter Pounder,0,11,7,18,2652
3895,2023-01-02,PAM,gemGrab,Minecart Madness,0,9,10,19,2352
3896,2023-01-02,PAM,gemGrab,Double Swoosh,0,8,7,15,1512
3897,2023-01-02,PAM,brawlBall,Center Stage,0,12,8,20,7110
3898,2023-01-02,PAM,brawlBall,Backyard Bowl,0,2,2,4,492
3899,2023-01-02,PAM,bounty,Hideout,0,1,2,3,3090
3900,2023-01-01,PAM,hotZone,Quarter Pounder,0,4,3,7,1188
3901,2023-01-01,PAM,heist,Bridge Too Far,0,1,0,1,462
3902,2023-01-01,PAM,gemGrab,Double Swoosh,0,5,2,7,1140
3903,2023-01-01,PAM,brawlBall,Backyard Bowl,0,12,9,21,2658
3904,2022-12-31,PAM,hotZone,Controller Chaos,0,2,3,5,198
3905,2022-12-31,PAM,gemGrab,Deep Diner,0,2,0,2,306
3906,2022-12-31,PAM,brawlBall,Super Beach,0,0,1,1,618
3907,2022-12-31,PAM,bounty,Canal Grande,0,2,2,4,54
3908,2022-12-30,PAM,hotZone,Controller Chaos,0,1,3,4,288
3909,2022-12-30,PAM,gemGrab,Deep Diner,0,1,1,2,438
3910,2022-12-30,PAM,brawlBall,Sneaky Fields,0,1,2,3,552
3911,2022-12-29,PAM,hotZone,Controller Chaos,0,1,0,1,12
3912,2022-12-29,PAM,heist,Kaboom Canyon,0,0,1,1,18
3913,2022-12-29,PAM,gemGrab,Undermine,0,0,8,8,102
3914,2022-12-29,PAM,brawlBall,Pinhole Punt,0,1,0,1,282
3915,2022-12-28,PAM,hotZone,Open Zone,0,0,1,1,108
3916,2022-12-27,PAM,hotZone,Controller Chaos,0,0,1,1,24
3917,2022-12-27,PAM,brawlBall,Beach Ball,0,2,0,2,144
3918,2022-12-26,PAM,hotZone,Controller Chaos,0,1,0,1,30
3919,2022-12-26,PAM,heist,Kaboom Canyon,0,0,1,1,36
3920,2022-12-26,PAM,gemGrab,Minecart Madness,0,1,0,1,60
3921,2022-12-25,PAM,brawlBall,Backyard Bowl,0,1,1,2,78
3922,2022-12-22,PAM,brawlBall,Pinhole Punt,0,0,5,5,132
3923,2022-12-20,PAM,brawlBall,Beach Ball,0,0,1,1,96
3924,2022-12-16,PAM,brawlBall,Sneaky Fields,0,1,0,1,84
3925,2022-12-13,PAM,hotZone,Dueling Beetles,0,0,1,1,6
3926,2022-12-13,PAM,gemGrab,Crystal Arcade,0,1,0,1,72
3927,2022-11-07,PAM,hotZone,Quarter Pounder,0,1,0,1,24
3928,2022-10-30,PAM,brawlBall,Beach Ball,0,1,0,1,12
3929,2022-10-15,PAM,hotZone,Ring of Fire,0,0,2,2,24
3930,2022-10-15,PAM,gemGrab,Hard Rock Mine,0,0,1,1,90
3931,2023-01-28,OTIS,knockout,Flaring Phoenix,0,19,12,31,12366
3932,2023-01-28,OTIS,hotZone,Controller Chaos,0,89,138,227,10134
3933,2023-01-28,OTIS,heist,Bridge Too Far,0,87,78,165,24240
3934,2023-01-28,OTIS,gemGrab,Hard Rock Mine,0,93,132,225,16638
3935,2023-01-28,OTIS,gemGrab,Deep Diner,0,19,22,41,5478
3936,2023-01-28,OTIS,brawlBall,Super Beach,10,270,395,675,74430
3937,2023-01-28,OTIS,brawlBall,Sneaky Fields,0,18,15,33,3582
3938,2023-01-28,OTIS,bounty,Canal Grande,0,31,25,56,10902
3939,2023-01-27,OTIS,knockout,Flaring Phoenix,0,17,21,38,5928
3940,2023-01-27,OTIS,hotZone,Controller Chaos,0,17,30,47,2676
3941,2023-01-27,OTIS,heist,Hot Potato,0,5,12,17,3486
3942,2023-01-27,OTIS,gemGrab,Undermine,0,5,6,11,942
3943,2023-01-27,OTIS,gemGrab,Deep Diner,0,23,27,50,6846
3944,2023-01-27,OTIS,brawlBall,Sneaky Fields,2,132,163,297,23514
3945,2023-01-27,OTIS,brawlBall,Pinhole Punt,0,14,9,23,738
3946,2023-01-27,OTIS,bounty,Temple Ruins,0,14,43,57,1890
3947,2023-01-26,OTIS,knockout,Riverside,0,34,15,49,19008
3948,2023-01-26,OTIS,hotZone,Open Zone,0,50,67,117,10182
3949,2023-01-26,OTIS,heist,Hot Potato,0,19,17,36,14610
3950,2023-01-26,OTIS,gemGrab,Undermine,0,46,67,113,10062
3951,2023-01-26,OTIS,gemGrab,Gem Fort,0,29,32,61,4674
3952,2023-01-26,OTIS,brawlBall,Sunny Soccer,0,11,31,42,3660
3953,2023-01-26,OTIS,brawlBall,Pinhole Punt,18,381,597,996,67338
3954,2023-01-26,OTIS,bounty,Temple Ruins,0,22,37,59,5610
3955,2023-01-25,OTIS,knockout,Riverside,0,5,11,16,9906
3956,2023-01-25,OTIS,hotZone,Open Zone,0,13,22,35,5262
3957,2023-01-25,OTIS,heist,Safe Zone,0,18,27,45,9156
3958,2023-01-25,OTIS,gemGrab,Gem Fort,0,23,60,83,5556
3959,2023-01-25,OTIS,gemGrab,Crystal Arcade,0,51,90,141,7866
3960,2023-01-25,OTIS,brawlBall,Sunny Soccer,12,210,323,545,40830
3961,2023-01-25,OTIS,brawlBall,Beach Ball,3,47,70,120,6408
3962,2023-01-25,OTIS,bounty,Excel,0,16,12,28,5790
3963,2023-01-24,OTIS,knockout,New Perspective,0,36,34,70,10542
3964,2023-01-24,OTIS,hotZone,Dueling Beetles,0,26,31,57,10662
3965,2023-01-24,OTIS,heist,Safe Zone,0,25,18,43,15750
3966,2023-01-24,OTIS,gemGrab,Minecart Madness,0,16,22,38,4002
3967,2023-01-24,OTIS,gemGrab,Crystal Arcade,0,57,98,155,14460
3968,2023-01-24,OTIS,brawlBall,Center Stage,2,39,45,86,7860
3969,2023-01-24,OTIS,brawlBall,Beach Ball,14,372,477,863,64614
3970,2023-01-24,OTIS,bounty,Excel,0,31,19,50,10896
3971,2023-01-23,OTIS,knockout,New Perspective,0,52,65,117,20676
3972,2023-01-23,OTIS,hotZone,Dueling Beetles,0,91,83,174,17502
3973,2023-01-23,OTIS,heist,Snaked Assault,0,36,44,80,15762
3974,2023-01-23,OTIS,gemGrab,Minecart Madness,0,78,143,221,19062
3975,2023-01-23,OTIS,gemGrab,Double Swoosh,0,36,39,75,7578
3976,2023-01-23,OTIS,brawlBall,Center Stage,12,524,789,1325,92862
3977,2023-01-23,OTIS,brawlBall,Backyard Bowl,1,25,32,58,4224
3978,2023-01-23,OTIS,bounty,Layer Cake,0,24,41,65,11142
3979,2023-01-22,OTIS,knockout,X Marks the Spot,0,12,14,26,9174
3980,2023-01-22,OTIS,hotZone,Ring of Fire,0,17,23,40,5730
3981,2023-01-22,OTIS,heist,Snaked Assault,0,21,26,47,8232
3982,2023-01-22,OTIS,gemGrab,Hard Rock Mine,0,30,52,82,4722
3983,2023-01-22,OTIS,gemGrab,Double Swoosh,0,42,78,120,9426
3984,2023-01-22,OTIS,brawlBall,Super Beach,2,35,63,100,7386
3985,2023-01-22,OTIS,brawlBall,Backyard Bowl,19,179,267,465,34788
3986,2023-01-22,OTIS,bounty,Layer Cake,0,13,8,21,6654
3987,2023-01-21,OTIS,knockout,X Marks the Spot,1,55,76,132,31698
3988,2023-01-21,OTIS,hotZone,Ring of Fire,0,74,93,167,16632
3989,2023-01-21,OTIS,heist,Tornado Ring,1,19,23,43,11664
3990,2023-01-21,OTIS,gemGrab,Hard Rock Mine,0,87,91,178,22980
3991,2023-01-21,OTIS,gemGrab,Deep Diner,0,17,32,49,4470
3992,2023-01-21,OTIS,brawlBall,Super Beach,22,529,791,1342,101364
3993,2023-01-21,OTIS,brawlBall,Sneaky Fields,0,9,14,23,3750
3994,2023-01-21,OTIS,bounty,Dry Season,0,33,47,80,14538
3995,2023-01-20,OTIS,knockout,Out in the Open,0,73,90,163,20106
3996,2023-01-20,OTIS,hotZone,Split,0,10,17,27,9678
3997,2023-01-20,OTIS,heist,Tornado Ring,0,20,22,42,12672
3998,2023-01-20,OTIS,gemGrab,Undermine,0,20,30,50,5442
3999,2023-01-20,OTIS,gemGrab,Deep Diner,0,85,113,198,19050
4000,2023-01-20,OTIS,brawlBall,Sneaky Fields,26,377,557,960,74778
4001,2023-01-20,OTIS,brawlBall,Pinhole Punt,0,22,46,68,2886
4002,2023-01-20,OTIS,bounty,Dry Season,0,30,35,65,11640
4003,2023-01-19,OTIS,knockout,Out in the Open,0,83,91,174,26574
4004,2023-01-19,OTIS,hotZone,Split,0,14,11,25,14856
4005,2023-01-19,OTIS,heist,Kaboom Canyon,0,17,13,30,6732
4006,2023-01-19,OTIS,gemGrab,Undermine,0,60,69,129,14154
4007,2023-01-19,OTIS,gemGrab,Gem Fort,0,15,4,19,2934
4008,2023-01-19,OTIS,brawlBall,Sunny Soccer,0,3,6,9,2274
4009,2023-01-19,OTIS,brawlBall,Pinhole Punt,25,433,624,1082,72498
4010,2023-01-19,OTIS,bounty,Shooting Star,0,16,17,33,11124
4011,2023-01-18,OTIS,knockout,Goldarm Gulch,0,6,6,12,2784
4012,2023-01-18,OTIS,hotZone,Parallel Plays,0,3,10,13,1158
4013,2023-01-18,OTIS,heist,Kaboom Canyon,0,8,14,22,2592
4014,2023-01-18,OTIS,gemGrab,Gem Fort,0,23,36,59,3006
4015,2023-01-18,OTIS,gemGrab,Crystal Arcade,0,5,5,10,990
4016,2023-01-18,OTIS,brawlBall,Sunny Soccer,3,112,167,282,18941
4017,2023-01-18,OTIS,brawlBall,Beach Ball,0,0,2,2,774
4018,2023-01-18,OTIS,bounty,Shooting Star,0,10,4,14,5088
4019,2023-01-17,OTIS,knockout,Goldarm Gulch,0,14,13,27,2520
4020,2023-01-17,OTIS,hotZone,Parallel Plays,0,10,4,14,1038
4021,2023-01-17,OTIS,heist,Pit Stop,0,5,2,7,1290
4022,2023-01-17,OTIS,gemGrab,Minecart Madness,0,1,1,2,216
4023,2023-01-17,OTIS,gemGrab,Crystal Arcade,0,13,19,32,1266
4024,2023-01-17,OTIS,brawlBall,Center Stage,0,1,1,2,288
4025,2023-01-17,OTIS,brawlBall,Beach Ball,2,27,51,80,5886
4026,2023-01-17,OTIS,bounty,Hideout,0,0,1,1,750
4027,2023-01-16,OTIS,knockout,Belle's Rock,0,4,2,6,1788
4028,2023-01-16,OTIS,hotZone,Quarter Pounder,0,6,22,28,1494
4029,2023-01-16,OTIS,heist,Pit Stop,0,8,3,11,4044
4030,2023-01-16,OTIS,gemGrab,Minecart Madness,0,6,9,15,1422
4031,2023-01-16,OTIS,gemGrab,Double Swoosh,0,1,6,7,708
4032,2023-01-16,OTIS,brawlBall,Center Stage,3,33,65,101,5778
4033,2023-01-16,OTIS,brawlBall,Backyard Bowl,0,3,6,9,852
4034,2023-01-15,OTIS,knockout,Belle's Rock,0,4,5,9,2904
4035,2023-01-15,OTIS,hotZone,Quarter Pounder,0,18,4,22,3318
4036,2023-01-15,OTIS,heist,Bridge Too Far,0,6,9,15,2736
4037,2023-01-15,OTIS,gemGrab,Hard Rock Mine,0,2,11,13,1014
4038,2023-01-15,OTIS,gemGrab,Double Swoosh,0,16,47,63,2178
4039,2023-01-15,OTIS,brawlBall,Super Beach,0,4,9,13,1074
4040,2023-01-15,OTIS,brawlBall,Backyard Bowl,0,42,74,116,8946
4041,2023-01-15,OTIS,bounty,Canal Grande,0,3,4,7,960
4042,2023-01-14,OTIS,knockout,Flaring Phoenix,0,3,4,7,1080
4043,2023-01-14,OTIS,hotZone,Controller Chaos,0,29,64,93,2772
4044,2023-01-14,OTIS,heist,Bridge Too Far,0,15,24,39,4020
4045,2023-01-14,OTIS,gemGrab,Hard Rock Mine,0,5,4,9,1272
4046,2023-01-14,OTIS,gemGrab,Deep Diner,0,5,20,25,858
4047,2023-01-14,OTIS,brawlBall,Super Beach,2,27,43,72,6336
4048,2023-01-14,OTIS,brawlBall,Sneaky Fields,2,9,35,46,918
4049,2023-01-14,OTIS,bounty,Canal Grande,0,2,1,3,1014
4050,2023-01-13,OTIS,knockout,Flaring Phoenix,0,2,0,2,1182
4051,2023-01-13,OTIS,hotZone,Controller Chaos,0,14,27,41,2928
4052,2023-01-13,OTIS,heist,Hot Potato,0,3,8,11,600
4053,2023-01-13,OTIS,gemGrab,Deep Diner,0,6,23,29,1650
4054,2023-01-13,OTIS,brawlBall,Sneaky Fields,1,47,40,88,6144
4055,2023-01-13,OTIS,brawlBall,Pinhole Punt,0,2,1,3,156
4056,2023-01-13,OTIS,bounty,Temple Ruins,0,1,2,3,270
4057,2023-01-12,OTIS,knockout,Riverside,0,1,4,5,2532
4058,2023-01-12,OTIS,hotZone,Open Zone,0,9,7,16,1488
4059,2023-01-12,OTIS,heist,Hot Potato,0,2,0,2,330
4060,2023-01-12,OTIS,gemGrab,Undermine,0,4,6,10,690
4061,2023-01-12,OTIS,brawlBall,Sunny Soccer,0,3,6,9,240
4062,2023-01-12,OTIS,brawlBall,Pinhole Punt,1,16,9,26,2292
4063,2023-01-11,OTIS,hotZone,Open Zone,0,1,0,1,462
4064,2023-01-11,OTIS,gemGrab,Gem Fort,0,1,1,2,414
4065,2023-01-11,OTIS,brawlBall,Sunny Soccer,0,5,22,27,1638
4066,2023-01-10,OTIS,hotZone,Dueling Beetles,0,10,49,59,2424
4067,2023-01-10,OTIS,heist,Safe Zone,0,3,7,10,1176
4068,2023-01-10,OTIS,gemGrab,Minecart Madness,0,5,5,10,828
4069,2023-01-10,OTIS,gemGrab,Crystal Arcade,0,10,13,23,1746
4070,2023-01-10,OTIS,brawlBall,Center Stage,0,6,3,9,708
4071,2023-01-10,OTIS,brawlBall,Beach Ball,0,29,42,71,4392
4072,2023-01-09,OTIS,knockout,New Perspective,0,1,2,3,876
4073,2023-01-09,OTIS,hotZone,Dueling Beetles,0,4,1,5,1554
4074,2023-01-09,OTIS,heist,Snaked Assault,0,3,2,5,2022
4075,2023-01-09,OTIS,gemGrab,Minecart Madness,1,10,25,36,1884
4076,2023-01-09,OTIS,gemGrab,Double Swoosh,0,9,17,26,1320
4077,2023-01-09,OTIS,brawlBall,Center Stage,0,32,36,68,5460
4078,2023-01-09,OTIS,bounty,Layer Cake,0,6,23,29,1512
4079,2023-01-08,OTIS,knockout,X Marks the Spot,0,5,17,22,1692
4080,2023-01-08,OTIS,hotZone,Ring of Fire,0,12,18,30,1644
4081,2023-01-08,OTIS,heist,Snaked Assault,0,2,5,7,1494
4082,2023-01-08,OTIS,gemGrab,Hard Rock Mine,0,1,0,1,630
4083,2023-01-08,OTIS,gemGrab,Double Swoosh,0,5,11,16,864
4084,2023-01-08,OTIS,brawlBall,Super Beach,0,7,19,26,732
4085,2023-01-08,OTIS,brawlBall,Backyard Bowl,2,25,40,67,4830
4086,2023-01-07,OTIS,hotZone,Ring of Fire,0,8,9,17,846
4087,2023-01-07,OTIS,heist,Tornado Ring,0,2,0,2,1350
4088,2023-01-07,OTIS,gemGrab,Hard Rock Mine,0,7,22,29,1158
4089,2023-01-07,OTIS,gemGrab,Deep Diner,0,2,0,2,918
4090,2023-01-07,OTIS,brawlBall,Super Beach,0,11,8,19,2622
4091,2023-01-07,OTIS,brawlBall,Sneaky Fields,0,1,9,10,402
4092,2023-01-07,OTIS,bounty,Dry Season,0,7,20,27,1320
4093,2023-01-06,OTIS,knockout,Out in the Open,0,4,0,4,1446
4094,2023-01-06,OTIS,hotZone,Split,0,1,2,3,1158
4095,2023-01-06,OTIS,heist,Tornado Ring,0,6,0,6,2538
4096,2023-01-06,OTIS,gemGrab,Undermine,0,2,1,3,540
4097,2023-01-06,OTIS,gemGrab,Deep Diner,0,6,2,8,2226
4098,2023-01-06,OTIS,brawlBall,Sneaky Fields,1,40,104,145,4896
4099,2023-01-06,OTIS,brawlBall,Pinhole Punt,0,2,1,3,510
4100,2023-01-06,OTIS,bounty,Dry Season,0,4,7,11,1944
4101,2023-01-05,OTIS,knockout,Out in the Open,0,11,16,27,2958
4102,2023-01-05,OTIS,hotZone,Split,0,5,16,21,3552
4103,2023-01-05,OTIS,heist,Kaboom Canyon,0,1,6,7,954
4104,2023-01-05,OTIS,gemGrab,Undermine,0,6,0,6,1812
4105,2023-01-05,OTIS,brawlBall,Pinhole Punt,4,47,119,170,8118
4106,2023-01-04,OTIS,knockout,Goldarm Gulch,0,4,5,9,696
4107,2023-01-04,OTIS,hotZone,Parallel Plays,0,7,7,14,864
4108,2023-01-04,OTIS,heist,Kaboom Canyon,0,8,4,12,1848
4109,2023-01-04,OTIS,gemGrab,Gem Fort,0,6,7,13,1788
4110,2023-01-04,OTIS,gemGrab,Crystal Arcade,0,5,5,10,642
4111,2023-01-04,OTIS,brawlBall,Sunny Soccer,3,43,75,121,6312
4112,2023-01-04,OTIS,bounty,Shooting Star,0,3,0,3,3570
4113,2023-01-03,OTIS,knockout,Goldarm Gulch,0,7,14,21,720
4114,2023-01-03,OTIS,hotZone,Parallel Plays,0,4,7,11,1542
4115,2023-01-03,OTIS,heist,Pit Stop,0,3,0,3,1956
4116,2023-01-03,OTIS,gemGrab,Minecart Madness,0,1,0,1,456
4117,2023-01-03,OTIS,gemGrab,Crystal Arcade,0,3,5,8,2406
4118,2023-01-03,OTIS,brawlBall,Center Stage,0,1,4,5,294
4119,2023-01-03,OTIS,brawlBall,Beach Ball,3,44,109,156,5580
4120,2023-01-03,OTIS,bounty,Hideout,0,3,0,3,1638
4121,2023-01-02,OTIS,knockout,Belle's Rock,0,7,3,10,1794
4122,2023-01-02,OTIS,hotZone,Quarter Pounder,0,10,31,41,2652
4123,2023-01-02,OTIS,heist,Pit Stop,0,0,2,2,3498
4124,2023-01-02,OTIS,gemGrab,Minecart Madness,0,7,62,69,2352
4125,2023-01-02,OTIS,gemGrab,Double Swoosh,0,8,4,12,1512
4126,2023-01-02,OTIS,brawlBall,Center Stage,3,45,63,111,7110
4127,2023-01-02,OTIS,brawlBall,Backyard Bowl,0,4,8,12,492
4128,2023-01-02,OTIS,bounty,Hideout,0,3,4,7,3090
4129,2023-01-01,OTIS,knockout,Belle's Rock,0,3,2,5,858
4130,2023-01-01,OTIS,hotZone,Quarter Pounder,0,6,9,15,1188
4131,2023-01-01,OTIS,heist,Bridge Too Far,0,6,2,8,462
4132,2023-01-01,OTIS,gemGrab,Double Swoosh,0,6,6,12,1140
4133,2023-01-01,OTIS,brawlBall,Backyard Bowl,0,14,38,52,2658
4134,2023-01-01,OTIS,bounty,Canal Grande,0,0,2,2,132
4135,2022-12-31,OTIS,hotZone,Controller Chaos,0,2,14,16,198
4136,2022-12-31,OTIS,heist,Bridge Too Far,0,2,0,2,276
4137,2022-12-31,OTIS,gemGrab,Minecart Madness,0,0,1,1,24
4138,2022-12-31,OTIS,brawlBall,Super Beach,0,5,0,5,618
4139,2022-12-31,OTIS,brawlBall,Sneaky Fields,0,0,1,1,60
4140,2022-12-31,OTIS,bounty,Canal Grande,0,1,0,1,54
4141,2022-12-30,OTIS,heist,Kaboom Canyon,0,0,1,1,18
4142,2022-12-30,OTIS,gemGrab,Deep Diner,0,1,3,4,438
4143,2022-12-30,OTIS,brawlBall,Sneaky Fields,0,4,5,9,552
4144,2022-12-29,OTIS,hotZone,Open Zone,0,5,3,8,54
4145,2022-12-29,OTIS,heist,Hot Potato,0,1,5,6,72
4146,2022-12-29,OTIS,gemGrab,Minecart Madness,0,0,1,1,24
4147,2022-12-29,OTIS,brawlBall,Pinhole Punt,0,1,1,2,282
4148,2022-12-28,OTIS,hotZone,Open Zone,0,7,13,20,108
4149,2022-12-27,OTIS,hotZone,Dueling Beetles,0,1,0,1,36
4150,2022-12-27,OTIS,brawlBall,Beach Ball,0,0,2,2,144
4151,2022-12-26,OTIS,gemGrab,Minecart Madness,0,0,1,1,60
4152,2022-12-25,OTIS,brawlBall,Backyard Bowl,0,1,0,1,78
4153,2022-12-22,OTIS,gemGrab,Gem Fort,0,1,12,13,90
4154,2022-12-22,OTIS,brawlBall,Pinhole Punt,0,1,8,9,132
4155,2022-12-21,OTIS,brawlBall,Sunny Soccer,0,0,1,1,54
4156,2022-12-19,OTIS,brawlBall,Center Stage,0,2,1,3,102
4157,2022-12-16,OTIS,brawlBall,Sneaky Fields,0,3,2,5,84
4158,2022-12-13,OTIS,gemGrab,Crystal Arcade,0,0,1,1,72
4159,2022-12-11,OTIS,brawlBall,Backyard Bowl,0,1,0,1,24
4160,2022-11-07,OTIS,hotZone,Quarter Pounder,0,3,1,4,24
4161,2022-10-26,OTIS,brawlBall,Sunny Soccer,0,1,2,3,18
4162,2022-10-15,OTIS,gemGrab,Hard Rock Mine,0,0,1,1,90
4163,2022-10-15,OTIS,bounty,Dry Season,0,0,1,1,6
4164,2022-10-10,OTIS,knockout,Belle's Rock,0,1,0,1,48
4165,2023-01-28,NITA,knockout,Flaring Phoenix,0,23,10,33,12366
4166,2023-01-28,NITA,hotZone,Controller Chaos,0,249,266,515,10134
4167,2023-01-28,NITA,heist,Bridge Too Far,0,118,47,165,24240
4168,2023-01-28,NITA,gemGrab,Hard Rock Mine,0,169,150,319,16638
4169,2023-01-28,NITA,gemGrab,Deep Diner,0,44,43,87,5478
4170,2023-01-28,NITA,brawlBall,Super Beach,27,1062,1138,2227,74430
4171,2023-01-28,NITA,brawlBall,Sneaky Fields,1,82,114,197,3582
4172,2023-01-28,NITA,bounty,Canal Grande,0,79,94,173,10902
4173,2023-01-27,NITA,knockout,Flaring Phoenix,0,2,4,6,5928
4174,2023-01-27,NITA,hotZone,Controller Chaos,0,56,70,126,2676
4175,2023-01-27,NITA,heist,Hot Potato,0,149,184,333,3486
4176,2023-01-27,NITA,gemGrab,Undermine,0,10,5,15,942
4177,2023-01-27,NITA,gemGrab,Deep Diner,0,53,38,91,6846
4178,2023-01-27,NITA,brawlBall,Sneaky Fields,12,413,489,914,23514
4179,2023-01-27,NITA,brawlBall,Pinhole Punt,0,5,3,8,738
4180,2023-01-27,NITA,bounty,Temple Ruins,0,7,1,8,1890
4181,2023-01-26,NITA,knockout,Riverside,0,18,6,24,19008
4182,2023-01-26,NITA,hotZone,Open Zone,0,39,16,55,10182
4183,2023-01-26,NITA,heist,Hot Potato,1,637,639,1277,14610
4184,2023-01-26,NITA,gemGrab,Undermine,0,128,179,307,10062
4185,2023-01-26,NITA,gemGrab,Gem Fort,0,49,41,90,4674
4186,2023-01-26,NITA,brawlBall,Sunny Soccer,0,63,77,140,3660
4187,2023-01-26,NITA,brawlBall,Pinhole Punt,9,428,542,979,67338
4188,2023-01-26,NITA,bounty,Temple Ruins,0,16,7,23,5610
4189,2023-01-25,NITA,knockout,Riverside,0,2,0,2,9906
4190,2023-01-25,NITA,hotZone,Open Zone,0,18,8,26,5262
4191,2023-01-25,NITA,heist,Safe Zone,0,88,39,127,9156
4192,2023-01-25,NITA,gemGrab,Gem Fort,0,74,89,163,5556
4193,2023-01-25,NITA,gemGrab,Crystal Arcade,0,113,143,256,7866
4194,2023-01-25,NITA,brawlBall,Sunny Soccer,11,488,503,1002,40830
4195,2023-01-25,NITA,brawlBall,Beach Ball,2,57,49,108,6408
4196,2023-01-25,NITA,bounty,Excel,0,12,13,25,5790
4197,2023-01-24,NITA,knockout,New Perspective,0,9,6,15,10542
4198,2023-01-24,NITA,hotZone,Dueling Beetles,0,83,40,123,10662
4199,2023-01-24,NITA,heist,Safe Zone,0,112,68,180,15750
4200,2023-01-24,NITA,gemGrab,Minecart Madness,0,7,5,12,4002
4201,2023-01-24,NITA,gemGrab,Crystal Arcade,0,339,404,743,14460
4202,2023-01-24,NITA,brawlBall,Center Stage,1,81,78,160,7860
4203,2023-01-24,NITA,brawlBall,Beach Ball,18,604,639,1261,64614
4204,2023-01-24,NITA,bounty,Excel,0,11,6,17,10896
4205,2023-01-23,NITA,knockout,New Perspective,0,30,15,45,20676
4206,2023-01-23,NITA,hotZone,Dueling Beetles,0,140,90,230,17502
4207,2023-01-23,NITA,heist,Snaked Assault,1,1010,1151,2162,15762
4208,2023-01-23,NITA,gemGrab,Minecart Madness,0,61,47,108,19062
4209,2023-01-23,NITA,gemGrab,Double Swoosh,0,92,98,190,7578
4210,2023-01-23,NITA,brawlBall,Center Stage,24,1041,1060,2125,92862
4211,2023-01-23,NITA,brawlBall,Backyard Bowl,0,6,6,12,4224
4212,2023-01-23,NITA,bounty,Layer Cake,0,16,6,22,11142
4213,2023-01-22,NITA,knockout,X Marks the Spot,0,10,3,13,9174
4214,2023-01-22,NITA,hotZone,Ring of Fire,0,43,40,83,5730
4215,2023-01-22,NITA,heist,Snaked Assault,3,531,584,1118,8232
4216,2023-01-22,NITA,gemGrab,Hard Rock Mine,0,67,95,162,4722
4217,2023-01-22,NITA,gemGrab,Double Swoosh,0,145,134,279,9426
4218,2023-01-22,NITA,brawlBall,Super Beach,3,107,112,222,7386
4219,2023-01-22,NITA,brawlBall,Backyard Bowl,1,96,90,187,34788
4220,2023-01-22,NITA,bounty,Layer Cake,0,13,5,18,6654
4221,2023-01-21,NITA,knockout,X Marks the Spot,0,28,6,34,31698
4222,2023-01-21,NITA,hotZone,Ring of Fire,0,91,59,150,16632
4223,2023-01-21,NITA,heist,Tornado Ring,2,750,932,1684,11664
4224,2023-01-21,NITA,gemGrab,Hard Rock Mine,0,277,266,543,22980
4225,2023-01-21,NITA,gemGrab,Deep Diner,0,31,54,85,4470
4226,2023-01-21,NITA,brawlBall,Super Beach,48,1367,1599,3014,101364
4227,2023-01-21,NITA,brawlBall,Sneaky Fields,2,70,98,170,3750
4228,2023-01-21,NITA,bounty,Dry Season,0,5,12,17,14538
4229,2023-01-20,NITA,knockout,Out in the Open,0,20,9,29,20106
4230,2023-01-20,NITA,hotZone,Split,0,109,52,161,9678
4231,2023-01-20,NITA,heist,Tornado Ring,6,841,883,1730,12672
4232,2023-01-20,NITA,gemGrab,Undermine,0,51,57,108,5442
4233,2023-01-20,NITA,gemGrab,Deep Diner,0,190,222,412,19050
4234,2023-01-20,NITA,brawlBall,Sneaky Fields,42,1190,1412,2644,74778
4235,2023-01-20,NITA,brawlBall,Pinhole Punt,2,16,13,31,2886
4236,2023-01-20,NITA,bounty,Dry Season,0,7,4,11,11640
4237,2023-01-19,NITA,knockout,Out in the Open,0,25,6,31,26574
4238,2023-01-19,NITA,hotZone,Split,0,148,116,264,14856
4239,2023-01-19,NITA,heist,Kaboom Canyon,0,126,93,219,6732
4240,2023-01-19,NITA,gemGrab,Undermine,0,177,216,393,14154
4241,2023-01-19,NITA,gemGrab,Gem Fort,0,32,36,68,2934
4242,2023-01-19,NITA,brawlBall,Sunny Soccer,0,18,15,33,2274
4243,2023-01-19,NITA,brawlBall,Pinhole Punt,19,538,526,1083,72498
4244,2023-01-19,NITA,bounty,Shooting Star,0,5,1,6,11124
4245,2023-01-18,NITA,knockout,Goldarm Gulch,0,4,3,7,2784
4246,2023-01-18,NITA,hotZone,Parallel Plays,0,29,21,50,1158
4247,2023-01-18,NITA,heist,Kaboom Canyon,0,41,21,62,2592
4248,2023-01-18,NITA,gemGrab,Gem Fort,0,33,33,66,3006
4249,2023-01-18,NITA,gemGrab,Crystal Arcade,0,7,15,22,990
4250,2023-01-18,NITA,brawlBall,Sunny Soccer,4,217,224,445,18941
4251,2023-01-18,NITA,brawlBall,Beach Ball,0,6,6,12,774
4252,2023-01-18,NITA,bounty,Shooting Star,0,1,1,2,5088
4253,2023-01-17,NITA,knockout,Goldarm Gulch,0,7,3,10,2520
4254,2023-01-17,NITA,hotZone,Parallel Plays,0,25,22,47,1038
4255,2023-01-17,NITA,heist,Pit Stop,0,56,62,118,1290
4256,2023-01-17,NITA,gemGrab,Crystal Arcade,0,19,22,41,1266
4257,2023-01-17,NITA,brawlBall,Center Stage,0,2,2,4,288
4258,2023-01-17,NITA,brawlBall,Beach Ball,0,56,70,126,5886
4259,2023-01-16,NITA,knockout,Belle's Rock,0,1,0,1,1788
4260,2023-01-16,NITA,hotZone,Quarter Pounder,0,15,8,23,1494
4261,2023-01-16,NITA,heist,Pit Stop,0,173,190,363,4044
4262,2023-01-16,NITA,gemGrab,Minecart Madness,0,4,3,7,1422
4263,2023-01-16,NITA,gemGrab,Double Swoosh,0,5,5,10,708
4264,2023-01-16,NITA,brawlBall,Center Stage,2,88,117,207,5778
4265,2023-01-16,NITA,brawlBall,Backyard Bowl,0,2,0,2,852
4266,2023-01-15,NITA,knockout,Belle's Rock,0,1,0,1,2904
4267,2023-01-15,NITA,hotZone,Quarter Pounder,0,68,36,104,3318
4268,2023-01-15,NITA,heist,Bridge Too Far,0,10,2,12,2736
4269,2023-01-15,NITA,gemGrab,Hard Rock Mine,0,15,5,20,1014
4270,2023-01-15,NITA,gemGrab,Double Swoosh,0,44,40,84,2178
4271,2023-01-15,NITA,brawlBall,Super Beach,0,14,9,23,1074
4272,2023-01-15,NITA,brawlBall,Backyard Bowl,0,33,18,51,8946
4273,2023-01-15,NITA,bounty,Canal Grande,0,8,1,9,960
4274,2023-01-14,NITA,knockout,Flaring Phoenix,0,1,0,1,1080
4275,2023-01-14,NITA,hotZone,Controller Chaos,0,76,36,112,2772
4276,2023-01-14,NITA,heist,Bridge Too Far,0,21,4,25,4020
4277,2023-01-14,NITA,gemGrab,Hard Rock Mine,0,9,4,13,1272
4278,2023-01-14,NITA,gemGrab,Deep Diner,0,13,16,29,858
4279,2023-01-14,NITA,brawlBall,Super Beach,1,98,105,204,6336
4280,2023-01-14,NITA,brawlBall,Sneaky Fields,0,21,27,48,918
4281,2023-01-14,NITA,bounty,Canal Grande,0,6,2,8,1014
4282,2023-01-13,NITA,knockout,Flaring Phoenix,0,4,0,4,1182
4283,2023-01-13,NITA,hotZone,Controller Chaos,0,138,102,240,2928
4284,2023-01-13,NITA,heist,Hot Potato,0,33,50,83,600
4285,2023-01-13,NITA,gemGrab,Deep Diner,0,9,7,16,1650
4286,2023-01-13,NITA,brawlBall,Sneaky Fields,4,124,157,285,6144
4287,2023-01-13,NITA,brawlBall,Pinhole Punt,1,0,0,1,156
4288,2023-01-13,NITA,bounty,Temple Ruins,0,3,0,3,270
4289,2023-01-12,NITA,hotZone,Open Zone,0,3,1,4,1488
4290,2023-01-12,NITA,heist,Hot Potato,0,23,17,40,330
4291,2023-01-12,NITA,gemGrab,Undermine,0,10,11,21,690
4292,2023-01-12,NITA,gemGrab,Gem Fort,0,2,0,2,162
4293,2023-01-12,NITA,brawlBall,Sunny Soccer,0,2,2,4,240
4294,2023-01-12,NITA,brawlBall,Pinhole Punt,0,19,6,25,2292
4295,2023-01-11,NITA,knockout,Riverside,0,1,0,1,528
4296,2023-01-11,NITA,hotZone,Open Zone,0,2,0,2,462
4297,2023-01-11,NITA,heist,Safe Zone,0,0,1,1,48
4298,2023-01-11,NITA,gemGrab,Gem Fort,0,8,3,11,414
4299,2023-01-11,NITA,brawlBall,Sunny Soccer,1,23,16,40,1638
4300,2023-01-11,NITA,brawlBall,Beach Ball,0,0,1,1,48
4301,2023-01-11,NITA,bounty,Excel,0,3,2,5,282
4302,2023-01-10,NITA,hotZone,Dueling Beetles,0,21,3,24,2424
4303,2023-01-10,NITA,heist,Safe Zone,0,9,1,10,1176
4304,2023-01-10,NITA,gemGrab,Minecart Madness,0,2,0,2,828
4305,2023-01-10,NITA,gemGrab,Crystal Arcade,0,48,46,94,1746
4306,2023-01-10,NITA,brawlBall,Center Stage,0,6,14,20,708
4307,2023-01-10,NITA,brawlBall,Beach Ball,1,44,85,130,4392
4308,2023-01-09,NITA,knockout,New Perspective,0,1,0,1,876
4309,2023-01-09,NITA,hotZone,Dueling Beetles,0,11,2,13,1554
4310,2023-01-09,NITA,heist,Snaked Assault,0,148,130,278,2022
4311,2023-01-09,NITA,gemGrab,Minecart Madness,0,7,0,7,1884
4312,2023-01-09,NITA,gemGrab,Double Swoosh,0,16,14,30,1320
4313,2023-01-09,NITA,brawlBall,Center Stage,1,55,52,108,5460
4314,2023-01-09,NITA,brawlBall,Backyard Bowl,0,3,0,3,474
4315,2023-01-09,NITA,bounty,Layer Cake,0,3,0,3,1512
4316,2023-01-08,NITA,hotZone,Ring of Fire,0,11,1,12,1644
4317,2023-01-08,NITA,heist,Snaked Assault,0,110,88,198,1494
4318,2023-01-08,NITA,gemGrab,Hard Rock Mine,0,14,13,27,630
4319,2023-01-08,NITA,gemGrab,Double Swoosh,0,13,7,20,864
4320,2023-01-08,NITA,brawlBall,Super Beach,0,18,9,27,732
4321,2023-01-08,NITA,brawlBall,Backyard Bowl,0,16,5,21,4830
4322,2023-01-08,NITA,bounty,Layer Cake,0,1,0,1,528
4323,2023-01-07,NITA,hotZone,Ring of Fire,0,4,0,4,846
4324,2023-01-07,NITA,heist,Tornado Ring,1,115,124,240,1350
4325,2023-01-07,NITA,gemGrab,Hard Rock Mine,0,14,6,20,1158
4326,2023-01-07,NITA,gemGrab,Deep Diner,0,21,27,48,918
4327,2023-01-07,NITA,brawlBall,Super Beach,2,52,45,99,2622
4328,2023-01-07,NITA,brawlBall,Sneaky Fields,1,6,3,10,402
4329,2023-01-07,NITA,bounty,Dry Season,0,2,0,2,1320
4330,2023-01-06,NITA,knockout,Out in the Open,0,1,0,1,1446
4331,2023-01-06,NITA,hotZone,Split,0,19,4,23,1158
4332,2023-01-06,NITA,heist,Tornado Ring,2,202,211,415,2538
4333,2023-01-06,NITA,gemGrab,Undermine,0,5,0,5,540
4334,2023-01-06,NITA,gemGrab,Deep Diner,0,29,24,53,2226
4335,2023-01-06,NITA,brawlBall,Sneaky Fields,0,121,136,257,4896
4336,2023-01-06,NITA,brawlBall,Pinhole Punt,0,4,1,5,510
4337,2023-01-05,NITA,knockout,Out in the Open,0,2,0,2,2958
4338,2023-01-05,NITA,hotZone,Split,0,32,11,43,3552
4339,2023-01-05,NITA,heist,Kaboom Canyon,0,25,8,33,954
4340,2023-01-05,NITA,gemGrab,Undermine,0,15,20,35,1812
4341,2023-01-05,NITA,gemGrab,Gem Fort,0,4,4,8,252
4342,2023-01-05,NITA,brawlBall,Sunny Soccer,0,0,1,1,84
4343,2023-01-05,NITA,brawlBall,Pinhole Punt,1,47,32,80,8118
4344,2023-01-04,NITA,knockout,Goldarm Gulch,0,2,0,2,696
4345,2023-01-04,NITA,hotZone,Parallel Plays,0,15,8,23,864
4346,2023-01-04,NITA,heist,Kaboom Canyon,0,36,6,42,1848
4347,2023-01-04,NITA,gemGrab,Gem Fort,0,26,37,63,1788
4348,2023-01-04,NITA,gemGrab,Crystal Arcade,0,7,12,19,642
4349,2023-01-04,NITA,brawlBall,Sunny Soccer,2,96,61,159,6312
4350,2023-01-04,NITA,bounty,Shooting Star,0,1,0,1,3570
4351,2023-01-03,NITA,knockout,Goldarm Gulch,0,1,1,2,720
4352,2023-01-03,NITA,hotZone,Parallel Plays,1,50,39,90,1542
4353,2023-01-03,NITA,hotZone,Controller Chaos,0,0,1,1,12
4354,2023-01-03,NITA,heist,Pit Stop,1,147,103,251,1956
4355,2023-01-03,NITA,gemGrab,Crystal Arcade,0,70,58,128,2406
4356,2023-01-03,NITA,brawlBall,Center Stage,1,2,8,11,294
4357,2023-01-03,NITA,brawlBall,Beach Ball,1,67,64,132,5580
4358,2023-01-03,NITA,bounty,Hideout,0,1,0,1,1638
4359,2023-01-02,NITA,knockout,Belle's Rock,0,3,0,3,1794
4360,2023-01-02,NITA,hotZone,Quarter Pounder,0,26,27,53,2652
4361,2023-01-02,NITA,heist,Pit Stop,0,264,180,444,3498
4362,2023-01-02,NITA,heist,Kaboom Canyon,0,3,1,4,30
4363,2023-01-02,NITA,gemGrab,Minecart Madness,0,10,2,12,2352
4364,2023-01-02,NITA,gemGrab,Double Swoosh,0,26,21,47,1512
4365,2023-01-02,NITA,brawlBall,Center Stage,1,95,79,175,7110
4366,2023-01-02,NITA,brawlBall,Backyard Bowl,0,1,0,1,492
4367,2023-01-02,NITA,bounty,Hideout,0,0,1,1,3090
4368,2023-01-01,NITA,hotZone,Quarter Pounder,0,20,5,25,1188
4369,2023-01-01,NITA,heist,Bridge Too Far,0,2,0,2,462
4370,2023-01-01,NITA,gemGrab,Double Swoosh,0,14,3,17,1140
4371,2023-01-01,NITA,brawlBall,Backyard Bowl,0,5,0,5,2658
4372,2022-12-31,NITA,hotZone,Controller Chaos,0,3,1,4,198
4373,2022-12-31,NITA,heist,Kaboom Canyon,0,1,0,1,12
4374,2022-12-31,NITA,gemGrab,Minecart Madness,0,1,0,1,24
4375,2022-12-31,NITA,gemGrab,Hard Rock Mine,0,1,2,3,384
4376,2022-12-31,NITA,gemGrab,Deep Diner,0,2,0,2,306
4377,2022-12-31,NITA,brawlBall,Super Beach,0,6,2,8,618
4378,2022-12-31,NITA,brawlBall,Sneaky Fields,0,5,6,11,60
4379,2022-12-30,NITA,hotZone,Controller Chaos,0,5,1,6,288
4380,2022-12-30,NITA,heist,Hot Potato,0,1,3,4,30
4381,2022-12-30,NITA,gemGrab,Undermine,0,3,14,17,102
4382,2022-12-30,NITA,gemGrab,Minecart Madness,0,0,1,1,24
4383,2022-12-30,NITA,gemGrab,Deep Diner,0,5,9,14,438
4384,2022-12-30,NITA,brawlBall,Sneaky Fields,0,17,19,36,552
4385,2022-12-29,NITA,heist,Kaboom Canyon,0,1,0,1,18
4386,2022-12-29,NITA,heist,Hot Potato,0,1,3,4,72
4387,2022-12-29,NITA,gemGrab,Undermine,0,1,1,2,102
4388,2022-12-29,NITA,brawlBall,Pinhole Punt,0,4,0,4,282
4389,2022-12-27,NITA,hotZone,Controller Chaos,0,1,0,1,24
4390,2022-12-27,NITA,heist,Kaboom Canyon,0,0,1,1,18
4391,2022-12-27,NITA,brawlBall,Center Stage,0,2,1,3,30
4392,2022-12-27,NITA,brawlBall,Beach Ball,0,1,0,1,144
4393,2022-12-26,NITA,heist,Kaboom Canyon,0,2,0,2,36
4394,2022-12-26,NITA,gemGrab,Minecart Madness,0,1,0,1,60
4395,2022-12-26,NITA,brawlBall,Center Stage,0,1,2,3,78
4396,2022-12-24,NITA,brawlBall,Super Beach,0,1,1,2,48
4397,2022-12-23,NITA,brawlBall,Sneaky Fields,0,1,1,2,12
4398,2022-12-22,NITA,gemGrab,Gem Fort,0,1,0,1,90
4399,2022-12-22,NITA,brawlBall,Pinhole Punt,0,2,0,2,132
4400,2022-12-21,NITA,brawlBall,Sunny Soccer,0,2,0,2,54
4401,2022-12-20,NITA,brawlBall,Beach Ball,0,1,1,2,96
4402,2022-12-19,NITA,brawlBall,Center Stage,0,1,2,3,102
4403,2022-12-16,NITA,brawlBall,Sneaky Fields,0,1,0,1,84
4404,2022-12-13,NITA,heist,Safe Zone,0,1,0,1,42
4405,2022-12-13,NITA,gemGrab,Crystal Arcade,0,1,1,2,72
4406,2022-12-13,NITA,brawlBall,Beach Ball,0,2,0,2,54
4407,2022-12-10,NITA,gemGrab,Hard Rock Mine,0,1,1,2,24
4408,2022-11-11,NITA,brawlBall,Sneaky Fields,0,1,2,3,42
4409,2022-11-03,NITA,brawlBall,Pinhole Punt,0,1,0,1,12
4410,2022-10-28,NITA,bounty,Canal Grande,0,1,0,1,12
4411,2022-10-15,NITA,gemGrab,Hard Rock Mine,0,0,1,1,90
4412,2023-01-28,NANI,knockout,Flaring Phoenix,0,39,20,59,12366
4413,2023-01-28,NANI,hotZone,Controller Chaos,0,3,1,4,10134
4414,2023-01-28,NANI,heist,Bridge Too Far,0,225,323,548,24240
4415,2023-01-28,NANI,gemGrab,Hard Rock Mine,0,14,9,23,16638
4416,2023-01-28,NANI,gemGrab,Deep Diner,0,4,3,7,5478
4417,2023-01-28,NANI,brawlBall,Super Beach,0,38,25,63,74430
4418,2023-01-28,NANI,brawlBall,Sneaky Fields,0,1,1,2,3582
4419,2023-01-28,NANI,bounty,Canal Grande,0,7,4,11,10902
4420,2023-01-27,NANI,knockout,Flaring Phoenix,0,15,10,25,5928
4421,2023-01-27,NANI,hotZone,Controller Chaos,0,1,0,1,2676
4422,2023-01-27,NANI,heist,Hot Potato,0,5,0,5,3486
4423,2023-01-27,NANI,gemGrab,Undermine,0,1,2,3,942
4424,2023-01-27,NANI,gemGrab,Deep Diner,0,5,1,6,6846
4425,2023-01-27,NANI,brawlBall,Sneaky Fields,0,3,12,15,23514
4426,2023-01-27,NANI,bounty,Temple Ruins,0,5,4,9,1890
4427,2023-01-26,NANI,knockout,Riverside,0,741,1129,1870,19008
4428,2023-01-26,NANI,hotZone,Open Zone,0,24,10,34,10182
4429,2023-01-26,NANI,heist,Hot Potato,0,6,4,10,14610
4430,2023-01-26,NANI,gemGrab,Undermine,0,6,2,8,10062
4431,2023-01-26,NANI,gemGrab,Gem Fort,0,2,3,5,4674
4432,2023-01-26,NANI,brawlBall,Sunny Soccer,0,1,2,3,3660
4433,2023-01-26,NANI,brawlBall,Pinhole Punt,3,61,45,109,67338
4434,2023-01-26,NANI,bounty,Temple Ruins,0,16,11,27,5610
4435,2023-01-25,NANI,knockout,Riverside,0,487,687,1174,9906
4436,2023-01-25,NANI,hotZone,Open Zone,0,4,9,13,5262
4437,2023-01-25,NANI,heist,Safe Zone,0,12,13,25,9156
4438,2023-01-25,NANI,gemGrab,Gem Fort,0,4,1,5,5556
4439,2023-01-25,NANI,gemGrab,Crystal Arcade,0,7,4,11,7866
4440,2023-01-25,NANI,brawlBall,Sunny Soccer,0,22,5,27,40830
4441,2023-01-25,NANI,brawlBall,Beach Ball,0,1,11,12,6408
4442,2023-01-25,NANI,bounty,Excel,0,12,7,19,5790
4443,2023-01-24,NANI,knockout,New Perspective,0,73,90,163,10542
4444,2023-01-24,NANI,hotZone,Dueling Beetles,0,8,4,12,10662
4445,2023-01-24,NANI,heist,Safe Zone,3,36,36,75,15750
4446,2023-01-24,NANI,gemGrab,Minecart Madness,0,5,6,11,4002
4447,2023-01-24,NANI,gemGrab,Crystal Arcade,0,12,4,16,14460
4448,2023-01-24,NANI,brawlBall,Center Stage,0,5,0,5,7860
4449,2023-01-24,NANI,brawlBall,Beach Ball,0,33,13,46,64614
4450,2023-01-24,NANI,bounty,Excel,0,23,16,39,10896
4451,2023-01-23,NANI,knockout,New Perspective,0,99,91,190,20676
4452,2023-01-23,NANI,hotZone,Dueling Beetles,0,2,0,2,17502
4453,2023-01-23,NANI,heist,Snaked Assault,0,8,1,9,15762
4454,2023-01-23,NANI,gemGrab,Minecart Madness,0,28,41,69,19062
4455,2023-01-23,NANI,gemGrab,Double Swoosh,0,5,1,6,7578
4456,2023-01-23,NANI,brawlBall,Center Stage,1,44,32,77,92862
4457,2023-01-23,NANI,brawlBall,Backyard Bowl,0,18,21,39,4224
4458,2023-01-23,NANI,bounty,Layer Cake,0,26,26,52,11142
4459,2023-01-22,NANI,knockout,X Marks the Spot,0,115,159,274,9174
4460,2023-01-22,NANI,hotZone,Ring of Fire,0,8,1,9,5730
4461,2023-01-22,NANI,heist,Snaked Assault,0,10,12,22,8232
4462,2023-01-22,NANI,gemGrab,Hard Rock Mine,0,1,1,2,4722
4463,2023-01-22,NANI,gemGrab,Double Swoosh,0,5,2,7,9426
4464,2023-01-22,NANI,brawlBall,Super Beach,0,1,0,1,7386
4465,2023-01-22,NANI,brawlBall,Backyard Bowl,5,118,120,243,34788
4466,2023-01-22,NANI,bounty,Layer Cake,0,5,11,16,6654
4467,2023-01-21,NANI,knockout,X Marks the Spot,3,369,498,870,31698
4468,2023-01-21,NANI,hotZone,Ring of Fire,0,9,4,13,16632
4469,2023-01-21,NANI,heist,Tornado Ring,0,2,2,4,11664
4470,2023-01-21,NANI,gemGrab,Hard Rock Mine,0,17,12,29,22980
4471,2023-01-21,NANI,gemGrab,Deep Diner,0,2,0,2,4470
4472,2023-01-21,NANI,brawlBall,Super Beach,1,35,32,68,101364
4473,2023-01-21,NANI,brawlBall,Sneaky Fields,0,2,0,2,3750
4474,2023-01-21,NANI,bounty,Dry Season,0,118,134,252,14538
4475,2023-01-20,NANI,knockout,Out in the Open,0,150,154,304,20106
4476,2023-01-20,NANI,hotZone,Split,0,1,1,2,9678
4477,2023-01-20,NANI,heist,Tornado Ring,0,7,2,9,12672
4478,2023-01-20,NANI,gemGrab,Undermine,0,5,2,7,5442
4479,2023-01-20,NANI,gemGrab,Deep Diner,0,29,18,47,19050
4480,2023-01-20,NANI,brawlBall,Sneaky Fields,0,16,7,23,74778
4481,2023-01-20,NANI,brawlBall,Pinhole Punt,0,1,8,9,2886
4482,2023-01-20,NANI,bounty,Dry Season,0,87,93,180,11640
4483,2023-01-19,NANI,knockout,Out in the Open,0,164,169,333,26574
4484,2023-01-19,NANI,hotZone,Split,0,6,3,9,14856
4485,2023-01-19,NANI,heist,Kaboom Canyon,1,42,61,104,6732
4486,2023-01-19,NANI,gemGrab,Undermine,0,10,12,22,14154
4487,2023-01-19,NANI,gemGrab,Gem Fort,0,1,1,2,2934
4488,2023-01-19,NANI,brawlBall,Sunny Soccer,0,1,0,1,2274
4489,2023-01-19,NANI,brawlBall,Pinhole Punt,2,53,45,100,72498
4490,2023-01-19,NANI,bounty,Shooting Star,0,411,553,964,11124
4491,2023-01-18,NANI,knockout,Goldarm Gulch,0,9,10,19,2784
4492,2023-01-18,NANI,hotZone,Parallel Plays,0,2,1,3,1158
4493,2023-01-18,NANI,heist,Kaboom Canyon,0,12,8,20,2592
4494,2023-01-18,NANI,gemGrab,Gem Fort,0,3,0,3,3006
4495,2023-01-18,NANI,brawlBall,Sunny Soccer,1,13,3,17,18941
4496,2023-01-18,NANI,bounty,Shooting Star,0,212,226,438,5088
4497,2023-01-17,NANI,knockout,Goldarm Gulch,0,2,3,5,2520
4498,2023-01-17,NANI,heist,Pit Stop,0,1,0,1,1290
4499,2023-01-17,NANI,gemGrab,Minecart Madness,0,0,1,1,216
4500,2023-01-17,NANI,brawlBall,Beach Ball,0,4,4,8,5886
4501,2023-01-17,NANI,bounty,Hideout,0,25,22,47,750
4502,2023-01-16,NANI,knockout,Belle's Rock,0,3,2,5,1788
4503,2023-01-16,NANI,hotZone,Quarter Pounder,0,2,0,2,1494
4504,2023-01-16,NANI,gemGrab,Minecart Madness,0,3,5,8,1422
4505,2023-01-16,NANI,brawlBall,Center Stage,0,5,1,6,5778
4506,2023-01-16,NANI,brawlBall,Backyard Bowl,0,1,3,4,852
4507,2023-01-16,NANI,bounty,Hideout,0,27,56,83,1470
4508,2023-01-15,NANI,knockout,Belle's Rock,0,5,2,7,2904
4509,2023-01-15,NANI,hotZone,Quarter Pounder,0,1,1,2,3318
4510,2023-01-15,NANI,heist,Bridge Too Far,0,21,37,58,2736
4511,2023-01-15,NANI,gemGrab,Hard Rock Mine,0,0,1,1,1014
4512,2023-01-15,NANI,gemGrab,Double Swoosh,0,1,0,1,2178
4513,2023-01-15,NANI,brawlBall,Backyard Bowl,1,24,24,49,8946
4514,2023-01-15,NANI,bounty,Canal Grande,0,1,0,1,960
4515,2023-01-14,NANI,knockout,Flaring Phoenix,0,3,1,4,1080
4516,2023-01-14,NANI,hotZone,Controller Chaos,0,5,0,5,2772
4517,2023-01-14,NANI,heist,Bridge Too Far,0,47,50,97,4020
4518,2023-01-14,NANI,gemGrab,Deep Diner,0,3,8,11,858
4519,2023-01-14,NANI,brawlBall,Super Beach,0,2,0,2,6336
4520,2023-01-14,NANI,brawlBall,Sneaky Fields,0,1,0,1,918
4521,2023-01-14,NANI,bounty,Canal Grande,0,1,0,1,1014
4522,2023-01-13,NANI,knockout,Flaring Phoenix,0,7,3,10,1182
4523,2023-01-13,NANI,hotZone,Controller Chaos,0,2,0,2,2928
4524,2023-01-13,NANI,gemGrab,Deep Diner,0,1,1,2,1650
4525,2023-01-13,NANI,brawlBall,Sneaky Fields,0,1,1,2,6144
4526,2023-01-13,NANI,bounty,Temple Ruins,0,1,1,2,270
4527,2023-01-12,NANI,knockout,Riverside,0,131,158,289,2532
4528,2023-01-12,NANI,brawlBall,Pinhole Punt,0,1,0,1,2292
4529,2023-01-11,NANI,knockout,Riverside,0,37,49,86,528
4530,2023-01-11,NANI,hotZone,Open Zone,0,1,1,2,462
4531,2023-01-11,NANI,bounty,Excel,0,1,0,1,282
4532,2023-01-10,NANI,knockout,New Perspective,0,4,3,7,720
4533,2023-01-10,NANI,heist,Safe Zone,0,1,1,2,1176
4534,2023-01-10,NANI,gemGrab,Minecart Madness,0,4,14,18,828
4535,2023-01-10,NANI,gemGrab,Crystal Arcade,0,3,2,5,1746
4536,2023-01-10,NANI,brawlBall,Beach Ball,0,2,0,2,4392
4537,2023-01-09,NANI,knockout,New Perspective,0,2,2,4,876
4538,2023-01-09,NANI,gemGrab,Minecart Madness,0,2,5,7,1884
4539,2023-01-09,NANI,brawlBall,Backyard Bowl,0,2,2,4,474
4540,2023-01-09,NANI,bounty,Layer Cake,0,2,1,3,1512
4541,2023-01-08,NANI,knockout,X Marks the Spot,0,23,12,35,1692
4542,2023-01-08,NANI,hotZone,Ring of Fire,0,1,0,1,1644
4543,2023-01-08,NANI,brawlBall,Super Beach,0,1,1,2,732
4544,2023-01-08,NANI,brawlBall,Backyard Bowl,2,5,16,23,4830
4545,2023-01-08,NANI,bounty,Layer Cake,0,1,1,2,528
4546,2023-01-07,NANI,knockout,X Marks the Spot,0,11,2,13,1014
4547,2023-01-07,NANI,gemGrab,Hard Rock Mine,0,2,0,2,1158
4548,2023-01-07,NANI,gemGrab,Deep Diner,0,1,0,1,918
4549,2023-01-07,NANI,brawlBall,Super Beach,0,1,0,1,2622
4550,2023-01-07,NANI,bounty,Dry Season,0,8,5,13,1320
4551,2023-01-06,NANI,knockout,Out in the Open,0,5,1,6,1446
4552,2023-01-06,NANI,bounty,Dry Season,0,10,15,25,1944
4553,2023-01-05,NANI,knockout,Out in the Open,0,18,11,29,2958
4554,2023-01-05,NANI,heist,Kaboom Canyon,0,2,1,3,954
4555,2023-01-05,NANI,gemGrab,Undermine,0,0,1,1,1812
4556,2023-01-05,NANI,brawlBall,Pinhole Punt,0,1,0,1,8118
4557,2023-01-05,NANI,bounty,Shooting Star,0,74,139,213,1362
4558,2023-01-04,NANI,knockout,Goldarm Gulch,0,0,2,2,696
4559,2023-01-04,NANI,heist,Kaboom Canyon,0,5,10,15,1848
4560,2023-01-04,NANI,brawlBall,Sunny Soccer,0,0,1,1,6312
4561,2023-01-04,NANI,bounty,Shooting Star,0,235,329,564,3570
4562,2023-01-03,NANI,knockout,Goldarm Gulch,0,1,4,5,720
4563,2023-01-03,NANI,gemGrab,Crystal Arcade,0,1,0,1,2406
4564,2023-01-03,NANI,brawlBall,Beach Ball,0,2,0,2,5580
4565,2023-01-03,NANI,bounty,Hideout,0,29,48,77,1638
4566,2023-01-02,NANI,knockout,Belle's Rock,0,9,8,17,1794
4567,2023-01-02,NANI,hotZone,Quarter Pounder,0,1,2,3,2652
4568,2023-01-02,NANI,gemGrab,Minecart Madness,0,1,0,1,2352
4569,2023-01-02,NANI,brawlBall,Center Stage,0,2,0,2,7110
4570,2023-01-02,NANI,brawlBall,Backyard Bowl,0,0,1,1,492
4571,2023-01-02,NANI,bounty,Hideout,0,66,50,116,3090
4572,2023-01-01,NANI,hotZone,Quarter Pounder,0,12,13,25,1188
4573,2023-01-01,NANI,heist,Bridge Too Far,0,4,3,7,462
4574,2023-01-01,NANI,gemGrab,Double Swoosh,0,1,0,1,1140
4575,2023-01-01,NANI,brawlBall,Backyard Bowl,0,8,3,11,2658
4576,2022-12-31,NANI,heist,Bridge Too Far,0,2,1,3,276
4577,2022-12-30,NANI,knockout,Flaring Phoenix,0,0,1,1,72
4578,2022-12-29,NANI,heist,Kaboom Canyon,0,1,0,1,18
4579,2022-12-24,NANI,knockout,X Marks the Spot,0,0,1,1,12
4580,2022-12-22,NANI,brawlBall,Pinhole Punt,0,1,0,1,132
4581,2022-12-13,NANI,knockout,New Perspective,0,2,13,15,84
4582,2022-11-01,NANI,knockout,New Perspective,0,2,1,3,54
4583,2022-10-26,NANI,bounty,Shooting Star,0,4,4,8,36
4584,2022-10-15,NANI,gemGrab,Hard Rock Mine,0,0,1,1,90
4585,2023-01-28,MR. P,knockout,Flaring Phoenix,0,70,75,145,12366
4586,2023-01-28,MR. P,hotZone,Controller Chaos,0,16,9,25,10134
4587,2023-01-28,MR. P,heist,Bridge Too Far,0,33,34,67,24240
4588,2023-01-28,MR. P,gemGrab,Hard Rock Mine,0,42,54,96,16638
4589,2023-01-28,MR. P,gemGrab,Deep Diner,0,21,30,51,5478
4590,2023-01-28,MR. P,brawlBall,Super Beach,1,46,60,107,74430
4591,2023-01-28,MR. P,brawlBall,Sneaky Fields,0,5,4,9,3582
4592,2023-01-28,MR. P,bounty,Canal Grande,0,74,94,168,10902
4593,2023-01-27,MR. P,knockout,Flaring Phoenix,0,24,15,39,5928
4594,2023-01-27,MR. P,hotZone,Controller Chaos,0,7,4,11,2676
4595,2023-01-27,MR. P,heist,Hot Potato,0,4,8,12,3486
4596,2023-01-27,MR. P,gemGrab,Undermine,0,5,3,8,942
4597,2023-01-27,MR. P,gemGrab,Deep Diner,0,50,50,100,6846
4598,2023-01-27,MR. P,brawlBall,Sneaky Fields,0,16,11,27,23514
4599,2023-01-27,MR. P,brawlBall,Pinhole Punt,0,1,0,1,738
4600,2023-01-27,MR. P,bounty,Temple Ruins,0,8,7,15,1890
4601,2023-01-26,MR. P,knockout,Riverside,0,98,125,223,19008
4602,2023-01-26,MR. P,hotZone,Open Zone,0,27,11,38,10182
4603,2023-01-26,MR. P,heist,Hot Potato,0,7,3,10,14610
4604,2023-01-26,MR. P,gemGrab,Undermine,0,27,57,84,10062
4605,2023-01-26,MR. P,gemGrab,Gem Fort,0,8,6,14,4674
4606,2023-01-26,MR. P,brawlBall,Sunny Soccer,0,4,9,13,3660
4607,2023-01-26,MR. P,brawlBall,Pinhole Punt,2,69,68,139,67338
4608,2023-01-26,MR. P,bounty,Temple Ruins,0,21,30,51,5610
4609,2023-01-25,MR. P,knockout,Riverside,0,40,45,85,9906
4610,2023-01-25,MR. P,hotZone,Open Zone,0,6,3,9,5262
4611,2023-01-25,MR. P,heist,Safe Zone,0,9,4,13,9156
4612,2023-01-25,MR. P,gemGrab,Gem Fort,0,20,12,32,5556
4613,2023-01-25,MR. P,gemGrab,Crystal Arcade,0,28,35,63,7866
4614,2023-01-25,MR. P,brawlBall,Sunny Soccer,1,28,39,68,40830
4615,2023-01-25,MR. P,brawlBall,Beach Ball,0,5,4,9,6408
4616,2023-01-25,MR. P,bounty,Excel,0,43,54,97,5790
4617,2023-01-24,MR. P,knockout,New Perspective,0,40,42,82,10542
4618,2023-01-24,MR. P,hotZone,Dueling Beetles,0,21,21,42,10662
4619,2023-01-24,MR. P,heist,Safe Zone,0,24,6,30,15750
4620,2023-01-24,MR. P,gemGrab,Minecart Madness,0,21,26,47,4002
4621,2023-01-24,MR. P,gemGrab,Crystal Arcade,0,30,32,62,14460
4622,2023-01-24,MR. P,brawlBall,Center Stage,0,3,2,5,7860
4623,2023-01-24,MR. P,brawlBall,Beach Ball,3,74,86,163,64614
4624,2023-01-24,MR. P,bounty,Excel,0,86,107,193,10896
4625,2023-01-23,MR. P,knockout,New Perspective,0,57,73,130,20676
4626,2023-01-23,MR. P,hotZone,Dueling Beetles,0,24,17,41,17502
4627,2023-01-23,MR. P,heist,Snaked Assault,0,14,13,27,15762
4628,2023-01-23,MR. P,gemGrab,Minecart Madness,0,78,82,160,19062
4629,2023-01-23,MR. P,gemGrab,Double Swoosh,0,14,22,36,7578
4630,2023-01-23,MR. P,brawlBall,Center Stage,4,73,89,166,92862
4631,2023-01-23,MR. P,brawlBall,Backyard Bowl,0,3,4,7,4224
4632,2023-01-23,MR. P,bounty,Layer Cake,0,89,88,177,11142
4633,2023-01-22,MR. P,knockout,X Marks the Spot,0,26,39,65,9174
4634,2023-01-22,MR. P,hotZone,Ring of Fire,0,5,5,10,5730
4635,2023-01-22,MR. P,heist,Snaked Assault,0,2,2,4,8232
4636,2023-01-22,MR. P,gemGrab,Hard Rock Mine,0,12,11,23,4722
4637,2023-01-22,MR. P,gemGrab,Double Swoosh,0,17,24,41,9426
4638,2023-01-22,MR. P,brawlBall,Super Beach,0,6,11,17,7386
4639,2023-01-22,MR. P,brawlBall,Backyard Bowl,2,58,67,127,34788
4640,2023-01-22,MR. P,bounty,Layer Cake,0,48,36,84,6654
4641,2023-01-21,MR. P,knockout,X Marks the Spot,0,143,174,317,31698
4642,2023-01-21,MR. P,hotZone,Ring of Fire,0,13,10,23,16632
4643,2023-01-21,MR. P,heist,Tornado Ring,0,5,2,7,11664
4644,2023-01-21,MR. P,gemGrab,Hard Rock Mine,0,41,42,83,22980
4645,2023-01-21,MR. P,gemGrab,Deep Diner,0,22,43,65,4470
4646,2023-01-21,MR. P,brawlBall,Super Beach,1,86,87,174,101364
4647,2023-01-21,MR. P,brawlBall,Sneaky Fields,0,2,1,3,3750
4648,2023-01-21,MR. P,bounty,Dry Season,0,113,141,254,14538
4649,2023-01-20,MR. P,knockout,Out in the Open,2,79,109,190,20106
4650,2023-01-20,MR. P,hotZone,Split,0,13,9,22,9678
4651,2023-01-20,MR. P,heist,Tornado Ring,0,8,9,17,12672
4652,2023-01-20,MR. P,gemGrab,Undermine,0,14,21,35,5442
4653,2023-01-20,MR. P,gemGrab,Deep Diner,0,68,91,159,19050
4654,2023-01-20,MR. P,brawlBall,Sneaky Fields,2,31,35,68,74778
4655,2023-01-20,MR. P,brawlBall,Pinhole Punt,0,1,0,1,2886
4656,2023-01-20,MR. P,bounty,Dry Season,0,91,94,185,11640
4657,2023-01-19,MR. P,knockout,Out in the Open,0,87,60,147,26574
4658,2023-01-19,MR. P,hotZone,Split,0,12,7,19,14856
4659,2023-01-19,MR. P,heist,Kaboom Canyon,0,10,15,25,6732
4660,2023-01-19,MR. P,gemGrab,Undermine,0,50,81,131,14154
4661,2023-01-19,MR. P,gemGrab,Gem Fort,0,12,16,28,2934
4662,2023-01-19,MR. P,brawlBall,Sunny Soccer,0,2,2,4,2274
4663,2023-01-19,MR. P,brawlBall,Pinhole Punt,0,59,77,136,72498
4664,2023-01-19,MR. P,bounty,Shooting Star,0,40,81,121,11124
4665,2023-01-18,MR. P,knockout,Goldarm Gulch,0,18,13,31,2784
4666,2023-01-18,MR. P,hotZone,Parallel Plays,0,1,2,3,1158
4667,2023-01-18,MR. P,heist,Kaboom Canyon,0,1,2,3,2592
4668,2023-01-18,MR. P,gemGrab,Gem Fort,0,7,7,14,3006
4669,2023-01-18,MR. P,gemGrab,Crystal Arcade,0,1,1,2,990
4670,2023-01-18,MR. P,brawlBall,Sunny Soccer,1,13,29,43,18941
4671,2023-01-18,MR. P,bounty,Shooting Star,0,28,38,66,5088
4672,2023-01-17,MR. P,knockout,Goldarm Gulch,0,8,10,18,2520
4673,2023-01-17,MR. P,hotZone,Parallel Plays,0,4,3,7,1038
4674,2023-01-17,MR. P,gemGrab,Minecart Madness,0,1,0,1,216
4675,2023-01-17,MR. P,gemGrab,Crystal Arcade,0,5,10,15,1266
4676,2023-01-17,MR. P,brawlBall,Beach Ball,0,12,11,23,5886
4677,2023-01-17,MR. P,bounty,Hideout,0,4,8,12,750
4678,2023-01-16,MR. P,knockout,Belle's Rock,0,14,8,22,1788
4679,2023-01-16,MR. P,hotZone,Quarter Pounder,0,1,4,5,1494
4680,2023-01-16,MR. P,heist,Pit Stop,0,2,2,4,4044
4681,2023-01-16,MR. P,gemGrab,Minecart Madness,0,2,12,14,1422
4682,2023-01-16,MR. P,gemGrab,Double Swoosh,0,2,8,10,708
4683,2023-01-16,MR. P,brawlBall,Center Stage,0,4,3,7,5778
4684,2023-01-16,MR. P,brawlBall,Backyard Bowl,1,0,0,1,852
4685,2023-01-16,MR. P,bounty,Hideout,0,2,5,7,1470
4686,2023-01-15,MR. P,knockout,Belle's Rock,0,13,18,31,2904
4687,2023-01-15,MR. P,hotZone,Quarter Pounder,0,5,1,6,3318
4688,2023-01-15,MR. P,heist,Bridge Too Far,0,5,6,11,2736
4689,2023-01-15,MR. P,gemGrab,Hard Rock Mine,0,2,0,2,1014
4690,2023-01-15,MR. P,gemGrab,Double Swoosh,0,2,3,5,2178
4691,2023-01-15,MR. P,brawlBall,Backyard Bowl,0,7,36,43,8946
4692,2023-01-15,MR. P,bounty,Canal Grande,0,5,22,27,960
4693,2023-01-14,MR. P,knockout,Flaring Phoenix,0,8,17,25,1080
4694,2023-01-14,MR. P,hotZone,Controller Chaos,0,7,2,9,2772
4695,2023-01-14,MR. P,heist,Bridge Too Far,0,8,0,8,4020
4696,2023-01-14,MR. P,gemGrab,Hard Rock Mine,0,1,1,2,1272
4697,2023-01-14,MR. P,gemGrab,Deep Diner,0,5,3,8,858
4698,2023-01-14,MR. P,brawlBall,Super Beach,0,7,3,10,6336
4699,2023-01-14,MR. P,bounty,Canal Grande,0,4,2,6,1014
4700,2023-01-13,MR. P,knockout,Flaring Phoenix,0,8,17,25,1182
4701,2023-01-13,MR. P,gemGrab,Deep Diner,0,8,1,9,1650
4702,2023-01-13,MR. P,brawlBall,Sneaky Fields,0,3,7,10,6144
4703,2023-01-13,MR. P,brawlBall,Pinhole Punt,0,1,0,1,156
4704,2023-01-13,MR. P,bounty,Temple Ruins,0,0,3,3,270
4705,2023-01-12,MR. P,knockout,Riverside,0,11,1,12,2532
4706,2023-01-12,MR. P,hotZone,Open Zone,0,2,1,3,1488
4707,2023-01-12,MR. P,gemGrab,Undermine,0,1,1,2,690
4708,2023-01-12,MR. P,brawlBall,Pinhole Punt,0,0,2,2,2292
4709,2023-01-11,MR. P,hotZone,Open Zone,0,1,0,1,462
4710,2023-01-11,MR. P,heist,Safe Zone,0,1,0,1,48
4711,2023-01-11,MR. P,gemGrab,Gem Fort,0,1,0,1,414
4712,2023-01-11,MR. P,brawlBall,Sunny Soccer,0,3,2,5,1638
4713,2023-01-11,MR. P,bounty,Excel,0,1,8,9,282
4714,2023-01-10,MR. P,knockout,New Perspective,0,8,6,14,720
4715,2023-01-10,MR. P,hotZone,Dueling Beetles,0,3,1,4,2424
4716,2023-01-10,MR. P,heist,Safe Zone,0,2,0,2,1176
4717,2023-01-10,MR. P,gemGrab,Minecart Madness,0,4,14,18,828
4718,2023-01-10,MR. P,gemGrab,Crystal Arcade,0,2,0,2,1746
4719,2023-01-10,MR. P,brawlBall,Beach Ball,0,6,12,18,4392
4720,2023-01-10,MR. P,bounty,Excel,0,2,2,4,330
4721,2023-01-09,MR. P,knockout,New Perspective,0,1,0,1,876
4722,2023-01-09,MR. P,hotZone,Dueling Beetles,0,4,10,14,1554
4723,2023-01-09,MR. P,gemGrab,Minecart Madness,0,9,12,21,1884
4724,2023-01-09,MR. P,gemGrab,Double Swoosh,0,2,11,13,1320
4725,2023-01-09,MR. P,brawlBall,Center Stage,0,1,2,3,5460
4726,2023-01-09,MR. P,bounty,Layer Cake,0,11,4,15,1512
4727,2023-01-08,MR. P,knockout,X Marks the Spot,0,4,2,6,1692
4728,2023-01-08,MR. P,hotZone,Ring of Fire,0,1,0,1,1644
4729,2023-01-08,MR. P,heist,Snaked Assault,0,3,0,3,1494
4730,2023-01-08,MR. P,gemGrab,Double Swoosh,0,9,41,50,864
4731,2023-01-08,MR. P,brawlBall,Backyard Bowl,0,4,14,18,4830
4732,2023-01-07,MR. P,knockout,X Marks the Spot,0,3,11,14,1014
4733,2023-01-07,MR. P,hotZone,Ring of Fire,0,3,1,4,846
4734,2023-01-07,MR. P,gemGrab,Deep Diner,0,2,1,3,918
4735,2023-01-07,MR. P,bounty,Dry Season,0,9,2,11,1320
4736,2023-01-06,MR. P,knockout,Out in the Open,0,3,1,4,1446
4737,2023-01-06,MR. P,hotZone,Split,0,1,0,1,1158
4738,2023-01-06,MR. P,gemGrab,Deep Diner,0,5,3,8,2226
4739,2023-01-06,MR. P,brawlBall,Sneaky Fields,0,0,5,5,4896
4740,2023-01-06,MR. P,bounty,Dry Season,0,19,15,34,1944
4741,2023-01-05,MR. P,knockout,Out in the Open,0,8,24,32,2958
4742,2023-01-05,MR. P,gemGrab,Undermine,0,3,1,4,1812
4743,2023-01-05,MR. P,gemGrab,Gem Fort,0,0,1,1,252
4744,2023-01-05,MR. P,brawlBall,Pinhole Punt,0,4,8,12,8118
4745,2023-01-05,MR. P,bounty,Shooting Star,0,6,1,7,1362
4746,2023-01-04,MR. P,knockout,Goldarm Gulch,0,0,1,1,696
4747,2023-01-04,MR. P,hotZone,Parallel Plays,0,1,0,1,864
4748,2023-01-04,MR. P,heist,Kaboom Canyon,0,1,0,1,1848
4749,2023-01-04,MR. P,gemGrab,Crystal Arcade,0,1,3,4,642
4750,2023-01-04,MR. P,brawlBall,Sunny Soccer,0,3,2,5,6312
4751,2023-01-04,MR. P,bounty,Shooting Star,0,18,5,23,3570
4752,2023-01-03,MR. P,knockout,Goldarm Gulch,0,1,1,2,720
4753,2023-01-03,MR. P,hotZone,Parallel Plays,0,1,2,3,1542
4754,2023-01-03,MR. P,heist,Pit Stop,0,1,0,1,1956
4755,2023-01-03,MR. P,gemGrab,Crystal Arcade,0,4,5,9,2406
4756,2023-01-03,MR. P,brawlBall,Center Stage,0,1,0,1,294
4757,2023-01-03,MR. P,brawlBall,Beach Ball,0,5,16,21,5580
4758,2023-01-03,MR. P,bounty,Hideout,0,7,4,11,1638
4759,2023-01-02,MR. P,knockout,Belle's Rock,0,14,4,18,1794
4760,2023-01-02,MR. P,hotZone,Quarter Pounder,0,5,9,14,2652
4761,2023-01-02,MR. P,heist,Pit Stop,0,1,0,1,3498
4762,2023-01-02,MR. P,gemGrab,Minecart Madness,0,10,18,28,2352
4763,2023-01-02,MR. P,brawlBall,Center Stage,0,4,2,6,7110
4764,2023-01-02,MR. P,brawlBall,Backyard Bowl,0,1,0,1,492
4765,2023-01-02,MR. P,bounty,Hideout,0,9,7,16,3090
4766,2023-01-01,MR. P,knockout,Belle's Rock,0,1,2,3,858
4767,2023-01-01,MR. P,hotZone,Quarter Pounder,0,1,0,1,1188
4768,2023-01-01,MR. P,gemGrab,Double Swoosh,0,7,25,32,1140
4769,2023-01-01,MR. P,brawlBall,Backyard Bowl,0,9,16,25,2658
4770,2023-01-01,MR. P,bounty,Canal Grande,0,1,2,3,132
4771,2022-12-31,MR. P,hotZone,Controller Chaos,0,1,1,2,198
4772,2022-12-24,MR. P,knockout,X Marks the Spot,0,1,1,2,12
4773,2022-12-23,MR. P,knockout,Out in the Open,0,1,0,1,132
4774,2022-12-22,MR. P,gemGrab,Gem Fort,0,1,0,1,90
4775,2022-11-07,MR. P,hotZone,Quarter Pounder,0,1,0,1,24
4776,2022-11-01,MR. P,knockout,New Perspective,0,2,2,4,54
4777,2022-10-30,MR. P,knockout,Out in the Open,0,0,2,2,12
4778,2022-10-26,MR. P,bounty,Shooting Star,0,0,1,1,36
4779,2023-01-28,MORTIS,knockout,Flaring Phoenix,1,543,501,1045,12366
4780,2023-01-28,MORTIS,hotZone,Controller Chaos,0,76,40,116,10134
4781,2023-01-28,MORTIS,heist,Bridge Too Far,0,24,6,30,24240
4782,2023-01-28,MORTIS,gemGrab,Hard Rock Mine,0,442,346,788,16638
4783,2023-01-28,MORTIS,gemGrab,Deep Diner,0,178,106,284,5478
4784,2023-01-28,MORTIS,brawlBall,Super Beach,68,4240,3348,7656,74430
4785,2023-01-28,MORTIS,brawlBall,Sneaky Fields,0,110,82,192,3582
4786,2023-01-28,MORTIS,bounty,Canal Grande,0,179,104,283,10902
4787,2023-01-27,MORTIS,knockout,Flaring Phoenix,1,289,299,589,5928
4788,2023-01-27,MORTIS,hotZone,Controller Chaos,0,18,6,24,2676
4789,2023-01-27,MORTIS,heist,Hot Potato,0,2,2,4,3486
4790,2023-01-27,MORTIS,gemGrab,Undermine,0,19,15,34,942
4791,2023-01-27,MORTIS,gemGrab,Deep Diner,0,226,194,420,6846
4792,2023-01-27,MORTIS,brawlBall,Sneaky Fields,13,912,727,1652,23514
4793,2023-01-27,MORTIS,brawlBall,Pinhole Punt,2,25,26,53,738
4794,2023-01-27,MORTIS,bounty,Temple Ruins,0,61,36,97,1890
4795,2023-01-26,MORTIS,knockout,Riverside,0,121,47,168,19008
4796,2023-01-26,MORTIS,hotZone,Open Zone,0,70,24,94,10182
4797,2023-01-26,MORTIS,heist,Hot Potato,0,19,5,24,14610
4798,2023-01-26,MORTIS,gemGrab,Undermine,0,314,218,532,10062
4799,2023-01-26,MORTIS,gemGrab,Gem Fort,0,162,118,280,4674
4800,2023-01-26,MORTIS,brawlBall,Sunny Soccer,0,204,143,347,3660
4801,2023-01-26,MORTIS,brawlBall,Pinhole Punt,67,3774,2903,6744,67338
4802,2023-01-26,MORTIS,bounty,Temple Ruins,0,175,164,339,5610
4803,2023-01-25,MORTIS,knockout,Riverside,0,51,28,79,9906
4804,2023-01-25,MORTIS,hotZone,Open Zone,0,25,6,31,5262
4805,2023-01-25,MORTIS,heist,Safe Zone,0,11,1,12,9156
4806,2023-01-25,MORTIS,gemGrab,Gem Fort,0,180,127,307,5556
4807,2023-01-25,MORTIS,gemGrab,Crystal Arcade,0,200,135,335,7866
4808,2023-01-25,MORTIS,brawlBall,Sunny Soccer,49,2178,1643,3870,40830
4809,2023-01-25,MORTIS,brawlBall,Beach Ball,9,327,245,581,6408
4810,2023-01-25,MORTIS,bounty,Excel,0,305,328,633,5790
4811,2023-01-24,MORTIS,knockout,New Perspective,0,288,297,585,10542
4812,2023-01-24,MORTIS,hotZone,Dueling Beetles,0,113,99,212,10662
4813,2023-01-24,MORTIS,heist,Safe Zone,0,15,6,21,15750
4814,2023-01-24,MORTIS,gemGrab,Minecart Madness,0,91,91,182,4002
4815,2023-01-24,MORTIS,gemGrab,Crystal Arcade,0,414,346,760,14460
4816,2023-01-24,MORTIS,brawlBall,Center Stage,6,270,221,497,7860
4817,2023-01-24,MORTIS,brawlBall,Beach Ball,82,3536,2801,6419,64614
4818,2023-01-24,MORTIS,bounty,Excel,0,603,614,1217,10896
4819,2023-01-23,MORTIS,knockout,New Perspective,3,741,829,1573,20676
4820,2023-01-23,MORTIS,hotZone,Dueling Beetles,1,180,138,319,17502
4821,2023-01-23,MORTIS,heist,Snaked Assault,0,14,7,21,15762
4822,2023-01-23,MORTIS,gemGrab,Minecart Madness,0,467,413,880,19062
4823,2023-01-23,MORTIS,gemGrab,Double Swoosh,0,180,138,318,7578
4824,2023-01-23,MORTIS,brawlBall,Center Stage,67,4123,3107,7297,92862
4825,2023-01-23,MORTIS,brawlBall,Backyard Bowl,2,183,133,318,4224
4826,2023-01-23,MORTIS,bounty,Layer Cake,0,561,480,1041,11142
4827,2023-01-22,MORTIS,knockout,X Marks the Spot,0,188,137,325,9174
4828,2023-01-22,MORTIS,hotZone,Ring of Fire,0,43,18,61,5730
4829,2023-01-22,MORTIS,heist,Snaked Assault,0,5,1,6,8232
4830,2023-01-22,MORTIS,gemGrab,Hard Rock Mine,0,167,139,306,4722
4831,2023-01-22,MORTIS,gemGrab,Double Swoosh,0,241,141,382,9426
4832,2023-01-22,MORTIS,brawlBall,Super Beach,7,355,278,640,7386
4833,2023-01-22,MORTIS,brawlBall,Backyard Bowl,52,1867,1524,3443,34788
4834,2023-01-22,MORTIS,bounty,Layer Cake,0,355,357,712,6654
4835,2023-01-21,MORTIS,knockout,X Marks the Spot,3,622,563,1188,31698
4836,2023-01-21,MORTIS,hotZone,Ring of Fire,0,85,75,160,16632
4837,2023-01-21,MORTIS,heist,Tornado Ring,0,17,3,20,11664
4838,2023-01-21,MORTIS,gemGrab,Hard Rock Mine,0,764,606,1370,22980
4839,2023-01-21,MORTIS,gemGrab,Deep Diner,0,133,87,220,4470
4840,2023-01-21,MORTIS,brawlBall,Super Beach,116,5585,4101,9802,101364
4841,2023-01-21,MORTIS,brawlBall,Sneaky Fields,0,161,103,264,3750
4842,2023-01-21,MORTIS,bounty,Dry Season,0,444,380,824,14538
4843,2023-01-20,MORTIS,knockout,Out in the Open,3,365,275,643,20106
4844,2023-01-20,MORTIS,hotZone,Split,0,86,54,140,9678
4845,2023-01-20,MORTIS,heist,Tornado Ring,0,23,2,25,12672
4846,2023-01-20,MORTIS,gemGrab,Undermine,0,188,132,320,5442
4847,2023-01-20,MORTIS,gemGrab,Deep Diner,0,633,469,1102,19050
4848,2023-01-20,MORTIS,brawlBall,Sneaky Fields,59,3370,2371,5800,74778
4849,2023-01-20,MORTIS,brawlBall,Pinhole Punt,1,161,133,295,2886
4850,2023-01-20,MORTIS,bounty,Dry Season,0,408,460,868,11640
4851,2023-01-19,MORTIS,knockout,Out in the Open,0,504,420,924,26574
4852,2023-01-19,MORTIS,hotZone,Split,0,81,49,130,14856
4853,2023-01-19,MORTIS,heist,Kaboom Canyon,0,13,2,15,6732
4854,2023-01-19,MORTIS,gemGrab,Undermine,0,443,335,778,14154
4855,2023-01-19,MORTIS,gemGrab,Gem Fort,0,75,46,121,2934
4856,2023-01-19,MORTIS,brawlBall,Sunny Soccer,1,114,81,196,2274
4857,2023-01-19,MORTIS,brawlBall,Pinhole Punt,57,4563,3469,8089,72498
4858,2023-01-19,MORTIS,bounty,Shooting Star,0,178,156,334,11124
4859,2023-01-18,MORTIS,knockout,Goldarm Gulch,1,47,40,88,2784
4860,2023-01-18,MORTIS,hotZone,Parallel Plays,0,8,13,21,1158
4861,2023-01-18,MORTIS,heist,Kaboom Canyon,0,3,0,3,2592
4862,2023-01-18,MORTIS,gemGrab,Gem Fort,0,100,74,174,3006
4863,2023-01-18,MORTIS,gemGrab,Crystal Arcade,0,21,9,30,990
4864,2023-01-18,MORTIS,brawlBall,Sunny Soccer,13,1115,868,1996,18941
4865,2023-01-18,MORTIS,brawlBall,Beach Ball,0,43,40,83,774
4866,2023-01-18,MORTIS,bounty,Shooting Star,0,86,92,178,5088
4867,2023-01-17,MORTIS,knockout,Goldarm Gulch,0,57,45,102,2520
4868,2023-01-17,MORTIS,hotZone,Parallel Plays,0,7,2,9,1038
4869,2023-01-17,MORTIS,gemGrab,Minecart Madness,0,3,6,9,216
4870,2023-01-17,MORTIS,gemGrab,Crystal Arcade,0,39,19,58,1266
4871,2023-01-17,MORTIS,brawlBall,Center Stage,0,21,10,31,288
4872,2023-01-17,MORTIS,brawlBall,Beach Ball,1,368,283,652,5886
4873,2023-01-17,MORTIS,bounty,Hideout,0,19,24,43,750
4874,2023-01-16,MORTIS,knockout,Belle's Rock,0,45,34,79,1788
4875,2023-01-16,MORTIS,hotZone,Quarter Pounder,0,10,2,12,1494
4876,2023-01-16,MORTIS,heist,Pit Stop,0,2,0,2,4044
4877,2023-01-16,MORTIS,gemGrab,Minecart Madness,0,42,27,69,1422
4878,2023-01-16,MORTIS,gemGrab,Double Swoosh,0,9,7,16,708
4879,2023-01-16,MORTIS,brawlBall,Center Stage,1,236,166,403,5778
4880,2023-01-16,MORTIS,brawlBall,Backyard Bowl,0,40,10,50,852
4881,2023-01-16,MORTIS,bounty,Hideout,0,42,17,59,1470
4882,2023-01-15,MORTIS,knockout,Belle's Rock,0,77,71,148,2904
4883,2023-01-15,MORTIS,hotZone,Quarter Pounder,0,12,9,21,3318
4884,2023-01-15,MORTIS,heist,Bridge Too Far,0,2,0,2,2736
4885,2023-01-15,MORTIS,gemGrab,Hard Rock Mine,0,41,22,63,1014
4886,2023-01-15,MORTIS,gemGrab,Double Swoosh,0,82,58,140,2178
4887,2023-01-15,MORTIS,brawlBall,Super Beach,2,41,22,65,1074
4888,2023-01-15,MORTIS,brawlBall,Backyard Bowl,9,437,257,703,8946
4889,2023-01-15,MORTIS,bounty,Canal Grande,0,19,9,28,960
4890,2023-01-14,MORTIS,knockout,Flaring Phoenix,1,24,25,50,1080
4891,2023-01-14,MORTIS,hotZone,Controller Chaos,0,17,7,24,2772
4892,2023-01-14,MORTIS,heist,Bridge Too Far,0,3,0,3,4020
4893,2023-01-14,MORTIS,gemGrab,Hard Rock Mine,0,44,36,80,1272
4894,2023-01-14,MORTIS,gemGrab,Deep Diner,0,25,35,60,858
4895,2023-01-14,MORTIS,brawlBall,Super Beach,6,304,205,515,6336
4896,2023-01-14,MORTIS,brawlBall,Sneaky Fields,0,12,5,17,918
4897,2023-01-14,MORTIS,bounty,Canal Grande,0,14,23,37,1014
4898,2023-01-13,MORTIS,knockout,Flaring Phoenix,0,49,63,112,1182
4899,2023-01-13,MORTIS,hotZone,Controller Chaos,0,24,45,69,2928
4900,2023-01-13,MORTIS,gemGrab,Undermine,0,1,0,1,18
4901,2023-01-13,MORTIS,gemGrab,Deep Diner,0,73,32,105,1650
4902,2023-01-13,MORTIS,brawlBall,Sneaky Fields,2,171,97,270,6144
4903,2023-01-13,MORTIS,brawlBall,Pinhole Punt,0,2,3,5,156
4904,2023-01-13,MORTIS,bounty,Temple Ruins,0,10,20,30,270
4905,2023-01-12,MORTIS,knockout,Riverside,0,12,5,17,2532
4906,2023-01-12,MORTIS,hotZone,Open Zone,0,9,2,11,1488
4907,2023-01-12,MORTIS,gemGrab,Undermine,0,8,7,15,690
4908,2023-01-12,MORTIS,gemGrab,Gem Fort,0,3,2,5,162
4909,2023-01-12,MORTIS,brawlBall,Sunny Soccer,0,3,0,3,240
4910,2023-01-12,MORTIS,brawlBall,Pinhole Punt,0,67,55,122,2292
4911,2023-01-11,MORTIS,knockout,Riverside,0,2,0,2,528
4912,2023-01-11,MORTIS,hotZone,Open Zone,0,1,1,2,462
4913,2023-01-11,MORTIS,gemGrab,Gem Fort,0,8,3,11,414
4914,2023-01-11,MORTIS,brawlBall,Sunny Soccer,0,47,46,93,1638
4915,2023-01-11,MORTIS,brawlBall,Beach Ball,0,2,2,4,48
4916,2023-01-11,MORTIS,bounty,Excel,0,18,12,30,282
4917,2023-01-10,MORTIS,knockout,New Perspective,0,15,15,30,720
4918,2023-01-10,MORTIS,hotZone,Dueling Beetles,0,31,22,53,2424
4919,2023-01-10,MORTIS,heist,Safe Zone,0,1,0,1,1176
4920,2023-01-10,MORTIS,gemGrab,Minecart Madness,0,23,19,42,828
4921,2023-01-10,MORTIS,gemGrab,Crystal Arcade,0,52,30,82,1746
4922,2023-01-10,MORTIS,brawlBall,Center Stage,0,26,34,60,708
4923,2023-01-10,MORTIS,brawlBall,Beach Ball,0,156,74,230,4392
4924,2023-01-10,MORTIS,bounty,Excel,0,22,7,29,330
4925,2023-01-09,MORTIS,knockout,New Perspective,0,34,35,69,876
4926,2023-01-09,MORTIS,hotZone,Dueling Beetles,0,13,17,30,1554
4927,2023-01-09,MORTIS,heist,Snaked Assault,0,1,1,2,2022
4928,2023-01-09,MORTIS,gemGrab,Minecart Madness,0,44,14,58,1884
4929,2023-01-09,MORTIS,gemGrab,Double Swoosh,0,24,15,39,1320
4930,2023-01-09,MORTIS,brawlBall,Center Stage,3,142,120,265,5460
4931,2023-01-09,MORTIS,brawlBall,Backyard Bowl,0,13,6,19,474
4932,2023-01-09,MORTIS,bounty,Layer Cake,0,77,110,187,1512
4933,2023-01-08,MORTIS,knockout,X Marks the Spot,0,32,21,53,1692
4934,2023-01-08,MORTIS,hotZone,Ring of Fire,0,8,1,9,1644
4935,2023-01-08,MORTIS,heist,Snaked Assault,0,1,0,1,1494
4936,2023-01-08,MORTIS,gemGrab,Hard Rock Mine,0,17,10,27,630
4937,2023-01-08,MORTIS,gemGrab,Double Swoosh,0,14,7,21,864
4938,2023-01-08,MORTIS,brawlBall,Super Beach,0,17,9,26,732
4939,2023-01-08,MORTIS,brawlBall,Backyard Bowl,1,169,71,241,4830
4940,2023-01-08,MORTIS,bounty,Layer Cake,0,26,17,43,528
4941,2023-01-07,MORTIS,knockout,X Marks the Spot,0,15,11,26,1014
4942,2023-01-07,MORTIS,hotZone,Ring of Fire,0,3,1,4,846
4943,2023-01-07,MORTIS,heist,Tornado Ring,0,2,0,2,1350
4944,2023-01-07,MORTIS,gemGrab,Hard Rock Mine,0,36,15,51,1158
4945,2023-01-07,MORTIS,gemGrab,Deep Diner,0,29,9,38,918
4946,2023-01-07,MORTIS,brawlBall,Super Beach,0,88,35,123,2622
4947,2023-01-07,MORTIS,brawlBall,Sneaky Fields,0,12,2,14,402
4948,2023-01-07,MORTIS,bounty,Dry Season,0,56,38,94,1320
4949,2023-01-06,MORTIS,knockout,Out in the Open,0,23,31,54,1446
4950,2023-01-06,MORTIS,hotZone,Split,0,7,3,10,1158
4951,2023-01-06,MORTIS,gemGrab,Undermine,0,9,17,26,540
4952,2023-01-06,MORTIS,gemGrab,Deep Diner,0,59,17,76,2226
4953,2023-01-06,MORTIS,brawlBall,Sneaky Fields,0,88,36,124,4896
4954,2023-01-06,MORTIS,brawlBall,Pinhole Punt,0,20,10,30,510
4955,2023-01-06,MORTIS,bounty,Dry Season,0,67,54,121,1944
4956,2023-01-05,MORTIS,knockout,Out in the Open,1,50,20,71,2958
4957,2023-01-05,MORTIS,hotZone,Split,0,9,2,11,3552
4958,2023-01-05,MORTIS,heist,Kaboom Canyon,0,1,0,1,954
4959,2023-01-05,MORTIS,gemGrab,Undermine,0,38,28,66,1812
4960,2023-01-05,MORTIS,gemGrab,Gem Fort,0,1,2,3,252
4961,2023-01-05,MORTIS,brawlBall,Sunny Soccer,0,4,1,5,84
4962,2023-01-05,MORTIS,brawlBall,Pinhole Punt,2,227,93,322,8118
4963,2023-01-05,MORTIS,bounty,Shooting Star,0,20,29,49,1362
4964,2023-01-04,MORTIS,knockout,Goldarm Gulch,0,15,13,28,696
4965,2023-01-04,MORTIS,hotZone,Parallel Plays,0,9,8,17,864
4966,2023-01-04,MORTIS,gemGrab,Gem Fort,0,49,18,67,1788
4967,2023-01-04,MORTIS,gemGrab,Crystal Arcade,0,17,8,25,642
4968,2023-01-04,MORTIS,brawlBall,Sunny Soccer,2,171,77,250,6312
4969,2023-01-04,MORTIS,brawlBall,Beach Ball,0,5,2,7,54
4970,2023-01-04,MORTIS,bounty,Shooting Star,0,59,51,110,3570
4971,2023-01-03,MORTIS,knockout,Goldarm Gulch,0,17,7,24,720
4972,2023-01-03,MORTIS,hotZone,Parallel Plays,0,9,2,11,1542
4973,2023-01-03,MORTIS,heist,Pit Stop,0,1,0,1,1956
4974,2023-01-03,MORTIS,gemGrab,Minecart Madness,0,6,3,9,456
4975,2023-01-03,MORTIS,gemGrab,Crystal Arcade,0,57,26,83,2406
4976,2023-01-03,MORTIS,brawlBall,Center Stage,0,15,5,20,294
4977,2023-01-03,MORTIS,brawlBall,Beach Ball,1,184,51,236,5580
4978,2023-01-03,MORTIS,bounty,Hideout,0,50,65,115,1638
4979,2023-01-02,MORTIS,knockout,Belle's Rock,0,45,34,79,1794
4980,2023-01-02,MORTIS,hotZone,Quarter Pounder,0,15,11,26,2652
4981,2023-01-02,MORTIS,gemGrab,Minecart Madness,0,55,11,66,2352
4982,2023-01-02,MORTIS,gemGrab,Double Swoosh,0,21,4,25,1512
4983,2023-01-02,MORTIS,brawlBall,Center Stage,2,165,53,220,7110
4984,2023-01-02,MORTIS,brawlBall,Backyard Bowl,3,25,19,47,492
4985,2023-01-02,MORTIS,bounty,Hideout,0,93,68,161,3090
4986,2023-01-01,MORTIS,knockout,Belle's Rock,0,17,9,26,858
4987,2023-01-01,MORTIS,hotZone,Quarter Pounder,0,7,12,19,1188
4988,2023-01-01,MORTIS,hotZone,Controller Chaos,0,0,1,1,12
4989,2023-01-01,MORTIS,gemGrab,Minecart Madness,0,0,1,1,12
4990,2023-01-01,MORTIS,gemGrab,Hard Rock Mine,0,1,0,1,48
4991,2023-01-01,MORTIS,gemGrab,Double Swoosh,0,14,6,20,1140
4992,2023-01-01,MORTIS,brawlBall,Backyard Bowl,1,106,32,139,2658
4993,2023-01-01,MORTIS,bounty,Canal Grande,0,0,2,2,132
4994,2022-12-31,MORTIS,knockout,Flaring Phoenix,0,0,1,1,18
4995,2022-12-31,MORTIS,hotZone,Controller Chaos,0,1,0,1,198
4996,2022-12-31,MORTIS,gemGrab,Hard Rock Mine,0,13,4,17,384
4997,2022-12-31,MORTIS,gemGrab,Deep Diner,0,4,4,8,306
4998,2022-12-31,MORTIS,brawlBall,Super Beach,1,26,10,37,618
4999,2022-12-31,MORTIS,bounty,Canal Grande,0,1,0,1,54
5000,2022-12-30,MORTIS,knockout,Flaring Phoenix,0,3,2,5,72
5001,2022-12-30,MORTIS,hotZone,Controller Chaos,0,3,6,9,288
5002,2022-12-30,MORTIS,heist,Kaboom Canyon,0,1,0,1,18
5003,2022-12-30,MORTIS,gemGrab,Deep Diner,0,11,4,15,438
5004,2022-12-30,MORTIS,brawlBall,Sneaky Fields,0,19,10,29,552
5005,2022-12-29,MORTIS,hotZone,Open Zone,0,1,0,1,54
5006,2022-12-29,MORTIS,gemGrab,Undermine,0,1,1,2,102
5007,2022-12-29,MORTIS,gemGrab,Minecart Madness,0,1,1,2,24
5008,2022-12-29,MORTIS,brawlBall,Pinhole Punt,0,8,14,22,282
5009,2022-12-28,MORTIS,brawlBall,Sunny Soccer,0,4,4,8,42
5010,2022-12-27,MORTIS,gemGrab,Minecart Madness,0,0,2,2,30
5011,2022-12-27,MORTIS,brawlBall,Beach Ball,0,9,5,14,144
5012,2022-12-26,MORTIS,heist,Kaboom Canyon,0,0,2,2,36
5013,2022-12-26,MORTIS,gemGrab,Minecart Madness,0,1,5,6,60
5014,2022-12-26,MORTIS,brawlBall,Center Stage,0,5,2,7,78
5015,2022-12-25,MORTIS,brawlBall,Backyard Bowl,0,1,0,1,78
5016,2022-12-25,MORTIS,bounty,Layer Cake,0,1,1,2,12
5017,2022-12-24,MORTIS,brawlBall,Super Beach,0,2,2,4,48
5018,2022-12-24,MORTIS,bounty,Dry Season,0,1,0,1,12
5019,2022-12-23,MORTIS,knockout,Out in the Open,0,0,1,1,132
5020,2022-12-23,MORTIS,brawlBall,Sneaky Fields,0,0,1,1,12
5021,2022-12-22,MORTIS,gemGrab,Gem Fort,0,1,2,3,90
5022,2022-12-22,MORTIS,brawlBall,Pinhole Punt,0,5,0,5,132
5023,2022-12-21,MORTIS,brawlBall,Sunny Soccer,0,3,3,6,54
5024,2022-12-20,MORTIS,brawlBall,Beach Ball,0,5,6,11,96
5025,2022-12-19,MORTIS,brawlBall,Center Stage,0,7,5,12,102
5026,2022-12-17,MORTIS,knockout,Flaring Phoenix,0,4,4,8,30
5027,2022-12-16,MORTIS,brawlBall,Sneaky Fields,0,4,2,6,84
5028,2022-12-16,MORTIS,bounty,Temple Ruins,0,1,4,5,24
5029,2022-12-13,MORTIS,knockout,New Perspective,0,2,1,3,84
5030,2022-12-13,MORTIS,gemGrab,Crystal Arcade,0,2,1,3,72
5031,2022-12-13,MORTIS,brawlBall,Beach Ball,0,4,1,5,54
5032,2022-12-11,MORTIS,gemGrab,Double Swoosh,0,2,0,2,12
5033,2022-12-10,MORTIS,knockout,X Marks the Spot,0,1,1,2,12
5034,2022-11-11,MORTIS,brawlBall,Sneaky Fields,0,1,0,1,42
5035,2022-11-03,MORTIS,bounty,Temple Ruins,0,0,1,1,6
5036,2022-10-28,MORTIS,brawlBall,Beach Ball,0,1,0,1,12
5037,2022-10-26,MORTIS,brawlBall,Sunny Soccer,0,2,0,2,18
5038,2022-10-26,MORTIS,bounty,Shooting Star,0,0,1,1,36
5039,2022-10-15,MORTIS,hotZone,Ring of Fire,0,1,0,1,24
5040,2022-10-15,MORTIS,gemGrab,Hard Rock Mine,0,2,2,4,90
5041,2022-10-15,MORTIS,brawlBall,Super Beach,0,1,1,2,12
5042,2022-10-10,MORTIS,knockout,Belle's Rock,0,1,0,1,48
5043,2023-01-28,MEG,knockout,Flaring Phoenix,0,7,6,13,12366
5044,2023-01-28,MEG,hotZone,Controller Chaos,0,71,62,133,10134
5045,2023-01-28,MEG,heist,Bridge Too Far,2,160,205,367,24240
5046,2023-01-28,MEG,gemGrab,Hard Rock Mine,0,53,50,103,16638
5047,2023-01-28,MEG,gemGrab,Deep Diner,0,9,19,28,5478
5048,2023-01-28,MEG,brawlBall,Super Beach,0,106,137,243,74430
5049,2023-01-28,MEG,brawlBall,Sneaky Fields,0,1,1,2,3582
5050,2023-01-28,MEG,bounty,Canal Grande,0,2,1,3,10902
5051,2023-01-27,MEG,knockout,Flaring Phoenix,0,1,2,3,5928
5052,2023-01-27,MEG,hotZone,Controller Chaos,0,16,16,32,2676
5053,2023-01-27,MEG,heist,Hot Potato,0,8,5,13,3486
5054,2023-01-27,MEG,gemGrab,Undermine,0,3,2,5,942
5055,2023-01-27,MEG,gemGrab,Deep Diner,0,14,12,26,6846
5056,2023-01-27,MEG,brawlBall,Sneaky Fields,0,14,29,43,23514
5057,2023-01-27,MEG,brawlBall,Pinhole Punt,0,1,0,1,738
5058,2023-01-27,MEG,bounty,Temple Ruins,0,4,3,7,1890
5059,2023-01-26,MEG,knockout,Riverside,0,26,26,52,19008
5060,2023-01-26,MEG,hotZone,Open Zone,0,213,473,686,10182
5061,2023-01-26,MEG,heist,Hot Potato,0,6,5,11,14610
5062,2023-01-26,MEG,gemGrab,Undermine,0,14,23,37,10062
5063,2023-01-26,MEG,gemGrab,Gem Fort,0,8,6,14,4674
5064,2023-01-26,MEG,brawlBall,Sunny Soccer,0,3,3,6,3660
5065,2023-01-26,MEG,brawlBall,Pinhole Punt,8,213,250,471,67338
5066,2023-01-26,MEG,bounty,Temple Ruins,0,9,8,17,5610
5067,2023-01-25,MEG,knockout,Riverside,0,21,23,44,9906
5068,2023-01-25,MEG,hotZone,Open Zone,0,150,249,399,5262
5069,2023-01-25,MEG,heist,Safe Zone,0,22,25,47,9156
5070,2023-01-25,MEG,gemGrab,Gem Fort,0,21,19,40,5556
5071,2023-01-25,MEG,gemGrab,Crystal Arcade,0,19,10,29,7866
5072,2023-01-25,MEG,brawlBall,Sunny Soccer,0,48,68,116,40830
5073,2023-01-25,MEG,brawlBall,Beach Ball,1,11,13,25,6408
5074,2023-01-25,MEG,bounty,Excel,0,0,1,1,5790
5075,2023-01-24,MEG,knockout,New Perspective,0,13,22,35,10542
5076,2023-01-24,MEG,hotZone,Dueling Beetles,0,130,381,511,10662
5077,2023-01-24,MEG,heist,Safe Zone,0,33,46,79,15750
5078,2023-01-24,MEG,gemGrab,Minecart Madness,0,37,47,84,4002
5079,2023-01-24,MEG,gemGrab,Crystal Arcade,0,36,46,82,14460
5080,2023-01-24,MEG,brawlBall,Center Stage,0,20,12,32,7860
5081,2023-01-24,MEG,brawlBall,Beach Ball,4,108,148,260,64614
5082,2023-01-24,MEG,bounty,Excel,0,3,8,11,10896
5083,2023-01-23,MEG,knockout,New Perspective,0,14,9,23,20676
5084,2023-01-23,MEG,hotZone,Dueling Beetles,0,305,536,841,17502
5085,2023-01-23,MEG,heist,Snaked Assault,0,13,15,28,15762
5086,2023-01-23,MEG,gemGrab,Minecart Madness,0,65,111,176,19062
5087,2023-01-23,MEG,gemGrab,Double Swoosh,0,16,10,26,7578
5088,2023-01-23,MEG,brawlBall,Center Stage,2,108,130,240,92862
5089,2023-01-23,MEG,brawlBall,Backyard Bowl,0,29,37,66,4224
5090,2023-01-23,MEG,bounty,Layer Cake,0,8,10,18,11142
5091,2023-01-22,MEG,knockout,X Marks the Spot,0,4,5,9,9174
5092,2023-01-22,MEG,hotZone,Ring of Fire,0,70,137,207,5730
5093,2023-01-22,MEG,heist,Snaked Assault,0,4,1,5,8232
5094,2023-01-22,MEG,gemGrab,Hard Rock Mine,0,0,6,6,4722
5095,2023-01-22,MEG,gemGrab,Double Swoosh,0,25,22,47,9426
5096,2023-01-22,MEG,brawlBall,Super Beach,1,11,13,25,7386
5097,2023-01-22,MEG,brawlBall,Backyard Bowl,10,152,215,377,34788
5098,2023-01-22,MEG,bounty,Layer Cake,0,1,2,3,6654
5099,2023-01-21,MEG,knockout,X Marks the Spot,0,27,50,77,31698
5100,2023-01-21,MEG,hotZone,Ring of Fire,1,260,448,709,16632
5101,2023-01-21,MEG,heist,Tornado Ring,1,14,14,29,11664
5102,2023-01-21,MEG,gemGrab,Hard Rock Mine,0,31,32,63,22980
5103,2023-01-21,MEG,gemGrab,Deep Diner,0,5,12,17,4470
5104,2023-01-21,MEG,brawlBall,Super Beach,4,100,119,223,101364
5105,2023-01-21,MEG,brawlBall,Sneaky Fields,0,2,3,5,3750
5106,2023-01-21,MEG,bounty,Dry Season,0,10,5,15,14538
5107,2023-01-20,MEG,knockout,Out in the Open,0,17,32,49,20106
5108,2023-01-20,MEG,hotZone,Split,0,7,6,13,9678
5109,2023-01-20,MEG,heist,Tornado Ring,0,11,7,18,12672
5110,2023-01-20,MEG,gemGrab,Undermine,0,12,18,30,5442
5111,2023-01-20,MEG,gemGrab,Deep Diner,0,39,67,106,19050
5112,2023-01-20,MEG,brawlBall,Sneaky Fields,1,57,66,124,74778
5113,2023-01-20,MEG,brawlBall,Pinhole Punt,0,12,11,23,2886
5114,2023-01-20,MEG,bounty,Dry Season,0,15,11,26,11640
5115,2023-01-19,MEG,knockout,Out in the Open,0,39,31,70,26574
5116,2023-01-19,MEG,hotZone,Split,0,11,9,20,14856
5117,2023-01-19,MEG,heist,Kaboom Canyon,0,20,49,69,6732
5118,2023-01-19,MEG,gemGrab,Undermine,0,27,32,59,14154
5119,2023-01-19,MEG,gemGrab,Gem Fort,0,6,5,11,2934
5120,2023-01-19,MEG,brawlBall,Sunny Soccer,0,3,0,3,2274
5121,2023-01-19,MEG,brawlBall,Pinhole Punt,5,196,269,470,72498
5122,2023-01-19,MEG,bounty,Shooting Star,0,12,14,26,11124
5123,2023-01-18,MEG,knockout,Goldarm Gulch,0,3,1,4,2784
5124,2023-01-18,MEG,hotZone,Parallel Plays,0,4,0,4,1158
5125,2023-01-18,MEG,heist,Kaboom Canyon,0,9,28,37,2592
5126,2023-01-18,MEG,gemGrab,Gem Fort,0,6,6,12,3006
5127,2023-01-18,MEG,gemGrab,Crystal Arcade,0,2,5,7,990
5128,2023-01-18,MEG,brawlBall,Sunny Soccer,2,18,28,48,18941
5129,2023-01-18,MEG,brawlBall,Beach Ball,0,4,0,4,774
5130,2023-01-18,MEG,bounty,Shooting Star,0,7,15,22,5088
5131,2023-01-17,MEG,knockout,Goldarm Gulch,0,0,1,1,2520
5132,2023-01-17,MEG,hotZone,Parallel Plays,0,2,1,3,1038
5133,2023-01-17,MEG,gemGrab,Minecart Madness,0,2,2,4,216
5134,2023-01-17,MEG,gemGrab,Crystal Arcade,0,2,3,5,1266
5135,2023-01-17,MEG,brawlBall,Beach Ball,0,17,16,33,5886
5136,2023-01-17,MEG,bounty,Hideout,0,0,2,2,750
5137,2023-01-16,MEG,knockout,Belle's Rock,0,1,0,1,1788
5138,2023-01-16,MEG,hotZone,Quarter Pounder,0,9,57,66,1494
5139,2023-01-16,MEG,gemGrab,Minecart Madness,0,5,12,17,1422
5140,2023-01-16,MEG,gemGrab,Double Swoosh,0,1,0,1,708
5141,2023-01-16,MEG,brawlBall,Center Stage,0,3,2,5,5778
5142,2023-01-16,MEG,brawlBall,Backyard Bowl,0,3,13,16,852
5143,2023-01-16,MEG,bounty,Hideout,0,2,0,2,1470
5144,2023-01-15,MEG,knockout,Belle's Rock,0,1,1,2,2904
5145,2023-01-15,MEG,hotZone,Quarter Pounder,0,36,120,156,3318
5146,2023-01-15,MEG,heist,Bridge Too Far,0,26,42,68,2736
5147,2023-01-15,MEG,gemGrab,Double Swoosh,0,3,7,10,2178
5148,2023-01-15,MEG,brawlBall,Backyard Bowl,1,48,54,103,8946
5149,2023-01-14,MEG,knockout,Flaring Phoenix,0,1,2,3,1080
5150,2023-01-14,MEG,hotZone,Controller Chaos,0,6,34,40,2772
5151,2023-01-14,MEG,heist,Bridge Too Far,0,15,51,66,4020
5152,2023-01-14,MEG,gemGrab,Hard Rock Mine,0,1,0,1,1272
5153,2023-01-14,MEG,gemGrab,Deep Diner,0,3,0,3,858
5154,2023-01-14,MEG,brawlBall,Super Beach,0,7,9,16,6336
5155,2023-01-14,MEG,brawlBall,Sneaky Fields,0,3,0,3,918
5156,2023-01-13,MEG,knockout,Flaring Phoenix,0,0,1,1,1182
5157,2023-01-13,MEG,hotZone,Controller Chaos,0,12,26,38,2928
5158,2023-01-13,MEG,gemGrab,Deep Diner,0,1,1,2,1650
5159,2023-01-13,MEG,brawlBall,Sneaky Fields,0,2,0,2,6144
5160,2023-01-13,MEG,brawlBall,Pinhole Punt,0,0,1,1,156
5161,2023-01-13,MEG,bounty,Temple Ruins,0,0,1,1,270
5162,2023-01-12,MEG,knockout,Riverside,0,1,0,1,2532
5163,2023-01-12,MEG,hotZone,Open Zone,0,13,69,82,1488
5164,2023-01-12,MEG,brawlBall,Pinhole Punt,0,5,10,15,2292
5165,2023-01-11,MEG,knockout,Riverside,0,4,3,7,528
5166,2023-01-11,MEG,hotZone,Open Zone,0,16,27,43,462
5167,2023-01-11,MEG,brawlBall,Sunny Soccer,0,2,1,3,1638
5168,2023-01-10,MEG,hotZone,Dueling Beetles,0,20,54,74,2424
5169,2023-01-10,MEG,heist,Safe Zone,0,2,4,6,1176
5170,2023-01-10,MEG,gemGrab,Minecart Madness,0,2,18,20,828
5171,2023-01-10,MEG,gemGrab,Crystal Arcade,0,1,0,1,1746
5172,2023-01-10,MEG,brawlBall,Beach Ball,0,17,41,58,4392
5173,2023-01-09,MEG,knockout,New Perspective,0,0,1,1,876
5174,2023-01-09,MEG,hotZone,Dueling Beetles,0,9,31,40,1554
5175,2023-01-09,MEG,heist,Snaked Assault,0,3,0,3,2022
5176,2023-01-09,MEG,gemGrab,Minecart Madness,0,7,29,36,1884
5177,2023-01-09,MEG,gemGrab,Double Swoosh,0,1,1,2,1320
5178,2023-01-09,MEG,brawlBall,Center Stage,0,1,0,1,5460
5179,2023-01-09,MEG,brawlBall,Backyard Bowl,1,4,10,15,474
5180,2023-01-09,MEG,bounty,Layer Cake,0,1,2,3,1512
5181,2023-01-08,MEG,knockout,X Marks the Spot,0,4,3,7,1692
5182,2023-01-08,MEG,hotZone,Ring of Fire,0,23,42,65,1644
5183,2023-01-08,MEG,heist,Snaked Assault,0,1,0,1,1494
5184,2023-01-08,MEG,gemGrab,Hard Rock Mine,0,1,1,2,630
5185,2023-01-08,MEG,gemGrab,Double Swoosh,0,1,0,1,864
5186,2023-01-08,MEG,brawlBall,Super Beach,0,0,4,4,732
5187,2023-01-08,MEG,brawlBall,Backyard Bowl,0,25,29,54,4830
5188,2023-01-08,MEG,bounty,Layer Cake,0,1,0,1,528
5189,2023-01-07,MEG,hotZone,Ring of Fire,0,19,39,58,846
5190,2023-01-07,MEG,brawlBall,Sneaky Fields,0,0,3,3,402
5191,2023-01-07,MEG,bounty,Dry Season,0,0,3,3,1320
5192,2023-01-06,MEG,gemGrab,Undermine,0,2,1,3,540
5193,2023-01-06,MEG,brawlBall,Sneaky Fields,0,5,2,7,4896
5194,2023-01-06,MEG,brawlBall,Pinhole Punt,0,0,2,2,510
5195,2023-01-06,MEG,bounty,Dry Season,0,0,1,1,1944
5196,2023-01-05,MEG,knockout,Out in the Open,0,5,2,7,2958
5197,2023-01-05,MEG,hotZone,Split,0,1,0,1,3552
5198,2023-01-05,MEG,heist,Kaboom Canyon,0,5,12,17,954
5199,2023-01-05,MEG,gemGrab,Undermine,0,3,5,8,1812
5200,2023-01-05,MEG,gemGrab,Gem Fort,0,0,1,1,252
5201,2023-01-05,MEG,brawlBall,Pinhole Punt,1,9,25,35,8118
5202,2023-01-05,MEG,bounty,Shooting Star,0,0,1,1,1362
5203,2023-01-04,MEG,hotZone,Parallel Plays,0,0,3,3,864
5204,2023-01-04,MEG,heist,Kaboom Canyon,0,3,8,11,1848
5205,2023-01-04,MEG,gemGrab,Gem Fort,0,1,0,1,1788
5206,2023-01-04,MEG,gemGrab,Crystal Arcade,0,1,0,1,642
5207,2023-01-04,MEG,brawlBall,Sunny Soccer,0,1,0,1,6312
5208,2023-01-04,MEG,bounty,Shooting Star,0,1,1,2,3570
5209,2023-01-03,MEG,knockout,Goldarm Gulch,0,1,0,1,720
5210,2023-01-03,MEG,hotZone,Parallel Plays,0,1,0,1,1542
5211,2023-01-03,MEG,gemGrab,Minecart Madness,0,2,17,19,456
5212,2023-01-03,MEG,gemGrab,Crystal Arcade,0,3,0,3,2406
5213,2023-01-03,MEG,brawlBall,Beach Ball,0,4,1,5,5580
5214,2023-01-03,MEG,bounty,Hideout,0,1,0,1,1638
5215,2023-01-02,MEG,knockout,Belle's Rock,0,1,0,1,1794
5216,2023-01-02,MEG,hotZone,Quarter Pounder,0,24,33,57,2652
5217,2023-01-02,MEG,gemGrab,Minecart Madness,0,9,15,24,2352
5218,2023-01-02,MEG,gemGrab,Double Swoosh,0,1,0,1,1512
5219,2023-01-02,MEG,brawlBall,Center Stage,0,3,0,3,7110
5220,2023-01-02,MEG,brawlBall,Backyard Bowl,0,1,0,1,492
5221,2023-01-02,MEG,bounty,Hideout,0,2,1,3,3090
5222,2023-01-01,MEG,knockout,Belle's Rock,0,1,6,7,858
5223,2023-01-01,MEG,hotZone,Quarter Pounder,0,12,19,31,1188
5224,2023-01-01,MEG,heist,Bridge Too Far,0,1,1,2,462
5225,2023-01-01,MEG,brawlBall,Backyard Bowl,0,13,5,18,2658
5226,2022-12-31,MEG,gemGrab,Hard Rock Mine,0,0,3,3,384
5227,2022-12-31,MEG,brawlBall,Super Beach,0,0,8,8,618
5228,2022-12-30,MEG,hotZone,Controller Chaos,0,6,15,21,288
5229,2022-12-30,MEG,heist,Kaboom Canyon,0,1,1,2,18
5230,2022-12-30,MEG,gemGrab,Minecart Madness,0,0,1,1,24
5231,2022-12-30,MEG,gemGrab,Deep Diner,0,2,0,2,438
5232,2022-12-30,MEG,brawlBall,Sneaky Fields,0,0,1,1,552
5233,2022-12-29,MEG,hotZone,Open Zone,0,1,1,2,54
5234,2022-12-29,MEG,brawlBall,Pinhole Punt,0,0,1,1,282
5235,2022-12-27,MEG,heist,Kaboom Canyon,0,0,1,1,18
5236,2022-12-27,MEG,gemGrab,Minecart Madness,0,0,1,1,30
5237,2022-12-27,MEG,brawlBall,Beach Ball,0,2,1,3,144
5238,2022-12-26,MEG,gemGrab,Minecart Madness,0,0,1,1,60
5239,2022-12-22,MEG,brawlBall,Pinhole Punt,0,0,1,1,132
5240,2022-12-11,MEG,brawlBall,Backyard Bowl,0,0,1,1,24
5241,2022-12-10,MEG,gemGrab,Hard Rock Mine,0,1,0,1,24
5242,2023-01-28,MAX,knockout,Flaring Phoenix,0,28,49,77,12366
5243,2023-01-28,MAX,hotZone,Controller Chaos,0,44,66,110,10134
5244,2023-01-28,MAX,heist,Bridge Too Far,1,520,554,1075,24240
5245,2023-01-28,MAX,gemGrab,Hard Rock Mine,0,194,226,420,16638
5246,2023-01-28,MAX,gemGrab,Deep Diner,0,61,61,122,5478
5247,2023-01-28,MAX,brawlBall,Super Beach,29,1012,1066,2107,74430
5248,2023-01-28,MAX,brawlBall,Sneaky Fields,0,35,45,80,3582
5249,2023-01-28,MAX,bounty,Canal Grande,0,40,42,82,10902
5250,2023-01-27,MAX,knockout,Flaring Phoenix,0,23,6,29,5928
5251,2023-01-27,MAX,hotZone,Controller Chaos,0,13,6,19,2676
5252,2023-01-27,MAX,heist,Hot Potato,0,13,12,25,3486
5253,2023-01-27,MAX,gemGrab,Undermine,0,11,17,28,942
5254,2023-01-27,MAX,gemGrab,Deep Diner,0,70,66,136,6846
5255,2023-01-27,MAX,brawlBall,Sneaky Fields,6,241,319,566,23514
5256,2023-01-27,MAX,brawlBall,Pinhole Punt,0,12,12,24,738
5257,2023-01-27,MAX,bounty,Temple Ruins,0,26,21,47,1890
5258,2023-01-26,MAX,knockout,Riverside,0,121,101,222,19008
5259,2023-01-26,MAX,hotZone,Open Zone,0,151,159,310,10182
5260,2023-01-26,MAX,heist,Hot Potato,0,41,32,73,14610
5261,2023-01-26,MAX,gemGrab,Undermine,0,98,123,221,10062
5262,2023-01-26,MAX,gemGrab,Gem Fort,0,43,46,89,4674
5263,2023-01-26,MAX,brawlBall,Sunny Soccer,1,49,53,103,3660
5264,2023-01-26,MAX,brawlBall,Pinhole Punt,34,1131,1177,2342,67338
5265,2023-01-26,MAX,bounty,Temple Ruins,0,48,52,100,5610
5266,2023-01-25,MAX,knockout,Riverside,0,66,66,132,9906
5267,2023-01-25,MAX,hotZone,Open Zone,0,87,63,150,5262
5268,2023-01-25,MAX,heist,Safe Zone,1,88,105,194,9156
5269,2023-01-25,MAX,gemGrab,Gem Fort,0,42,47,89,5556
5270,2023-01-25,MAX,gemGrab,Crystal Arcade,0,104,123,227,7866
5271,2023-01-25,MAX,brawlBall,Sunny Soccer,11,495,551,1057,40830
5272,2023-01-25,MAX,brawlBall,Beach Ball,1,81,128,210,6408
5273,2023-01-25,MAX,bounty,Excel,0,22,39,61,5790
5274,2023-01-24,MAX,knockout,New Perspective,0,84,41,125,10542
5275,2023-01-24,MAX,hotZone,Dueling Beetles,0,46,34,80,10662
5276,2023-01-24,MAX,heist,Safe Zone,0,216,245,461,15750
5277,2023-01-24,MAX,gemGrab,Minecart Madness,0,26,35,61,4002
5278,2023-01-24,MAX,gemGrab,Crystal Arcade,0,154,231,385,14460
5279,2023-01-24,MAX,brawlBall,Center Stage,1,74,91,166,7860
5280,2023-01-24,MAX,brawlBall,Beach Ball,33,882,998,1913,64614
5281,2023-01-24,MAX,bounty,Excel,0,67,68,135,10896
5282,2023-01-23,MAX,knockout,New Perspective,0,113,85,198,20676
5283,2023-01-23,MAX,hotZone,Dueling Beetles,0,94,103,197,17502
5284,2023-01-23,MAX,heist,Snaked Assault,0,91,157,248,15762
5285,2023-01-23,MAX,gemGrab,Minecart Madness,0,184,242,426,19062
5286,2023-01-23,MAX,gemGrab,Double Swoosh,0,51,59,110,7578
5287,2023-01-23,MAX,brawlBall,Center Stage,24,860,957,1841,92862
5288,2023-01-23,MAX,brawlBall,Backyard Bowl,3,98,95,196,4224
5289,2023-01-23,MAX,bounty,Layer Cake,0,63,94,157,11142
5290,2023-01-22,MAX,knockout,X Marks the Spot,0,75,68,143,9174
5291,2023-01-22,MAX,hotZone,Ring of Fire,0,44,25,69,5730
5292,2023-01-22,MAX,heist,Snaked Assault,0,49,43,92,8232
5293,2023-01-22,MAX,gemGrab,Hard Rock Mine,0,44,59,103,4722
5294,2023-01-22,MAX,gemGrab,Double Swoosh,0,54,66,120,9426
5295,2023-01-22,MAX,brawlBall,Super Beach,2,126,168,296,7386
5296,2023-01-22,MAX,brawlBall,Backyard Bowl,28,671,695,1394,34788
5297,2023-01-22,MAX,bounty,Layer Cake,0,29,41,70,6654
5298,2023-01-21,MAX,knockout,X Marks the Spot,1,215,177,393,31698
5299,2023-01-21,MAX,hotZone,Ring of Fire,0,103,65,168,16632
5300,2023-01-21,MAX,heist,Tornado Ring,0,31,33,64,11664
5301,2023-01-21,MAX,gemGrab,Hard Rock Mine,0,240,254,494,22980
5302,2023-01-21,MAX,gemGrab,Deep Diner,0,31,49,80,4470
5303,2023-01-21,MAX,brawlBall,Super Beach,40,1255,1285,2580,101364
5304,2023-01-21,MAX,brawlBall,Sneaky Fields,1,41,52,94,3750
5305,2023-01-21,MAX,bounty,Dry Season,0,136,120,256,14538
5306,2023-01-20,MAX,knockout,Out in the Open,0,169,153,322,20106
5307,2023-01-20,MAX,hotZone,Split,0,21,10,31,9678
5308,2023-01-20,MAX,heist,Tornado Ring,0,45,30,75,12672
5309,2023-01-20,MAX,gemGrab,Undermine,0,51,51,102,5442
5310,2023-01-20,MAX,gemGrab,Deep Diner,0,180,136,316,19050
5311,2023-01-20,MAX,brawlBall,Sneaky Fields,7,651,754,1412,74778
5312,2023-01-20,MAX,brawlBall,Pinhole Punt,1,27,41,69,2886
5313,2023-01-20,MAX,bounty,Dry Season,0,113,106,219,11640
5314,2023-01-19,MAX,knockout,Out in the Open,1,192,111,304,26574
5315,2023-01-19,MAX,hotZone,Split,0,17,18,35,14856
5316,2023-01-19,MAX,heist,Kaboom Canyon,1,76,99,176,6732
5317,2023-01-19,MAX,gemGrab,Undermine,0,91,108,199,14154
5318,2023-01-19,MAX,gemGrab,Gem Fort,0,25,47,72,2934
5319,2023-01-19,MAX,brawlBall,Sunny Soccer,0,15,47,62,2274
5320,2023-01-19,MAX,brawlBall,Pinhole Punt,25,1128,1206,2359,72498
5321,2023-01-19,MAX,bounty,Shooting Star,0,157,186,343,11124
5322,2023-01-18,MAX,knockout,Goldarm Gulch,0,10,23,33,2784
5323,2023-01-18,MAX,hotZone,Parallel Plays,0,4,6,10,1158
5324,2023-01-18,MAX,heist,Kaboom Canyon,0,37,52,89,2592
5325,2023-01-18,MAX,gemGrab,Gem Fort,0,9,13,22,3006
5326,2023-01-18,MAX,gemGrab,Crystal Arcade,0,6,1,7,990
5327,2023-01-18,MAX,brawlBall,Sunny Soccer,3,193,219,415,18941
5328,2023-01-18,MAX,brawlBall,Beach Ball,0,11,18,29,774
5329,2023-01-18,MAX,bounty,Shooting Star,0,72,62,134,5088
5330,2023-01-17,MAX,knockout,Goldarm Gulch,0,9,5,14,2520
5331,2023-01-17,MAX,hotZone,Parallel Plays,0,1,2,3,1038
5332,2023-01-17,MAX,gemGrab,Minecart Madness,0,2,3,5,216
5333,2023-01-17,MAX,gemGrab,Crystal Arcade,0,13,8,21,1266
5334,2023-01-17,MAX,brawlBall,Center Stage,0,2,5,7,288
5335,2023-01-17,MAX,brawlBall,Beach Ball,2,42,64,108,5886
5336,2023-01-17,MAX,bounty,Hideout,0,12,12,24,750
5337,2023-01-16,MAX,knockout,Belle's Rock,0,15,8,23,1788
5338,2023-01-16,MAX,hotZone,Quarter Pounder,0,8,7,15,1494
5339,2023-01-16,MAX,heist,Pit Stop,0,14,7,21,4044
5340,2023-01-16,MAX,gemGrab,Minecart Madness,0,19,14,33,1422
5341,2023-01-16,MAX,gemGrab,Double Swoosh,0,8,3,11,708
5342,2023-01-16,MAX,brawlBall,Center Stage,1,41,66,108,5778
5343,2023-01-16,MAX,brawlBall,Backyard Bowl,0,21,8,29,852
5344,2023-01-16,MAX,bounty,Hideout,0,27,21,48,1470
5345,2023-01-15,MAX,knockout,Belle's Rock,0,29,21,50,2904
5346,2023-01-15,MAX,hotZone,Quarter Pounder,0,16,33,49,3318
5347,2023-01-15,MAX,heist,Bridge Too Far,0,50,52,102,2736
5348,2023-01-15,MAX,gemGrab,Hard Rock Mine,0,14,20,34,1014
5349,2023-01-15,MAX,gemGrab,Double Swoosh,0,16,29,45,2178
5350,2023-01-15,MAX,brawlBall,Super Beach,0,16,12,28,1074
5351,2023-01-15,MAX,brawlBall,Backyard Bowl,4,189,246,439,8946
5352,2023-01-15,MAX,bounty,Canal Grande,0,2,3,5,960
5353,2023-01-14,MAX,knockout,Flaring Phoenix,0,5,2,7,1080
5354,2023-01-14,MAX,hotZone,Controller Chaos,0,9,1,10,2772
5355,2023-01-14,MAX,heist,Bridge Too Far,0,91,52,143,4020
5356,2023-01-14,MAX,gemGrab,Hard Rock Mine,0,21,15,36,1272
5357,2023-01-14,MAX,gemGrab,Deep Diner,0,9,23,32,858
5358,2023-01-14,MAX,brawlBall,Super Beach,4,98,157,259,6336
5359,2023-01-14,MAX,brawlBall,Sneaky Fields,0,17,17,34,918
5360,2023-01-14,MAX,bounty,Canal Grande,0,0,2,2,1014
5361,2023-01-13,MAX,knockout,Flaring Phoenix,0,7,4,11,1182
5362,2023-01-13,MAX,hotZone,Controller Chaos,0,4,1,5,2928
5363,2023-01-13,MAX,heist,Hot Potato,0,1,2,3,600
5364,2023-01-13,MAX,gemGrab,Deep Diner,0,19,21,40,1650
5365,2023-01-13,MAX,brawlBall,Sneaky Fields,0,88,74,162,6144
5366,2023-01-13,MAX,brawlBall,Pinhole Punt,0,1,2,3,156
5367,2023-01-13,MAX,bounty,Temple Ruins,0,6,4,10,270
5368,2023-01-12,MAX,knockout,Riverside,0,18,17,35,2532
5369,2023-01-12,MAX,hotZone,Open Zone,0,24,13,37,1488
5370,2023-01-12,MAX,heist,Hot Potato,0,0,1,1,330
5371,2023-01-12,MAX,gemGrab,Undermine,0,4,2,6,690
5372,2023-01-12,MAX,gemGrab,Gem Fort,0,1,0,1,162
5373,2023-01-12,MAX,brawlBall,Sunny Soccer,0,1,1,2,240
5374,2023-01-12,MAX,brawlBall,Pinhole Punt,0,54,75,129,2292
5375,2023-01-12,MAX,bounty,Temple Ruins,0,1,0,1,24
5376,2023-01-11,MAX,knockout,Riverside,0,2,1,3,528
5377,2023-01-11,MAX,hotZone,Open Zone,0,8,1,9,462
5378,2023-01-11,MAX,gemGrab,Gem Fort,0,3,1,4,414
5379,2023-01-11,MAX,brawlBall,Sunny Soccer,2,27,31,60,1638
5380,2023-01-11,MAX,bounty,Excel,0,1,0,1,282
5381,2023-01-10,MAX,knockout,New Perspective,0,4,1,5,720
5382,2023-01-10,MAX,hotZone,Dueling Beetles,0,13,30,43,2424
5383,2023-01-10,MAX,heist,Safe Zone,0,9,11,20,1176
5384,2023-01-10,MAX,gemGrab,Minecart Madness,0,8,1,9,828
5385,2023-01-10,MAX,gemGrab,Crystal Arcade,0,23,27,50,1746
5386,2023-01-10,MAX,brawlBall,Center Stage,0,3,0,3,708
5387,2023-01-10,MAX,brawlBall,Beach Ball,4,51,60,115,4392
5388,2023-01-10,MAX,bounty,Excel,0,3,0,3,330
5389,2023-01-09,MAX,knockout,New Perspective,0,2,4,6,876
5390,2023-01-09,MAX,hotZone,Dueling Beetles,0,7,4,11,1554
5391,2023-01-09,MAX,heist,Snaked Assault,0,25,18,43,2022
5392,2023-01-09,MAX,gemGrab,Minecart Madness,0,21,14,35,1884
5393,2023-01-09,MAX,gemGrab,Double Swoosh,0,10,12,22,1320
5394,2023-01-09,MAX,brawlBall,Center Stage,0,55,63,118,5460
5395,2023-01-09,MAX,brawlBall,Backyard Bowl,2,11,12,25,474
5396,2023-01-09,MAX,bounty,Layer Cake,0,19,30,49,1512
5397,2023-01-08,MAX,knockout,X Marks the Spot,0,14,6,20,1692
5398,2023-01-08,MAX,hotZone,Ring of Fire,0,19,7,26,1644
5399,2023-01-08,MAX,heist,Snaked Assault,0,6,7,13,1494
5400,2023-01-08,MAX,gemGrab,Hard Rock Mine,0,8,7,15,630
5401,2023-01-08,MAX,gemGrab,Double Swoosh,0,8,9,17,864
5402,2023-01-08,MAX,brawlBall,Super Beach,0,14,26,40,732
5403,2023-01-08,MAX,brawlBall,Backyard Bowl,4,168,191,363,4830
5404,2023-01-08,MAX,bounty,Layer Cake,0,2,0,2,528
5405,2023-01-07,MAX,knockout,X Marks the Spot,0,9,8,17,1014
5406,2023-01-07,MAX,hotZone,Ring of Fire,0,3,3,6,846
5407,2023-01-07,MAX,heist,Tornado Ring,0,7,0,7,1350
5408,2023-01-07,MAX,gemGrab,Hard Rock Mine,0,14,11,25,1158
5409,2023-01-07,MAX,gemGrab,Deep Diner,0,13,14,27,918
5410,2023-01-07,MAX,brawlBall,Super Beach,2,52,93,147,2622
5411,2023-01-07,MAX,brawlBall,Sneaky Fields,0,4,4,8,402
5412,2023-01-07,MAX,bounty,Dry Season,0,17,18,35,1320
5413,2023-01-06,MAX,knockout,Out in the Open,0,13,7,20,1446
5414,2023-01-06,MAX,hotZone,Split,0,3,0,3,1158
5415,2023-01-06,MAX,heist,Tornado Ring,0,8,10,18,2538
5416,2023-01-06,MAX,gemGrab,Undermine,0,8,20,28,540
5417,2023-01-06,MAX,gemGrab,Deep Diner,0,16,32,48,2226
5418,2023-01-06,MAX,brawlBall,Sneaky Fields,0,54,101,155,4896
5419,2023-01-06,MAX,brawlBall,Pinhole Punt,0,9,14,23,510
5420,2023-01-06,MAX,bounty,Dry Season,0,43,42,85,1944
5421,2023-01-05,MAX,knockout,Out in the Open,0,34,38,72,2958
5422,2023-01-05,MAX,hotZone,Split,0,3,0,3,3552
5423,2023-01-05,MAX,heist,Kaboom Canyon,0,11,32,43,954
5424,2023-01-05,MAX,gemGrab,Undermine,0,19,34,53,1812
5425,2023-01-05,MAX,gemGrab,Gem Fort,0,4,0,4,252
5426,2023-01-05,MAX,brawlBall,Sunny Soccer,0,2,0,2,84
5427,2023-01-05,MAX,brawlBall,Pinhole Punt,5,151,129,285,8118
5428,2023-01-05,MAX,bounty,Shooting Star,0,27,22,49,1362
5429,2023-01-04,MAX,knockout,Goldarm Gulch,0,6,8,14,696
5430,2023-01-04,MAX,hotZone,Parallel Plays,0,7,1,8,864
5431,2023-01-04,MAX,heist,Kaboom Canyon,0,17,12,29,1848
5432,2023-01-04,MAX,gemGrab,Gem Fort,0,12,14,26,1788
5433,2023-01-04,MAX,gemGrab,Crystal Arcade,0,5,1,6,642
5434,2023-01-04,MAX,brawlBall,Sunny Soccer,2,91,67,160,6312
5435,2023-01-04,MAX,brawlBall,Beach Ball,0,1,3,4,54
5436,2023-01-04,MAX,bounty,Shooting Star,0,82,41,123,3570
5437,2023-01-03,MAX,knockout,Goldarm Gulch,0,3,2,5,720
5438,2023-01-03,MAX,hotZone,Parallel Plays,0,4,0,4,1542
5439,2023-01-03,MAX,heist,Pit Stop,0,1,1,2,1956
5440,2023-01-03,MAX,gemGrab,Minecart Madness,0,6,2,8,456
5441,2023-01-03,MAX,gemGrab,Crystal Arcade,0,17,22,39,2406
5442,2023-01-03,MAX,brawlBall,Center Stage,0,5,0,5,294
5443,2023-01-03,MAX,brawlBall,Beach Ball,0,76,89,165,5580
5444,2023-01-03,MAX,bounty,Hideout,0,37,59,96,1638
5445,2023-01-02,MAX,knockout,Belle's Rock,0,20,28,48,1794
5446,2023-01-02,MAX,hotZone,Quarter Pounder,0,29,58,87,2652
5447,2023-01-02,MAX,heist,Pit Stop,0,5,0,5,3498
5448,2023-01-02,MAX,heist,Kaboom Canyon,0,1,0,1,30
5449,2023-01-02,MAX,gemGrab,Minecart Madness,0,31,35,66,2352
5450,2023-01-02,MAX,gemGrab,Double Swoosh,0,10,14,24,1512
5451,2023-01-02,MAX,brawlBall,Center Stage,1,59,60,120,7110
5452,2023-01-02,MAX,brawlBall,Backyard Bowl,0,10,9,19,492
5453,2023-01-02,MAX,bounty,Hideout,0,62,52,114,3090
5454,2023-01-01,MAX,knockout,Belle's Rock,0,5,5,10,858
5455,2023-01-01,MAX,hotZone,Quarter Pounder,0,5,5,10,1188
5456,2023-01-01,MAX,heist,Bridge Too Far,0,7,10,17,462
5457,2023-01-01,MAX,gemGrab,Hard Rock Mine,0,4,3,7,48
5458,2023-01-01,MAX,gemGrab,Double Swoosh,0,18,3,21,1140
5459,2023-01-01,MAX,brawlBall,Backyard Bowl,0,86,88,174,2658
5460,2023-01-01,MAX,bounty,Canal Grande,0,1,3,4,132
5461,2022-12-31,MAX,heist,Kaboom Canyon,0,1,0,1,12
5462,2022-12-31,MAX,heist,Bridge Too Far,0,4,3,7,276
5463,2022-12-31,MAX,gemGrab,Hard Rock Mine,0,7,4,11,384
5464,2022-12-31,MAX,gemGrab,Deep Diner,0,1,0,1,306
5465,2022-12-31,MAX,brawlBall,Super Beach,0,10,22,32,618
5466,2022-12-31,MAX,brawlBall,Sneaky Fields,0,4,7,11,60
5467,2022-12-30,MAX,knockout,Flaring Phoenix,0,1,0,1,72
5468,2022-12-30,MAX,hotZone,Controller Chaos,0,6,4,10,288
5469,2022-12-30,MAX,gemGrab,Minecart Madness,0,1,0,1,24
5470,2022-12-30,MAX,gemGrab,Deep Diner,0,7,6,13,438
5471,2022-12-30,MAX,brawlBall,Sneaky Fields,0,5,4,9,552
5472,2022-12-29,MAX,heist,Kaboom Canyon,0,0,1,1,18
5473,2022-12-29,MAX,gemGrab,Undermine,0,2,0,2,102
5474,2022-12-29,MAX,gemGrab,Minecart Madness,0,1,0,1,24
5475,2022-12-29,MAX,brawlBall,Pinhole Punt,0,5,4,9,282
5476,2022-12-28,MAX,hotZone,Open Zone,0,1,1,2,108
5477,2022-12-28,MAX,brawlBall,Sunny Soccer,0,1,1,2,42
5478,2022-12-27,MAX,brawlBall,Center Stage,0,1,0,1,30
5479,2022-12-27,MAX,brawlBall,Beach Ball,0,4,1,5,144
5480,2022-12-26,MAX,hotZone,Controller Chaos,0,1,0,1,30
5481,2022-12-26,MAX,gemGrab,Minecart Madness,0,0,1,1,60
5482,2022-12-26,MAX,brawlBall,Center Stage,0,0,2,2,78
5483,2022-12-25,MAX,brawlBall,Backyard Bowl,0,1,1,2,78
5484,2022-12-24,MAX,brawlBall,Super Beach,0,2,0,2,48
5485,2022-12-23,MAX,knockout,Out in the Open,0,1,0,1,132
5486,2022-12-23,MAX,brawlBall,Sneaky Fields,0,1,0,1,12
5487,2022-12-22,MAX,gemGrab,Gem Fort,0,2,0,2,90
5488,2022-12-22,MAX,brawlBall,Pinhole Punt,0,2,1,3,132
5489,2022-12-20,MAX,brawlBall,Beach Ball,0,2,0,2,96
5490,2022-12-19,MAX,brawlBall,Center Stage,0,1,0,1,102
5491,2022-12-13,MAX,knockout,New Perspective,0,2,0,2,84
5492,2022-12-13,MAX,gemGrab,Crystal Arcade,0,1,0,1,72
5493,2022-12-13,MAX,brawlBall,Beach Ball,0,0,2,2,54
5494,2022-11-11,MAX,brawlBall,Sneaky Fields,0,0,1,1,42
5495,2022-11-03,MAX,brawlBall,Pinhole Punt,0,0,1,1,12
5496,2022-11-01,MAX,knockout,New Perspective,0,0,1,1,54
5497,2022-10-30,MAX,hotZone,Dueling Beetles,0,1,0,1,12
5498,2022-10-15,MAX,gemGrab,Hard Rock Mine,0,1,0,1,90
5499,2022-10-15,MAX,bounty,Dry Season,0,1,0,1,6
5500,2023-01-28,MANDY,knockout,Flaring Phoenix,1,369,510,880,12366
5501,2023-01-28,MANDY,hotZone,Controller Chaos,0,38,48,86,10134
5502,2023-01-28,MANDY,heist,Bridge Too Far,3,588,614,1205,24240
5503,2023-01-28,MANDY,gemGrab,Hard Rock Mine,0,131,142,273,16638
5504,2023-01-28,MANDY,gemGrab,Deep Diner,0,42,56,98,5478
5505,2023-01-28,MANDY,brawlBall,Super Beach,19,549,799,1367,74430
5506,2023-01-28,MANDY,brawlBall,Sneaky Fields,0,24,35,59,3582
5507,2023-01-28,MANDY,bounty,Canal Grande,0,134,214,348,10902
5508,2023-01-27,MANDY,knockout,Flaring Phoenix,0,171,231,402,5928
5509,2023-01-27,MANDY,hotZone,Controller Chaos,0,18,10,28,2676
5510,2023-01-27,MANDY,heist,Hot Potato,0,16,21,37,3486
5511,2023-01-27,MANDY,gemGrab,Undermine,0,7,7,14,942
5512,2023-01-27,MANDY,gemGrab,Deep Diner,0,68,123,191,6846
5513,2023-01-27,MANDY,brawlBall,Sneaky Fields,5,118,187,310,23514
5514,2023-01-27,MANDY,brawlBall,Pinhole Punt,0,4,3,7,738
5515,2023-01-27,MANDY,bounty,Temple Ruins,0,29,52,81,1890
5516,2023-01-26,MANDY,knockout,Riverside,1,670,1034,1705,19008
5517,2023-01-26,MANDY,hotZone,Open Zone,0,99,155,254,10182
5518,2023-01-26,MANDY,heist,Hot Potato,0,54,67,121,14610
5519,2023-01-26,MANDY,gemGrab,Undermine,0,76,142,218,10062
5520,2023-01-26,MANDY,gemGrab,Gem Fort,0,33,37,70,4674
5521,2023-01-26,MANDY,brawlBall,Sunny Soccer,0,4,12,16,3660
5522,2023-01-26,MANDY,brawlBall,Pinhole Punt,32,644,1081,1757,67338
5523,2023-01-26,MANDY,bounty,Temple Ruins,0,75,125,200,5610
5524,2023-01-25,MANDY,knockout,Riverside,0,414,607,1021,9906
5525,2023-01-25,MANDY,hotZone,Open Zone,0,42,60,102,5262
5526,2023-01-25,MANDY,heist,Safe Zone,1,119,133,253,9156
5527,2023-01-25,MANDY,gemGrab,Gem Fort,0,63,65,128,5556
5528,2023-01-25,MANDY,gemGrab,Crystal Arcade,0,59,94,153,7866
5529,2023-01-25,MANDY,brawlBall,Sunny Soccer,19,341,521,881,40830
5530,2023-01-25,MANDY,brawlBall,Beach Ball,2,34,43,79,6408
5531,2023-01-25,MANDY,bounty,Excel,0,82,116,198,5790
5532,2023-01-24,MANDY,knockout,New Perspective,0,271,457,728,10542
5533,2023-01-24,MANDY,hotZone,Dueling Beetles,0,43,46,89,10662
5534,2023-01-24,MANDY,heist,Safe Zone,4,250,238,492,15750
5535,2023-01-24,MANDY,gemGrab,Minecart Madness,0,87,109,196,4002
5536,2023-01-24,MANDY,gemGrab,Crystal Arcade,0,184,260,444,14460
5537,2023-01-24,MANDY,brawlBall,Center Stage,1,28,72,101,7860
5538,2023-01-24,MANDY,brawlBall,Beach Ball,28,482,796,1306,64614
5539,2023-01-24,MANDY,bounty,Excel,0,141,234,375,10896
5540,2023-01-23,MANDY,knockout,New Perspective,2,527,720,1249,20676
5541,2023-01-23,MANDY,hotZone,Dueling Beetles,0,79,111,190,17502
5542,2023-01-23,MANDY,heist,Snaked Assault,1,43,50,94,15762
5543,2023-01-23,MANDY,gemGrab,Minecart Madness,0,318,452,770,19062
5544,2023-01-23,MANDY,gemGrab,Double Swoosh,0,49,90,139,7578
5545,2023-01-23,MANDY,brawlBall,Center Stage,26,678,987,1691,92862
5546,2023-01-23,MANDY,brawlBall,Backyard Bowl,4,66,86,156,4224
5547,2023-01-23,MANDY,bounty,Layer Cake,0,151,213,364,11142
5548,2023-01-22,MANDY,knockout,X Marks the Spot,1,294,397,692,9174
5549,2023-01-22,MANDY,hotZone,Ring of Fire,2,28,40,70,5730
5550,2023-01-22,MANDY,heist,Snaked Assault,0,22,32,54,8232
5551,2023-01-22,MANDY,gemGrab,Hard Rock Mine,0,64,106,170,4722
5552,2023-01-22,MANDY,gemGrab,Double Swoosh,0,86,122,208,9426
5553,2023-01-22,MANDY,brawlBall,Super Beach,0,50,64,114,7386
5554,2023-01-22,MANDY,brawlBall,Backyard Bowl,31,598,890,1519,34788
5555,2023-01-22,MANDY,bounty,Layer Cake,0,84,136,220,6654
5556,2023-01-21,MANDY,knockout,X Marks the Spot,5,903,1276,2184,31698
5557,2023-01-21,MANDY,hotZone,Ring of Fire,0,103,97,200,16632
5558,2023-01-21,MANDY,heist,Tornado Ring,1,34,38,73,11664
5559,2023-01-21,MANDY,gemGrab,Hard Rock Mine,0,205,310,515,22980
5560,2023-01-21,MANDY,gemGrab,Deep Diner,0,68,80,148,4470
5561,2023-01-21,MANDY,brawlBall,Super Beach,21,713,1272,2006,101364
5562,2023-01-21,MANDY,brawlBall,Sneaky Fields,0,15,29,44,3750
5563,2023-01-21,MANDY,bounty,Dry Season,0,385,605,990,14538
5564,2023-01-20,MANDY,knockout,Out in the Open,1,669,919,1589,20106
5565,2023-01-20,MANDY,hotZone,Split,0,26,39,65,9678
5566,2023-01-20,MANDY,heist,Tornado Ring,0,53,51,104,12672
5567,2023-01-20,MANDY,gemGrab,Undermine,0,62,103,165,5442
5568,2023-01-20,MANDY,gemGrab,Deep Diner,0,225,372,597,19050
5569,2023-01-20,MANDY,brawlBall,Sneaky Fields,13,469,693,1175,74778
5570,2023-01-20,MANDY,brawlBall,Pinhole Punt,1,29,26,56,2886
5571,2023-01-20,MANDY,bounty,Dry Season,0,436,677,1113,11640
5572,2023-01-19,MANDY,knockout,Out in the Open,5,686,1017,1708,26574
5573,2023-01-19,MANDY,hotZone,Split,0,37,57,94,14856
5574,2023-01-19,MANDY,heist,Kaboom Canyon,0,71,128,199,6732
5575,2023-01-19,MANDY,gemGrab,Undermine,0,133,200,333,14154
5576,2023-01-19,MANDY,gemGrab,Gem Fort,0,13,30,43,2934
5577,2023-01-19,MANDY,brawlBall,Sunny Soccer,0,16,41,57,2274
5578,2023-01-19,MANDY,brawlBall,Pinhole Punt,24,758,1082,1864,72498
5579,2023-01-19,MANDY,bounty,Shooting Star,0,305,528,833,11124
5580,2023-01-18,MANDY,knockout,Goldarm Gulch,0,71,136,207,2784
5581,2023-01-18,MANDY,hotZone,Parallel Plays,0,6,5,11,1158
5582,2023-01-18,MANDY,heist,Kaboom Canyon,0,35,67,102,2592
5583,2023-01-18,MANDY,gemGrab,Gem Fort,0,44,48,92,3006
5584,2023-01-18,MANDY,gemGrab,Crystal Arcade,0,7,3,10,990
5585,2023-01-18,MANDY,brawlBall,Sunny Soccer,6,221,338,565,18941
5586,2023-01-18,MANDY,brawlBall,Beach Ball,1,12,10,23,774
5587,2023-01-18,MANDY,bounty,Shooting Star,0,223,320,543,5088
5588,2023-01-17,MANDY,knockout,Goldarm Gulch,0,60,84,144,2520
5589,2023-01-17,MANDY,hotZone,Parallel Plays,0,12,6,18,1038
5590,2023-01-17,MANDY,heist,Pit Stop,0,2,4,6,1290
5591,2023-01-17,MANDY,gemGrab,Minecart Madness,0,6,6,12,216
5592,2023-01-17,MANDY,gemGrab,Crystal Arcade,0,10,16,26,1266
5593,2023-01-17,MANDY,brawlBall,Center Stage,0,1,0,1,288
5594,2023-01-17,MANDY,brawlBall,Beach Ball,2,41,104,147,5886
5595,2023-01-17,MANDY,bounty,Hideout,0,17,14,31,750
5596,2023-01-16,MANDY,knockout,Belle's Rock,0,38,65,103,1788
5597,2023-01-16,MANDY,hotZone,Quarter Pounder,0,9,8,17,1494
5598,2023-01-16,MANDY,heist,Pit Stop,0,2,0,2,4044
5599,2023-01-16,MANDY,gemGrab,Minecart Madness,0,20,39,59,1422
5600,2023-01-16,MANDY,gemGrab,Double Swoosh,0,1,0,1,708
5601,2023-01-16,MANDY,brawlBall,Center Stage,1,52,55,108,5778
5602,2023-01-16,MANDY,brawlBall,Backyard Bowl,1,9,50,60,852
5603,2023-01-16,MANDY,bounty,Hideout,0,38,112,150,1470
5604,2023-01-15,MANDY,knockout,Belle's Rock,0,71,127,198,2904
5605,2023-01-15,MANDY,hotZone,Quarter Pounder,0,18,21,39,3318
5606,2023-01-15,MANDY,heist,Bridge Too Far,0,54,68,122,2736
5607,2023-01-15,MANDY,gemGrab,Hard Rock Mine,0,7,26,33,1014
5608,2023-01-15,MANDY,gemGrab,Double Swoosh,0,11,13,24,2178
5609,2023-01-15,MANDY,brawlBall,Super Beach,0,5,4,9,1074
5610,2023-01-15,MANDY,brawlBall,Backyard Bowl,10,104,224,338,8946
5611,2023-01-15,MANDY,bounty,Canal Grande,0,5,31,36,960
5612,2023-01-14,MANDY,knockout,Flaring Phoenix,0,20,39,59,1080
5613,2023-01-14,MANDY,hotZone,Controller Chaos,0,16,18,34,2772
5614,2023-01-14,MANDY,heist,Bridge Too Far,0,76,150,226,4020
5615,2023-01-14,MANDY,gemGrab,Hard Rock Mine,0,5,12,17,1272
5616,2023-01-14,MANDY,gemGrab,Deep Diner,0,13,24,37,858
5617,2023-01-14,MANDY,brawlBall,Super Beach,2,63,201,266,6336
5618,2023-01-14,MANDY,brawlBall,Sneaky Fields,0,3,1,4,918
5619,2023-01-14,MANDY,bounty,Canal Grande,0,3,6,9,1014
5620,2023-01-13,MANDY,knockout,Flaring Phoenix,0,31,87,118,1182
5621,2023-01-13,MANDY,hotZone,Controller Chaos,0,1,1,2,2928
5622,2023-01-13,MANDY,gemGrab,Undermine,0,1,1,2,18
5623,2023-01-13,MANDY,gemGrab,Deep Diner,0,12,15,27,1650
5624,2023-01-13,MANDY,brawlBall,Sneaky Fields,1,39,95,135,6144
5625,2023-01-13,MANDY,bounty,Temple Ruins,0,1,2,3,270
5626,2023-01-12,MANDY,knockout,Riverside,0,44,103,147,2532
5627,2023-01-12,MANDY,hotZone,Open Zone,0,11,25,36,1488
5628,2023-01-12,MANDY,gemGrab,Undermine,0,8,2,10,690
5629,2023-01-12,MANDY,brawlBall,Sunny Soccer,0,3,11,14,240
5630,2023-01-12,MANDY,brawlBall,Pinhole Punt,0,7,4,11,2292
5631,2023-01-11,MANDY,knockout,Riverside,0,8,7,15,528
5632,2023-01-11,MANDY,hotZone,Open Zone,0,0,1,1,462
5633,2023-01-11,MANDY,gemGrab,Gem Fort,0,2,7,9,414
5634,2023-01-11,MANDY,brawlBall,Sunny Soccer,0,4,10,14,1638
5635,2023-01-10,MANDY,knockout,New Perspective,0,3,9,12,720
5636,2023-01-10,MANDY,hotZone,Dueling Beetles,0,8,17,25,2424
5637,2023-01-10,MANDY,heist,Safe Zone,0,1,0,1,1176
5638,2023-01-10,MANDY,gemGrab,Minecart Madness,0,5,30,35,828
5639,2023-01-10,MANDY,gemGrab,Crystal Arcade,0,12,28,40,1746
5640,2023-01-10,MANDY,brawlBall,Beach Ball,1,26,48,75,4392
5641,2023-01-09,MANDY,knockout,New Perspective,0,4,9,13,876
5642,2023-01-09,MANDY,hotZone,Dueling Beetles,0,9,20,29,1554
5643,2023-01-09,MANDY,gemGrab,Minecart Madness,0,8,25,33,1884
5644,2023-01-09,MANDY,gemGrab,Double Swoosh,0,3,7,10,1320
5645,2023-01-09,MANDY,brawlBall,Center Stage,0,9,24,33,5460
5646,2023-01-09,MANDY,brawlBall,Backyard Bowl,0,2,1,3,474
5647,2023-01-09,MANDY,bounty,Layer Cake,0,4,6,10,1512
5648,2023-01-08,MANDY,knockout,X Marks the Spot,0,8,3,11,1692
5649,2023-01-08,MANDY,hotZone,Ring of Fire,0,0,9,9,1644
5650,2023-01-08,MANDY,heist,Snaked Assault,0,5,17,22,1494
5651,2023-01-08,MANDY,gemGrab,Hard Rock Mine,0,0,2,2,630
5652,2023-01-08,MANDY,brawlBall,Super Beach,0,3,0,3,732
5653,2023-01-08,MANDY,brawlBall,Backyard Bowl,0,7,10,17,4830
5654,2023-01-08,MANDY,bounty,Layer Cake,0,0,1,1,528
5655,2023-01-07,MANDY,knockout,X Marks the Spot,0,4,10,14,1014
5656,2023-01-07,MANDY,heist,Tornado Ring,0,1,0,1,1350
5657,2023-01-07,MANDY,brawlBall,Super Beach,0,3,8,11,2622
5658,2023-01-07,MANDY,bounty,Dry Season,0,8,26,34,1320
5659,2023-01-06,MANDY,knockout,Out in the Open,0,3,16,19,1446
5660,2023-01-06,MANDY,heist,Tornado Ring,1,4,11,16,2538
5661,2023-01-06,MANDY,gemGrab,Deep Diner,0,1,2,3,2226
5662,2023-01-06,MANDY,brawlBall,Sneaky Fields,1,28,52,81,4896
5663,2023-01-06,MANDY,brawlBall,Pinhole Punt,0,2,5,7,510
5664,2023-01-06,MANDY,bounty,Dry Season,0,24,51,75,1944
5665,2023-01-05,MANDY,knockout,Out in the Open,0,47,88,135,2958
5666,2023-01-05,MANDY,heist,Kaboom Canyon,0,2,2,4,954
5667,2023-01-05,MANDY,brawlBall,Pinhole Punt,2,51,129,182,8118
5668,2023-01-05,MANDY,bounty,Shooting Star,0,13,14,27,1362
5669,2023-01-04,MANDY,knockout,Goldarm Gulch,0,6,31,37,696
5670,2023-01-04,MANDY,hotZone,Parallel Plays,0,2,20,22,864
5671,2023-01-04,MANDY,heist,Kaboom Canyon,0,1,17,18,1848
5672,2023-01-04,MANDY,gemGrab,Gem Fort,0,2,1,3,1788
5673,2023-01-04,MANDY,gemGrab,Crystal Arcade,0,0,2,2,642
5674,2023-01-04,MANDY,brawlBall,Sunny Soccer,2,36,99,137,6312
5675,2023-01-04,MANDY,bounty,Shooting Star,0,29,91,120,3570
5676,2023-01-03,MANDY,knockout,Goldarm Gulch,0,11,22,33,720
5677,2023-01-03,MANDY,hotZone,Parallel Plays,0,3,14,17,1542
5678,2023-01-03,MANDY,heist,Pit Stop,0,2,0,2,1956
5679,2023-01-03,MANDY,gemGrab,Minecart Madness,0,11,34,45,456
5680,2023-01-03,MANDY,gemGrab,Crystal Arcade,0,11,45,56,2406
5681,2023-01-03,MANDY,brawlBall,Center Stage,1,4,21,26,294
5682,2023-01-03,MANDY,brawlBall,Beach Ball,3,48,153,204,5580
5683,2023-01-03,MANDY,bounty,Hideout,0,17,70,87,1638
5684,2023-01-02,MANDY,knockout,Belle's Rock,0,2,29,31,1794
5685,2023-01-02,MANDY,hotZone,Quarter Pounder,0,0,1,1,2652
5686,2023-01-02,MANDY,heist,Pit Stop,0,1,0,1,3498
5687,2023-01-02,MANDY,gemGrab,Minecart Madness,0,41,137,178,2352
5688,2023-01-02,MANDY,brawlBall,Center Stage,3,90,290,383,7110
5689,2023-01-02,MANDY,bounty,Hideout,0,49,152,201,3090
5690,2023-01-28,LOU,knockout,Flaring Phoenix,0,14,6,20,12366
5691,2023-01-28,LOU,hotZone,Controller Chaos,0,115,160,275,10134
5692,2023-01-28,LOU,heist,Bridge Too Far,0,22,34,56,24240
5693,2023-01-28,LOU,gemGrab,Hard Rock Mine,0,43,34,77,16638
5694,2023-01-28,LOU,gemGrab,Deep Diner,0,16,19,35,5478
5695,2023-01-28,LOU,brawlBall,Super Beach,10,256,307,573,74430
5696,2023-01-28,LOU,brawlBall,Sneaky Fields,0,12,28,40,3582
5697,2023-01-28,LOU,bounty,Canal Grande,0,12,13,25,10902
5698,2023-01-27,LOU,knockout,Flaring Phoenix,0,4,3,7,5928
5699,2023-01-27,LOU,hotZone,Controller Chaos,0,24,22,46,2676
5700,2023-01-27,LOU,heist,Hot Potato,0,3,1,4,3486
5701,2023-01-27,LOU,gemGrab,Undermine,0,4,4,8,942
5702,2023-01-27,LOU,gemGrab,Deep Diner,0,24,28,52,6846
5703,2023-01-27,LOU,brawlBall,Sneaky Fields,3,80,115,198,23514
5704,2023-01-27,LOU,brawlBall,Pinhole Punt,0,3,0,3,738
5705,2023-01-27,LOU,bounty,Temple Ruins,0,6,9,15,1890
5706,2023-01-26,LOU,knockout,Riverside,0,22,10,32,19008
5707,2023-01-26,LOU,hotZone,Open Zone,0,99,114,213,10182
5708,2023-01-26,LOU,heist,Hot Potato,0,6,3,9,14610
5709,2023-01-26,LOU,gemGrab,Undermine,0,18,26,44,10062
5710,2023-01-26,LOU,gemGrab,Gem Fort,0,8,10,18,4674
5711,2023-01-26,LOU,brawlBall,Sunny Soccer,1,13,11,25,3660
5712,2023-01-26,LOU,brawlBall,Pinhole Punt,10,266,357,633,67338
5713,2023-01-26,LOU,bounty,Temple Ruins,0,10,2,12,5610
5714,2023-01-25,LOU,knockout,Riverside,0,7,3,10,9906
5715,2023-01-25,LOU,hotZone,Open Zone,0,55,80,135,5262
5716,2023-01-25,LOU,heist,Safe Zone,0,7,1,8,9156
5717,2023-01-25,LOU,gemGrab,Gem Fort,0,11,11,22,5556
5718,2023-01-25,LOU,gemGrab,Crystal Arcade,0,13,10,23,7866
5719,2023-01-25,LOU,brawlBall,Sunny Soccer,7,153,206,366,40830
5720,2023-01-25,LOU,brawlBall,Beach Ball,0,24,37,61,6408
5721,2023-01-25,LOU,bounty,Excel,0,6,11,17,5790
5722,2023-01-24,LOU,knockout,New Perspective,0,8,4,12,10542
5723,2023-01-24,LOU,hotZone,Dueling Beetles,0,263,536,799,10662
5724,2023-01-24,LOU,heist,Safe Zone,0,17,5,22,15750
5725,2023-01-24,LOU,gemGrab,Minecart Madness,0,16,6,22,4002
5726,2023-01-24,LOU,gemGrab,Crystal Arcade,0,35,35,70,14460
5727,2023-01-24,LOU,brawlBall,Center Stage,1,11,13,25,7860
5728,2023-01-24,LOU,brawlBall,Beach Ball,6,221,275,502,64614
5729,2023-01-24,LOU,bounty,Excel,0,8,2,10,10896
5730,2023-01-23,LOU,knockout,New Perspective,0,20,18,38,20676
5731,2023-01-23,LOU,hotZone,Dueling Beetles,1,557,923,1481,17502
5732,2023-01-23,LOU,heist,Snaked Assault,0,4,4,8,15762
5733,2023-01-23,LOU,gemGrab,Minecart Madness,0,66,100,166,19062
5734,2023-01-23,LOU,gemGrab,Double Swoosh,0,15,4,19,7578
5735,2023-01-23,LOU,brawlBall,Center Stage,19,243,417,679,92862
5736,2023-01-23,LOU,brawlBall,Backyard Bowl,0,4,19,23,4224
5737,2023-01-23,LOU,bounty,Layer Cake,0,4,4,8,11142
5738,2023-01-22,LOU,knockout,X Marks the Spot,0,6,2,8,9174
5739,2023-01-22,LOU,hotZone,Ring of Fire,0,132,246,378,5730
5740,2023-01-22,LOU,heist,Snaked Assault,0,4,1,5,8232
5741,2023-01-22,LOU,gemGrab,Hard Rock Mine,0,2,5,7,4722
5742,2023-01-22,LOU,gemGrab,Double Swoosh,0,13,17,30,9426
5743,2023-01-22,LOU,brawlBall,Super Beach,0,25,62,87,7386
5744,2023-01-22,LOU,brawlBall,Backyard Bowl,6,87,105,198,34788
5745,2023-01-22,LOU,bounty,Layer Cake,0,3,8,11,6654
5746,2023-01-21,LOU,knockout,X Marks the Spot,0,25,25,50,31698
5747,2023-01-21,LOU,hotZone,Ring of Fire,4,469,645,1118,16632
5748,2023-01-21,LOU,heist,Tornado Ring,0,4,2,6,11664
5749,2023-01-21,LOU,gemGrab,Hard Rock Mine,0,21,23,44,22980
5750,2023-01-21,LOU,gemGrab,Deep Diner,0,14,5,19,4470
5751,2023-01-21,LOU,brawlBall,Super Beach,17,339,578,934,101364
5752,2023-01-21,LOU,brawlBall,Sneaky Fields,0,8,9,17,3750
5753,2023-01-21,LOU,bounty,Dry Season,0,10,7,17,14538
5754,2023-01-20,LOU,knockout,Out in the Open,1,23,10,34,20106
5755,2023-01-20,LOU,hotZone,Split,0,25,19,44,9678
5756,2023-01-20,LOU,heist,Tornado Ring,1,10,9,20,12672
5757,2023-01-20,LOU,gemGrab,Undermine,0,8,11,19,5442
5758,2023-01-20,LOU,gemGrab,Deep Diner,0,56,47,103,19050
5759,2023-01-20,LOU,brawlBall,Sneaky Fields,13,243,272,528,74778
5760,2023-01-20,LOU,brawlBall,Pinhole Punt,0,9,19,28,2886
5761,2023-01-20,LOU,bounty,Dry Season,0,5,7,12,11640
5762,2023-01-19,LOU,knockout,Out in the Open,0,24,19,43,26574
5763,2023-01-19,LOU,hotZone,Split,0,35,34,69,14856
5764,2023-01-19,LOU,heist,Kaboom Canyon,1,9,5,15,6732
5765,2023-01-19,LOU,gemGrab,Undermine,0,22,25,47,14154
5766,2023-01-19,LOU,gemGrab,Gem Fort,0,5,2,7,2934
5767,2023-01-19,LOU,brawlBall,Sunny Soccer,0,7,4,11,2274
5768,2023-01-19,LOU,brawlBall,Pinhole Punt,6,209,248,463,72498
5769,2023-01-19,LOU,bounty,Shooting Star,0,6,9,15,11124
5770,2023-01-18,LOU,knockout,Goldarm Gulch,0,2,1,3,2784
5771,2023-01-18,LOU,hotZone,Parallel Plays,0,6,10,16,1158
5772,2023-01-18,LOU,heist,Kaboom Canyon,0,3,7,10,2592
5773,2023-01-18,LOU,gemGrab,Gem Fort,0,9,3,12,3006
5774,2023-01-18,LOU,gemGrab,Crystal Arcade,0,0,4,4,990
5775,2023-01-18,LOU,brawlBall,Sunny Soccer,1,56,49,106,18941
5776,2023-01-18,LOU,bounty,Shooting Star,0,2,2,4,5088
5777,2023-01-17,LOU,knockout,Goldarm Gulch,0,3,2,5,2520
5778,2023-01-17,LOU,hotZone,Parallel Plays,0,4,4,8,1038
5779,2023-01-17,LOU,gemGrab,Minecart Madness,0,1,2,3,216
5780,2023-01-17,LOU,gemGrab,Crystal Arcade,0,3,0,3,1266
5781,2023-01-17,LOU,brawlBall,Beach Ball,1,11,20,32,5886
5782,2023-01-17,LOU,bounty,Hideout,0,0,2,2,750
5783,2023-01-16,LOU,knockout,Belle's Rock,0,1,0,1,1788
5784,2023-01-16,LOU,hotZone,Quarter Pounder,0,4,2,6,1494
5785,2023-01-16,LOU,heist,Pit Stop,0,4,1,5,4044
5786,2023-01-16,LOU,gemGrab,Minecart Madness,0,6,9,15,1422
5787,2023-01-16,LOU,brawlBall,Center Stage,0,8,17,25,5778
5788,2023-01-16,LOU,brawlBall,Backyard Bowl,0,3,0,3,852
5789,2023-01-15,LOU,knockout,Belle's Rock,0,0,1,1,2904
5790,2023-01-15,LOU,hotZone,Quarter Pounder,0,13,17,30,3318
5791,2023-01-15,LOU,heist,Bridge Too Far,0,1,5,6,2736
5792,2023-01-15,LOU,gemGrab,Double Swoosh,0,5,6,11,2178
5793,2023-01-15,LOU,brawlBall,Super Beach,1,9,9,19,1074
5794,2023-01-15,LOU,brawlBall,Backyard Bowl,0,17,34,51,8946
5795,2023-01-15,LOU,bounty,Canal Grande,0,1,1,2,960
5796,2023-01-14,LOU,knockout,Flaring Phoenix,0,1,0,1,1080
5797,2023-01-14,LOU,hotZone,Controller Chaos,0,19,77,96,2772
5798,2023-01-14,LOU,heist,Bridge Too Far,0,3,0,3,4020
5799,2023-01-14,LOU,gemGrab,Hard Rock Mine,0,1,1,2,1272
5800,2023-01-14,LOU,gemGrab,Deep Diner,0,1,0,1,858
5801,2023-01-14,LOU,brawlBall,Super Beach,0,31,23,54,6336
5802,2023-01-14,LOU,brawlBall,Sneaky Fields,0,5,4,9,918
5803,2023-01-13,LOU,knockout,Flaring Phoenix,0,1,2,3,1182
5804,2023-01-13,LOU,hotZone,Controller Chaos,0,47,70,117,2928
5805,2023-01-13,LOU,gemGrab,Deep Diner,0,4,10,14,1650
5806,2023-01-13,LOU,brawlBall,Sneaky Fields,1,15,40,56,6144
5807,2023-01-13,LOU,brawlBall,Pinhole Punt,0,2,1,3,156
5808,2023-01-12,LOU,knockout,Riverside,0,1,0,1,2532
5809,2023-01-12,LOU,hotZone,Open Zone,0,7,15,22,1488
5810,2023-01-12,LOU,heist,Hot Potato,0,1,0,1,330
5811,2023-01-12,LOU,gemGrab,Undermine,0,1,0,1,690
5812,2023-01-12,LOU,brawlBall,Sunny Soccer,0,2,2,4,240
5813,2023-01-12,LOU,brawlBall,Pinhole Punt,0,5,2,7,2292
5814,2023-01-11,LOU,knockout,Riverside,0,1,0,1,528
5815,2023-01-11,LOU,hotZone,Open Zone,0,4,3,7,462
5816,2023-01-11,LOU,gemGrab,Gem Fort,0,1,0,1,414
5817,2023-01-11,LOU,brawlBall,Sunny Soccer,0,7,20,27,1638
5818,2023-01-11,LOU,bounty,Excel,0,1,0,1,282
5819,2023-01-10,LOU,knockout,New Perspective,0,0,1,1,720
5820,2023-01-10,LOU,hotZone,Dueling Beetles,0,55,80,135,2424
5821,2023-01-10,LOU,heist,Safe Zone,0,1,0,1,1176
5822,2023-01-10,LOU,gemGrab,Minecart Madness,0,2,0,2,828
5823,2023-01-10,LOU,gemGrab,Crystal Arcade,0,2,0,2,1746
5824,2023-01-10,LOU,brawlBall,Center Stage,0,1,0,1,708
5825,2023-01-10,LOU,brawlBall,Beach Ball,0,7,9,16,4392
5826,2023-01-09,LOU,hotZone,Dueling Beetles,0,38,73,111,1554
5827,2023-01-09,LOU,gemGrab,Minecart Madness,0,4,1,5,1884
5828,2023-01-09,LOU,gemGrab,Double Swoosh,0,2,2,4,1320
5829,2023-01-09,LOU,brawlBall,Center Stage,0,10,19,29,5460
5830,2023-01-09,LOU,bounty,Layer Cake,0,1,0,1,1512
5831,2023-01-08,LOU,knockout,X Marks the Spot,0,1,0,1,1692
5832,2023-01-08,LOU,hotZone,Ring of Fire,0,26,24,50,1644
5833,2023-01-08,LOU,heist,Snaked Assault,0,2,0,2,1494
5834,2023-01-08,LOU,gemGrab,Double Swoosh,0,1,0,1,864
5835,2023-01-08,LOU,brawlBall,Backyard Bowl,0,10,10,20,4830
5836,2023-01-07,LOU,knockout,X Marks the Spot,0,1,0,1,1014
5837,2023-01-07,LOU,hotZone,Ring of Fire,0,14,14,28,846
5838,2023-01-07,LOU,heist,Tornado Ring,0,1,3,4,1350
5839,2023-01-07,LOU,gemGrab,Deep Diner,0,0,1,1,918
5840,2023-01-07,LOU,brawlBall,Super Beach,0,7,13,20,2622
5841,2023-01-06,LOU,gemGrab,Undermine,0,1,0,1,540
5842,2023-01-06,LOU,gemGrab,Deep Diner,0,2,0,2,2226
5843,2023-01-06,LOU,brawlBall,Sneaky Fields,1,21,16,38,4896
5844,2023-01-06,LOU,brawlBall,Pinhole Punt,0,1,0,1,510
5845,2023-01-05,LOU,knockout,Out in the Open,0,3,1,4,2958
5846,2023-01-05,LOU,hotZone,Split,0,7,8,15,3552
5847,2023-01-05,LOU,brawlBall,Pinhole Punt,2,31,73,106,8118
5848,2023-01-04,LOU,hotZone,Parallel Plays,0,3,2,5,864
5849,2023-01-04,LOU,heist,Kaboom Canyon,0,0,2,2,1848
5850,2023-01-04,LOU,gemGrab,Gem Fort,0,4,3,7,1788
5851,2023-01-04,LOU,gemGrab,Crystal Arcade,0,0,1,1,642
5852,2023-01-04,LOU,brawlBall,Sunny Soccer,0,27,24,51,6312
5853,2023-01-03,LOU,hotZone,Parallel Plays,0,3,0,3,1542
5854,2023-01-03,LOU,hotZone,Controller Chaos,0,1,0,1,12
5855,2023-01-03,LOU,gemGrab,Minecart Madness,0,4,6,10,456
5856,2023-01-03,LOU,gemGrab,Crystal Arcade,0,0,2,2,2406
5857,2023-01-03,LOU,brawlBall,Beach Ball,0,16,25,41,5580
5858,2023-01-02,LOU,knockout,Belle's Rock,0,3,0,3,1794
5859,2023-01-02,LOU,hotZone,Quarter Pounder,0,24,20,44,2652
5860,2023-01-02,LOU,heist,Pit Stop,0,0,1,1,3498
5861,2023-01-02,LOU,gemGrab,Minecart Madness,0,1,3,4,2352
5862,2023-01-02,LOU,gemGrab,Double Swoosh,0,1,3,4,1512
5863,2023-01-02,LOU,brawlBall,Center Stage,0,16,26,42,7110
5864,2023-01-02,LOU,brawlBall,Backyard Bowl,0,1,1,2,492
5865,2023-01-01,LOU,hotZone,Quarter Pounder,0,4,3,7,1188
5866,2023-01-01,LOU,gemGrab,Double Swoosh,0,3,0,3,1140
5867,2023-01-01,LOU,brawlBall,Backyard Bowl,0,7,9,16,2658
5868,2022-12-31,LOU,hotZone,Controller Chaos,0,7,15,22,198
5869,2022-12-31,LOU,gemGrab,Minecart Madness,0,1,1,2,24
5870,2022-12-31,LOU,gemGrab,Deep Diner,0,1,0,1,306
5871,2022-12-31,LOU,brawlBall,Super Beach,0,0,1,1,618
5872,2022-12-31,LOU,brawlBall,Sneaky Fields,0,1,0,1,60
5873,2022-12-30,LOU,hotZone,Controller Chaos,0,7,16,23,288
5874,2022-12-30,LOU,brawlBall,Sneaky Fields,1,3,2,6,552
5875,2022-12-29,LOU,hotZone,Open Zone,0,0,2,2,54
5876,2022-12-29,LOU,heist,Hot Potato,0,1,0,1,72
5877,2022-12-28,LOU,hotZone,Open Zone,0,3,2,5,108
5878,2022-12-28,LOU,brawlBall,Sunny Soccer,0,1,1,2,42
5879,2022-12-27,LOU,hotZone,Controller Chaos,0,0,1,1,24
5880,2022-12-26,LOU,hotZone,Controller Chaos,0,1,0,1,30
5881,2022-12-26,LOU,gemGrab,Minecart Madness,0,1,0,1,60
5882,2022-12-22,LOU,brawlBall,Pinhole Punt,0,3,2,5,132
5883,2022-12-20,LOU,brawlBall,Beach Ball,0,2,1,3,96
5884,2022-12-17,LOU,brawlBall,Super Beach,0,1,1,2,6
5885,2022-12-16,LOU,gemGrab,Undermine,0,1,0,1,6
5886,2022-12-16,LOU,brawlBall,Sneaky Fields,0,2,0,2,84
5887,2022-12-10,LOU,hotZone,Ring of Fire,0,0,1,1,6
5888,2022-11-07,LOU,hotZone,Quarter Pounder,0,3,1,4,24
5889,2022-10-30,LOU,hotZone,Dueling Beetles,0,0,2,2,12
5890,2022-10-30,LOU,heist,Safe Zone,0,0,1,1,6
5891,2022-10-28,LOU,hotZone,Dueling Beetles,0,1,0,1,12
5892,2023-01-28,LOLA,knockout,Flaring Phoenix,0,9,6,15,12366
5893,2023-01-28,LOLA,hotZone,Controller Chaos,0,28,38,66,10134
5894,2023-01-28,LOLA,heist,Bridge Too Far,2,425,526,953,24240
5895,2023-01-28,LOLA,gemGrab,Hard Rock Mine,0,44,77,121,16638
5896,2023-01-28,LOLA,gemGrab,Deep Diner,0,8,20,28,5478
5897,2023-01-28,LOLA,brawlBall,Super Beach,5,115,110,230,74430
5898,2023-01-28,LOLA,brawlBall,Sneaky Fields,0,6,0,6,3582
5899,2023-01-28,LOLA,bounty,Canal Grande,0,2,3,5,10902
5900,2023-01-27,LOLA,knockout,Flaring Phoenix,0,11,17,28,5928
5901,2023-01-27,LOLA,hotZone,Controller Chaos,0,4,4,8,2676
5902,2023-01-27,LOLA,heist,Hot Potato,0,22,39,61,3486
5903,2023-01-27,LOLA,gemGrab,Undermine,0,4,1,5,942
5904,2023-01-27,LOLA,gemGrab,Deep Diner,0,8,8,16,6846
5905,2023-01-27,LOLA,brawlBall,Sneaky Fields,1,28,15,44,23514
5906,2023-01-27,LOLA,brawlBall,Pinhole Punt,0,0,1,1,738
5907,2023-01-27,LOLA,bounty,Temple Ruins,0,5,5,10,1890
5908,2023-01-26,LOLA,knockout,Riverside,0,44,56,100,19008
5909,2023-01-26,LOLA,hotZone,Open Zone,0,91,141,232,10182
5910,2023-01-26,LOLA,heist,Hot Potato,0,40,32,72,14610
5911,2023-01-26,LOLA,gemGrab,Undermine,0,22,27,49,10062
5912,2023-01-26,LOLA,gemGrab,Gem Fort,0,17,17,34,4674
5913,2023-01-26,LOLA,brawlBall,Sunny Soccer,0,2,2,4,3660
5914,2023-01-26,LOLA,brawlBall,Pinhole Punt,6,223,344,573,67338
5915,2023-01-26,LOLA,bounty,Temple Ruins,0,17,13,30,5610
5916,2023-01-25,LOLA,knockout,Riverside,0,23,24,47,9906
5917,2023-01-25,LOLA,hotZone,Open Zone,0,70,94,164,5262
5918,2023-01-25,LOLA,heist,Safe Zone,2,66,131,199,9156
5919,2023-01-25,LOLA,gemGrab,Gem Fort,0,8,10,18,5556
5920,2023-01-25,LOLA,gemGrab,Crystal Arcade,0,20,24,44,7866
5921,2023-01-25,LOLA,brawlBall,Sunny Soccer,2,41,56,99,40830
5922,2023-01-25,LOLA,brawlBall,Beach Ball,0,11,6,17,6408
5923,2023-01-25,LOLA,bounty,Excel,0,2,1,3,5790
5924,2023-01-24,LOLA,knockout,New Perspective,0,9,11,20,10542
5925,2023-01-24,LOLA,hotZone,Dueling Beetles,0,34,30,64,10662
5926,2023-01-24,LOLA,heist,Safe Zone,1,117,121,239,15750
5927,2023-01-24,LOLA,gemGrab,Minecart Madness,0,11,39,50,4002
5928,2023-01-24,LOLA,gemGrab,Crystal Arcade,0,35,27,62,14460
5929,2023-01-24,LOLA,brawlBall,Center Stage,0,6,5,11,7860
5930,2023-01-24,LOLA,brawlBall,Beach Ball,4,80,103,187,64614
5931,2023-01-24,LOLA,bounty,Excel,0,8,2,10,10896
5932,2023-01-23,LOLA,knockout,New Perspective,0,22,15,37,20676
5933,2023-01-23,LOLA,hotZone,Dueling Beetles,0,46,85,131,17502
5934,2023-01-23,LOLA,heist,Snaked Assault,1,96,147,244,15762
5935,2023-01-23,LOLA,gemGrab,Minecart Madness,0,72,124,196,19062
5936,2023-01-23,LOLA,gemGrab,Double Swoosh,0,6,17,23,7578
5937,2023-01-23,LOLA,brawlBall,Center Stage,4,89,124,217,92862
5938,2023-01-23,LOLA,brawlBall,Backyard Bowl,0,26,44,70,4224
5939,2023-01-23,LOLA,bounty,Layer Cake,0,12,15,27,11142
5940,2023-01-22,LOLA,knockout,X Marks the Spot,0,4,5,9,9174
5941,2023-01-22,LOLA,hotZone,Ring of Fire,0,21,61,82,5730
5942,2023-01-22,LOLA,heist,Snaked Assault,0,40,60,100,8232
5943,2023-01-22,LOLA,gemGrab,Hard Rock Mine,0,15,11,26,4722
5944,2023-01-22,LOLA,gemGrab,Double Swoosh,0,24,23,47,9426
5945,2023-01-22,LOLA,brawlBall,Super Beach,0,9,30,39,7386
5946,2023-01-22,LOLA,brawlBall,Backyard Bowl,12,157,214,383,34788
5947,2023-01-22,LOLA,bounty,Layer Cake,0,3,1,4,6654
5948,2023-01-21,LOLA,knockout,X Marks the Spot,0,48,51,99,31698
5949,2023-01-21,LOLA,hotZone,Ring of Fire,0,89,98,187,16632
5950,2023-01-21,LOLA,heist,Tornado Ring,0,26,29,55,11664
5951,2023-01-21,LOLA,gemGrab,Hard Rock Mine,0,43,36,79,22980
5952,2023-01-21,LOLA,gemGrab,Deep Diner,0,15,16,31,4470
5953,2023-01-21,LOLA,brawlBall,Super Beach,5,129,173,307,101364
5954,2023-01-21,LOLA,brawlBall,Sneaky Fields,0,1,1,2,3750
5955,2023-01-21,LOLA,bounty,Dry Season,0,21,13,34,14538
5956,2023-01-20,LOLA,knockout,Out in the Open,0,33,26,59,20106
5957,2023-01-20,LOLA,hotZone,Split,0,9,10,19,9678
5958,2023-01-20,LOLA,heist,Tornado Ring,0,30,15,45,12672
5959,2023-01-20,LOLA,gemGrab,Undermine,0,7,17,24,5442
5960,2023-01-20,LOLA,gemGrab,Deep Diner,0,35,76,111,19050
5961,2023-01-20,LOLA,brawlBall,Sneaky Fields,1,60,54,115,74778
5962,2023-01-20,LOLA,brawlBall,Pinhole Punt,0,6,5,11,2886
5963,2023-01-20,LOLA,bounty,Dry Season,0,7,28,35,11640
5964,2023-01-19,LOLA,knockout,Out in the Open,0,53,46,99,26574
5965,2023-01-19,LOLA,hotZone,Split,0,7,10,17,14856
5966,2023-01-19,LOLA,heist,Kaboom Canyon,0,71,125,196,6732
5967,2023-01-19,LOLA,gemGrab,Undermine,0,33,50,83,14154
5968,2023-01-19,LOLA,gemGrab,Gem Fort,0,15,20,35,2934
5969,2023-01-19,LOLA,brawlBall,Sunny Soccer,0,5,10,15,2274
5970,2023-01-19,LOLA,brawlBall,Pinhole Punt,11,232,319,562,72498
5971,2023-01-19,LOLA,bounty,Shooting Star,0,14,17,31,11124
5972,2023-01-18,LOLA,knockout,Goldarm Gulch,0,5,4,9,2784
5973,2023-01-18,LOLA,hotZone,Parallel Plays,0,2,2,4,1158
5974,2023-01-18,LOLA,heist,Kaboom Canyon,0,21,40,61,2592
5975,2023-01-18,LOLA,gemGrab,Gem Fort,0,4,5,9,3006
5976,2023-01-18,LOLA,gemGrab,Crystal Arcade,0,3,0,3,990
5977,2023-01-18,LOLA,brawlBall,Sunny Soccer,0,24,23,47,18941
5978,2023-01-18,LOLA,brawlBall,Beach Ball,0,4,1,5,774
5979,2023-01-18,LOLA,bounty,Shooting Star,0,9,10,19,5088
5980,2023-01-17,LOLA,knockout,Goldarm Gulch,0,5,6,11,2520
5981,2023-01-17,LOLA,hotZone,Parallel Plays,0,2,3,5,1038
5982,2023-01-17,LOLA,heist,Pit Stop,0,0,1,1,1290
5983,2023-01-17,LOLA,gemGrab,Minecart Madness,0,1,5,6,216
5984,2023-01-17,LOLA,gemGrab,Crystal Arcade,0,2,4,6,1266
5985,2023-01-17,LOLA,brawlBall,Beach Ball,1,6,8,15,5886
5986,2023-01-17,LOLA,bounty,Hideout,0,2,2,4,750
5987,2023-01-16,LOLA,knockout,Belle's Rock,0,1,5,6,1788
5988,2023-01-16,LOLA,hotZone,Quarter Pounder,0,11,21,32,1494
5989,2023-01-16,LOLA,heist,Pit Stop,0,2,0,2,4044
5990,2023-01-16,LOLA,gemGrab,Minecart Madness,0,17,14,31,1422
5991,2023-01-16,LOLA,gemGrab,Double Swoosh,0,1,14,15,708
5992,2023-01-16,LOLA,brawlBall,Center Stage,0,2,6,8,5778
5993,2023-01-16,LOLA,brawlBall,Backyard Bowl,0,3,9,12,852
5994,2023-01-16,LOLA,bounty,Hideout,0,3,3,6,1470
5995,2023-01-15,LOLA,hotZone,Quarter Pounder,0,8,15,23,3318
5996,2023-01-15,LOLA,heist,Bridge Too Far,0,51,54,105,2736
5997,2023-01-15,LOLA,gemGrab,Hard Rock Mine,0,1,0,1,1014
5998,2023-01-15,LOLA,gemGrab,Double Swoosh,0,2,3,5,2178
5999,2023-01-15,LOLA,brawlBall,Super Beach,0,1,0,1,1074
6000,2023-01-15,LOLA,brawlBall,Backyard Bowl,4,52,63,119,8946
6001,2023-01-15,LOLA,bounty,Canal Grande,0,1,0,1,960
6002,2023-01-14,LOLA,knockout,Flaring Phoenix,0,1,10,11,1080
6003,2023-01-14,LOLA,hotZone,Controller Chaos,0,4,3,7,2772
6004,2023-01-14,LOLA,heist,Bridge Too Far,0,99,137,236,4020
6005,2023-01-14,LOLA,gemGrab,Hard Rock Mine,0,1,0,1,1272
6006,2023-01-14,LOLA,gemGrab,Deep Diner,0,2,0,2,858
6007,2023-01-14,LOLA,brawlBall,Super Beach,0,15,13,28,6336
6008,2023-01-13,LOLA,knockout,Flaring Phoenix,0,2,0,2,1182
6009,2023-01-13,LOLA,hotZone,Controller Chaos,0,4,1,5,2928
6010,2023-01-13,LOLA,heist,Hot Potato,0,0,1,1,600
6011,2023-01-13,LOLA,gemGrab,Deep Diner,0,5,1,6,1650
6012,2023-01-13,LOLA,brawlBall,Sneaky Fields,0,8,8,16,6144
6013,2023-01-13,LOLA,brawlBall,Pinhole Punt,0,1,1,2,156
6014,2023-01-12,LOLA,knockout,Riverside,0,3,0,3,2532
6015,2023-01-12,LOLA,hotZone,Open Zone,0,9,7,16,1488
6016,2023-01-12,LOLA,gemGrab,Undermine,0,4,7,11,690
6017,2023-01-12,LOLA,brawlBall,Pinhole Punt,0,1,1,2,2292
6018,2023-01-11,LOLA,hotZone,Open Zone,0,4,6,10,462
6019,2023-01-11,LOLA,gemGrab,Gem Fort,0,0,1,1,414
6020,2023-01-11,LOLA,brawlBall,Sunny Soccer,0,1,4,5,1638
6021,2023-01-10,LOLA,knockout,New Perspective,0,1,0,1,720
6022,2023-01-10,LOLA,hotZone,Dueling Beetles,0,4,12,16,2424
6023,2023-01-10,LOLA,heist,Safe Zone,0,7,8,15,1176
6024,2023-01-10,LOLA,gemGrab,Minecart Madness,0,1,3,4,828
6025,2023-01-10,LOLA,gemGrab,Crystal Arcade,0,0,2,2,1746
6026,2023-01-10,LOLA,brawlBall,Beach Ball,0,2,2,4,4392
6027,2023-01-09,LOLA,knockout,New Perspective,0,1,0,1,876
6028,2023-01-09,LOLA,hotZone,Dueling Beetles,0,3,2,5,1554
6029,2023-01-09,LOLA,heist,Snaked Assault,0,5,3,8,2022
6030,2023-01-09,LOLA,gemGrab,Minecart Madness,1,13,23,37,1884
6031,2023-01-09,LOLA,gemGrab,Double Swoosh,0,2,2,4,1320
6032,2023-01-09,LOLA,brawlBall,Center Stage,0,1,6,7,5460
6033,2023-01-09,LOLA,brawlBall,Backyard Bowl,0,2,3,5,474
6034,2023-01-08,LOLA,knockout,X Marks the Spot,0,2,0,2,1692
6035,2023-01-08,LOLA,hotZone,Ring of Fire,0,8,4,12,1644
6036,2023-01-08,LOLA,heist,Snaked Assault,0,8,2,10,1494
6037,2023-01-08,LOLA,gemGrab,Hard Rock Mine,0,4,5,9,630
6038,2023-01-08,LOLA,gemGrab,Double Swoosh,0,3,1,4,864
6039,2023-01-08,LOLA,brawlBall,Backyard Bowl,0,17,37,54,4830
6040,2023-01-08,LOLA,bounty,Layer Cake,0,1,0,1,528
6041,2023-01-07,LOLA,knockout,X Marks the Spot,0,2,0,2,1014
6042,2023-01-07,LOLA,hotZone,Ring of Fire,0,4,0,4,846
6043,2023-01-07,LOLA,heist,Tornado Ring,0,3,1,4,1350
6044,2023-01-07,LOLA,gemGrab,Hard Rock Mine,0,1,0,1,1158
6045,2023-01-07,LOLA,gemGrab,Deep Diner,0,1,1,2,918
6046,2023-01-07,LOLA,brawlBall,Super Beach,0,1,8,9,2622
6047,2023-01-07,LOLA,brawlBall,Sneaky Fields,0,1,0,1,402
6048,2023-01-07,LOLA,bounty,Dry Season,0,2,0,2,1320
6049,2023-01-06,LOLA,knockout,Out in the Open,0,0,4,4,1446
6050,2023-01-06,LOLA,hotZone,Split,0,2,0,2,1158
6051,2023-01-06,LOLA,heist,Tornado Ring,0,4,1,5,2538
6052,2023-01-06,LOLA,gemGrab,Undermine,0,2,0,2,540
6053,2023-01-06,LOLA,gemGrab,Deep Diner,0,0,17,17,2226
6054,2023-01-06,LOLA,brawlBall,Sneaky Fields,0,4,8,12,4896
6055,2023-01-06,LOLA,brawlBall,Pinhole Punt,0,1,2,3,510
6056,2023-01-06,LOLA,bounty,Dry Season,0,8,15,23,1944
6057,2023-01-05,LOLA,heist,Kaboom Canyon,0,17,57,74,954
6058,2023-01-05,LOLA,brawlBall,Pinhole Punt,3,21,62,86,8118
6059,2023-01-05,LOLA,bounty,Shooting Star,0,4,16,20,1362
6060,2023-01-04,LOLA,knockout,Goldarm Gulch,0,1,0,1,696
6061,2023-01-04,LOLA,hotZone,Parallel Plays,0,1,0,1,864
6062,2023-01-04,LOLA,heist,Kaboom Canyon,1,39,82,122,1848
6063,2023-01-04,LOLA,gemGrab,Gem Fort,0,3,1,4,1788
6064,2023-01-04,LOLA,brawlBall,Sunny Soccer,0,1,1,2,6312
6065,2023-01-04,LOLA,bounty,Shooting Star,0,6,0,6,3570
6066,2023-01-03,LOLA,knockout,Goldarm Gulch,0,2,3,5,720
6067,2023-01-03,LOLA,hotZone,Parallel Plays,0,3,0,3,1542
6068,2023-01-03,LOLA,heist,Pit Stop,0,1,0,1,1956
6069,2023-01-03,LOLA,gemGrab,Minecart Madness,0,1,24,25,456
6070,2023-01-03,LOLA,brawlBall,Center Stage,0,2,0,2,294
6071,2023-01-03,LOLA,brawlBall,Beach Ball,0,3,1,4,5580
6072,2023-01-02,LOLA,knockout,Belle's Rock,0,1,1,2,1794
6073,2023-01-02,LOLA,hotZone,Quarter Pounder,0,6,6,12,2652
6074,2023-01-02,LOLA,heist,Pit Stop,0,3,0,3,3498
6075,2023-01-02,LOLA,gemGrab,Minecart Madness,0,9,15,24,2352
6076,2023-01-02,LOLA,gemGrab,Double Swoosh,0,2,0,2,1512
6077,2023-01-02,LOLA,brawlBall,Center Stage,0,8,4,12,7110
6078,2023-01-02,LOLA,brawlBall,Backyard Bowl,1,2,4,7,492
6079,2023-01-02,LOLA,bounty,Hideout,0,3,1,4,3090
6080,2023-01-01,LOLA,knockout,Belle's Rock,0,2,0,2,858
6081,2023-01-01,LOLA,hotZone,Quarter Pounder,0,2,1,3,1188
6082,2023-01-01,LOLA,heist,Bridge Too Far,0,12,22,34,462
6083,2023-01-01,LOLA,gemGrab,Double Swoosh,0,2,4,6,1140
6084,2023-01-01,LOLA,brawlBall,Backyard Bowl,0,21,47,68,2658
6085,2022-12-31,LOLA,heist,Bridge Too Far,0,6,10,16,276
6086,2022-12-31,LOLA,gemGrab,Minecart Madness,0,1,0,1,24
6087,2022-12-31,LOLA,gemGrab,Hard Rock Mine,0,2,0,2,384
6088,2022-12-31,LOLA,gemGrab,Deep Diner,0,0,1,1,306
6089,2022-12-31,LOLA,brawlBall,Super Beach,0,1,3,4,618
6090,2022-12-30,LOLA,hotZone,Controller Chaos,0,1,0,1,288
6091,2022-12-30,LOLA,heist,Hot Potato,0,1,0,1,30
6092,2022-12-30,LOLA,gemGrab,Undermine,0,2,0,2,102
6093,2022-12-30,LOLA,brawlBall,Sneaky Fields,0,2,1,3,552
6094,2022-12-29,LOLA,hotZone,Open Zone,0,0,1,1,54
6095,2022-12-29,LOLA,heist,Hot Potato,0,1,0,1,72
6096,2022-12-29,LOLA,gemGrab,Undermine,0,1,0,1,102
6097,2022-12-28,LOLA,hotZone,Open Zone,0,2,8,10,108
6098,2022-12-27,LOLA,knockout,New Perspective,0,1,0,1,30
6099,2022-12-26,LOLA,heist,Kaboom Canyon,0,0,1,1,36
6100,2022-12-26,LOLA,brawlBall,Center Stage,0,1,0,1,78
6101,2022-12-22,LOLA,brawlBall,Pinhole Punt,0,1,0,1,132
6102,2022-12-21,LOLA,brawlBall,Sunny Soccer,0,0,1,1,54
6103,2022-12-16,LOLA,gemGrab,Undermine,0,1,0,1,6
6104,2022-12-13,LOLA,heist,Safe Zone,0,0,2,2,42
6105,2022-12-13,LOLA,gemGrab,Crystal Arcade,0,1,0,1,72
6106,2022-12-11,LOLA,gemGrab,Double Swoosh,0,0,1,1,12
6107,2022-11-01,LOLA,knockout,New Perspective,0,0,1,1,54
6108,2022-10-10,LOLA,knockout,Belle's Rock,0,2,0,2,48
6109,2023-01-28,LEON,knockout,Flaring Phoenix,0,154,101,255,12366
6110,2023-01-28,LEON,hotZone,Controller Chaos,0,45,11,56,10134
6111,2023-01-28,LEON,heist,Bridge Too Far,0,28,14,42,24240
6112,2023-01-28,LEON,gemGrab,Hard Rock Mine,0,195,167,362,16638
6113,2023-01-28,LEON,gemGrab,Deep Diner,0,77,71,148,5478
6114,2023-01-28,LEON,brawlBall,Super Beach,10,334,270,614,74430
6115,2023-01-28,LEON,brawlBall,Sneaky Fields,0,6,8,14,3582
6116,2023-01-28,LEON,bounty,Canal Grande,0,121,100,221,10902
6117,2023-01-27,LEON,knockout,Flaring Phoenix,0,73,57,130,5928
6118,2023-01-27,LEON,hotZone,Controller Chaos,0,14,4,18,2676
6119,2023-01-27,LEON,heist,Hot Potato,0,7,1,8,3486
6120,2023-01-27,LEON,gemGrab,Undermine,0,11,12,23,942
6121,2023-01-27,LEON,gemGrab,Deep Diner,0,87,77,164,6846
6122,2023-01-27,LEON,brawlBall,Sneaky Fields,1,84,71,156,23514
6123,2023-01-27,LEON,brawlBall,Pinhole Punt,1,5,5,11,738
6124,2023-01-27,LEON,bounty,Temple Ruins,0,36,20,56,1890
6125,2023-01-26,LEON,knockout,Riverside,0,184,87,271,19008
6126,2023-01-26,LEON,hotZone,Open Zone,0,66,37,103,10182
6127,2023-01-26,LEON,heist,Hot Potato,0,14,3,17,14610
6128,2023-01-26,LEON,gemGrab,Undermine,0,92,44,136,10062
6129,2023-01-26,LEON,gemGrab,Gem Fort,0,47,40,87,4674
6130,2023-01-26,LEON,brawlBall,Sunny Soccer,0,27,5,32,3660
6131,2023-01-26,LEON,brawlBall,Pinhole Punt,20,509,530,1059,67338
6132,2023-01-26,LEON,bounty,Temple Ruins,0,87,53,140,5610
6133,2023-01-25,LEON,knockout,Riverside,0,100,70,170,9906
6134,2023-01-25,LEON,hotZone,Open Zone,0,31,28,59,5262
6135,2023-01-25,LEON,heist,Safe Zone,0,20,6,26,9156
6136,2023-01-25,LEON,gemGrab,Gem Fort,0,50,52,102,5556
6137,2023-01-25,LEON,gemGrab,Crystal Arcade,0,92,44,136,7866
6138,2023-01-25,LEON,brawlBall,Sunny Soccer,6,228,190,424,40830
6139,2023-01-25,LEON,brawlBall,Beach Ball,2,51,24,77,6408
6140,2023-01-25,LEON,bounty,Excel,0,68,52,120,5790
6141,2023-01-24,LEON,knockout,New Perspective,0,196,114,310,10542
6142,2023-01-24,LEON,hotZone,Dueling Beetles,0,39,41,80,10662
6143,2023-01-24,LEON,heist,Safe Zone,0,25,7,32,15750
6144,2023-01-24,LEON,gemGrab,Minecart Madness,0,31,23,54,4002
6145,2023-01-24,LEON,gemGrab,Crystal Arcade,0,156,108,264,14460
6146,2023-01-24,LEON,brawlBall,Center Stage,3,40,21,64,7860
6147,2023-01-24,LEON,brawlBall,Beach Ball,7,451,402,860,64614
6148,2023-01-24,LEON,bounty,Excel,0,106,76,182,10896
6149,2023-01-23,LEON,knockout,New Perspective,0,264,192,456,20676
6150,2023-01-23,LEON,hotZone,Dueling Beetles,0,61,49,110,17502
6151,2023-01-23,LEON,heist,Snaked Assault,0,30,12,42,15762
6152,2023-01-23,LEON,gemGrab,Minecart Madness,0,133,90,223,19062
6153,2023-01-23,LEON,gemGrab,Double Swoosh,0,53,22,75,7578
6154,2023-01-23,LEON,brawlBall,Center Stage,8,410,299,717,92862
6155,2023-01-23,LEON,brawlBall,Backyard Bowl,1,44,76,121,4224
6156,2023-01-23,LEON,bounty,Layer Cake,0,161,186,347,11142
6157,2023-01-22,LEON,knockout,X Marks the Spot,0,84,77,161,9174
6158,2023-01-22,LEON,hotZone,Ring of Fire,0,45,32,77,5730
6159,2023-01-22,LEON,heist,Snaked Assault,0,13,4,17,8232
6160,2023-01-22,LEON,gemGrab,Hard Rock Mine,0,54,37,91,4722
6161,2023-01-22,LEON,gemGrab,Double Swoosh,0,71,57,128,9426
6162,2023-01-22,LEON,brawlBall,Super Beach,1,32,20,53,7386
6163,2023-01-22,LEON,brawlBall,Backyard Bowl,17,376,412,805,34788
6164,2023-01-22,LEON,bounty,Layer Cake,0,119,91,210,6654
6165,2023-01-21,LEON,knockout,X Marks the Spot,0,313,254,567,31698
6166,2023-01-21,LEON,hotZone,Ring of Fire,0,102,139,241,16632
6167,2023-01-21,LEON,heist,Tornado Ring,0,23,19,42,11664
6168,2023-01-21,LEON,gemGrab,Hard Rock Mine,0,253,203,456,22980
6169,2023-01-21,LEON,gemGrab,Deep Diner,0,68,70,138,4470
6170,2023-01-21,LEON,brawlBall,Super Beach,8,464,308,780,101364
6171,2023-01-21,LEON,brawlBall,Sneaky Fields,0,16,15,31,3750
6172,2023-01-21,LEON,bounty,Dry Season,0,177,238,415,14538
6173,2023-01-20,LEON,knockout,Out in the Open,0,251,183,434,20106
6174,2023-01-20,LEON,hotZone,Split,0,26,14,40,9678
6175,2023-01-20,LEON,heist,Tornado Ring,0,15,8,23,12672
6176,2023-01-20,LEON,gemGrab,Undermine,0,63,40,103,5442
6177,2023-01-20,LEON,gemGrab,Deep Diner,0,208,198,406,19050
6178,2023-01-20,LEON,brawlBall,Sneaky Fields,6,302,186,494,74778
6179,2023-01-20,LEON,brawlBall,Pinhole Punt,0,35,38,73,2886
6180,2023-01-20,LEON,bounty,Dry Season,0,189,174,363,11640
6181,2023-01-19,LEON,knockout,Out in the Open,0,262,153,415,26574
6182,2023-01-19,LEON,hotZone,Split,0,37,19,56,14856
6183,2023-01-19,LEON,heist,Kaboom Canyon,0,14,12,26,6732
6184,2023-01-19,LEON,gemGrab,Undermine,0,141,114,255,14154
6185,2023-01-19,LEON,gemGrab,Gem Fort,0,30,29,59,2934
6186,2023-01-19,LEON,brawlBall,Sunny Soccer,0,18,5,23,2274
6187,2023-01-19,LEON,brawlBall,Pinhole Punt,20,554,516,1090,72498
6188,2023-01-19,LEON,bounty,Shooting Star,0,103,64,167,11124
6189,2023-01-18,LEON,knockout,Goldarm Gulch,1,41,31,73,2784
6190,2023-01-18,LEON,hotZone,Parallel Plays,0,7,2,9,1158
6191,2023-01-18,LEON,heist,Kaboom Canyon,0,4,2,6,2592
6192,2023-01-18,LEON,gemGrab,Gem Fort,0,38,29,67,3006
6193,2023-01-18,LEON,gemGrab,Crystal Arcade,0,10,7,17,990
6194,2023-01-18,LEON,brawlBall,Sunny Soccer,3,118,81,202,18941
6195,2023-01-18,LEON,brawlBall,Beach Ball,0,6,0,6,774
6196,2023-01-18,LEON,bounty,Shooting Star,0,52,49,101,5088
6197,2023-01-17,LEON,knockout,Goldarm Gulch,0,36,21,57,2520
6198,2023-01-17,LEON,hotZone,Parallel Plays,0,12,7,19,1038
6199,2023-01-17,LEON,heist,Pit Stop,0,1,1,2,1290
6200,2023-01-17,LEON,gemGrab,Minecart Madness,0,1,1,2,216
6201,2023-01-17,LEON,gemGrab,Crystal Arcade,0,5,4,9,1266
6202,2023-01-17,LEON,brawlBall,Center Stage,0,3,1,4,288
6203,2023-01-17,LEON,brawlBall,Beach Ball,1,51,30,82,5886
6204,2023-01-17,LEON,bounty,Hideout,0,9,10,19,750
6205,2023-01-16,LEON,knockout,Belle's Rock,0,9,7,16,1788
6206,2023-01-16,LEON,hotZone,Quarter Pounder,0,7,14,21,1494
6207,2023-01-16,LEON,heist,Pit Stop,0,2,0,2,4044
6208,2023-01-16,LEON,gemGrab,Minecart Madness,0,15,15,30,1422
6209,2023-01-16,LEON,gemGrab,Double Swoosh,0,6,0,6,708
6210,2023-01-16,LEON,brawlBall,Center Stage,1,19,12,32,5778
6211,2023-01-16,LEON,brawlBall,Backyard Bowl,1,14,0,15,852
6212,2023-01-16,LEON,bounty,Hideout,0,20,25,45,1470
6213,2023-01-15,LEON,knockout,Belle's Rock,0,31,15,46,2904
6214,2023-01-15,LEON,hotZone,Quarter Pounder,0,11,1,12,3318
6215,2023-01-15,LEON,heist,Bridge Too Far,0,1,1,2,2736
6216,2023-01-15,LEON,gemGrab,Hard Rock Mine,0,16,26,42,1014
6217,2023-01-15,LEON,gemGrab,Double Swoosh,0,14,4,18,2178
6218,2023-01-15,LEON,brawlBall,Super Beach,0,2,4,6,1074
6219,2023-01-15,LEON,brawlBall,Backyard Bowl,6,117,113,236,8946
6220,2023-01-15,LEON,bounty,Canal Grande,0,8,4,12,960
6221,2023-01-14,LEON,knockout,Flaring Phoenix,0,11,5,16,1080
6222,2023-01-14,LEON,hotZone,Controller Chaos,0,9,4,13,2772
6223,2023-01-14,LEON,heist,Bridge Too Far,0,6,0,6,4020
6224,2023-01-14,LEON,gemGrab,Hard Rock Mine,0,17,11,28,1272
6225,2023-01-14,LEON,gemGrab,Deep Diner,0,6,4,10,858
6226,2023-01-14,LEON,brawlBall,Super Beach,1,22,11,34,6336
6227,2023-01-14,LEON,brawlBall,Sneaky Fields,0,2,0,2,918
6228,2023-01-14,LEON,bounty,Canal Grande,0,9,8,17,1014
6229,2023-01-13,LEON,knockout,Flaring Phoenix,0,11,8,19,1182
6230,2023-01-13,LEON,hotZone,Controller Chaos,0,11,0,11,2928
6231,2023-01-13,LEON,gemGrab,Deep Diner,0,25,3,28,1650
6232,2023-01-13,LEON,brawlBall,Sneaky Fields,0,11,2,13,6144
6233,2023-01-13,LEON,brawlBall,Pinhole Punt,0,0,1,1,156
6234,2023-01-13,LEON,bounty,Temple Ruins,0,4,2,6,270
6235,2023-01-12,LEON,knockout,Riverside,0,22,9,31,2532
6236,2023-01-12,LEON,hotZone,Open Zone,0,10,2,12,1488
6237,2023-01-12,LEON,gemGrab,Undermine,0,5,3,8,690
6238,2023-01-12,LEON,gemGrab,Gem Fort,0,1,1,2,162
6239,2023-01-12,LEON,brawlBall,Sunny Soccer,0,3,0,3,240
6240,2023-01-12,LEON,brawlBall,Pinhole Punt,0,22,10,32,2292
6241,2023-01-11,LEON,knockout,Riverside,0,1,4,5,528
6242,2023-01-11,LEON,hotZone,Open Zone,0,11,31,42,462
6243,2023-01-11,LEON,gemGrab,Gem Fort,0,5,2,7,414
6244,2023-01-11,LEON,brawlBall,Sunny Soccer,0,13,21,34,1638
6245,2023-01-11,LEON,bounty,Excel,0,3,2,5,282
6246,2023-01-10,LEON,knockout,New Perspective,0,11,10,21,720
6247,2023-01-10,LEON,hotZone,Dueling Beetles,0,9,2,11,2424
6248,2023-01-10,LEON,gemGrab,Minecart Madness,0,7,4,11,828
6249,2023-01-10,LEON,gemGrab,Crystal Arcade,0,20,4,24,1746
6250,2023-01-10,LEON,brawlBall,Center Stage,0,1,0,1,708
6251,2023-01-10,LEON,brawlBall,Beach Ball,0,16,12,28,4392
6252,2023-01-10,LEON,bounty,Excel,0,5,0,5,330
6253,2023-01-09,LEON,knockout,New Perspective,0,11,4,15,876
6254,2023-01-09,LEON,hotZone,Dueling Beetles,0,9,6,15,1554
6255,2023-01-09,LEON,heist,Snaked Assault,0,3,1,4,2022
6256,2023-01-09,LEON,gemGrab,Minecart Madness,0,22,10,32,1884
6257,2023-01-09,LEON,gemGrab,Double Swoosh,0,8,0,8,1320
6258,2023-01-09,LEON,brawlBall,Center Stage,1,20,12,33,5460
6259,2023-01-09,LEON,brawlBall,Backyard Bowl,1,4,0,5,474
6260,2023-01-09,LEON,bounty,Layer Cake,0,24,16,40,1512
6261,2023-01-08,LEON,knockout,X Marks the Spot,0,29,31,60,1692
6262,2023-01-08,LEON,hotZone,Ring of Fire,0,9,5,14,1644
6263,2023-01-08,LEON,heist,Snaked Assault,0,3,1,4,1494
6264,2023-01-08,LEON,gemGrab,Hard Rock Mine,0,4,4,8,630
6265,2023-01-08,LEON,gemGrab,Double Swoosh,0,4,0,4,864
6266,2023-01-08,LEON,brawlBall,Super Beach,0,4,2,6,732
6267,2023-01-08,LEON,brawlBall,Backyard Bowl,1,66,60,127,4830
6268,2023-01-08,LEON,bounty,Layer Cake,0,0,2,2,528
6269,2023-01-07,LEON,knockout,X Marks the Spot,0,5,2,7,1014
6270,2023-01-07,LEON,hotZone,Ring of Fire,0,1,0,1,846
6271,2023-01-07,LEON,heist,Tornado Ring,0,4,0,4,1350
6272,2023-01-07,LEON,gemGrab,Hard Rock Mine,0,16,16,32,1158
6273,2023-01-07,LEON,gemGrab,Deep Diner,0,6,2,8,918
6274,2023-01-07,LEON,brawlBall,Super Beach,0,8,3,11,2622
6275,2023-01-07,LEON,brawlBall,Sneaky Fields,1,3,2,6,402
6276,2023-01-07,LEON,bounty,Dry Season,0,22,12,34,1320
6277,2023-01-06,LEON,knockout,Out in the Open,0,11,6,17,1446
6278,2023-01-06,LEON,hotZone,Split,0,5,0,5,1158
6279,2023-01-06,LEON,heist,Tornado Ring,0,4,1,5,2538
6280,2023-01-06,LEON,gemGrab,Undermine,0,5,0,5,540
6281,2023-01-06,LEON,gemGrab,Deep Diner,0,20,5,25,2226
6282,2023-01-06,LEON,brawlBall,Sneaky Fields,0,13,9,22,4896
6283,2023-01-06,LEON,brawlBall,Pinhole Punt,0,0,2,2,510
6284,2023-01-06,LEON,bounty,Dry Season,0,31,49,80,1944
6285,2023-01-05,LEON,knockout,Out in the Open,0,28,19,47,2958
6286,2023-01-05,LEON,hotZone,Split,1,5,2,8,3552
6287,2023-01-05,LEON,heist,Kaboom Canyon,0,1,0,1,954
6288,2023-01-05,LEON,gemGrab,Undermine,0,14,6,20,1812
6289,2023-01-05,LEON,gemGrab,Gem Fort,0,4,1,5,252
6290,2023-01-05,LEON,brawlBall,Pinhole Punt,2,58,123,183,8118
6291,2023-01-05,LEON,bounty,Shooting Star,0,24,9,33,1362
6292,2023-01-04,LEON,knockout,Goldarm Gulch,0,15,1,16,696
6293,2023-01-04,LEON,hotZone,Parallel Plays,0,10,4,14,864
6294,2023-01-04,LEON,heist,Kaboom Canyon,0,3,0,3,1848
6295,2023-01-04,LEON,gemGrab,Gem Fort,0,10,4,14,1788
6296,2023-01-04,LEON,gemGrab,Crystal Arcade,0,5,1,6,642
6297,2023-01-04,LEON,brawlBall,Sunny Soccer,0,15,12,27,6312
6298,2023-01-04,LEON,bounty,Shooting Star,0,46,10,56,3570
6299,2023-01-03,LEON,knockout,Goldarm Gulch,0,12,2,14,720
6300,2023-01-03,LEON,hotZone,Parallel Plays,1,29,92,122,1542
6301,2023-01-03,LEON,heist,Pit Stop,0,0,1,1,1956
6302,2023-01-03,LEON,gemGrab,Minecart Madness,0,4,0,4,456
6303,2023-01-03,LEON,gemGrab,Crystal Arcade,0,24,1,25,2406
6304,2023-01-03,LEON,brawlBall,Center Stage,0,3,0,3,294
6305,2023-01-03,LEON,brawlBall,Beach Ball,0,21,15,36,5580
6306,2023-01-03,LEON,bounty,Hideout,0,26,20,46,1638
6307,2023-01-02,LEON,knockout,Belle's Rock,0,18,3,21,1794
6308,2023-01-02,LEON,hotZone,Quarter Pounder,0,12,10,22,2652
6309,2023-01-02,LEON,heist,Pit Stop,0,2,0,2,3498
6310,2023-01-02,LEON,gemGrab,Minecart Madness,0,25,5,30,2352
6311,2023-01-02,LEON,gemGrab,Double Swoosh,0,9,1,10,1512
6312,2023-01-02,LEON,brawlBall,Center Stage,1,19,10,30,7110
6313,2023-01-02,LEON,brawlBall,Backyard Bowl,0,6,1,7,492
6314,2023-01-02,LEON,bounty,Hideout,0,63,59,122,3090
6315,2023-01-01,LEON,knockout,Belle's Rock,0,8,5,13,858
6316,2023-01-01,LEON,hotZone,Quarter Pounder,0,2,11,13,1188
6317,2023-01-01,LEON,gemGrab,Double Swoosh,0,8,3,11,1140
6318,2023-01-01,LEON,brawlBall,Backyard Bowl,0,22,21,43,2658
6319,2023-01-01,LEON,bounty,Canal Grande,0,1,0,1,132
6320,2022-12-31,LEON,gemGrab,Hard Rock Mine,0,2,11,13,384
6321,2022-12-31,LEON,gemGrab,Deep Diner,0,5,8,13,306
6322,2022-12-31,LEON,brawlBall,Super Beach,0,3,4,7,618
6323,2022-12-31,LEON,bounty,Canal Grande,0,1,0,1,54
6324,2022-12-30,LEON,knockout,Flaring Phoenix,0,1,0,1,72
6325,2022-12-30,LEON,hotZone,Controller Chaos,0,1,0,1,288
6326,2022-12-30,LEON,gemGrab,Deep Diner,0,14,7,21,438
6327,2022-12-30,LEON,brawlBall,Sneaky Fields,0,5,3,8,552
6328,2022-12-29,LEON,hotZone,Open Zone,0,1,0,1,54
6329,2022-12-29,LEON,gemGrab,Gem Fort,0,2,1,3,30
6330,2022-12-29,LEON,brawlBall,Pinhole Punt,0,3,0,3,282
6331,2022-12-28,LEON,hotZone,Open Zone,0,0,1,1,108
6332,2022-12-27,LEON,knockout,New Perspective,0,0,1,1,30
6333,2022-12-27,LEON,hotZone,Controller Chaos,0,1,0,1,24
6334,2022-12-27,LEON,heist,Safe Zone,0,1,1,2,12
6335,2022-12-27,LEON,gemGrab,Minecart Madness,0,1,0,1,30
6336,2022-12-27,LEON,brawlBall,Beach Ball,0,8,5,13,144
6337,2022-12-27,LEON,bounty,Excel,0,2,1,3,18
6338,2022-12-25,LEON,brawlBall,Backyard Bowl,0,1,0,1,78
6339,2022-12-23,LEON,knockout,Out in the Open,0,1,1,2,132
6340,2022-12-22,LEON,brawlBall,Pinhole Punt,0,4,0,4,132
6341,2022-12-21,LEON,brawlBall,Sunny Soccer,0,1,0,1,54
6342,2022-12-20,LEON,brawlBall,Beach Ball,0,1,2,3,96
6343,2022-12-16,LEON,bounty,Temple Ruins,0,1,0,1,24
6344,2022-12-13,LEON,knockout,New Perspective,0,3,0,3,84
6345,2022-12-13,LEON,gemGrab,Crystal Arcade,0,4,0,4,72
6346,2022-11-07,LEON,hotZone,Quarter Pounder,0,1,0,1,24
6347,2022-11-01,LEON,knockout,New Perspective,0,0,1,1,54
6348,2022-10-26,LEON,bounty,Shooting Star,0,1,4,5,36
6349,2022-10-15,LEON,gemGrab,Hard Rock Mine,0,2,2,4,90
6350,2023-01-28,JESSIE,knockout,Flaring Phoenix,0,15,11,26,12366
6351,2023-01-28,JESSIE,hotZone,Controller Chaos,0,136,118,254,10134
6352,2023-01-28,JESSIE,heist,Bridge Too Far,0,305,232,537,24240
6353,2023-01-28,JESSIE,gemGrab,Hard Rock Mine,0,98,67,165,16638
6354,2023-01-28,JESSIE,gemGrab,Deep Diner,0,63,45,108,5478
6355,2023-01-28,JESSIE,brawlBall,Super Beach,13,398,464,875,74430
6356,2023-01-28,JESSIE,brawlBall,Sneaky Fields,0,5,6,11,3582
6357,2023-01-28,JESSIE,bounty,Canal Grande,0,33,7,40,10902
6358,2023-01-27,JESSIE,knockout,Flaring Phoenix,0,9,6,15,5928
6359,2023-01-27,JESSIE,hotZone,Controller Chaos,0,18,30,48,2676
6360,2023-01-27,JESSIE,heist,Hot Potato,1,115,81,197,3486
6361,2023-01-27,JESSIE,gemGrab,Undermine,0,5,4,9,942
6362,2023-01-27,JESSIE,gemGrab,Deep Diner,0,57,40,97,6846
6363,2023-01-27,JESSIE,brawlBall,Sneaky Fields,3,73,79,155,23514
6364,2023-01-27,JESSIE,brawlBall,Pinhole Punt,0,2,0,2,738
6365,2023-01-27,JESSIE,bounty,Temple Ruins,0,3,1,4,1890
6366,2023-01-26,JESSIE,knockout,Riverside,0,29,18,47,19008
6367,2023-01-26,JESSIE,hotZone,Open Zone,0,97,58,155,10182
6368,2023-01-26,JESSIE,heist,Hot Potato,0,300,222,522,14610
6369,2023-01-26,JESSIE,gemGrab,Undermine,0,72,78,150,10062
6370,2023-01-26,JESSIE,gemGrab,Gem Fort,0,57,33,90,4674
6371,2023-01-26,JESSIE,brawlBall,Sunny Soccer,0,22,18,40,3660
6372,2023-01-26,JESSIE,brawlBall,Pinhole Punt,6,286,312,604,67338
6373,2023-01-26,JESSIE,bounty,Temple Ruins,0,18,11,29,5610
6374,2023-01-25,JESSIE,knockout,Riverside,0,12,6,18,9906
6375,2023-01-25,JESSIE,hotZone,Open Zone,0,50,40,90,5262
6376,2023-01-25,JESSIE,heist,Safe Zone,2,272,161,435,9156
6377,2023-01-25,JESSIE,gemGrab,Gem Fort,0,50,42,92,5556
6378,2023-01-25,JESSIE,gemGrab,Crystal Arcade,0,71,93,164,7866
6379,2023-01-25,JESSIE,brawlBall,Sunny Soccer,7,199,218,424,40830
6380,2023-01-25,JESSIE,brawlBall,Beach Ball,2,26,26,54,6408
6381,2023-01-25,JESSIE,bounty,Excel,0,17,6,23,5790
6382,2023-01-24,JESSIE,knockout,New Perspective,0,32,40,72,10542
6383,2023-01-24,JESSIE,hotZone,Dueling Beetles,0,140,119,259,10662
6384,2023-01-24,JESSIE,heist,Safe Zone,0,443,300,743,15750
6385,2023-01-24,JESSIE,gemGrab,Minecart Madness,0,23,12,35,4002
6386,2023-01-24,JESSIE,gemGrab,Crystal Arcade,0,99,65,164,14460
6387,2023-01-24,JESSIE,brawlBall,Center Stage,0,27,20,47,7860
6388,2023-01-24,JESSIE,brawlBall,Beach Ball,9,285,277,571,64614
6389,2023-01-24,JESSIE,bounty,Excel,0,15,5,20,10896
6390,2023-01-23,JESSIE,knockout,New Perspective,0,35,19,54,20676
6391,2023-01-23,JESSIE,hotZone,Dueling Beetles,0,219,139,358,17502
6392,2023-01-23,JESSIE,heist,Snaked Assault,2,631,343,976,15762
6393,2023-01-23,JESSIE,gemGrab,Minecart Madness,0,118,79,197,19062
6394,2023-01-23,JESSIE,gemGrab,Double Swoosh,0,65,64,129,7578
6395,2023-01-23,JESSIE,brawlBall,Center Stage,10,274,236,520,92862
6396,2023-01-23,JESSIE,brawlBall,Backyard Bowl,1,24,11,36,4224
6397,2023-01-23,JESSIE,bounty,Layer Cake,0,26,9,35,11142
6398,2023-01-22,JESSIE,knockout,X Marks the Spot,0,16,5,21,9174
6399,2023-01-22,JESSIE,hotZone,Ring of Fire,0,65,37,102,5730
6400,2023-01-22,JESSIE,heist,Snaked Assault,2,239,151,392,8232
6401,2023-01-22,JESSIE,gemGrab,Hard Rock Mine,0,24,15,39,4722
6402,2023-01-22,JESSIE,gemGrab,Double Swoosh,0,74,66,140,9426
6403,2023-01-22,JESSIE,brawlBall,Super Beach,0,42,47,89,7386
6404,2023-01-22,JESSIE,brawlBall,Backyard Bowl,8,143,108,259,34788
6405,2023-01-22,JESSIE,bounty,Layer Cake,0,12,3,15,6654
6406,2023-01-21,JESSIE,knockout,X Marks the Spot,0,45,18,63,31698
6407,2023-01-21,JESSIE,hotZone,Ring of Fire,0,174,130,304,16632
6408,2023-01-21,JESSIE,heist,Tornado Ring,2,367,213,582,11664
6409,2023-01-21,JESSIE,gemGrab,Hard Rock Mine,0,176,104,280,22980
6410,2023-01-21,JESSIE,gemGrab,Deep Diner,0,49,62,111,4470
6411,2023-01-21,JESSIE,brawlBall,Super Beach,12,500,691,1203,101364
6412,2023-01-21,JESSIE,brawlBall,Sneaky Fields,1,13,10,24,3750
6413,2023-01-21,JESSIE,bounty,Dry Season,0,31,11,42,14538
6414,2023-01-20,JESSIE,knockout,Out in the Open,0,44,35,79,20106
6415,2023-01-20,JESSIE,hotZone,Split,0,40,15,55,9678
6416,2023-01-20,JESSIE,heist,Tornado Ring,3,315,238,556,12672
6417,2023-01-20,JESSIE,gemGrab,Undermine,0,40,40,80,5442
6418,2023-01-20,JESSIE,gemGrab,Deep Diner,0,190,170,360,19050
6419,2023-01-20,JESSIE,brawlBall,Sneaky Fields,9,236,263,508,74778
6420,2023-01-20,JESSIE,brawlBall,Pinhole Punt,0,23,30,53,2886
6421,2023-01-20,JESSIE,bounty,Dry Season,0,16,16,32,11640
6422,2023-01-19,JESSIE,knockout,Out in the Open,0,57,25,82,26574
6423,2023-01-19,JESSIE,hotZone,Split,0,62,23,85,14856
6424,2023-01-19,JESSIE,heist,Kaboom Canyon,0,215,164,379,6732
6425,2023-01-19,JESSIE,gemGrab,Undermine,0,116,75,191,14154
6426,2023-01-19,JESSIE,gemGrab,Gem Fort,0,27,16,43,2934
6427,2023-01-19,JESSIE,brawlBall,Sunny Soccer,0,8,10,18,2274
6428,2023-01-19,JESSIE,brawlBall,Pinhole Punt,11,336,336,683,72498
6429,2023-01-19,JESSIE,bounty,Shooting Star,0,16,4,20,11124
6430,2023-01-18,JESSIE,knockout,Goldarm Gulch,0,4,7,11,2784
6431,2023-01-18,JESSIE,hotZone,Parallel Plays,0,13,14,27,1158
6432,2023-01-18,JESSIE,heist,Kaboom Canyon,0,71,45,116,2592
6433,2023-01-18,JESSIE,gemGrab,Gem Fort,0,36,31,67,3006
6434,2023-01-18,JESSIE,gemGrab,Crystal Arcade,0,13,1,14,990
6435,2023-01-18,JESSIE,brawlBall,Sunny Soccer,6,86,90,182,18941
6436,2023-01-18,JESSIE,brawlBall,Beach Ball,0,2,2,4,774
6437,2023-01-18,JESSIE,bounty,Shooting Star,0,7,5,12,5088
6438,2023-01-17,JESSIE,knockout,Goldarm Gulch,0,3,0,3,2520
6439,2023-01-17,JESSIE,hotZone,Parallel Plays,0,16,13,29,1038
6440,2023-01-17,JESSIE,heist,Pit Stop,0,22,8,30,1290
6441,2023-01-17,JESSIE,gemGrab,Minecart Madness,0,1,3,4,216
6442,2023-01-17,JESSIE,gemGrab,Crystal Arcade,0,7,4,11,1266
6443,2023-01-17,JESSIE,brawlBall,Beach Ball,1,28,29,58,5886
6444,2023-01-17,JESSIE,bounty,Hideout,0,2,0,2,750
6445,2023-01-16,JESSIE,knockout,Belle's Rock,0,6,1,7,1788
6446,2023-01-16,JESSIE,hotZone,Quarter Pounder,0,21,4,25,1494
6447,2023-01-16,JESSIE,heist,Pit Stop,0,30,16,46,4044
6448,2023-01-16,JESSIE,gemGrab,Minecart Madness,0,16,12,28,1422
6449,2023-01-16,JESSIE,gemGrab,Double Swoosh,0,6,3,9,708
6450,2023-01-16,JESSIE,brawlBall,Center Stage,1,14,12,27,5778
6451,2023-01-16,JESSIE,brawlBall,Backyard Bowl,0,2,0,2,852
6452,2023-01-16,JESSIE,bounty,Hideout,0,0,1,1,1470
6453,2023-01-15,JESSIE,knockout,Belle's Rock,0,4,4,8,2904
6454,2023-01-15,JESSIE,hotZone,Quarter Pounder,0,38,12,50,3318
6455,2023-01-15,JESSIE,heist,Bridge Too Far,0,57,30,87,2736
6456,2023-01-15,JESSIE,gemGrab,Hard Rock Mine,0,5,1,6,1014
6457,2023-01-15,JESSIE,gemGrab,Double Swoosh,0,14,16,30,2178
6458,2023-01-15,JESSIE,brawlBall,Super Beach,0,5,2,7,1074
6459,2023-01-15,JESSIE,brawlBall,Backyard Bowl,2,31,38,71,8946
6460,2023-01-15,JESSIE,bounty,Canal Grande,0,3,1,4,960
6461,2023-01-14,JESSIE,knockout,Flaring Phoenix,0,2,0,2,1080
6462,2023-01-14,JESSIE,hotZone,Controller Chaos,0,27,15,42,2772
6463,2023-01-14,JESSIE,heist,Bridge Too Far,0,44,19,63,4020
6464,2023-01-14,JESSIE,gemGrab,Hard Rock Mine,0,8,3,11,1272
6465,2023-01-14,JESSIE,gemGrab,Deep Diner,0,8,6,14,858
6466,2023-01-14,JESSIE,brawlBall,Super Beach,0,44,57,101,6336
6467,2023-01-14,JESSIE,brawlBall,Sneaky Fields,0,3,1,4,918
6468,2023-01-14,JESSIE,bounty,Canal Grande,0,1,1,2,1014
6469,2023-01-13,JESSIE,knockout,Flaring Phoenix,0,3,1,4,1182
6470,2023-01-13,JESSIE,hotZone,Controller Chaos,0,26,6,32,2928
6471,2023-01-13,JESSIE,heist,Hot Potato,0,17,20,37,600
6472,2023-01-13,JESSIE,gemGrab,Undermine,0,1,0,1,18
6473,2023-01-13,JESSIE,gemGrab,Deep Diner,0,13,6,19,1650
6474,2023-01-13,JESSIE,brawlBall,Sneaky Fields,0,15,35,50,6144
6475,2023-01-13,JESSIE,brawlBall,Pinhole Punt,0,1,0,1,156
6476,2023-01-13,JESSIE,bounty,Temple Ruins,0,1,0,1,270
6477,2023-01-12,JESSIE,knockout,Riverside,0,3,0,3,2532
6478,2023-01-12,JESSIE,hotZone,Open Zone,0,21,1,22,1488
6479,2023-01-12,JESSIE,heist,Hot Potato,0,8,3,11,330
6480,2023-01-12,JESSIE,gemGrab,Undermine,0,2,1,3,690
6481,2023-01-12,JESSIE,brawlBall,Sunny Soccer,0,0,1,1,240
6482,2023-01-12,JESSIE,brawlBall,Pinhole Punt,0,12,26,38,2292
6483,2023-01-11,JESSIE,knockout,Riverside,0,1,0,1,528
6484,2023-01-11,JESSIE,hotZone,Open Zone,0,1,2,3,462
6485,2023-01-11,JESSIE,heist,Safe Zone,0,2,1,3,48
6486,2023-01-11,JESSIE,gemGrab,Gem Fort,0,4,1,5,414
6487,2023-01-11,JESSIE,brawlBall,Sunny Soccer,0,4,7,11,1638
6488,2023-01-10,JESSIE,hotZone,Dueling Beetles,0,36,30,66,2424
6489,2023-01-10,JESSIE,heist,Safe Zone,0,33,9,42,1176
6490,2023-01-10,JESSIE,gemGrab,Minecart Madness,0,8,5,13,828
6491,2023-01-10,JESSIE,gemGrab,Crystal Arcade,0,8,1,9,1746
6492,2023-01-10,JESSIE,brawlBall,Center Stage,0,3,1,4,708
6493,2023-01-10,JESSIE,brawlBall,Beach Ball,0,13,17,30,4392
6494,2023-01-09,JESSIE,knockout,New Perspective,0,1,0,1,876
6495,2023-01-09,JESSIE,hotZone,Dueling Beetles,0,11,14,25,1554
6496,2023-01-09,JESSIE,heist,Snaked Assault,0,78,49,127,2022
6497,2023-01-09,JESSIE,gemGrab,Minecart Madness,0,16,10,26,1884
6498,2023-01-09,JESSIE,gemGrab,Double Swoosh,0,7,2,9,1320
6499,2023-01-09,JESSIE,brawlBall,Center Stage,0,9,1,10,5460
6500,2023-01-09,JESSIE,brawlBall,Backyard Bowl,0,1,1,2,474
6501,2023-01-09,JESSIE,bounty,Layer Cake,0,2,2,4,1512
6502,2023-01-08,JESSIE,knockout,X Marks the Spot,0,2,0,2,1692
6503,2023-01-08,JESSIE,hotZone,Ring of Fire,0,24,2,26,1644
6504,2023-01-08,JESSIE,heist,Snaked Assault,0,38,19,57,1494
6505,2023-01-08,JESSIE,gemGrab,Hard Rock Mine,0,6,1,7,630
6506,2023-01-08,JESSIE,gemGrab,Double Swoosh,0,8,11,19,864
6507,2023-01-08,JESSIE,brawlBall,Super Beach,0,4,10,14,732
6508,2023-01-08,JESSIE,brawlBall,Backyard Bowl,0,19,11,30,4830
6509,2023-01-08,JESSIE,bounty,Layer Cake,0,1,1,2,528
6510,2023-01-07,JESSIE,hotZone,Ring of Fire,0,9,2,11,846
6511,2023-01-07,JESSIE,heist,Tornado Ring,0,27,10,37,1350
6512,2023-01-07,JESSIE,gemGrab,Hard Rock Mine,0,6,3,9,1158
6513,2023-01-07,JESSIE,gemGrab,Deep Diner,0,13,7,20,918
6514,2023-01-07,JESSIE,brawlBall,Super Beach,2,15,23,40,2622
6515,2023-01-07,JESSIE,brawlBall,Sneaky Fields,0,1,0,1,402
6516,2023-01-07,JESSIE,bounty,Dry Season,0,2,0,2,1320
6517,2023-01-06,JESSIE,knockout,Out in the Open,0,3,1,4,1446
6518,2023-01-06,JESSIE,hotZone,Split,0,4,0,4,1158
6519,2023-01-06,JESSIE,heist,Tornado Ring,0,43,32,75,2538
6520,2023-01-06,JESSIE,gemGrab,Undermine,0,1,2,3,540
6521,2023-01-06,JESSIE,gemGrab,Deep Diner,0,20,3,23,2226
6522,2023-01-06,JESSIE,brawlBall,Sneaky Fields,0,5,6,11,4896
6523,2023-01-06,JESSIE,brawlBall,Pinhole Punt,0,1,1,2,510
6524,2023-01-06,JESSIE,bounty,Dry Season,0,2,0,2,1944
6525,2023-01-05,JESSIE,knockout,Out in the Open,0,2,1,3,2958
6526,2023-01-05,JESSIE,hotZone,Split,0,3,1,4,3552
6527,2023-01-05,JESSIE,heist,Kaboom Canyon,0,36,7,43,954
6528,2023-01-05,JESSIE,gemGrab,Undermine,0,20,5,25,1812
6529,2023-01-05,JESSIE,gemGrab,Gem Fort,0,1,3,4,252
6530,2023-01-05,JESSIE,brawlBall,Pinhole Punt,0,17,18,35,8118
6531,2023-01-05,JESSIE,bounty,Shooting Star,0,1,0,1,1362
6532,2023-01-04,JESSIE,knockout,Goldarm Gulch,0,2,0,2,696
6533,2023-01-04,JESSIE,hotZone,Parallel Plays,0,11,21,32,864
6534,2023-01-04,JESSIE,heist,Kaboom Canyon,1,59,38,98,1848
6535,2023-01-04,JESSIE,gemGrab,Gem Fort,0,12,8,20,1788
6536,2023-01-04,JESSIE,gemGrab,Crystal Arcade,0,7,4,11,642
6537,2023-01-04,JESSIE,brawlBall,Sunny Soccer,1,28,12,41,6312
6538,2023-01-04,JESSIE,brawlBall,Beach Ball,0,1,0,1,54
6539,2023-01-04,JESSIE,bounty,Shooting Star,0,3,1,4,3570
6540,2023-01-03,JESSIE,hotZone,Parallel Plays,2,17,7,26,1542
6541,2023-01-03,JESSIE,heist,Pit Stop,0,15,8,23,1956
6542,2023-01-03,JESSIE,gemGrab,Minecart Madness,0,3,0,3,456
6543,2023-01-03,JESSIE,gemGrab,Crystal Arcade,0,17,10,27,2406
6544,2023-01-03,JESSIE,brawlBall,Center Stage,0,2,0,2,294
6545,2023-01-03,JESSIE,brawlBall,Beach Ball,1,21,32,54,5580
6546,2023-01-03,JESSIE,bounty,Hideout,0,2,0,2,1638
6547,2023-01-02,JESSIE,knockout,Belle's Rock,0,3,0,3,1794
6548,2023-01-02,JESSIE,hotZone,Quarter Pounder,0,26,5,31,2652
6549,2023-01-02,JESSIE,hotZone,Controller Chaos,0,1,0,1,18
6550,2023-01-02,JESSIE,heist,Pit Stop,0,37,2,39,3498
6551,2023-01-02,JESSIE,heist,Kaboom Canyon,0,0,1,1,30
6552,2023-01-02,JESSIE,gemGrab,Minecart Madness,0,16,2,18,2352
6553,2023-01-02,JESSIE,gemGrab,Double Swoosh,0,7,4,11,1512
6554,2023-01-02,JESSIE,brawlBall,Center Stage,0,12,3,15,7110
6555,2023-01-02,JESSIE,brawlBall,Backyard Bowl,0,1,0,1,492
6556,2023-01-02,JESSIE,bounty,Hideout,0,3,1,4,3090
6557,2023-01-01,JESSIE,knockout,Belle's Rock,0,1,0,1,858
6558,2023-01-01,JESSIE,hotZone,Quarter Pounder,0,10,2,12,1188
6559,2023-01-01,JESSIE,heist,Kaboom Canyon,0,0,1,1,12
6560,2023-01-01,JESSIE,heist,Bridge Too Far,0,4,3,7,462
6561,2023-01-01,JESSIE,gemGrab,Double Swoosh,0,6,13,19,1140
6562,2023-01-01,JESSIE,brawlBall,Backyard Bowl,0,7,10,17,2658
6563,2023-01-01,JESSIE,bounty,Canal Grande,0,0,1,1,132
6564,2022-12-31,JESSIE,hotZone,Controller Chaos,0,3,0,3,198
6565,2022-12-31,JESSIE,heist,Bridge Too Far,0,2,0,2,276
6566,2022-12-31,JESSIE,gemGrab,Hard Rock Mine,0,1,0,1,384
6567,2022-12-31,JESSIE,gemGrab,Deep Diner,0,1,0,1,306
6568,2022-12-31,JESSIE,brawlBall,Super Beach,0,3,11,14,618
6569,2022-12-30,JESSIE,hotZone,Controller Chaos,0,3,2,5,288
6570,2022-12-30,JESSIE,gemGrab,Undermine,0,2,0,2,102
6571,2022-12-30,JESSIE,gemGrab,Deep Diner,0,9,1,10,438
6572,2022-12-30,JESSIE,brawlBall,Sneaky Fields,0,1,0,1,552
6573,2022-12-29,JESSIE,brawlBall,Pinhole Punt,0,2,3,5,282
6574,2022-12-27,JESSIE,heist,Safe Zone,0,1,0,1,12
6575,2022-12-27,JESSIE,heist,Kaboom Canyon,0,2,0,2,18
6576,2022-12-27,JESSIE,brawlBall,Beach Ball,0,1,1,2,144
6577,2022-12-26,JESSIE,heist,Kaboom Canyon,0,2,0,2,36
6578,2022-12-26,JESSIE,gemGrab,Minecart Madness,0,1,0,1,60
6579,2022-12-26,JESSIE,brawlBall,Center Stage,0,1,0,1,78
6580,2022-12-24,JESSIE,brawlBall,Super Beach,0,1,0,1,48
6581,2022-12-23,JESSIE,knockout,Out in the Open,0,0,1,1,132
6582,2022-12-22,JESSIE,brawlBall,Pinhole Punt,0,1,0,1,132
6583,2022-12-13,JESSIE,heist,Safe Zone,0,2,3,5,42
6584,2022-12-10,JESSIE,knockout,X Marks the Spot,0,2,0,2,12
6585,2022-12-10,JESSIE,hotZone,Ring of Fire,0,0,1,1,6
6586,2022-11-11,JESSIE,brawlBall,Sneaky Fields,0,1,0,1,42
6587,2022-11-01,JESSIE,knockout,New Perspective,0,1,0,1,54
6588,2022-10-30,JESSIE,heist,Safe Zone,0,1,0,1,6
6589,2022-10-30,JESSIE,brawlBall,Beach Ball,0,1,0,1,12
6590,2022-10-30,JESSIE,bounty,Canal Grande,0,1,0,1,12
6591,2022-10-15,JESSIE,gemGrab,Hard Rock Mine,0,0,2,2,90
6592,2023-01-28,JANET,knockout,Flaring Phoenix,0,34,47,81,12366
6593,2023-01-28,JANET,hotZone,Controller Chaos,0,23,53,76,10134
6594,2023-01-28,JANET,heist,Bridge Too Far,0,17,9,26,24240
6595,2023-01-28,JANET,gemGrab,Hard Rock Mine,0,84,133,217,16638
6596,2023-01-28,JANET,gemGrab,Deep Diner,0,33,44,77,5478
6597,2023-01-28,JANET,brawlBall,Super Beach,6,142,179,327,74430
6598,2023-01-28,JANET,brawlBall,Sneaky Fields,0,15,23,38,3582
6599,2023-01-28,JANET,bounty,Canal Grande,0,73,85,158,10902
6600,2023-01-27,JANET,knockout,Flaring Phoenix,0,10,10,20,5928
6601,2023-01-27,JANET,hotZone,Controller Chaos,0,12,12,24,2676
6602,2023-01-27,JANET,heist,Hot Potato,0,1,1,2,3486
6603,2023-01-27,JANET,gemGrab,Undermine,0,5,7,12,942
6604,2023-01-27,JANET,gemGrab,Deep Diner,0,38,41,79,6846
6605,2023-01-27,JANET,brawlBall,Sneaky Fields,4,45,65,114,23514
6606,2023-01-27,JANET,brawlBall,Pinhole Punt,0,0,1,1,738
6607,2023-01-27,JANET,bounty,Temple Ruins,0,10,6,16,1890
6608,2023-01-26,JANET,knockout,Riverside,2,54,25,81,19008
6609,2023-01-26,JANET,hotZone,Open Zone,0,51,75,126,10182
6610,2023-01-26,JANET,heist,Hot Potato,0,1,5,6,14610
6611,2023-01-26,JANET,gemGrab,Undermine,0,58,106,164,10062
6612,2023-01-26,JANET,gemGrab,Gem Fort,0,17,15,32,4674
6613,2023-01-26,JANET,brawlBall,Sunny Soccer,0,4,9,13,3660
6614,2023-01-26,JANET,brawlBall,Pinhole Punt,9,204,279,492,67338
6615,2023-01-26,JANET,bounty,Temple Ruins,0,45,59,104,5610
6616,2023-01-25,JANET,knockout,Riverside,0,20,17,37,9906
6617,2023-01-25,JANET,hotZone,Open Zone,0,29,33,62,5262
6618,2023-01-25,JANET,heist,Safe Zone,0,4,3,7,9156
6619,2023-01-25,JANET,gemGrab,Gem Fort,0,28,19,47,5556
6620,2023-01-25,JANET,gemGrab,Crystal Arcade,0,32,45,77,7866
6621,2023-01-25,JANET,brawlBall,Sunny Soccer,4,73,87,164,40830
6622,2023-01-25,JANET,brawlBall,Beach Ball,0,16,27,43,6408
6623,2023-01-25,JANET,bounty,Excel,0,13,14,27,5790
6624,2023-01-24,JANET,knockout,New Perspective,0,30,25,55,10542
6625,2023-01-24,JANET,hotZone,Dueling Beetles,0,62,84,146,10662
6626,2023-01-24,JANET,heist,Safe Zone,0,7,2,9,15750
6627,2023-01-24,JANET,gemGrab,Minecart Madness,0,19,40,59,4002
6628,2023-01-24,JANET,gemGrab,Crystal Arcade,0,60,67,127,14460
6629,2023-01-24,JANET,brawlBall,Center Stage,1,23,28,52,7860
6630,2023-01-24,JANET,brawlBall,Beach Ball,8,206,280,494,64614
6631,2023-01-24,JANET,bounty,Excel,0,37,36,73,10896
6632,2023-01-23,JANET,knockout,New Perspective,0,75,68,143,20676
6633,2023-01-23,JANET,hotZone,Dueling Beetles,0,103,155,258,17502
6634,2023-01-23,JANET,heist,Snaked Assault,0,6,3,9,15762
6635,2023-01-23,JANET,gemGrab,Minecart Madness,0,119,181,300,19062
6636,2023-01-23,JANET,gemGrab,Double Swoosh,0,56,73,129,7578
6637,2023-01-23,JANET,brawlBall,Center Stage,10,301,369,680,92862
6638,2023-01-23,JANET,brawlBall,Backyard Bowl,0,17,39,56,4224
6639,2023-01-23,JANET,bounty,Layer Cake,0,62,134,196,11142
6640,2023-01-22,JANET,knockout,X Marks the Spot,0,32,16,48,9174
6641,2023-01-22,JANET,hotZone,Ring of Fire,0,19,26,45,5730
6642,2023-01-22,JANET,heist,Snaked Assault,0,1,3,4,8232
6643,2023-01-22,JANET,gemGrab,Hard Rock Mine,0,14,9,23,4722
6644,2023-01-22,JANET,gemGrab,Double Swoosh,0,66,105,171,9426
6645,2023-01-22,JANET,brawlBall,Super Beach,1,23,26,50,7386
6646,2023-01-22,JANET,brawlBall,Backyard Bowl,3,103,128,234,34788
6647,2023-01-22,JANET,bounty,Layer Cake,0,24,18,42,6654
6648,2023-01-21,JANET,knockout,X Marks the Spot,0,135,106,241,31698
6649,2023-01-21,JANET,hotZone,Ring of Fire,0,63,68,131,16632
6650,2023-01-21,JANET,heist,Tornado Ring,0,6,3,9,11664
6651,2023-01-21,JANET,gemGrab,Hard Rock Mine,0,136,156,292,22980
6652,2023-01-21,JANET,gemGrab,Deep Diner,0,23,38,61,4470
6653,2023-01-21,JANET,brawlBall,Super Beach,5,169,166,340,101364
6654,2023-01-21,JANET,brawlBall,Sneaky Fields,0,7,3,10,3750
6655,2023-01-21,JANET,bounty,Dry Season,0,41,80,121,14538
6656,2023-01-20,JANET,knockout,Out in the Open,0,84,79,163,20106
6657,2023-01-20,JANET,hotZone,Split,0,27,26,53,9678
6658,2023-01-20,JANET,heist,Tornado Ring,0,4,2,6,12672
6659,2023-01-20,JANET,gemGrab,Undermine,0,29,24,53,5442
6660,2023-01-20,JANET,gemGrab,Deep Diner,0,101,128,229,19050
6661,2023-01-20,JANET,brawlBall,Sneaky Fields,9,174,192,375,74778
6662,2023-01-20,JANET,brawlBall,Pinhole Punt,0,5,4,9,2886
6663,2023-01-20,JANET,bounty,Dry Season,0,29,21,50,11640
6664,2023-01-19,JANET,knockout,Out in the Open,0,91,122,213,26574
6665,2023-01-19,JANET,hotZone,Split,0,14,7,21,14856
6666,2023-01-19,JANET,heist,Kaboom Canyon,0,8,3,11,6732
6667,2023-01-19,JANET,gemGrab,Undermine,0,67,88,155,14154
6668,2023-01-19,JANET,gemGrab,Gem Fort,0,7,22,29,2934
6669,2023-01-19,JANET,brawlBall,Sunny Soccer,0,4,2,6,2274
6670,2023-01-19,JANET,brawlBall,Pinhole Punt,7,251,329,587,72498
6671,2023-01-19,JANET,bounty,Shooting Star,0,23,34,57,11124
6672,2023-01-18,JANET,knockout,Goldarm Gulch,0,18,31,49,2784
6673,2023-01-18,JANET,hotZone,Parallel Plays,0,3,16,19,1158
6674,2023-01-18,JANET,heist,Kaboom Canyon,0,1,1,2,2592
6675,2023-01-18,JANET,gemGrab,Gem Fort,0,11,15,26,3006
6676,2023-01-18,JANET,gemGrab,Crystal Arcade,0,6,7,13,990
6677,2023-01-18,JANET,brawlBall,Sunny Soccer,2,58,77,137,18941
6678,2023-01-18,JANET,brawlBall,Beach Ball,0,3,0,3,774
6679,2023-01-18,JANET,bounty,Shooting Star,0,17,22,39,5088
6680,2023-01-17,JANET,knockout,Goldarm Gulch,0,8,6,14,2520
6681,2023-01-17,JANET,hotZone,Parallel Plays,0,3,4,7,1038
6682,2023-01-17,JANET,heist,Pit Stop,0,0,1,1,1290
6683,2023-01-17,JANET,gemGrab,Minecart Madness,0,1,2,3,216
6684,2023-01-17,JANET,gemGrab,Crystal Arcade,0,15,12,27,1266
6685,2023-01-17,JANET,brawlBall,Center Stage,0,1,0,1,288
6686,2023-01-17,JANET,brawlBall,Beach Ball,1,10,13,24,5886
6687,2023-01-17,JANET,bounty,Hideout,0,3,1,4,750
6688,2023-01-16,JANET,knockout,Belle's Rock,0,10,16,26,1788
6689,2023-01-16,JANET,hotZone,Quarter Pounder,0,4,0,4,1494
6690,2023-01-16,JANET,heist,Pit Stop,0,0,1,1,4044
6691,2023-01-16,JANET,gemGrab,Minecart Madness,0,8,7,15,1422
6692,2023-01-16,JANET,gemGrab,Double Swoosh,0,8,1,9,708
6693,2023-01-16,JANET,brawlBall,Center Stage,0,16,36,52,5778
6694,2023-01-16,JANET,brawlBall,Backyard Bowl,0,3,6,9,852
6695,2023-01-16,JANET,bounty,Hideout,0,11,18,29,1470
6696,2023-01-15,JANET,knockout,Belle's Rock,0,9,24,33,2904
6697,2023-01-15,JANET,hotZone,Quarter Pounder,0,12,9,21,3318
6698,2023-01-15,JANET,heist,Bridge Too Far,0,1,0,1,2736
6699,2023-01-15,JANET,gemGrab,Hard Rock Mine,0,3,0,3,1014
6700,2023-01-15,JANET,gemGrab,Double Swoosh,0,12,57,69,2178
6701,2023-01-15,JANET,brawlBall,Super Beach,0,1,0,1,1074
6702,2023-01-15,JANET,brawlBall,Backyard Bowl,0,27,32,59,8946
6703,2023-01-15,JANET,bounty,Canal Grande,0,5,4,9,960
6704,2023-01-14,JANET,knockout,Flaring Phoenix,0,2,1,3,1080
6705,2023-01-14,JANET,hotZone,Controller Chaos,0,9,6,15,2772
6706,2023-01-14,JANET,heist,Bridge Too Far,0,1,0,1,4020
6707,2023-01-14,JANET,gemGrab,Hard Rock Mine,0,3,6,9,1272
6708,2023-01-14,JANET,gemGrab,Deep Diner,0,6,1,7,858
6709,2023-01-14,JANET,brawlBall,Super Beach,0,10,3,13,6336
6710,2023-01-14,JANET,brawlBall,Sneaky Fields,0,1,0,1,918
6711,2023-01-14,JANET,bounty,Canal Grande,0,2,7,9,1014
6712,2023-01-13,JANET,knockout,Flaring Phoenix,0,2,3,5,1182
6713,2023-01-13,JANET,hotZone,Controller Chaos,0,7,5,12,2928
6714,2023-01-13,JANET,heist,Hot Potato,0,1,0,1,600
6715,2023-01-13,JANET,gemGrab,Deep Diner,0,6,6,12,1650
6716,2023-01-13,JANET,brawlBall,Sneaky Fields,0,12,5,17,6144
6717,2023-01-13,JANET,bounty,Temple Ruins,0,1,0,1,270
6718,2023-01-12,JANET,knockout,Riverside,0,3,0,3,2532
6719,2023-01-12,JANET,hotZone,Open Zone,0,5,13,18,1488
6720,2023-01-12,JANET,gemGrab,Undermine,0,7,20,27,690
6721,2023-01-12,JANET,brawlBall,Sunny Soccer,0,1,0,1,240
6722,2023-01-12,JANET,brawlBall,Pinhole Punt,0,12,30,42,2292
6723,2023-01-12,JANET,bounty,Temple Ruins,0,1,0,1,24
6724,2023-01-11,JANET,hotZone,Open Zone,0,2,7,9,462
6725,2023-01-11,JANET,gemGrab,Gem Fort,0,3,1,4,414
6726,2023-01-11,JANET,brawlBall,Sunny Soccer,1,1,4,6,1638
6727,2023-01-10,JANET,knockout,New Perspective,0,4,2,6,720
6728,2023-01-10,JANET,hotZone,Dueling Beetles,0,6,4,10,2424
6729,2023-01-10,JANET,heist,Safe Zone,0,0,1,1,1176
6730,2023-01-10,JANET,gemGrab,Minecart Madness,0,6,23,29,828
6731,2023-01-10,JANET,gemGrab,Crystal Arcade,0,3,20,23,1746
6732,2023-01-10,JANET,brawlBall,Center Stage,0,3,0,3,708
6733,2023-01-10,JANET,brawlBall,Beach Ball,1,9,54,64,4392
6734,2023-01-09,JANET,knockout,New Perspective,0,3,3,6,876
6735,2023-01-09,JANET,hotZone,Dueling Beetles,0,6,0,6,1554
6736,2023-01-09,JANET,gemGrab,Minecart Madness,0,2,11,13,1884
6737,2023-01-09,JANET,gemGrab,Double Swoosh,0,8,26,34,1320
6738,2023-01-09,JANET,brawlBall,Center Stage,2,10,21,33,5460
6739,2023-01-09,JANET,bounty,Layer Cake,0,4,14,18,1512
6740,2023-01-08,JANET,knockout,X Marks the Spot,0,17,12,29,1692
6741,2023-01-08,JANET,hotZone,Ring of Fire,0,1,3,4,1644
6742,2023-01-08,JANET,gemGrab,Hard Rock Mine,0,4,2,6,630
6743,2023-01-08,JANET,gemGrab,Double Swoosh,0,4,8,12,864
6744,2023-01-08,JANET,brawlBall,Backyard Bowl,1,14,8,23,4830
6745,2023-01-08,JANET,bounty,Layer Cake,0,7,27,34,528
6746,2023-01-07,JANET,knockout,X Marks the Spot,0,2,0,2,1014
6747,2023-01-07,JANET,hotZone,Ring of Fire,0,5,3,8,846
6748,2023-01-07,JANET,heist,Tornado Ring,0,1,0,1,1350
6749,2023-01-07,JANET,gemGrab,Hard Rock Mine,0,3,1,4,1158
6750,2023-01-07,JANET,gemGrab,Deep Diner,0,5,4,9,918
6751,2023-01-07,JANET,brawlBall,Super Beach,0,2,5,7,2622
6752,2023-01-07,JANET,bounty,Dry Season,0,8,14,22,1320
6753,2023-01-06,JANET,knockout,Out in the Open,0,4,2,6,1446
6754,2023-01-06,JANET,hotZone,Split,0,1,1,2,1158
6755,2023-01-06,JANET,heist,Tornado Ring,0,1,0,1,2538
6756,2023-01-06,JANET,gemGrab,Undermine,0,2,2,4,540
6757,2023-01-06,JANET,gemGrab,Deep Diner,0,14,2,16,2226
6758,2023-01-06,JANET,brawlBall,Sneaky Fields,0,5,3,8,4896
6759,2023-01-06,JANET,brawlBall,Pinhole Punt,0,1,5,6,510
6760,2023-01-06,JANET,bounty,Dry Season,0,7,3,10,1944
6761,2023-01-05,JANET,knockout,Out in the Open,0,7,28,35,2958
6762,2023-01-05,JANET,hotZone,Split,0,10,11,21,3552
6763,2023-01-05,JANET,heist,Kaboom Canyon,0,1,0,1,954
6764,2023-01-05,JANET,gemGrab,Undermine,0,13,27,40,1812
6765,2023-01-05,JANET,gemGrab,Gem Fort,0,1,0,1,252
6766,2023-01-05,JANET,brawlBall,Sunny Soccer,0,1,0,1,84
6767,2023-01-05,JANET,brawlBall,Pinhole Punt,0,24,40,64,8118
6768,2023-01-05,JANET,bounty,Shooting Star,0,2,2,4,1362
6769,2023-01-04,JANET,knockout,Goldarm Gulch,0,2,1,3,696
6770,2023-01-04,JANET,hotZone,Parallel Plays,0,5,22,27,864
6771,2023-01-04,JANET,heist,Kaboom Canyon,0,4,0,4,1848
6772,2023-01-04,JANET,gemGrab,Gem Fort,0,5,0,5,1788
6773,2023-01-04,JANET,gemGrab,Crystal Arcade,0,4,17,21,642
6774,2023-01-04,JANET,brawlBall,Sunny Soccer,0,8,5,13,6312
6775,2023-01-04,JANET,bounty,Shooting Star,0,3,1,4,3570
6776,2023-01-03,JANET,knockout,Goldarm Gulch,0,3,3,6,720
6777,2023-01-03,JANET,hotZone,Parallel Plays,1,14,36,51,1542
6778,2023-01-03,JANET,gemGrab,Minecart Madness,0,1,2,3,456
6779,2023-01-03,JANET,gemGrab,Crystal Arcade,0,14,6,20,2406
6780,2023-01-03,JANET,brawlBall,Center Stage,0,2,11,13,294
6781,2023-01-03,JANET,brawlBall,Beach Ball,1,16,62,79,5580
6782,2023-01-03,JANET,bounty,Hideout,0,6,20,26,1638
6783,2023-01-02,JANET,knockout,Belle's Rock,0,6,2,8,1794
6784,2023-01-02,JANET,hotZone,Quarter Pounder,0,10,18,28,2652
6785,2023-01-02,JANET,heist,Pit Stop,0,1,0,1,3498
6786,2023-01-02,JANET,heist,Kaboom Canyon,0,0,1,1,30
6787,2023-01-02,JANET,gemGrab,Minecart Madness,0,12,17,29,2352
6788,2023-01-02,JANET,gemGrab,Double Swoosh,0,11,19,30,1512
6789,2023-01-02,JANET,brawlBall,Center Stage,2,12,36,50,7110
6790,2023-01-02,JANET,brawlBall,Backyard Bowl,0,1,1,2,492
6791,2023-01-02,JANET,bounty,Hideout,0,10,23,33,3090
6792,2023-01-01,JANET,knockout,Belle's Rock,0,11,13,24,858
6793,2023-01-01,JANET,hotZone,Quarter Pounder,0,7,10,17,1188
6794,2023-01-01,JANET,gemGrab,Double Swoosh,0,8,7,15,1140
6795,2023-01-01,JANET,brawlBall,Backyard Bowl,0,11,3,14,2658
6796,2023-01-01,JANET,bounty,Canal Grande,0,6,8,14,132
6797,2022-12-31,JANET,hotZone,Controller Chaos,0,1,0,1,198
6798,2022-12-31,JANET,gemGrab,Minecart Madness,0,0,1,1,24
6799,2022-12-31,JANET,gemGrab,Hard Rock Mine,0,1,0,1,384
6800,2022-12-31,JANET,gemGrab,Deep Diner,0,2,0,2,306
6801,2022-12-31,JANET,brawlBall,Super Beach,0,0,1,1,618
6802,2022-12-31,JANET,bounty,Canal Grande,0,3,3,6,54
6803,2022-12-30,JANET,knockout,Flaring Phoenix,0,0,1,1,72
6804,2022-12-30,JANET,brawlBall,Sneaky Fields,0,0,2,2,552
6805,2022-12-29,JANET,gemGrab,Undermine,0,1,0,1,102
6806,2022-12-29,JANET,gemGrab,Minecart Madness,0,1,0,1,24
6807,2022-12-29,JANET,gemGrab,Gem Fort,0,1,1,2,30
6808,2022-12-28,JANET,hotZone,Open Zone,0,0,1,1,108
6809,2022-12-27,JANET,brawlBall,Center Stage,0,0,1,1,30
6810,2022-12-25,JANET,gemGrab,Double Swoosh,0,2,3,5,30
6811,2022-12-23,JANET,knockout,Out in the Open,0,1,1,2,132
6812,2022-12-22,JANET,brawlBall,Pinhole Punt,0,0,1,1,132
6813,2022-12-16,JANET,gemGrab,Undermine,0,0,1,1,6
6814,2022-12-13,JANET,gemGrab,Crystal Arcade,0,1,0,1,72
6815,2022-10-28,JANET,knockout,Out in the Open,0,1,1,2,18
6816,2022-10-28,JANET,hotZone,Dueling Beetles,0,0,2,2,12
6817,2022-10-28,JANET,bounty,Canal Grande,0,0,2,2,12
6818,2022-10-15,JANET,hotZone,Ring of Fire,0,0,1,1,24
6819,2023-01-28,JACKY,knockout,Flaring Phoenix,3,172,274,449,12366
6820,2023-01-28,JACKY,hotZone,Controller Chaos,0,27,7,34,10134
6821,2023-01-28,JACKY,heist,Bridge Too Far,0,13,4,17,24240
6822,2023-01-28,JACKY,gemGrab,Hard Rock Mine,0,48,45,93,16638
6823,2023-01-28,JACKY,gemGrab,Deep Diner,0,7,0,7,5478
6824,2023-01-28,JACKY,brawlBall,Super Beach,39,937,1110,2086,74430
6825,2023-01-28,JACKY,brawlBall,Sneaky Fields,1,88,73,162,3582
6826,2023-01-28,JACKY,bounty,Canal Grande,0,93,127,220,10902
6827,2023-01-27,JACKY,knockout,Flaring Phoenix,1,101,151,253,5928
6828,2023-01-27,JACKY,hotZone,Controller Chaos,0,10,6,16,2676
6829,2023-01-27,JACKY,heist,Hot Potato,0,3,1,4,3486
6830,2023-01-27,JACKY,gemGrab,Undermine,0,2,1,3,942
6831,2023-01-27,JACKY,gemGrab,Deep Diner,0,11,9,20,6846
6832,2023-01-27,JACKY,brawlBall,Sneaky Fields,18,540,575,1133,23514
6833,2023-01-27,JACKY,brawlBall,Pinhole Punt,0,3,12,15,738
6834,2023-01-27,JACKY,bounty,Temple Ruins,0,2,0,2,1890
6835,2023-01-26,JACKY,knockout,Riverside,0,6,2,8,19008
6836,2023-01-26,JACKY,hotZone,Open Zone,0,3,2,5,10182
6837,2023-01-26,JACKY,heist,Hot Potato,0,19,9,28,14610
6838,2023-01-26,JACKY,gemGrab,Undermine,0,29,13,42,10062
6839,2023-01-26,JACKY,gemGrab,Gem Fort,0,19,28,47,4674
6840,2023-01-26,JACKY,brawlBall,Sunny Soccer,0,39,40,79,3660
6841,2023-01-26,JACKY,brawlBall,Pinhole Punt,8,403,386,797,67338
6842,2023-01-26,JACKY,bounty,Temple Ruins,0,26,21,47,5610
6843,2023-01-25,JACKY,knockout,Riverside,0,7,0,7,9906
6844,2023-01-25,JACKY,hotZone,Open Zone,0,3,0,3,5262
6845,2023-01-25,JACKY,heist,Safe Zone,0,4,0,4,9156
6846,2023-01-25,JACKY,gemGrab,Gem Fort,0,40,21,61,5556
6847,2023-01-25,JACKY,gemGrab,Crystal Arcade,0,17,14,31,7866
6848,2023-01-25,JACKY,brawlBall,Sunny Soccer,10,416,546,972,40830
6849,2023-01-25,JACKY,brawlBall,Beach Ball,1,67,47,115,6408
6850,2023-01-25,JACKY,bounty,Excel,0,6,6,12,5790
6851,2023-01-24,JACKY,knockout,New Perspective,1,140,228,369,10542
6852,2023-01-24,JACKY,hotZone,Dueling Beetles,0,33,18,51,10662
6853,2023-01-24,JACKY,heist,Safe Zone,0,7,4,11,15750
6854,2023-01-24,JACKY,gemGrab,Minecart Madness,0,3,2,5,4002
6855,2023-01-24,JACKY,gemGrab,Crystal Arcade,0,20,34,54,14460
6856,2023-01-24,JACKY,brawlBall,Center Stage,5,81,95,181,7860
6857,2023-01-24,JACKY,brawlBall,Beach Ball,17,601,594,1212,64614
6858,2023-01-24,JACKY,bounty,Excel,0,36,39,75,10896
6859,2023-01-23,JACKY,knockout,New Perspective,2,459,605,1066,20676
6860,2023-01-23,JACKY,hotZone,Dueling Beetles,0,50,16,66,17502
6861,2023-01-23,JACKY,heist,Snaked Assault,0,14,2,16,15762
6862,2023-01-23,JACKY,gemGrab,Minecart Madness,0,10,8,18,19062
6863,2023-01-23,JACKY,gemGrab,Double Swoosh,0,45,18,63,7578
6864,2023-01-23,JACKY,brawlBall,Center Stage,51,1388,1420,2859,92862
6865,2023-01-23,JACKY,brawlBall,Backyard Bowl,0,6,3,9,4224
6866,2023-01-23,JACKY,bounty,Layer Cake,0,28,26,54,11142
6867,2023-01-22,JACKY,knockout,X Marks the Spot,2,186,244,432,9174
6868,2023-01-22,JACKY,hotZone,Ring of Fire,0,8,7,15,5730
6869,2023-01-22,JACKY,heist,Snaked Assault,0,6,6,12,8232
6870,2023-01-22,JACKY,gemGrab,Hard Rock Mine,0,17,18,35,4722
6871,2023-01-22,JACKY,gemGrab,Double Swoosh,0,51,32,83,9426
6872,2023-01-22,JACKY,brawlBall,Super Beach,5,103,106,214,7386
6873,2023-01-22,JACKY,brawlBall,Backyard Bowl,1,67,40,108,34788
6874,2023-01-22,JACKY,bounty,Layer Cake,0,25,32,57,6654
6875,2023-01-21,JACKY,knockout,X Marks the Spot,2,750,898,1650,31698
6876,2023-01-21,JACKY,hotZone,Ring of Fire,0,25,54,79,16632
6877,2023-01-21,JACKY,heist,Tornado Ring,0,16,11,27,11664
6878,2023-01-21,JACKY,gemGrab,Hard Rock Mine,0,80,61,141,22980
6879,2023-01-21,JACKY,gemGrab,Deep Diner,0,20,9,29,4470
6880,2023-01-21,JACKY,brawlBall,Super Beach,35,1196,1347,2578,101364
6881,2023-01-21,JACKY,brawlBall,Sneaky Fields,1,94,105,200,3750
6882,2023-01-21,JACKY,bounty,Dry Season,0,14,7,21,14538
6883,2023-01-20,JACKY,knockout,Out in the Open,8,297,509,814,20106
6884,2023-01-20,JACKY,hotZone,Split,0,41,74,115,9678
6885,2023-01-20,JACKY,heist,Tornado Ring,0,10,8,18,12672
6886,2023-01-20,JACKY,gemGrab,Undermine,0,12,3,15,5442
6887,2023-01-20,JACKY,gemGrab,Deep Diner,0,22,15,37,19050
6888,2023-01-20,JACKY,brawlBall,Sneaky Fields,47,1860,2216,4123,74778
6889,2023-01-20,JACKY,brawlBall,Pinhole Punt,0,22,19,41,2886
6890,2023-01-20,JACKY,bounty,Dry Season,0,1,14,15,11640
6891,2023-01-19,JACKY,knockout,Out in the Open,11,696,1005,1712,26574
6892,2023-01-19,JACKY,hotZone,Split,0,62,46,108,14856
6893,2023-01-19,JACKY,heist,Kaboom Canyon,0,10,3,13,6732
6894,2023-01-19,JACKY,gemGrab,Undermine,0,46,24,70,14154
6895,2023-01-19,JACKY,gemGrab,Gem Fort,0,14,13,27,2934
6896,2023-01-19,JACKY,brawlBall,Sunny Soccer,0,20,23,43,2274
6897,2023-01-19,JACKY,brawlBall,Pinhole Punt,14,427,454,895,72498
6898,2023-01-19,JACKY,bounty,Shooting Star,0,6,0,6,11124
6899,2023-01-18,JACKY,knockout,Goldarm Gulch,3,49,46,98,2784
6900,2023-01-18,JACKY,hotZone,Parallel Plays,0,5,7,12,1158
6901,2023-01-18,JACKY,heist,Kaboom Canyon,0,3,0,3,2592
6902,2023-01-18,JACKY,gemGrab,Gem Fort,0,14,16,30,3006
6903,2023-01-18,JACKY,gemGrab,Crystal Arcade,0,2,0,2,990
6904,2023-01-18,JACKY,brawlBall,Sunny Soccer,7,183,194,384,18941
6905,2023-01-18,JACKY,brawlBall,Beach Ball,0,4,8,12,774
6906,2023-01-18,JACKY,bounty,Shooting Star,0,1,0,1,5088
6907,2023-01-17,JACKY,knockout,Goldarm Gulch,0,35,73,108,2520
6908,2023-01-17,JACKY,hotZone,Parallel Plays,0,6,3,9,1038
6909,2023-01-17,JACKY,heist,Pit Stop,0,0,1,1,1290
6910,2023-01-17,JACKY,gemGrab,Crystal Arcade,0,4,5,9,1266
6911,2023-01-17,JACKY,brawlBall,Center Stage,1,5,9,15,288
6912,2023-01-17,JACKY,brawlBall,Beach Ball,2,41,50,93,5886
6913,2023-01-16,JACKY,knockout,Belle's Rock,0,18,32,50,1788
6914,2023-01-16,JACKY,hotZone,Quarter Pounder,0,2,0,2,1494
6915,2023-01-16,JACKY,heist,Pit Stop,0,2,0,2,4044
6916,2023-01-16,JACKY,gemGrab,Minecart Madness,0,1,1,2,1422
6917,2023-01-16,JACKY,gemGrab,Double Swoosh,0,5,1,6,708
6918,2023-01-16,JACKY,brawlBall,Center Stage,3,103,95,201,5778
6919,2023-01-16,JACKY,brawlBall,Backyard Bowl,0,1,1,2,852
6920,2023-01-16,JACKY,bounty,Hideout,0,3,2,5,1470
6921,2023-01-15,JACKY,knockout,Belle's Rock,0,31,28,59,2904
6922,2023-01-15,JACKY,hotZone,Quarter Pounder,0,12,1,13,3318
6923,2023-01-15,JACKY,gemGrab,Hard Rock Mine,0,5,13,18,1014
6924,2023-01-15,JACKY,gemGrab,Double Swoosh,0,16,6,22,2178
6925,2023-01-15,JACKY,brawlBall,Super Beach,1,18,11,30,1074
6926,2023-01-15,JACKY,brawlBall,Backyard Bowl,0,17,8,25,8946
6927,2023-01-15,JACKY,bounty,Canal Grande,0,10,9,19,960
6928,2023-01-14,JACKY,knockout,Flaring Phoenix,1,20,41,62,1080
6929,2023-01-14,JACKY,hotZone,Controller Chaos,0,5,2,7,2772
6930,2023-01-14,JACKY,heist,Bridge Too Far,0,1,0,1,4020
6931,2023-01-14,JACKY,gemGrab,Hard Rock Mine,0,5,2,7,1272
6932,2023-01-14,JACKY,brawlBall,Super Beach,6,97,112,215,6336
6933,2023-01-14,JACKY,brawlBall,Sneaky Fields,0,40,29,69,918
6934,2023-01-14,JACKY,bounty,Canal Grande,0,11,18,29,1014
6935,2023-01-13,JACKY,knockout,Flaring Phoenix,0,13,19,32,1182
6936,2023-01-13,JACKY,hotZone,Controller Chaos,0,5,0,5,2928
6937,2023-01-13,JACKY,gemGrab,Deep Diner,0,2,0,2,1650
6938,2023-01-13,JACKY,brawlBall,Sneaky Fields,2,171,173,346,6144
6939,2023-01-13,JACKY,brawlBall,Pinhole Punt,0,1,1,2,156
6940,2023-01-13,JACKY,bounty,Temple Ruins,0,0,3,3,270
6941,2023-01-12,JACKY,hotZone,Open Zone,0,3,0,3,1488
6942,2023-01-12,JACKY,gemGrab,Undermine,0,4,1,5,690
6943,2023-01-12,JACKY,gemGrab,Gem Fort,0,1,0,1,162
6944,2023-01-12,JACKY,brawlBall,Sunny Soccer,0,1,0,1,240
6945,2023-01-12,JACKY,brawlBall,Pinhole Punt,0,21,11,32,2292
6946,2023-01-11,JACKY,gemGrab,Gem Fort,0,3,12,15,414
6947,2023-01-11,JACKY,brawlBall,Sunny Soccer,0,19,18,37,1638
6948,2023-01-11,JACKY,brawlBall,Beach Ball,0,1,0,1,48
6949,2023-01-10,JACKY,knockout,New Perspective,0,12,13,25,720
6950,2023-01-10,JACKY,hotZone,Dueling Beetles,0,9,0,9,2424
6951,2023-01-10,JACKY,gemGrab,Crystal Arcade,0,6,4,10,1746
6952,2023-01-10,JACKY,brawlBall,Center Stage,0,17,5,22,708
6953,2023-01-10,JACKY,brawlBall,Beach Ball,0,54,15,69,4392
6954,2023-01-10,JACKY,bounty,Excel,0,2,2,4,330
6955,2023-01-09,JACKY,knockout,New Perspective,0,27,28,55,876
6956,2023-01-09,JACKY,hotZone,Dueling Beetles,0,12,1,13,1554
6957,2023-01-09,JACKY,heist,Snaked Assault,0,3,0,3,2022
6958,2023-01-09,JACKY,gemGrab,Minecart Madness,0,1,0,1,1884
6959,2023-01-09,JACKY,gemGrab,Double Swoosh,0,3,2,5,1320
6960,2023-01-09,JACKY,brawlBall,Center Stage,3,113,108,224,5460
6961,2023-01-09,JACKY,brawlBall,Backyard Bowl,0,1,0,1,474
6962,2023-01-09,JACKY,bounty,Layer Cake,0,3,1,4,1512
6963,2023-01-08,JACKY,knockout,X Marks the Spot,0,41,90,131,1692
6964,2023-01-08,JACKY,hotZone,Ring of Fire,0,2,0,2,1644
6965,2023-01-08,JACKY,gemGrab,Hard Rock Mine,0,4,0,4,630
6966,2023-01-08,JACKY,gemGrab,Double Swoosh,0,4,0,4,864
6967,2023-01-08,JACKY,brawlBall,Super Beach,0,5,8,13,732
6968,2023-01-08,JACKY,brawlBall,Backyard Bowl,1,13,3,17,4830
6969,2023-01-08,JACKY,bounty,Layer Cake,0,0,1,1,528
6970,2023-01-07,JACKY,knockout,X Marks the Spot,0,27,36,63,1014
6971,2023-01-07,JACKY,hotZone,Ring of Fire,0,1,0,1,846
6972,2023-01-07,JACKY,heist,Tornado Ring,0,3,0,3,1350
6973,2023-01-07,JACKY,gemGrab,Hard Rock Mine,0,0,1,1,1158
6974,2023-01-07,JACKY,gemGrab,Deep Diner,0,2,0,2,918
6975,2023-01-07,JACKY,brawlBall,Super Beach,0,44,6,50,2622
6976,2023-01-07,JACKY,brawlBall,Sneaky Fields,0,13,3,16,402
6977,2023-01-07,JACKY,bounty,Dry Season,0,1,2,3,1320
6978,2023-01-06,JACKY,knockout,Out in the Open,0,44,62,106,1446
6979,2023-01-06,JACKY,hotZone,Split,0,6,0,6,1158
6980,2023-01-06,JACKY,heist,Tornado Ring,0,1,2,3,2538
6981,2023-01-06,JACKY,gemGrab,Undermine,0,0,1,1,540
6982,2023-01-06,JACKY,gemGrab,Deep Diner,0,1,2,3,2226
6983,2023-01-06,JACKY,brawlBall,Sneaky Fields,4,143,88,235,4896
6984,2023-01-06,JACKY,brawlBall,Pinhole Punt,0,4,1,5,510
6985,2023-01-06,JACKY,bounty,Dry Season,0,4,3,7,1944
6986,2023-01-05,JACKY,knockout,Out in the Open,2,68,115,185,2958
6987,2023-01-05,JACKY,hotZone,Split,0,22,19,41,3552
6988,2023-01-05,JACKY,heist,Kaboom Canyon,0,1,0,1,954
6989,2023-01-05,JACKY,gemGrab,Undermine,0,2,1,3,1812
6990,2023-01-05,JACKY,gemGrab,Gem Fort,0,2,0,2,252
6991,2023-01-05,JACKY,brawlBall,Pinhole Punt,1,53,6,60,8118
6992,2023-01-05,JACKY,bounty,Shooting Star,0,1,0,1,1362
6993,2023-01-04,JACKY,knockout,Goldarm Gulch,0,7,2,9,696
6994,2023-01-04,JACKY,hotZone,Parallel Plays,0,3,0,3,864
6995,2023-01-04,JACKY,heist,Kaboom Canyon,0,0,1,1,1848
6996,2023-01-04,JACKY,gemGrab,Gem Fort,0,5,6,11,1788
6997,2023-01-04,JACKY,gemGrab,Crystal Arcade,0,1,0,1,642
6998,2023-01-04,JACKY,brawlBall,Sunny Soccer,0,59,38,97,6312
6999,2023-01-04,JACKY,brawlBall,Beach Ball,0,0,1,1,54
7000,2023-01-03,JACKY,knockout,Goldarm Gulch,0,9,9,18,720
7001,2023-01-03,JACKY,hotZone,Parallel Plays,0,5,0,5,1542
7002,2023-01-03,JACKY,heist,Pit Stop,0,1,0,1,1956
7003,2023-01-03,JACKY,gemGrab,Crystal Arcade,0,8,14,22,2406
7004,2023-01-03,JACKY,brawlBall,Beach Ball,0,56,14,70,5580
7005,2023-01-03,JACKY,bounty,Hideout,0,1,0,1,1638
7006,2023-01-02,JACKY,knockout,Belle's Rock,0,10,23,33,1794
7007,2023-01-02,JACKY,hotZone,Quarter Pounder,0,11,9,20,2652
7008,2023-01-02,JACKY,heist,Pit Stop,0,3,0,3,3498
7009,2023-01-02,JACKY,gemGrab,Minecart Madness,0,1,1,2,2352
7010,2023-01-02,JACKY,gemGrab,Double Swoosh,0,2,2,4,1512
7011,2023-01-02,JACKY,brawlBall,Center Stage,2,112,77,191,7110
7012,2023-01-02,JACKY,bounty,Hideout,0,2,1,3,3090
7013,2023-01-01,JACKY,knockout,Belle's Rock,0,3,12,15,858
7014,2023-01-01,JACKY,hotZone,Quarter Pounder,0,1,0,1,1188
7015,2023-01-01,JACKY,gemGrab,Minecart Madness,0,0,1,1,12
7016,2023-01-01,JACKY,gemGrab,Double Swoosh,0,3,4,7,1140
7017,2023-01-01,JACKY,brawlBall,Backyard Bowl,0,10,4,14,2658
7018,2023-01-01,JACKY,bounty,Canal Grande,0,0,1,1,132
7019,2022-12-31,JACKY,hotZone,Controller Chaos,0,1,0,1,198
7020,2022-12-31,JACKY,gemGrab,Hard Rock Mine,0,1,0,1,384
7021,2022-12-31,JACKY,gemGrab,Deep Diner,0,0,1,1,306
7022,2022-12-31,JACKY,brawlBall,Super Beach,0,10,7,17,618
7023,2022-12-31,JACKY,brawlBall,Sneaky Fields,0,0,1,1,60
7024,2022-12-31,JACKY,bounty,Canal Grande,0,1,0,1,54
7025,2022-12-30,JACKY,hotZone,Controller Chaos,0,3,0,3,288
7026,2022-12-30,JACKY,heist,Kaboom Canyon,0,1,1,2,18
7027,2022-12-30,JACKY,gemGrab,Minecart Madness,0,1,0,1,24
7028,2022-12-30,JACKY,brawlBall,Sneaky Fields,0,7,7,14,552
7029,2022-12-29,JACKY,brawlBall,Pinhole Punt,0,1,1,2,282
7030,2022-12-28,JACKY,brawlBall,Sunny Soccer,0,1,1,2,42
7031,2022-12-27,JACKY,brawlBall,Beach Ball,0,0,2,2,144
7032,2022-12-26,JACKY,gemGrab,Minecart Madness,0,1,0,1,60
7033,2022-12-26,JACKY,brawlBall,Center Stage,0,0,1,1,78
7034,2022-12-24,JACKY,brawlBall,Super Beach,0,1,1,2,48
7035,2022-12-23,JACKY,brawlBall,Sneaky Fields,0,1,0,1,12
7036,2022-12-22,JACKY,brawlBall,Pinhole Punt,0,1,0,1,132
7037,2022-12-21,JACKY,brawlBall,Sunny Soccer,0,1,0,1,54
7038,2022-12-19,JACKY,brawlBall,Center Stage,0,1,0,1,102
7039,2022-12-16,JACKY,gemGrab,Undermine,0,1,0,1,6
7040,2022-12-16,JACKY,brawlBall,Sneaky Fields,0,1,0,1,84
7041,2022-11-11,JACKY,brawlBall,Sneaky Fields,0,3,1,4,42
7042,2022-10-30,JACKY,bounty,Canal Grande,0,0,2,2,12
7043,2022-10-28,JACKY,hotZone,Dueling Beetles,0,1,0,1,12
7044,2023-01-28,GUS,knockout,Flaring Phoenix,0,40,51,91,12366
7045,2023-01-28,GUS,hotZone,Controller Chaos,0,24,29,53,10134
7046,2023-01-28,GUS,heist,Bridge Too Far,0,56,68,124,24240
7047,2023-01-28,GUS,gemGrab,Hard Rock Mine,0,120,136,256,16638
7048,2023-01-28,GUS,gemGrab,Deep Diner,0,33,42,75,5478
7049,2023-01-28,GUS,brawlBall,Super Beach,5,234,248,487,74430
7050,2023-01-28,GUS,brawlBall,Sneaky Fields,0,8,11,19,3582
7051,2023-01-28,GUS,bounty,Canal Grande,0,21,27,48,10902
7052,2023-01-27,GUS,knockout,Flaring Phoenix,0,26,23,49,5928
7053,2023-01-27,GUS,hotZone,Controller Chaos,0,11,11,22,2676
7054,2023-01-27,GUS,heist,Hot Potato,0,1,1,2,3486
7055,2023-01-27,GUS,gemGrab,Undermine,0,8,11,19,942
7056,2023-01-27,GUS,gemGrab,Deep Diner,0,55,89,144,6846
7057,2023-01-27,GUS,brawlBall,Sneaky Fields,1,59,53,113,23514
7058,2023-01-27,GUS,brawlBall,Pinhole Punt,0,1,4,5,738
7059,2023-01-27,GUS,bounty,Temple Ruins,0,15,29,44,1890
7060,2023-01-26,GUS,knockout,Riverside,1,232,381,614,19008
7061,2023-01-26,GUS,hotZone,Open Zone,0,61,111,172,10182
7062,2023-01-26,GUS,heist,Hot Potato,0,1,1,2,14610
7063,2023-01-26,GUS,gemGrab,Undermine,0,50,94,144,10062
7064,2023-01-26,GUS,gemGrab,Gem Fort,0,10,7,17,4674
7065,2023-01-26,GUS,brawlBall,Sunny Soccer,0,6,5,11,3660
7066,2023-01-26,GUS,brawlBall,Pinhole Punt,4,252,300,556,67338
7067,2023-01-26,GUS,bounty,Temple Ruins,0,26,37,63,5610
7068,2023-01-25,GUS,knockout,Riverside,0,88,132,220,9906
7069,2023-01-25,GUS,hotZone,Open Zone,0,45,52,97,5262
7070,2023-01-25,GUS,heist,Safe Zone,0,15,18,33,9156
7071,2023-01-25,GUS,gemGrab,Gem Fort,0,15,38,53,5556
7072,2023-01-25,GUS,gemGrab,Crystal Arcade,0,51,94,145,7866
7073,2023-01-25,GUS,brawlBall,Sunny Soccer,4,96,119,219,40830
7074,2023-01-25,GUS,brawlBall,Beach Ball,0,14,5,19,6408
7075,2023-01-25,GUS,bounty,Excel,0,25,57,82,5790
7076,2023-01-24,GUS,knockout,New Perspective,0,62,88,150,10542
7077,2023-01-24,GUS,hotZone,Dueling Beetles,0,42,63,105,10662
7078,2023-01-24,GUS,heist,Safe Zone,1,26,30,57,15750
7079,2023-01-24,GUS,gemGrab,Minecart Madness,0,25,34,59,4002
7080,2023-01-24,GUS,gemGrab,Crystal Arcade,0,118,132,250,14460
7081,2023-01-24,GUS,brawlBall,Center Stage,0,12,10,22,7860
7082,2023-01-24,GUS,brawlBall,Beach Ball,6,180,174,360,64614
7083,2023-01-24,GUS,bounty,Excel,0,71,116,187,10896
7084,2023-01-23,GUS,knockout,New Perspective,0,119,152,271,20676
7085,2023-01-23,GUS,hotZone,Dueling Beetles,0,74,85,159,17502
7086,2023-01-23,GUS,heist,Snaked Assault,0,5,5,10,15762
7087,2023-01-23,GUS,gemGrab,Minecart Madness,0,130,188,318,19062
7088,2023-01-23,GUS,gemGrab,Double Swoosh,0,31,42,73,7578
7089,2023-01-23,GUS,brawlBall,Center Stage,4,168,186,358,92862
7090,2023-01-23,GUS,brawlBall,Backyard Bowl,0,36,57,93,4224
7091,2023-01-23,GUS,bounty,Layer Cake,0,48,66,114,11142
7092,2023-01-22,GUS,knockout,X Marks the Spot,0,67,76,143,9174
7093,2023-01-22,GUS,hotZone,Ring of Fire,0,26,30,56,5730
7094,2023-01-22,GUS,heist,Snaked Assault,0,1,1,2,8232
7095,2023-01-22,GUS,gemGrab,Hard Rock Mine,0,35,67,102,4722
7096,2023-01-22,GUS,gemGrab,Double Swoosh,0,29,45,74,9426
7097,2023-01-22,GUS,brawlBall,Super Beach,0,24,16,40,7386
7098,2023-01-22,GUS,brawlBall,Backyard Bowl,14,256,370,640,34788
7099,2023-01-22,GUS,bounty,Layer Cake,0,29,27,56,6654
7100,2023-01-21,GUS,knockout,X Marks the Spot,1,278,336,615,31698
7101,2023-01-21,GUS,hotZone,Ring of Fire,0,102,118,220,16632
7102,2023-01-21,GUS,heist,Tornado Ring,0,11,3,14,11664
7103,2023-01-21,GUS,gemGrab,Hard Rock Mine,0,116,138,254,22980
7104,2023-01-21,GUS,gemGrab,Deep Diner,0,39,55,94,4470
7105,2023-01-21,GUS,brawlBall,Super Beach,6,307,394,707,101364
7106,2023-01-21,GUS,brawlBall,Sneaky Fields,0,8,3,11,3750
7107,2023-01-21,GUS,bounty,Dry Season,0,181,261,442,14538
7108,2023-01-20,GUS,knockout,Out in the Open,1,265,313,579,20106
7109,2023-01-20,GUS,hotZone,Split,0,6,5,11,9678
7110,2023-01-20,GUS,heist,Tornado Ring,0,1,1,2,12672
7111,2023-01-20,GUS,gemGrab,Undermine,0,14,25,39,5442
7112,2023-01-20,GUS,gemGrab,Deep Diner,0,127,210,337,19050
7113,2023-01-20,GUS,brawlBall,Sneaky Fields,3,163,150,316,74778
7114,2023-01-20,GUS,brawlBall,Pinhole Punt,0,7,13,20,2886
7115,2023-01-20,GUS,bounty,Dry Season,0,129,194,323,11640
7116,2023-01-19,GUS,knockout,Out in the Open,1,204,266,471,26574
7117,2023-01-19,GUS,hotZone,Split,0,13,7,20,14856
7118,2023-01-19,GUS,heist,Kaboom Canyon,0,11,18,29,6732
7119,2023-01-19,GUS,gemGrab,Undermine,0,63,100,163,14154
7120,2023-01-19,GUS,gemGrab,Gem Fort,0,9,10,19,2934
7121,2023-01-19,GUS,brawlBall,Sunny Soccer,0,4,0,4,2274
7122,2023-01-19,GUS,brawlBall,Pinhole Punt,15,300,401,716,72498
7123,2023-01-19,GUS,bounty,Shooting Star,0,101,189,290,11124
7124,2023-01-18,GUS,knockout,Goldarm Gulch,0,17,15,32,2784
7125,2023-01-18,GUS,hotZone,Parallel Plays,0,2,3,5,1158
7126,2023-01-18,GUS,heist,Kaboom Canyon,0,6,2,8,2592
7127,2023-01-18,GUS,gemGrab,Gem Fort,0,13,13,26,3006
7128,2023-01-18,GUS,gemGrab,Crystal Arcade,0,7,11,18,990
7129,2023-01-18,GUS,brawlBall,Sunny Soccer,0,40,43,83,18941
7130,2023-01-18,GUS,brawlBall,Beach Ball,0,4,6,10,774
7131,2023-01-18,GUS,bounty,Shooting Star,0,63,72,135,5088
7132,2023-01-17,GUS,knockout,Goldarm Gulch,0,21,18,39,2520
7133,2023-01-17,GUS,hotZone,Parallel Plays,0,8,4,12,1038
7134,2023-01-17,GUS,gemGrab,Minecart Madness,0,6,4,10,216
7135,2023-01-17,GUS,gemGrab,Crystal Arcade,0,6,4,10,1266
7136,2023-01-17,GUS,brawlBall,Beach Ball,1,23,27,51,5886
7137,2023-01-17,GUS,bounty,Hideout,0,8,8,16,750
7138,2023-01-16,GUS,knockout,Belle's Rock,0,35,32,67,1788
7139,2023-01-16,GUS,hotZone,Quarter Pounder,0,3,3,6,1494
7140,2023-01-16,GUS,gemGrab,Minecart Madness,0,8,13,21,1422
7141,2023-01-16,GUS,gemGrab,Double Swoosh,0,2,4,6,708
7142,2023-01-16,GUS,brawlBall,Center Stage,0,10,14,24,5778
7143,2023-01-16,GUS,brawlBall,Backyard Bowl,0,2,5,7,852
7144,2023-01-16,GUS,bounty,Hideout,0,17,47,64,1470
7145,2023-01-15,GUS,knockout,Belle's Rock,0,32,47,79,2904
7146,2023-01-15,GUS,hotZone,Quarter Pounder,0,10,18,28,3318
7147,2023-01-15,GUS,heist,Bridge Too Far,0,3,2,5,2736
7148,2023-01-15,GUS,gemGrab,Hard Rock Mine,0,2,1,3,1014
7149,2023-01-15,GUS,gemGrab,Double Swoosh,0,5,23,28,2178
7150,2023-01-15,GUS,brawlBall,Super Beach,0,1,0,1,1074
7151,2023-01-15,GUS,brawlBall,Backyard Bowl,5,48,89,142,8946
7152,2023-01-15,GUS,bounty,Canal Grande,0,1,1,2,960
7153,2023-01-14,GUS,knockout,Flaring Phoenix,0,15,8,23,1080
7154,2023-01-14,GUS,hotZone,Controller Chaos,0,7,48,55,2772
7155,2023-01-14,GUS,heist,Bridge Too Far,0,8,0,8,4020
7156,2023-01-14,GUS,gemGrab,Hard Rock Mine,0,9,21,30,1272
7157,2023-01-14,GUS,gemGrab,Deep Diner,0,3,3,6,858
7158,2023-01-14,GUS,brawlBall,Super Beach,0,11,11,22,6336
7159,2023-01-14,GUS,brawlBall,Sneaky Fields,0,2,13,15,918
7160,2023-01-14,GUS,bounty,Canal Grande,0,0,2,2,1014
7161,2023-01-13,GUS,knockout,Flaring Phoenix,0,5,27,32,1182
7162,2023-01-13,GUS,hotZone,Controller Chaos,0,4,0,4,2928
7163,2023-01-13,GUS,gemGrab,Undermine,0,1,0,1,18
7164,2023-01-13,GUS,gemGrab,Deep Diner,0,6,4,10,1650
7165,2023-01-13,GUS,brawlBall,Sneaky Fields,0,18,29,47,6144
7166,2023-01-13,GUS,bounty,Temple Ruins,0,3,1,4,270
7167,2023-01-12,GUS,knockout,Riverside,0,25,46,71,2532
7168,2023-01-12,GUS,hotZone,Open Zone,0,9,27,36,1488
7169,2023-01-12,GUS,gemGrab,Undermine,0,5,4,9,690
7170,2023-01-12,GUS,brawlBall,Sunny Soccer,0,0,1,1,240
7171,2023-01-12,GUS,brawlBall,Pinhole Punt,3,9,7,19,2292
7172,2023-01-11,GUS,knockout,Riverside,0,4,5,9,528
7173,2023-01-11,GUS,hotZone,Open Zone,0,5,0,5,462
7174,2023-01-11,GUS,heist,Safe Zone,0,5,0,5,48
7175,2023-01-11,GUS,gemGrab,Gem Fort,0,1,0,1,414
7176,2023-01-11,GUS,brawlBall,Sunny Soccer,0,6,2,8,1638
7177,2023-01-11,GUS,bounty,Excel,0,1,0,1,282
7178,2023-01-10,GUS,knockout,New Perspective,0,1,5,6,720
7179,2023-01-10,GUS,hotZone,Dueling Beetles,0,4,11,15,2424
7180,2023-01-10,GUS,heist,Safe Zone,0,3,0,3,1176
7181,2023-01-10,GUS,gemGrab,Minecart Madness,0,7,7,14,828
7182,2023-01-10,GUS,gemGrab,Crystal Arcade,0,2,7,9,1746
7183,2023-01-10,GUS,brawlBall,Center Stage,0,3,3,6,708
7184,2023-01-10,GUS,brawlBall,Beach Ball,0,11,8,19,4392
7185,2023-01-10,GUS,bounty,Excel,0,3,15,18,330
7186,2023-01-09,GUS,knockout,New Perspective,0,1,12,13,876
7187,2023-01-09,GUS,hotZone,Dueling Beetles,0,5,9,14,1554
7188,2023-01-09,GUS,gemGrab,Minecart Madness,0,17,40,57,1884
7189,2023-01-09,GUS,gemGrab,Double Swoosh,0,0,2,2,1320
7190,2023-01-09,GUS,brawlBall,Center Stage,0,4,6,10,5460
7191,2023-01-09,GUS,bounty,Layer Cake,0,8,50,58,1512
7192,2023-01-08,GUS,knockout,X Marks the Spot,0,10,30,40,1692
7193,2023-01-08,GUS,hotZone,Ring of Fire,0,4,9,13,1644
7194,2023-01-08,GUS,heist,Snaked Assault,0,0,1,1,1494
7195,2023-01-08,GUS,gemGrab,Hard Rock Mine,0,5,8,13,630
7196,2023-01-08,GUS,brawlBall,Backyard Bowl,0,30,61,91,4830
7197,2023-01-08,GUS,bounty,Layer Cake,0,4,0,4,528
7198,2023-01-07,GUS,knockout,X Marks the Spot,0,7,5,12,1014
7199,2023-01-07,GUS,hotZone,Ring of Fire,0,0,1,1,846
7200,2023-01-07,GUS,heist,Tornado Ring,0,0,1,1,1350
7201,2023-01-07,GUS,gemGrab,Hard Rock Mine,0,4,10,14,1158
7202,2023-01-07,GUS,gemGrab,Deep Diner,0,4,12,16,918
7203,2023-01-07,GUS,brawlBall,Super Beach,0,13,5,18,2622
7204,2023-01-07,GUS,bounty,Dry Season,0,14,16,30,1320
7205,2023-01-06,GUS,knockout,Out in the Open,0,20,32,52,1446
7206,2023-01-06,GUS,gemGrab,Undermine,0,0,10,10,540
7207,2023-01-06,GUS,gemGrab,Deep Diner,0,11,47,58,2226
7208,2023-01-06,GUS,brawlBall,Sneaky Fields,0,3,3,6,4896
7209,2023-01-06,GUS,brawlBall,Pinhole Punt,0,2,4,6,510
7210,2023-01-06,GUS,bounty,Dry Season,0,32,38,70,1944
7211,2023-01-05,GUS,knockout,Out in the Open,0,31,40,71,2958
7212,2023-01-05,GUS,gemGrab,Undermine,0,8,15,23,1812
7213,2023-01-05,GUS,brawlBall,Pinhole Punt,0,21,26,47,8118
7214,2023-01-05,GUS,bounty,Shooting Star,0,24,50,74,1362
7215,2023-01-04,GUS,knockout,Goldarm Gulch,0,5,2,7,696
7216,2023-01-04,GUS,hotZone,Parallel Plays,0,3,2,5,864
7217,2023-01-04,GUS,heist,Kaboom Canyon,0,0,5,5,1848
7218,2023-01-04,GUS,gemGrab,Gem Fort,0,3,6,9,1788
7219,2023-01-04,GUS,gemGrab,Crystal Arcade,0,5,22,27,642
7220,2023-01-04,GUS,brawlBall,Sunny Soccer,0,8,6,14,6312
7221,2023-01-04,GUS,brawlBall,Beach Ball,0,0,1,1,54
7222,2023-01-04,GUS,bounty,Shooting Star,0,41,91,132,3570
7223,2023-01-03,GUS,knockout,Goldarm Gulch,0,8,9,17,720
7224,2023-01-03,GUS,hotZone,Parallel Plays,0,1,3,4,1542
7225,2023-01-03,GUS,gemGrab,Minecart Madness,0,0,7,7,456
7226,2023-01-03,GUS,gemGrab,Crystal Arcade,0,21,76,97,2406
7227,2023-01-03,GUS,brawlBall,Center Stage,1,0,4,5,294
7228,2023-01-03,GUS,brawlBall,Beach Ball,0,11,6,17,5580
7229,2023-01-03,GUS,bounty,Hideout,0,13,21,34,1638
7230,2023-01-02,GUS,knockout,Belle's Rock,0,17,45,62,1794
7231,2023-01-02,GUS,hotZone,Quarter Pounder,0,18,13,31,2652
7232,2023-01-02,GUS,heist,Kaboom Canyon,0,1,0,1,30
7233,2023-01-02,GUS,gemGrab,Minecart Madness,0,8,76,84,2352
7234,2023-01-02,GUS,gemGrab,Double Swoosh,0,5,5,10,1512
7235,2023-01-02,GUS,brawlBall,Center Stage,0,9,5,14,7110
7236,2023-01-02,GUS,brawlBall,Backyard Bowl,1,0,1,2,492
7237,2023-01-02,GUS,bounty,Hideout,0,40,91,131,3090
7238,2023-01-01,GUS,knockout,Belle's Rock,0,18,33,51,858
7239,2023-01-01,GUS,hotZone,Quarter Pounder,0,4,5,9,1188
7240,2023-01-01,GUS,heist,Bridge Too Far,0,1,0,1,462
7241,2023-01-01,GUS,gemGrab,Hard Rock Mine,0,1,0,1,48
7242,2023-01-01,GUS,gemGrab,Double Swoosh,0,4,7,11,1140
7243,2023-01-01,GUS,brawlBall,Backyard Bowl,0,20,57,77,2658
7244,2022-12-31,GUS,heist,Bridge Too Far,0,4,3,7,276
7245,2022-12-31,GUS,gemGrab,Hard Rock Mine,0,0,4,4,384
7246,2022-12-31,GUS,gemGrab,Deep Diner,0,3,19,22,306
7247,2022-12-31,GUS,brawlBall,Super Beach,0,8,2,10,618
7248,2022-12-31,GUS,bounty,Canal Grande,0,2,0,2,54
7249,2022-12-30,GUS,gemGrab,Deep Diner,0,2,0,2,438
7250,2022-12-29,GUS,gemGrab,Gem Fort,0,0,1,1,30
7251,2022-12-29,GUS,brawlBall,Pinhole Punt,0,2,3,5,282
7252,2022-12-28,GUS,brawlBall,Sunny Soccer,0,0,1,1,42
7253,2022-12-27,GUS,knockout,New Perspective,0,0,1,1,30
7254,2022-12-27,GUS,hotZone,Dueling Beetles,0,4,3,7,36
7255,2022-12-27,GUS,brawlBall,Beach Ball,0,2,0,2,144
7256,2022-12-26,GUS,hotZone,Controller Chaos,0,0,1,1,30
7257,2022-12-23,GUS,gemGrab,Deep Diner,0,0,1,1,6
7258,2022-12-22,GUS,brawlBall,Pinhole Punt,0,2,2,4,132
7259,2022-12-21,GUS,brawlBall,Sunny Soccer,0,0,2,2,54
7260,2022-12-17,GUS,knockout,Flaring Phoenix,0,1,0,1,30
7261,2022-12-16,GUS,brawlBall,Sneaky Fields,0,1,0,1,84
7262,2022-12-13,GUS,gemGrab,Crystal Arcade,0,1,0,1,72
7263,2022-12-11,GUS,brawlBall,Backyard Bowl,0,0,1,1,24
7264,2022-12-10,GUS,knockout,X Marks the Spot,0,1,0,1,12
7265,2022-11-07,GUS,hotZone,Quarter Pounder,0,0,1,1,24
7266,2022-11-03,GUS,brawlBall,Pinhole Punt,0,0,1,1,12
7267,2022-10-15,GUS,gemGrab,Hard Rock Mine,0,1,0,1,90
7268,2022-10-15,GUS,bounty,Dry Season,0,0,1,1,6
7269,2022-10-10,GUS,knockout,Belle's Rock,0,1,1,2,48
7270,2023-01-28,GROM,knockout,Flaring Phoenix,0,403,434,837,12366
7271,2023-01-28,GROM,hotZone,Controller Chaos,0,50,40,90,10134
7272,2023-01-28,GROM,heist,Bridge Too Far,2,576,797,1375,24240
7273,2023-01-28,GROM,gemGrab,Hard Rock Mine,0,52,51,103,16638
7274,2023-01-28,GROM,gemGrab,Deep Diner,0,44,55,99,5478
7275,2023-01-28,GROM,brawlBall,Super Beach,3,200,175,378,74430
7276,2023-01-28,GROM,brawlBall,Sneaky Fields,0,10,6,16,3582
7277,2023-01-28,GROM,bounty,Canal Grande,0,482,578,1060,10902
7278,2023-01-27,GROM,knockout,Flaring Phoenix,0,185,159,344,5928
7279,2023-01-27,GROM,hotZone,Controller Chaos,0,25,14,39,2676
7280,2023-01-27,GROM,heist,Hot Potato,0,30,32,62,3486
7281,2023-01-27,GROM,gemGrab,Undermine,0,1,1,2,942
7282,2023-01-27,GROM,gemGrab,Deep Diner,0,64,66,130,6846
7283,2023-01-27,GROM,brawlBall,Sneaky Fields,0,74,86,160,23514
7284,2023-01-27,GROM,brawlBall,Pinhole Punt,0,16,11,27,738
7285,2023-01-27,GROM,bounty,Temple Ruins,0,35,18,53,1890
7286,2023-01-26,GROM,knockout,Riverside,1,370,256,627,19008
7287,2023-01-26,GROM,hotZone,Open Zone,0,46,14,60,10182
7288,2023-01-26,GROM,heist,Hot Potato,0,54,48,102,14610
7289,2023-01-26,GROM,gemGrab,Undermine,0,43,21,64,10062
7290,2023-01-26,GROM,gemGrab,Gem Fort,0,8,13,21,4674
7291,2023-01-26,GROM,brawlBall,Sunny Soccer,0,23,15,38,3660
7292,2023-01-26,GROM,brawlBall,Pinhole Punt,5,192,164,361,67338
7293,2023-01-26,GROM,bounty,Temple Ruins,0,114,133,247,5610
7294,2023-01-25,GROM,knockout,Riverside,0,155,116,271,9906
7295,2023-01-25,GROM,hotZone,Open Zone,0,18,11,29,5262
7296,2023-01-25,GROM,heist,Safe Zone,1,231,233,465,9156
7297,2023-01-25,GROM,gemGrab,Gem Fort,0,24,11,35,5556
7298,2023-01-25,GROM,gemGrab,Crystal Arcade,0,31,30,61,7866
7299,2023-01-25,GROM,brawlBall,Sunny Soccer,4,234,224,462,40830
7300,2023-01-25,GROM,brawlBall,Beach Ball,1,29,58,88,6408
7301,2023-01-25,GROM,bounty,Excel,0,310,330,640,5790
7302,2023-01-24,GROM,knockout,New Perspective,0,292,315,607,10542
7303,2023-01-24,GROM,hotZone,Dueling Beetles,0,116,71,187,10662
7304,2023-01-24,GROM,heist,Safe Zone,1,306,367,674,15750
7305,2023-01-24,GROM,gemGrab,Minecart Madness,0,33,32,65,4002
7306,2023-01-24,GROM,gemGrab,Crystal Arcade,0,58,33,91,14460
7307,2023-01-24,GROM,brawlBall,Center Stage,6,157,204,367,7860
7308,2023-01-24,GROM,brawlBall,Beach Ball,9,418,432,859,64614
7309,2023-01-24,GROM,bounty,Excel,0,580,522,1102,10896
7310,2023-01-23,GROM,knockout,New Perspective,0,538,507,1045,20676
7311,2023-01-23,GROM,hotZone,Dueling Beetles,1,191,125,317,17502
7312,2023-01-23,GROM,heist,Snaked Assault,0,44,13,57,15762
7313,2023-01-23,GROM,gemGrab,Minecart Madness,0,194,128,322,19062
7314,2023-01-23,GROM,gemGrab,Double Swoosh,0,27,13,40,7578
7315,2023-01-23,GROM,brawlBall,Center Stage,48,2078,2563,4689,92862
7316,2023-01-23,GROM,brawlBall,Backyard Bowl,1,9,3,13,4224
7317,2023-01-23,GROM,bounty,Layer Cake,0,420,509,929,11142
7318,2023-01-22,GROM,knockout,X Marks the Spot,1,335,401,737,9174
7319,2023-01-22,GROM,hotZone,Ring of Fire,0,28,20,48,5730
7320,2023-01-22,GROM,heist,Snaked Assault,0,15,12,27,8232
7321,2023-01-22,GROM,gemGrab,Hard Rock Mine,0,14,9,23,4722
7322,2023-01-22,GROM,gemGrab,Double Swoosh,0,29,45,74,9426
7323,2023-01-22,GROM,brawlBall,Super Beach,0,22,14,36,7386
7324,2023-01-22,GROM,brawlBall,Backyard Bowl,2,89,63,154,34788
7325,2023-01-22,GROM,bounty,Layer Cake,0,327,313,640,6654
7326,2023-01-21,GROM,knockout,X Marks the Spot,1,1123,1055,2179,31698
7327,2023-01-21,GROM,hotZone,Ring of Fire,0,98,59,157,16632
7328,2023-01-21,GROM,heist,Tornado Ring,0,34,17,51,11664
7329,2023-01-21,GROM,gemGrab,Hard Rock Mine,0,60,60,120,22980
7330,2023-01-21,GROM,gemGrab,Deep Diner,0,41,35,76,4470
7331,2023-01-21,GROM,brawlBall,Super Beach,4,312,242,558,101364
7332,2023-01-21,GROM,brawlBall,Sneaky Fields,0,12,13,25,3750
7333,2023-01-21,GROM,bounty,Dry Season,0,484,497,981,14538
7334,2023-01-20,GROM,knockout,Out in the Open,3,457,421,881,20106
7335,2023-01-20,GROM,hotZone,Split,0,173,92,265,9678
7336,2023-01-20,GROM,heist,Tornado Ring,0,38,18,56,12672
7337,2023-01-20,GROM,gemGrab,Undermine,0,18,16,34,5442
7338,2023-01-20,GROM,gemGrab,Deep Diner,0,187,183,370,19050
7339,2023-01-20,GROM,brawlBall,Sneaky Fields,3,224,236,463,74778
7340,2023-01-20,GROM,brawlBall,Pinhole Punt,0,7,9,16,2886
7341,2023-01-20,GROM,bounty,Dry Season,0,329,339,668,11640
7342,2023-01-19,GROM,knockout,Out in the Open,0,613,554,1167,26574
7343,2023-01-19,GROM,hotZone,Split,0,248,194,442,14856
7344,2023-01-19,GROM,heist,Kaboom Canyon,0,63,62,125,6732
7345,2023-01-19,GROM,gemGrab,Undermine,0,51,35,86,14154
7346,2023-01-19,GROM,gemGrab,Gem Fort,0,3,1,4,2934
7347,2023-01-19,GROM,brawlBall,Sunny Soccer,0,14,7,21,2274
7348,2023-01-19,GROM,brawlBall,Pinhole Punt,3,200,160,363,72498
7349,2023-01-19,GROM,bounty,Shooting Star,0,317,397,714,11124
7350,2023-01-18,GROM,knockout,Goldarm Gulch,0,104,105,209,2784
7351,2023-01-18,GROM,hotZone,Parallel Plays,0,4,1,5,1158
7352,2023-01-18,GROM,heist,Kaboom Canyon,0,27,15,42,2592
7353,2023-01-18,GROM,gemGrab,Gem Fort,0,12,4,16,3006
7354,2023-01-18,GROM,gemGrab,Crystal Arcade,0,3,0,3,990
7355,2023-01-18,GROM,brawlBall,Sunny Soccer,5,98,87,190,18941
7356,2023-01-18,GROM,brawlBall,Beach Ball,0,3,7,10,774
7357,2023-01-18,GROM,bounty,Shooting Star,0,127,144,271,5088
7358,2023-01-17,GROM,knockout,Goldarm Gulch,0,92,111,203,2520
7359,2023-01-17,GROM,hotZone,Parallel Plays,0,5,6,11,1038
7360,2023-01-17,GROM,heist,Pit Stop,0,7,5,12,1290
7361,2023-01-17,GROM,gemGrab,Minecart Madness,0,1,1,2,216
7362,2023-01-17,GROM,gemGrab,Crystal Arcade,0,3,2,5,1266
7363,2023-01-17,GROM,brawlBall,Center Stage,0,1,2,3,288
7364,2023-01-17,GROM,brawlBall,Beach Ball,2,34,28,64,5886
7365,2023-01-17,GROM,bounty,Hideout,0,41,37,78,750
7366,2023-01-16,GROM,knockout,Belle's Rock,0,104,119,223,1788
7367,2023-01-16,GROM,hotZone,Quarter Pounder,0,13,14,27,1494
7368,2023-01-16,GROM,heist,Pit Stop,0,17,19,36,4044
7369,2023-01-16,GROM,gemGrab,Minecart Madness,0,12,12,24,1422
7370,2023-01-16,GROM,gemGrab,Double Swoosh,0,4,3,7,708
7371,2023-01-16,GROM,brawlBall,Center Stage,7,177,204,388,5778
7372,2023-01-16,GROM,brawlBall,Backyard Bowl,0,1,1,2,852
7373,2023-01-16,GROM,bounty,Hideout,0,74,54,128,1470
7374,2023-01-15,GROM,knockout,Belle's Rock,0,210,212,422,2904
7375,2023-01-15,GROM,hotZone,Quarter Pounder,0,30,33,63,3318
7376,2023-01-15,GROM,heist,Bridge Too Far,1,46,43,90,2736
7377,2023-01-15,GROM,gemGrab,Hard Rock Mine,0,1,1,2,1014
7378,2023-01-15,GROM,gemGrab,Double Swoosh,0,7,2,9,2178
7379,2023-01-15,GROM,brawlBall,Super Beach,0,6,0,6,1074
7380,2023-01-15,GROM,brawlBall,Backyard Bowl,1,21,16,38,8946
7381,2023-01-15,GROM,bounty,Canal Grande,0,54,61,115,960
7382,2023-01-14,GROM,knockout,Flaring Phoenix,0,60,34,94,1080
7383,2023-01-14,GROM,hotZone,Controller Chaos,0,26,9,35,2772
7384,2023-01-14,GROM,heist,Bridge Too Far,0,76,70,146,4020
7385,2023-01-14,GROM,gemGrab,Hard Rock Mine,0,2,7,9,1272
7386,2023-01-14,GROM,gemGrab,Deep Diner,0,10,8,18,858
7387,2023-01-14,GROM,brawlBall,Super Beach,2,24,12,38,6336
7388,2023-01-14,GROM,bounty,Canal Grande,0,57,71,128,1014
7389,2023-01-13,GROM,knockout,Flaring Phoenix,0,43,38,81,1182
7390,2023-01-13,GROM,hotZone,Controller Chaos,0,19,10,29,2928
7391,2023-01-13,GROM,heist,Hot Potato,0,4,3,7,600
7392,2023-01-13,GROM,gemGrab,Deep Diner,0,11,5,16,1650
7393,2023-01-13,GROM,brawlBall,Sneaky Fields,1,22,14,37,6144
7394,2023-01-13,GROM,brawlBall,Pinhole Punt,0,1,0,1,156
7395,2023-01-13,GROM,bounty,Temple Ruins,0,2,2,4,270
7396,2023-01-12,GROM,knockout,Riverside,0,63,30,93,2532
7397,2023-01-12,GROM,hotZone,Open Zone,0,5,1,6,1488
7398,2023-01-12,GROM,heist,Hot Potato,0,0,2,2,330
7399,2023-01-12,GROM,gemGrab,Undermine,0,3,2,5,690
7400,2023-01-12,GROM,brawlBall,Sunny Soccer,0,2,0,2,240
7401,2023-01-12,GROM,brawlBall,Pinhole Punt,0,4,3,7,2292
7402,2023-01-12,GROM,bounty,Temple Ruins,0,0,4,4,24
7403,2023-01-11,GROM,knockout,Riverside,0,11,2,13,528
7404,2023-01-11,GROM,hotZone,Open Zone,0,2,0,2,462
7405,2023-01-11,GROM,heist,Safe Zone,0,1,1,2,48
7406,2023-01-11,GROM,gemGrab,Gem Fort,0,0,4,4,414
7407,2023-01-11,GROM,brawlBall,Sunny Soccer,1,18,18,37,1638
7408,2023-01-11,GROM,bounty,Excel,0,13,14,27,282
7409,2023-01-10,GROM,knockout,New Perspective,0,35,52,87,720
7410,2023-01-10,GROM,hotZone,Dueling Beetles,0,25,31,56,2424
7411,2023-01-10,GROM,heist,Safe Zone,0,24,9,33,1176
7412,2023-01-10,GROM,gemGrab,Minecart Madness,0,9,19,28,828
7413,2023-01-10,GROM,gemGrab,Crystal Arcade,0,7,6,13,1746
7414,2023-01-10,GROM,brawlBall,Center Stage,0,18,49,67,708
7415,2023-01-10,GROM,brawlBall,Beach Ball,0,31,35,66,4392
7416,2023-01-10,GROM,bounty,Excel,0,18,12,30,330
7417,2023-01-09,GROM,knockout,New Perspective,0,28,28,56,876
7418,2023-01-09,GROM,hotZone,Dueling Beetles,0,33,15,48,1554
7419,2023-01-09,GROM,heist,Snaked Assault,0,8,3,11,2022
7420,2023-01-09,GROM,gemGrab,Minecart Madness,0,25,6,31,1884
7421,2023-01-09,GROM,gemGrab,Double Swoosh,0,6,0,6,1320
7422,2023-01-09,GROM,brawlBall,Center Stage,7,207,283,497,5460
7423,2023-01-09,GROM,brawlBall,Backyard Bowl,0,1,2,3,474
7424,2023-01-09,GROM,bounty,Layer Cake,0,70,49,119,1512
7425,2023-01-08,GROM,knockout,X Marks the Spot,0,81,75,156,1692
7426,2023-01-08,GROM,hotZone,Ring of Fire,0,6,4,10,1644
7427,2023-01-08,GROM,heist,Snaked Assault,0,7,10,17,1494
7428,2023-01-08,GROM,gemGrab,Hard Rock Mine,0,1,0,1,630
7429,2023-01-08,GROM,gemGrab,Double Swoosh,0,5,5,10,864
7430,2023-01-08,GROM,brawlBall,Backyard Bowl,0,10,8,18,4830
7431,2023-01-08,GROM,bounty,Layer Cake,0,24,27,51,528
7432,2023-01-07,GROM,knockout,X Marks the Spot,0,41,42,83,1014
7433,2023-01-07,GROM,hotZone,Ring of Fire,0,8,9,17,846
7434,2023-01-07,GROM,heist,Tornado Ring,0,1,3,4,1350
7435,2023-01-07,GROM,gemGrab,Hard Rock Mine,0,3,2,5,1158
7436,2023-01-07,GROM,gemGrab,Deep Diner,0,8,13,21,918
7437,2023-01-07,GROM,brawlBall,Super Beach,0,14,11,25,2622
7438,2023-01-07,GROM,brawlBall,Sneaky Fields,1,1,1,3,402
7439,2023-01-07,GROM,bounty,Dry Season,0,60,94,154,1320
7440,2023-01-06,GROM,knockout,Out in the Open,0,52,40,92,1446
7441,2023-01-06,GROM,hotZone,Split,0,25,24,49,1158
7442,2023-01-06,GROM,heist,Tornado Ring,0,5,1,6,2538
7443,2023-01-06,GROM,gemGrab,Undermine,0,0,1,1,540
7444,2023-01-06,GROM,gemGrab,Deep Diner,0,30,72,102,2226
7445,2023-01-06,GROM,brawlBall,Sneaky Fields,1,13,20,34,4896
7446,2023-01-06,GROM,bounty,Dry Season,0,95,118,213,1944
7447,2023-01-05,GROM,knockout,Out in the Open,0,101,92,193,2958
7448,2023-01-05,GROM,hotZone,Split,0,52,92,144,3552
7449,2023-01-05,GROM,heist,Kaboom Canyon,0,7,5,12,954
7450,2023-01-05,GROM,gemGrab,Undermine,0,2,4,6,1812
7451,2023-01-05,GROM,gemGrab,Gem Fort,0,0,2,2,252
7452,2023-01-05,GROM,brawlBall,Sunny Soccer,0,0,1,1,84
7453,2023-01-05,GROM,brawlBall,Pinhole Punt,0,25,20,45,8118
7454,2023-01-05,GROM,bounty,Shooting Star,0,56,58,114,1362
7455,2023-01-04,GROM,knockout,Goldarm Gulch,0,35,38,73,696
7456,2023-01-04,GROM,hotZone,Parallel Plays,0,4,1,5,864
7457,2023-01-04,GROM,heist,Kaboom Canyon,0,19,26,45,1848
7458,2023-01-04,GROM,gemGrab,Gem Fort,0,1,0,1,1788
7459,2023-01-04,GROM,gemGrab,Crystal Arcade,0,1,1,2,642
7460,2023-01-04,GROM,brawlBall,Sunny Soccer,1,46,59,106,6312
7461,2023-01-04,GROM,bounty,Shooting Star,0,144,162,306,3570
7462,2023-01-03,GROM,knockout,Goldarm Gulch,0,49,55,104,720
7463,2023-01-03,GROM,hotZone,Parallel Plays,0,10,9,19,1542
7464,2023-01-03,GROM,heist,Pit Stop,0,10,2,12,1956
7465,2023-01-03,GROM,gemGrab,Minecart Madness,0,6,2,8,456
7466,2023-01-03,GROM,gemGrab,Crystal Arcade,0,2,2,4,2406
7467,2023-01-03,GROM,brawlBall,Center Stage,0,9,1,10,294
7468,2023-01-03,GROM,brawlBall,Beach Ball,0,36,31,67,5580
7469,2023-01-03,GROM,bounty,Hideout,0,86,105,191,1638
7470,2023-01-02,GROM,knockout,Belle's Rock,0,120,142,262,1794
7471,2023-01-02,GROM,hotZone,Quarter Pounder,1,17,12,30,2652
7472,2023-01-02,GROM,heist,Pit Stop,0,5,1,6,3498
7473,2023-01-02,GROM,gemGrab,Minecart Madness,0,16,15,31,2352
7474,2023-01-02,GROM,gemGrab,Double Swoosh,0,1,0,1,1512
7475,2023-01-02,GROM,brawlBall,Center Stage,7,264,305,576,7110
7476,2023-01-02,GROM,brawlBall,Backyard Bowl,0,2,2,4,492
7477,2023-01-02,GROM,bounty,Hideout,0,169,192,361,3090
7478,2023-01-01,GROM,knockout,Belle's Rock,0,61,80,141,858
7479,2023-01-01,GROM,hotZone,Quarter Pounder,0,6,26,32,1188
7480,2023-01-01,GROM,heist,Bridge Too Far,0,13,20,33,462
7481,2023-01-01,GROM,gemGrab,Hard Rock Mine,0,0,1,1,48
7482,2023-01-01,GROM,gemGrab,Double Swoosh,0,2,1,3,1140
7483,2023-01-01,GROM,brawlBall,Backyard Bowl,0,4,0,4,2658
7484,2023-01-01,GROM,bounty,Canal Grande,0,2,3,5,132
7485,2022-12-31,GROM,knockout,Flaring Phoenix,0,2,0,2,18
7486,2022-12-31,GROM,heist,Bridge Too Far,0,2,3,5,276
7487,2022-12-31,GROM,gemGrab,Minecart Madness,0,0,1,1,24
7488,2022-12-31,GROM,gemGrab,Hard Rock Mine,0,1,0,1,384
7489,2022-12-31,GROM,gemGrab,Deep Diner,0,1,4,5,306
7490,2022-12-31,GROM,brawlBall,Super Beach,0,3,0,3,618
7491,2022-12-31,GROM,bounty,Canal Grande,0,1,3,4,54
7492,2022-12-30,GROM,knockout,Flaring Phoenix,0,4,1,5,72
7493,2022-12-30,GROM,hotZone,Controller Chaos,0,4,0,4,288
7494,2022-12-30,GROM,gemGrab,Deep Diner,0,4,0,4,438
7495,2022-12-30,GROM,brawlBall,Sneaky Fields,0,4,0,4,552
7496,2022-12-29,GROM,gemGrab,Undermine,0,0,1,1,102
7497,2022-12-29,GROM,gemGrab,Minecart Madness,0,0,1,1,24
7498,2022-12-29,GROM,brawlBall,Pinhole Punt,0,2,0,2,282
7499,2022-12-28,GROM,brawlBall,Sunny Soccer,0,0,1,1,42
7500,2022-12-27,GROM,hotZone,Dueling Beetles,0,0,1,1,36
7501,2022-12-27,GROM,heist,Safe Zone,0,2,0,2,12
7502,2022-12-27,GROM,brawlBall,Center Stage,0,1,2,3,30
7503,2022-12-27,GROM,brawlBall,Beach Ball,0,2,0,2,144
7504,2022-12-27,GROM,bounty,Excel,0,0,1,1,18
7505,2022-12-26,GROM,heist,Kaboom Canyon,0,0,1,1,36
7506,2022-12-26,GROM,brawlBall,Center Stage,0,3,4,7,78
7507,2022-12-25,GROM,bounty,Layer Cake,0,2,1,3,12
7508,2022-12-24,GROM,brawlBall,Super Beach,0,0,1,1,48
7509,2022-12-23,GROM,knockout,Out in the Open,0,4,8,12,132
7510,2022-12-22,GROM,gemGrab,Gem Fort,0,1,0,1,90
7511,2022-12-19,GROM,brawlBall,Center Stage,0,2,0,2,102
7512,2022-12-18,GROM,knockout,Belle's Rock,0,1,0,1,6
7513,2022-12-17,GROM,knockout,Flaring Phoenix,0,3,1,4,30
7514,2022-12-13,GROM,knockout,New Perspective,0,4,13,17,84
7515,2022-12-13,GROM,heist,Safe Zone,0,0,1,1,42
7516,2022-12-11,GROM,brawlBall,Backyard Bowl,0,1,0,1,24
7517,2022-10-26,GROM,bounty,Shooting Star,0,1,0,1,36
7518,2022-10-15,GROM,gemGrab,Hard Rock Mine,0,1,0,1,90
7519,2022-10-10,GROM,knockout,Belle's Rock,0,1,1,2,48
7520,2023-01-28,GRIFF,knockout,Flaring Phoenix,0,20,11,31,12366
7521,2023-01-28,GRIFF,hotZone,Controller Chaos,0,164,224,388,10134
7522,2023-01-28,GRIFF,heist,Bridge Too Far,0,65,49,114,24240
7523,2023-01-28,GRIFF,gemGrab,Hard Rock Mine,0,102,87,189,16638
7524,2023-01-28,GRIFF,gemGrab,Deep Diner,0,60,58,118,5478
7525,2023-01-28,GRIFF,brawlBall,Super Beach,29,680,692,1401,74430
7526,2023-01-28,GRIFF,brawlBall,Sneaky Fields,1,20,21,42,3582
7527,2023-01-28,GRIFF,bounty,Canal Grande,0,55,38,93,10902
7528,2023-01-27,GRIFF,knockout,Flaring Phoenix,0,8,6,14,5928
7529,2023-01-27,GRIFF,hotZone,Controller Chaos,0,40,27,67,2676
7530,2023-01-27,GRIFF,heist,Hot Potato,0,32,24,56,3486
7531,2023-01-27,GRIFF,gemGrab,Undermine,0,7,6,13,942
7532,2023-01-27,GRIFF,gemGrab,Deep Diner,0,86,90,176,6846
7533,2023-01-27,GRIFF,brawlBall,Sneaky Fields,3,210,177,390,23514
7534,2023-01-27,GRIFF,brawlBall,Pinhole Punt,0,5,8,13,738
7535,2023-01-27,GRIFF,bounty,Temple Ruins,0,9,1,10,1890
7536,2023-01-26,GRIFF,knockout,Riverside,0,16,7,23,19008
7537,2023-01-26,GRIFF,hotZone,Open Zone,0,77,54,131,10182
7538,2023-01-26,GRIFF,heist,Hot Potato,0,140,160,300,14610
7539,2023-01-26,GRIFF,gemGrab,Undermine,0,73,85,158,10062
7540,2023-01-26,GRIFF,gemGrab,Gem Fort,0,44,41,85,4674
7541,2023-01-26,GRIFF,brawlBall,Sunny Soccer,0,34,41,75,3660
7542,2023-01-26,GRIFF,brawlBall,Pinhole Punt,21,654,653,1328,67338
7543,2023-01-26,GRIFF,bounty,Temple Ruins,0,16,14,30,5610
7544,2023-01-25,GRIFF,knockout,Riverside,0,6,4,10,9906
7545,2023-01-25,GRIFF,hotZone,Open Zone,0,54,20,74,5262
7546,2023-01-25,GRIFF,heist,Safe Zone,0,55,89,144,9156
7547,2023-01-25,GRIFF,gemGrab,Gem Fort,0,39,50,89,5556
7548,2023-01-25,GRIFF,gemGrab,Crystal Arcade,0,60,50,110,7866
7549,2023-01-25,GRIFF,brawlBall,Sunny Soccer,12,311,320,643,40830
7550,2023-01-25,GRIFF,brawlBall,Beach Ball,4,58,64,126,6408
7551,2023-01-25,GRIFF,bounty,Excel,0,17,8,25,5790
7552,2023-01-24,GRIFF,knockout,New Perspective,0,17,11,28,10542
7553,2023-01-24,GRIFF,hotZone,Dueling Beetles,0,139,161,300,10662
7554,2023-01-24,GRIFF,heist,Safe Zone,2,90,97,189,15750
7555,2023-01-24,GRIFF,gemGrab,Minecart Madness,0,17,12,29,4002
7556,2023-01-24,GRIFF,gemGrab,Crystal Arcade,0,114,102,216,14460
7557,2023-01-24,GRIFF,brawlBall,Center Stage,3,74,114,191,7860
7558,2023-01-24,GRIFF,brawlBall,Beach Ball,14,609,761,1384,64614
7559,2023-01-24,GRIFF,bounty,Excel,0,20,6,26,10896
7560,2023-01-23,GRIFF,knockout,New Perspective,0,37,29,66,20676
7561,2023-01-23,GRIFF,hotZone,Dueling Beetles,0,268,202,470,17502
7562,2023-01-23,GRIFF,heist,Snaked Assault,1,234,269,504,15762
7563,2023-01-23,GRIFF,gemGrab,Minecart Madness,0,75,96,171,19062
7564,2023-01-23,GRIFF,gemGrab,Double Swoosh,0,75,45,120,7578
7565,2023-01-23,GRIFF,brawlBall,Center Stage,29,833,900,1762,92862
7566,2023-01-23,GRIFF,brawlBall,Backyard Bowl,0,21,24,45,4224
7567,2023-01-23,GRIFF,bounty,Layer Cake,0,18,19,37,11142
7568,2023-01-22,GRIFF,knockout,X Marks the Spot,0,16,15,31,9174
7569,2023-01-22,GRIFF,hotZone,Ring of Fire,0,91,103,194,5730
7570,2023-01-22,GRIFF,heist,Snaked Assault,0,135,166,301,8232
7571,2023-01-22,GRIFF,gemGrab,Hard Rock Mine,0,30,15,45,4722
7572,2023-01-22,GRIFF,gemGrab,Double Swoosh,0,68,59,127,9426
7573,2023-01-22,GRIFF,brawlBall,Super Beach,2,58,60,120,7386
7574,2023-01-22,GRIFF,brawlBall,Backyard Bowl,16,233,169,418,34788
7575,2023-01-22,GRIFF,bounty,Layer Cake,0,18,18,36,6654
7576,2023-01-21,GRIFF,knockout,X Marks the Spot,0,52,25,77,31698
7577,2023-01-21,GRIFF,hotZone,Ring of Fire,1,170,184,355,16632
7578,2023-01-21,GRIFF,heist,Tornado Ring,3,166,195,364,11664
7579,2023-01-21,GRIFF,gemGrab,Hard Rock Mine,0,140,169,309,22980
7580,2023-01-21,GRIFF,gemGrab,Deep Diner,0,40,60,100,4470
7581,2023-01-21,GRIFF,brawlBall,Super Beach,35,952,910,1897,101364
7582,2023-01-21,GRIFF,brawlBall,Sneaky Fields,1,38,35,74,3750
7583,2023-01-21,GRIFF,bounty,Dry Season,0,16,9,25,14538
7584,2023-01-20,GRIFF,knockout,Out in the Open,0,38,32,70,20106
7585,2023-01-20,GRIFF,hotZone,Split,0,80,93,173,9678
7586,2023-01-20,GRIFF,heist,Tornado Ring,2,127,137,266,12672
7587,2023-01-20,GRIFF,gemGrab,Undermine,0,50,29,79,5442
7588,2023-01-20,GRIFF,gemGrab,Deep Diner,0,200,224,424,19050
7589,2023-01-20,GRIFF,brawlBall,Sneaky Fields,23,710,719,1452,74778
7590,2023-01-20,GRIFF,brawlBall,Pinhole Punt,1,35,25,61,2886
7591,2023-01-20,GRIFF,bounty,Dry Season,0,10,5,15,11640
7592,2023-01-19,GRIFF,knockout,Out in the Open,0,65,31,96,26574
7593,2023-01-19,GRIFF,hotZone,Split,0,127,94,221,14856
7594,2023-01-19,GRIFF,heist,Kaboom Canyon,0,63,65,128,6732
7595,2023-01-19,GRIFF,gemGrab,Undermine,0,86,74,160,14154
7596,2023-01-19,GRIFF,gemGrab,Gem Fort,0,32,17,49,2934
7597,2023-01-19,GRIFF,brawlBall,Sunny Soccer,0,13,16,29,2274
7598,2023-01-19,GRIFF,brawlBall,Pinhole Punt,26,728,739,1493,72498
7599,2023-01-19,GRIFF,bounty,Shooting Star,0,17,7,24,11124
7600,2023-01-18,GRIFF,knockout,Goldarm Gulch,0,9,9,18,2784
7601,2023-01-18,GRIFF,hotZone,Parallel Plays,0,16,26,42,1158
7602,2023-01-18,GRIFF,heist,Kaboom Canyon,0,13,15,28,2592
7603,2023-01-18,GRIFF,gemGrab,Gem Fort,0,42,33,75,3006
7604,2023-01-18,GRIFF,gemGrab,Crystal Arcade,0,4,3,7,990
7605,2023-01-18,GRIFF,brawlBall,Sunny Soccer,2,156,176,334,18941
7606,2023-01-18,GRIFF,brawlBall,Beach Ball,0,6,6,12,774
7607,2023-01-18,GRIFF,bounty,Shooting Star,0,3,2,5,5088
7608,2023-01-17,GRIFF,knockout,Goldarm Gulch,0,1,4,5,2520
7609,2023-01-17,GRIFF,hotZone,Parallel Plays,0,13,24,37,1038
7610,2023-01-17,GRIFF,heist,Pit Stop,0,11,13,24,1290
7611,2023-01-17,GRIFF,gemGrab,Crystal Arcade,0,11,11,22,1266
7612,2023-01-17,GRIFF,brawlBall,Center Stage,0,2,5,7,288
7613,2023-01-17,GRIFF,brawlBall,Beach Ball,1,48,48,97,5886
7614,2023-01-17,GRIFF,bounty,Hideout,0,2,0,2,750
7615,2023-01-16,GRIFF,knockout,Belle's Rock,0,1,0,1,1788
7616,2023-01-16,GRIFF,hotZone,Quarter Pounder,0,22,17,39,1494
7617,2023-01-16,GRIFF,heist,Pit Stop,0,41,40,81,4044
7618,2023-01-16,GRIFF,gemGrab,Minecart Madness,0,8,3,11,1422
7619,2023-01-16,GRIFF,gemGrab,Double Swoosh,0,6,8,14,708
7620,2023-01-16,GRIFF,brawlBall,Center Stage,1,43,51,95,5778
7621,2023-01-16,GRIFF,brawlBall,Backyard Bowl,0,2,6,8,852
7622,2023-01-15,GRIFF,knockout,Belle's Rock,0,0,1,1,2904
7623,2023-01-15,GRIFF,hotZone,Quarter Pounder,0,73,125,198,3318
7624,2023-01-15,GRIFF,heist,Bridge Too Far,0,16,16,32,2736
7625,2023-01-15,GRIFF,gemGrab,Hard Rock Mine,0,5,2,7,1014
7626,2023-01-15,GRIFF,gemGrab,Double Swoosh,0,15,2,17,2178
7627,2023-01-15,GRIFF,brawlBall,Super Beach,0,2,6,8,1074
7628,2023-01-15,GRIFF,brawlBall,Backyard Bowl,0,41,50,91,8946
7629,2023-01-15,GRIFF,bounty,Canal Grande,0,2,0,2,960
7630,2023-01-14,GRIFF,knockout,Flaring Phoenix,0,2,0,2,1080
7631,2023-01-14,GRIFF,hotZone,Controller Chaos,0,48,86,134,2772
7632,2023-01-14,GRIFF,heist,Bridge Too Far,0,6,2,8,4020
7633,2023-01-14,GRIFF,gemGrab,Hard Rock Mine,0,1,2,3,1272
7634,2023-01-14,GRIFF,gemGrab,Deep Diner,0,6,5,11,858
7635,2023-01-14,GRIFF,brawlBall,Super Beach,5,60,97,162,6336
7636,2023-01-14,GRIFF,brawlBall,Sneaky Fields,0,9,1,10,918
7637,2023-01-14,GRIFF,bounty,Canal Grande,0,1,0,1,1014
7638,2023-01-13,GRIFF,knockout,Flaring Phoenix,0,4,0,4,1182
7639,2023-01-13,GRIFF,hotZone,Controller Chaos,0,67,88,155,2928
7640,2023-01-13,GRIFF,heist,Hot Potato,0,5,2,7,600
7641,2023-01-13,GRIFF,gemGrab,Deep Diner,0,16,19,35,1650
7642,2023-01-13,GRIFF,brawlBall,Sneaky Fields,2,49,62,113,6144
7643,2023-01-13,GRIFF,brawlBall,Pinhole Punt,2,9,13,24,156
7644,2023-01-12,GRIFF,knockout,Riverside,0,1,1,2,2532
7645,2023-01-12,GRIFF,hotZone,Open Zone,0,13,6,19,1488
7646,2023-01-12,GRIFF,heist,Hot Potato,0,5,0,5,330
7647,2023-01-12,GRIFF,gemGrab,Undermine,0,2,7,9,690
7648,2023-01-12,GRIFF,gemGrab,Gem Fort,0,0,1,1,162
7649,2023-01-12,GRIFF,brawlBall,Sunny Soccer,0,1,0,1,240
7650,2023-01-12,GRIFF,brawlBall,Pinhole Punt,0,24,23,47,2292
7651,2023-01-11,GRIFF,hotZone,Open Zone,0,3,0,3,462
7652,2023-01-11,GRIFF,heist,Safe Zone,0,1,0,1,48
7653,2023-01-11,GRIFF,gemGrab,Gem Fort,0,2,0,2,414
7654,2023-01-11,GRIFF,brawlBall,Sunny Soccer,0,8,5,13,1638
7655,2023-01-10,GRIFF,knockout,New Perspective,0,3,0,3,720
7656,2023-01-10,GRIFF,hotZone,Dueling Beetles,0,23,34,57,2424
7657,2023-01-10,GRIFF,heist,Safe Zone,0,8,2,10,1176
7658,2023-01-10,GRIFF,gemGrab,Minecart Madness,0,1,0,1,828
7659,2023-01-10,GRIFF,gemGrab,Crystal Arcade,0,15,51,66,1746
7660,2023-01-10,GRIFF,brawlBall,Center Stage,0,9,0,9,708
7661,2023-01-10,GRIFF,brawlBall,Beach Ball,0,33,27,60,4392
7662,2023-01-09,GRIFF,hotZone,Dueling Beetles,0,14,23,37,1554
7663,2023-01-09,GRIFF,heist,Snaked Assault,0,32,40,72,2022
7664,2023-01-09,GRIFF,gemGrab,Minecart Madness,0,5,1,6,1884
7665,2023-01-09,GRIFF,gemGrab,Double Swoosh,0,6,15,21,1320
7666,2023-01-09,GRIFF,brawlBall,Center Stage,1,41,28,70,5460
7667,2023-01-09,GRIFF,brawlBall,Backyard Bowl,0,3,2,5,474
7668,2023-01-09,GRIFF,bounty,Layer Cake,0,2,0,2,1512
7669,2023-01-08,GRIFF,hotZone,Ring of Fire,0,19,29,48,1644
7670,2023-01-08,GRIFF,heist,Snaked Assault,0,14,7,21,1494
7671,2023-01-08,GRIFF,gemGrab,Hard Rock Mine,0,3,5,8,630
7672,2023-01-08,GRIFF,gemGrab,Double Swoosh,0,2,1,3,864
7673,2023-01-08,GRIFF,brawlBall,Super Beach,0,10,8,18,732
7674,2023-01-08,GRIFF,brawlBall,Backyard Bowl,0,21,26,47,4830
7675,2023-01-07,GRIFF,hotZone,Ring of Fire,0,8,20,28,846
7676,2023-01-07,GRIFF,heist,Tornado Ring,0,19,4,23,1350
7677,2023-01-07,GRIFF,gemGrab,Hard Rock Mine,0,7,2,9,1158
7678,2023-01-07,GRIFF,gemGrab,Deep Diner,0,4,2,6,918
7679,2023-01-07,GRIFF,brawlBall,Super Beach,1,24,22,47,2622
7680,2023-01-07,GRIFF,bounty,Dry Season,0,2,4,6,1320
7681,2023-01-06,GRIFF,knockout,Out in the Open,0,2,1,3,1446
7682,2023-01-06,GRIFF,hotZone,Split,0,9,6,15,1158
7683,2023-01-06,GRIFF,heist,Tornado Ring,0,23,47,70,2538
7684,2023-01-06,GRIFF,gemGrab,Undermine,0,3,1,4,540
7685,2023-01-06,GRIFF,gemGrab,Deep Diner,0,24,28,52,2226
7686,2023-01-06,GRIFF,brawlBall,Sneaky Fields,0,31,28,59,4896
7687,2023-01-06,GRIFF,brawlBall,Pinhole Punt,0,2,6,8,510
7688,2023-01-05,GRIFF,knockout,Out in the Open,0,6,1,7,2958
7689,2023-01-05,GRIFF,hotZone,Split,1,44,62,107,3552
7690,2023-01-05,GRIFF,heist,Kaboom Canyon,0,5,1,6,954
7691,2023-01-05,GRIFF,gemGrab,Undermine,0,5,1,6,1812
7692,2023-01-05,GRIFF,gemGrab,Gem Fort,0,2,1,3,252
7693,2023-01-05,GRIFF,brawlBall,Sunny Soccer,0,0,1,1,84
7694,2023-01-05,GRIFF,brawlBall,Pinhole Punt,2,77,76,155,8118
7695,2023-01-04,GRIFF,hotZone,Parallel Plays,0,9,42,51,864
7696,2023-01-04,GRIFF,heist,Kaboom Canyon,0,12,9,21,1848
7697,2023-01-04,GRIFF,gemGrab,Gem Fort,0,11,23,34,1788
7698,2023-01-04,GRIFF,gemGrab,Crystal Arcade,0,1,0,1,642
7699,2023-01-04,GRIFF,brawlBall,Sunny Soccer,1,69,56,126,6312
7700,2023-01-04,GRIFF,brawlBall,Beach Ball,0,1,0,1,54
7701,2023-01-04,GRIFF,bounty,Shooting Star,0,1,0,1,3570
7702,2023-01-03,GRIFF,hotZone,Parallel Plays,1,29,57,87,1542
7703,2023-01-03,GRIFF,heist,Pit Stop,0,13,27,40,1956
7704,2023-01-03,GRIFF,gemGrab,Minecart Madness,0,2,0,2,456
7705,2023-01-03,GRIFF,gemGrab,Crystal Arcade,0,30,57,87,2406
7706,2023-01-03,GRIFF,brawlBall,Center Stage,0,1,2,3,294
7707,2023-01-03,GRIFF,brawlBall,Beach Ball,1,36,35,72,5580
7708,2023-01-03,GRIFF,bounty,Hideout,0,3,0,3,1638
7709,2023-01-02,GRIFF,knockout,Belle's Rock,0,2,0,2,1794
7710,2023-01-02,GRIFF,hotZone,Quarter Pounder,1,37,44,82,2652
7711,2023-01-02,GRIFF,hotZone,Controller Chaos,0,0,2,2,18
7712,2023-01-02,GRIFF,heist,Pit Stop,0,35,26,61,3498
7713,2023-01-02,GRIFF,heist,Kaboom Canyon,0,1,0,1,30
7714,2023-01-02,GRIFF,gemGrab,Minecart Madness,0,11,4,15,2352
7715,2023-01-02,GRIFF,gemGrab,Double Swoosh,0,14,17,31,1512
7716,2023-01-02,GRIFF,brawlBall,Center Stage,0,39,35,74,7110
7717,2023-01-02,GRIFF,brawlBall,Backyard Bowl,0,2,1,3,492
7718,2023-01-02,GRIFF,bounty,Hideout,0,2,0,2,3090
7719,2023-01-01,GRIFF,hotZone,Quarter Pounder,0,19,14,33,1188
7720,2023-01-01,GRIFF,hotZone,Controller Chaos,0,1,0,1,12
7721,2023-01-01,GRIFF,heist,Bridge Too Far,0,0,1,1,462
7722,2023-01-01,GRIFF,gemGrab,Double Swoosh,0,7,16,23,1140
7723,2023-01-01,GRIFF,brawlBall,Backyard Bowl,0,17,22,39,2658
7724,2023-01-01,GRIFF,bounty,Canal Grande,0,2,0,2,132
7725,2022-12-31,GRIFF,hotZone,Controller Chaos,0,0,1,1,198
7726,2022-12-31,GRIFF,heist,Bridge Too Far,0,2,0,2,276
7727,2022-12-31,GRIFF,gemGrab,Hard Rock Mine,0,1,0,1,384
7728,2022-12-31,GRIFF,gemGrab,Deep Diner,0,3,1,4,306
7729,2022-12-31,GRIFF,brawlBall,Super Beach,0,3,2,5,618
7730,2022-12-31,GRIFF,brawlBall,Sneaky Fields,0,0,1,1,60
7731,2022-12-31,GRIFF,bounty,Canal Grande,0,1,0,1,54
7732,2022-12-30,GRIFF,knockout,Flaring Phoenix,0,1,0,1,72
7733,2022-12-30,GRIFF,hotZone,Controller Chaos,0,5,1,6,288
7734,2022-12-30,GRIFF,heist,Hot Potato,0,1,0,1,30
7735,2022-12-30,GRIFF,gemGrab,Undermine,0,2,13,15,102
7736,2022-12-30,GRIFF,gemGrab,Deep Diner,0,5,7,12,438
7737,2022-12-30,GRIFF,brawlBall,Sneaky Fields,0,5,10,15,552
7738,2022-12-29,GRIFF,hotZone,Open Zone,0,0,1,1,54
7739,2022-12-29,GRIFF,heist,Kaboom Canyon,0,1,0,1,18
7740,2022-12-29,GRIFF,brawlBall,Pinhole Punt,0,3,1,4,282
7741,2022-12-27,GRIFF,hotZone,Controller Chaos,0,1,0,1,24
7742,2022-12-27,GRIFF,heist,Safe Zone,0,1,0,1,12
7743,2022-12-27,GRIFF,heist,Kaboom Canyon,0,1,1,2,18
7744,2022-12-27,GRIFF,gemGrab,Minecart Madness,0,0,1,1,30
7745,2022-12-27,GRIFF,brawlBall,Beach Ball,0,0,2,2,144
7746,2022-12-26,GRIFF,hotZone,Controller Chaos,0,0,2,2,30
7747,2022-12-26,GRIFF,heist,Kaboom Canyon,0,1,0,1,36
7748,2022-12-26,GRIFF,brawlBall,Center Stage,0,4,3,7,78
7749,2022-12-24,GRIFF,brawlBall,Super Beach,0,1,0,1,48
7750,2022-12-22,GRIFF,gemGrab,Gem Fort,0,1,0,1,90
7751,2022-12-22,GRIFF,brawlBall,Pinhole Punt,0,2,0,2,132
7752,2022-12-21,GRIFF,brawlBall,Sunny Soccer,0,1,0,1,54
7753,2022-12-20,GRIFF,brawlBall,Beach Ball,0,1,1,2,96
7754,2022-12-19,GRIFF,brawlBall,Center Stage,0,2,1,3,102
7755,2022-12-16,GRIFF,hotZone,Controller Chaos,0,0,1,1,6
7756,2022-12-16,GRIFF,brawlBall,Sneaky Fields,0,0,1,1,84
7757,2022-12-13,GRIFF,gemGrab,Crystal Arcade,0,1,0,1,72
7758,2022-12-11,GRIFF,gemGrab,Double Swoosh,0,0,1,1,12
7759,2022-12-11,GRIFF,brawlBall,Backyard Bowl,0,1,2,3,24
7760,2022-11-11,GRIFF,brawlBall,Sneaky Fields,0,3,5,8,42
7761,2022-10-30,GRIFF,hotZone,Dueling Beetles,0,1,0,1,12
7762,2022-10-30,GRIFF,brawlBall,Beach Ball,0,1,0,1,12
7763,2022-10-28,GRIFF,knockout,Out in the Open,0,1,0,1,18
7764,2022-10-28,GRIFF,bounty,Canal Grande,0,0,2,2,12
7765,2022-10-15,GRIFF,hotZone,Ring of Fire,0,1,2,3,24
7766,2022-10-15,GRIFF,gemGrab,Hard Rock Mine,0,0,1,1,90
7767,2023-01-28,GRAY,knockout,Flaring Phoenix,4,333,475,812,12366
7768,2023-01-28,GRAY,hotZone,Controller Chaos,0,36,34,70,10134
7769,2023-01-28,GRAY,heist,Bridge Too Far,1,27,16,44,24240
7770,2023-01-28,GRAY,gemGrab,Hard Rock Mine,0,85,99,184,16638
7771,2023-01-28,GRAY,gemGrab,Deep Diner,0,35,59,94,5478
7772,2023-01-28,GRAY,brawlBall,Super Beach,17,432,507,956,74430
7773,2023-01-28,GRAY,brawlBall,Sneaky Fields,0,19,19,38,3582
7774,2023-01-28,GRAY,bounty,Canal Grande,0,62,64,126,10902
7775,2023-01-27,GRAY,knockout,Flaring Phoenix,2,191,261,454,5928
7776,2023-01-27,GRAY,hotZone,Controller Chaos,0,10,9,19,2676
7777,2023-01-27,GRAY,heist,Hot Potato,0,6,2,8,3486
7778,2023-01-27,GRAY,gemGrab,Undermine,0,3,8,11,942
7779,2023-01-27,GRAY,gemGrab,Deep Diner,0,52,93,145,6846
7780,2023-01-27,GRAY,brawlBall,Sneaky Fields,1,96,98,195,23514
7781,2023-01-27,GRAY,brawlBall,Pinhole Punt,0,5,7,12,738
7782,2023-01-27,GRAY,bounty,Temple Ruins,0,14,28,42,1890
7783,2023-01-26,GRAY,knockout,Riverside,1,166,176,343,19008
7784,2023-01-26,GRAY,hotZone,Open Zone,0,31,52,83,10182
7785,2023-01-26,GRAY,heist,Hot Potato,0,12,10,22,14610
7786,2023-01-26,GRAY,gemGrab,Undermine,0,27,35,62,10062
7787,2023-01-26,GRAY,gemGrab,Gem Fort,0,29,23,52,4674
7788,2023-01-26,GRAY,brawlBall,Sunny Soccer,0,33,38,71,3660
7789,2023-01-26,GRAY,brawlBall,Pinhole Punt,18,412,474,904,67338
7790,2023-01-26,GRAY,bounty,Temple Ruins,0,67,79,146,5610
7791,2023-01-25,GRAY,knockout,Riverside,0,96,82,178,9906
7792,2023-01-25,GRAY,hotZone,Open Zone,0,13,30,43,5262
7793,2023-01-25,GRAY,heist,Safe Zone,0,11,7,18,9156
7794,2023-01-25,GRAY,gemGrab,Gem Fort,0,33,66,99,5556
7795,2023-01-25,GRAY,gemGrab,Crystal Arcade,0,41,80,121,7866
7796,2023-01-25,GRAY,brawlBall,Sunny Soccer,4,275,279,558,40830
7797,2023-01-25,GRAY,brawlBall,Beach Ball,3,62,61,126,6408
7798,2023-01-25,GRAY,bounty,Excel,0,44,33,77,5790
7799,2023-01-24,GRAY,knockout,New Perspective,2,301,400,703,10542
7800,2023-01-24,GRAY,hotZone,Dueling Beetles,0,35,39,74,10662
7801,2023-01-24,GRAY,heist,Safe Zone,0,26,34,60,15750
7802,2023-01-24,GRAY,gemGrab,Minecart Madness,0,37,65,102,4002
7803,2023-01-24,GRAY,gemGrab,Crystal Arcade,0,80,117,197,14460
7804,2023-01-24,GRAY,brawlBall,Center Stage,1,43,21,65,7860
7805,2023-01-24,GRAY,brawlBall,Beach Ball,11,524,603,1138,64614
7806,2023-01-24,GRAY,bounty,Excel,0,116,138,254,10896
7807,2023-01-23,GRAY,knockout,New Perspective,2,829,1092,1923,20676
7808,2023-01-23,GRAY,hotZone,Dueling Beetles,0,75,73,148,17502
7809,2023-01-23,GRAY,heist,Snaked Assault,0,13,14,27,15762
7810,2023-01-23,GRAY,gemGrab,Minecart Madness,0,153,240,393,19062
7811,2023-01-23,GRAY,gemGrab,Double Swoosh,0,29,41,70,7578
7812,2023-01-23,GRAY,brawlBall,Center Stage,12,460,534,1006,92862
7813,2023-01-23,GRAY,brawlBall,Backyard Bowl,0,28,22,50,4224
7814,2023-01-23,GRAY,bounty,Layer Cake,0,134,195,329,11142
7815,2023-01-22,GRAY,knockout,X Marks the Spot,3,368,432,803,9174
7816,2023-01-22,GRAY,hotZone,Ring of Fire,0,3,5,8,5730
7817,2023-01-22,GRAY,heist,Snaked Assault,0,7,6,13,8232
7818,2023-01-22,GRAY,gemGrab,Hard Rock Mine,0,29,29,58,4722
7819,2023-01-22,GRAY,gemGrab,Double Swoosh,0,44,44,88,9426
7820,2023-01-22,GRAY,brawlBall,Super Beach,0,39,65,104,7386
7821,2023-01-22,GRAY,brawlBall,Backyard Bowl,12,318,439,769,34788
7822,2023-01-22,GRAY,bounty,Layer Cake,0,68,77,145,6654
7823,2023-01-21,GRAY,knockout,X Marks the Spot,3,1274,1670,2947,31698
7824,2023-01-21,GRAY,hotZone,Ring of Fire,0,47,78,125,16632
7825,2023-01-21,GRAY,heist,Tornado Ring,0,17,6,23,11664
7826,2023-01-21,GRAY,gemGrab,Hard Rock Mine,0,79,100,179,22980
7827,2023-01-21,GRAY,gemGrab,Deep Diner,0,34,54,88,4470
7828,2023-01-21,GRAY,brawlBall,Super Beach,19,653,854,1526,101364
7829,2023-01-21,GRAY,brawlBall,Sneaky Fields,0,15,21,36,3750
7830,2023-01-21,GRAY,bounty,Dry Season,0,156,165,321,14538
7831,2023-01-20,GRAY,knockout,Out in the Open,8,558,844,1410,20106
7832,2023-01-20,GRAY,hotZone,Split,0,61,81,142,9678
7833,2023-01-20,GRAY,heist,Tornado Ring,0,19,8,27,12672
7834,2023-01-20,GRAY,gemGrab,Undermine,0,28,21,49,5442
7835,2023-01-20,GRAY,gemGrab,Deep Diner,0,140,187,327,19050
7836,2023-01-20,GRAY,brawlBall,Sneaky Fields,5,264,270,539,74778
7837,2023-01-20,GRAY,brawlBall,Pinhole Punt,1,10,12,23,2886
7838,2023-01-20,GRAY,bounty,Dry Season,0,119,161,280,11640
7839,2023-01-19,GRAY,knockout,Out in the Open,13,1052,1525,2590,26574
7840,2023-01-19,GRAY,hotZone,Split,0,68,57,125,14856
7841,2023-01-19,GRAY,heist,Kaboom Canyon,1,18,23,42,6732
7842,2023-01-19,GRAY,gemGrab,Undermine,0,53,78,131,14154
7843,2023-01-19,GRAY,gemGrab,Gem Fort,0,9,8,17,2934
7844,2023-01-19,GRAY,brawlBall,Sunny Soccer,0,17,23,40,2274
7845,2023-01-19,GRAY,brawlBall,Pinhole Punt,21,417,474,912,72498
7846,2023-01-19,GRAY,bounty,Shooting Star,0,89,120,209,11124
7847,2023-01-18,GRAY,knockout,Goldarm Gulch,3,109,123,235,2784
7848,2023-01-18,GRAY,hotZone,Parallel Plays,0,9,7,16,1158
7849,2023-01-18,GRAY,heist,Kaboom Canyon,0,8,8,16,2592
7850,2023-01-18,GRAY,gemGrab,Gem Fort,0,20,19,39,3006
7851,2023-01-18,GRAY,gemGrab,Crystal Arcade,0,2,3,5,990
7852,2023-01-18,GRAY,brawlBall,Sunny Soccer,8,163,177,348,18941
7853,2023-01-18,GRAY,brawlBall,Beach Ball,1,8,10,19,774
7854,2023-01-18,GRAY,bounty,Shooting Star,0,57,36,93,5088
7855,2023-01-17,GRAY,knockout,Goldarm Gulch,0,83,132,215,2520
7856,2023-01-17,GRAY,hotZone,Parallel Plays,0,4,8,12,1038
7857,2023-01-17,GRAY,gemGrab,Minecart Madness,0,2,4,6,216
7858,2023-01-17,GRAY,gemGrab,Crystal Arcade,0,7,5,12,1266
7859,2023-01-17,GRAY,brawlBall,Center Stage,0,1,0,1,288
7860,2023-01-17,GRAY,brawlBall,Beach Ball,1,30,62,93,5886
7861,2023-01-17,GRAY,bounty,Hideout,0,4,8,12,750
7862,2023-01-16,GRAY,knockout,Belle's Rock,0,44,70,114,1788
7863,2023-01-16,GRAY,hotZone,Quarter Pounder,0,7,3,10,1494
7864,2023-01-16,GRAY,heist,Pit Stop,0,2,0,2,4044
7865,2023-01-16,GRAY,gemGrab,Minecart Madness,0,17,28,45,1422
7866,2023-01-16,GRAY,gemGrab,Double Swoosh,0,1,1,2,708
7867,2023-01-16,GRAY,brawlBall,Center Stage,0,28,34,62,5778
7868,2023-01-16,GRAY,brawlBall,Backyard Bowl,0,4,1,5,852
7869,2023-01-16,GRAY,bounty,Hideout,0,11,11,22,1470
7870,2023-01-15,GRAY,knockout,Belle's Rock,0,83,95,178,2904
7871,2023-01-15,GRAY,hotZone,Quarter Pounder,0,21,82,103,3318
7872,2023-01-15,GRAY,heist,Bridge Too Far,0,3,0,3,2736
7873,2023-01-15,GRAY,gemGrab,Hard Rock Mine,0,2,4,6,1014
7874,2023-01-15,GRAY,gemGrab,Double Swoosh,0,8,7,15,2178
7875,2023-01-15,GRAY,brawlBall,Super Beach,0,3,1,4,1074
7876,2023-01-15,GRAY,brawlBall,Backyard Bowl,1,49,50,100,8946
7877,2023-01-15,GRAY,bounty,Canal Grande,0,6,3,9,960
7878,2023-01-14,GRAY,knockout,Flaring Phoenix,1,43,60,104,1080
7879,2023-01-14,GRAY,hotZone,Controller Chaos,0,9,0,9,2772
7880,2023-01-14,GRAY,heist,Bridge Too Far,0,3,0,3,4020
7881,2023-01-14,GRAY,gemGrab,Hard Rock Mine,0,3,1,4,1272
7882,2023-01-14,GRAY,gemGrab,Deep Diner,0,8,6,14,858
7883,2023-01-14,GRAY,brawlBall,Super Beach,0,26,27,53,6336
7884,2023-01-14,GRAY,bounty,Canal Grande,0,4,3,7,1014
7885,2023-01-13,GRAY,knockout,Flaring Phoenix,0,33,38,71,1182
7886,2023-01-13,GRAY,hotZone,Controller Chaos,0,3,3,6,2928
7887,2023-01-13,GRAY,gemGrab,Deep Diner,0,7,23,30,1650
7888,2023-01-13,GRAY,brawlBall,Sneaky Fields,1,12,42,55,6144
7889,2023-01-13,GRAY,brawlBall,Pinhole Punt,0,0,1,1,156
7890,2023-01-13,GRAY,bounty,Temple Ruins,0,1,1,2,270
7891,2023-01-12,GRAY,knockout,Riverside,0,24,16,40,2532
7892,2023-01-12,GRAY,hotZone,Open Zone,0,8,13,21,1488
7893,2023-01-12,GRAY,heist,Hot Potato,0,1,0,1,330
7894,2023-01-12,GRAY,gemGrab,Undermine,0,7,17,24,690
7895,2023-01-12,GRAY,gemGrab,Gem Fort,0,2,8,10,162
7896,2023-01-12,GRAY,brawlBall,Sunny Soccer,0,5,6,11,240
7897,2023-01-12,GRAY,brawlBall,Pinhole Punt,0,14,14,28,2292
7898,2023-01-11,GRAY,knockout,Riverside,0,7,8,15,528
7899,2023-01-11,GRAY,hotZone,Open Zone,0,2,0,2,462
7900,2023-01-11,GRAY,heist,Safe Zone,0,0,3,3,48
7901,2023-01-11,GRAY,gemGrab,Gem Fort,0,0,2,2,414
7902,2023-01-11,GRAY,brawlBall,Sunny Soccer,0,15,27,42,1638
7903,2023-01-11,GRAY,bounty,Excel,0,2,0,2,282
7904,2023-01-10,GRAY,knockout,New Perspective,0,25,38,63,720
7905,2023-01-10,GRAY,hotZone,Dueling Beetles,0,12,30,42,2424
7906,2023-01-10,GRAY,gemGrab,Minecart Madness,0,1,4,5,828
7907,2023-01-10,GRAY,gemGrab,Crystal Arcade,0,13,30,43,1746
7908,2023-01-10,GRAY,brawlBall,Center Stage,0,4,0,4,708
7909,2023-01-10,GRAY,brawlBall,Beach Ball,1,48,54,103,4392
7910,2023-01-10,GRAY,bounty,Excel,0,6,3,9,330
7911,2023-01-09,GRAY,knockout,New Perspective,0,51,60,111,876
7912,2023-01-09,GRAY,hotZone,Dueling Beetles,0,10,17,27,1554
7913,2023-01-09,GRAY,gemGrab,Minecart Madness,0,21,37,58,1884
7914,2023-01-09,GRAY,gemGrab,Double Swoosh,0,10,32,42,1320
7915,2023-01-09,GRAY,brawlBall,Center Stage,1,40,28,69,5460
7916,2023-01-09,GRAY,brawlBall,Backyard Bowl,2,11,35,48,474
7917,2023-01-09,GRAY,bounty,Layer Cake,0,12,12,24,1512
7918,2023-01-08,GRAY,knockout,X Marks the Spot,0,61,100,161,1692
7919,2023-01-08,GRAY,hotZone,Ring of Fire,0,3,0,3,1644
7920,2023-01-08,GRAY,heist,Snaked Assault,0,1,12,13,1494
7921,2023-01-08,GRAY,gemGrab,Hard Rock Mine,0,2,0,2,630
7922,2023-01-08,GRAY,gemGrab,Double Swoosh,0,9,14,23,864
7923,2023-01-08,GRAY,brawlBall,Super Beach,0,5,2,7,732
7924,2023-01-08,GRAY,brawlBall,Backyard Bowl,0,58,67,125,4830
7925,2023-01-08,GRAY,bounty,Layer Cake,0,4,2,6,528
7926,2023-01-07,GRAY,knockout,X Marks the Spot,0,47,89,136,1014
7927,2023-01-07,GRAY,hotZone,Ring of Fire,0,0,3,3,846
7928,2023-01-07,GRAY,heist,Tornado Ring,0,1,0,1,1350
7929,2023-01-07,GRAY,gemGrab,Hard Rock Mine,0,7,35,42,1158
7930,2023-01-07,GRAY,gemGrab,Deep Diner,0,10,21,31,918
7931,2023-01-07,GRAY,brawlBall,Super Beach,0,38,38,76,2622
7932,2023-01-07,GRAY,brawlBall,Sneaky Fields,0,0,1,1,402
7933,2023-01-07,GRAY,bounty,Dry Season,0,10,4,14,1320
7934,2023-01-06,GRAY,knockout,Out in the Open,0,86,137,223,1446
7935,2023-01-06,GRAY,hotZone,Split,0,10,23,33,1158
7936,2023-01-06,GRAY,heist,Tornado Ring,1,1,0,2,2538
7937,2023-01-06,GRAY,gemGrab,Undermine,0,9,4,13,540
7938,2023-01-06,GRAY,gemGrab,Deep Diner,0,13,23,36,2226
7939,2023-01-06,GRAY,brawlBall,Sneaky Fields,1,26,22,49,4896
7940,2023-01-06,GRAY,brawlBall,Pinhole Punt,0,12,9,21,510
7941,2023-01-06,GRAY,bounty,Dry Season,0,14,6,20,1944
7942,2023-01-05,GRAY,knockout,Out in the Open,2,126,201,329,2958
7943,2023-01-05,GRAY,hotZone,Split,0,46,78,124,3552
7944,2023-01-05,GRAY,heist,Kaboom Canyon,0,2,0,2,954
7945,2023-01-05,GRAY,gemGrab,Undermine,0,12,28,40,1812
7946,2023-01-05,GRAY,gemGrab,Gem Fort,0,3,0,3,252
7947,2023-01-05,GRAY,brawlBall,Sunny Soccer,0,0,2,2,84
7948,2023-01-05,GRAY,brawlBall,Pinhole Punt,4,84,132,220,8118
7949,2023-01-05,GRAY,bounty,Shooting Star,0,9,9,18,1362
7950,2023-01-04,GRAY,knockout,Goldarm Gulch,0,24,14,38,696
7951,2023-01-04,GRAY,hotZone,Parallel Plays,0,2,3,5,864
7952,2023-01-04,GRAY,heist,Kaboom Canyon,0,1,5,6,1848
7953,2023-01-04,GRAY,gemGrab,Gem Fort,0,9,33,42,1788
7954,2023-01-04,GRAY,gemGrab,Crystal Arcade,0,8,9,17,642
7955,2023-01-04,GRAY,brawlBall,Sunny Soccer,1,95,161,257,6312
7956,2023-01-04,GRAY,bounty,Shooting Star,0,5,8,13,3570
7957,2023-01-03,GRAY,knockout,Goldarm Gulch,0,15,28,43,720
7958,2023-01-03,GRAY,hotZone,Parallel Plays,0,4,0,4,1542
7959,2023-01-03,GRAY,gemGrab,Minecart Madness,0,3,2,5,456
7960,2023-01-03,GRAY,gemGrab,Crystal Arcade,0,15,81,96,2406
7961,2023-01-03,GRAY,brawlBall,Center Stage,0,7,9,16,294
7962,2023-01-03,GRAY,brawlBall,Beach Ball,1,71,124,196,5580
7963,2023-01-03,GRAY,bounty,Hideout,0,16,14,30,1638
7964,2023-01-02,GRAY,knockout,Belle's Rock,0,44,49,93,1794
7965,2023-01-02,GRAY,hotZone,Quarter Pounder,0,16,9,25,2652
7966,2023-01-02,GRAY,heist,Pit Stop,0,1,0,1,3498
7967,2023-01-02,GRAY,gemGrab,Minecart Madness,0,13,13,26,2352
7968,2023-01-02,GRAY,gemGrab,Double Swoosh,0,15,22,37,1512
7969,2023-01-02,GRAY,brawlBall,Center Stage,2,90,165,257,7110
7970,2023-01-02,GRAY,brawlBall,Backyard Bowl,2,17,31,50,492
7971,2023-01-02,GRAY,bounty,Hideout,0,33,91,124,3090
7972,2023-01-01,GRAY,knockout,Belle's Rock,0,16,24,40,858
7973,2023-01-01,GRAY,hotZone,Quarter Pounder,0,30,41,71,1188
7974,2023-01-01,GRAY,heist,Bridge Too Far,0,0,1,1,462
7975,2023-01-01,GRAY,gemGrab,Double Swoosh,0,9,12,21,1140
7976,2023-01-01,GRAY,brawlBall,Backyard Bowl,2,39,88,129,2658
7977,2023-01-01,GRAY,bounty,Canal Grande,0,1,0,1,132
7978,2022-12-31,GRAY,knockout,Flaring Phoenix,0,1,1,2,18
7979,2022-12-31,GRAY,heist,Kaboom Canyon,0,1,1,2,12
7980,2022-12-31,GRAY,heist,Bridge Too Far,0,1,0,1,276
7981,2022-12-31,GRAY,gemGrab,Hard Rock Mine,0,9,15,24,384
7982,2022-12-31,GRAY,gemGrab,Deep Diner,0,3,4,7,306
7983,2022-12-31,GRAY,brawlBall,Super Beach,0,5,5,10,618
7984,2022-12-31,GRAY,brawlBall,Sneaky Fields,0,1,0,1,60
7985,2022-12-31,GRAY,bounty,Canal Grande,0,0,2,2,54
7986,2022-12-30,GRAY,knockout,Flaring Phoenix,0,4,8,12,72
7987,2022-12-30,GRAY,hotZone,Controller Chaos,0,2,1,3,288
7988,2022-12-30,GRAY,heist,Hot Potato,0,1,0,1,30
7989,2022-12-30,GRAY,gemGrab,Undermine,0,1,0,1,102
7990,2022-12-30,GRAY,gemGrab,Minecart Madness,0,1,0,1,24
7991,2022-12-30,GRAY,gemGrab,Deep Diner,0,7,14,21,438
7992,2022-12-30,GRAY,brawlBall,Sneaky Fields,2,15,26,43,552
7993,2022-12-29,GRAY,hotZone,Open Zone,0,1,0,1,54
7994,2022-12-29,GRAY,heist,Kaboom Canyon,0,0,1,1,18
7995,2022-12-29,GRAY,gemGrab,Undermine,0,2,8,10,102
7996,2022-12-29,GRAY,gemGrab,Minecart Madness,0,0,1,1,24
7997,2022-12-29,GRAY,brawlBall,Pinhole Punt,0,6,7,13,282
7998,2022-12-28,GRAY,hotZone,Open Zone,0,2,2,4,108
7999,2022-12-27,GRAY,knockout,New Perspective,0,3,0,3,30
8000,2022-12-27,GRAY,hotZone,Dueling Beetles,0,0,1,1,36
8001,2022-12-27,GRAY,hotZone,Controller Chaos,0,1,0,1,24
8002,2022-12-27,GRAY,gemGrab,Minecart Madness,0,0,2,2,30
8003,2022-12-27,GRAY,brawlBall,Beach Ball,0,3,10,13,144
8004,2022-12-27,GRAY,bounty,Excel,0,0,1,1,18
8005,2022-12-26,GRAY,hotZone,Controller Chaos,0,3,2,5,30
8006,2022-12-26,GRAY,heist,Kaboom Canyon,0,0,1,1,36
8007,2022-12-26,GRAY,gemGrab,Minecart Madness,0,1,2,3,60
8008,2022-12-26,GRAY,brawlBall,Center Stage,0,0,1,1,78
8009,2022-12-25,GRAY,hotZone,Ring of Fire,0,1,1,2,12
8010,2022-12-23,GRAY,knockout,Out in the Open,0,0,1,1,132
8011,2022-12-22,GRAY,brawlBall,Pinhole Punt,0,1,2,3,132
8012,2022-12-20,GRAY,brawlBall,Beach Ball,1,3,1,5,96
8013,2022-12-18,GRAY,knockout,Belle's Rock,0,0,1,1,6
8014,2022-12-17,GRAY,knockout,Flaring Phoenix,0,1,0,1,30
8015,2022-12-13,GRAY,knockout,New Perspective,0,2,0,2,84
8016,2022-12-13,GRAY,brawlBall,Beach Ball,0,2,5,7,54
8017,2023-01-28,GENE,knockout,Flaring Phoenix,0,123,108,231,12366
8018,2023-01-28,GENE,hotZone,Controller Chaos,0,10,5,15,10134
8019,2023-01-28,GENE,heist,Bridge Too Far,0,8,4,12,24240
8020,2023-01-28,GENE,gemGrab,Hard Rock Mine,0,369,358,727,16638
8021,2023-01-28,GENE,gemGrab,Deep Diner,0,93,126,219,5478
8022,2023-01-28,GENE,brawlBall,Super Beach,4,125,81,210,74430
8023,2023-01-28,GENE,brawlBall,Sneaky Fields,0,7,7,14,3582
8024,2023-01-28,GENE,bounty,Canal Grande,0,132,154,286,10902
8025,2023-01-27,GENE,knockout,Flaring Phoenix,2,43,58,103,5928
8026,2023-01-27,GENE,hotZone,Controller Chaos,0,3,5,8,2676
8027,2023-01-27,GENE,heist,Hot Potato,0,1,0,1,3486
8028,2023-01-27,GENE,gemGrab,Undermine,0,16,20,36,942
8029,2023-01-27,GENE,gemGrab,Deep Diner,0,116,133,249,6846
8030,2023-01-27,GENE,brawlBall,Sneaky Fields,0,38,23,61,23514
8031,2023-01-27,GENE,brawlBall,Pinhole Punt,0,1,1,2,738
8032,2023-01-27,GENE,bounty,Temple Ruins,0,30,72,102,1890
8033,2023-01-26,GENE,knockout,Riverside,0,215,240,455,19008
8034,2023-01-26,GENE,hotZone,Open Zone,0,29,3,32,10182
8035,2023-01-26,GENE,heist,Hot Potato,0,1,2,3,14610
8036,2023-01-26,GENE,gemGrab,Undermine,0,207,185,392,10062
8037,2023-01-26,GENE,gemGrab,Gem Fort,0,74,87,161,4674
8038,2023-01-26,GENE,brawlBall,Sunny Soccer,0,5,3,8,3660
8039,2023-01-26,GENE,brawlBall,Pinhole Punt,7,246,217,470,67338
8040,2023-01-26,GENE,bounty,Temple Ruins,0,100,152,252,5610
8041,2023-01-25,GENE,knockout,Riverside,0,114,97,211,9906
8042,2023-01-25,GENE,hotZone,Open Zone,0,12,6,18,5262
8043,2023-01-25,GENE,heist,Safe Zone,0,4,2,6,9156
8044,2023-01-25,GENE,gemGrab,Gem Fort,0,91,76,167,5556
8045,2023-01-25,GENE,gemGrab,Crystal Arcade,0,140,136,276,7866
8046,2023-01-25,GENE,brawlBall,Sunny Soccer,2,90,73,165,40830
8047,2023-01-25,GENE,brawlBall,Beach Ball,1,18,13,32,6408
8048,2023-01-25,GENE,bounty,Excel,0,68,91,159,5790
8049,2023-01-24,GENE,knockout,New Perspective,0,112,93,205,10542
8050,2023-01-24,GENE,hotZone,Dueling Beetles,0,5,8,13,10662
8051,2023-01-24,GENE,heist,Safe Zone,0,7,3,10,15750
8052,2023-01-24,GENE,gemGrab,Minecart Madness,0,57,66,123,4002
8053,2023-01-24,GENE,gemGrab,Crystal Arcade,0,360,279,639,14460
8054,2023-01-24,GENE,brawlBall,Center Stage,1,6,8,15,7860
8055,2023-01-24,GENE,brawlBall,Beach Ball,5,158,153,316,64614
8056,2023-01-24,GENE,bounty,Excel,0,160,244,404,10896
8057,2023-01-23,GENE,knockout,New Perspective,0,164,179,343,20676
8058,2023-01-23,GENE,hotZone,Dueling Beetles,0,9,1,10,17502
8059,2023-01-23,GENE,heist,Snaked Assault,0,18,10,28,15762
8060,2023-01-23,GENE,gemGrab,Minecart Madness,0,338,369,707,19062
8061,2023-01-23,GENE,gemGrab,Double Swoosh,0,190,161,351,7578
8062,2023-01-23,GENE,brawlBall,Center Stage,5,157,152,314,92862
8063,2023-01-23,GENE,brawlBall,Backyard Bowl,2,30,32,64,4224
8064,2023-01-23,GENE,bounty,Layer Cake,0,146,228,374,11142
8065,2023-01-22,GENE,knockout,X Marks the Spot,0,152,178,330,9174
8066,2023-01-22,GENE,hotZone,Ring of Fire,0,8,1,9,5730
8067,2023-01-22,GENE,gemGrab,Hard Rock Mine,0,92,87,179,4722
8068,2023-01-22,GENE,gemGrab,Double Swoosh,0,299,313,612,9426
8069,2023-01-22,GENE,brawlBall,Super Beach,1,12,12,25,7386
8070,2023-01-22,GENE,brawlBall,Backyard Bowl,5,173,174,352,34788
8071,2023-01-22,GENE,bounty,Layer Cake,0,119,150,269,6654
8072,2023-01-21,GENE,knockout,X Marks the Spot,2,451,562,1015,31698
8073,2023-01-21,GENE,hotZone,Ring of Fire,0,20,3,23,16632
8074,2023-01-21,GENE,heist,Tornado Ring,0,5,0,5,11664
8075,2023-01-21,GENE,gemGrab,Hard Rock Mine,0,583,560,1143,22980
8076,2023-01-21,GENE,gemGrab,Deep Diner,0,57,82,139,4470
8077,2023-01-21,GENE,brawlBall,Super Beach,8,166,126,300,101364
8078,2023-01-21,GENE,brawlBall,Sneaky Fields,0,12,4,16,3750
8079,2023-01-21,GENE,bounty,Dry Season,0,239,362,601,14538
8080,2023-01-20,GENE,knockout,Out in the Open,2,331,380,713,20106
8081,2023-01-20,GENE,hotZone,Split,0,9,1,10,9678
8082,2023-01-20,GENE,heist,Tornado Ring,0,1,0,1,12672
8083,2023-01-20,GENE,gemGrab,Undermine,0,109,130,239,5442
8084,2023-01-20,GENE,gemGrab,Deep Diner,0,362,338,700,19050
8085,2023-01-20,GENE,brawlBall,Sneaky Fields,6,101,103,210,74778
8086,2023-01-20,GENE,brawlBall,Pinhole Punt,0,5,7,12,2886
8087,2023-01-20,GENE,bounty,Dry Season,0,261,316,577,11640
8088,2023-01-19,GENE,knockout,Out in the Open,1,408,355,764,26574
8089,2023-01-19,GENE,hotZone,Split,0,5,6,11,14856
8090,2023-01-19,GENE,heist,Kaboom Canyon,0,6,2,8,6732
8091,2023-01-19,GENE,gemGrab,Undermine,0,259,248,507,14154
8092,2023-01-19,GENE,gemGrab,Gem Fort,0,39,33,72,2934
8093,2023-01-19,GENE,brawlBall,Sunny Soccer,0,3,2,5,2274
8094,2023-01-19,GENE,brawlBall,Pinhole Punt,14,206,189,409,72498
8095,2023-01-19,GENE,bounty,Shooting Star,0,132,184,316,11124
8096,2023-01-18,GENE,knockout,Goldarm Gulch,0,31,40,71,2784
8097,2023-01-18,GENE,hotZone,Parallel Plays,0,2,2,4,1158
8098,2023-01-18,GENE,heist,Kaboom Canyon,0,2,0,2,2592
8099,2023-01-18,GENE,gemGrab,Gem Fort,0,51,47,98,3006
8100,2023-01-18,GENE,gemGrab,Crystal Arcade,0,20,39,59,990
8101,2023-01-18,GENE,brawlBall,Sunny Soccer,1,30,57,88,18941
8102,2023-01-18,GENE,brawlBall,Beach Ball,0,2,1,3,774
8103,2023-01-18,GENE,bounty,Shooting Star,0,65,87,152,5088
8104,2023-01-17,GENE,knockout,Goldarm Gulch,0,34,31,65,2520
8105,2023-01-17,GENE,hotZone,Parallel Plays,0,0,3,3,1038
8106,2023-01-17,GENE,heist,Pit Stop,0,0,1,1,1290
8107,2023-01-17,GENE,gemGrab,Minecart Madness,0,4,2,6,216
8108,2023-01-17,GENE,gemGrab,Crystal Arcade,0,24,31,55,1266
8109,2023-01-17,GENE,brawlBall,Beach Ball,0,20,15,35,5886
8110,2023-01-17,GENE,bounty,Hideout,0,14,9,23,750
8111,2023-01-16,GENE,knockout,Belle's Rock,0,19,20,39,1788
8112,2023-01-16,GENE,gemGrab,Minecart Madness,0,25,24,49,1422
8113,2023-01-16,GENE,gemGrab,Double Swoosh,0,24,55,79,708
8114,2023-01-16,GENE,brawlBall,Center Stage,0,7,8,15,5778
8115,2023-01-16,GENE,brawlBall,Backyard Bowl,0,2,2,4,852
8116,2023-01-16,GENE,bounty,Hideout,0,13,17,30,1470
8117,2023-01-15,GENE,knockout,Belle's Rock,0,42,33,75,2904
8118,2023-01-15,GENE,hotZone,Quarter Pounder,0,3,0,3,3318
8119,2023-01-15,GENE,heist,Bridge Too Far,0,1,0,1,2736
8120,2023-01-15,GENE,gemGrab,Hard Rock Mine,0,30,29,59,1014
8121,2023-01-15,GENE,gemGrab,Double Swoosh,0,89,71,160,2178
8122,2023-01-15,GENE,brawlBall,Backyard Bowl,4,54,36,94,8946
8123,2023-01-15,GENE,bounty,Canal Grande,0,13,10,23,960
8124,2023-01-14,GENE,knockout,Flaring Phoenix,0,11,22,33,1080
8125,2023-01-14,GENE,hotZone,Controller Chaos,0,3,0,3,2772
8126,2023-01-14,GENE,heist,Bridge Too Far,0,2,1,3,4020
8127,2023-01-14,GENE,gemGrab,Hard Rock Mine,0,26,11,37,1272
8128,2023-01-14,GENE,gemGrab,Deep Diner,0,25,32,57,858
8129,2023-01-14,GENE,brawlBall,Super Beach,0,11,4,15,6336
8130,2023-01-14,GENE,brawlBall,Sneaky Fields,0,1,12,13,918
8131,2023-01-14,GENE,bounty,Canal Grande,0,8,4,12,1014
8132,2023-01-13,GENE,knockout,Flaring Phoenix,0,19,11,30,1182
8133,2023-01-13,GENE,gemGrab,Deep Diner,0,26,57,83,1650
8134,2023-01-13,GENE,brawlBall,Sneaky Fields,2,8,19,29,6144
8135,2023-01-13,GENE,brawlBall,Pinhole Punt,0,0,1,1,156
8136,2023-01-13,GENE,bounty,Temple Ruins,0,8,0,8,270
8137,2023-01-12,GENE,knockout,Riverside,0,17,7,24,2532
8138,2023-01-12,GENE,hotZone,Open Zone,0,9,11,20,1488
8139,2023-01-12,GENE,gemGrab,Undermine,0,21,19,40,690
8140,2023-01-12,GENE,gemGrab,Gem Fort,0,3,2,5,162
8141,2023-01-12,GENE,brawlBall,Pinhole Punt,0,7,3,10,2292
8142,2023-01-11,GENE,knockout,Riverside,0,2,2,4,528
8143,2023-01-11,GENE,gemGrab,Gem Fort,0,14,22,36,414
8144,2023-01-11,GENE,brawlBall,Sunny Soccer,0,3,1,4,1638
8145,2023-01-11,GENE,bounty,Excel,0,6,15,21,282
8146,2023-01-10,GENE,knockout,New Perspective,0,3,2,5,720
8147,2023-01-10,GENE,hotZone,Dueling Beetles,0,1,0,1,2424
8148,2023-01-10,GENE,gemGrab,Minecart Madness,0,23,1,24,828
8149,2023-01-10,GENE,gemGrab,Crystal Arcade,0,18,14,32,1746
8150,2023-01-10,GENE,brawlBall,Beach Ball,0,9,12,21,4392
8151,2023-01-10,GENE,bounty,Excel,0,6,12,18,330
8152,2023-01-09,GENE,knockout,New Perspective,0,2,16,18,876
8153,2023-01-09,GENE,hotZone,Dueling Beetles,0,1,0,1,1554
8154,2023-01-09,GENE,gemGrab,Minecart Madness,1,34,22,57,1884
8155,2023-01-09,GENE,gemGrab,Double Swoosh,0,30,28,58,1320
8156,2023-01-09,GENE,brawlBall,Center Stage,1,6,6,13,5460
8157,2023-01-09,GENE,brawlBall,Backyard Bowl,1,0,1,2,474
8158,2023-01-09,GENE,bounty,Layer Cake,0,23,62,85,1512
8159,2023-01-08,GENE,knockout,X Marks the Spot,0,25,41,66,1692
8160,2023-01-08,GENE,hotZone,Ring of Fire,0,0,1,1,1644
8161,2023-01-08,GENE,heist,Snaked Assault,0,1,0,1,1494
8162,2023-01-08,GENE,gemGrab,Hard Rock Mine,0,18,12,30,630
8163,2023-01-08,GENE,gemGrab,Double Swoosh,0,29,31,60,864
8164,2023-01-08,GENE,brawlBall,Super Beach,0,2,0,2,732
8165,2023-01-08,GENE,brawlBall,Backyard Bowl,0,27,29,56,4830
8166,2023-01-08,GENE,bounty,Layer Cake,0,29,53,82,528
8167,2023-01-07,GENE,knockout,X Marks the Spot,0,25,26,51,1014
8168,2023-01-07,GENE,heist,Tornado Ring,0,1,0,1,1350
8169,2023-01-07,GENE,gemGrab,Hard Rock Mine,0,38,28,66,1158
8170,2023-01-07,GENE,gemGrab,Deep Diner,0,28,19,47,918
8171,2023-01-07,GENE,brawlBall,Super Beach,0,7,1,8,2622
8172,2023-01-07,GENE,brawlBall,Sneaky Fields,0,1,0,1,402
8173,2023-01-07,GENE,bounty,Dry Season,0,44,60,104,1320
8174,2023-01-06,GENE,knockout,Out in the Open,0,17,9,26,1446
8175,2023-01-06,GENE,hotZone,Split,0,2,0,2,1158
8176,2023-01-06,GENE,heist,Tornado Ring,0,2,0,2,2538
8177,2023-01-06,GENE,gemGrab,Undermine,0,10,8,18,540
8178,2023-01-06,GENE,gemGrab,Deep Diner,0,51,35,86,2226
8179,2023-01-06,GENE,brawlBall,Sneaky Fields,0,3,1,4,4896
8180,2023-01-06,GENE,brawlBall,Pinhole Punt,0,0,2,2,510
8181,2023-01-06,GENE,bounty,Dry Season,0,77,106,183,1944
8182,2023-01-05,GENE,knockout,Out in the Open,0,67,50,117,2958
8183,2023-01-05,GENE,heist,Kaboom Canyon,0,1,0,1,954
8184,2023-01-05,GENE,gemGrab,Undermine,0,30,25,55,1812
8185,2023-01-05,GENE,gemGrab,Gem Fort,0,4,1,5,252
8186,2023-01-05,GENE,brawlBall,Pinhole Punt,2,18,20,40,8118
8187,2023-01-05,GENE,bounty,Shooting Star,0,24,13,37,1362
8188,2023-01-04,GENE,knockout,Goldarm Gulch,0,18,32,50,696
8189,2023-01-04,GENE,hotZone,Parallel Plays,0,1,0,1,864
8190,2023-01-04,GENE,heist,Kaboom Canyon,0,1,0,1,1848
8191,2023-01-04,GENE,gemGrab,Gem Fort,0,34,31,65,1788
8192,2023-01-04,GENE,gemGrab,Crystal Arcade,0,12,3,15,642
8193,2023-01-04,GENE,brawlBall,Sunny Soccer,1,7,7,15,6312
8194,2023-01-04,GENE,bounty,Shooting Star,0,57,30,87,3570
8195,2023-01-03,GENE,knockout,Goldarm Gulch,0,6,11,17,720
8196,2023-01-03,GENE,hotZone,Parallel Plays,0,2,0,2,1542
8197,2023-01-03,GENE,heist,Pit Stop,0,1,0,1,1956
8198,2023-01-03,GENE,gemGrab,Minecart Madness,0,12,26,38,456
8199,2023-01-03,GENE,gemGrab,Crystal Arcade,0,72,88,160,2406
8200,2023-01-03,GENE,brawlBall,Beach Ball,1,7,2,10,5580
8201,2023-01-03,GENE,bounty,Hideout,0,23,24,47,1638
8202,2023-01-02,GENE,knockout,Belle's Rock,0,35,28,63,1794
8203,2023-01-02,GENE,hotZone,Quarter Pounder,0,4,5,9,2652
8204,2023-01-02,GENE,heist,Pit Stop,0,1,0,1,3498
8205,2023-01-02,GENE,gemGrab,Minecart Madness,0,48,27,75,2352
8206,2023-01-02,GENE,gemGrab,Double Swoosh,0,69,83,152,1512
8207,2023-01-02,GENE,brawlBall,Center Stage,0,23,5,28,7110
8208,2023-01-02,GENE,brawlBall,Backyard Bowl,0,1,0,1,492
8209,2023-01-02,GENE,bounty,Hideout,0,69,48,117,3090
8210,2023-01-01,GENE,knockout,Belle's Rock,0,30,16,46,858
8211,2023-01-01,GENE,hotZone,Quarter Pounder,0,4,14,18,1188
8212,2023-01-01,GENE,hotZone,Controller Chaos,0,0,1,1,12
8213,2023-01-01,GENE,gemGrab,Hard Rock Mine,0,0,1,1,48
8214,2023-01-01,GENE,gemGrab,Double Swoosh,0,57,29,86,1140
8215,2023-01-01,GENE,brawlBall,Backyard Bowl,1,10,20,31,2658
8216,2023-01-01,GENE,bounty,Canal Grande,0,2,3,5,132
8217,2022-12-31,GENE,gemGrab,Hard Rock Mine,0,8,9,17,384
8218,2022-12-31,GENE,gemGrab,Deep Diner,0,11,4,15,306
8219,2022-12-31,GENE,brawlBall,Super Beach,0,2,0,2,618
8220,2022-12-31,GENE,bounty,Canal Grande,0,1,2,3,54
8221,2022-12-30,GENE,knockout,Flaring Phoenix,0,2,1,3,72
8222,2022-12-30,GENE,hotZone,Controller Chaos,0,0,1,1,288
8223,2022-12-30,GENE,gemGrab,Undermine,0,1,1,2,102
8224,2022-12-30,GENE,gemGrab,Deep Diner,0,7,8,15,438
8225,2022-12-29,GENE,gemGrab,Undermine,0,7,7,14,102
8226,2022-12-29,GENE,brawlBall,Pinhole Punt,0,1,0,1,282
8227,2022-12-27,GENE,gemGrab,Minecart Madness,0,0,2,2,30
8228,2022-12-26,GENE,gemGrab,Minecart Madness,0,0,2,2,60
8229,2022-12-25,GENE,gemGrab,Double Swoosh,0,1,0,1,30
8230,2022-12-23,GENE,knockout,Out in the Open,0,10,12,22,132
8231,2022-12-23,GENE,gemGrab,Deep Diner,0,1,0,1,6
8232,2022-12-22,GENE,gemGrab,Gem Fort,0,3,0,3,90
8233,2022-12-22,GENE,brawlBall,Pinhole Punt,0,1,0,1,132
8234,2022-12-21,GENE,bounty,Shooting Star,0,1,2,3,6
8235,2022-12-20,GENE,brawlBall,Beach Ball,0,1,0,1,96
8236,2022-12-19,GENE,brawlBall,Center Stage,0,0,1,1,102
8237,2022-12-17,GENE,knockout,Flaring Phoenix,0,0,1,1,30
8238,2022-12-13,GENE,gemGrab,Crystal Arcade,0,1,0,1,72
8239,2022-12-13,GENE,brawlBall,Beach Ball,0,0,1,1,54
8240,2022-12-10,GENE,knockout,X Marks the Spot,0,0,1,1,12
8241,2022-12-10,GENE,gemGrab,Hard Rock Mine,0,2,1,3,24
8242,2022-11-01,GENE,knockout,New Perspective,0,1,2,3,54
8243,2022-10-30,GENE,knockout,Out in the Open,0,1,2,3,12
8244,2022-10-30,GENE,bounty,Canal Grande,0,0,2,2,12
8245,2022-10-26,GENE,bounty,Shooting Star,0,0,1,1,36
8246,2022-10-15,GENE,gemGrab,Hard Rock Mine,0,0,2,2,90
8247,2022-10-10,GENE,knockout,Belle's Rock,0,0,3,3,48
8248,2023-01-28,GALE,knockout,Flaring Phoenix,0,18,5,23,12366
8249,2023-01-28,GALE,hotZone,Controller Chaos,0,76,85,161,10134
8250,2023-01-28,GALE,heist,Bridge Too Far,0,12,2,14,24240
8251,2023-01-28,GALE,gemGrab,Hard Rock Mine,0,27,34,61,16638
8252,2023-01-28,GALE,gemGrab,Deep Diner,0,9,3,12,5478
8253,2023-01-28,GALE,brawlBall,Super Beach,7,373,341,721,74430
8254,2023-01-28,GALE,brawlBall,Sneaky Fields,0,20,8,28,3582
8255,2023-01-28,GALE,bounty,Canal Grande,0,13,9,22,10902
8256,2023-01-27,GALE,knockout,Flaring Phoenix,0,11,5,16,5928
8257,2023-01-27,GALE,hotZone,Controller Chaos,0,16,10,26,2676
8258,2023-01-27,GALE,heist,Hot Potato,0,5,0,5,3486
8259,2023-01-27,GALE,gemGrab,Undermine,0,2,2,4,942
8260,2023-01-27,GALE,gemGrab,Deep Diner,0,17,7,24,6846
8261,2023-01-27,GALE,brawlBall,Sneaky Fields,1,143,129,273,23514
8262,2023-01-27,GALE,brawlBall,Pinhole Punt,0,10,7,17,738
8263,2023-01-27,GALE,bounty,Temple Ruins,0,7,1,8,1890
8264,2023-01-26,GALE,knockout,Riverside,0,16,4,20,19008
8265,2023-01-26,GALE,hotZone,Open Zone,0,37,11,48,10182
8266,2023-01-26,GALE,heist,Hot Potato,0,14,8,22,14610
8267,2023-01-26,GALE,gemGrab,Undermine,0,29,43,72,10062
8268,2023-01-26,GALE,gemGrab,Gem Fort,0,21,18,39,4674
8269,2023-01-26,GALE,brawlBall,Sunny Soccer,1,21,36,58,3660
8270,2023-01-26,GALE,brawlBall,Pinhole Punt,17,389,314,720,67338
8271,2023-01-26,GALE,bounty,Temple Ruins,0,13,19,32,5610
8272,2023-01-25,GALE,knockout,Riverside,0,5,3,8,9906
8273,2023-01-25,GALE,hotZone,Open Zone,0,17,9,26,5262
8274,2023-01-25,GALE,heist,Safe Zone,0,7,5,12,9156
8275,2023-01-25,GALE,gemGrab,Gem Fort,0,28,17,45,5556
8276,2023-01-25,GALE,gemGrab,Crystal Arcade,0,18,6,24,7866
8277,2023-01-25,GALE,brawlBall,Sunny Soccer,12,237,205,454,40830
8278,2023-01-25,GALE,brawlBall,Beach Ball,2,33,46,81,6408
8279,2023-01-25,GALE,bounty,Excel,0,4,11,15,5790
8280,2023-01-24,GALE,knockout,New Perspective,0,30,16,46,10542
8281,2023-01-24,GALE,hotZone,Dueling Beetles,0,24,18,42,10662
8282,2023-01-24,GALE,heist,Safe Zone,0,15,4,19,15750
8283,2023-01-24,GALE,gemGrab,Minecart Madness,0,14,8,22,4002
8284,2023-01-24,GALE,gemGrab,Crystal Arcade,0,34,27,61,14460
8285,2023-01-24,GALE,brawlBall,Center Stage,2,50,69,121,7860
8286,2023-01-24,GALE,brawlBall,Beach Ball,15,360,283,658,64614
8287,2023-01-24,GALE,bounty,Excel,0,15,12,27,10896
8288,2023-01-23,GALE,knockout,New Perspective,0,41,27,68,20676
8289,2023-01-23,GALE,hotZone,Dueling Beetles,1,61,53,115,17502
8290,2023-01-23,GALE,heist,Snaked Assault,0,10,5,15,15762
8291,2023-01-23,GALE,gemGrab,Minecart Madness,0,50,30,80,19062
8292,2023-01-23,GALE,gemGrab,Double Swoosh,0,14,21,35,7578
8293,2023-01-23,GALE,brawlBall,Center Stage,31,633,714,1378,92862
8294,2023-01-23,GALE,brawlBall,Backyard Bowl,1,11,6,18,4224
8295,2023-01-23,GALE,bounty,Layer Cake,0,12,7,19,11142
8296,2023-01-22,GALE,knockout,X Marks the Spot,0,12,6,18,9174
8297,2023-01-22,GALE,hotZone,Ring of Fire,0,11,1,12,5730
8298,2023-01-22,GALE,heist,Snaked Assault,0,7,6,13,8232
8299,2023-01-22,GALE,gemGrab,Hard Rock Mine,0,9,5,14,4722
8300,2023-01-22,GALE,gemGrab,Double Swoosh,0,17,16,33,9426
8301,2023-01-22,GALE,brawlBall,Super Beach,0,37,15,52,7386
8302,2023-01-22,GALE,brawlBall,Backyard Bowl,2,104,85,191,34788
8303,2023-01-22,GALE,bounty,Layer Cake,0,4,3,7,6654
8304,2023-01-21,GALE,knockout,X Marks the Spot,1,50,34,85,31698
8305,2023-01-21,GALE,hotZone,Ring of Fire,0,35,15,50,16632
8306,2023-01-21,GALE,heist,Tornado Ring,0,11,0,11,11664
8307,2023-01-21,GALE,gemGrab,Hard Rock Mine,0,43,63,106,22980
8308,2023-01-21,GALE,gemGrab,Deep Diner,0,11,7,18,4470
8309,2023-01-21,GALE,brawlBall,Super Beach,13,488,413,914,101364
8310,2023-01-21,GALE,brawlBall,Sneaky Fields,0,18,15,33,3750
8311,2023-01-21,GALE,bounty,Dry Season,0,10,0,10,14538
8312,2023-01-20,GALE,knockout,Out in the Open,0,37,40,77,20106
8313,2023-01-20,GALE,hotZone,Split,0,109,229,338,9678
8314,2023-01-20,GALE,heist,Tornado Ring,0,12,4,16,12672
8315,2023-01-20,GALE,gemGrab,Undermine,0,23,18,41,5442
8316,2023-01-20,GALE,gemGrab,Deep Diner,0,35,33,68,19050
8317,2023-01-20,GALE,brawlBall,Sneaky Fields,8,359,310,677,74778
8318,2023-01-20,GALE,brawlBall,Pinhole Punt,0,11,10,21,2886
8319,2023-01-20,GALE,bounty,Dry Season,0,10,3,13,11640
8320,2023-01-19,GALE,knockout,Out in the Open,0,47,19,66,26574
8321,2023-01-19,GALE,hotZone,Split,0,157,232,389,14856
8322,2023-01-19,GALE,heist,Kaboom Canyon,0,23,26,49,6732
8323,2023-01-19,GALE,gemGrab,Undermine,0,41,27,68,14154
8324,2023-01-19,GALE,gemGrab,Gem Fort,0,6,5,11,2934
8325,2023-01-19,GALE,brawlBall,Sunny Soccer,0,14,15,29,2274
8326,2023-01-19,GALE,brawlBall,Pinhole Punt,11,416,354,781,72498
8327,2023-01-19,GALE,bounty,Shooting Star,0,14,5,19,11124
8328,2023-01-18,GALE,knockout,Goldarm Gulch,0,0,6,6,2784
8329,2023-01-18,GALE,hotZone,Parallel Plays,0,7,5,12,1158
8330,2023-01-18,GALE,heist,Kaboom Canyon,0,10,11,21,2592
8331,2023-01-18,GALE,gemGrab,Gem Fort,0,9,8,17,3006
8332,2023-01-18,GALE,gemGrab,Crystal Arcade,0,8,3,11,990
8333,2023-01-18,GALE,brawlBall,Sunny Soccer,2,116,87,205,18941
8334,2023-01-18,GALE,brawlBall,Beach Ball,0,2,4,6,774
8335,2023-01-18,GALE,bounty,Shooting Star,0,6,1,7,5088
8336,2023-01-17,GALE,knockout,Goldarm Gulch,0,9,2,11,2520
8337,2023-01-17,GALE,hotZone,Parallel Plays,0,9,8,17,1038
8338,2023-01-17,GALE,heist,Pit Stop,0,1,0,1,1290
8339,2023-01-17,GALE,gemGrab,Minecart Madness,0,1,1,2,216
8340,2023-01-17,GALE,gemGrab,Crystal Arcade,0,1,1,2,1266
8341,2023-01-17,GALE,brawlBall,Center Stage,0,3,3,6,288
8342,2023-01-17,GALE,brawlBall,Beach Ball,1,31,27,59,5886
8343,2023-01-16,GALE,hotZone,Quarter Pounder,0,9,1,10,1494
8344,2023-01-16,GALE,heist,Pit Stop,0,8,1,9,4044
8345,2023-01-16,GALE,gemGrab,Minecart Madness,0,3,3,6,1422
8346,2023-01-16,GALE,gemGrab,Double Swoosh,0,2,3,5,708
8347,2023-01-16,GALE,brawlBall,Center Stage,1,38,43,82,5778
8348,2023-01-16,GALE,brawlBall,Backyard Bowl,0,3,2,5,852
8349,2023-01-15,GALE,knockout,Belle's Rock,0,4,1,5,2904
8350,2023-01-15,GALE,hotZone,Quarter Pounder,0,11,12,23,3318
8351,2023-01-15,GALE,heist,Bridge Too Far,0,1,0,1,2736
8352,2023-01-15,GALE,gemGrab,Hard Rock Mine,0,3,0,3,1014
8353,2023-01-15,GALE,gemGrab,Double Swoosh,0,5,4,9,2178
8354,2023-01-15,GALE,brawlBall,Super Beach,0,4,1,5,1074
8355,2023-01-15,GALE,brawlBall,Backyard Bowl,2,31,18,51,8946
8356,2023-01-15,GALE,bounty,Canal Grande,0,1,0,1,960
8357,2023-01-14,GALE,knockout,Flaring Phoenix,0,0,2,2,1080
8358,2023-01-14,GALE,hotZone,Controller Chaos,0,25,11,36,2772
8359,2023-01-14,GALE,heist,Bridge Too Far,0,2,2,4,4020
8360,2023-01-14,GALE,gemGrab,Hard Rock Mine,0,1,0,1,1272
8361,2023-01-14,GALE,brawlBall,Super Beach,1,29,11,41,6336
8362,2023-01-14,GALE,brawlBall,Sneaky Fields,0,2,15,17,918
8363,2023-01-14,GALE,bounty,Canal Grande,0,0,1,1,1014
8364,2023-01-13,GALE,knockout,Flaring Phoenix,0,3,0,3,1182
8365,2023-01-13,GALE,hotZone,Controller Chaos,0,21,26,47,2928
8366,2023-01-13,GALE,heist,Hot Potato,0,0,4,4,600
8367,2023-01-13,GALE,gemGrab,Deep Diner,0,6,3,9,1650
8368,2023-01-13,GALE,brawlBall,Sneaky Fields,1,36,24,61,6144
8369,2023-01-13,GALE,brawlBall,Pinhole Punt,0,1,0,1,156
8370,2023-01-12,GALE,knockout,Riverside,0,1,0,1,2532
8371,2023-01-12,GALE,hotZone,Open Zone,0,6,10,16,1488
8372,2023-01-12,GALE,heist,Hot Potato,0,1,0,1,330
8373,2023-01-12,GALE,gemGrab,Undermine,0,4,4,8,690
8374,2023-01-12,GALE,gemGrab,Gem Fort,0,2,0,2,162
8375,2023-01-12,GALE,brawlBall,Sunny Soccer,0,6,2,8,240
8376,2023-01-12,GALE,brawlBall,Pinhole Punt,0,10,9,19,2292
8377,2023-01-11,GALE,hotZone,Open Zone,0,2,7,9,462
8378,2023-01-11,GALE,brawlBall,Sunny Soccer,1,10,8,19,1638
8379,2023-01-10,GALE,hotZone,Dueling Beetles,0,11,0,11,2424
8380,2023-01-10,GALE,gemGrab,Crystal Arcade,0,5,0,5,1746
8381,2023-01-10,GALE,brawlBall,Center Stage,0,6,0,6,708
8382,2023-01-10,GALE,brawlBall,Beach Ball,1,15,16,32,4392
8383,2023-01-09,GALE,knockout,New Perspective,0,1,0,1,876
8384,2023-01-09,GALE,hotZone,Dueling Beetles,0,5,0,5,1554
8385,2023-01-09,GALE,heist,Snaked Assault,0,1,0,1,2022
8386,2023-01-09,GALE,gemGrab,Minecart Madness,0,5,1,6,1884
8387,2023-01-09,GALE,gemGrab,Double Swoosh,0,5,0,5,1320
8388,2023-01-09,GALE,brawlBall,Center Stage,0,37,35,72,5460
8389,2023-01-09,GALE,brawlBall,Backyard Bowl,0,4,3,7,474
8390,2023-01-09,GALE,bounty,Layer Cake,0,2,1,3,1512
8391,2023-01-08,GALE,knockout,X Marks the Spot,0,2,0,2,1692
8392,2023-01-08,GALE,hotZone,Ring of Fire,0,8,3,11,1644
8393,2023-01-08,GALE,heist,Snaked Assault,0,0,1,1,1494
8394,2023-01-08,GALE,gemGrab,Hard Rock Mine,0,1,0,1,630
8395,2023-01-08,GALE,gemGrab,Double Swoosh,0,1,0,1,864
8396,2023-01-08,GALE,brawlBall,Super Beach,0,2,2,4,732
8397,2023-01-08,GALE,brawlBall,Backyard Bowl,2,22,21,45,4830
8398,2023-01-07,GALE,hotZone,Ring of Fire,0,3,0,3,846
8399,2023-01-07,GALE,heist,Tornado Ring,0,2,0,2,1350
8400,2023-01-07,GALE,gemGrab,Hard Rock Mine,0,1,0,1,1158
8401,2023-01-07,GALE,brawlBall,Super Beach,0,14,16,30,2622
8402,2023-01-07,GALE,brawlBall,Sneaky Fields,0,3,2,5,402
8403,2023-01-06,GALE,knockout,Out in the Open,0,1,0,1,1446
8404,2023-01-06,GALE,hotZone,Split,0,22,18,40,1158
8405,2023-01-06,GALE,heist,Tornado Ring,0,1,0,1,2538
8406,2023-01-06,GALE,gemGrab,Undermine,0,4,0,4,540
8407,2023-01-06,GALE,gemGrab,Deep Diner,0,6,1,7,2226
8408,2023-01-06,GALE,brawlBall,Sneaky Fields,0,27,11,38,4896
8409,2023-01-06,GALE,brawlBall,Pinhole Punt,0,1,0,1,510
8410,2023-01-05,GALE,knockout,Out in the Open,1,3,3,7,2958
8411,2023-01-05,GALE,hotZone,Split,0,111,126,237,3552
8412,2023-01-05,GALE,heist,Kaboom Canyon,0,2,6,8,954
8413,2023-01-05,GALE,gemGrab,Undermine,0,7,0,7,1812
8414,2023-01-05,GALE,gemGrab,Gem Fort,0,2,0,2,252
8415,2023-01-05,GALE,brawlBall,Pinhole Punt,4,56,48,108,8118
8416,2023-01-04,GALE,knockout,Goldarm Gulch,0,1,0,1,696
8417,2023-01-04,GALE,hotZone,Parallel Plays,0,8,2,10,864
8418,2023-01-04,GALE,heist,Kaboom Canyon,0,7,7,14,1848
8419,2023-01-04,GALE,gemGrab,Gem Fort,0,2,0,2,1788
8420,2023-01-04,GALE,gemGrab,Crystal Arcade,0,2,0,2,642
8421,2023-01-04,GALE,brawlBall,Sunny Soccer,0,32,22,54,6312
8422,2023-01-04,GALE,bounty,Shooting Star,0,2,0,2,3570
8423,2023-01-03,GALE,knockout,Goldarm Gulch,0,3,0,3,720
8424,2023-01-03,GALE,hotZone,Parallel Plays,0,18,25,43,1542
8425,2023-01-03,GALE,heist,Pit Stop,0,4,0,4,1956
8426,2023-01-03,GALE,gemGrab,Minecart Madness,0,1,0,1,456
8427,2023-01-03,GALE,gemGrab,Crystal Arcade,0,2,0,2,2406
8428,2023-01-03,GALE,brawlBall,Center Stage,0,1,0,1,294
8429,2023-01-03,GALE,brawlBall,Beach Ball,0,37,26,63,5580
8430,2023-01-02,GALE,knockout,Belle's Rock,0,2,0,2,1794
8431,2023-01-02,GALE,hotZone,Quarter Pounder,0,14,3,17,2652
8432,2023-01-02,GALE,heist,Pit Stop,0,1,2,3,3498
8433,2023-01-02,GALE,gemGrab,Minecart Madness,0,8,9,17,2352
8434,2023-01-02,GALE,gemGrab,Double Swoosh,0,5,14,19,1512
8435,2023-01-02,GALE,brawlBall,Center Stage,1,53,38,92,7110
8436,2023-01-02,GALE,brawlBall,Backyard Bowl,0,1,1,2,492
8437,2023-01-02,GALE,bounty,Hideout,0,1,1,2,3090
8438,2023-01-01,GALE,hotZone,Quarter Pounder,0,8,0,8,1188
8439,2023-01-01,GALE,hotZone,Controller Chaos,0,1,0,1,12
8440,2023-01-01,GALE,gemGrab,Double Swoosh,0,2,0,2,1140
8441,2023-01-01,GALE,brawlBall,Backyard Bowl,0,17,1,18,2658
8442,2022-12-31,GALE,hotZone,Controller Chaos,0,1,2,3,198
8443,2022-12-31,GALE,brawlBall,Super Beach,0,4,1,5,618
8444,2022-12-31,GALE,bounty,Canal Grande,0,1,2,3,54
8445,2022-12-30,GALE,hotZone,Controller Chaos,0,3,1,4,288
8446,2022-12-30,GALE,gemGrab,Undermine,0,1,0,1,102
8447,2022-12-30,GALE,brawlBall,Sneaky Fields,0,0,3,3,552
8448,2022-12-29,GALE,gemGrab,Undermine,0,1,0,1,102
8449,2022-12-29,GALE,gemGrab,Gem Fort,0,0,1,1,30
8450,2022-12-29,GALE,brawlBall,Pinhole Punt,0,2,2,4,282
8451,2022-12-28,GALE,hotZone,Open Zone,0,1,0,1,108
8452,2022-12-27,GALE,hotZone,Dueling Beetles,0,1,0,1,36
8453,2022-12-27,GALE,gemGrab,Minecart Madness,0,2,0,2,30
8454,2022-12-26,GALE,heist,Kaboom Canyon,0,1,0,1,36
8455,2022-12-26,GALE,gemGrab,Minecart Madness,0,2,0,2,60
8456,2022-12-26,GALE,brawlBall,Center Stage,0,0,1,1,78
8457,2022-12-24,GALE,brawlBall,Super Beach,0,1,1,2,48
8458,2022-12-23,GALE,brawlBall,Sneaky Fields,0,1,0,1,12
8459,2022-12-22,GALE,heist,Kaboom Canyon,0,1,0,1,6
8460,2022-12-22,GALE,gemGrab,Gem Fort,0,1,0,1,90
8461,2022-12-22,GALE,brawlBall,Pinhole Punt,0,2,1,3,132
8462,2022-12-21,GALE,brawlBall,Sunny Soccer,0,0,1,1,54
8463,2022-12-20,GALE,brawlBall,Beach Ball,0,1,0,1,96
8464,2022-12-19,GALE,brawlBall,Center Stage,0,1,0,1,102
8465,2022-12-17,GALE,brawlBall,Super Beach,0,1,0,1,6
8466,2022-12-16,GALE,brawlBall,Sneaky Fields,0,1,0,1,84
8467,2022-12-13,GALE,knockout,New Perspective,0,1,0,1,84
8468,2022-12-13,GALE,brawlBall,Beach Ball,0,2,0,2,54
8469,2022-12-11,GALE,brawlBall,Backyard Bowl,0,2,1,3,24
8470,2022-11-11,GALE,knockout,New Perspective,0,1,0,1,12
8471,2022-11-11,GALE,brawlBall,Sneaky Fields,0,1,0,1,42
8472,2022-10-30,GALE,knockout,Out in the Open,0,0,2,2,12
8473,2022-10-15,GALE,gemGrab,Hard Rock Mine,0,2,0,2,90
8474,2023-01-28,FRANK,knockout,Flaring Phoenix,0,19,9,28,12366
8475,2023-01-28,FRANK,hotZone,Controller Chaos,0,93,46,139,10134
8476,2023-01-28,FRANK,heist,Bridge Too Far,0,20,20,40,24240
8477,2023-01-28,FRANK,gemGrab,Hard Rock Mine,0,37,18,55,16638
8478,2023-01-28,FRANK,gemGrab,Deep Diner,0,4,4,8,5478
8479,2023-01-28,FRANK,brawlBall,Super Beach,7,799,737,1543,74430
8480,2023-01-28,FRANK,brawlBall,Sneaky Fields,0,40,47,87,3582
8481,2023-01-28,FRANK,bounty,Canal Grande,0,25,16,41,10902
8482,2023-01-27,FRANK,knockout,Flaring Phoenix,0,4,4,8,5928
8483,2023-01-27,FRANK,hotZone,Controller Chaos,0,18,55,73,2676
8484,2023-01-27,FRANK,heist,Hot Potato,0,10,8,18,3486
8485,2023-01-27,FRANK,gemGrab,Undermine,0,2,1,3,942
8486,2023-01-27,FRANK,gemGrab,Deep Diner,0,10,7,17,6846
8487,2023-01-27,FRANK,brawlBall,Sneaky Fields,8,273,294,575,23514
8488,2023-01-27,FRANK,brawlBall,Pinhole Punt,0,5,2,7,738
8489,2023-01-27,FRANK,bounty,Temple Ruins,0,2,0,2,1890
8490,2023-01-26,FRANK,knockout,Riverside,0,6,6,12,19008
8491,2023-01-26,FRANK,hotZone,Open Zone,0,20,16,36,10182
8492,2023-01-26,FRANK,heist,Hot Potato,0,22,10,32,14610
8493,2023-01-26,FRANK,gemGrab,Undermine,0,34,47,81,10062
8494,2023-01-26,FRANK,gemGrab,Gem Fort,0,12,12,24,4674
8495,2023-01-26,FRANK,brawlBall,Sunny Soccer,0,46,31,77,3660
8496,2023-01-26,FRANK,brawlBall,Pinhole Punt,15,577,529,1121,67338
8497,2023-01-26,FRANK,bounty,Temple Ruins,0,10,8,18,5610
8498,2023-01-25,FRANK,knockout,Riverside,0,7,3,10,9906
8499,2023-01-25,FRANK,hotZone,Open Zone,0,8,5,13,5262
8500,2023-01-25,FRANK,heist,Safe Zone,0,11,1,12,9156
8501,2023-01-25,FRANK,gemGrab,Gem Fort,0,23,21,44,5556
8502,2023-01-25,FRANK,gemGrab,Crystal Arcade,0,24,28,52,7866
8503,2023-01-25,FRANK,brawlBall,Sunny Soccer,4,444,388,836,40830
8504,2023-01-25,FRANK,brawlBall,Beach Ball,3,64,63,130,6408
8505,2023-01-25,FRANK,bounty,Excel,0,6,2,8,5790
8506,2023-01-24,FRANK,knockout,New Perspective,0,14,14,28,10542
8507,2023-01-24,FRANK,hotZone,Dueling Beetles,0,77,57,134,10662
8508,2023-01-24,FRANK,heist,Safe Zone,0,14,15,29,15750
8509,2023-01-24,FRANK,gemGrab,Minecart Madness,0,3,2,5,4002
8510,2023-01-24,FRANK,gemGrab,Crystal Arcade,0,31,24,55,14460
8511,2023-01-24,FRANK,brawlBall,Center Stage,6,91,83,180,7860
8512,2023-01-24,FRANK,brawlBall,Beach Ball,16,727,653,1396,64614
8513,2023-01-24,FRANK,bounty,Excel,0,15,12,27,10896
8514,2023-01-23,FRANK,knockout,New Perspective,0,24,23,47,20676
8515,2023-01-23,FRANK,hotZone,Dueling Beetles,0,85,57,142,17502
8516,2023-01-23,FRANK,heist,Snaked Assault,0,69,68,137,15762
8517,2023-01-23,FRANK,gemGrab,Minecart Madness,0,25,13,38,19062
8518,2023-01-23,FRANK,gemGrab,Double Swoosh,0,17,19,36,7578
8519,2023-01-23,FRANK,brawlBall,Center Stage,14,1074,1019,2107,92862
8520,2023-01-23,FRANK,brawlBall,Backyard Bowl,0,24,27,51,4224
8521,2023-01-23,FRANK,bounty,Layer Cake,0,17,22,39,11142
8522,2023-01-22,FRANK,knockout,X Marks the Spot,0,11,6,17,9174
8523,2023-01-22,FRANK,hotZone,Ring of Fire,0,22,25,47,5730
8524,2023-01-22,FRANK,heist,Snaked Assault,0,18,23,41,8232
8525,2023-01-22,FRANK,gemGrab,Hard Rock Mine,0,6,6,12,4722
8526,2023-01-22,FRANK,gemGrab,Double Swoosh,0,41,40,81,9426
8527,2023-01-22,FRANK,brawlBall,Super Beach,3,85,67,155,7386
8528,2023-01-22,FRANK,brawlBall,Backyard Bowl,4,161,147,312,34788
8529,2023-01-22,FRANK,bounty,Layer Cake,0,17,21,38,6654
8530,2023-01-21,FRANK,knockout,X Marks the Spot,0,38,33,71,31698
8531,2023-01-21,FRANK,hotZone,Ring of Fire,0,59,70,129,16632
8532,2023-01-21,FRANK,heist,Tornado Ring,0,48,44,92,11664
8533,2023-01-21,FRANK,gemGrab,Hard Rock Mine,0,41,27,68,22980
8534,2023-01-21,FRANK,gemGrab,Deep Diner,0,11,6,17,4470
8535,2023-01-21,FRANK,brawlBall,Super Beach,15,1104,1042,2161,101364
8536,2023-01-21,FRANK,brawlBall,Sneaky Fields,0,42,50,92,3750
8537,2023-01-21,FRANK,bounty,Dry Season,0,8,6,14,14538
8538,2023-01-20,FRANK,knockout,Out in the Open,0,14,7,21,20106
8539,2023-01-20,FRANK,hotZone,Split,0,160,248,408,9678
8540,2023-01-20,FRANK,heist,Tornado Ring,0,51,50,101,12672
8541,2023-01-20,FRANK,gemGrab,Undermine,0,14,6,20,5442
8542,2023-01-20,FRANK,gemGrab,Deep Diner,0,23,34,57,19050
8543,2023-01-20,FRANK,brawlBall,Sneaky Fields,15,999,957,1971,74778
8544,2023-01-20,FRANK,brawlBall,Pinhole Punt,1,24,26,51,2886
8545,2023-01-20,FRANK,bounty,Dry Season,0,7,4,11,11640
8546,2023-01-19,FRANK,knockout,Out in the Open,0,21,12,33,26574
8547,2023-01-19,FRANK,hotZone,Split,0,182,301,483,14856
8548,2023-01-19,FRANK,heist,Kaboom Canyon,0,15,4,19,6732
8549,2023-01-19,FRANK,gemGrab,Undermine,0,48,29,77,14154
8550,2023-01-19,FRANK,gemGrab,Gem Fort,0,9,8,17,2934
8551,2023-01-19,FRANK,brawlBall,Sunny Soccer,0,24,17,41,2274
8552,2023-01-19,FRANK,brawlBall,Pinhole Punt,18,590,505,1113,72498
8553,2023-01-19,FRANK,bounty,Shooting Star,0,12,25,37,11124
8554,2023-01-18,FRANK,knockout,Goldarm Gulch,0,6,7,13,2784
8555,2023-01-18,FRANK,hotZone,Parallel Plays,0,6,2,8,1158
8556,2023-01-18,FRANK,heist,Kaboom Canyon,0,5,0,5,2592
8557,2023-01-18,FRANK,gemGrab,Gem Fort,0,15,9,24,3006
8558,2023-01-18,FRANK,gemGrab,Crystal Arcade,0,0,1,1,990
8559,2023-01-18,FRANK,brawlBall,Sunny Soccer,1,198,166,365,18941
8560,2023-01-18,FRANK,brawlBall,Beach Ball,0,7,7,14,774
8561,2023-01-18,FRANK,bounty,Shooting Star,0,6,7,13,5088
8562,2023-01-17,FRANK,knockout,Goldarm Gulch,0,3,6,9,2520
8563,2023-01-17,FRANK,hotZone,Parallel Plays,0,5,4,9,1038
8564,2023-01-17,FRANK,heist,Pit Stop,0,8,17,25,1290
8565,2023-01-17,FRANK,gemGrab,Crystal Arcade,0,3,1,4,1266
8566,2023-01-17,FRANK,brawlBall,Center Stage,0,6,4,10,288
8567,2023-01-17,FRANK,brawlBall,Beach Ball,0,66,70,136,5886
8568,2023-01-17,FRANK,bounty,Hideout,0,1,0,1,750
8569,2023-01-16,FRANK,knockout,Belle's Rock,0,2,0,2,1788
8570,2023-01-16,FRANK,hotZone,Quarter Pounder,0,21,17,38,1494
8571,2023-01-16,FRANK,heist,Pit Stop,0,20,46,66,4044
8572,2023-01-16,FRANK,gemGrab,Minecart Madness,0,1,0,1,1422
8573,2023-01-16,FRANK,gemGrab,Double Swoosh,0,1,1,2,708
8574,2023-01-16,FRANK,brawlBall,Center Stage,3,56,97,156,5778
8575,2023-01-16,FRANK,brawlBall,Backyard Bowl,0,5,6,11,852
8576,2023-01-16,FRANK,bounty,Hideout,0,2,0,2,1470
8577,2023-01-15,FRANK,knockout,Belle's Rock,0,3,3,6,2904
8578,2023-01-15,FRANK,hotZone,Quarter Pounder,0,19,5,24,3318
8579,2023-01-15,FRANK,heist,Bridge Too Far,0,1,0,1,2736
8580,2023-01-15,FRANK,gemGrab,Hard Rock Mine,0,5,5,10,1014
8581,2023-01-15,FRANK,gemGrab,Double Swoosh,0,9,5,14,2178
8582,2023-01-15,FRANK,brawlBall,Super Beach,0,7,4,11,1074
8583,2023-01-15,FRANK,brawlBall,Backyard Bowl,1,67,46,114,8946
8584,2023-01-15,FRANK,bounty,Canal Grande,0,2,5,7,960
8585,2023-01-14,FRANK,hotZone,Controller Chaos,0,32,22,54,2772
8586,2023-01-14,FRANK,heist,Bridge Too Far,0,3,0,3,4020
8587,2023-01-14,FRANK,gemGrab,Hard Rock Mine,0,2,0,2,1272
8588,2023-01-14,FRANK,gemGrab,Deep Diner,0,0,1,1,858
8589,2023-01-14,FRANK,brawlBall,Super Beach,1,74,65,140,6336
8590,2023-01-14,FRANK,brawlBall,Sneaky Fields,0,12,2,14,918
8591,2023-01-14,FRANK,bounty,Canal Grande,0,4,1,5,1014
8592,2023-01-13,FRANK,knockout,Flaring Phoenix,0,4,1,5,1182
8593,2023-01-13,FRANK,hotZone,Controller Chaos,0,27,6,33,2928
8594,2023-01-13,FRANK,heist,Hot Potato,0,2,0,2,600
8595,2023-01-13,FRANK,gemGrab,Deep Diner,0,6,1,7,1650
8596,2023-01-13,FRANK,brawlBall,Sneaky Fields,1,87,64,152,6144
8597,2023-01-13,FRANK,brawlBall,Pinhole Punt,0,1,0,1,156
8598,2023-01-13,FRANK,bounty,Temple Ruins,0,0,1,1,270
8599,2023-01-12,FRANK,knockout,Riverside,0,1,1,2,2532
8600,2023-01-12,FRANK,hotZone,Open Zone,0,9,0,9,1488
8601,2023-01-12,FRANK,heist,Hot Potato,0,1,0,1,330
8602,2023-01-12,FRANK,gemGrab,Undermine,0,3,2,5,690
8603,2023-01-12,FRANK,gemGrab,Gem Fort,0,1,0,1,162
8604,2023-01-12,FRANK,brawlBall,Sunny Soccer,0,5,4,9,240
8605,2023-01-12,FRANK,brawlBall,Pinhole Punt,0,30,22,52,2292
8606,2023-01-11,FRANK,brawlBall,Sunny Soccer,0,14,14,28,1638
8607,2023-01-11,FRANK,bounty,Excel,0,3,3,6,282
8608,2023-01-10,FRANK,knockout,New Perspective,0,1,0,1,720
8609,2023-01-10,FRANK,hotZone,Dueling Beetles,0,15,5,20,2424
8610,2023-01-10,FRANK,gemGrab,Crystal Arcade,0,1,0,1,1746
8611,2023-01-10,FRANK,brawlBall,Center Stage,0,8,24,32,708
8612,2023-01-10,FRANK,brawlBall,Beach Ball,1,46,22,69,4392
8613,2023-01-09,FRANK,hotZone,Dueling Beetles,0,6,2,8,1554
8614,2023-01-09,FRANK,heist,Snaked Assault,0,9,0,9,2022
8615,2023-01-09,FRANK,gemGrab,Minecart Madness,0,1,2,3,1884
8616,2023-01-09,FRANK,gemGrab,Double Swoosh,0,2,1,3,1320
8617,2023-01-09,FRANK,brawlBall,Center Stage,0,64,70,134,5460
8618,2023-01-09,FRANK,brawlBall,Backyard Bowl,0,2,7,9,474
8619,2023-01-09,FRANK,bounty,Layer Cake,0,5,0,5,1512
8620,2023-01-08,FRANK,knockout,X Marks the Spot,0,3,0,3,1692
8621,2023-01-08,FRANK,hotZone,Ring of Fire,0,6,1,7,1644
8622,2023-01-08,FRANK,heist,Snaked Assault,0,4,0,4,1494
8623,2023-01-08,FRANK,gemGrab,Double Swoosh,0,7,38,45,864
8624,2023-01-08,FRANK,brawlBall,Super Beach,0,2,2,4,732
8625,2023-01-08,FRANK,brawlBall,Backyard Bowl,0,16,10,26,4830
8626,2023-01-08,FRANK,bounty,Layer Cake,0,0,2,2,528
8627,2023-01-07,FRANK,knockout,X Marks the Spot,0,1,0,1,1014
8628,2023-01-07,FRANK,hotZone,Ring of Fire,0,4,1,5,846
8629,2023-01-07,FRANK,heist,Tornado Ring,0,10,15,25,1350
8630,2023-01-07,FRANK,gemGrab,Hard Rock Mine,0,2,0,2,1158
8631,2023-01-07,FRANK,brawlBall,Super Beach,0,28,33,61,2622
8632,2023-01-07,FRANK,brawlBall,Sneaky Fields,1,7,18,26,402
8633,2023-01-07,FRANK,bounty,Dry Season,0,2,1,3,1320
8634,2023-01-06,FRANK,hotZone,Split,0,10,5,15,1158
8635,2023-01-06,FRANK,heist,Tornado Ring,0,20,20,40,2538
8636,2023-01-06,FRANK,gemGrab,Undermine,0,1,1,2,540
8637,2023-01-06,FRANK,gemGrab,Deep Diner,0,5,3,8,2226
8638,2023-01-06,FRANK,brawlBall,Sneaky Fields,2,54,55,111,4896
8639,2023-01-06,FRANK,brawlBall,Pinhole Punt,0,2,0,2,510
8640,2023-01-06,FRANK,bounty,Dry Season,0,1,0,1,1944
8641,2023-01-05,FRANK,knockout,Out in the Open,0,1,0,1,2958
8642,2023-01-05,FRANK,hotZone,Split,0,68,42,110,3552
8643,2023-01-05,FRANK,heist,Kaboom Canyon,0,3,0,3,954
8644,2023-01-05,FRANK,gemGrab,Undermine,0,9,2,11,1812
8645,2023-01-05,FRANK,brawlBall,Sunny Soccer,0,0,1,1,84
8646,2023-01-05,FRANK,brawlBall,Pinhole Punt,1,40,48,89,8118
8647,2023-01-05,FRANK,bounty,Shooting Star,0,1,1,2,1362
8648,2023-01-04,FRANK,hotZone,Parallel Plays,0,4,0,4,864
8649,2023-01-04,FRANK,heist,Kaboom Canyon,0,2,0,2,1848
8650,2023-01-04,FRANK,gemGrab,Gem Fort,0,3,3,6,1788
8651,2023-01-04,FRANK,gemGrab,Crystal Arcade,0,6,12,18,642
8652,2023-01-04,FRANK,brawlBall,Sunny Soccer,1,65,38,104,6312
8653,2023-01-04,FRANK,bounty,Shooting Star,0,1,0,1,3570
8654,2023-01-03,FRANK,knockout,Goldarm Gulch,0,1,0,1,720
8655,2023-01-03,FRANK,hotZone,Parallel Plays,0,7,0,7,1542
8656,2023-01-03,FRANK,heist,Pit Stop,0,9,0,9,1956
8657,2023-01-03,FRANK,gemGrab,Minecart Madness,0,1,0,1,456
8658,2023-01-03,FRANK,gemGrab,Crystal Arcade,0,1,3,4,2406
8659,2023-01-03,FRANK,brawlBall,Center Stage,0,4,1,5,294
8660,2023-01-03,FRANK,brawlBall,Beach Ball,1,56,19,76,5580
8661,2023-01-02,FRANK,knockout,Belle's Rock,0,3,0,3,1794
8662,2023-01-02,FRANK,hotZone,Quarter Pounder,1,17,21,39,2652
8663,2023-01-02,FRANK,heist,Pit Stop,0,23,26,49,3498
8664,2023-01-02,FRANK,heist,Kaboom Canyon,0,1,0,1,30
8665,2023-01-02,FRANK,gemGrab,Minecart Madness,0,2,1,3,2352
8666,2023-01-02,FRANK,gemGrab,Double Swoosh,0,10,9,19,1512
8667,2023-01-02,FRANK,brawlBall,Center Stage,1,51,20,72,7110
8668,2023-01-02,FRANK,brawlBall,Backyard Bowl,0,4,3,7,492
8669,2023-01-02,FRANK,bounty,Hideout,0,3,2,5,3090
8670,2023-01-01,FRANK,hotZone,Quarter Pounder,0,6,14,20,1188
8671,2023-01-01,FRANK,heist,Bridge Too Far,0,1,0,1,462
8672,2023-01-01,FRANK,gemGrab,Double Swoosh,0,3,0,3,1140
8673,2023-01-01,FRANK,brawlBall,Backyard Bowl,0,19,31,50,2658
8674,2022-12-31,FRANK,hotZone,Controller Chaos,0,1,0,1,198
8675,2022-12-31,FRANK,heist,Bridge Too Far,0,1,1,2,276
8676,2022-12-31,FRANK,gemGrab,Hard Rock Mine,0,1,1,2,384
8677,2022-12-31,FRANK,brawlBall,Super Beach,0,5,3,8,618
8678,2022-12-31,FRANK,brawlBall,Sneaky Fields,0,1,0,1,60
8679,2022-12-30,FRANK,hotZone,Controller Chaos,0,5,0,5,288
8680,2022-12-30,FRANK,gemGrab,Deep Diner,0,2,1,3,438
8681,2022-12-30,FRANK,brawlBall,Sneaky Fields,0,11,9,20,552
8682,2022-12-29,FRANK,gemGrab,Gem Fort,0,0,1,1,30
8683,2022-12-29,FRANK,brawlBall,Pinhole Punt,0,4,5,9,282
8684,2022-12-28,FRANK,brawlBall,Sunny Soccer,0,1,0,1,42
8685,2022-12-27,FRANK,hotZone,Controller Chaos,0,1,0,1,24
8686,2022-12-27,FRANK,brawlBall,Beach Ball,0,0,1,1,144
8687,2022-12-26,FRANK,hotZone,Controller Chaos,0,0,1,1,30
8688,2022-12-26,FRANK,brawlBall,Center Stage,0,0,1,1,78
8689,2022-12-22,FRANK,brawlBall,Pinhole Punt,0,1,0,1,132
8690,2022-12-21,FRANK,brawlBall,Sunny Soccer,0,1,0,1,54
8691,2022-12-20,FRANK,brawlBall,Beach Ball,0,1,1,2,96
8692,2022-12-19,FRANK,brawlBall,Center Stage,0,0,3,3,102
8693,2022-12-16,FRANK,brawlBall,Sneaky Fields,0,1,0,1,84
8694,2022-12-13,FRANK,brawlBall,Beach Ball,0,0,1,1,54
8695,2022-11-07,FRANK,hotZone,Quarter Pounder,0,1,0,1,24
8696,2022-10-28,FRANK,brawlBall,Beach Ball,0,1,0,1,12
8697,2022-10-26,FRANK,brawlBall,Sunny Soccer,0,2,0,2,18
8698,2022-10-15,FRANK,brawlBall,Super Beach,0,0,1,1,12
8699,2023-01-28,FANG,knockout,Flaring Phoenix,0,135,73,208,12366
8700,2023-01-28,FANG,hotZone,Controller Chaos,0,58,41,99,10134
8701,2023-01-28,FANG,heist,Bridge Too Far,0,81,57,138,24240
8702,2023-01-28,FANG,gemGrab,Hard Rock Mine,0,175,139,314,16638
8703,2023-01-28,FANG,gemGrab,Deep Diner,0,69,55,124,5478
8704,2023-01-28,FANG,brawlBall,Super Beach,15,965,929,1909,74430
8705,2023-01-28,FANG,brawlBall,Sneaky Fields,1,28,24,53,3582
8706,2023-01-28,FANG,bounty,Canal Grande,0,100,135,235,10902
8707,2023-01-27,FANG,knockout,Flaring Phoenix,2,49,36,87,5928
8708,2023-01-27,FANG,hotZone,Controller Chaos,0,21,30,51,2676
8709,2023-01-27,FANG,heist,Hot Potato,0,12,3,15,3486
8710,2023-01-27,FANG,gemGrab,Undermine,0,19,19,38,942
8711,2023-01-27,FANG,gemGrab,Deep Diner,0,52,51,103,6846
8712,2023-01-27,FANG,brawlBall,Sneaky Fields,1,253,192,446,23514
8713,2023-01-27,FANG,brawlBall,Pinhole Punt,0,8,7,15,738
8714,2023-01-27,FANG,bounty,Temple Ruins,0,31,18,49,1890
8715,2023-01-26,FANG,knockout,Riverside,0,212,172,384,19008
8716,2023-01-26,FANG,hotZone,Open Zone,0,78,31,109,10182
8717,2023-01-26,FANG,heist,Hot Potato,0,34,28,62,14610
8718,2023-01-26,FANG,gemGrab,Undermine,0,88,69,157,10062
8719,2023-01-26,FANG,gemGrab,Gem Fort,0,47,26,73,4674
8720,2023-01-26,FANG,brawlBall,Sunny Soccer,0,53,54,107,3660
8721,2023-01-26,FANG,brawlBall,Pinhole Punt,26,871,855,1752,67338
8722,2023-01-26,FANG,bounty,Temple Ruins,0,53,48,101,5610
8723,2023-01-25,FANG,knockout,Riverside,0,65,37,102,9906
8724,2023-01-25,FANG,hotZone,Open Zone,0,34,17,51,5262
8725,2023-01-25,FANG,heist,Safe Zone,3,57,33,93,9156
8726,2023-01-25,FANG,gemGrab,Gem Fort,0,55,49,104,5556
8727,2023-01-25,FANG,gemGrab,Crystal Arcade,0,109,115,224,7866
8728,2023-01-25,FANG,brawlBall,Sunny Soccer,5,471,521,997,40830
8729,2023-01-25,FANG,brawlBall,Beach Ball,3,91,79,173,6408
8730,2023-01-25,FANG,bounty,Excel,0,69,111,180,5790
8731,2023-01-24,FANG,knockout,New Perspective,1,163,195,359,10542
8732,2023-01-24,FANG,hotZone,Dueling Beetles,0,61,42,103,10662
8733,2023-01-24,FANG,heist,Safe Zone,0,45,58,103,15750
8734,2023-01-24,FANG,gemGrab,Minecart Madness,0,33,25,58,4002
8735,2023-01-24,FANG,gemGrab,Crystal Arcade,0,152,150,302,14460
8736,2023-01-24,FANG,brawlBall,Center Stage,2,102,86,190,7860
8737,2023-01-24,FANG,brawlBall,Beach Ball,29,789,804,1622,64614
8738,2023-01-24,FANG,bounty,Excel,0,157,265,422,10896
8739,2023-01-23,FANG,knockout,New Perspective,0,188,179,367,20676
8740,2023-01-23,FANG,hotZone,Dueling Beetles,0,57,45,102,17502
8741,2023-01-23,FANG,heist,Snaked Assault,0,17,20,37,15762
8742,2023-01-23,FANG,gemGrab,Minecart Madness,0,160,220,380,19062
8743,2023-01-23,FANG,gemGrab,Double Swoosh,0,52,33,85,7578
8744,2023-01-23,FANG,brawlBall,Center Stage,25,933,864,1822,92862
8745,2023-01-23,FANG,brawlBall,Backyard Bowl,2,72,73,147,4224
8746,2023-01-23,FANG,bounty,Layer Cake,0,153,260,413,11142
8747,2023-01-22,FANG,knockout,X Marks the Spot,1,117,90,208,9174
8748,2023-01-22,FANG,hotZone,Ring of Fire,0,39,42,81,5730
8749,2023-01-22,FANG,heist,Snaked Assault,0,19,26,45,8232
8750,2023-01-22,FANG,gemGrab,Hard Rock Mine,0,28,23,51,4722
8751,2023-01-22,FANG,gemGrab,Double Swoosh,0,48,36,84,9426
8752,2023-01-22,FANG,brawlBall,Super Beach,4,89,80,173,7386
8753,2023-01-22,FANG,brawlBall,Backyard Bowl,14,484,534,1032,34788
8754,2023-01-22,FANG,bounty,Layer Cake,0,100,121,221,6654
8755,2023-01-21,FANG,knockout,X Marks the Spot,1,359,329,689,31698
8756,2023-01-21,FANG,hotZone,Ring of Fire,0,102,61,163,16632
8757,2023-01-21,FANG,heist,Tornado Ring,0,22,9,31,11664
8758,2023-01-21,FANG,gemGrab,Hard Rock Mine,0,195,177,372,22980
8759,2023-01-21,FANG,gemGrab,Deep Diner,0,49,44,93,4470
8760,2023-01-21,FANG,brawlBall,Super Beach,27,1046,1069,2142,101364
8761,2023-01-21,FANG,brawlBall,Sneaky Fields,0,48,33,81,3750
8762,2023-01-21,FANG,bounty,Dry Season,0,168,255,423,14538
8763,2023-01-20,FANG,knockout,Out in the Open,2,221,194,417,20106
8764,2023-01-20,FANG,hotZone,Split,0,20,25,45,9678
8765,2023-01-20,FANG,heist,Tornado Ring,0,20,9,29,12672
8766,2023-01-20,FANG,gemGrab,Undermine,0,44,34,78,5442
8767,2023-01-20,FANG,gemGrab,Deep Diner,0,167,160,327,19050
8768,2023-01-20,FANG,brawlBall,Sneaky Fields,13,726,659,1398,74778
8769,2023-01-20,FANG,brawlBall,Pinhole Punt,1,54,34,89,2886
8770,2023-01-20,FANG,bounty,Dry Season,0,120,125,245,11640
8771,2023-01-19,FANG,knockout,Out in the Open,0,212,137,349,26574
8772,2023-01-19,FANG,hotZone,Split,0,29,21,50,14856
8773,2023-01-19,FANG,heist,Kaboom Canyon,2,31,11,44,6732
8774,2023-01-19,FANG,gemGrab,Undermine,0,110,101,211,14154
8775,2023-01-19,FANG,gemGrab,Gem Fort,0,30,23,53,2934
8776,2023-01-19,FANG,brawlBall,Sunny Soccer,0,36,26,62,2274
8777,2023-01-19,FANG,brawlBall,Pinhole Punt,26,878,882,1786,72498
8778,2023-01-19,FANG,bounty,Shooting Star,0,110,122,232,11124
8779,2023-01-18,FANG,knockout,Goldarm Gulch,0,27,22,49,2784
8780,2023-01-18,FANG,hotZone,Parallel Plays,0,12,14,26,1158
8781,2023-01-18,FANG,heist,Kaboom Canyon,0,9,9,18,2592
8782,2023-01-18,FANG,gemGrab,Gem Fort,0,22,29,51,3006
8783,2023-01-18,FANG,gemGrab,Crystal Arcade,0,15,17,32,990
8784,2023-01-18,FANG,brawlBall,Sunny Soccer,5,165,186,356,18941
8785,2023-01-18,FANG,brawlBall,Beach Ball,0,14,13,27,774
8786,2023-01-18,FANG,bounty,Shooting Star,0,45,39,84,5088
8787,2023-01-17,FANG,knockout,Goldarm Gulch,0,26,23,49,2520
8788,2023-01-17,FANG,hotZone,Parallel Plays,0,8,1,9,1038
8789,2023-01-17,FANG,heist,Pit Stop,0,1,0,1,1290
8790,2023-01-17,FANG,gemGrab,Minecart Madness,0,3,4,7,216
8791,2023-01-17,FANG,gemGrab,Crystal Arcade,0,12,10,22,1266
8792,2023-01-17,FANG,brawlBall,Center Stage,0,2,3,5,288
8793,2023-01-17,FANG,brawlBall,Beach Ball,2,65,72,139,5886
8794,2023-01-17,FANG,bounty,Hideout,0,6,3,9,750
8795,2023-01-16,FANG,knockout,Belle's Rock,0,25,13,38,1788
8796,2023-01-16,FANG,hotZone,Quarter Pounder,0,12,8,20,1494
8797,2023-01-16,FANG,heist,Pit Stop,0,4,0,4,4044
8798,2023-01-16,FANG,gemGrab,Minecart Madness,0,6,21,27,1422
8799,2023-01-16,FANG,gemGrab,Double Swoosh,0,10,2,12,708
8800,2023-01-16,FANG,brawlBall,Center Stage,2,52,40,94,5778
8801,2023-01-16,FANG,brawlBall,Backyard Bowl,0,13,17,30,852
8802,2023-01-16,FANG,bounty,Hideout,0,10,8,18,1470
8803,2023-01-15,FANG,knockout,Belle's Rock,0,36,56,92,2904
8804,2023-01-15,FANG,hotZone,Quarter Pounder,0,16,4,20,3318
8805,2023-01-15,FANG,heist,Bridge Too Far,0,3,4,7,2736
8806,2023-01-15,FANG,gemGrab,Hard Rock Mine,0,10,5,15,1014
8807,2023-01-15,FANG,gemGrab,Double Swoosh,0,11,12,23,2178
8808,2023-01-15,FANG,brawlBall,Super Beach,1,13,3,17,1074
8809,2023-01-15,FANG,brawlBall,Backyard Bowl,4,138,142,284,8946
8810,2023-01-15,FANG,bounty,Canal Grande,0,15,10,25,960
8811,2023-01-14,FANG,knockout,Flaring Phoenix,0,15,6,21,1080
8812,2023-01-14,FANG,hotZone,Controller Chaos,0,6,4,10,2772
8813,2023-01-14,FANG,heist,Bridge Too Far,0,9,15,24,4020
8814,2023-01-14,FANG,gemGrab,Hard Rock Mine,0,10,8,18,1272
8815,2023-01-14,FANG,gemGrab,Deep Diner,0,9,1,10,858
8816,2023-01-14,FANG,brawlBall,Super Beach,0,42,28,70,6336
8817,2023-01-14,FANG,brawlBall,Sneaky Fields,0,6,2,8,918
8818,2023-01-14,FANG,bounty,Canal Grande,0,21,23,44,1014
8819,2023-01-13,FANG,knockout,Flaring Phoenix,0,6,1,7,1182
8820,2023-01-13,FANG,hotZone,Controller Chaos,0,13,1,14,2928
8821,2023-01-13,FANG,heist,Hot Potato,0,1,0,1,600
8822,2023-01-13,FANG,gemGrab,Deep Diner,0,13,22,35,1650
8823,2023-01-13,FANG,brawlBall,Sneaky Fields,1,24,14,39,6144
8824,2023-01-13,FANG,brawlBall,Pinhole Punt,2,1,0,3,156
8825,2023-01-13,FANG,bounty,Temple Ruins,0,5,11,16,270
8826,2023-01-12,FANG,knockout,Riverside,0,30,25,55,2532
8827,2023-01-12,FANG,hotZone,Open Zone,0,10,5,15,1488
8828,2023-01-12,FANG,gemGrab,Undermine,0,8,2,10,690
8829,2023-01-12,FANG,gemGrab,Gem Fort,0,4,1,5,162
8830,2023-01-12,FANG,brawlBall,Sunny Soccer,0,2,1,3,240
8831,2023-01-12,FANG,brawlBall,Pinhole Punt,0,27,23,50,2292
8832,2023-01-12,FANG,bounty,Temple Ruins,0,1,0,1,24
8833,2023-01-11,FANG,knockout,Riverside,0,3,1,4,528
8834,2023-01-11,FANG,hotZone,Open Zone,0,2,0,2,462
8835,2023-01-11,FANG,heist,Safe Zone,0,1,0,1,48
8836,2023-01-11,FANG,gemGrab,Gem Fort,0,2,10,12,414
8837,2023-01-11,FANG,brawlBall,Sunny Soccer,0,14,14,28,1638
8838,2023-01-11,FANG,bounty,Excel,0,0,11,11,282
8839,2023-01-10,FANG,knockout,New Perspective,0,17,19,36,720
8840,2023-01-10,FANG,hotZone,Dueling Beetles,0,11,14,25,2424
8841,2023-01-10,FANG,heist,Safe Zone,0,4,1,5,1176
8842,2023-01-10,FANG,gemGrab,Minecart Madness,0,5,2,7,828
8843,2023-01-10,FANG,gemGrab,Crystal Arcade,0,11,12,23,1746
8844,2023-01-10,FANG,brawlBall,Center Stage,0,6,3,9,708
8845,2023-01-10,FANG,brawlBall,Beach Ball,0,35,40,75,4392
8846,2023-01-10,FANG,bounty,Excel,0,5,4,9,330
8847,2023-01-09,FANG,knockout,New Perspective,0,5,12,17,876
8848,2023-01-09,FANG,hotZone,Dueling Beetles,0,7,15,22,1554
8849,2023-01-09,FANG,heist,Snaked Assault,0,6,3,9,2022
8850,2023-01-09,FANG,gemGrab,Minecart Madness,0,10,7,17,1884
8851,2023-01-09,FANG,gemGrab,Double Swoosh,0,8,6,14,1320
8852,2023-01-09,FANG,brawlBall,Center Stage,1,52,26,79,5460
8853,2023-01-09,FANG,brawlBall,Backyard Bowl,1,5,14,20,474
8854,2023-01-09,FANG,bounty,Layer Cake,0,19,12,31,1512
8855,2023-01-08,FANG,knockout,X Marks the Spot,0,27,25,52,1692
8856,2023-01-08,FANG,hotZone,Ring of Fire,0,23,17,40,1644
8857,2023-01-08,FANG,heist,Snaked Assault,0,7,6,13,1494
8858,2023-01-08,FANG,gemGrab,Hard Rock Mine,0,2,1,3,630
8859,2023-01-08,FANG,gemGrab,Double Swoosh,0,5,1,6,864
8860,2023-01-08,FANG,brawlBall,Super Beach,0,5,3,8,732
8861,2023-01-08,FANG,brawlBall,Backyard Bowl,2,57,77,136,4830
8862,2023-01-08,FANG,bounty,Layer Cake,0,7,2,9,528
8863,2023-01-07,FANG,knockout,X Marks the Spot,0,10,21,31,1014
8864,2023-01-07,FANG,hotZone,Ring of Fire,0,6,2,8,846
8865,2023-01-07,FANG,heist,Tornado Ring,0,2,0,2,1350
8866,2023-01-07,FANG,gemGrab,Hard Rock Mine,0,4,1,5,1158
8867,2023-01-07,FANG,gemGrab,Deep Diner,0,5,1,6,918
8868,2023-01-07,FANG,brawlBall,Super Beach,0,31,30,61,2622
8869,2023-01-07,FANG,brawlBall,Sneaky Fields,0,1,0,1,402
8870,2023-01-07,FANG,bounty,Dry Season,0,15,16,31,1320
8871,2023-01-06,FANG,knockout,Out in the Open,0,7,1,8,1446
8872,2023-01-06,FANG,hotZone,Split,0,1,5,6,1158
8873,2023-01-06,FANG,heist,Tornado Ring,0,1,0,1,2538
8874,2023-01-06,FANG,gemGrab,Undermine,0,1,0,1,540
8875,2023-01-06,FANG,gemGrab,Deep Diner,0,12,6,18,2226
8876,2023-01-06,FANG,brawlBall,Sneaky Fields,0,22,14,36,4896
8877,2023-01-06,FANG,bounty,Dry Season,0,23,38,61,1944
8878,2023-01-05,FANG,knockout,Out in the Open,0,22,12,34,2958
8879,2023-01-05,FANG,hotZone,Split,0,7,0,7,3552
8880,2023-01-05,FANG,heist,Kaboom Canyon,0,4,0,4,954
8881,2023-01-05,FANG,gemGrab,Undermine,0,19,33,52,1812
8882,2023-01-05,FANG,gemGrab,Gem Fort,0,3,1,4,252
8883,2023-01-05,FANG,brawlBall,Pinhole Punt,1,63,20,84,8118
8884,2023-01-05,FANG,bounty,Shooting Star,0,18,28,46,1362
8885,2023-01-04,FANG,knockout,Goldarm Gulch,0,12,4,16,696
8886,2023-01-04,FANG,hotZone,Parallel Plays,0,1,0,1,864
8887,2023-01-04,FANG,heist,Kaboom Canyon,0,6,3,9,1848
8888,2023-01-04,FANG,gemGrab,Gem Fort,0,9,1,10,1788
8889,2023-01-04,FANG,gemGrab,Crystal Arcade,0,10,15,25,642
8890,2023-01-04,FANG,brawlBall,Sunny Soccer,0,31,54,85,6312
8891,2023-01-04,FANG,bounty,Shooting Star,0,27,43,70,3570
8892,2023-01-03,FANG,knockout,Goldarm Gulch,0,13,24,37,720
8893,2023-01-03,FANG,hotZone,Parallel Plays,1,4,2,7,1542
8894,2023-01-03,FANG,heist,Pit Stop,0,1,0,1,1956
8895,2023-01-03,FANG,gemGrab,Minecart Madness,0,2,0,2,456
8896,2023-01-03,FANG,gemGrab,Crystal Arcade,0,13,5,18,2406
8897,2023-01-03,FANG,brawlBall,Center Stage,0,2,0,2,294
8898,2023-01-03,FANG,brawlBall,Beach Ball,1,48,34,83,5580
8899,2023-01-03,FANG,bounty,Hideout,0,10,5,15,1638
8900,2023-01-02,FANG,knockout,Belle's Rock,0,17,4,21,1794
8901,2023-01-02,FANG,hotZone,Quarter Pounder,0,9,4,13,2652
8902,2023-01-02,FANG,heist,Pit Stop,0,3,0,3,3498
8903,2023-01-02,FANG,gemGrab,Minecart Madness,0,17,24,41,2352
8904,2023-01-02,FANG,gemGrab,Double Swoosh,0,8,6,14,1512
8905,2023-01-02,FANG,brawlBall,Center Stage,0,42,19,61,7110
8906,2023-01-02,FANG,brawlBall,Backyard Bowl,0,5,1,6,492
8907,2023-01-02,FANG,bounty,Hideout,0,26,36,62,3090
8908,2023-01-01,FANG,knockout,Belle's Rock,0,13,20,33,858
8909,2023-01-01,FANG,hotZone,Quarter Pounder,0,2,0,2,1188
8910,2023-01-01,FANG,gemGrab,Hard Rock Mine,0,2,0,2,48
8911,2023-01-01,FANG,gemGrab,Double Swoosh,0,7,1,8,1140
8912,2023-01-01,FANG,brawlBall,Backyard Bowl,0,29,20,49,2658
8913,2023-01-01,FANG,bounty,Canal Grande,0,1,1,2,132
8914,2022-12-31,FANG,gemGrab,Hard Rock Mine,0,4,1,5,384
8915,2022-12-31,FANG,gemGrab,Deep Diner,0,1,2,3,306
8916,2022-12-31,FANG,brawlBall,Super Beach,0,5,4,9,618
8917,2022-12-30,FANG,knockout,Flaring Phoenix,0,0,1,1,72
8918,2022-12-30,FANG,hotZone,Controller Chaos,0,1,0,1,288
8919,2022-12-30,FANG,gemGrab,Undermine,0,1,0,1,102
8920,2022-12-30,FANG,gemGrab,Deep Diner,0,3,1,4,438
8921,2022-12-30,FANG,brawlBall,Sneaky Fields,0,3,1,4,552
8922,2022-12-29,FANG,hotZone,Open Zone,0,1,0,1,54
8923,2022-12-29,FANG,gemGrab,Undermine,0,1,0,1,102
8924,2022-12-27,FANG,hotZone,Dueling Beetles,0,0,1,1,36
8925,2022-12-26,FANG,hotZone,Controller Chaos,0,1,0,1,30
8926,2022-12-24,FANG,bounty,Dry Season,0,1,1,2,12
8927,2022-12-23,FANG,knockout,Out in the Open,0,1,0,1,132
8928,2022-12-22,FANG,brawlBall,Pinhole Punt,0,1,5,6,132
8929,2022-12-21,FANG,brawlBall,Sunny Soccer,0,0,1,1,54
8930,2022-12-21,FANG,bounty,Shooting Star,0,1,0,1,6
8931,2022-12-20,FANG,brawlBall,Beach Ball,0,0,1,1,96
8932,2022-12-19,FANG,brawlBall,Center Stage,0,2,2,4,102
8933,2022-12-16,FANG,gemGrab,Undermine,0,0,1,1,6
8934,2022-12-16,FANG,brawlBall,Sneaky Fields,0,1,2,3,84
8935,2022-12-13,FANG,heist,Safe Zone,0,0,1,1,42
8936,2022-12-13,FANG,brawlBall,Beach Ball,0,2,5,7,54
8937,2022-11-11,FANG,knockout,New Perspective,0,0,2,2,12
8938,2022-10-28,FANG,hotZone,Dueling Beetles,0,1,0,1,12
8939,2022-10-26,FANG,brawlBall,Sunny Soccer,0,1,2,3,18
8940,2022-10-15,FANG,hotZone,Ring of Fire,0,1,0,1,24
8941,2022-10-15,FANG,gemGrab,Hard Rock Mine,0,1,0,1,90
8942,2022-10-15,FANG,bounty,Dry Season,0,0,1,1,6
8943,2022-10-10,FANG,knockout,Belle's Rock,0,2,0,2,48
8944,2023-01-28,EVE,knockout,Flaring Phoenix,0,27,23,50,12366
8945,2023-01-28,EVE,hotZone,Controller Chaos,0,12,6,18,10134
8946,2023-01-28,EVE,heist,Bridge Too Far,3,411,518,932,24240
8947,2023-01-28,EVE,gemGrab,Hard Rock Mine,0,22,23,45,16638
8948,2023-01-28,EVE,gemGrab,Deep Diner,0,14,24,38,5478
8949,2023-01-28,EVE,brawlBall,Super Beach,0,54,64,118,74430
8950,2023-01-28,EVE,brawlBall,Sneaky Fields,0,1,0,1,3582
8951,2023-01-28,EVE,bounty,Canal Grande,0,458,601,1059,10902
8952,2023-01-27,EVE,knockout,Flaring Phoenix,0,17,9,26,5928
8953,2023-01-27,EVE,hotZone,Controller Chaos,0,5,5,10,2676
8954,2023-01-27,EVE,heist,Hot Potato,0,1,0,1,3486
8955,2023-01-27,EVE,gemGrab,Undermine,0,2,3,5,942
8956,2023-01-27,EVE,gemGrab,Deep Diner,0,17,10,27,6846
8957,2023-01-27,EVE,brawlBall,Sneaky Fields,2,20,19,41,23514
8958,2023-01-27,EVE,brawlBall,Pinhole Punt,0,1,1,2,738
8959,2023-01-27,EVE,bounty,Temple Ruins,0,9,3,12,1890
8960,2023-01-26,EVE,knockout,Riverside,0,743,1125,1868,19008
8961,2023-01-26,EVE,hotZone,Open Zone,0,30,15,45,10182
8962,2023-01-26,EVE,heist,Hot Potato,0,7,4,11,14610
8963,2023-01-26,EVE,gemGrab,Undermine,0,44,57,101,10062
8964,2023-01-26,EVE,gemGrab,Gem Fort,0,16,10,26,4674
8965,2023-01-26,EVE,brawlBall,Sunny Soccer,0,3,2,5,3660
8966,2023-01-26,EVE,brawlBall,Pinhole Punt,0,127,106,233,67338
8967,2023-01-26,EVE,bounty,Temple Ruins,0,17,27,44,5610
8968,2023-01-25,EVE,knockout,Riverside,0,526,700,1226,9906
8969,2023-01-25,EVE,hotZone,Open Zone,0,10,3,13,5262
8970,2023-01-25,EVE,heist,Safe Zone,0,112,105,217,9156
8971,2023-01-25,EVE,gemGrab,Gem Fort,0,18,17,35,5556
8972,2023-01-25,EVE,gemGrab,Crystal Arcade,0,34,25,59,7866
8973,2023-01-25,EVE,brawlBall,Sunny Soccer,0,34,69,103,40830
8974,2023-01-25,EVE,brawlBall,Beach Ball,2,13,15,30,6408
8975,2023-01-25,EVE,bounty,Excel,0,10,6,16,5790
8976,2023-01-24,EVE,knockout,New Perspective,0,51,56,107,10542
8977,2023-01-24,EVE,hotZone,Dueling Beetles,0,18,16,34,10662
8978,2023-01-24,EVE,heist,Safe Zone,1,149,212,362,15750
8979,2023-01-24,EVE,gemGrab,Minecart Madness,0,15,15,30,4002
8980,2023-01-24,EVE,gemGrab,Crystal Arcade,0,31,35,66,14460
8981,2023-01-24,EVE,brawlBall,Center Stage,0,18,16,34,7860
8982,2023-01-24,EVE,brawlBall,Beach Ball,0,61,73,134,64614
8983,2023-01-24,EVE,bounty,Excel,0,26,13,39,10896
8984,2023-01-23,EVE,knockout,New Perspective,0,59,47,106,20676
8985,2023-01-23,EVE,hotZone,Dueling Beetles,0,16,10,26,17502
8986,2023-01-23,EVE,heist,Snaked Assault,0,18,10,28,15762
8987,2023-01-23,EVE,gemGrab,Minecart Madness,0,45,37,82,19062
8988,2023-01-23,EVE,gemGrab,Double Swoosh,0,21,12,33,7578
8989,2023-01-23,EVE,brawlBall,Center Stage,3,80,76,159,92862
8990,2023-01-23,EVE,brawlBall,Backyard Bowl,0,8,5,13,4224
8991,2023-01-23,EVE,bounty,Layer Cake,0,31,42,73,11142
8992,2023-01-22,EVE,knockout,X Marks the Spot,0,41,33,74,9174
8993,2023-01-22,EVE,hotZone,Ring of Fire,0,16,12,28,5730
8994,2023-01-22,EVE,heist,Snaked Assault,0,6,6,12,8232
8995,2023-01-22,EVE,gemGrab,Hard Rock Mine,0,21,16,37,4722
8996,2023-01-22,EVE,gemGrab,Double Swoosh,0,21,12,33,9426
8997,2023-01-22,EVE,brawlBall,Super Beach,0,5,9,14,7386
8998,2023-01-22,EVE,brawlBall,Backyard Bowl,3,70,100,173,34788
8999,2023-01-22,EVE,bounty,Layer Cake,0,15,27,42,6654
9000,2023-01-21,EVE,knockout,X Marks the Spot,0,129,172,301,31698
9001,2023-01-21,EVE,hotZone,Ring of Fire,1,43,34,78,16632
9002,2023-01-21,EVE,heist,Tornado Ring,0,6,6,12,11664
9003,2023-01-21,EVE,gemGrab,Hard Rock Mine,0,63,60,123,22980
9004,2023-01-21,EVE,gemGrab,Deep Diner,0,19,11,30,4470
9005,2023-01-21,EVE,brawlBall,Super Beach,1,65,78,144,101364
9006,2023-01-21,EVE,brawlBall,Sneaky Fields,0,1,1,2,3750
9007,2023-01-21,EVE,bounty,Dry Season,0,86,57,143,14538
9008,2023-01-20,EVE,knockout,Out in the Open,1,284,359,644,20106
9009,2023-01-20,EVE,hotZone,Split,0,7,4,11,9678
9010,2023-01-20,EVE,heist,Tornado Ring,0,11,4,15,12672
9011,2023-01-20,EVE,gemGrab,Undermine,0,14,19,33,5442
9012,2023-01-20,EVE,gemGrab,Deep Diner,0,63,57,120,19050
9013,2023-01-20,EVE,brawlBall,Sneaky Fields,0,39,34,73,74778
9014,2023-01-20,EVE,brawlBall,Pinhole Punt,0,0,6,6,2886
9015,2023-01-20,EVE,bounty,Dry Season,0,43,47,90,11640
9016,2023-01-19,EVE,knockout,Out in the Open,0,289,319,608,26574
9017,2023-01-19,EVE,hotZone,Split,0,8,8,16,14856
9018,2023-01-19,EVE,heist,Kaboom Canyon,1,62,74,137,6732
9019,2023-01-19,EVE,gemGrab,Undermine,0,49,35,84,14154
9020,2023-01-19,EVE,gemGrab,Gem Fort,0,10,7,17,2934
9021,2023-01-19,EVE,brawlBall,Sunny Soccer,0,1,2,3,2274
9022,2023-01-19,EVE,brawlBall,Pinhole Punt,6,110,103,219,72498
9023,2023-01-19,EVE,bounty,Shooting Star,0,75,62,137,11124
9024,2023-01-18,EVE,knockout,Goldarm Gulch,1,15,14,30,2784
9025,2023-01-18,EVE,hotZone,Parallel Plays,0,3,3,6,1158
9026,2023-01-18,EVE,heist,Kaboom Canyon,0,28,21,49,2592
9027,2023-01-18,EVE,gemGrab,Gem Fort,0,15,7,22,3006
9028,2023-01-18,EVE,gemGrab,Crystal Arcade,0,5,4,9,990
9029,2023-01-18,EVE,brawlBall,Sunny Soccer,2,26,27,55,18941
9030,2023-01-18,EVE,brawlBall,Beach Ball,0,2,1,3,774
9031,2023-01-18,EVE,bounty,Shooting Star,0,22,31,53,5088
9032,2023-01-17,EVE,knockout,Goldarm Gulch,0,13,8,21,2520
9033,2023-01-17,EVE,hotZone,Parallel Plays,0,5,4,9,1038
9034,2023-01-17,EVE,gemGrab,Minecart Madness,0,1,0,1,216
9035,2023-01-17,EVE,gemGrab,Crystal Arcade,0,6,5,11,1266
9036,2023-01-17,EVE,brawlBall,Beach Ball,0,8,5,13,5886
9037,2023-01-17,EVE,bounty,Hideout,0,3,2,5,750
9038,2023-01-16,EVE,knockout,Belle's Rock,0,4,2,6,1788
9039,2023-01-16,EVE,hotZone,Quarter Pounder,0,3,0,3,1494
9040,2023-01-16,EVE,gemGrab,Minecart Madness,0,4,10,14,1422
9041,2023-01-16,EVE,gemGrab,Double Swoosh,0,1,0,1,708
9042,2023-01-16,EVE,brawlBall,Center Stage,0,3,1,4,5778
9043,2023-01-16,EVE,brawlBall,Backyard Bowl,0,2,0,2,852
9044,2023-01-16,EVE,bounty,Hideout,0,2,3,5,1470
9045,2023-01-15,EVE,knockout,Belle's Rock,0,5,3,8,2904
9046,2023-01-15,EVE,hotZone,Quarter Pounder,0,6,1,7,3318
9047,2023-01-15,EVE,heist,Bridge Too Far,0,40,44,84,2736
9048,2023-01-15,EVE,gemGrab,Hard Rock Mine,0,0,2,2,1014
9049,2023-01-15,EVE,gemGrab,Double Swoosh,0,2,2,4,2178
9050,2023-01-15,EVE,brawlBall,Backyard Bowl,2,14,8,24,8946
9051,2023-01-15,EVE,bounty,Canal Grande,0,42,38,80,960
9052,2023-01-14,EVE,knockout,Flaring Phoenix,0,7,14,21,1080
9053,2023-01-14,EVE,hotZone,Controller Chaos,0,4,0,4,2772
9054,2023-01-14,EVE,heist,Bridge Too Far,0,95,133,228,4020
9055,2023-01-14,EVE,gemGrab,Deep Diner,0,2,0,2,858
9056,2023-01-14,EVE,brawlBall,Super Beach,0,8,17,25,6336
9057,2023-01-14,EVE,bounty,Canal Grande,0,57,82,139,1014
9058,2023-01-13,EVE,knockout,Flaring Phoenix,0,4,0,4,1182
9059,2023-01-13,EVE,hotZone,Controller Chaos,0,5,1,6,2928
9060,2023-01-13,EVE,gemGrab,Deep Diner,0,3,6,9,1650
9061,2023-01-13,EVE,brawlBall,Sneaky Fields,0,6,0,6,6144
9062,2023-01-13,EVE,bounty,Temple Ruins,0,0,1,1,270
9063,2023-01-12,EVE,knockout,Riverside,0,135,244,379,2532
9064,2023-01-12,EVE,hotZone,Open Zone,0,3,0,3,1488
9065,2023-01-12,EVE,gemGrab,Undermine,0,1,0,1,690
9066,2023-01-12,EVE,brawlBall,Sunny Soccer,0,0,1,1,240
9067,2023-01-12,EVE,brawlBall,Pinhole Punt,0,4,21,25,2292
9068,2023-01-11,EVE,knockout,Riverside,0,50,72,122,528
9069,2023-01-11,EVE,hotZone,Open Zone,0,1,0,1,462
9070,2023-01-11,EVE,heist,Safe Zone,0,1,1,2,48
9071,2023-01-11,EVE,gemGrab,Gem Fort,0,2,1,3,414
9072,2023-01-11,EVE,brawlBall,Sunny Soccer,0,2,0,2,1638
9073,2023-01-11,EVE,bounty,Excel,0,1,0,1,282
9074,2023-01-10,EVE,knockout,New Perspective,0,1,2,3,720
9075,2023-01-10,EVE,hotZone,Dueling Beetles,0,1,4,5,2424
9076,2023-01-10,EVE,heist,Safe Zone,0,20,5,25,1176
9077,2023-01-10,EVE,gemGrab,Minecart Madness,0,1,0,1,828
9078,2023-01-10,EVE,gemGrab,Crystal Arcade,0,3,1,4,1746
9079,2023-01-10,EVE,brawlBall,Beach Ball,0,6,8,14,4392
9080,2023-01-09,EVE,knockout,New Perspective,0,1,0,1,876
9081,2023-01-09,EVE,hotZone,Dueling Beetles,0,2,0,2,1554
9082,2023-01-09,EVE,heist,Snaked Assault,0,5,2,7,2022
9083,2023-01-09,EVE,gemGrab,Minecart Madness,0,3,5,8,1884
9084,2023-01-09,EVE,gemGrab,Double Swoosh,0,1,0,1,1320
9085,2023-01-09,EVE,brawlBall,Center Stage,0,9,8,17,5460
9086,2023-01-09,EVE,bounty,Layer Cake,0,2,1,3,1512
9087,2023-01-08,EVE,knockout,X Marks the Spot,0,4,2,6,1692
9088,2023-01-08,EVE,hotZone,Ring of Fire,0,3,5,8,1644
9089,2023-01-08,EVE,heist,Snaked Assault,0,1,0,1,1494
9090,2023-01-08,EVE,brawlBall,Backyard Bowl,0,5,1,6,4830
9091,2023-01-08,EVE,bounty,Layer Cake,0,2,1,3,528
9092,2023-01-07,EVE,knockout,X Marks the Spot,0,7,5,12,1014
9093,2023-01-07,EVE,hotZone,Ring of Fire,0,1,0,1,846
9094,2023-01-07,EVE,brawlBall,Super Beach,0,2,0,2,2622
9095,2023-01-07,EVE,brawlBall,Sneaky Fields,0,1,3,4,402
9096,2023-01-07,EVE,bounty,Dry Season,0,5,3,8,1320
9097,2023-01-06,EVE,knockout,Out in the Open,0,19,15,34,1446
9098,2023-01-06,EVE,hotZone,Split,0,2,0,2,1158
9099,2023-01-06,EVE,heist,Tornado Ring,0,5,0,5,2538
9100,2023-01-06,EVE,gemGrab,Undermine,0,3,0,3,540
9101,2023-01-06,EVE,gemGrab,Deep Diner,0,3,0,3,2226
9102,2023-01-06,EVE,brawlBall,Sneaky Fields,0,3,10,13,4896
9103,2023-01-06,EVE,bounty,Dry Season,0,5,12,17,1944
9104,2023-01-05,EVE,knockout,Out in the Open,0,39,30,69,2958
9105,2023-01-05,EVE,hotZone,Split,0,2,1,3,3552
9106,2023-01-05,EVE,heist,Kaboom Canyon,0,6,5,11,954
9107,2023-01-05,EVE,gemGrab,Undermine,0,2,1,3,1812
9108,2023-01-05,EVE,brawlBall,Pinhole Punt,0,9,18,27,8118
9109,2023-01-05,EVE,bounty,Shooting Star,0,4,3,7,1362
9110,2023-01-04,EVE,knockout,Goldarm Gulch,0,3,1,4,696
9111,2023-01-04,EVE,hotZone,Parallel Plays,0,1,0,1,864
9112,2023-01-04,EVE,heist,Kaboom Canyon,0,14,17,31,1848
9113,2023-01-04,EVE,gemGrab,Gem Fort,0,1,6,7,1788
9114,2023-01-04,EVE,gemGrab,Crystal Arcade,0,3,12,15,642
9115,2023-01-04,EVE,brawlBall,Sunny Soccer,0,2,0,2,6312
9116,2023-01-04,EVE,bounty,Shooting Star,0,17,28,45,3570
9117,2023-01-03,EVE,knockout,Goldarm Gulch,0,4,6,10,720
9118,2023-01-03,EVE,hotZone,Parallel Plays,0,1,0,1,1542
9119,2023-01-03,EVE,heist,Pit Stop,0,1,0,1,1956
9120,2023-01-03,EVE,heist,Kaboom Canyon,0,0,1,1,12
9121,2023-01-03,EVE,gemGrab,Crystal Arcade,0,6,0,6,2406
9122,2023-01-03,EVE,brawlBall,Center Stage,0,1,4,5,294
9123,2023-01-03,EVE,brawlBall,Beach Ball,0,7,2,9,5580
9124,2023-01-03,EVE,bounty,Hideout,0,3,1,4,1638
9125,2023-01-02,EVE,knockout,Belle's Rock,0,10,14,24,1794
9126,2023-01-02,EVE,hotZone,Quarter Pounder,0,3,2,5,2652
9127,2023-01-02,EVE,gemGrab,Minecart Madness,0,13,0,13,2352
9128,2023-01-02,EVE,brawlBall,Center Stage,0,7,2,9,7110
9129,2023-01-02,EVE,brawlBall,Backyard Bowl,0,0,1,1,492
9130,2023-01-02,EVE,bounty,Hideout,0,11,1,12,3090
9131,2023-01-01,EVE,knockout,Belle's Rock,0,1,0,1,858
9132,2023-01-01,EVE,hotZone,Quarter Pounder,0,4,0,4,1188
9133,2023-01-01,EVE,heist,Bridge Too Far,0,9,11,20,462
9134,2023-01-01,EVE,gemGrab,Double Swoosh,0,3,0,3,1140
9135,2023-01-01,EVE,brawlBall,Backyard Bowl,0,10,53,63,2658
9136,2023-01-01,EVE,bounty,Canal Grande,0,3,5,8,132
9137,2022-12-31,EVE,heist,Bridge Too Far,0,4,6,10,276
9138,2022-12-31,EVE,gemGrab,Hard Rock Mine,0,2,0,2,384
9139,2022-12-31,EVE,bounty,Canal Grande,0,1,0,1,54
9140,2022-12-30,EVE,gemGrab,Deep Diner,0,1,0,1,438
9141,2022-12-28,EVE,hotZone,Controller Chaos,0,1,0,1,6
9142,2022-12-27,EVE,knockout,New Perspective,0,1,0,1,30
9143,2022-12-23,EVE,knockout,Out in the Open,0,0,2,2,132
9144,2022-12-13,EVE,knockout,New Perspective,0,1,0,1,84
9145,2022-12-13,EVE,heist,Safe Zone,0,1,0,1,42
9146,2022-12-13,EVE,gemGrab,Crystal Arcade,0,1,7,8,72
9147,2022-11-11,EVE,brawlBall,Sneaky Fields,0,1,0,1,42
9148,2022-10-30,EVE,knockout,Out in the Open,0,1,0,1,12
9149,2022-10-28,EVE,knockout,Out in the Open,0,0,1,1,18
9150,2022-10-28,EVE,heist,Safe Zone,0,0,1,1,6
9151,2022-10-15,EVE,hotZone,Ring of Fire,0,2,2,4,24
9152,2023-01-28,EMZ,knockout,Flaring Phoenix,0,28,16,44,12366
9153,2023-01-28,EMZ,hotZone,Controller Chaos,0,252,284,536,10134
9154,2023-01-28,EMZ,heist,Bridge Too Far,0,34,11,45,24240
9155,2023-01-28,EMZ,gemGrab,Hard Rock Mine,0,107,66,173,16638
9156,2023-01-28,EMZ,gemGrab,Deep Diner,0,23,29,52,5478
9157,2023-01-28,EMZ,brawlBall,Super Beach,15,444,532,991,74430
9158,2023-01-28,EMZ,brawlBall,Sneaky Fields,3,44,57,104,3582
9159,2023-01-28,EMZ,bounty,Canal Grande,0,44,30,74,10902
9160,2023-01-27,EMZ,knockout,Flaring Phoenix,0,8,4,12,5928
9161,2023-01-27,EMZ,hotZone,Controller Chaos,0,50,81,131,2676
9162,2023-01-27,EMZ,heist,Hot Potato,1,39,46,86,3486
9163,2023-01-27,EMZ,gemGrab,Undermine,0,12,8,20,942
9164,2023-01-27,EMZ,gemGrab,Deep Diner,0,37,25,62,6846
9165,2023-01-27,EMZ,brawlBall,Sneaky Fields,6,201,256,463,23514
9166,2023-01-27,EMZ,brawlBall,Pinhole Punt,0,6,6,12,738
9167,2023-01-27,EMZ,bounty,Temple Ruins,0,7,15,22,1890
9168,2023-01-26,EMZ,knockout,Riverside,0,22,7,29,19008
9169,2023-01-26,EMZ,hotZone,Open Zone,0,74,36,110,10182
9170,2023-01-26,EMZ,heist,Hot Potato,1,482,564,1047,14610
9171,2023-01-26,EMZ,gemGrab,Undermine,0,157,134,291,10062
9172,2023-01-26,EMZ,gemGrab,Gem Fort,0,46,51,97,4674
9173,2023-01-26,EMZ,brawlBall,Sunny Soccer,0,22,11,33,3660
9174,2023-01-26,EMZ,brawlBall,Pinhole Punt,18,494,505,1017,67338
9175,2023-01-26,EMZ,bounty,Temple Ruins,0,35,26,61,5610
9176,2023-01-25,EMZ,knockout,Riverside,0,16,2,18,9906
9177,2023-01-25,EMZ,hotZone,Open Zone,0,33,23,56,5262
9178,2023-01-25,EMZ,heist,Safe Zone,0,30,9,39,9156
9179,2023-01-25,EMZ,gemGrab,Gem Fort,0,66,62,128,5556
9180,2023-01-25,EMZ,gemGrab,Crystal Arcade,0,90,71,161,7866
9181,2023-01-25,EMZ,brawlBall,Sunny Soccer,11,281,311,603,40830
9182,2023-01-25,EMZ,brawlBall,Beach Ball,5,29,21,55,6408
9183,2023-01-25,EMZ,bounty,Excel,0,10,2,12,5790
9184,2023-01-24,EMZ,knockout,New Perspective,0,30,16,46,10542
9185,2023-01-24,EMZ,hotZone,Dueling Beetles,0,133,87,220,10662
9186,2023-01-24,EMZ,heist,Safe Zone,0,46,26,72,15750
9187,2023-01-24,EMZ,gemGrab,Minecart Madness,0,25,5,30,4002
9188,2023-01-24,EMZ,gemGrab,Crystal Arcade,0,123,105,228,14460
9189,2023-01-24,EMZ,brawlBall,Center Stage,5,68,78,151,7860
9190,2023-01-24,EMZ,brawlBall,Beach Ball,9,394,385,788,64614
9191,2023-01-24,EMZ,bounty,Excel,0,12,6,18,10896
9192,2023-01-23,EMZ,knockout,New Perspective,0,46,29,75,20676
9193,2023-01-23,EMZ,hotZone,Dueling Beetles,0,220,88,308,17502
9194,2023-01-23,EMZ,heist,Snaked Assault,1,574,807,1382,15762
9195,2023-01-23,EMZ,gemGrab,Minecart Madness,0,107,52,159,19062
9196,2023-01-23,EMZ,gemGrab,Double Swoosh,0,181,147,328,7578
9197,2023-01-23,EMZ,brawlBall,Center Stage,17,614,708,1339,92862
9198,2023-01-23,EMZ,brawlBall,Backyard Bowl,0,15,5,20,4224
9199,2023-01-23,EMZ,bounty,Layer Cake,0,33,8,41,11142
9200,2023-01-22,EMZ,knockout,X Marks the Spot,0,17,8,25,9174
9201,2023-01-22,EMZ,hotZone,Ring of Fire,0,61,53,114,5730
9202,2023-01-22,EMZ,heist,Snaked Assault,2,312,425,739,8232
9203,2023-01-22,EMZ,gemGrab,Hard Rock Mine,0,24,15,39,4722
9204,2023-01-22,EMZ,gemGrab,Double Swoosh,0,196,203,399,9426
9205,2023-01-22,EMZ,brawlBall,Super Beach,1,43,49,93,7386
9206,2023-01-22,EMZ,brawlBall,Backyard Bowl,6,96,59,161,34788
9207,2023-01-22,EMZ,bounty,Layer Cake,0,11,4,15,6654
9208,2023-01-21,EMZ,knockout,X Marks the Spot,0,55,22,77,31698
9209,2023-01-21,EMZ,hotZone,Ring of Fire,0,162,109,271,16632
9210,2023-01-21,EMZ,heist,Tornado Ring,3,534,767,1304,11664
9211,2023-01-21,EMZ,gemGrab,Hard Rock Mine,0,143,65,208,22980
9212,2023-01-21,EMZ,gemGrab,Deep Diner,0,47,22,69,4470
9213,2023-01-21,EMZ,brawlBall,Super Beach,22,677,687,1386,101364
9214,2023-01-21,EMZ,brawlBall,Sneaky Fields,0,24,33,57,3750
9215,2023-01-21,EMZ,bounty,Dry Season,0,11,4,15,14538
9216,2023-01-20,EMZ,knockout,Out in the Open,0,44,14,58,20106
9217,2023-01-20,EMZ,hotZone,Split,0,52,34,86,9678
9218,2023-01-20,EMZ,heist,Tornado Ring,7,709,942,1658,12672
9219,2023-01-20,EMZ,gemGrab,Undermine,0,52,42,94,5442
9220,2023-01-20,EMZ,gemGrab,Deep Diner,0,157,98,255,19050
9221,2023-01-20,EMZ,brawlBall,Sneaky Fields,32,762,1001,1795,74778
9222,2023-01-20,EMZ,brawlBall,Pinhole Punt,0,23,36,59,2886
9223,2023-01-20,EMZ,bounty,Dry Season,0,11,4,15,11640
9224,2023-01-19,EMZ,knockout,Out in the Open,0,61,27,88,26574
9225,2023-01-19,EMZ,hotZone,Split,0,76,44,120,14856
9226,2023-01-19,EMZ,heist,Kaboom Canyon,0,24,20,44,6732
9227,2023-01-19,EMZ,gemGrab,Undermine,0,255,271,526,14154
9228,2023-01-19,EMZ,gemGrab,Gem Fort,0,42,26,68,2934
9229,2023-01-19,EMZ,brawlBall,Sunny Soccer,0,11,9,20,2274
9230,2023-01-19,EMZ,brawlBall,Pinhole Punt,15,478,498,991,72498
9231,2023-01-19,EMZ,bounty,Shooting Star,0,10,4,14,11124
9232,2023-01-18,EMZ,knockout,Goldarm Gulch,0,5,2,7,2784
9233,2023-01-18,EMZ,hotZone,Parallel Plays,0,13,8,21,1158
9234,2023-01-18,EMZ,heist,Kaboom Canyon,0,8,1,9,2592
9235,2023-01-18,EMZ,gemGrab,Gem Fort,0,40,38,78,3006
9236,2023-01-18,EMZ,gemGrab,Crystal Arcade,0,12,3,15,990
9237,2023-01-18,EMZ,brawlBall,Sunny Soccer,0,125,144,269,18941
9238,2023-01-18,EMZ,brawlBall,Beach Ball,0,0,4,4,774
9239,2023-01-18,EMZ,bounty,Shooting Star,0,6,1,7,5088
9240,2023-01-17,EMZ,knockout,Goldarm Gulch,0,3,3,6,2520
9241,2023-01-17,EMZ,hotZone,Parallel Plays,0,13,13,26,1038
9242,2023-01-17,EMZ,heist,Pit Stop,0,10,7,17,1290
9243,2023-01-17,EMZ,gemGrab,Minecart Madness,0,1,0,1,216
9244,2023-01-17,EMZ,gemGrab,Crystal Arcade,0,14,16,30,1266
9245,2023-01-17,EMZ,brawlBall,Center Stage,0,1,1,2,288
9246,2023-01-17,EMZ,brawlBall,Beach Ball,0,31,24,55,5886
9247,2023-01-17,EMZ,bounty,Hideout,0,1,0,1,750
9248,2023-01-16,EMZ,knockout,Belle's Rock,0,2,0,2,1788
9249,2023-01-16,EMZ,hotZone,Quarter Pounder,0,18,18,36,1494
9250,2023-01-16,EMZ,heist,Pit Stop,0,47,68,115,4044
9251,2023-01-16,EMZ,gemGrab,Minecart Madness,0,3,3,6,1422
9252,2023-01-16,EMZ,gemGrab,Double Swoosh,0,12,14,26,708
9253,2023-01-16,EMZ,brawlBall,Center Stage,3,36,45,84,5778
9254,2023-01-16,EMZ,brawlBall,Backyard Bowl,0,2,4,6,852
9255,2023-01-16,EMZ,bounty,Hideout,0,1,0,1,1470
9256,2023-01-15,EMZ,knockout,Belle's Rock,0,1,1,2,2904
9257,2023-01-15,EMZ,hotZone,Quarter Pounder,0,40,20,60,3318
9258,2023-01-15,EMZ,heist,Bridge Too Far,0,3,0,3,2736
9259,2023-01-15,EMZ,gemGrab,Hard Rock Mine,0,8,2,10,1014
9260,2023-01-15,EMZ,gemGrab,Double Swoosh,0,46,38,84,2178
9261,2023-01-15,EMZ,brawlBall,Super Beach,0,4,3,7,1074
9262,2023-01-15,EMZ,brawlBall,Backyard Bowl,2,24,5,31,8946
9263,2023-01-15,EMZ,bounty,Canal Grande,0,5,1,6,960
9264,2023-01-14,EMZ,knockout,Flaring Phoenix,0,2,1,3,1080
9265,2023-01-14,EMZ,hotZone,Controller Chaos,0,76,67,143,2772
9266,2023-01-14,EMZ,heist,Bridge Too Far,0,3,1,4,4020
9267,2023-01-14,EMZ,gemGrab,Hard Rock Mine,0,7,1,8,1272
9268,2023-01-14,EMZ,gemGrab,Deep Diner,0,5,1,6,858
9269,2023-01-14,EMZ,brawlBall,Super Beach,1,41,27,69,6336
9270,2023-01-14,EMZ,brawlBall,Sneaky Fields,0,16,6,22,918
9271,2023-01-14,EMZ,bounty,Canal Grande,0,3,3,6,1014
9272,2023-01-13,EMZ,hotZone,Controller Chaos,0,86,85,171,2928
9273,2023-01-13,EMZ,heist,Hot Potato,0,18,12,30,600
9274,2023-01-13,EMZ,gemGrab,Undermine,0,1,0,1,18
9275,2023-01-13,EMZ,gemGrab,Deep Diner,0,10,5,15,1650
9276,2023-01-13,EMZ,brawlBall,Sneaky Fields,0,65,39,104,6144
9277,2023-01-13,EMZ,bounty,Temple Ruins,0,2,0,2,270
9278,2023-01-12,EMZ,knockout,Riverside,0,1,0,1,2532
9279,2023-01-12,EMZ,hotZone,Open Zone,0,17,0,17,1488
9280,2023-01-12,EMZ,heist,Hot Potato,0,17,31,48,330
9281,2023-01-12,EMZ,gemGrab,Undermine,0,10,8,18,690
9282,2023-01-12,EMZ,gemGrab,Gem Fort,0,2,1,3,162
9283,2023-01-12,EMZ,brawlBall,Sunny Soccer,0,6,8,14,240
9284,2023-01-12,EMZ,brawlBall,Pinhole Punt,0,22,11,33,2292
9285,2023-01-11,EMZ,hotZone,Open Zone,0,2,0,2,462
9286,2023-01-11,EMZ,heist,Safe Zone,0,1,0,1,48
9287,2023-01-11,EMZ,gemGrab,Gem Fort,0,7,9,16,414
9288,2023-01-11,EMZ,brawlBall,Sunny Soccer,0,15,14,29,1638
9289,2023-01-10,EMZ,knockout,New Perspective,0,1,0,1,720
9290,2023-01-10,EMZ,hotZone,Dueling Beetles,0,41,8,49,2424
9291,2023-01-10,EMZ,heist,Safe Zone,0,2,0,2,1176
9292,2023-01-10,EMZ,gemGrab,Minecart Madness,0,7,6,13,828
9293,2023-01-10,EMZ,gemGrab,Crystal Arcade,0,16,4,20,1746
9294,2023-01-10,EMZ,brawlBall,Center Stage,0,15,55,70,708
9295,2023-01-10,EMZ,brawlBall,Beach Ball,0,29,17,46,4392
9296,2023-01-09,EMZ,knockout,New Perspective,0,4,1,5,876
9297,2023-01-09,EMZ,hotZone,Dueling Beetles,0,21,8,29,1554
9298,2023-01-09,EMZ,heist,Snaked Assault,0,59,78,137,2022
9299,2023-01-09,EMZ,gemGrab,Minecart Madness,0,10,7,17,1884
9300,2023-01-09,EMZ,gemGrab,Double Swoosh,0,21,9,30,1320
9301,2023-01-09,EMZ,brawlBall,Center Stage,1,52,144,197,5460
9302,2023-01-09,EMZ,bounty,Layer Cake,0,5,0,5,1512
9303,2023-01-08,EMZ,knockout,X Marks the Spot,0,4,0,4,1692
9304,2023-01-08,EMZ,hotZone,Ring of Fire,0,11,4,15,1644
9305,2023-01-08,EMZ,heist,Snaked Assault,0,67,45,112,1494
9306,2023-01-08,EMZ,gemGrab,Hard Rock Mine,0,5,1,6,630
9307,2023-01-08,EMZ,gemGrab,Double Swoosh,0,21,13,34,864
9308,2023-01-08,EMZ,brawlBall,Super Beach,0,3,2,5,732
9309,2023-01-08,EMZ,brawlBall,Backyard Bowl,0,7,5,12,4830
9310,2023-01-07,EMZ,knockout,X Marks the Spot,0,1,0,1,1014
9311,2023-01-07,EMZ,hotZone,Ring of Fire,0,10,1,11,846
9312,2023-01-07,EMZ,heist,Tornado Ring,2,70,83,155,1350
9313,2023-01-07,EMZ,gemGrab,Hard Rock Mine,0,6,1,7,1158
9314,2023-01-07,EMZ,gemGrab,Deep Diner,0,7,4,11,918
9315,2023-01-07,EMZ,brawlBall,Super Beach,0,23,11,34,2622
9316,2023-01-07,EMZ,brawlBall,Sneaky Fields,0,4,14,18,402
9317,2023-01-07,EMZ,bounty,Dry Season,0,1,0,1,1320
9318,2023-01-06,EMZ,knockout,Out in the Open,0,2,2,4,1446
9319,2023-01-06,EMZ,hotZone,Split,0,4,0,4,1158
9320,2023-01-06,EMZ,heist,Tornado Ring,2,164,164,330,2538
9321,2023-01-06,EMZ,gemGrab,Undermine,0,10,10,20,540
9322,2023-01-06,EMZ,gemGrab,Deep Diner,0,10,4,14,2226
9323,2023-01-06,EMZ,brawlBall,Sneaky Fields,2,47,87,136,4896
9324,2023-01-06,EMZ,brawlBall,Pinhole Punt,0,2,5,7,510
9325,2023-01-06,EMZ,bounty,Dry Season,0,1,0,1,1944
9326,2023-01-05,EMZ,knockout,Out in the Open,0,5,0,5,2958
9327,2023-01-05,EMZ,hotZone,Split,0,9,0,9,3552
9328,2023-01-05,EMZ,heist,Kaboom Canyon,0,4,0,4,954
9329,2023-01-05,EMZ,gemGrab,Undermine,0,23,25,48,1812
9330,2023-01-05,EMZ,gemGrab,Gem Fort,0,3,2,5,252
9331,2023-01-05,EMZ,brawlBall,Sunny Soccer,0,1,0,1,84
9332,2023-01-05,EMZ,brawlBall,Pinhole Punt,4,66,70,140,8118
9333,2023-01-04,EMZ,knockout,Goldarm Gulch,0,3,0,3,696
9334,2023-01-04,EMZ,hotZone,Parallel Plays,0,12,3,15,864
9335,2023-01-04,EMZ,heist,Kaboom Canyon,0,14,0,14,1848
9336,2023-01-04,EMZ,gemGrab,Gem Fort,0,21,15,36,1788
9337,2023-01-04,EMZ,gemGrab,Crystal Arcade,0,9,5,14,642
9338,2023-01-04,EMZ,brawlBall,Sunny Soccer,3,47,98,148,6312
9339,2023-01-04,EMZ,bounty,Shooting Star,0,1,0,1,3570
9340,2023-01-03,EMZ,knockout,Goldarm Gulch,0,1,0,1,720
9341,2023-01-03,EMZ,hotZone,Parallel Plays,0,23,10,33,1542
9342,2023-01-03,EMZ,heist,Pit Stop,0,12,20,32,1956
9343,2023-01-03,EMZ,gemGrab,Minecart Madness,0,2,0,2,456
9344,2023-01-03,EMZ,gemGrab,Crystal Arcade,0,15,3,18,2406
9345,2023-01-03,EMZ,brawlBall,Center Stage,0,4,10,14,294
9346,2023-01-03,EMZ,brawlBall,Beach Ball,0,41,46,87,5580
9347,2023-01-03,EMZ,bounty,Hideout,0,2,1,3,1638
9348,2023-01-02,EMZ,hotZone,Quarter Pounder,0,42,4,46,2652
9349,2023-01-02,EMZ,hotZone,Controller Chaos,0,1,1,2,18
9350,2023-01-02,EMZ,heist,Pit Stop,0,42,37,79,3498
9351,2023-01-02,EMZ,heist,Kaboom Canyon,0,0,1,1,30
9352,2023-01-02,EMZ,gemGrab,Minecart Madness,0,7,2,9,2352
9353,2023-01-02,EMZ,gemGrab,Double Swoosh,0,25,29,54,1512
9354,2023-01-02,EMZ,brawlBall,Center Stage,1,70,69,140,7110
9355,2023-01-02,EMZ,brawlBall,Backyard Bowl,0,2,3,5,492
9356,2023-01-02,EMZ,bounty,Hideout,0,4,0,4,3090
9357,2023-01-01,EMZ,hotZone,Quarter Pounder,0,9,1,10,1188
9358,2023-01-01,EMZ,heist,Kaboom Canyon,0,1,0,1,12
9359,2023-01-01,EMZ,heist,Bridge Too Far,0,1,0,1,462
9360,2023-01-01,EMZ,gemGrab,Double Swoosh,0,15,17,32,1140
9361,2023-01-01,EMZ,brawlBall,Backyard Bowl,0,4,5,9,2658
9362,2023-01-01,EMZ,bounty,Canal Grande,0,1,0,1,132
9363,2022-12-31,EMZ,hotZone,Controller Chaos,0,6,3,9,198
9364,2022-12-31,EMZ,gemGrab,Hard Rock Mine,0,4,0,4,384
9365,2022-12-31,EMZ,gemGrab,Deep Diner,0,2,0,2,306
9366,2022-12-31,EMZ,brawlBall,Super Beach,0,4,5,9,618
9367,2022-12-30,EMZ,knockout,Flaring Phoenix,0,0,1,1,72
9368,2022-12-30,EMZ,hotZone,Controller Chaos,0,4,2,6,288
9369,2022-12-30,EMZ,heist,Kaboom Canyon,0,0,1,1,18
9370,2022-12-30,EMZ,gemGrab,Undermine,0,1,0,1,102
9371,2022-12-30,EMZ,gemGrab,Minecart Madness,0,0,1,1,24
9372,2022-12-30,EMZ,gemGrab,Deep Diner,0,1,0,1,438
9373,2022-12-30,EMZ,brawlBall,Sneaky Fields,0,10,12,22,552
9374,2022-12-29,EMZ,hotZone,Open Zone,0,1,0,1,54
9375,2022-12-29,EMZ,hotZone,Controller Chaos,0,0,1,1,12
9376,2022-12-29,EMZ,heist,Hot Potato,0,4,1,5,72
9377,2022-12-29,EMZ,gemGrab,Undermine,0,7,4,11,102
9378,2022-12-29,EMZ,gemGrab,Minecart Madness,0,0,1,1,24
9379,2022-12-29,EMZ,brawlBall,Pinhole Punt,0,1,0,1,282
9380,2022-12-27,EMZ,hotZone,Dueling Beetles,0,0,1,1,36
9381,2022-12-27,EMZ,hotZone,Controller Chaos,0,0,2,2,24
9382,2022-12-27,EMZ,heist,Kaboom Canyon,0,1,0,1,18
9383,2022-12-27,EMZ,brawlBall,Beach Ball,0,1,1,2,144
9384,2022-12-26,EMZ,hotZone,Controller Chaos,0,2,0,2,30
9385,2022-12-26,EMZ,gemGrab,Minecart Madness,0,1,2,3,60
9386,2022-12-26,EMZ,brawlBall,Center Stage,0,1,1,2,78
9387,2022-12-25,EMZ,hotZone,Ring of Fire,0,1,0,1,12
9388,2022-12-25,EMZ,gemGrab,Double Swoosh,0,1,1,2,30
9389,2022-12-22,EMZ,gemGrab,Gem Fort,0,1,0,1,90
9390,2022-12-22,EMZ,brawlBall,Pinhole Punt,0,2,1,3,132
9391,2022-12-20,EMZ,brawlBall,Beach Ball,0,0,1,1,96
9392,2022-12-19,EMZ,brawlBall,Center Stage,0,2,3,5,102
9393,2022-12-16,EMZ,brawlBall,Sneaky Fields,0,1,0,1,84
9394,2022-12-13,EMZ,hotZone,Dueling Beetles,0,1,0,1,6
9395,2022-12-13,EMZ,brawlBall,Beach Ball,0,1,0,1,54
9396,2022-12-11,EMZ,gemGrab,Double Swoosh,0,1,1,2,12
9397,2022-11-11,EMZ,brawlBall,Sneaky Fields,0,1,4,5,42
9398,2022-10-30,EMZ,hotZone,Dueling Beetles,0,1,0,1,12
9399,2022-10-30,EMZ,brawlBall,Beach Ball,0,1,0,1,12
9400,2022-10-30,EMZ,bounty,Canal Grande,0,0,1,1,12
9401,2022-10-28,EMZ,brawlBall,Beach Ball,0,1,2,3,12
9402,2022-10-15,EMZ,gemGrab,Hard Rock Mine,0,3,1,4,90
9403,2023-01-28,EL PRIMO,knockout,Flaring Phoenix,0,32,7,39,12366
9404,2023-01-28,EL PRIMO,hotZone,Controller Chaos,0,76,30,106,10134
9405,2023-01-28,EL PRIMO,heist,Bridge Too Far,0,79,28,107,24240
9406,2023-01-28,EL PRIMO,gemGrab,Hard Rock Mine,0,78,80,158,16638
9407,2023-01-28,EL PRIMO,gemGrab,Deep Diner,0,13,4,17,5478
9408,2023-01-28,EL PRIMO,brawlBall,Super Beach,25,1251,1147,2423,74430
9409,2023-01-28,EL PRIMO,brawlBall,Sneaky Fields,3,103,69,175,3582
9410,2023-01-28,EL PRIMO,bounty,Canal Grande,0,25,12,37,10902
9411,2023-01-27,EL PRIMO,knockout,Flaring Phoenix,1,16,7,24,5928
9412,2023-01-27,EL PRIMO,hotZone,Controller Chaos,0,9,6,15,2676
9413,2023-01-27,EL PRIMO,heist,Hot Potato,0,48,35,83,3486
9414,2023-01-27,EL PRIMO,gemGrab,Undermine,0,1,2,3,942
9415,2023-01-27,EL PRIMO,gemGrab,Deep Diner,0,18,6,24,6846
9416,2023-01-27,EL PRIMO,brawlBall,Sneaky Fields,8,625,538,1171,23514
9417,2023-01-27,EL PRIMO,brawlBall,Pinhole Punt,0,13,14,27,738
9418,2023-01-27,EL PRIMO,bounty,Temple Ruins,0,4,0,4,1890
9419,2023-01-26,EL PRIMO,knockout,Riverside,0,18,7,25,19008
9420,2023-01-26,EL PRIMO,hotZone,Open Zone,0,20,5,25,10182
9421,2023-01-26,EL PRIMO,heist,Hot Potato,1,176,147,324,14610
9422,2023-01-26,EL PRIMO,gemGrab,Undermine,0,34,29,63,10062
9423,2023-01-26,EL PRIMO,gemGrab,Gem Fort,0,32,16,48,4674
9424,2023-01-26,EL PRIMO,brawlBall,Sunny Soccer,1,89,81,171,3660
9425,2023-01-26,EL PRIMO,brawlBall,Pinhole Punt,17,907,697,1621,67338
9426,2023-01-26,EL PRIMO,bounty,Temple Ruins,0,18,2,20,5610
9427,2023-01-25,EL PRIMO,knockout,Riverside,0,17,4,21,9906
9428,2023-01-25,EL PRIMO,hotZone,Open Zone,0,6,1,7,5262
9429,2023-01-25,EL PRIMO,heist,Safe Zone,0,25,21,46,9156
9430,2023-01-25,EL PRIMO,gemGrab,Gem Fort,0,41,36,77,5556
9431,2023-01-25,EL PRIMO,gemGrab,Crystal Arcade,0,26,18,44,7866
9432,2023-01-25,EL PRIMO,brawlBall,Sunny Soccer,19,759,623,1401,40830
9433,2023-01-25,EL PRIMO,brawlBall,Beach Ball,4,127,103,234,6408
9434,2023-01-25,EL PRIMO,bounty,Excel,0,16,16,32,5790
9435,2023-01-24,EL PRIMO,knockout,New Perspective,0,18,9,27,10542
9436,2023-01-24,EL PRIMO,hotZone,Dueling Beetles,0,39,8,47,10662
9437,2023-01-24,EL PRIMO,heist,Safe Zone,0,67,47,114,15750
9438,2023-01-24,EL PRIMO,gemGrab,Minecart Madness,0,19,22,41,4002
9439,2023-01-24,EL PRIMO,gemGrab,Crystal Arcade,0,45,36,81,14460
9440,2023-01-24,EL PRIMO,brawlBall,Center Stage,9,184,152,345,7860
9441,2023-01-24,EL PRIMO,brawlBall,Beach Ball,21,1154,883,2058,64614
9442,2023-01-24,EL PRIMO,bounty,Excel,0,8,10,18,10896
9443,2023-01-23,EL PRIMO,knockout,New Perspective,0,42,21,63,20676
9444,2023-01-23,EL PRIMO,hotZone,Dueling Beetles,0,60,19,79,17502
9445,2023-01-23,EL PRIMO,heist,Snaked Assault,0,236,166,402,15762
9446,2023-01-23,EL PRIMO,gemGrab,Minecart Madness,0,62,34,96,19062
9447,2023-01-23,EL PRIMO,gemGrab,Double Swoosh,0,39,15,54,7578
9448,2023-01-23,EL PRIMO,brawlBall,Center Stage,46,2101,1960,4107,92862
9449,2023-01-23,EL PRIMO,brawlBall,Backyard Bowl,0,37,25,62,4224
9450,2023-01-23,EL PRIMO,bounty,Layer Cake,0,20,20,40,11142
9451,2023-01-22,EL PRIMO,knockout,X Marks the Spot,0,9,3,12,9174
9452,2023-01-22,EL PRIMO,hotZone,Ring of Fire,0,25,24,49,5730
9453,2023-01-22,EL PRIMO,heist,Snaked Assault,0,98,72,170,8232
9454,2023-01-22,EL PRIMO,gemGrab,Hard Rock Mine,0,21,25,46,4722
9455,2023-01-22,EL PRIMO,gemGrab,Double Swoosh,0,56,27,83,9426
9456,2023-01-22,EL PRIMO,brawlBall,Super Beach,3,149,125,277,7386
9457,2023-01-22,EL PRIMO,brawlBall,Backyard Bowl,4,265,203,472,34788
9458,2023-01-22,EL PRIMO,bounty,Layer Cake,0,11,7,18,6654
9459,2023-01-21,EL PRIMO,knockout,X Marks the Spot,0,40,19,59,31698
9460,2023-01-21,EL PRIMO,hotZone,Ring of Fire,0,31,48,79,16632
9461,2023-01-21,EL PRIMO,heist,Tornado Ring,1,213,170,384,11664
9462,2023-01-21,EL PRIMO,gemGrab,Hard Rock Mine,0,101,76,177,22980
9463,2023-01-21,EL PRIMO,gemGrab,Deep Diner,0,9,8,17,4470
9464,2023-01-21,EL PRIMO,brawlBall,Super Beach,32,1635,1414,3081,101364
9465,2023-01-21,EL PRIMO,brawlBall,Sneaky Fields,0,86,87,173,3750
9466,2023-01-21,EL PRIMO,bounty,Dry Season,0,18,7,25,14538
9467,2023-01-20,EL PRIMO,knockout,Out in the Open,0,33,13,46,20106
9468,2023-01-20,EL PRIMO,hotZone,Split,0,77,59,136,9678
9469,2023-01-20,EL PRIMO,heist,Tornado Ring,1,146,123,270,12672
9470,2023-01-20,EL PRIMO,gemGrab,Undermine,0,16,5,21,5442
9471,2023-01-20,EL PRIMO,gemGrab,Deep Diner,0,57,32,89,19050
9472,2023-01-20,EL PRIMO,brawlBall,Sneaky Fields,29,1926,1716,3671,74778
9473,2023-01-20,EL PRIMO,brawlBall,Pinhole Punt,2,36,24,62,2886
9474,2023-01-20,EL PRIMO,bounty,Dry Season,0,7,7,14,11640
9475,2023-01-19,EL PRIMO,knockout,Out in the Open,0,28,17,45,26574
9476,2023-01-19,EL PRIMO,hotZone,Split,0,125,74,199,14856
9477,2023-01-19,EL PRIMO,heist,Kaboom Canyon,1,48,21,70,6732
9478,2023-01-19,EL PRIMO,gemGrab,Undermine,0,60,28,88,14154
9479,2023-01-19,EL PRIMO,gemGrab,Gem Fort,0,15,13,28,2934
9480,2023-01-19,EL PRIMO,brawlBall,Sunny Soccer,0,65,49,114,2274
9481,2023-01-19,EL PRIMO,brawlBall,Pinhole Punt,20,912,727,1659,72498
9482,2023-01-19,EL PRIMO,bounty,Shooting Star,0,5,2,7,11124
9483,2023-01-18,EL PRIMO,knockout,Goldarm Gulch,0,5,5,10,2784
9484,2023-01-18,EL PRIMO,hotZone,Parallel Plays,0,3,2,5,1158
9485,2023-01-18,EL PRIMO,heist,Kaboom Canyon,0,6,3,9,2592
9486,2023-01-18,EL PRIMO,gemGrab,Gem Fort,0,13,12,25,3006
9487,2023-01-18,EL PRIMO,gemGrab,Crystal Arcade,0,2,2,4,990
9488,2023-01-18,EL PRIMO,brawlBall,Sunny Soccer,4,360,337,701,18941
9489,2023-01-18,EL PRIMO,brawlBall,Beach Ball,0,12,6,18,774
9490,2023-01-18,EL PRIMO,bounty,Shooting Star,0,3,0,3,5088
9491,2023-01-17,EL PRIMO,knockout,Goldarm Gulch,0,6,5,11,2520
9492,2023-01-17,EL PRIMO,hotZone,Parallel Plays,0,7,3,10,1038
9493,2023-01-17,EL PRIMO,heist,Pit Stop,0,23,31,54,1290
9494,2023-01-17,EL PRIMO,gemGrab,Minecart Madness,0,2,0,2,216
9495,2023-01-17,EL PRIMO,gemGrab,Crystal Arcade,0,4,4,8,1266
9496,2023-01-17,EL PRIMO,brawlBall,Center Stage,0,4,8,12,288
9497,2023-01-17,EL PRIMO,brawlBall,Beach Ball,1,85,75,161,5886
9498,2023-01-16,EL PRIMO,knockout,Belle's Rock,0,4,1,5,1788
9499,2023-01-16,EL PRIMO,hotZone,Quarter Pounder,0,3,0,3,1494
9500,2023-01-16,EL PRIMO,heist,Pit Stop,0,93,80,173,4044
9501,2023-01-16,EL PRIMO,gemGrab,Minecart Madness,0,4,0,4,1422
9502,2023-01-16,EL PRIMO,gemGrab,Double Swoosh,0,1,0,1,708
9503,2023-01-16,EL PRIMO,brawlBall,Center Stage,6,119,98,223,5778
9504,2023-01-16,EL PRIMO,brawlBall,Backyard Bowl,0,12,4,16,852
9505,2023-01-15,EL PRIMO,knockout,Belle's Rock,0,2,4,6,2904
9506,2023-01-15,EL PRIMO,hotZone,Quarter Pounder,0,18,3,21,3318
9507,2023-01-15,EL PRIMO,heist,Bridge Too Far,0,6,2,8,2736
9508,2023-01-15,EL PRIMO,gemGrab,Hard Rock Mine,0,5,1,6,1014
9509,2023-01-15,EL PRIMO,gemGrab,Double Swoosh,0,13,5,18,2178
9510,2023-01-15,EL PRIMO,brawlBall,Super Beach,0,15,6,21,1074
9511,2023-01-15,EL PRIMO,brawlBall,Backyard Bowl,3,74,39,116,8946
9512,2023-01-15,EL PRIMO,bounty,Canal Grande,0,3,1,4,960
9513,2023-01-14,EL PRIMO,knockout,Flaring Phoenix,0,1,2,3,1080
9514,2023-01-14,EL PRIMO,hotZone,Controller Chaos,0,12,1,13,2772
9515,2023-01-14,EL PRIMO,heist,Bridge Too Far,0,4,0,4,4020
9516,2023-01-14,EL PRIMO,gemGrab,Hard Rock Mine,0,4,1,5,1272
9517,2023-01-14,EL PRIMO,gemGrab,Deep Diner,0,1,1,2,858
9518,2023-01-14,EL PRIMO,brawlBall,Super Beach,2,93,56,151,6336
9519,2023-01-14,EL PRIMO,brawlBall,Sneaky Fields,1,19,22,42,918
9520,2023-01-14,EL PRIMO,bounty,Canal Grande,0,5,1,6,1014
9521,2023-01-13,EL PRIMO,knockout,Flaring Phoenix,0,1,3,4,1182
9522,2023-01-13,EL PRIMO,hotZone,Controller Chaos,0,15,5,20,2928
9523,2023-01-13,EL PRIMO,heist,Hot Potato,0,6,1,7,600
9524,2023-01-13,EL PRIMO,gemGrab,Deep Diner,0,4,1,5,1650
9525,2023-01-13,EL PRIMO,brawlBall,Sneaky Fields,2,146,166,314,6144
9526,2023-01-13,EL PRIMO,brawlBall,Pinhole Punt,0,2,0,2,156
9527,2023-01-12,EL PRIMO,hotZone,Open Zone,0,1,0,1,1488
9528,2023-01-12,EL PRIMO,heist,Hot Potato,0,4,2,6,330
9529,2023-01-12,EL PRIMO,gemGrab,Undermine,0,2,4,6,690
9530,2023-01-12,EL PRIMO,gemGrab,Gem Fort,0,1,0,1,162
9531,2023-01-12,EL PRIMO,brawlBall,Sunny Soccer,0,8,18,26,240
9532,2023-01-12,EL PRIMO,brawlBall,Pinhole Punt,0,31,17,48,2292
9533,2023-01-11,EL PRIMO,brawlBall,Sunny Soccer,0,30,19,49,1638
9534,2023-01-11,EL PRIMO,brawlBall,Beach Ball,0,0,2,2,48
9535,2023-01-10,EL PRIMO,knockout,New Perspective,0,1,1,2,720
9536,2023-01-10,EL PRIMO,hotZone,Dueling Beetles,0,9,0,9,2424
9537,2023-01-10,EL PRIMO,heist,Safe Zone,0,8,1,9,1176
9538,2023-01-10,EL PRIMO,gemGrab,Minecart Madness,0,4,0,4,828
9539,2023-01-10,EL PRIMO,gemGrab,Crystal Arcade,0,6,3,9,1746
9540,2023-01-10,EL PRIMO,brawlBall,Center Stage,0,10,5,15,708
9541,2023-01-10,EL PRIMO,brawlBall,Beach Ball,0,60,29,89,4392
9542,2023-01-09,EL PRIMO,knockout,New Perspective,0,1,1,2,876
9543,2023-01-09,EL PRIMO,hotZone,Dueling Beetles,0,6,0,6,1554
9544,2023-01-09,EL PRIMO,heist,Snaked Assault,0,48,4,52,2022
9545,2023-01-09,EL PRIMO,gemGrab,Minecart Madness,0,7,1,8,1884
9546,2023-01-09,EL PRIMO,gemGrab,Double Swoosh,0,1,0,1,1320
9547,2023-01-09,EL PRIMO,brawlBall,Center Stage,4,98,92,194,5460
9548,2023-01-09,EL PRIMO,brawlBall,Backyard Bowl,0,4,0,4,474
9549,2023-01-09,EL PRIMO,bounty,Layer Cake,0,4,0,4,1512
9550,2023-01-08,EL PRIMO,knockout,X Marks the Spot,0,4,0,4,1692
9551,2023-01-08,EL PRIMO,hotZone,Ring of Fire,0,3,0,3,1644
9552,2023-01-08,EL PRIMO,heist,Snaked Assault,0,18,24,42,1494
9553,2023-01-08,EL PRIMO,gemGrab,Hard Rock Mine,0,5,0,5,630
9554,2023-01-08,EL PRIMO,gemGrab,Double Swoosh,0,3,1,4,864
9555,2023-01-08,EL PRIMO,brawlBall,Super Beach,1,6,2,9,732
9556,2023-01-08,EL PRIMO,brawlBall,Backyard Bowl,1,39,8,48,4830
9557,2023-01-07,EL PRIMO,knockout,X Marks the Spot,0,1,0,1,1014
9558,2023-01-07,EL PRIMO,hotZone,Ring of Fire,0,2,2,4,846
9559,2023-01-07,EL PRIMO,heist,Tornado Ring,0,23,2,25,1350
9560,2023-01-07,EL PRIMO,gemGrab,Hard Rock Mine,0,4,10,14,1158
9561,2023-01-07,EL PRIMO,gemGrab,Deep Diner,0,6,7,13,918
9562,2023-01-07,EL PRIMO,brawlBall,Super Beach,0,32,30,62,2622
9563,2023-01-07,EL PRIMO,brawlBall,Sneaky Fields,0,7,0,7,402
9564,2023-01-07,EL PRIMO,bounty,Dry Season,0,1,0,1,1320
9565,2023-01-06,EL PRIMO,hotZone,Split,0,12,1,13,1158
9566,2023-01-06,EL PRIMO,heist,Tornado Ring,0,16,6,22,2538
9567,2023-01-06,EL PRIMO,gemGrab,Undermine,0,2,0,2,540
9568,2023-01-06,EL PRIMO,gemGrab,Deep Diner,0,5,1,6,2226
9569,2023-01-06,EL PRIMO,brawlBall,Sneaky Fields,1,96,59,156,4896
9570,2023-01-06,EL PRIMO,brawlBall,Pinhole Punt,0,5,1,6,510
9571,2023-01-06,EL PRIMO,bounty,Dry Season,0,1,0,1,1944
9572,2023-01-05,EL PRIMO,knockout,Out in the Open,0,1,0,1,2958
9573,2023-01-05,EL PRIMO,hotZone,Split,0,22,6,28,3552
9574,2023-01-05,EL PRIMO,heist,Kaboom Canyon,0,4,2,6,954
9575,2023-01-05,EL PRIMO,gemGrab,Undermine,0,5,1,6,1812
9576,2023-01-05,EL PRIMO,gemGrab,Gem Fort,0,1,0,1,252
9577,2023-01-05,EL PRIMO,brawlBall,Sunny Soccer,0,2,0,2,84
9578,2023-01-05,EL PRIMO,brawlBall,Pinhole Punt,2,67,26,95,8118
9579,2023-01-04,EL PRIMO,knockout,Goldarm Gulch,0,2,0,2,696
9580,2023-01-04,EL PRIMO,hotZone,Parallel Plays,0,4,0,4,864
9581,2023-01-04,EL PRIMO,heist,Kaboom Canyon,0,8,1,9,1848
9582,2023-01-04,EL PRIMO,gemGrab,Gem Fort,0,7,5,12,1788
9583,2023-01-04,EL PRIMO,brawlBall,Sunny Soccer,3,81,65,149,6312
9584,2023-01-04,EL PRIMO,bounty,Shooting Star,0,1,0,1,3570
9585,2023-01-03,EL PRIMO,knockout,Goldarm Gulch,0,0,1,1,720
9586,2023-01-03,EL PRIMO,hotZone,Parallel Plays,0,8,0,8,1542
9587,2023-01-03,EL PRIMO,heist,Pit Stop,0,54,71,125,1956
9588,2023-01-03,EL PRIMO,gemGrab,Minecart Madness,0,2,0,2,456
9589,2023-01-03,EL PRIMO,gemGrab,Crystal Arcade,0,3,0,3,2406
9590,2023-01-03,EL PRIMO,brawlBall,Center Stage,0,2,2,4,294
9591,2023-01-03,EL PRIMO,brawlBall,Beach Ball,0,73,35,108,5580
9592,2023-01-03,EL PRIMO,bounty,Hideout,0,2,0,2,1638
9593,2023-01-02,EL PRIMO,knockout,Belle's Rock,0,2,0,2,1794
9594,2023-01-02,EL PRIMO,hotZone,Quarter Pounder,0,9,2,11,2652
9595,2023-01-02,EL PRIMO,hotZone,Controller Chaos,0,2,1,3,18
9596,2023-01-02,EL PRIMO,heist,Pit Stop,1,85,178,264,3498
9597,2023-01-02,EL PRIMO,heist,Kaboom Canyon,0,1,0,1,30
9598,2023-01-02,EL PRIMO,gemGrab,Minecart Madness,0,2,3,5,2352
9599,2023-01-02,EL PRIMO,gemGrab,Double Swoosh,0,5,1,6,1512
9600,2023-01-02,EL PRIMO,brawlBall,Center Stage,1,117,83,201,7110
9601,2023-01-02,EL PRIMO,brawlBall,Backyard Bowl,0,4,0,4,492
9602,2023-01-02,EL PRIMO,bounty,Hideout,0,3,1,4,3090
9603,2023-01-01,EL PRIMO,hotZone,Quarter Pounder,0,2,0,2,1188
9604,2023-01-01,EL PRIMO,heist,Bridge Too Far,0,1,0,1,462
9605,2023-01-01,EL PRIMO,gemGrab,Double Swoosh,0,5,0,5,1140
9606,2023-01-01,EL PRIMO,brawlBall,Backyard Bowl,0,17,4,21,2658
9607,2022-12-31,EL PRIMO,knockout,Flaring Phoenix,0,0,1,1,18
9608,2022-12-31,EL PRIMO,hotZone,Controller Chaos,0,3,1,4,198
9609,2022-12-31,EL PRIMO,heist,Bridge Too Far,0,1,0,1,276
9610,2022-12-31,EL PRIMO,gemGrab,Minecart Madness,0,1,1,2,24
9611,2022-12-31,EL PRIMO,gemGrab,Hard Rock Mine,0,2,1,3,384
9612,2022-12-31,EL PRIMO,gemGrab,Deep Diner,0,1,2,3,306
9613,2022-12-31,EL PRIMO,brawlBall,Super Beach,0,11,15,26,618
9614,2022-12-31,EL PRIMO,brawlBall,Sneaky Fields,0,2,3,5,60
9615,2022-12-30,EL PRIMO,knockout,Flaring Phoenix,0,0,1,1,72
9616,2022-12-30,EL PRIMO,hotZone,Controller Chaos,0,1,0,1,288
9617,2022-12-30,EL PRIMO,gemGrab,Deep Diner,0,2,1,3,438
9618,2022-12-30,EL PRIMO,brawlBall,Sneaky Fields,0,8,8,16,552
9619,2022-12-29,EL PRIMO,heist,Hot Potato,0,1,3,4,72
9620,2022-12-29,EL PRIMO,brawlBall,Pinhole Punt,0,1,1,2,282
9621,2022-12-28,EL PRIMO,brawlBall,Sunny Soccer,0,1,0,1,42
9622,2022-12-27,EL PRIMO,knockout,New Perspective,0,1,0,1,30
9623,2022-12-27,EL PRIMO,brawlBall,Center Stage,0,1,0,1,30
9624,2022-12-26,EL PRIMO,heist,Kaboom Canyon,0,2,0,2,36
9625,2022-12-26,EL PRIMO,brawlBall,Center Stage,0,1,0,1,78
9626,2022-12-23,EL PRIMO,brawlBall,Sneaky Fields,0,0,1,1,12
9627,2022-12-22,EL PRIMO,brawlBall,Pinhole Punt,0,2,0,2,132
9628,2022-12-21,EL PRIMO,brawlBall,Sunny Soccer,0,1,0,1,54
9629,2022-12-20,EL PRIMO,brawlBall,Beach Ball,0,2,1,3,96
9630,2022-12-19,EL PRIMO,brawlBall,Center Stage,0,0,1,1,102
9631,2022-12-16,EL PRIMO,brawlBall,Sneaky Fields,0,0,2,2,84
9632,2022-12-13,EL PRIMO,gemGrab,Crystal Arcade,0,1,0,1,72
9633,2022-12-13,EL PRIMO,brawlBall,Beach Ball,0,1,0,1,54
9634,2022-12-11,EL PRIMO,brawlBall,Backyard Bowl,0,0,1,1,24
9635,2022-11-11,EL PRIMO,brawlBall,Sneaky Fields,0,1,1,2,42
9636,2022-10-30,EL PRIMO,hotZone,Dueling Beetles,0,1,0,1,12
9637,2022-10-30,EL PRIMO,heist,Safe Zone,0,1,0,1,6
9638,2022-10-30,EL PRIMO,bounty,Canal Grande,0,1,0,1,12
9639,2022-10-26,EL PRIMO,brawlBall,Sunny Soccer,0,1,2,3,18
9640,2023-01-28,EDGAR,knockout,Flaring Phoenix,0,118,70,188,12366
9641,2023-01-28,EDGAR,hotZone,Controller Chaos,0,46,28,74,10134
9642,2023-01-28,EDGAR,heist,Bridge Too Far,0,54,11,65,24240
9643,2023-01-28,EDGAR,gemGrab,Hard Rock Mine,0,56,27,83,16638
9644,2023-01-28,EDGAR,gemGrab,Deep Diner,0,23,26,49,5478
9645,2023-01-28,EDGAR,brawlBall,Super Beach,7,356,256,619,74430
9646,2023-01-28,EDGAR,brawlBall,Sneaky Fields,0,27,12,39,3582
9647,2023-01-28,EDGAR,bounty,Canal Grande,0,80,73,153,10902
9648,2023-01-27,EDGAR,knockout,Flaring Phoenix,0,46,24,70,5928
9649,2023-01-27,EDGAR,hotZone,Controller Chaos,0,7,4,11,2676
9650,2023-01-27,EDGAR,heist,Hot Potato,0,38,51,89,3486
9651,2023-01-27,EDGAR,gemGrab,Undermine,0,4,3,7,942
9652,2023-01-27,EDGAR,gemGrab,Deep Diner,0,30,14,44,6846
9653,2023-01-27,EDGAR,brawlBall,Sneaky Fields,5,129,111,245,23514
9654,2023-01-27,EDGAR,brawlBall,Pinhole Punt,0,3,1,4,738
9655,2023-01-27,EDGAR,bounty,Temple Ruins,0,6,4,10,1890
9656,2023-01-26,EDGAR,knockout,Riverside,1,65,20,86,19008
9657,2023-01-26,EDGAR,hotZone,Open Zone,0,13,7,20,10182
9658,2023-01-26,EDGAR,heist,Hot Potato,0,187,161,348,14610
9659,2023-01-26,EDGAR,gemGrab,Undermine,0,37,23,60,10062
9660,2023-01-26,EDGAR,gemGrab,Gem Fort,0,29,15,44,4674
9661,2023-01-26,EDGAR,brawlBall,Sunny Soccer,0,31,38,69,3660
9662,2023-01-26,EDGAR,brawlBall,Pinhole Punt,2,249,170,421,67338
9663,2023-01-26,EDGAR,bounty,Temple Ruins,0,38,26,64,5610
9664,2023-01-25,EDGAR,knockout,Riverside,0,31,20,51,9906
9665,2023-01-25,EDGAR,hotZone,Open Zone,0,3,1,4,5262
9666,2023-01-25,EDGAR,heist,Safe Zone,0,33,19,52,9156
9667,2023-01-25,EDGAR,gemGrab,Gem Fort,0,27,15,42,5556
9668,2023-01-25,EDGAR,gemGrab,Crystal Arcade,0,21,19,40,7866
9669,2023-01-25,EDGAR,brawlBall,Sunny Soccer,2,194,150,346,40830
9670,2023-01-25,EDGAR,brawlBall,Beach Ball,2,33,16,51,6408
9671,2023-01-25,EDGAR,bounty,Excel,0,46,30,76,5790
9672,2023-01-24,EDGAR,knockout,New Perspective,1,104,58,163,10542
9673,2023-01-24,EDGAR,hotZone,Dueling Beetles,0,32,13,45,10662
9674,2023-01-24,EDGAR,heist,Safe Zone,0,53,18,71,15750
9675,2023-01-24,EDGAR,gemGrab,Minecart Madness,0,7,5,12,4002
9676,2023-01-24,EDGAR,gemGrab,Crystal Arcade,0,59,48,107,14460
9677,2023-01-24,EDGAR,brawlBall,Center Stage,1,46,40,87,7860
9678,2023-01-24,EDGAR,brawlBall,Beach Ball,8,336,203,547,64614
9679,2023-01-24,EDGAR,bounty,Excel,0,52,26,78,10896
9680,2023-01-23,EDGAR,knockout,New Perspective,0,121,63,184,20676
9681,2023-01-23,EDGAR,hotZone,Dueling Beetles,0,36,12,48,17502
9682,2023-01-23,EDGAR,heist,Snaked Assault,2,175,109,286,15762
9683,2023-01-23,EDGAR,gemGrab,Minecart Madness,0,74,32,106,19062
9684,2023-01-23,EDGAR,gemGrab,Double Swoosh,0,30,12,42,7578
9685,2023-01-23,EDGAR,brawlBall,Center Stage,8,453,361,822,92862
9686,2023-01-23,EDGAR,brawlBall,Backyard Bowl,0,13,3,16,4224
9687,2023-01-23,EDGAR,bounty,Layer Cake,0,82,32,114,11142
9688,2023-01-22,EDGAR,knockout,X Marks the Spot,0,47,25,72,9174
9689,2023-01-22,EDGAR,hotZone,Ring of Fire,0,12,4,16,5730
9690,2023-01-22,EDGAR,heist,Snaked Assault,0,87,57,144,8232
9691,2023-01-22,EDGAR,gemGrab,Hard Rock Mine,0,26,15,41,4722
9692,2023-01-22,EDGAR,gemGrab,Double Swoosh,0,36,16,52,9426
9693,2023-01-22,EDGAR,brawlBall,Super Beach,0,35,12,47,7386
9694,2023-01-22,EDGAR,brawlBall,Backyard Bowl,1,96,46,143,34788
9695,2023-01-22,EDGAR,bounty,Layer Cake,0,32,14,46,6654
9696,2023-01-21,EDGAR,knockout,X Marks the Spot,0,154,65,219,31698
9697,2023-01-21,EDGAR,hotZone,Ring of Fire,0,19,7,26,16632
9698,2023-01-21,EDGAR,heist,Tornado Ring,0,133,89,222,11664
9699,2023-01-21,EDGAR,gemGrab,Hard Rock Mine,0,92,47,139,22980
9700,2023-01-21,EDGAR,gemGrab,Deep Diner,0,14,8,22,4470
9701,2023-01-21,EDGAR,brawlBall,Super Beach,11,470,303,784,101364
9702,2023-01-21,EDGAR,brawlBall,Sneaky Fields,0,29,19,48,3750
9703,2023-01-21,EDGAR,bounty,Dry Season,0,33,23,56,14538
9704,2023-01-20,EDGAR,knockout,Out in the Open,0,74,44,118,20106
9705,2023-01-20,EDGAR,hotZone,Split,0,117,97,214,9678
9706,2023-01-20,EDGAR,heist,Tornado Ring,2,136,102,240,12672
9707,2023-01-20,EDGAR,gemGrab,Undermine,0,14,19,33,5442
9708,2023-01-20,EDGAR,gemGrab,Deep Diner,0,69,50,119,19050
9709,2023-01-20,EDGAR,brawlBall,Sneaky Fields,3,440,328,771,74778
9710,2023-01-20,EDGAR,brawlBall,Pinhole Punt,1,24,6,31,2886
9711,2023-01-20,EDGAR,bounty,Dry Season,0,25,14,39,11640
9712,2023-01-19,EDGAR,knockout,Out in the Open,1,122,61,184,26574
9713,2023-01-19,EDGAR,hotZone,Split,0,161,121,282,14856
9714,2023-01-19,EDGAR,heist,Kaboom Canyon,0,59,32,91,6732
9715,2023-01-19,EDGAR,gemGrab,Undermine,0,56,23,79,14154
9716,2023-01-19,EDGAR,gemGrab,Gem Fort,0,12,10,22,2934
9717,2023-01-19,EDGAR,brawlBall,Sunny Soccer,0,7,5,12,2274
9718,2023-01-19,EDGAR,brawlBall,Pinhole Punt,6,260,144,410,72498
9719,2023-01-19,EDGAR,bounty,Shooting Star,0,15,9,24,11124
9720,2023-01-18,EDGAR,knockout,Goldarm Gulch,0,24,8,32,2784
9721,2023-01-18,EDGAR,hotZone,Parallel Plays,0,11,3,14,1158
9722,2023-01-18,EDGAR,heist,Kaboom Canyon,0,18,11,29,2592
9723,2023-01-18,EDGAR,gemGrab,Gem Fort,0,18,13,31,3006
9724,2023-01-18,EDGAR,gemGrab,Crystal Arcade,0,3,2,5,990
9725,2023-01-18,EDGAR,brawlBall,Sunny Soccer,3,101,75,179,18941
9726,2023-01-18,EDGAR,brawlBall,Beach Ball,0,5,3,8,774
9727,2023-01-18,EDGAR,bounty,Shooting Star,0,7,1,8,5088
9728,2023-01-17,EDGAR,knockout,Goldarm Gulch,0,29,15,44,2520
9729,2023-01-17,EDGAR,hotZone,Parallel Plays,0,7,0,7,1038
9730,2023-01-17,EDGAR,heist,Pit Stop,0,52,58,110,1290
9731,2023-01-17,EDGAR,gemGrab,Minecart Madness,0,1,1,2,216
9732,2023-01-17,EDGAR,gemGrab,Crystal Arcade,0,1,1,2,1266
9733,2023-01-17,EDGAR,brawlBall,Center Stage,0,4,0,4,288
9734,2023-01-17,EDGAR,brawlBall,Beach Ball,1,48,17,66,5886
9735,2023-01-17,EDGAR,bounty,Hideout,0,1,1,2,750
9736,2023-01-16,EDGAR,knockout,Belle's Rock,0,12,6,18,1788
9737,2023-01-16,EDGAR,hotZone,Quarter Pounder,0,5,1,6,1494
9738,2023-01-16,EDGAR,heist,Pit Stop,0,121,132,253,4044
9739,2023-01-16,EDGAR,gemGrab,Minecart Madness,0,10,1,11,1422
9740,2023-01-16,EDGAR,gemGrab,Double Swoosh,0,1,0,1,708
9741,2023-01-16,EDGAR,brawlBall,Center Stage,0,27,23,50,5778
9742,2023-01-16,EDGAR,brawlBall,Backyard Bowl,0,3,1,4,852
9743,2023-01-16,EDGAR,bounty,Hideout,0,3,0,3,1470
9744,2023-01-15,EDGAR,knockout,Belle's Rock,0,25,16,41,2904
9745,2023-01-15,EDGAR,hotZone,Quarter Pounder,0,16,2,18,3318
9746,2023-01-15,EDGAR,heist,Bridge Too Far,0,4,1,5,2736
9747,2023-01-15,EDGAR,gemGrab,Hard Rock Mine,0,1,0,1,1014
9748,2023-01-15,EDGAR,gemGrab,Double Swoosh,0,2,2,4,2178
9749,2023-01-15,EDGAR,brawlBall,Super Beach,0,1,0,1,1074
9750,2023-01-15,EDGAR,brawlBall,Backyard Bowl,0,12,10,22,8946
9751,2023-01-15,EDGAR,bounty,Canal Grande,0,2,1,3,960
9752,2023-01-14,EDGAR,knockout,Flaring Phoenix,0,10,9,19,1080
9753,2023-01-14,EDGAR,hotZone,Controller Chaos,0,15,0,15,2772
9754,2023-01-14,EDGAR,heist,Bridge Too Far,0,3,1,4,4020
9755,2023-01-14,EDGAR,gemGrab,Hard Rock Mine,0,5,0,5,1272
9756,2023-01-14,EDGAR,gemGrab,Deep Diner,0,2,0,2,858
9757,2023-01-14,EDGAR,brawlBall,Super Beach,1,25,26,52,6336
9758,2023-01-14,EDGAR,brawlBall,Sneaky Fields,0,1,0,1,918
9759,2023-01-14,EDGAR,bounty,Canal Grande,0,3,0,3,1014
9760,2023-01-13,EDGAR,knockout,Flaring Phoenix,0,8,9,17,1182
9761,2023-01-13,EDGAR,hotZone,Controller Chaos,0,9,0,9,2928
9762,2023-01-13,EDGAR,heist,Hot Potato,0,8,8,16,600
9763,2023-01-13,EDGAR,gemGrab,Deep Diner,0,3,1,4,1650
9764,2023-01-13,EDGAR,brawlBall,Sneaky Fields,0,25,36,61,6144
9765,2023-01-13,EDGAR,bounty,Temple Ruins,0,2,0,2,270
9766,2023-01-12,EDGAR,knockout,Riverside,0,8,0,8,2532
9767,2023-01-12,EDGAR,hotZone,Open Zone,0,2,1,3,1488
9768,2023-01-12,EDGAR,heist,Hot Potato,0,3,2,5,330
9769,2023-01-12,EDGAR,brawlBall,Pinhole Punt,0,6,2,8,2292
9770,2023-01-11,EDGAR,hotZone,Open Zone,0,1,0,1,462
9771,2023-01-11,EDGAR,heist,Safe Zone,0,0,1,1,48
9772,2023-01-11,EDGAR,gemGrab,Gem Fort,0,2,0,2,414
9773,2023-01-11,EDGAR,brawlBall,Sunny Soccer,0,7,3,10,1638
9774,2023-01-11,EDGAR,bounty,Excel,0,3,6,9,282
9775,2023-01-10,EDGAR,knockout,New Perspective,0,5,3,8,720
9776,2023-01-10,EDGAR,hotZone,Dueling Beetles,0,6,1,7,2424
9777,2023-01-10,EDGAR,heist,Safe Zone,0,1,0,1,1176
9778,2023-01-10,EDGAR,gemGrab,Minecart Madness,0,3,0,3,828
9779,2023-01-10,EDGAR,gemGrab,Crystal Arcade,0,4,0,4,1746
9780,2023-01-10,EDGAR,brawlBall,Center Stage,0,1,0,1,708
9781,2023-01-10,EDGAR,brawlBall,Beach Ball,0,8,4,12,4392
9782,2023-01-10,EDGAR,bounty,Excel,0,0,1,1,330
9783,2023-01-09,EDGAR,knockout,New Perspective,0,6,3,9,876
9784,2023-01-09,EDGAR,hotZone,Dueling Beetles,0,4,0,4,1554
9785,2023-01-09,EDGAR,heist,Snaked Assault,0,34,4,38,2022
9786,2023-01-09,EDGAR,gemGrab,Minecart Madness,0,6,1,7,1884
9787,2023-01-09,EDGAR,gemGrab,Double Swoosh,0,3,0,3,1320
9788,2023-01-09,EDGAR,brawlBall,Center Stage,1,27,36,64,5460
9789,2023-01-09,EDGAR,brawlBall,Backyard Bowl,0,2,0,2,474
9790,2023-01-09,EDGAR,bounty,Layer Cake,0,10,1,11,1512
9791,2023-01-08,EDGAR,knockout,X Marks the Spot,0,6,0,6,1692
9792,2023-01-08,EDGAR,hotZone,Ring of Fire,0,1,0,1,1644
9793,2023-01-08,EDGAR,heist,Snaked Assault,0,12,23,35,1494
9794,2023-01-08,EDGAR,gemGrab,Hard Rock Mine,0,1,0,1,630
9795,2023-01-08,EDGAR,gemGrab,Double Swoosh,0,3,1,4,864
9796,2023-01-08,EDGAR,brawlBall,Super Beach,0,0,1,1,732
9797,2023-01-08,EDGAR,brawlBall,Backyard Bowl,0,4,1,5,4830
9798,2023-01-08,EDGAR,bounty,Layer Cake,0,2,1,3,528
9799,2023-01-07,EDGAR,knockout,X Marks the Spot,0,0,1,1,1014
9800,2023-01-07,EDGAR,hotZone,Ring of Fire,0,1,0,1,846
9801,2023-01-07,EDGAR,heist,Tornado Ring,0,14,4,18,1350
9802,2023-01-07,EDGAR,gemGrab,Hard Rock Mine,0,5,2,7,1158
9803,2023-01-07,EDGAR,gemGrab,Deep Diner,0,1,1,2,918
9804,2023-01-07,EDGAR,brawlBall,Super Beach,0,4,3,7,2622
9805,2023-01-07,EDGAR,brawlBall,Sneaky Fields,0,1,0,1,402
9806,2023-01-06,EDGAR,knockout,Out in the Open,0,4,2,6,1446
9807,2023-01-06,EDGAR,hotZone,Split,0,6,1,7,1158
9808,2023-01-06,EDGAR,heist,Tornado Ring,1,15,13,29,2538
9809,2023-01-06,EDGAR,gemGrab,Deep Diner,0,5,1,6,2226
9810,2023-01-06,EDGAR,brawlBall,Sneaky Fields,0,19,13,32,4896
9811,2023-01-06,EDGAR,brawlBall,Pinhole Punt,0,2,1,3,510
9812,2023-01-06,EDGAR,bounty,Dry Season,0,1,0,1,1944
9813,2023-01-05,EDGAR,knockout,Out in the Open,0,5,1,6,2958
9814,2023-01-05,EDGAR,hotZone,Split,0,16,16,32,3552
9815,2023-01-05,EDGAR,heist,Kaboom Canyon,0,9,0,9,954
9816,2023-01-05,EDGAR,gemGrab,Undermine,0,3,1,4,1812
9817,2023-01-05,EDGAR,gemGrab,Gem Fort,0,1,1,2,252
9818,2023-01-05,EDGAR,brawlBall,Pinhole Punt,0,14,5,19,8118
9819,2023-01-05,EDGAR,bounty,Shooting Star,0,1,0,1,1362
9820,2023-01-04,EDGAR,knockout,Goldarm Gulch,0,1,1,2,696
9821,2023-01-04,EDGAR,hotZone,Parallel Plays,0,3,3,6,864
9822,2023-01-04,EDGAR,heist,Kaboom Canyon,0,12,0,12,1848
9823,2023-01-04,EDGAR,gemGrab,Gem Fort,0,9,20,29,1788
9824,2023-01-04,EDGAR,gemGrab,Crystal Arcade,0,0,2,2,642
9825,2023-01-04,EDGAR,brawlBall,Sunny Soccer,0,10,2,12,6312
9826,2023-01-04,EDGAR,bounty,Shooting Star,0,2,1,3,3570
9827,2023-01-03,EDGAR,knockout,Goldarm Gulch,0,7,0,7,720
9828,2023-01-03,EDGAR,hotZone,Parallel Plays,0,3,1,4,1542
9829,2023-01-03,EDGAR,heist,Pit Stop,1,41,33,75,1956
9830,2023-01-03,EDGAR,heist,Kaboom Canyon,0,1,0,1,12
9831,2023-01-03,EDGAR,gemGrab,Minecart Madness,0,2,0,2,456
9832,2023-01-03,EDGAR,gemGrab,Crystal Arcade,0,4,0,4,2406
9833,2023-01-03,EDGAR,brawlBall,Center Stage,0,1,0,1,294
9834,2023-01-03,EDGAR,brawlBall,Beach Ball,0,9,3,12,5580
9835,2023-01-03,EDGAR,bounty,Hideout,0,2,0,2,1638
9836,2023-01-02,EDGAR,knockout,Belle's Rock,0,10,2,12,1794
9837,2023-01-02,EDGAR,hotZone,Quarter Pounder,0,12,0,12,2652
9838,2023-01-02,EDGAR,heist,Pit Stop,0,96,145,241,3498
9839,2023-01-02,EDGAR,gemGrab,Minecart Madness,0,4,2,6,2352
9840,2023-01-02,EDGAR,brawlBall,Center Stage,0,24,17,41,7110
9841,2023-01-02,EDGAR,bounty,Hideout,0,3,1,4,3090
9842,2023-01-01,EDGAR,knockout,Belle's Rock,0,11,8,19,858
9843,2023-01-01,EDGAR,hotZone,Quarter Pounder,0,2,0,2,1188
9844,2023-01-01,EDGAR,heist,Kaboom Canyon,0,1,0,1,12
9845,2023-01-01,EDGAR,gemGrab,Double Swoosh,0,3,1,4,1140
9846,2023-01-01,EDGAR,brawlBall,Backyard Bowl,0,5,2,7,2658
9847,2022-12-31,EDGAR,hotZone,Controller Chaos,0,0,2,2,198
9848,2022-12-31,EDGAR,heist,Kaboom Canyon,0,1,0,1,12
9849,2022-12-31,EDGAR,gemGrab,Hard Rock Mine,0,0,1,1,384
9850,2022-12-31,EDGAR,gemGrab,Deep Diner,0,1,0,1,306
9851,2022-12-31,EDGAR,brawlBall,Super Beach,0,1,0,1,618
9852,2022-12-30,EDGAR,hotZone,Controller Chaos,0,0,1,1,288
9853,2022-12-30,EDGAR,brawlBall,Sneaky Fields,0,1,0,1,552
9854,2022-12-29,EDGAR,heist,Kaboom Canyon,0,0,1,1,18
9855,2022-12-29,EDGAR,gemGrab,Minecart Madness,0,1,0,1,24
9856,2022-12-29,EDGAR,brawlBall,Pinhole Punt,0,1,0,1,282
9857,2022-12-27,EDGAR,hotZone,Dueling Beetles,0,0,1,1,36
9858,2022-12-27,EDGAR,brawlBall,Beach Ball,0,1,1,2,144
9859,2022-12-26,EDGAR,hotZone,Controller Chaos,0,0,1,1,30
9860,2022-12-26,EDGAR,heist,Kaboom Canyon,0,2,1,3,36
9861,2022-12-26,EDGAR,gemGrab,Minecart Madness,0,0,1,1,60
9862,2022-12-25,EDGAR,hotZone,Ring of Fire,0,0,1,1,12
9863,2022-12-24,EDGAR,brawlBall,Super Beach,0,0,1,1,48
9864,2022-12-23,EDGAR,knockout,Out in the Open,0,1,1,2,132
9865,2022-12-19,EDGAR,brawlBall,Center Stage,0,1,0,1,102
9866,2022-12-13,EDGAR,heist,Safe Zone,0,1,1,2,42
9867,2022-12-10,EDGAR,gemGrab,Hard Rock Mine,0,0,1,1,24
9868,2022-11-11,EDGAR,brawlBall,Sneaky Fields,0,1,0,1,42
9869,2022-11-03,EDGAR,bounty,Temple Ruins,0,0,1,1,6
9870,2023-01-28,DYNAMIKE,knockout,Flaring Phoenix,0,121,81,202,12366
9871,2023-01-28,DYNAMIKE,hotZone,Controller Chaos,0,298,244,542,10134
9872,2023-01-28,DYNAMIKE,heist,Bridge Too Far,0,50,14,64,24240
9873,2023-01-28,DYNAMIKE,gemGrab,Hard Rock Mine,0,79,46,125,16638
9874,2023-01-28,DYNAMIKE,gemGrab,Deep Diner,0,83,86,169,5478
9875,2023-01-28,DYNAMIKE,brawlBall,Super Beach,42,1982,1858,3882,74430
9876,2023-01-28,DYNAMIKE,brawlBall,Sneaky Fields,0,31,21,52,3582
9877,2023-01-28,DYNAMIKE,bounty,Canal Grande,0,144,60,204,10902
9878,2023-01-27,DYNAMIKE,knockout,Flaring Phoenix,0,53,27,80,5928
9879,2023-01-27,DYNAMIKE,hotZone,Controller Chaos,0,51,52,103,2676
9880,2023-01-27,DYNAMIKE,heist,Hot Potato,0,130,98,228,3486
9881,2023-01-27,DYNAMIKE,gemGrab,Undermine,0,8,6,14,942
9882,2023-01-27,DYNAMIKE,gemGrab,Deep Diner,0,109,95,204,6846
9883,2023-01-27,DYNAMIKE,brawlBall,Sneaky Fields,0,247,161,408,23514
9884,2023-01-27,DYNAMIKE,brawlBall,Pinhole Punt,0,5,2,7,738
9885,2023-01-27,DYNAMIKE,bounty,Temple Ruins,0,10,1,11,1890
9886,2023-01-26,DYNAMIKE,knockout,Riverside,0,44,31,75,19008
9887,2023-01-26,DYNAMIKE,hotZone,Open Zone,0,39,14,53,10182
9888,2023-01-26,DYNAMIKE,heist,Hot Potato,2,664,760,1426,14610
9889,2023-01-26,DYNAMIKE,gemGrab,Undermine,0,85,41,126,10062
9890,2023-01-26,DYNAMIKE,gemGrab,Gem Fort,0,22,13,35,4674
9891,2023-01-26,DYNAMIKE,brawlBall,Sunny Soccer,0,86,83,169,3660
9892,2023-01-26,DYNAMIKE,brawlBall,Pinhole Punt,16,535,301,852,67338
9893,2023-01-26,DYNAMIKE,bounty,Temple Ruins,0,22,12,34,5610
9894,2023-01-25,DYNAMIKE,knockout,Riverside,0,22,5,27,9906
9895,2023-01-25,DYNAMIKE,hotZone,Open Zone,0,10,0,10,5262
9896,2023-01-25,DYNAMIKE,heist,Safe Zone,0,55,26,81,9156
9897,2023-01-25,DYNAMIKE,gemGrab,Gem Fort,0,35,17,52,5556
9898,2023-01-25,DYNAMIKE,gemGrab,Crystal Arcade,0,69,23,92,7866
9899,2023-01-25,DYNAMIKE,brawlBall,Sunny Soccer,33,1163,1141,2337,40830
9900,2023-01-25,DYNAMIKE,brawlBall,Beach Ball,6,159,114,279,6408
9901,2023-01-25,DYNAMIKE,bounty,Excel,0,87,27,114,5790
9902,2023-01-24,DYNAMIKE,knockout,New Perspective,0,107,82,189,10542
9903,2023-01-24,DYNAMIKE,hotZone,Dueling Beetles,0,134,56,190,10662
9904,2023-01-24,DYNAMIKE,heist,Safe Zone,0,67,25,92,15750
9905,2023-01-24,DYNAMIKE,gemGrab,Minecart Madness,0,33,22,55,4002
9906,2023-01-24,DYNAMIKE,gemGrab,Crystal Arcade,0,107,70,177,14460
9907,2023-01-24,DYNAMIKE,brawlBall,Center Stage,2,60,32,94,7860
9908,2023-01-24,DYNAMIKE,brawlBall,Beach Ball,49,1618,1422,3089,64614
9909,2023-01-24,DYNAMIKE,bounty,Excel,0,117,76,193,10896
9910,2023-01-23,DYNAMIKE,knockout,New Perspective,0,183,101,284,20676
9911,2023-01-23,DYNAMIKE,hotZone,Dueling Beetles,1,199,77,277,17502
9912,2023-01-23,DYNAMIKE,heist,Snaked Assault,2,239,99,340,15762
9913,2023-01-23,DYNAMIKE,gemGrab,Minecart Madness,0,158,97,255,19062
9914,2023-01-23,DYNAMIKE,gemGrab,Double Swoosh,0,40,12,52,7578
9915,2023-01-23,DYNAMIKE,brawlBall,Center Stage,13,719,434,1166,92862
9916,2023-01-23,DYNAMIKE,brawlBall,Backyard Bowl,1,26,5,32,4224
9917,2023-01-23,DYNAMIKE,bounty,Layer Cake,0,177,130,307,11142
9918,2023-01-22,DYNAMIKE,knockout,X Marks the Spot,0,62,31,93,9174
9919,2023-01-22,DYNAMIKE,hotZone,Ring of Fire,0,29,7,36,5730
9920,2023-01-22,DYNAMIKE,heist,Snaked Assault,1,91,48,140,8232
9921,2023-01-22,DYNAMIKE,gemGrab,Hard Rock Mine,0,26,10,36,4722
9922,2023-01-22,DYNAMIKE,gemGrab,Double Swoosh,0,42,48,90,9426
9923,2023-01-22,DYNAMIKE,brawlBall,Super Beach,11,221,267,499,7386
9924,2023-01-22,DYNAMIKE,brawlBall,Backyard Bowl,0,184,68,252,34788
9925,2023-01-22,DYNAMIKE,bounty,Layer Cake,0,78,25,103,6654
9926,2023-01-21,DYNAMIKE,knockout,X Marks the Spot,0,193,89,282,31698
9927,2023-01-21,DYNAMIKE,hotZone,Ring of Fire,0,76,16,92,16632
9928,2023-01-21,DYNAMIKE,heist,Tornado Ring,2,170,86,258,11664
9929,2023-01-21,DYNAMIKE,gemGrab,Hard Rock Mine,0,114,67,181,22980
9930,2023-01-21,DYNAMIKE,gemGrab,Deep Diner,0,80,48,128,4470
9931,2023-01-21,DYNAMIKE,brawlBall,Super Beach,69,2903,2883,5855,101364
9932,2023-01-21,DYNAMIKE,brawlBall,Sneaky Fields,2,32,21,55,3750
9933,2023-01-21,DYNAMIKE,bounty,Dry Season,0,56,15,71,14538
9934,2023-01-20,DYNAMIKE,knockout,Out in the Open,0,90,39,129,20106
9935,2023-01-20,DYNAMIKE,hotZone,Split,0,568,595,1163,9678
9936,2023-01-20,DYNAMIKE,heist,Tornado Ring,4,154,97,255,12672
9937,2023-01-20,DYNAMIKE,gemGrab,Undermine,0,35,11,46,5442
9938,2023-01-20,DYNAMIKE,gemGrab,Deep Diner,0,282,306,588,19050
9939,2023-01-20,DYNAMIKE,brawlBall,Sneaky Fields,14,772,531,1317,74778
9940,2023-01-20,DYNAMIKE,brawlBall,Pinhole Punt,0,28,8,36,2886
9941,2023-01-20,DYNAMIKE,bounty,Dry Season,0,39,23,62,11640
9942,2023-01-19,DYNAMIKE,knockout,Out in the Open,1,117,80,198,26574
9943,2023-01-19,DYNAMIKE,hotZone,Split,0,965,976,1941,14856
9944,2023-01-19,DYNAMIKE,heist,Kaboom Canyon,0,64,19,83,6732
9945,2023-01-19,DYNAMIKE,gemGrab,Undermine,0,99,60,159,14154
9946,2023-01-19,DYNAMIKE,gemGrab,Gem Fort,0,14,2,16,2934
9947,2023-01-19,DYNAMIKE,brawlBall,Sunny Soccer,1,75,66,142,2274
9948,2023-01-19,DYNAMIKE,brawlBall,Pinhole Punt,11,561,339,911,72498
9949,2023-01-19,DYNAMIKE,bounty,Shooting Star,0,37,17,54,11124
9950,2023-01-18,DYNAMIKE,knockout,Goldarm Gulch,0,19,11,30,2784
9951,2023-01-18,DYNAMIKE,hotZone,Parallel Plays,0,20,20,40,1158
9952,2023-01-18,DYNAMIKE,heist,Kaboom Canyon,0,18,9,27,2592
9953,2023-01-18,DYNAMIKE,gemGrab,Gem Fort,0,12,12,24,3006
9954,2023-01-18,DYNAMIKE,gemGrab,Crystal Arcade,0,9,10,19,990
9955,2023-01-18,DYNAMIKE,brawlBall,Sunny Soccer,10,551,428,989,18941
9956,2023-01-18,DYNAMIKE,brawlBall,Beach Ball,0,30,15,45,774
9957,2023-01-18,DYNAMIKE,bounty,Shooting Star,0,15,2,17,5088
9958,2023-01-17,DYNAMIKE,knockout,Goldarm Gulch,0,15,5,20,2520
9959,2023-01-17,DYNAMIKE,hotZone,Parallel Plays,0,7,9,16,1038
9960,2023-01-17,DYNAMIKE,heist,Pit Stop,0,67,51,118,1290
9961,2023-01-17,DYNAMIKE,gemGrab,Minecart Madness,0,1,0,1,216
9962,2023-01-17,DYNAMIKE,gemGrab,Crystal Arcade,0,4,5,9,1266
9963,2023-01-17,DYNAMIKE,brawlBall,Center Stage,0,1,1,2,288
9964,2023-01-17,DYNAMIKE,brawlBall,Beach Ball,5,152,154,311,5886
9965,2023-01-17,DYNAMIKE,bounty,Hideout,0,5,2,7,750
9966,2023-01-16,DYNAMIKE,knockout,Belle's Rock,0,25,12,37,1788
9967,2023-01-16,DYNAMIKE,hotZone,Quarter Pounder,0,34,35,69,1494
9968,2023-01-16,DYNAMIKE,heist,Pit Stop,0,176,102,278,4044
9969,2023-01-16,DYNAMIKE,gemGrab,Minecart Madness,0,15,6,21,1422
9970,2023-01-16,DYNAMIKE,gemGrab,Double Swoosh,0,4,1,5,708
9971,2023-01-16,DYNAMIKE,brawlBall,Center Stage,0,39,19,58,5778
9972,2023-01-16,DYNAMIKE,brawlBall,Backyard Bowl,0,9,10,19,852
9973,2023-01-16,DYNAMIKE,bounty,Hideout,0,14,8,22,1470
9974,2023-01-15,DYNAMIKE,knockout,Belle's Rock,0,25,13,38,2904
9975,2023-01-15,DYNAMIKE,hotZone,Quarter Pounder,0,60,58,118,3318
9976,2023-01-15,DYNAMIKE,heist,Bridge Too Far,0,5,2,7,2736
9977,2023-01-15,DYNAMIKE,gemGrab,Hard Rock Mine,0,3,0,3,1014
9978,2023-01-15,DYNAMIKE,gemGrab,Double Swoosh,0,4,1,5,2178
9979,2023-01-15,DYNAMIKE,brawlBall,Super Beach,3,34,40,77,1074
9980,2023-01-15,DYNAMIKE,brawlBall,Backyard Bowl,1,52,19,72,8946
9981,2023-01-15,DYNAMIKE,bounty,Canal Grande,0,9,2,11,960
9982,2023-01-14,DYNAMIKE,knockout,Flaring Phoenix,0,6,5,11,1080
9983,2023-01-14,DYNAMIKE,hotZone,Controller Chaos,0,66,23,89,2772
9984,2023-01-14,DYNAMIKE,heist,Bridge Too Far,0,7,0,7,4020
9985,2023-01-14,DYNAMIKE,gemGrab,Hard Rock Mine,0,7,0,7,1272
9986,2023-01-14,DYNAMIKE,gemGrab,Deep Diner,0,14,37,51,858
9987,2023-01-14,DYNAMIKE,brawlBall,Super Beach,7,207,187,401,6336
9988,2023-01-14,DYNAMIKE,brawlBall,Sneaky Fields,0,6,1,7,918
9989,2023-01-14,DYNAMIKE,bounty,Canal Grande,0,11,0,11,1014
9990,2023-01-13,DYNAMIKE,knockout,Flaring Phoenix,0,10,5,15,1182
9991,2023-01-13,DYNAMIKE,hotZone,Controller Chaos,0,63,39,102,2928
9992,2023-01-13,DYNAMIKE,heist,Hot Potato,0,31,32,63,600
9993,2023-01-13,DYNAMIKE,gemGrab,Deep Diner,0,27,39,66,1650
9994,2023-01-13,DYNAMIKE,brawlBall,Sneaky Fields,0,43,25,68,6144
9995,2023-01-13,DYNAMIKE,bounty,Temple Ruins,0,0,8,8,270
9996,2023-01-12,DYNAMIKE,knockout,Riverside,0,11,4,15,2532
9997,2023-01-12,DYNAMIKE,hotZone,Open Zone,0,6,0,6,1488
9998,2023-01-12,DYNAMIKE,heist,Hot Potato,0,22,34,56,330
9999,2023-01-12,DYNAMIKE,gemGrab,Undermine,0,4,1,5,690
10000,2023-01-12,DYNAMIKE,brawlBall,Sunny Soccer,0,5,1,6,240
10001,2023-01-12,DYNAMIKE,brawlBall,Pinhole Punt,0,11,3,14,2292
10002,2023-01-11,DYNAMIKE,hotZone,Open Zone,0,1,0,1,462
10003,2023-01-11,DYNAMIKE,gemGrab,Gem Fort,0,1,0,1,414
10004,2023-01-11,DYNAMIKE,brawlBall,Sunny Soccer,1,40,25,66,1638
10005,2023-01-11,DYNAMIKE,brawlBall,Beach Ball,0,1,0,1,48
10006,2023-01-11,DYNAMIKE,bounty,Excel,0,2,13,15,282
10007,2023-01-10,DYNAMIKE,knockout,New Perspective,0,13,3,16,720
10008,2023-01-10,DYNAMIKE,hotZone,Dueling Beetles,0,25,3,28,2424
10009,2023-01-10,DYNAMIKE,heist,Safe Zone,0,4,0,4,1176
10010,2023-01-10,DYNAMIKE,gemGrab,Minecart Madness,0,5,0,5,828
10011,2023-01-10,DYNAMIKE,gemGrab,Crystal Arcade,0,6,2,8,1746
10012,2023-01-10,DYNAMIKE,brawlBall,Center Stage,0,6,0,6,708
10013,2023-01-10,DYNAMIKE,brawlBall,Beach Ball,3,86,99,188,4392
10014,2023-01-10,DYNAMIKE,bounty,Excel,0,11,33,44,330
10015,2023-01-09,DYNAMIKE,knockout,New Perspective,0,5,1,6,876
10016,2023-01-09,DYNAMIKE,hotZone,Dueling Beetles,0,16,0,16,1554
10017,2023-01-09,DYNAMIKE,heist,Snaked Assault,0,24,1,25,2022
10018,2023-01-09,DYNAMIKE,gemGrab,Minecart Madness,0,20,14,34,1884
10019,2023-01-09,DYNAMIKE,gemGrab,Double Swoosh,0,8,0,8,1320
10020,2023-01-09,DYNAMIKE,brawlBall,Center Stage,1,23,6,30,5460
10021,2023-01-09,DYNAMIKE,brawlBall,Backyard Bowl,0,2,1,3,474
10022,2023-01-09,DYNAMIKE,bounty,Layer Cake,0,24,10,34,1512
10023,2023-01-08,DYNAMIKE,knockout,X Marks the Spot,0,17,4,21,1692
10024,2023-01-08,DYNAMIKE,hotZone,Ring of Fire,0,5,1,6,1644
10025,2023-01-08,DYNAMIKE,heist,Snaked Assault,0,18,3,21,1494
10026,2023-01-08,DYNAMIKE,gemGrab,Hard Rock Mine,0,2,0,2,630
10027,2023-01-08,DYNAMIKE,gemGrab,Double Swoosh,0,1,1,2,864
10028,2023-01-08,DYNAMIKE,brawlBall,Super Beach,2,32,30,64,732
10029,2023-01-08,DYNAMIKE,brawlBall,Backyard Bowl,0,17,3,20,4830
10030,2023-01-08,DYNAMIKE,bounty,Layer Cake,0,6,2,8,528
10031,2023-01-07,DYNAMIKE,knockout,X Marks the Spot,0,5,1,6,1014
10032,2023-01-07,DYNAMIKE,heist,Tornado Ring,1,16,29,46,1350
10033,2023-01-07,DYNAMIKE,gemGrab,Hard Rock Mine,0,1,2,3,1158
10034,2023-01-07,DYNAMIKE,gemGrab,Deep Diner,0,21,17,38,918
10035,2023-01-07,DYNAMIKE,brawlBall,Super Beach,1,64,57,122,2622
10036,2023-01-07,DYNAMIKE,brawlBall,Sneaky Fields,0,4,0,4,402
10037,2023-01-07,DYNAMIKE,bounty,Dry Season,0,4,0,4,1320
10038,2023-01-06,DYNAMIKE,knockout,Out in the Open,0,6,0,6,1446
10039,2023-01-06,DYNAMIKE,hotZone,Split,0,68,47,115,1158
10040,2023-01-06,DYNAMIKE,heist,Tornado Ring,0,28,6,34,2538
10041,2023-01-06,DYNAMIKE,gemGrab,Undermine,0,1,0,1,540
10042,2023-01-06,DYNAMIKE,gemGrab,Deep Diner,0,33,45,78,2226
10043,2023-01-06,DYNAMIKE,brawlBall,Sneaky Fields,0,23,7,30,4896
10044,2023-01-06,DYNAMIKE,brawlBall,Pinhole Punt,0,2,0,2,510
10045,2023-01-06,DYNAMIKE,bounty,Dry Season,0,2,0,2,1944
10046,2023-01-05,DYNAMIKE,knockout,Out in the Open,0,3,3,6,2958
10047,2023-01-05,DYNAMIKE,hotZone,Split,0,176,153,329,3552
10048,2023-01-05,DYNAMIKE,heist,Kaboom Canyon,0,11,1,12,954
10049,2023-01-05,DYNAMIKE,gemGrab,Undermine,0,7,9,16,1812
10050,2023-01-05,DYNAMIKE,gemGrab,Gem Fort,0,3,7,10,252
10051,2023-01-05,DYNAMIKE,brawlBall,Sunny Soccer,0,3,5,8,84
10052,2023-01-05,DYNAMIKE,brawlBall,Pinhole Punt,2,36,13,51,8118
10053,2023-01-05,DYNAMIKE,bounty,Shooting Star,0,3,0,3,1362
10054,2023-01-04,DYNAMIKE,knockout,Goldarm Gulch,0,5,2,7,696
10055,2023-01-04,DYNAMIKE,hotZone,Parallel Plays,0,16,3,19,864
10056,2023-01-04,DYNAMIKE,heist,Kaboom Canyon,0,15,1,16,1848
10057,2023-01-04,DYNAMIKE,gemGrab,Gem Fort,0,1,1,2,1788
10058,2023-01-04,DYNAMIKE,gemGrab,Crystal Arcade,0,3,1,4,642
10059,2023-01-04,DYNAMIKE,brawlBall,Sunny Soccer,1,165,170,336,6312
10060,2023-01-04,DYNAMIKE,brawlBall,Beach Ball,0,1,0,1,54
10061,2023-01-04,DYNAMIKE,bounty,Shooting Star,0,3,0,3,3570
10062,2023-01-03,DYNAMIKE,knockout,Goldarm Gulch,0,1,2,3,720
10063,2023-01-03,DYNAMIKE,hotZone,Parallel Plays,0,17,1,18,1542
10064,2023-01-03,DYNAMIKE,hotZone,Controller Chaos,0,1,0,1,12
10065,2023-01-03,DYNAMIKE,heist,Pit Stop,0,77,38,115,1956
10066,2023-01-03,DYNAMIKE,gemGrab,Minecart Madness,0,3,0,3,456
10067,2023-01-03,DYNAMIKE,gemGrab,Crystal Arcade,0,9,1,10,2406
10068,2023-01-03,DYNAMIKE,brawlBall,Center Stage,0,2,0,2,294
10069,2023-01-03,DYNAMIKE,brawlBall,Beach Ball,1,114,98,213,5580
10070,2023-01-03,DYNAMIKE,bounty,Hideout,0,8,0,8,1638
10071,2023-01-02,DYNAMIKE,knockout,Belle's Rock,0,28,3,31,1794
10072,2023-01-02,DYNAMIKE,hotZone,Quarter Pounder,0,47,14,61,2652
10073,2023-01-02,DYNAMIKE,heist,Pit Stop,0,129,125,254,3498
10074,2023-01-02,DYNAMIKE,gemGrab,Minecart Madness,0,15,3,18,2352
10075,2023-01-02,DYNAMIKE,gemGrab,Double Swoosh,0,2,2,4,1512
10076,2023-01-02,DYNAMIKE,brawlBall,Center Stage,0,44,28,72,7110
10077,2023-01-02,DYNAMIKE,brawlBall,Backyard Bowl,0,5,1,6,492
10078,2023-01-02,DYNAMIKE,bounty,Hideout,0,13,2,15,3090
10079,2023-01-01,DYNAMIKE,knockout,Belle's Rock,0,3,0,3,858
10080,2023-01-01,DYNAMIKE,hotZone,Quarter Pounder,0,18,3,21,1188
10081,2023-01-01,DYNAMIKE,heist,Bridge Too Far,0,1,0,1,462
10082,2023-01-01,DYNAMIKE,gemGrab,Double Swoosh,0,9,1,10,1140
10083,2023-01-01,DYNAMIKE,brawlBall,Backyard Bowl,0,13,6,19,2658
10084,2023-01-01,DYNAMIKE,bounty,Canal Grande,0,3,0,3,132
10085,2022-12-31,DYNAMIKE,hotZone,Controller Chaos,0,4,4,8,198
10086,2022-12-31,DYNAMIKE,gemGrab,Hard Rock Mine,0,2,0,2,384
10087,2022-12-31,DYNAMIKE,gemGrab,Deep Diner,0,2,1,3,306
10088,2022-12-31,DYNAMIKE,brawlBall,Super Beach,1,23,27,51,618
10089,2022-12-30,DYNAMIKE,knockout,Flaring Phoenix,0,1,0,1,72
10090,2022-12-30,DYNAMIKE,hotZone,Controller Chaos,0,3,1,4,288
10091,2022-12-30,DYNAMIKE,heist,Hot Potato,0,2,2,4,30
10092,2022-12-30,DYNAMIKE,gemGrab,Minecart Madness,0,1,0,1,24
10093,2022-12-30,DYNAMIKE,gemGrab,Deep Diner,0,2,4,6,438
10094,2022-12-30,DYNAMIKE,brawlBall,Sneaky Fields,0,5,2,7,552
10095,2022-12-29,DYNAMIKE,hotZone,Controller Chaos,0,1,0,1,12
10096,2022-12-29,DYNAMIKE,heist,Hot Potato,0,2,8,10,72
10097,2022-12-29,DYNAMIKE,gemGrab,Minecart Madness,0,1,1,2,24
10098,2022-12-29,DYNAMIKE,gemGrab,Gem Fort,0,1,0,1,30
10099,2022-12-28,DYNAMIKE,brawlBall,Sunny Soccer,0,1,0,1,42
10100,2022-12-27,DYNAMIKE,hotZone,Dueling Beetles,0,0,1,1,36
10101,2022-12-27,DYNAMIKE,hotZone,Controller Chaos,0,1,0,1,24
10102,2022-12-27,DYNAMIKE,gemGrab,Minecart Madness,0,2,0,2,30
10103,2022-12-27,DYNAMIKE,brawlBall,Beach Ball,0,2,2,4,144
10104,2022-12-27,DYNAMIKE,bounty,Excel,0,1,0,1,18
10105,2022-12-26,DYNAMIKE,hotZone,Controller Chaos,0,1,0,1,30
10106,2022-12-26,DYNAMIKE,heist,Kaboom Canyon,0,1,0,1,36
10107,2022-12-26,DYNAMIKE,gemGrab,Minecart Madness,0,0,1,1,60
10108,2022-12-25,DYNAMIKE,brawlBall,Backyard Bowl,0,1,0,1,78
10109,2022-12-24,DYNAMIKE,brawlBall,Super Beach,0,4,2,6,48
10110,2022-12-23,DYNAMIKE,knockout,Out in the Open,0,1,0,1,132
10111,2022-12-22,DYNAMIKE,gemGrab,Gem Fort,0,0,1,1,90
10112,2022-12-22,DYNAMIKE,brawlBall,Pinhole Punt,0,2,0,2,132
10113,2022-12-21,DYNAMIKE,brawlBall,Sunny Soccer,0,0,1,1,54
10114,2022-12-20,DYNAMIKE,brawlBall,Beach Ball,0,2,1,3,96
10115,2022-12-16,DYNAMIKE,brawlBall,Sneaky Fields,0,1,3,4,84
10116,2022-12-13,DYNAMIKE,knockout,New Perspective,0,1,0,1,84
10117,2022-12-13,DYNAMIKE,heist,Safe Zone,0,0,1,1,42
10118,2022-12-13,DYNAMIKE,gemGrab,Crystal Arcade,0,1,0,1,72
10119,2022-12-13,DYNAMIKE,brawlBall,Beach Ball,0,1,2,3,54
10120,2022-12-10,DYNAMIKE,knockout,X Marks the Spot,0,0,1,1,12
10121,2022-12-10,DYNAMIKE,gemGrab,Hard Rock Mine,0,4,0,4,24
10122,2022-11-07,DYNAMIKE,hotZone,Quarter Pounder,0,0,1,1,24
10123,2022-11-03,DYNAMIKE,brawlBall,Pinhole Punt,0,1,1,2,12
10124,2022-11-01,DYNAMIKE,knockout,New Perspective,0,1,1,2,54
10125,2022-10-30,DYNAMIKE,bounty,Canal Grande,0,1,0,1,12
10126,2022-10-28,DYNAMIKE,bounty,Canal Grande,0,1,0,1,12
10127,2022-10-15,DYNAMIKE,gemGrab,Hard Rock Mine,0,0,1,1,90
10128,2023-01-28,DARRYL,knockout,Flaring Phoenix,0,20,15,35,12366
10129,2023-01-28,DARRYL,hotZone,Controller Chaos,0,39,23,62,10134
10130,2023-01-28,DARRYL,heist,Bridge Too Far,1,114,98,213,24240
10131,2023-01-28,DARRYL,gemGrab,Hard Rock Mine,0,73,57,130,16638
10132,2023-01-28,DARRYL,gemGrab,Deep Diner,0,11,17,28,5478
10133,2023-01-28,DARRYL,brawlBall,Super Beach,8,495,505,1008,74430
10134,2023-01-28,DARRYL,brawlBall,Sneaky Fields,1,29,19,49,3582
10135,2023-01-28,DARRYL,bounty,Canal Grande,0,51,64,115,10902
10136,2023-01-27,DARRYL,knockout,Flaring Phoenix,0,16,4,20,5928
10137,2023-01-27,DARRYL,hotZone,Controller Chaos,0,8,5,13,2676
10138,2023-01-27,DARRYL,heist,Hot Potato,0,59,88,147,3486
10139,2023-01-27,DARRYL,gemGrab,Undermine,0,3,1,4,942
10140,2023-01-27,DARRYL,gemGrab,Deep Diner,0,25,28,53,6846
10141,2023-01-27,DARRYL,brawlBall,Sneaky Fields,4,194,208,406,23514
10142,2023-01-27,DARRYL,brawlBall,Pinhole Punt,1,6,3,10,738
10143,2023-01-27,DARRYL,bounty,Temple Ruins,0,8,8,16,1890
10144,2023-01-26,DARRYL,knockout,Riverside,0,23,6,29,19008
10145,2023-01-26,DARRYL,hotZone,Open Zone,0,16,8,24,10182
10146,2023-01-26,DARRYL,heist,Hot Potato,0,368,405,773,14610
10147,2023-01-26,DARRYL,gemGrab,Undermine,0,46,34,80,10062
10148,2023-01-26,DARRYL,gemGrab,Gem Fort,0,20,17,37,4674
10149,2023-01-26,DARRYL,brawlBall,Sunny Soccer,0,35,32,67,3660
10150,2023-01-26,DARRYL,brawlBall,Pinhole Punt,9,435,404,848,67338
10151,2023-01-26,DARRYL,bounty,Temple Ruins,0,10,17,27,5610
10152,2023-01-25,DARRYL,knockout,Riverside,0,13,9,22,9906
10153,2023-01-25,DARRYL,hotZone,Open Zone,0,4,4,8,5262
10154,2023-01-25,DARRYL,heist,Safe Zone,1,91,72,164,9156
10155,2023-01-25,DARRYL,gemGrab,Gem Fort,0,26,15,41,5556
10156,2023-01-25,DARRYL,gemGrab,Crystal Arcade,0,29,16,45,7866
10157,2023-01-25,DARRYL,brawlBall,Sunny Soccer,5,385,404,794,40830
10158,2023-01-25,DARRYL,brawlBall,Beach Ball,2,48,59,109,6408
10159,2023-01-25,DARRYL,bounty,Excel,0,14,11,25,5790
10160,2023-01-24,DARRYL,knockout,New Perspective,0,28,24,52,10542
10161,2023-01-24,DARRYL,hotZone,Dueling Beetles,0,23,7,30,10662
10162,2023-01-24,DARRYL,heist,Safe Zone,0,96,105,201,15750
10163,2023-01-24,DARRYL,gemGrab,Minecart Madness,0,5,3,8,4002
10164,2023-01-24,DARRYL,gemGrab,Crystal Arcade,0,53,41,94,14460
10165,2023-01-24,DARRYL,brawlBall,Center Stage,1,57,60,118,7860
10166,2023-01-24,DARRYL,brawlBall,Beach Ball,11,424,474,909,64614
10167,2023-01-24,DARRYL,bounty,Excel,0,17,12,29,10896
10168,2023-01-23,DARRYL,knockout,New Perspective,0,39,42,81,20676
10169,2023-01-23,DARRYL,hotZone,Dueling Beetles,0,30,25,55,17502
10170,2023-01-23,DARRYL,heist,Snaked Assault,3,239,244,486,15762
10171,2023-01-23,DARRYL,gemGrab,Minecart Madness,0,49,48,97,19062
10172,2023-01-23,DARRYL,gemGrab,Double Swoosh,0,28,21,49,7578
10173,2023-01-23,DARRYL,brawlBall,Center Stage,20,811,867,1698,92862
10174,2023-01-23,DARRYL,brawlBall,Backyard Bowl,0,22,15,37,4224
10175,2023-01-23,DARRYL,bounty,Layer Cake,0,34,26,60,11142
10176,2023-01-22,DARRYL,knockout,X Marks the Spot,0,13,9,22,9174
10177,2023-01-22,DARRYL,hotZone,Ring of Fire,0,13,16,29,5730
10178,2023-01-22,DARRYL,heist,Snaked Assault,0,161,220,381,8232
10179,2023-01-22,DARRYL,gemGrab,Hard Rock Mine,0,16,16,32,4722
10180,2023-01-22,DARRYL,gemGrab,Double Swoosh,0,36,26,62,9426
10181,2023-01-22,DARRYL,brawlBall,Super Beach,1,62,82,145,7386
10182,2023-01-22,DARRYL,brawlBall,Backyard Bowl,3,104,93,200,34788
10183,2023-01-22,DARRYL,bounty,Layer Cake,0,40,50,90,6654
10184,2023-01-21,DARRYL,knockout,X Marks the Spot,0,54,27,81,31698
10185,2023-01-21,DARRYL,hotZone,Ring of Fire,0,39,50,89,16632
10186,2023-01-21,DARRYL,heist,Tornado Ring,1,178,211,390,11664
10187,2023-01-21,DARRYL,gemGrab,Hard Rock Mine,0,89,89,178,22980
10188,2023-01-21,DARRYL,gemGrab,Deep Diner,0,15,17,32,4470
10189,2023-01-21,DARRYL,brawlBall,Super Beach,16,692,664,1372,101364
10190,2023-01-21,DARRYL,brawlBall,Sneaky Fields,0,32,28,60,3750
10191,2023-01-21,DARRYL,bounty,Dry Season,0,13,11,24,14538
10192,2023-01-20,DARRYL,knockout,Out in the Open,0,34,13,47,20106
10193,2023-01-20,DARRYL,hotZone,Split,0,44,52,96,9678
10194,2023-01-20,DARRYL,heist,Tornado Ring,3,228,274,505,12672
10195,2023-01-20,DARRYL,gemGrab,Undermine,0,28,21,49,5442
10196,2023-01-20,DARRYL,gemGrab,Deep Diner,0,51,32,83,19050
10197,2023-01-20,DARRYL,brawlBall,Sneaky Fields,10,640,619,1269,74778
10198,2023-01-20,DARRYL,brawlBall,Pinhole Punt,0,20,15,35,2886
10199,2023-01-20,DARRYL,bounty,Dry Season,0,9,4,13,11640
10200,2023-01-19,DARRYL,knockout,Out in the Open,0,22,9,31,26574
10201,2023-01-19,DARRYL,hotZone,Split,0,64,114,178,14856
10202,2023-01-19,DARRYL,heist,Kaboom Canyon,1,69,50,120,6732
10203,2023-01-19,DARRYL,gemGrab,Undermine,0,58,40,98,14154
10204,2023-01-19,DARRYL,gemGrab,Gem Fort,0,18,22,40,2934
10205,2023-01-19,DARRYL,brawlBall,Sunny Soccer,1,25,36,62,2274
10206,2023-01-19,DARRYL,brawlBall,Pinhole Punt,10,480,503,993,72498
10207,2023-01-19,DARRYL,bounty,Shooting Star,0,8,3,11,11124
10208,2023-01-18,DARRYL,knockout,Goldarm Gulch,0,6,7,13,2784
10209,2023-01-18,DARRYL,hotZone,Parallel Plays,0,5,6,11,1158
10210,2023-01-18,DARRYL,heist,Kaboom Canyon,0,23,14,37,2592
10211,2023-01-18,DARRYL,gemGrab,Gem Fort,0,13,6,19,3006
10212,2023-01-18,DARRYL,gemGrab,Crystal Arcade,0,4,0,4,990
10213,2023-01-18,DARRYL,brawlBall,Sunny Soccer,0,166,169,335,18941
10214,2023-01-18,DARRYL,brawlBall,Beach Ball,0,11,9,20,774
10215,2023-01-18,DARRYL,bounty,Shooting Star,0,2,0,2,5088
10216,2023-01-17,DARRYL,knockout,Goldarm Gulch,0,3,9,12,2520
10217,2023-01-17,DARRYL,hotZone,Parallel Plays,0,3,1,4,1038
10218,2023-01-17,DARRYL,heist,Pit Stop,0,37,37,74,1290
10219,2023-01-17,DARRYL,gemGrab,Minecart Madness,0,2,0,2,216
10220,2023-01-17,DARRYL,gemGrab,Crystal Arcade,0,3,1,4,1266
10221,2023-01-17,DARRYL,brawlBall,Center Stage,0,4,2,6,288
10222,2023-01-17,DARRYL,brawlBall,Beach Ball,0,44,60,104,5886
10223,2023-01-16,DARRYL,knockout,Belle's Rock,0,3,2,5,1788
10224,2023-01-16,DARRYL,hotZone,Quarter Pounder,0,5,1,6,1494
10225,2023-01-16,DARRYL,heist,Pit Stop,0,132,163,295,4044
10226,2023-01-16,DARRYL,gemGrab,Minecart Madness,0,6,2,8,1422
10227,2023-01-16,DARRYL,gemGrab,Double Swoosh,0,3,1,4,708
10228,2023-01-16,DARRYL,brawlBall,Center Stage,1,39,36,76,5778
10229,2023-01-16,DARRYL,brawlBall,Backyard Bowl,0,2,0,2,852
10230,2023-01-15,DARRYL,knockout,Belle's Rock,0,4,2,6,2904
10231,2023-01-15,DARRYL,hotZone,Quarter Pounder,0,3,2,5,3318
10232,2023-01-15,DARRYL,heist,Bridge Too Far,0,16,13,29,2736
10233,2023-01-15,DARRYL,gemGrab,Hard Rock Mine,0,2,0,2,1014
10234,2023-01-15,DARRYL,gemGrab,Double Swoosh,0,3,17,20,2178
10235,2023-01-15,DARRYL,brawlBall,Super Beach,0,9,2,11,1074
10236,2023-01-15,DARRYL,brawlBall,Backyard Bowl,2,31,29,62,8946
10237,2023-01-15,DARRYL,bounty,Canal Grande,0,4,2,6,960
10238,2023-01-14,DARRYL,knockout,Flaring Phoenix,0,4,5,9,1080
10239,2023-01-14,DARRYL,hotZone,Controller Chaos,0,20,17,37,2772
10240,2023-01-14,DARRYL,heist,Bridge Too Far,0,23,14,37,4020
10241,2023-01-14,DARRYL,gemGrab,Hard Rock Mine,0,5,6,11,1272
10242,2023-01-14,DARRYL,gemGrab,Deep Diner,0,2,0,2,858
10243,2023-01-14,DARRYL,brawlBall,Super Beach,0,39,24,63,6336
10244,2023-01-14,DARRYL,brawlBall,Sneaky Fields,0,8,0,8,918
10245,2023-01-14,DARRYL,bounty,Canal Grande,0,7,8,15,1014
10246,2023-01-13,DARRYL,knockout,Flaring Phoenix,0,2,1,3,1182
10247,2023-01-13,DARRYL,hotZone,Controller Chaos,0,9,1,10,2928
10248,2023-01-13,DARRYL,heist,Hot Potato,0,15,23,38,600
10249,2023-01-13,DARRYL,gemGrab,Deep Diner,0,2,1,3,1650
10250,2023-01-13,DARRYL,brawlBall,Sneaky Fields,0,45,30,75,6144
10251,2023-01-12,DARRYL,knockout,Riverside,0,4,0,4,2532
10252,2023-01-12,DARRYL,hotZone,Open Zone,0,3,1,4,1488
10253,2023-01-12,DARRYL,heist,Hot Potato,0,4,6,10,330
10254,2023-01-12,DARRYL,gemGrab,Undermine,0,0,1,1,690
10255,2023-01-12,DARRYL,gemGrab,Gem Fort,0,2,0,2,162
10256,2023-01-12,DARRYL,brawlBall,Sunny Soccer,0,2,0,2,240
10257,2023-01-12,DARRYL,brawlBall,Pinhole Punt,1,18,15,34,2292
10258,2023-01-12,DARRYL,bounty,Temple Ruins,0,0,2,2,24
10259,2023-01-11,DARRYL,gemGrab,Gem Fort,0,1,0,1,414
10260,2023-01-11,DARRYL,brawlBall,Sunny Soccer,0,15,3,18,1638
10261,2023-01-11,DARRYL,brawlBall,Beach Ball,0,1,1,2,48
10262,2023-01-11,DARRYL,bounty,Excel,0,3,9,12,282
10263,2023-01-10,DARRYL,knockout,New Perspective,0,3,5,8,720
10264,2023-01-10,DARRYL,hotZone,Dueling Beetles,0,8,1,9,2424
10265,2023-01-10,DARRYL,heist,Safe Zone,0,6,3,9,1176
10266,2023-01-10,DARRYL,gemGrab,Minecart Madness,0,1,2,3,828
10267,2023-01-10,DARRYL,gemGrab,Crystal Arcade,0,2,0,2,1746
10268,2023-01-10,DARRYL,brawlBall,Center Stage,0,3,5,8,708
10269,2023-01-10,DARRYL,brawlBall,Beach Ball,0,20,22,42,4392
10270,2023-01-09,DARRYL,knockout,New Perspective,0,1,3,4,876
10271,2023-01-09,DARRYL,hotZone,Dueling Beetles,0,12,4,16,1554
10272,2023-01-09,DARRYL,heist,Snaked Assault,0,37,47,84,2022
10273,2023-01-09,DARRYL,gemGrab,Minecart Madness,0,4,6,10,1884
10274,2023-01-09,DARRYL,gemGrab,Double Swoosh,0,2,0,2,1320
10275,2023-01-09,DARRYL,brawlBall,Center Stage,0,31,23,54,5460
10276,2023-01-09,DARRYL,brawlBall,Backyard Bowl,0,1,7,8,474
10277,2023-01-09,DARRYL,bounty,Layer Cake,0,2,1,3,1512
10278,2023-01-08,DARRYL,knockout,X Marks the Spot,0,4,1,5,1692
10279,2023-01-08,DARRYL,hotZone,Ring of Fire,0,6,2,8,1644
10280,2023-01-08,DARRYL,heist,Snaked Assault,0,29,44,73,1494
10281,2023-01-08,DARRYL,gemGrab,Hard Rock Mine,0,4,7,11,630
10282,2023-01-08,DARRYL,gemGrab,Double Swoosh,0,1,1,2,864
10283,2023-01-08,DARRYL,brawlBall,Super Beach,0,2,1,3,732
10284,2023-01-08,DARRYL,brawlBall,Backyard Bowl,0,19,3,22,4830
10285,2023-01-08,DARRYL,bounty,Layer Cake,0,1,1,2,528
10286,2023-01-07,DARRYL,hotZone,Ring of Fire,0,1,0,1,846
10287,2023-01-07,DARRYL,heist,Tornado Ring,0,44,95,139,1350
10288,2023-01-07,DARRYL,gemGrab,Hard Rock Mine,0,6,11,17,1158
10289,2023-01-07,DARRYL,gemGrab,Deep Diner,0,1,1,2,918
10290,2023-01-07,DARRYL,brawlBall,Super Beach,0,21,22,43,2622
10291,2023-01-07,DARRYL,brawlBall,Sneaky Fields,0,1,1,2,402
10292,2023-01-07,DARRYL,bounty,Dry Season,0,2,0,2,1320
10293,2023-01-06,DARRYL,knockout,Out in the Open,0,0,1,1,1446
10294,2023-01-06,DARRYL,hotZone,Split,0,7,18,25,1158
10295,2023-01-06,DARRYL,heist,Tornado Ring,0,55,62,117,2538
10296,2023-01-06,DARRYL,gemGrab,Undermine,0,2,0,2,540
10297,2023-01-06,DARRYL,gemGrab,Deep Diner,0,5,2,7,2226
10298,2023-01-06,DARRYL,brawlBall,Sneaky Fields,0,30,44,74,4896
10299,2023-01-06,DARRYL,brawlBall,Pinhole Punt,0,7,1,8,510
10300,2023-01-06,DARRYL,bounty,Dry Season,0,1,0,1,1944
10301,2023-01-05,DARRYL,knockout,Out in the Open,0,1,1,2,2958
10302,2023-01-05,DARRYL,hotZone,Split,0,23,8,31,3552
10303,2023-01-05,DARRYL,heist,Kaboom Canyon,0,9,12,21,954
10304,2023-01-05,DARRYL,gemGrab,Undermine,0,3,1,4,1812
10305,2023-01-05,DARRYL,brawlBall,Pinhole Punt,0,35,37,72,8118
10306,2023-01-05,DARRYL,bounty,Shooting Star,0,1,1,2,1362
10307,2023-01-04,DARRYL,knockout,Goldarm Gulch,0,1,0,1,696
10308,2023-01-04,DARRYL,hotZone,Parallel Plays,0,1,0,1,864
10309,2023-01-04,DARRYL,heist,Kaboom Canyon,0,10,8,18,1848
10310,2023-01-04,DARRYL,gemGrab,Gem Fort,0,2,0,2,1788
10311,2023-01-04,DARRYL,gemGrab,Crystal Arcade,0,4,5,9,642
10312,2023-01-04,DARRYL,brawlBall,Sunny Soccer,0,59,65,124,6312
10313,2023-01-04,DARRYL,brawlBall,Beach Ball,0,0,1,1,54
10314,2023-01-04,DARRYL,bounty,Shooting Star,0,1,0,1,3570
10315,2023-01-03,DARRYL,knockout,Goldarm Gulch,0,2,0,2,720
10316,2023-01-03,DARRYL,hotZone,Parallel Plays,0,4,0,4,1542
10317,2023-01-03,DARRYL,heist,Pit Stop,1,52,75,128,1956
10318,2023-01-03,DARRYL,gemGrab,Minecart Madness,0,1,0,1,456
10319,2023-01-03,DARRYL,gemGrab,Crystal Arcade,0,10,4,14,2406
10320,2023-01-03,DARRYL,brawlBall,Center Stage,0,2,0,2,294
10321,2023-01-03,DARRYL,brawlBall,Beach Ball,1,33,20,54,5580
10322,2023-01-03,DARRYL,bounty,Hideout,0,2,0,2,1638
10323,2023-01-02,DARRYL,knockout,Belle's Rock,0,5,2,7,1794
10324,2023-01-02,DARRYL,hotZone,Quarter Pounder,0,9,2,11,2652
10325,2023-01-02,DARRYL,heist,Pit Stop,1,109,155,265,3498
10326,2023-01-02,DARRYL,gemGrab,Minecart Madness,0,5,0,5,2352
10327,2023-01-02,DARRYL,gemGrab,Double Swoosh,0,6,0,6,1512
10328,2023-01-02,DARRYL,brawlBall,Center Stage,0,48,36,84,7110
10329,2023-01-02,DARRYL,brawlBall,Backyard Bowl,0,3,1,4,492
10330,2023-01-02,DARRYL,bounty,Hideout,0,1,0,1,3090
10331,2023-01-01,DARRYL,hotZone,Quarter Pounder,0,1,0,1,1188
10332,2023-01-01,DARRYL,heist,Bridge Too Far,0,4,9,13,462
10333,2023-01-01,DARRYL,gemGrab,Double Swoosh,0,5,2,7,1140
10334,2023-01-01,DARRYL,brawlBall,Backyard Bowl,0,5,4,9,2658
10335,2022-12-31,DARRYL,heist,Kaboom Canyon,0,0,1,1,12
10336,2022-12-31,DARRYL,heist,Bridge Too Far,0,1,1,2,276
10337,2022-12-31,DARRYL,gemGrab,Hard Rock Mine,0,1,0,1,384
10338,2022-12-31,DARRYL,gemGrab,Deep Diner,0,1,0,1,306
10339,2022-12-31,DARRYL,brawlBall,Super Beach,0,3,2,5,618
10340,2022-12-30,DARRYL,hotZone,Controller Chaos,0,3,1,4,288
10341,2022-12-30,DARRYL,heist,Kaboom Canyon,0,1,0,1,18
10342,2022-12-30,DARRYL,heist,Hot Potato,0,0,1,1,30
10343,2022-12-30,DARRYL,gemGrab,Deep Diner,0,3,0,3,438
10344,2022-12-30,DARRYL,brawlBall,Sneaky Fields,0,3,4,7,552
10345,2022-12-29,DARRYL,hotZone,Controller Chaos,0,0,1,1,12
10346,2022-12-29,DARRYL,heist,Hot Potato,0,3,0,3,72
10347,2022-12-29,DARRYL,gemGrab,Gem Fort,0,0,1,1,30
10348,2022-12-29,DARRYL,brawlBall,Pinhole Punt,0,0,12,12,282
10349,2022-12-27,DARRYL,hotZone,Dueling Beetles,0,0,1,1,36
10350,2022-12-27,DARRYL,brawlBall,Beach Ball,0,0,1,1,144
10351,2022-12-26,DARRYL,gemGrab,Minecart Madness,0,1,0,1,60
10352,2022-12-22,DARRYL,gemGrab,Gem Fort,0,0,1,1,90
10353,2022-12-19,DARRYL,brawlBall,Center Stage,0,1,1,2,102
10354,2022-12-16,DARRYL,brawlBall,Sneaky Fields,0,0,1,1,84
10355,2022-12-13,DARRYL,heist,Safe Zone,0,1,0,1,42
10356,2022-12-13,DARRYL,brawlBall,Beach Ball,0,1,0,1,54
10357,2022-11-11,DARRYL,brawlBall,Sneaky Fields,0,0,1,1,42
10358,2022-11-03,DARRYL,brawlBall,Pinhole Punt,0,1,0,1,12
10359,2022-10-28,DARRYL,heist,Safe Zone,0,1,0,1,6
10360,2022-10-28,DARRYL,bounty,Canal Grande,0,1,0,1,12
10361,2022-10-26,DARRYL,brawlBall,Sunny Soccer,0,1,0,1,18
10362,2022-10-15,DARRYL,gemGrab,Hard Rock Mine,0,1,0,1,90
10363,2023-01-28,CROW,knockout,Flaring Phoenix,2,110,49,161,12366
10364,2023-01-28,CROW,hotZone,Controller Chaos,0,82,43,125,10134
10365,2023-01-28,CROW,heist,Bridge Too Far,2,74,42,118,24240
10366,2023-01-28,CROW,gemGrab,Hard Rock Mine,0,304,214,518,16638
10367,2023-01-28,CROW,gemGrab,Deep Diner,0,125,60,185,5478
10368,2023-01-28,CROW,brawlBall,Super Beach,23,766,633,1422,74430
10369,2023-01-28,CROW,brawlBall,Sneaky Fields,1,29,18,48,3582
10370,2023-01-28,CROW,bounty,Canal Grande,0,92,62,154,10902
10371,2023-01-27,CROW,knockout,Flaring Phoenix,0,69,39,108,5928
10372,2023-01-27,CROW,hotZone,Controller Chaos,0,24,15,39,2676
10373,2023-01-27,CROW,heist,Hot Potato,0,19,3,22,3486
10374,2023-01-27,CROW,gemGrab,Undermine,0,33,31,64,942
10375,2023-01-27,CROW,gemGrab,Deep Diner,0,151,95,246,6846
10376,2023-01-27,CROW,brawlBall,Sneaky Fields,3,171,190,364,23514
10377,2023-01-27,CROW,brawlBall,Pinhole Punt,0,26,28,54,738
10378,2023-01-27,CROW,bounty,Temple Ruins,0,47,76,123,1890
10379,2023-01-26,CROW,knockout,Riverside,0,178,69,247,19008
10380,2023-01-26,CROW,hotZone,Open Zone,0,482,501,983,10182
10381,2023-01-26,CROW,heist,Hot Potato,0,28,12,40,14610
10382,2023-01-26,CROW,gemGrab,Undermine,0,350,306,656,10062
10383,2023-01-26,CROW,gemGrab,Gem Fort,0,107,132,239,4674
10384,2023-01-26,CROW,brawlBall,Sunny Soccer,0,46,47,93,3660
10385,2023-01-26,CROW,brawlBall,Pinhole Punt,57,1811,1935,3803,67338
10386,2023-01-26,CROW,bounty,Temple Ruins,0,138,142,280,5610
10387,2023-01-25,CROW,knockout,Riverside,0,74,30,104,9906
10388,2023-01-25,CROW,hotZone,Open Zone,0,293,321,614,5262
10389,2023-01-25,CROW,heist,Safe Zone,2,79,58,139,9156
10390,2023-01-25,CROW,gemGrab,Gem Fort,0,165,190,355,5556
10391,2023-01-25,CROW,gemGrab,Crystal Arcade,0,192,103,295,7866
10392,2023-01-25,CROW,brawlBall,Sunny Soccer,9,463,402,874,40830
10393,2023-01-25,CROW,brawlBall,Beach Ball,5,110,88,203,6408
10394,2023-01-25,CROW,bounty,Excel,0,40,17,57,5790
10395,2023-01-24,CROW,knockout,New Perspective,0,172,75,247,10542
10396,2023-01-24,CROW,hotZone,Dueling Beetles,0,104,77,181,10662
10397,2023-01-24,CROW,heist,Safe Zone,0,78,40,118,15750
10398,2023-01-24,CROW,gemGrab,Minecart Madness,0,95,90,185,4002
10399,2023-01-24,CROW,gemGrab,Crystal Arcade,0,261,160,421,14460
10400,2023-01-24,CROW,brawlBall,Center Stage,1,127,110,238,7860
10401,2023-01-24,CROW,brawlBall,Beach Ball,35,935,849,1819,64614
10402,2023-01-24,CROW,bounty,Excel,0,60,39,99,10896
10403,2023-01-23,CROW,knockout,New Perspective,3,289,150,442,20676
10404,2023-01-23,CROW,hotZone,Dueling Beetles,0,173,78,251,17502
10405,2023-01-23,CROW,heist,Snaked Assault,1,64,32,97,15762
10406,2023-01-23,CROW,gemGrab,Minecart Madness,0,497,557,1054,19062
10407,2023-01-23,CROW,gemGrab,Double Swoosh,0,289,305,594,7578
10408,2023-01-23,CROW,brawlBall,Center Stage,35,1244,1137,2416,92862
10409,2023-01-23,CROW,brawlBall,Backyard Bowl,10,146,128,284,4224
10410,2023-01-23,CROW,bounty,Layer Cake,0,63,37,100,11142
10411,2023-01-22,CROW,knockout,X Marks the Spot,0,78,73,151,9174
10412,2023-01-22,CROW,hotZone,Ring of Fire,1,177,212,390,5730
10413,2023-01-22,CROW,heist,Snaked Assault,0,20,7,27,8232
10414,2023-01-22,CROW,gemGrab,Hard Rock Mine,0,69,46,115,4722
10415,2023-01-22,CROW,gemGrab,Double Swoosh,0,312,366,678,9426
10416,2023-01-22,CROW,brawlBall,Super Beach,4,63,49,116,7386
10417,2023-01-22,CROW,brawlBall,Backyard Bowl,57,1000,961,2018,34788
10418,2023-01-22,CROW,bounty,Layer Cake,0,36,17,53,6654
10419,2023-01-21,CROW,knockout,X Marks the Spot,0,326,171,497,31698
10420,2023-01-21,CROW,hotZone,Ring of Fire,0,476,520,996,16632
10421,2023-01-21,CROW,heist,Tornado Ring,1,67,72,140,11664
10422,2023-01-21,CROW,gemGrab,Hard Rock Mine,0,383,289,672,22980
10423,2023-01-21,CROW,gemGrab,Deep Diner,0,123,84,207,4470
10424,2023-01-21,CROW,brawlBall,Super Beach,31,1185,920,2136,101364
10425,2023-01-21,CROW,brawlBall,Sneaky Fields,1,46,42,89,3750
10426,2023-01-21,CROW,bounty,Dry Season,0,122,56,178,14538
10427,2023-01-20,CROW,knockout,Out in the Open,1,291,159,451,20106
10428,2023-01-20,CROW,hotZone,Split,0,41,10,51,9678
10429,2023-01-20,CROW,heist,Tornado Ring,0,74,51,125,12672
10430,2023-01-20,CROW,gemGrab,Undermine,0,209,195,404,5442
10431,2023-01-20,CROW,gemGrab,Deep Diner,0,386,238,624,19050
10432,2023-01-20,CROW,brawlBall,Sneaky Fields,18,739,611,1368,74778
10433,2023-01-20,CROW,brawlBall,Pinhole Punt,1,70,70,141,2886
10434,2023-01-20,CROW,bounty,Dry Season,0,126,64,190,11640
10435,2023-01-19,CROW,knockout,Out in the Open,0,319,166,485,26574
10436,2023-01-19,CROW,hotZone,Split,0,68,25,93,14856
10437,2023-01-19,CROW,heist,Kaboom Canyon,1,98,110,209,6732
10438,2023-01-19,CROW,gemGrab,Undermine,0,497,435,932,14154
10439,2023-01-19,CROW,gemGrab,Gem Fort,0,86,66,152,2934
10440,2023-01-19,CROW,brawlBall,Sunny Soccer,0,30,27,57,2274
10441,2023-01-19,CROW,brawlBall,Pinhole Punt,57,1981,2081,4119,72498
10442,2023-01-19,CROW,bounty,Shooting Star,0,103,43,146,11124
10443,2023-01-18,CROW,knockout,Goldarm Gulch,0,29,16,45,2784
10444,2023-01-18,CROW,hotZone,Parallel Plays,0,11,16,27,1158
10445,2023-01-18,CROW,heist,Kaboom Canyon,0,65,54,119,2592
10446,2023-01-18,CROW,gemGrab,Gem Fort,0,96,114,210,3006
10447,2023-01-18,CROW,gemGrab,Crystal Arcade,0,26,14,40,990
10448,2023-01-18,CROW,brawlBall,Sunny Soccer,3,199,169,371,18941
10449,2023-01-18,CROW,brawlBall,Beach Ball,0,19,17,36,774
10450,2023-01-18,CROW,bounty,Shooting Star,0,37,22,59,5088
10451,2023-01-17,CROW,knockout,Goldarm Gulch,0,25,13,38,2520
10452,2023-01-17,CROW,hotZone,Parallel Plays,0,5,5,10,1038
10453,2023-01-17,CROW,heist,Pit Stop,0,4,0,4,1290
10454,2023-01-17,CROW,gemGrab,Minecart Madness,0,5,3,8,216
10455,2023-01-17,CROW,gemGrab,Crystal Arcade,0,22,15,37,1266
10456,2023-01-17,CROW,brawlBall,Center Stage,1,1,3,5,288
10457,2023-01-17,CROW,brawlBall,Beach Ball,7,71,72,150,5886
10458,2023-01-17,CROW,bounty,Hideout,0,11,2,13,750
10459,2023-01-16,CROW,knockout,Belle's Rock,0,10,1,11,1788
10460,2023-01-16,CROW,hotZone,Quarter Pounder,0,27,7,34,1494
10461,2023-01-16,CROW,heist,Pit Stop,0,5,0,5,4044
10462,2023-01-16,CROW,gemGrab,Minecart Madness,0,44,52,96,1422
10463,2023-01-16,CROW,gemGrab,Double Swoosh,0,23,9,32,708
10464,2023-01-16,CROW,brawlBall,Center Stage,1,73,72,146,5778
10465,2023-01-16,CROW,brawlBall,Backyard Bowl,0,34,30,64,852
10466,2023-01-16,CROW,bounty,Hideout,0,23,4,27,1470
10467,2023-01-15,CROW,knockout,Belle's Rock,0,12,6,18,2904
10468,2023-01-15,CROW,hotZone,Quarter Pounder,0,62,23,85,3318
10469,2023-01-15,CROW,heist,Bridge Too Far,0,8,0,8,2736
10470,2023-01-15,CROW,gemGrab,Hard Rock Mine,0,19,12,31,1014
10471,2023-01-15,CROW,gemGrab,Double Swoosh,0,70,92,162,2178
10472,2023-01-15,CROW,brawlBall,Super Beach,0,12,3,15,1074
10473,2023-01-15,CROW,brawlBall,Backyard Bowl,15,326,374,715,8946
10474,2023-01-15,CROW,bounty,Canal Grande,0,5,2,7,960
10475,2023-01-14,CROW,knockout,Flaring Phoenix,0,5,6,11,1080
10476,2023-01-14,CROW,hotZone,Controller Chaos,0,34,14,48,2772
10477,2023-01-14,CROW,heist,Bridge Too Far,0,12,1,13,4020
10478,2023-01-14,CROW,gemGrab,Hard Rock Mine,0,32,4,36,1272
10479,2023-01-14,CROW,gemGrab,Deep Diner,0,20,13,33,858
10480,2023-01-14,CROW,brawlBall,Super Beach,2,81,47,130,6336
10481,2023-01-14,CROW,brawlBall,Sneaky Fields,0,6,0,6,918
10482,2023-01-14,CROW,bounty,Canal Grande,0,11,3,14,1014
10483,2023-01-13,CROW,knockout,Flaring Phoenix,0,14,7,21,1182
10484,2023-01-13,CROW,hotZone,Controller Chaos,0,22,5,27,2928
10485,2023-01-13,CROW,heist,Hot Potato,0,1,0,1,600
10486,2023-01-13,CROW,gemGrab,Undermine,0,1,2,3,18
10487,2023-01-13,CROW,gemGrab,Deep Diner,0,52,12,64,1650
10488,2023-01-13,CROW,brawlBall,Sneaky Fields,0,56,65,121,6144
10489,2023-01-13,CROW,brawlBall,Pinhole Punt,3,4,9,16,156
10490,2023-01-13,CROW,bounty,Temple Ruins,0,5,5,10,270
10491,2023-01-12,CROW,knockout,Riverside,0,12,2,14,2532
10492,2023-01-12,CROW,hotZone,Open Zone,0,68,114,182,1488
10493,2023-01-12,CROW,heist,Hot Potato,0,0,1,1,330
10494,2023-01-12,CROW,gemGrab,Undermine,0,21,33,54,690
10495,2023-01-12,CROW,gemGrab,Gem Fort,0,3,1,4,162
10496,2023-01-12,CROW,brawlBall,Sunny Soccer,0,1,0,1,240
10497,2023-01-12,CROW,brawlBall,Pinhole Punt,1,74,55,130,2292
10498,2023-01-12,CROW,bounty,Temple Ruins,0,1,0,1,24
10499,2023-01-11,CROW,hotZone,Open Zone,0,32,28,60,462
10500,2023-01-11,CROW,gemGrab,Gem Fort,0,10,3,13,414
10501,2023-01-11,CROW,brawlBall,Sunny Soccer,0,15,8,23,1638
10502,2023-01-11,CROW,brawlBall,Beach Ball,0,1,0,1,48
10503,2023-01-11,CROW,bounty,Excel,0,1,0,1,282
10504,2023-01-10,CROW,knockout,New Perspective,0,17,1,18,720
10505,2023-01-10,CROW,hotZone,Dueling Beetles,0,36,19,55,2424
10506,2023-01-10,CROW,heist,Safe Zone,0,5,2,7,1176
10507,2023-01-10,CROW,gemGrab,Minecart Madness,0,30,25,55,828
10508,2023-01-10,CROW,gemGrab,Crystal Arcade,0,51,24,75,1746
10509,2023-01-10,CROW,brawlBall,Center Stage,1,14,24,39,708
10510,2023-01-10,CROW,brawlBall,Beach Ball,1,86,51,138,4392
10511,2023-01-10,CROW,bounty,Excel,0,4,0,4,330
10512,2023-01-09,CROW,knockout,New Perspective,0,9,2,11,876
10513,2023-01-09,CROW,hotZone,Dueling Beetles,0,10,8,18,1554
10514,2023-01-09,CROW,heist,Snaked Assault,0,7,3,10,2022
10515,2023-01-09,CROW,gemGrab,Minecart Madness,0,45,41,86,1884
10516,2023-01-09,CROW,gemGrab,Double Swoosh,0,44,35,79,1320
10517,2023-01-09,CROW,brawlBall,Center Stage,1,56,52,109,5460
10518,2023-01-09,CROW,brawlBall,Backyard Bowl,0,17,2,19,474
10519,2023-01-09,CROW,bounty,Layer Cake,0,11,3,14,1512
10520,2023-01-08,CROW,knockout,X Marks the Spot,0,18,0,18,1692
10521,2023-01-08,CROW,hotZone,Ring of Fire,0,37,17,54,1644
10522,2023-01-08,CROW,heist,Snaked Assault,0,3,3,6,1494
10523,2023-01-08,CROW,gemGrab,Hard Rock Mine,0,5,7,12,630
10524,2023-01-08,CROW,gemGrab,Double Swoosh,0,27,48,75,864
10525,2023-01-08,CROW,brawlBall,Super Beach,0,6,5,11,732
10526,2023-01-08,CROW,brawlBall,Backyard Bowl,5,176,143,324,4830
10527,2023-01-08,CROW,bounty,Layer Cake,0,2,1,3,528
10528,2023-01-07,CROW,knockout,X Marks the Spot,0,5,1,6,1014
10529,2023-01-07,CROW,hotZone,Ring of Fire,0,34,17,51,846
10530,2023-01-07,CROW,heist,Tornado Ring,0,12,4,16,1350
10531,2023-01-07,CROW,gemGrab,Hard Rock Mine,0,19,6,25,1158
10532,2023-01-07,CROW,gemGrab,Deep Diner,0,14,23,37,918
10533,2023-01-07,CROW,brawlBall,Super Beach,0,25,11,36,2622
10534,2023-01-07,CROW,brawlBall,Sneaky Fields,0,3,0,3,402
10535,2023-01-07,CROW,bounty,Dry Season,0,5,5,10,1320
10536,2023-01-06,CROW,knockout,Out in the Open,0,22,9,31,1446
10537,2023-01-06,CROW,hotZone,Split,0,4,0,4,1158
10538,2023-01-06,CROW,heist,Tornado Ring,0,12,18,30,2538
10539,2023-01-06,CROW,gemGrab,Undermine,0,14,7,21,540
10540,2023-01-06,CROW,gemGrab,Deep Diner,0,49,24,73,2226
10541,2023-01-06,CROW,brawlBall,Sneaky Fields,3,45,17,65,4896
10542,2023-01-06,CROW,brawlBall,Pinhole Punt,0,23,26,49,510
10543,2023-01-06,CROW,bounty,Dry Season,0,10,1,11,1944
10544,2023-01-05,CROW,knockout,Out in the Open,1,29,16,46,2958
10545,2023-01-05,CROW,hotZone,Split,0,18,5,23,3552
10546,2023-01-05,CROW,heist,Kaboom Canyon,0,16,1,17,954
10547,2023-01-05,CROW,gemGrab,Undermine,0,73,47,120,1812
10548,2023-01-05,CROW,gemGrab,Gem Fort,0,10,11,21,252
10549,2023-01-05,CROW,brawlBall,Sunny Soccer,0,1,1,2,84
10550,2023-01-05,CROW,brawlBall,Pinhole Punt,9,274,247,530,8118
10551,2023-01-05,CROW,bounty,Shooting Star,0,12,3,15,1362
10552,2023-01-04,CROW,knockout,Goldarm Gulch,0,11,6,17,696
10553,2023-01-04,CROW,hotZone,Parallel Plays,0,9,1,10,864
10554,2023-01-04,CROW,heist,Kaboom Canyon,1,42,45,88,1848
10555,2023-01-04,CROW,gemGrab,Gem Fort,0,82,88,170,1788
10556,2023-01-04,CROW,gemGrab,Crystal Arcade,0,18,15,33,642
10557,2023-01-04,CROW,brawlBall,Sunny Soccer,1,56,28,85,6312
10558,2023-01-04,CROW,brawlBall,Beach Ball,0,1,0,1,54
10559,2023-01-04,CROW,bounty,Shooting Star,0,22,2,24,3570
10560,2023-01-03,CROW,knockout,Goldarm Gulch,0,4,0,4,720
10561,2023-01-03,CROW,hotZone,Parallel Plays,0,18,5,23,1542
10562,2023-01-03,CROW,heist,Pit Stop,0,3,0,3,1956
10563,2023-01-03,CROW,gemGrab,Minecart Madness,0,17,5,22,456
10564,2023-01-03,CROW,gemGrab,Crystal Arcade,0,43,11,54,2406
10565,2023-01-03,CROW,brawlBall,Center Stage,1,3,1,5,294
10566,2023-01-03,CROW,brawlBall,Beach Ball,0,101,72,173,5580
10567,2023-01-03,CROW,bounty,Hideout,0,9,0,9,1638
10568,2023-01-02,CROW,knockout,Belle's Rock,0,13,1,14,1794
10569,2023-01-02,CROW,hotZone,Quarter Pounder,0,43,16,59,2652
10570,2023-01-02,CROW,heist,Pit Stop,0,2,0,2,3498
10571,2023-01-02,CROW,heist,Kaboom Canyon,0,0,1,1,30
10572,2023-01-02,CROW,gemGrab,Minecart Madness,0,86,99,185,2352
10573,2023-01-02,CROW,gemGrab,Double Swoosh,0,34,21,55,1512
10574,2023-01-02,CROW,brawlBall,Center Stage,3,92,83,178,7110
10575,2023-01-02,CROW,brawlBall,Backyard Bowl,2,11,13,26,492
10576,2023-01-02,CROW,bounty,Hideout,0,20,2,22,3090
10577,2023-01-01,CROW,knockout,Belle's Rock,0,2,2,4,858
10578,2023-01-01,CROW,hotZone,Quarter Pounder,0,10,1,11,1188
10579,2023-01-01,CROW,heist,Bridge Too Far,0,1,0,1,462
10580,2023-01-01,CROW,gemGrab,Hard Rock Mine,0,1,0,1,48
10581,2023-01-01,CROW,gemGrab,Double Swoosh,0,26,18,44,1140
10582,2023-01-01,CROW,brawlBall,Backyard Bowl,2,98,95,195,2658
10583,2023-01-01,CROW,bounty,Canal Grande,0,2,0,2,132
10584,2022-12-31,CROW,hotZone,Controller Chaos,0,2,0,2,198
10585,2022-12-31,CROW,gemGrab,Hard Rock Mine,0,8,5,13,384
10586,2022-12-31,CROW,gemGrab,Deep Diner,0,10,2,12,306
10587,2022-12-31,CROW,brawlBall,Super Beach,0,2,3,5,618
10588,2022-12-31,CROW,brawlBall,Sneaky Fields,0,0,1,1,60
10589,2022-12-30,CROW,knockout,Flaring Phoenix,0,0,1,1,72
10590,2022-12-30,CROW,hotZone,Controller Chaos,0,7,0,7,288
10591,2022-12-30,CROW,gemGrab,Undermine,0,5,1,6,102
10592,2022-12-30,CROW,gemGrab,Minecart Madness,0,0,1,1,24
10593,2022-12-30,CROW,gemGrab,Deep Diner,0,4,1,5,438
10594,2022-12-30,CROW,brawlBall,Sneaky Fields,0,3,1,4,552
10595,2022-12-29,CROW,hotZone,Open Zone,0,1,5,6,54
10596,2022-12-29,CROW,gemGrab,Undermine,0,2,0,2,102
10597,2022-12-29,CROW,gemGrab,Gem Fort,0,1,1,2,30
10598,2022-12-29,CROW,brawlBall,Pinhole Punt,0,8,4,12,282
10599,2022-12-28,CROW,hotZone,Open Zone,0,8,5,13,108
10600,2022-12-27,CROW,knockout,New Perspective,0,1,0,1,30
10601,2022-12-27,CROW,hotZone,Controller Chaos,0,1,0,1,24
10602,2022-12-27,CROW,gemGrab,Minecart Madness,0,2,0,2,30
10603,2022-12-27,CROW,brawlBall,Beach Ball,0,0,1,1,144
10604,2022-12-26,CROW,gemGrab,Minecart Madness,0,1,1,2,60
10605,2022-12-26,CROW,brawlBall,Center Stage,0,1,0,1,78
10606,2022-12-25,CROW,gemGrab,Double Swoosh,0,1,2,3,30
10607,2022-12-25,CROW,brawlBall,Backyard Bowl,0,3,0,3,78
10608,2022-12-24,CROW,brawlBall,Super Beach,0,0,1,1,48
10609,2022-12-24,CROW,bounty,Dry Season,0,0,1,1,12
10610,2022-12-23,CROW,knockout,Out in the Open,0,5,0,5,132
10611,2022-12-22,CROW,heist,Kaboom Canyon,0,0,1,1,6
10612,2022-12-22,CROW,gemGrab,Gem Fort,0,5,0,5,90
10613,2022-12-22,CROW,brawlBall,Pinhole Punt,0,4,0,4,132
10614,2022-12-21,CROW,brawlBall,Sunny Soccer,0,0,1,1,54
10615,2022-12-20,CROW,brawlBall,Beach Ball,0,1,0,1,96
10616,2022-12-16,CROW,brawlBall,Sneaky Fields,0,0,2,2,84
10617,2022-12-13,CROW,knockout,New Perspective,0,2,0,2,84
10618,2022-12-13,CROW,heist,Safe Zone,0,1,0,1,42
10619,2022-12-13,CROW,gemGrab,Crystal Arcade,0,0,1,1,72
10620,2022-12-13,CROW,brawlBall,Beach Ball,0,2,1,3,54
10621,2022-12-11,CROW,gemGrab,Double Swoosh,0,0,1,1,12
10622,2022-12-10,CROW,gemGrab,Hard Rock Mine,0,0,1,1,24
10623,2022-11-03,CROW,bounty,Temple Ruins,0,0,1,1,6
10624,2022-11-01,CROW,knockout,New Perspective,0,1,0,1,54
10625,2022-10-30,CROW,knockout,Out in the Open,0,1,0,1,12
10626,2022-10-28,CROW,brawlBall,Beach Ball,0,0,2,2,12
10627,2022-10-28,CROW,bounty,Canal Grande,0,1,0,1,12
10628,2022-10-15,CROW,gemGrab,Hard Rock Mine,0,0,1,1,90
10629,2023-01-28,COLT,knockout,Flaring Phoenix,0,80,77,157,12366
10630,2023-01-28,COLT,hotZone,Controller Chaos,0,35,24,59,10134
10631,2023-01-28,COLT,heist,Bridge Too Far,6,1880,1999,3885,24240
10632,2023-01-28,COLT,gemGrab,Hard Rock Mine,0,78,43,121,16638
10633,2023-01-28,COLT,gemGrab,Deep Diner,0,58,32,90,5478
10634,2023-01-28,COLT,brawlBall,Super Beach,25,844,790,1659,74430
10635,2023-01-28,COLT,brawlBall,Sneaky Fields,0,24,22,46,3582
10636,2023-01-28,COLT,bounty,Canal Grande,0,49,24,73,10902
10637,2023-01-27,COLT,knockout,Flaring Phoenix,0,40,27,67,5928
10638,2023-01-27,COLT,hotZone,Controller Chaos,0,5,4,9,2676
10639,2023-01-27,COLT,heist,Hot Potato,1,112,117,230,3486
10640,2023-01-27,COLT,gemGrab,Undermine,0,9,2,11,942
10641,2023-01-27,COLT,gemGrab,Deep Diner,0,68,37,105,6846
10642,2023-01-27,COLT,brawlBall,Sneaky Fields,8,225,208,441,23514
10643,2023-01-27,COLT,brawlBall,Pinhole Punt,1,13,11,25,738
10644,2023-01-27,COLT,bounty,Temple Ruins,0,19,9,28,1890
10645,2023-01-26,COLT,knockout,Riverside,1,289,234,524,19008
10646,2023-01-26,COLT,hotZone,Open Zone,0,70,52,122,10182
10647,2023-01-26,COLT,heist,Hot Potato,1,681,679,1361,14610
10648,2023-01-26,COLT,gemGrab,Undermine,0,67,40,107,10062
10649,2023-01-26,COLT,gemGrab,Gem Fort,0,45,42,87,4674
10650,2023-01-26,COLT,brawlBall,Sunny Soccer,0,46,39,85,3660
10651,2023-01-26,COLT,brawlBall,Pinhole Punt,27,1003,766,1796,67338
10652,2023-01-26,COLT,bounty,Temple Ruins,0,49,37,86,5610
10653,2023-01-25,COLT,knockout,Riverside,0,132,92,224,9906
10654,2023-01-25,COLT,hotZone,Open Zone,0,36,15,51,5262
10655,2023-01-25,COLT,heist,Safe Zone,0,547,632,1179,9156
10656,2023-01-25,COLT,gemGrab,Gem Fort,0,43,38,81,5556
10657,2023-01-25,COLT,gemGrab,Crystal Arcade,0,75,34,109,7866
10658,2023-01-25,COLT,brawlBall,Sunny Soccer,9,482,414,905,40830
10659,2023-01-25,COLT,brawlBall,Beach Ball,4,57,56,117,6408
10660,2023-01-25,COLT,bounty,Excel,0,39,13,52,5790
10661,2023-01-24,COLT,knockout,New Perspective,0,101,61,162,10542
10662,2023-01-24,COLT,hotZone,Dueling Beetles,0,51,55,106,10662
10663,2023-01-24,COLT,heist,Safe Zone,3,1177,1237,2417,15750
10664,2023-01-24,COLT,gemGrab,Minecart Madness,0,32,44,76,4002
10665,2023-01-24,COLT,gemGrab,Crystal Arcade,0,97,69,166,14460
10666,2023-01-24,COLT,brawlBall,Center Stage,6,109,75,190,7860
10667,2023-01-24,COLT,brawlBall,Beach Ball,30,862,794,1686,64614
10668,2023-01-24,COLT,bounty,Excel,0,74,43,117,10896
10669,2023-01-23,COLT,knockout,New Perspective,0,160,104,264,20676
10670,2023-01-23,COLT,hotZone,Dueling Beetles,1,68,70,139,17502
10671,2023-01-23,COLT,heist,Snaked Assault,4,948,1158,2110,15762
10672,2023-01-23,COLT,gemGrab,Minecart Madness,0,175,115,290,19062
10673,2023-01-23,COLT,gemGrab,Double Swoosh,0,47,53,100,7578
10674,2023-01-23,COLT,brawlBall,Center Stage,29,1121,940,2090,92862
10675,2023-01-23,COLT,brawlBall,Backyard Bowl,5,91,84,180,4224
10676,2023-01-23,COLT,bounty,Layer Cake,0,56,38,94,11142
10677,2023-01-22,COLT,knockout,X Marks the Spot,0,87,84,171,9174
10678,2023-01-22,COLT,hotZone,Ring of Fire,0,26,11,37,5730
10679,2023-01-22,COLT,heist,Snaked Assault,2,545,588,1135,8232
10680,2023-01-22,COLT,gemGrab,Hard Rock Mine,0,32,15,47,4722
10681,2023-01-22,COLT,gemGrab,Double Swoosh,0,30,29,59,9426
10682,2023-01-22,COLT,brawlBall,Super Beach,1,82,65,148,7386
10683,2023-01-22,COLT,brawlBall,Backyard Bowl,24,938,794,1756,34788
10684,2023-01-22,COLT,bounty,Layer Cake,0,28,18,46,6654
10685,2023-01-21,COLT,knockout,X Marks the Spot,0,316,246,562,31698
10686,2023-01-21,COLT,hotZone,Ring of Fire,0,73,26,99,16632
10687,2023-01-21,COLT,heist,Tornado Ring,1,545,558,1104,11664
10688,2023-01-21,COLT,gemGrab,Hard Rock Mine,0,133,71,204,22980
10689,2023-01-21,COLT,gemGrab,Deep Diner,0,40,35,75,4470
10690,2023-01-21,COLT,brawlBall,Super Beach,34,1122,990,2146,101364
10691,2023-01-21,COLT,brawlBall,Sneaky Fields,0,22,24,46,3750
10692,2023-01-21,COLT,bounty,Dry Season,0,150,79,229,14538
10693,2023-01-20,COLT,knockout,Out in the Open,0,214,160,374,20106
10694,2023-01-20,COLT,hotZone,Split,0,31,26,57,9678
10695,2023-01-20,COLT,heist,Tornado Ring,5,656,654,1315,12672
10696,2023-01-20,COLT,gemGrab,Undermine,0,45,22,67,5442
10697,2023-01-20,COLT,gemGrab,Deep Diner,0,163,129,292,19050
10698,2023-01-20,COLT,brawlBall,Sneaky Fields,14,615,463,1092,74778
10699,2023-01-20,COLT,brawlBall,Pinhole Punt,1,42,24,67,2886
10700,2023-01-20,COLT,bounty,Dry Season,0,109,71,180,11640
10701,2023-01-19,COLT,knockout,Out in the Open,0,233,216,449,26574
10702,2023-01-19,COLT,hotZone,Split,0,63,38,101,14856
10703,2023-01-19,COLT,heist,Kaboom Canyon,1,370,390,761,6732
10704,2023-01-19,COLT,gemGrab,Undermine,0,80,64,144,14154
10705,2023-01-19,COLT,gemGrab,Gem Fort,0,34,25,59,2934
10706,2023-01-19,COLT,brawlBall,Sunny Soccer,0,31,22,53,2274
10707,2023-01-19,COLT,brawlBall,Pinhole Punt,23,1109,1011,2143,72498
10708,2023-01-19,COLT,bounty,Shooting Star,0,162,88,250,11124
10709,2023-01-18,COLT,knockout,Goldarm Gulch,0,33,24,57,2784
10710,2023-01-18,COLT,hotZone,Parallel Plays,0,4,4,8,1158
10711,2023-01-18,COLT,heist,Kaboom Canyon,1,182,157,340,2592
10712,2023-01-18,COLT,gemGrab,Gem Fort,0,30,23,53,3006
10713,2023-01-18,COLT,gemGrab,Crystal Arcade,0,10,6,16,990
10714,2023-01-18,COLT,brawlBall,Sunny Soccer,7,204,229,440,18941
10715,2023-01-18,COLT,brawlBall,Beach Ball,0,12,12,24,774
10716,2023-01-18,COLT,bounty,Shooting Star,0,74,48,122,5088
10717,2023-01-17,COLT,knockout,Goldarm Gulch,0,19,15,34,2520
10718,2023-01-17,COLT,hotZone,Parallel Plays,0,6,0,6,1038
10719,2023-01-17,COLT,heist,Pit Stop,0,45,54,99,1290
10720,2023-01-17,COLT,gemGrab,Minecart Madness,0,1,2,3,216
10721,2023-01-17,COLT,gemGrab,Crystal Arcade,0,8,3,11,1266
10722,2023-01-17,COLT,brawlBall,Center Stage,0,3,1,4,288
10723,2023-01-17,COLT,brawlBall,Beach Ball,0,70,56,126,5886
10724,2023-01-17,COLT,bounty,Hideout,0,11,11,22,750
10725,2023-01-16,COLT,knockout,Belle's Rock,0,10,11,21,1788
10726,2023-01-16,COLT,hotZone,Quarter Pounder,0,11,1,12,1494
10727,2023-01-16,COLT,heist,Pit Stop,0,106,93,199,4044
10728,2023-01-16,COLT,gemGrab,Minecart Madness,0,6,4,10,1422
10729,2023-01-16,COLT,gemGrab,Double Swoosh,0,2,1,3,708
10730,2023-01-16,COLT,brawlBall,Center Stage,1,40,28,69,5778
10731,2023-01-16,COLT,brawlBall,Backyard Bowl,0,25,11,36,852
10732,2023-01-16,COLT,bounty,Hideout,0,16,11,27,1470
10733,2023-01-15,COLT,knockout,Belle's Rock,0,21,11,32,2904
10734,2023-01-15,COLT,hotZone,Quarter Pounder,0,10,0,10,3318
10735,2023-01-15,COLT,heist,Bridge Too Far,2,227,220,449,2736
10736,2023-01-15,COLT,gemGrab,Hard Rock Mine,0,3,1,4,1014
10737,2023-01-15,COLT,gemGrab,Double Swoosh,0,6,2,8,2178
10738,2023-01-15,COLT,brawlBall,Super Beach,1,21,14,36,1074
10739,2023-01-15,COLT,brawlBall,Backyard Bowl,7,211,133,351,8946
10740,2023-01-15,COLT,bounty,Canal Grande,0,3,0,3,960
10741,2023-01-14,COLT,knockout,Flaring Phoenix,0,10,1,11,1080
10742,2023-01-14,COLT,hotZone,Controller Chaos,0,6,22,28,2772
10743,2023-01-14,COLT,heist,Bridge Too Far,0,324,255,579,4020
10744,2023-01-14,COLT,gemGrab,Hard Rock Mine,0,4,1,5,1272
10745,2023-01-14,COLT,gemGrab,Deep Diner,0,7,8,15,858
10746,2023-01-14,COLT,brawlBall,Super Beach,3,51,36,90,6336
10747,2023-01-14,COLT,brawlBall,Sneaky Fields,0,9,13,22,918
10748,2023-01-14,COLT,bounty,Canal Grande,0,3,1,4,1014
10749,2023-01-13,COLT,knockout,Flaring Phoenix,0,4,1,5,1182
10750,2023-01-13,COLT,hotZone,Controller Chaos,0,8,8,16,2928
10751,2023-01-13,COLT,heist,Hot Potato,0,28,27,55,600
10752,2023-01-13,COLT,gemGrab,Deep Diner,0,12,13,25,1650
10753,2023-01-13,COLT,brawlBall,Sneaky Fields,0,41,54,95,6144
10754,2023-01-13,COLT,brawlBall,Pinhole Punt,0,3,4,7,156
10755,2023-01-13,COLT,bounty,Temple Ruins,0,3,0,3,270
10756,2023-01-12,COLT,knockout,Riverside,0,41,11,52,2532
10757,2023-01-12,COLT,hotZone,Open Zone,0,9,5,14,1488
10758,2023-01-12,COLT,heist,Hot Potato,0,14,10,24,330
10759,2023-01-12,COLT,gemGrab,Undermine,0,3,2,5,690
10760,2023-01-12,COLT,brawlBall,Sunny Soccer,0,1,2,3,240
10761,2023-01-12,COLT,brawlBall,Pinhole Punt,0,21,15,36,2292
10762,2023-01-11,COLT,knockout,Riverside,0,4,2,6,528
10763,2023-01-11,COLT,hotZone,Open Zone,0,2,1,3,462
10764,2023-01-11,COLT,heist,Safe Zone,0,2,3,5,48
10765,2023-01-11,COLT,gemGrab,Gem Fort,0,1,0,1,414
10766,2023-01-11,COLT,brawlBall,Sunny Soccer,0,15,11,26,1638
10767,2023-01-11,COLT,bounty,Excel,0,2,5,7,282
10768,2023-01-10,COLT,knockout,New Perspective,0,4,2,6,720
10769,2023-01-10,COLT,hotZone,Dueling Beetles,0,6,19,25,2424
10770,2023-01-10,COLT,heist,Safe Zone,0,87,124,211,1176
10771,2023-01-10,COLT,gemGrab,Minecart Madness,0,5,4,9,828
10772,2023-01-10,COLT,gemGrab,Crystal Arcade,0,5,13,18,1746
10773,2023-01-10,COLT,brawlBall,Center Stage,0,5,3,8,708
10774,2023-01-10,COLT,brawlBall,Beach Ball,0,48,21,69,4392
10775,2023-01-10,COLT,bounty,Excel,0,1,1,2,330
10776,2023-01-09,COLT,knockout,New Perspective,0,4,1,5,876
10777,2023-01-09,COLT,hotZone,Dueling Beetles,0,6,2,8,1554
10778,2023-01-09,COLT,heist,Snaked Assault,0,101,105,206,2022
10779,2023-01-09,COLT,gemGrab,Minecart Madness,0,12,8,20,1884
10780,2023-01-09,COLT,gemGrab,Double Swoosh,0,3,0,3,1320
10781,2023-01-09,COLT,brawlBall,Center Stage,0,46,23,69,5460
10782,2023-01-09,COLT,brawlBall,Backyard Bowl,0,18,8,26,474
10783,2023-01-09,COLT,bounty,Layer Cake,0,13,3,16,1512
10784,2023-01-08,COLT,knockout,X Marks the Spot,0,11,11,22,1692
10785,2023-01-08,COLT,hotZone,Ring of Fire,0,4,6,10,1644
10786,2023-01-08,COLT,heist,Snaked Assault,0,96,111,207,1494
10787,2023-01-08,COLT,gemGrab,Hard Rock Mine,0,1,3,4,630
10788,2023-01-08,COLT,gemGrab,Double Swoosh,0,3,0,3,864
10789,2023-01-08,COLT,brawlBall,Super Beach,1,8,4,13,732
10790,2023-01-08,COLT,brawlBall,Backyard Bowl,4,132,146,282,4830
10791,2023-01-08,COLT,bounty,Layer Cake,0,1,0,1,528
10792,2023-01-07,COLT,knockout,X Marks the Spot,0,6,3,9,1014
10793,2023-01-07,COLT,hotZone,Ring of Fire,0,2,0,2,846
10794,2023-01-07,COLT,heist,Tornado Ring,0,48,24,72,1350
10795,2023-01-07,COLT,gemGrab,Hard Rock Mine,0,3,0,3,1158
10796,2023-01-07,COLT,gemGrab,Deep Diner,0,7,3,10,918
10797,2023-01-07,COLT,brawlBall,Super Beach,0,19,24,43,2622
10798,2023-01-07,COLT,brawlBall,Sneaky Fields,0,2,1,3,402
10799,2023-01-07,COLT,bounty,Dry Season,0,13,2,15,1320
10800,2023-01-06,COLT,knockout,Out in the Open,0,16,5,21,1446
10801,2023-01-06,COLT,hotZone,Split,0,6,32,38,1158
10802,2023-01-06,COLT,heist,Tornado Ring,1,148,117,266,2538
10803,2023-01-06,COLT,gemGrab,Undermine,0,5,2,7,540
10804,2023-01-06,COLT,gemGrab,Deep Diner,0,12,5,17,2226
10805,2023-01-06,COLT,brawlBall,Sneaky Fields,0,28,7,35,4896
10806,2023-01-06,COLT,brawlBall,Pinhole Punt,0,8,6,14,510
10807,2023-01-06,COLT,bounty,Dry Season,0,12,6,18,1944
10808,2023-01-05,COLT,knockout,Out in the Open,1,22,20,43,2958
10809,2023-01-05,COLT,hotZone,Split,0,15,33,48,3552
10810,2023-01-05,COLT,heist,Kaboom Canyon,0,48,53,101,954
10811,2023-01-05,COLT,gemGrab,Undermine,0,6,1,7,1812
10812,2023-01-05,COLT,gemGrab,Gem Fort,0,0,2,2,252
10813,2023-01-05,COLT,brawlBall,Sunny Soccer,0,1,0,1,84
10814,2023-01-05,COLT,brawlBall,Pinhole Punt,5,72,59,136,8118
10815,2023-01-05,COLT,bounty,Shooting Star,0,9,4,13,1362
10816,2023-01-04,COLT,knockout,Goldarm Gulch,0,1,0,1,696
10817,2023-01-04,COLT,hotZone,Parallel Plays,0,3,0,3,864
10818,2023-01-04,COLT,heist,Kaboom Canyon,1,101,67,169,1848
10819,2023-01-04,COLT,gemGrab,Gem Fort,0,6,6,12,1788
10820,2023-01-04,COLT,gemGrab,Crystal Arcade,0,6,0,6,642
10821,2023-01-04,COLT,brawlBall,Sunny Soccer,2,44,17,63,6312
10822,2023-01-04,COLT,brawlBall,Beach Ball,0,3,0,3,54
10823,2023-01-04,COLT,bounty,Shooting Star,0,32,9,41,3570
10824,2023-01-03,COLT,knockout,Goldarm Gulch,0,2,2,4,720
10825,2023-01-03,COLT,heist,Pit Stop,0,39,55,94,1956
10826,2023-01-03,COLT,heist,Kaboom Canyon,0,1,2,3,12
10827,2023-01-03,COLT,gemGrab,Minecart Madness,0,2,0,2,456
10828,2023-01-03,COLT,gemGrab,Crystal Arcade,0,15,1,16,2406
10829,2023-01-03,COLT,brawlBall,Center Stage,0,4,2,6,294
10830,2023-01-03,COLT,brawlBall,Beach Ball,1,78,86,165,5580
10831,2023-01-03,COLT,bounty,Hideout,0,22,1,23,1638
10832,2023-01-02,COLT,knockout,Belle's Rock,0,16,15,31,1794
10833,2023-01-02,COLT,hotZone,Quarter Pounder,0,12,4,16,2652
10834,2023-01-02,COLT,hotZone,Controller Chaos,0,2,0,2,18
10835,2023-01-02,COLT,heist,Pit Stop,1,124,126,251,3498
10836,2023-01-02,COLT,heist,Kaboom Canyon,0,1,3,4,30
10837,2023-01-02,COLT,gemGrab,Minecart Madness,0,16,3,19,2352
10838,2023-01-02,COLT,gemGrab,Double Swoosh,0,4,1,5,1512
10839,2023-01-02,COLT,brawlBall,Center Stage,1,62,49,112,7110
10840,2023-01-02,COLT,brawlBall,Backyard Bowl,0,8,7,15,492
10841,2023-01-02,COLT,bounty,Hideout,0,32,12,44,3090
10842,2023-01-01,COLT,knockout,Belle's Rock,0,7,1,8,858
10843,2023-01-01,COLT,hotZone,Quarter Pounder,0,2,2,4,1188
10844,2023-01-01,COLT,heist,Kaboom Canyon,0,0,2,2,12
10845,2023-01-01,COLT,heist,Bridge Too Far,0,35,36,71,462
10846,2023-01-01,COLT,gemGrab,Double Swoosh,0,1,2,3,1140
10847,2023-01-01,COLT,brawlBall,Backyard Bowl,0,46,30,76,2658
10848,2022-12-31,COLT,heist,Kaboom Canyon,0,1,1,2,12
10849,2022-12-31,COLT,heist,Bridge Too Far,0,24,18,42,276
10850,2022-12-31,COLT,gemGrab,Minecart Madness,0,0,2,2,24
10851,2022-12-31,COLT,gemGrab,Deep Diner,0,4,10,14,306
10852,2022-12-31,COLT,brawlBall,Super Beach,0,3,5,8,618
10853,2022-12-30,COLT,heist,Kaboom Canyon,0,1,0,1,18
10854,2022-12-30,COLT,heist,Hot Potato,0,0,2,2,30
10855,2022-12-30,COLT,gemGrab,Undermine,0,1,0,1,102
10856,2022-12-30,COLT,gemGrab,Minecart Madness,0,1,0,1,24
10857,2022-12-30,COLT,gemGrab,Deep Diner,0,2,0,2,438
10858,2022-12-30,COLT,brawlBall,Sneaky Fields,0,6,2,8,552
10859,2022-12-29,COLT,heist,Kaboom Canyon,0,3,1,4,18
10860,2022-12-29,COLT,heist,Hot Potato,0,4,1,5,72
10861,2022-12-29,COLT,brawlBall,Pinhole Punt,0,5,0,5,282
10862,2022-12-28,COLT,brawlBall,Sunny Soccer,0,0,1,1,42
10863,2022-12-27,COLT,knockout,New Perspective,0,0,1,1,30
10864,2022-12-27,COLT,heist,Safe Zone,0,0,1,1,12
10865,2022-12-27,COLT,heist,Kaboom Canyon,0,1,1,2,18
10866,2022-12-27,COLT,gemGrab,Minecart Madness,0,1,0,1,30
10867,2022-12-27,COLT,brawlBall,Beach Ball,0,2,0,2,144
10868,2022-12-26,COLT,heist,Kaboom Canyon,0,1,3,4,36
10869,2022-12-26,COLT,brawlBall,Center Stage,0,1,0,1,78
10870,2022-12-25,COLT,brawlBall,Backyard Bowl,0,4,8,12,78
10871,2022-12-24,COLT,knockout,X Marks the Spot,0,1,0,1,12
10872,2022-12-24,COLT,brawlBall,Super Beach,0,0,1,1,48
10873,2022-12-23,COLT,knockout,Out in the Open,0,1,0,1,132
10874,2022-12-23,COLT,brawlBall,Sneaky Fields,0,0,1,1,12
10875,2022-12-22,COLT,heist,Kaboom Canyon,0,1,0,1,6
10876,2022-12-22,COLT,brawlBall,Pinhole Punt,0,2,0,2,132
10877,2022-12-20,COLT,brawlBall,Beach Ball,1,0,0,1,96
10878,2022-12-19,COLT,brawlBall,Center Stage,0,1,0,1,102
10879,2022-12-18,COLT,heist,Bridge Too Far,0,0,1,1,12
10880,2022-12-16,COLT,brawlBall,Sneaky Fields,0,2,1,3,84
10881,2022-12-16,COLT,bounty,Temple Ruins,0,1,0,1,24
10882,2022-12-13,COLT,heist,Safe Zone,0,4,3,7,42
10883,2022-12-13,COLT,gemGrab,Crystal Arcade,0,1,1,2,72
10884,2022-11-11,COLT,knockout,New Perspective,0,1,0,1,12
10885,2022-11-03,COLT,brawlBall,Pinhole Punt,0,1,1,2,12
10886,2022-11-03,COLT,bounty,Temple Ruins,0,1,0,1,6
10887,2022-11-01,COLT,knockout,New Perspective,0,2,2,4,54
10888,2022-10-30,COLT,heist,Safe Zone,0,0,1,1,6
10889,2022-10-28,COLT,brawlBall,Beach Ball,0,1,0,1,12
10890,2022-10-15,COLT,gemGrab,Hard Rock Mine,0,1,1,2,90
10891,2023-01-28,COLETTE,knockout,Flaring Phoenix,1,22,17,40,12366
10892,2023-01-28,COLETTE,hotZone,Controller Chaos,0,61,67,128,10134
10893,2023-01-28,COLETTE,heist,Bridge Too Far,2,713,761,1476,24240
10894,2023-01-28,COLETTE,gemGrab,Hard Rock Mine,0,49,37,86,16638
10895,2023-01-28,COLETTE,gemGrab,Deep Diner,0,13,14,27,5478
10896,2023-01-28,COLETTE,brawlBall,Super Beach,10,286,354,650,74430
10897,2023-01-28,COLETTE,brawlBall,Sneaky Fields,0,12,15,27,3582
10898,2023-01-28,COLETTE,bounty,Canal Grande,0,10,6,16,10902
10899,2023-01-27,COLETTE,knockout,Flaring Phoenix,0,11,6,17,5928
10900,2023-01-27,COLETTE,hotZone,Controller Chaos,0,11,15,26,2676
10901,2023-01-27,COLETTE,heist,Hot Potato,0,92,102,194,3486
10902,2023-01-27,COLETTE,gemGrab,Undermine,0,3,5,8,942
10903,2023-01-27,COLETTE,gemGrab,Deep Diner,0,22,18,40,6846
10904,2023-01-27,COLETTE,brawlBall,Sneaky Fields,3,99,85,187,23514
10905,2023-01-27,COLETTE,brawlBall,Pinhole Punt,0,2,3,5,738
10906,2023-01-27,COLETTE,bounty,Temple Ruins,0,5,4,9,1890
10907,2023-01-26,COLETTE,knockout,Riverside,1,34,25,60,19008
10908,2023-01-26,COLETTE,hotZone,Open Zone,0,44,29,73,10182
10909,2023-01-26,COLETTE,heist,Hot Potato,0,189,191,380,14610
10910,2023-01-26,COLETTE,gemGrab,Undermine,0,46,53,99,10062
10911,2023-01-26,COLETTE,gemGrab,Gem Fort,0,10,14,24,4674
10912,2023-01-26,COLETTE,brawlBall,Sunny Soccer,0,15,10,25,3660
10913,2023-01-26,COLETTE,brawlBall,Pinhole Punt,21,466,479,966,67338
10914,2023-01-26,COLETTE,bounty,Temple Ruins,0,20,16,36,5610
10915,2023-01-25,COLETTE,knockout,Riverside,0,22,12,34,9906
10916,2023-01-25,COLETTE,hotZone,Open Zone,0,17,22,39,5262
10917,2023-01-25,COLETTE,heist,Safe Zone,1,313,428,742,9156
10918,2023-01-25,COLETTE,gemGrab,Gem Fort,0,14,11,25,5556
10919,2023-01-25,COLETTE,gemGrab,Crystal Arcade,0,24,17,41,7866
10920,2023-01-25,COLETTE,brawlBall,Sunny Soccer,7,149,204,360,40830
10921,2023-01-25,COLETTE,brawlBall,Beach Ball,4,26,29,59,6408
10922,2023-01-25,COLETTE,bounty,Excel,0,2,4,6,5790
10923,2023-01-24,COLETTE,knockout,New Perspective,0,22,12,34,10542
10924,2023-01-24,COLETTE,hotZone,Dueling Beetles,0,39,35,74,10662
10925,2023-01-24,COLETTE,heist,Safe Zone,2,540,714,1256,15750
10926,2023-01-24,COLETTE,gemGrab,Minecart Madness,0,11,5,16,4002
10927,2023-01-24,COLETTE,gemGrab,Crystal Arcade,0,45,42,87,14460
10928,2023-01-24,COLETTE,brawlBall,Center Stage,3,45,53,101,7860
10929,2023-01-24,COLETTE,brawlBall,Beach Ball,16,280,319,615,64614
10930,2023-01-24,COLETTE,bounty,Excel,0,8,11,19,10896
10931,2023-01-23,COLETTE,knockout,New Perspective,0,48,34,82,20676
10932,2023-01-23,COLETTE,hotZone,Dueling Beetles,0,27,35,62,17502
10933,2023-01-23,COLETTE,heist,Snaked Assault,2,383,481,866,15762
10934,2023-01-23,COLETTE,gemGrab,Minecart Madness,0,75,114,189,19062
10935,2023-01-23,COLETTE,gemGrab,Double Swoosh,0,21,34,55,7578
10936,2023-01-23,COLETTE,brawlBall,Center Stage,9,422,453,884,92862
10937,2023-01-23,COLETTE,brawlBall,Backyard Bowl,3,21,36,60,4224
10938,2023-01-23,COLETTE,bounty,Layer Cake,0,8,2,10,11142
10939,2023-01-22,COLETTE,knockout,X Marks the Spot,0,13,21,34,9174
10940,2023-01-22,COLETTE,hotZone,Ring of Fire,0,16,24,40,5730
10941,2023-01-22,COLETTE,heist,Snaked Assault,1,139,187,327,8232
10942,2023-01-22,COLETTE,gemGrab,Hard Rock Mine,0,20,13,33,4722
10943,2023-01-22,COLETTE,gemGrab,Double Swoosh,0,23,16,39,9426
10944,2023-01-22,COLETTE,brawlBall,Super Beach,0,17,19,36,7386
10945,2023-01-22,COLETTE,brawlBall,Backyard Bowl,14,260,269,543,34788
10946,2023-01-22,COLETTE,bounty,Layer Cake,0,3,6,9,6654
10947,2023-01-21,COLETTE,knockout,X Marks the Spot,0,45,35,80,31698
10948,2023-01-21,COLETTE,hotZone,Ring of Fire,0,50,80,130,16632
10949,2023-01-21,COLETTE,heist,Tornado Ring,2,110,119,231,11664
10950,2023-01-21,COLETTE,gemGrab,Hard Rock Mine,0,44,43,87,22980
10951,2023-01-21,COLETTE,gemGrab,Deep Diner,0,10,8,18,4470
10952,2023-01-21,COLETTE,brawlBall,Super Beach,13,377,347,737,101364
10953,2023-01-21,COLETTE,brawlBall,Sneaky Fields,0,10,12,22,3750
10954,2023-01-21,COLETTE,bounty,Dry Season,0,25,27,52,14538
10955,2023-01-20,COLETTE,knockout,Out in the Open,0,49,43,92,20106
10956,2023-01-20,COLETTE,hotZone,Split,0,9,12,21,9678
10957,2023-01-20,COLETTE,heist,Tornado Ring,0,138,160,298,12672
10958,2023-01-20,COLETTE,gemGrab,Undermine,0,18,15,33,5442
10959,2023-01-20,COLETTE,gemGrab,Deep Diner,0,35,29,64,19050
10960,2023-01-20,COLETTE,brawlBall,Sneaky Fields,9,260,334,603,74778
10961,2023-01-20,COLETTE,brawlBall,Pinhole Punt,1,19,27,47,2886
10962,2023-01-20,COLETTE,bounty,Dry Season,0,20,14,34,11640
10963,2023-01-19,COLETTE,knockout,Out in the Open,1,72,48,121,26574
10964,2023-01-19,COLETTE,hotZone,Split,0,25,19,44,14856
10965,2023-01-19,COLETTE,heist,Kaboom Canyon,0,245,367,612,6732
10966,2023-01-19,COLETTE,gemGrab,Undermine,0,42,53,95,14154
10967,2023-01-19,COLETTE,gemGrab,Gem Fort,0,4,7,11,2934
10968,2023-01-19,COLETTE,brawlBall,Sunny Soccer,0,9,10,19,2274
10969,2023-01-19,COLETTE,brawlBall,Pinhole Punt,18,445,467,930,72498
10970,2023-01-19,COLETTE,bounty,Shooting Star,0,24,8,32,11124
10971,2023-01-18,COLETTE,knockout,Goldarm Gulch,0,6,9,15,2784
10972,2023-01-18,COLETTE,hotZone,Parallel Plays,0,3,0,3,1158
10973,2023-01-18,COLETTE,heist,Kaboom Canyon,1,130,181,312,2592
10974,2023-01-18,COLETTE,gemGrab,Gem Fort,0,9,9,18,3006
10975,2023-01-18,COLETTE,gemGrab,Crystal Arcade,0,4,4,8,990
10976,2023-01-18,COLETTE,brawlBall,Sunny Soccer,1,89,118,208,18941
10977,2023-01-18,COLETTE,brawlBall,Beach Ball,0,2,5,7,774
10978,2023-01-18,COLETTE,bounty,Shooting Star,0,2,8,10,5088
10979,2023-01-17,COLETTE,knockout,Goldarm Gulch,0,8,6,14,2520
10980,2023-01-17,COLETTE,hotZone,Parallel Plays,0,3,4,7,1038
10981,2023-01-17,COLETTE,heist,Pit Stop,0,7,2,9,1290
10982,2023-01-17,COLETTE,gemGrab,Minecart Madness,0,1,0,1,216
10983,2023-01-17,COLETTE,gemGrab,Crystal Arcade,0,3,4,7,1266
10984,2023-01-17,COLETTE,brawlBall,Center Stage,0,3,5,8,288
10985,2023-01-17,COLETTE,brawlBall,Beach Ball,1,24,27,52,5886
10986,2023-01-17,COLETTE,bounty,Hideout,0,1,1,2,750
10987,2023-01-16,COLETTE,knockout,Belle's Rock,0,2,1,3,1788
10988,2023-01-16,COLETTE,hotZone,Quarter Pounder,0,5,0,5,1494
10989,2023-01-16,COLETTE,heist,Pit Stop,0,7,5,12,4044
10990,2023-01-16,COLETTE,gemGrab,Minecart Madness,0,3,1,4,1422
10991,2023-01-16,COLETTE,brawlBall,Center Stage,2,37,60,99,5778
10992,2023-01-16,COLETTE,brawlBall,Backyard Bowl,0,8,4,12,852
10993,2023-01-16,COLETTE,bounty,Hideout,0,5,3,8,1470
10994,2023-01-15,COLETTE,knockout,Belle's Rock,0,4,8,12,2904
10995,2023-01-15,COLETTE,hotZone,Quarter Pounder,0,5,5,10,3318
10996,2023-01-15,COLETTE,heist,Bridge Too Far,0,68,103,171,2736
10997,2023-01-15,COLETTE,gemGrab,Hard Rock Mine,0,1,0,1,1014
10998,2023-01-15,COLETTE,gemGrab,Double Swoosh,0,6,4,10,2178
10999,2023-01-15,COLETTE,brawlBall,Super Beach,0,2,0,2,1074
11000,2023-01-15,COLETTE,brawlBall,Backyard Bowl,6,48,40,94,8946
11001,2023-01-15,COLETTE,bounty,Canal Grande,0,2,11,13,960
11002,2023-01-14,COLETTE,knockout,Flaring Phoenix,0,4,1,5,1080
11003,2023-01-14,COLETTE,hotZone,Controller Chaos,0,6,5,11,2772
11004,2023-01-14,COLETTE,heist,Bridge Too Far,0,145,196,341,4020
11005,2023-01-14,COLETTE,gemGrab,Hard Rock Mine,0,2,2,4,1272
11006,2023-01-14,COLETTE,brawlBall,Super Beach,0,19,16,35,6336
11007,2023-01-14,COLETTE,brawlBall,Sneaky Fields,0,3,3,6,918
11008,2023-01-14,COLETTE,bounty,Canal Grande,0,1,2,3,1014
11009,2023-01-13,COLETTE,knockout,Flaring Phoenix,0,3,5,8,1182
11010,2023-01-13,COLETTE,hotZone,Controller Chaos,0,9,4,13,2928
11011,2023-01-13,COLETTE,heist,Hot Potato,0,12,9,21,600
11012,2023-01-13,COLETTE,gemGrab,Deep Diner,0,3,1,4,1650
11013,2023-01-13,COLETTE,brawlBall,Sneaky Fields,1,13,11,25,6144
11014,2023-01-13,COLETTE,brawlBall,Pinhole Punt,0,3,0,3,156
11015,2023-01-13,COLETTE,bounty,Temple Ruins,0,0,1,1,270
11016,2023-01-12,COLETTE,knockout,Riverside,0,1,1,2,2532
11017,2023-01-12,COLETTE,hotZone,Open Zone,0,2,0,2,1488
11018,2023-01-12,COLETTE,heist,Hot Potato,0,2,2,4,330
11019,2023-01-12,COLETTE,gemGrab,Undermine,0,1,1,2,690
11020,2023-01-12,COLETTE,gemGrab,Gem Fort,0,1,0,1,162
11021,2023-01-12,COLETTE,brawlBall,Pinhole Punt,0,8,14,22,2292
11022,2023-01-11,COLETTE,hotZone,Open Zone,0,1,5,6,462
11023,2023-01-11,COLETTE,heist,Safe Zone,0,0,2,2,48
11024,2023-01-11,COLETTE,gemGrab,Gem Fort,0,1,0,1,414
11025,2023-01-11,COLETTE,brawlBall,Sunny Soccer,0,4,0,4,1638
11026,2023-01-10,COLETTE,hotZone,Dueling Beetles,0,6,5,11,2424
11027,2023-01-10,COLETTE,heist,Safe Zone,0,41,34,75,1176
11028,2023-01-10,COLETTE,gemGrab,Crystal Arcade,0,2,0,2,1746
11029,2023-01-10,COLETTE,brawlBall,Center Stage,1,4,3,8,708
11030,2023-01-10,COLETTE,brawlBall,Beach Ball,0,15,4,19,4392
11031,2023-01-09,COLETTE,hotZone,Dueling Beetles,0,6,21,27,1554
11032,2023-01-09,COLETTE,heist,Snaked Assault,0,50,52,102,2022
11033,2023-01-09,COLETTE,gemGrab,Minecart Madness,0,4,6,10,1884
11034,2023-01-09,COLETTE,gemGrab,Double Swoosh,0,0,3,3,1320
11035,2023-01-09,COLETTE,brawlBall,Center Stage,1,20,32,53,5460
11036,2023-01-09,COLETTE,brawlBall,Backyard Bowl,0,1,0,1,474
11037,2023-01-08,COLETTE,knockout,X Marks the Spot,0,0,1,1,1692
11038,2023-01-08,COLETTE,hotZone,Ring of Fire,0,4,17,21,1644
11039,2023-01-08,COLETTE,heist,Snaked Assault,0,20,9,29,1494
11040,2023-01-08,COLETTE,gemGrab,Hard Rock Mine,0,0,2,2,630
11041,2023-01-08,COLETTE,gemGrab,Double Swoosh,0,0,2,2,864
11042,2023-01-08,COLETTE,brawlBall,Super Beach,0,2,0,2,732
11043,2023-01-08,COLETTE,brawlBall,Backyard Bowl,1,28,53,82,4830
11044,2023-01-08,COLETTE,bounty,Layer Cake,0,1,0,1,528
11045,2023-01-07,COLETTE,knockout,X Marks the Spot,0,0,2,2,1014
11046,2023-01-07,COLETTE,hotZone,Ring of Fire,0,2,0,2,846
11047,2023-01-07,COLETTE,heist,Tornado Ring,1,19,19,39,1350
11048,2023-01-07,COLETTE,gemGrab,Hard Rock Mine,0,3,5,8,1158
11049,2023-01-07,COLETTE,gemGrab,Deep Diner,0,2,0,2,918
11050,2023-01-07,COLETTE,brawlBall,Super Beach,0,8,3,11,2622
11051,2023-01-06,COLETTE,heist,Tornado Ring,0,17,45,62,2538
11052,2023-01-06,COLETTE,gemGrab,Deep Diner,0,2,2,4,2226
11053,2023-01-06,COLETTE,brawlBall,Sneaky Fields,0,7,6,13,4896
11054,2023-01-06,COLETTE,brawlBall,Pinhole Punt,0,2,0,2,510
11055,2023-01-05,COLETTE,knockout,Out in the Open,0,2,5,7,2958
11056,2023-01-05,COLETTE,hotZone,Split,0,11,21,32,3552
11057,2023-01-05,COLETTE,heist,Kaboom Canyon,0,43,60,103,954
11058,2023-01-05,COLETTE,gemGrab,Undermine,0,3,0,3,1812
11059,2023-01-05,COLETTE,brawlBall,Pinhole Punt,1,19,26,46,8118
11060,2023-01-04,COLETTE,hotZone,Parallel Plays,0,2,4,6,864
11061,2023-01-04,COLETTE,heist,Kaboom Canyon,1,105,178,284,1848
11062,2023-01-04,COLETTE,gemGrab,Gem Fort,0,3,5,8,1788
11063,2023-01-04,COLETTE,gemGrab,Crystal Arcade,0,1,0,1,642
11064,2023-01-04,COLETTE,brawlBall,Sunny Soccer,0,17,36,53,6312
11065,2023-01-03,COLETTE,knockout,Goldarm Gulch,0,1,1,2,720
11066,2023-01-03,COLETTE,hotZone,Parallel Plays,0,5,7,12,1542
11067,2023-01-03,COLETTE,heist,Pit Stop,0,8,3,11,1956
11068,2023-01-03,COLETTE,gemGrab,Crystal Arcade,0,1,2,3,2406
11069,2023-01-03,COLETTE,brawlBall,Center Stage,0,1,1,2,294
11070,2023-01-03,COLETTE,brawlBall,Beach Ball,0,15,45,60,5580
11071,2023-01-03,COLETTE,bounty,Hideout,0,3,0,3,1638
11072,2023-01-02,COLETTE,knockout,Belle's Rock,0,1,1,2,1794
11073,2023-01-02,COLETTE,hotZone,Quarter Pounder,0,6,21,27,2652
11074,2023-01-02,COLETTE,heist,Pit Stop,0,16,7,23,3498
11075,2023-01-02,COLETTE,heist,Kaboom Canyon,0,0,1,1,30
11076,2023-01-02,COLETTE,gemGrab,Minecart Madness,0,5,6,11,2352
11077,2023-01-02,COLETTE,brawlBall,Center Stage,1,17,11,29,7110
11078,2023-01-02,COLETTE,brawlBall,Backyard Bowl,0,1,1,2,492
11079,2023-01-02,COLETTE,bounty,Hideout,0,4,1,5,3090
11080,2023-01-01,COLETTE,knockout,Belle's Rock,0,0,1,1,858
11081,2023-01-01,COLETTE,hotZone,Quarter Pounder,0,2,10,12,1188
11082,2023-01-01,COLETTE,heist,Kaboom Canyon,0,1,0,1,12
11083,2023-01-01,COLETTE,heist,Bridge Too Far,0,17,7,24,462
11084,2023-01-01,COLETTE,gemGrab,Double Swoosh,0,1,1,2,1140
11085,2023-01-01,COLETTE,brawlBall,Backyard Bowl,0,15,2,17,2658
11086,2022-12-31,COLETTE,heist,Kaboom Canyon,0,0,1,1,12
11087,2022-12-31,COLETTE,heist,Bridge Too Far,0,7,11,18,276
11088,2022-12-31,COLETTE,gemGrab,Deep Diner,0,1,0,1,306
11089,2022-12-31,COLETTE,brawlBall,Super Beach,0,3,6,9,618
11090,2022-12-31,COLETTE,brawlBall,Sneaky Fields,0,1,0,1,60
11091,2022-12-30,COLETTE,hotZone,Controller Chaos,0,2,12,14,288
11092,2022-12-30,COLETTE,heist,Hot Potato,0,1,1,2,30
11093,2022-12-30,COLETTE,gemGrab,Undermine,0,1,0,1,102
11094,2022-12-30,COLETTE,gemGrab,Deep Diner,0,1,0,1,438
11095,2022-12-30,COLETTE,brawlBall,Sneaky Fields,0,2,2,4,552
11096,2022-12-29,COLETTE,heist,Kaboom Canyon,0,0,1,1,18
11097,2022-12-29,COLETTE,heist,Hot Potato,0,1,0,1,72
11098,2022-12-29,COLETTE,gemGrab,Minecart Madness,0,1,0,1,24
11099,2022-12-29,COLETTE,brawlBall,Pinhole Punt,0,2,1,3,282
11100,2022-12-27,COLETTE,hotZone,Dueling Beetles,0,1,0,1,36
11101,2022-12-27,COLETTE,heist,Kaboom Canyon,0,0,1,1,18
11102,2022-12-27,COLETTE,brawlBall,Beach Ball,0,1,0,1,144
11103,2022-12-26,COLETTE,heist,Kaboom Canyon,0,0,2,2,36
11104,2022-12-25,COLETTE,brawlBall,Backyard Bowl,0,1,0,1,78
11105,2022-12-24,COLETTE,brawlBall,Super Beach,0,1,1,2,48
11106,2022-12-22,COLETTE,heist,Kaboom Canyon,0,0,1,1,6
11107,2022-12-22,COLETTE,brawlBall,Pinhole Punt,0,1,0,1,132
11108,2022-12-18,COLETTE,heist,Bridge Too Far,0,1,2,3,12
11109,2022-12-16,COLETTE,brawlBall,Sneaky Fields,0,1,0,1,84
11110,2022-12-13,COLETTE,heist,Safe Zone,0,0,1,1,42
11111,2022-10-15,COLETTE,brawlBall,Super Beach,0,1,0,1,12
11112,2023-01-28,CHESTER,knockout,Flaring Phoenix,0,47,54,101,12366
11113,2023-01-28,CHESTER,hotZone,Controller Chaos,0,92,84,176,10134
11114,2023-01-28,CHESTER,heist,Bridge Too Far,1,31,24,56,24240
11115,2023-01-28,CHESTER,gemGrab,Hard Rock Mine,0,91,81,172,16638
11116,2023-01-28,CHESTER,gemGrab,Deep Diner,0,40,43,83,5478
11117,2023-01-28,CHESTER,brawlBall,Super Beach,14,498,546,1058,74430
11118,2023-01-28,CHESTER,brawlBall,Sneaky Fields,3,32,29,64,3582
11119,2023-01-28,CHESTER,bounty,Canal Grande,0,51,67,118,10902
11120,2023-01-27,CHESTER,knockout,Flaring Phoenix,0,46,30,76,5928
11121,2023-01-27,CHESTER,hotZone,Controller Chaos,0,18,26,44,2676
11122,2023-01-27,CHESTER,heist,Hot Potato,0,10,9,19,3486
11123,2023-01-27,CHESTER,gemGrab,Undermine,0,6,6,12,942
11124,2023-01-27,CHESTER,gemGrab,Deep Diner,0,52,58,110,6846
11125,2023-01-27,CHESTER,brawlBall,Sneaky Fields,5,185,197,387,23514
11126,2023-01-27,CHESTER,brawlBall,Pinhole Punt,0,2,13,15,738
11127,2023-01-27,CHESTER,bounty,Temple Ruins,0,20,16,36,1890
11128,2023-01-26,CHESTER,knockout,Riverside,0,61,28,89,19008
11129,2023-01-26,CHESTER,hotZone,Open Zone,0,40,35,75,10182
11130,2023-01-26,CHESTER,heist,Hot Potato,0,28,18,46,14610
11131,2023-01-26,CHESTER,gemGrab,Undermine,0,134,138,272,10062
11132,2023-01-26,CHESTER,gemGrab,Gem Fort,0,67,88,155,4674
11133,2023-01-26,CHESTER,brawlBall,Sunny Soccer,0,37,29,66,3660
11134,2023-01-26,CHESTER,brawlBall,Pinhole Punt,24,646,722,1392,67338
11135,2023-01-26,CHESTER,bounty,Temple Ruins,0,59,87,146,5610
11136,2023-01-25,CHESTER,knockout,Riverside,0,15,10,25,9906
11137,2023-01-25,CHESTER,hotZone,Open Zone,0,36,26,62,5262
11138,2023-01-25,CHESTER,heist,Safe Zone,0,18,9,27,9156
11139,2023-01-25,CHESTER,gemGrab,Gem Fort,0,55,66,121,5556
11140,2023-01-25,CHESTER,gemGrab,Crystal Arcade,0,80,111,191,7866
11141,2023-01-25,CHESTER,brawlBall,Sunny Soccer,16,368,443,827,40830
11142,2023-01-25,CHESTER,brawlBall,Beach Ball,3,66,83,152,6408
11143,2023-01-25,CHESTER,bounty,Excel,0,17,16,33,5790
11144,2023-01-24,CHESTER,knockout,New Perspective,0,71,71,142,10542
11145,2023-01-24,CHESTER,hotZone,Dueling Beetles,0,43,25,68,10662
11146,2023-01-24,CHESTER,heist,Safe Zone,0,25,9,34,15750
11147,2023-01-24,CHESTER,gemGrab,Minecart Madness,0,25,17,42,4002
11148,2023-01-24,CHESTER,gemGrab,Crystal Arcade,0,119,106,225,14460
11149,2023-01-24,CHESTER,brawlBall,Center Stage,1,88,70,159,7860
11150,2023-01-24,CHESTER,brawlBall,Beach Ball,18,588,646,1252,64614
11151,2023-01-24,CHESTER,bounty,Excel,0,40,24,64,10896
11152,2023-01-23,CHESTER,knockout,New Perspective,0,126,80,206,20676
11153,2023-01-23,CHESTER,hotZone,Dueling Beetles,0,79,59,138,17502
11154,2023-01-23,CHESTER,heist,Snaked Assault,1,49,31,81,15762
11155,2023-01-23,CHESTER,gemGrab,Minecart Madness,0,121,139,260,19062
11156,2023-01-23,CHESTER,gemGrab,Double Swoosh,0,74,101,175,7578
11157,2023-01-23,CHESTER,brawlBall,Center Stage,31,985,1060,2076,92862
11158,2023-01-23,CHESTER,brawlBall,Backyard Bowl,2,36,33,71,4224
11159,2023-01-23,CHESTER,bounty,Layer Cake,0,35,34,69,11142
11160,2023-01-22,CHESTER,knockout,X Marks the Spot,0,37,23,60,9174
11161,2023-01-22,CHESTER,hotZone,Ring of Fire,0,15,23,38,5730
11162,2023-01-22,CHESTER,heist,Snaked Assault,0,22,16,38,8232
11163,2023-01-22,CHESTER,gemGrab,Hard Rock Mine,0,35,26,61,4722
11164,2023-01-22,CHESTER,gemGrab,Double Swoosh,0,100,123,223,9426
11165,2023-01-22,CHESTER,brawlBall,Super Beach,2,46,52,100,7386
11166,2023-01-22,CHESTER,brawlBall,Backyard Bowl,12,246,331,589,34788
11167,2023-01-22,CHESTER,bounty,Layer Cake,0,16,9,25,6654
11168,2023-01-21,CHESTER,knockout,X Marks the Spot,1,122,101,224,31698
11169,2023-01-21,CHESTER,hotZone,Ring of Fire,0,68,44,112,16632
11170,2023-01-21,CHESTER,heist,Tornado Ring,0,38,49,87,11664
11171,2023-01-21,CHESTER,gemGrab,Hard Rock Mine,0,155,150,305,22980
11172,2023-01-21,CHESTER,gemGrab,Deep Diner,0,25,24,49,4470
11173,2023-01-21,CHESTER,brawlBall,Super Beach,22,852,770,1644,101364
11174,2023-01-21,CHESTER,brawlBall,Sneaky Fields,1,32,19,52,3750
11175,2023-01-21,CHESTER,bounty,Dry Season,0,40,38,78,14538
11176,2023-01-20,CHESTER,knockout,Out in the Open,0,90,112,202,20106
11177,2023-01-20,CHESTER,hotZone,Split,0,52,58,110,9678
11178,2023-01-20,CHESTER,heist,Tornado Ring,0,48,51,99,12672
11179,2023-01-20,CHESTER,gemGrab,Undermine,0,81,74,155,5442
11180,2023-01-20,CHESTER,gemGrab,Deep Diner,0,159,193,352,19050
11181,2023-01-20,CHESTER,brawlBall,Sneaky Fields,26,676,598,1300,74778
11182,2023-01-20,CHESTER,brawlBall,Pinhole Punt,4,23,29,56,2886
11183,2023-01-20,CHESTER,bounty,Dry Season,0,39,27,66,11640
11184,2023-01-19,CHESTER,knockout,Out in the Open,0,111,56,167,26574
11185,2023-01-19,CHESTER,hotZone,Split,0,95,92,187,14856
11186,2023-01-19,CHESTER,heist,Kaboom Canyon,0,25,21,46,6732
11187,2023-01-19,CHESTER,gemGrab,Undermine,0,128,134,262,14154
11188,2023-01-19,CHESTER,gemGrab,Gem Fort,0,30,22,52,2934
11189,2023-01-19,CHESTER,brawlBall,Sunny Soccer,0,20,13,33,2274
11190,2023-01-19,CHESTER,brawlBall,Pinhole Punt,15,689,722,1426,72498
11191,2023-01-19,CHESTER,bounty,Shooting Star,0,11,13,24,11124
11192,2023-01-18,CHESTER,knockout,Goldarm Gulch,0,28,13,41,2784
11193,2023-01-18,CHESTER,hotZone,Parallel Plays,0,11,31,42,1158
11194,2023-01-18,CHESTER,heist,Kaboom Canyon,0,6,4,10,2592
11195,2023-01-18,CHESTER,gemGrab,Gem Fort,0,39,32,71,3006
11196,2023-01-18,CHESTER,gemGrab,Crystal Arcade,0,20,10,30,990
11197,2023-01-18,CHESTER,brawlBall,Sunny Soccer,2,197,223,422,18941
11198,2023-01-18,CHESTER,brawlBall,Beach Ball,0,8,4,12,774
11199,2023-01-18,CHESTER,bounty,Shooting Star,0,7,7,14,5088
11200,2023-01-17,CHESTER,knockout,Goldarm Gulch,0,29,23,52,2520
11201,2023-01-17,CHESTER,hotZone,Parallel Plays,0,5,12,17,1038
11202,2023-01-17,CHESTER,heist,Pit Stop,0,5,0,5,1290
11203,2023-01-17,CHESTER,gemGrab,Minecart Madness,0,2,0,2,216
11204,2023-01-17,CHESTER,gemGrab,Crystal Arcade,0,8,16,24,1266
11205,2023-01-17,CHESTER,brawlBall,Center Stage,1,6,8,15,288
11206,2023-01-17,CHESTER,brawlBall,Beach Ball,2,79,81,162,5886
11207,2023-01-17,CHESTER,bounty,Hideout,0,2,0,2,750
11208,2023-01-16,CHESTER,knockout,Belle's Rock,0,8,4,12,1788
11209,2023-01-16,CHESTER,hotZone,Quarter Pounder,0,13,16,29,1494
11210,2023-01-16,CHESTER,heist,Pit Stop,0,12,4,16,4044
11211,2023-01-16,CHESTER,gemGrab,Minecart Madness,0,13,10,23,1422
11212,2023-01-16,CHESTER,gemGrab,Double Swoosh,0,12,10,22,708
11213,2023-01-16,CHESTER,brawlBall,Center Stage,1,97,71,169,5778
11214,2023-01-16,CHESTER,brawlBall,Backyard Bowl,0,8,2,10,852
11215,2023-01-16,CHESTER,bounty,Hideout,0,4,21,25,1470
11216,2023-01-15,CHESTER,knockout,Belle's Rock,0,13,4,17,2904
11217,2023-01-15,CHESTER,hotZone,Quarter Pounder,0,64,65,129,3318
11218,2023-01-15,CHESTER,heist,Bridge Too Far,0,7,0,7,2736
11219,2023-01-15,CHESTER,gemGrab,Hard Rock Mine,0,21,36,57,1014
11220,2023-01-15,CHESTER,gemGrab,Double Swoosh,0,27,20,47,2178
11221,2023-01-15,CHESTER,brawlBall,Super Beach,0,18,3,21,1074
11222,2023-01-15,CHESTER,brawlBall,Backyard Bowl,9,93,113,215,8946
11223,2023-01-15,CHESTER,bounty,Canal Grande,0,7,11,18,960
11224,2023-01-14,CHESTER,knockout,Flaring Phoenix,0,12,3,15,1080
11225,2023-01-14,CHESTER,hotZone,Controller Chaos,0,40,48,88,2772
11226,2023-01-14,CHESTER,heist,Bridge Too Far,0,11,1,12,4020
11227,2023-01-14,CHESTER,gemGrab,Hard Rock Mine,0,15,6,21,1272
11228,2023-01-14,CHESTER,gemGrab,Deep Diner,0,5,2,7,858
11229,2023-01-14,CHESTER,brawlBall,Super Beach,3,75,87,165,6336
11230,2023-01-14,CHESTER,brawlBall,Sneaky Fields,0,5,4,9,918
11231,2023-01-14,CHESTER,bounty,Canal Grande,0,14,47,61,1014
11232,2023-01-13,CHESTER,knockout,Flaring Phoenix,0,10,5,15,1182
11233,2023-01-13,CHESTER,hotZone,Controller Chaos,0,33,5,38,2928
11234,2023-01-13,CHESTER,heist,Hot Potato,0,6,0,6,600
11235,2023-01-13,CHESTER,gemGrab,Undermine,0,1,0,1,18
11236,2023-01-13,CHESTER,gemGrab,Deep Diner,0,22,5,27,1650
11237,2023-01-13,CHESTER,brawlBall,Sneaky Fields,2,94,46,142,6144
11238,2023-01-13,CHESTER,brawlBall,Pinhole Punt,0,3,2,5,156
11239,2023-01-13,CHESTER,bounty,Temple Ruins,0,6,1,7,270
11240,2023-01-12,CHESTER,knockout,Riverside,0,19,5,24,2532
11241,2023-01-12,CHESTER,hotZone,Open Zone,0,22,10,32,1488
11242,2023-01-12,CHESTER,heist,Hot Potato,0,1,0,1,330
11243,2023-01-12,CHESTER,gemGrab,Undermine,0,23,21,44,690
11244,2023-01-12,CHESTER,gemGrab,Gem Fort,0,2,6,8,162
11245,2023-01-12,CHESTER,brawlBall,Sunny Soccer,0,8,19,27,240
11246,2023-01-12,CHESTER,brawlBall,Pinhole Punt,3,78,81,162,2292
11247,2023-01-12,CHESTER,bounty,Temple Ruins,0,2,1,3,24
11248,2023-01-11,CHESTER,knockout,Riverside,0,2,0,2,528
11249,2023-01-11,CHESTER,hotZone,Open Zone,0,7,2,9,462
11250,2023-01-11,CHESTER,gemGrab,Gem Fort,0,19,39,58,414
11251,2023-01-11,CHESTER,brawlBall,Sunny Soccer,2,56,44,102,1638
11252,2023-01-11,CHESTER,brawlBall,Beach Ball,0,4,5,9,48
11253,2023-01-11,CHESTER,bounty,Excel,0,2,0,2,282
11254,2023-01-10,CHESTER,knockout,New Perspective,0,24,24,48,720
11255,2023-01-10,CHESTER,hotZone,Dueling Beetles,0,54,38,92,2424
11256,2023-01-10,CHESTER,heist,Safe Zone,0,11,5,16,1176
11257,2023-01-10,CHESTER,gemGrab,Minecart Madness,0,23,22,45,828
11258,2023-01-10,CHESTER,gemGrab,Crystal Arcade,0,60,50,110,1746
11259,2023-01-10,CHESTER,brawlBall,Center Stage,1,32,37,70,708
11260,2023-01-10,CHESTER,brawlBall,Beach Ball,1,207,213,421,4392
11261,2023-01-10,CHESTER,bounty,Excel,0,4,8,12,330
11262,2023-01-09,CHESTER,knockout,New Perspective,0,27,20,47,876
11263,2023-01-09,CHESTER,hotZone,Dueling Beetles,0,35,21,56,1554
11264,2023-01-09,CHESTER,heist,Snaked Assault,0,43,47,90,2022
11265,2023-01-09,CHESTER,gemGrab,Minecart Madness,0,63,98,161,1884
11266,2023-01-09,CHESTER,gemGrab,Double Swoosh,0,68,53,121,1320
11267,2023-01-09,CHESTER,brawlBall,Center Stage,7,271,254,532,5460
11268,2023-01-09,CHESTER,brawlBall,Backyard Bowl,2,16,2,20,474
11269,2023-01-09,CHESTER,bounty,Layer Cake,0,21,19,40,1512
11270,2023-01-08,CHESTER,knockout,X Marks the Spot,0,16,5,21,1692
11271,2023-01-08,CHESTER,hotZone,Ring of Fire,0,48,73,121,1644
11272,2023-01-08,CHESTER,heist,Snaked Assault,0,32,66,98,1494
11273,2023-01-08,CHESTER,gemGrab,Hard Rock Mine,0,23,35,58,630
11274,2023-01-08,CHESTER,gemGrab,Double Swoosh,0,45,39,84,864
11275,2023-01-08,CHESTER,brawlBall,Super Beach,1,26,20,47,732
11276,2023-01-08,CHESTER,brawlBall,Backyard Bowl,4,130,121,255,4830
11277,2023-01-08,CHESTER,bounty,Layer Cake,0,15,18,33,528
11278,2023-01-07,CHESTER,knockout,X Marks the Spot,0,18,18,36,1014
11279,2023-01-07,CHESTER,hotZone,Ring of Fire,0,25,41,66,846
11280,2023-01-07,CHESTER,heist,Tornado Ring,0,29,26,55,1350
11281,2023-01-07,CHESTER,gemGrab,Hard Rock Mine,0,46,42,88,1158
11282,2023-01-07,CHESTER,gemGrab,Deep Diner,0,40,47,87,918
11283,2023-01-07,CHESTER,brawlBall,Super Beach,2,102,107,211,2622
11284,2023-01-07,CHESTER,brawlBall,Sneaky Fields,3,31,20,54,402
11285,2023-01-07,CHESTER,bounty,Dry Season,0,6,4,10,1320
11286,2023-01-06,CHESTER,knockout,Out in the Open,0,13,7,20,1446
11287,2023-01-06,CHESTER,hotZone,Split,0,28,49,77,1158
11288,2023-01-06,CHESTER,heist,Tornado Ring,1,59,56,116,2538
11289,2023-01-06,CHESTER,gemGrab,Undermine,0,37,56,93,540
11290,2023-01-06,CHESTER,gemGrab,Deep Diner,0,82,99,181,2226
11291,2023-01-06,CHESTER,brawlBall,Sneaky Fields,3,221,173,397,4896
11292,2023-01-06,CHESTER,brawlBall,Pinhole Punt,0,30,25,55,510
11293,2023-01-06,CHESTER,bounty,Dry Season,0,16,2,18,1944
11294,2023-01-05,CHESTER,knockout,Out in the Open,0,57,21,78,2958
11295,2023-01-05,CHESTER,hotZone,Split,0,97,70,167,3552
11296,2023-01-05,CHESTER,heist,Kaboom Canyon,0,12,14,26,954
11297,2023-01-05,CHESTER,gemGrab,Undermine,0,103,101,204,1812
11298,2023-01-05,CHESTER,gemGrab,Gem Fort,0,14,11,25,252
11299,2023-01-05,CHESTER,brawlBall,Sunny Soccer,0,4,1,5,84
11300,2023-01-05,CHESTER,brawlBall,Pinhole Punt,11,444,454,909,8118
11301,2023-01-05,CHESTER,bounty,Shooting Star,0,6,0,6,1362
11302,2023-01-04,CHESTER,knockout,Goldarm Gulch,0,18,6,24,696
11303,2023-01-04,CHESTER,hotZone,Parallel Plays,0,51,70,121,864
11304,2023-01-04,CHESTER,heist,Kaboom Canyon,1,28,22,51,1848
11305,2023-01-04,CHESTER,gemGrab,Gem Fort,0,102,91,193,1788
11306,2023-01-04,CHESTER,gemGrab,Crystal Arcade,0,22,14,36,642
11307,2023-01-04,CHESTER,brawlBall,Sunny Soccer,7,307,376,690,6312
11308,2023-01-04,CHESTER,brawlBall,Beach Ball,0,1,0,1,54
11309,2023-01-04,CHESTER,bounty,Shooting Star,0,17,2,19,3570
11310,2023-01-03,CHESTER,knockout,Goldarm Gulch,0,21,22,43,720
11311,2023-01-03,CHESTER,hotZone,Parallel Plays,2,89,106,197,1542
11312,2023-01-03,CHESTER,hotZone,Controller Chaos,0,1,1,2,12
11313,2023-01-03,CHESTER,heist,Pit Stop,0,30,24,54,1956
11314,2023-01-03,CHESTER,heist,Kaboom Canyon,0,1,0,1,12
11315,2023-01-03,CHESTER,gemGrab,Minecart Madness,0,23,24,47,456
11316,2023-01-03,CHESTER,gemGrab,Crystal Arcade,0,119,103,222,2406
11317,2023-01-03,CHESTER,brawlBall,Center Stage,0,12,13,25,294
11318,2023-01-03,CHESTER,brawlBall,Beach Ball,3,266,304,573,5580
11319,2023-01-03,CHESTER,bounty,Hideout,0,13,8,21,1638
11320,2023-01-02,CHESTER,knockout,Belle's Rock,0,18,19,37,1794
11321,2023-01-02,CHESTER,hotZone,Quarter Pounder,1,121,221,343,2652
11322,2023-01-02,CHESTER,hotZone,Controller Chaos,0,1,1,2,18
11323,2023-01-02,CHESTER,heist,Pit Stop,0,26,22,48,3498
11324,2023-01-02,CHESTER,heist,Kaboom Canyon,0,0,1,1,30
11325,2023-01-02,CHESTER,gemGrab,Minecart Madness,0,78,84,162,2352
11326,2023-01-02,CHESTER,gemGrab,Double Swoosh,0,76,93,169,1512
11327,2023-01-02,CHESTER,brawlBall,Center Stage,11,343,416,770,7110
11328,2023-01-02,CHESTER,brawlBall,Backyard Bowl,1,10,21,32,492
11329,2023-01-02,CHESTER,bounty,Hideout,0,26,11,37,3090
11330,2023-01-01,CHESTER,knockout,Belle's Rock,0,8,6,14,858
11331,2023-01-01,CHESTER,hotZone,Quarter Pounder,0,67,82,149,1188
11332,2023-01-01,CHESTER,heist,Bridge Too Far,0,5,0,5,462
11333,2023-01-01,CHESTER,gemGrab,Hard Rock Mine,0,1,2,3,48
11334,2023-01-01,CHESTER,gemGrab,Double Swoosh,0,54,86,140,1140
11335,2023-01-01,CHESTER,brawlBall,Backyard Bowl,3,69,105,177,2658
11336,2023-01-01,CHESTER,bounty,Canal Grande,0,3,11,14,132
11337,2022-12-31,CHESTER,knockout,Flaring Phoenix,0,0,1,1,18
11338,2022-12-31,CHESTER,hotZone,Controller Chaos,0,7,5,12,198
11339,2022-12-31,CHESTER,heist,Bridge Too Far,0,6,2,8,276
11340,2022-12-31,CHESTER,gemGrab,Hard Rock Mine,0,10,23,33,384
11341,2022-12-31,CHESTER,gemGrab,Deep Diner,0,11,2,13,306
11342,2022-12-31,CHESTER,brawlBall,Super Beach,1,22,42,65,618
11343,2022-12-31,CHESTER,brawlBall,Sneaky Fields,0,1,2,3,60
11344,2022-12-31,CHESTER,bounty,Canal Grande,0,2,3,5,54
11345,2022-12-30,CHESTER,knockout,Flaring Phoenix,0,0,1,1,72
11346,2022-12-30,CHESTER,hotZone,Controller Chaos,0,17,41,58,288
11347,2022-12-30,CHESTER,heist,Kaboom Canyon,0,0,2,2,18
11348,2022-12-30,CHESTER,heist,Hot Potato,0,4,1,5,30
11349,2022-12-30,CHESTER,gemGrab,Undermine,0,7,2,9,102
11350,2022-12-30,CHESTER,gemGrab,Minecart Madness,0,1,3,4,24
11351,2022-12-30,CHESTER,gemGrab,Deep Diner,0,21,34,55,438
11352,2022-12-30,CHESTER,brawlBall,Sneaky Fields,2,37,38,77,552
11353,2022-12-29,CHESTER,hotZone,Open Zone,0,4,2,6,54
11354,2022-12-29,CHESTER,hotZone,Controller Chaos,0,0,1,1,12
11355,2022-12-29,CHESTER,heist,Hot Potato,0,1,0,1,72
11356,2022-12-29,CHESTER,gemGrab,Undermine,0,4,1,5,102
11357,2022-12-29,CHESTER,gemGrab,Gem Fort,0,2,1,3,30
11358,2022-12-29,CHESTER,brawlBall,Pinhole Punt,0,14,19,33,282
11359,2022-12-28,CHESTER,hotZone,Open Zone,0,6,11,17,108
11360,2022-12-28,CHESTER,hotZone,Controller Chaos,0,1,1,2,6
11361,2022-12-28,CHESTER,gemGrab,Crystal Arcade,0,1,1,2,6
11362,2022-12-28,CHESTER,brawlBall,Sunny Soccer,0,2,2,4,42
11363,2022-12-28,CHESTER,brawlBall,Beach Ball,0,1,1,2,6
11364,2022-12-27,CHESTER,hotZone,Controller Chaos,0,1,1,2,24
11365,2022-12-27,CHESTER,heist,Safe Zone,0,0,1,1,12
11366,2022-12-27,CHESTER,gemGrab,Minecart Madness,0,1,0,1,30
11367,2022-12-27,CHESTER,brawlBall,Center Stage,0,1,2,3,30
11368,2022-12-27,CHESTER,brawlBall,Beach Ball,0,7,5,12,144
11369,2022-12-26,CHESTER,hotZone,Controller Chaos,0,1,2,3,30
11370,2022-12-26,CHESTER,gemGrab,Minecart Madness,0,3,1,4,60
11371,2022-12-26,CHESTER,brawlBall,Center Stage,0,4,4,8,78
11372,2022-12-25,CHESTER,hotZone,Ring of Fire,0,0,1,1,12
11373,2022-12-25,CHESTER,gemGrab,Double Swoosh,0,3,3,6,30
11374,2022-12-25,CHESTER,brawlBall,Backyard Bowl,0,3,2,5,78
11375,2022-12-24,CHESTER,brawlBall,Super Beach,0,1,3,4,48
11376,2022-12-24,CHESTER,bounty,Dry Season,0,0,1,1,12
11377,2022-12-23,CHESTER,knockout,Out in the Open,0,2,1,3,132
11378,2022-12-23,CHESTER,gemGrab,Deep Diner,0,1,1,2,6
11379,2022-12-23,CHESTER,brawlBall,Sneaky Fields,0,1,0,1,12
11380,2022-12-22,CHESTER,gemGrab,Gem Fort,0,8,14,22,90
11381,2022-12-22,CHESTER,brawlBall,Pinhole Punt,0,0,13,13,132
11382,2022-12-21,CHESTER,brawlBall,Sunny Soccer,0,3,4,7,54
11383,2022-12-20,CHESTER,brawlBall,Beach Ball,2,2,5,9,96
11384,2022-12-19,CHESTER,brawlBall,Center Stage,0,3,9,12,102
11385,2022-12-17,CHESTER,knockout,Flaring Phoenix,0,0,1,1,30
11386,2022-12-17,CHESTER,brawlBall,Super Beach,0,1,1,2,6
11387,2022-12-16,CHESTER,hotZone,Controller Chaos,0,0,1,1,6
11388,2022-12-16,CHESTER,brawlBall,Sneaky Fields,0,5,2,7,84
11389,2022-12-16,CHESTER,bounty,Temple Ruins,0,1,0,1,24
11390,2022-12-13,CHESTER,knockout,New Perspective,0,6,0,6,84
11391,2022-12-13,CHESTER,hotZone,Dueling Beetles,0,0,1,1,6
11392,2022-12-13,CHESTER,heist,Safe Zone,0,1,0,1,42
11393,2022-12-13,CHESTER,gemGrab,Crystal Arcade,0,4,8,12,72
11394,2022-12-13,CHESTER,brawlBall,Beach Ball,0,3,6,9,54
11395,2023-01-28,CARL,knockout,Flaring Phoenix,0,56,51,107,12366
11396,2023-01-28,CARL,hotZone,Controller Chaos,0,36,40,76,10134
11397,2023-01-28,CARL,heist,Bridge Too Far,0,185,135,320,24240
11398,2023-01-28,CARL,gemGrab,Hard Rock Mine,0,175,253,428,16638
11399,2023-01-28,CARL,gemGrab,Deep Diner,0,73,101,174,5478
11400,2023-01-28,CARL,brawlBall,Super Beach,10,387,398,795,74430
11401,2023-01-28,CARL,brawlBall,Sneaky Fields,0,14,19,33,3582
11402,2023-01-28,CARL,bounty,Canal Grande,0,132,184,316,10902
11403,2023-01-27,CARL,knockout,Flaring Phoenix,0,25,13,38,5928
11404,2023-01-27,CARL,hotZone,Controller Chaos,0,19,28,47,2676
11405,2023-01-27,CARL,heist,Hot Potato,0,20,12,32,3486
11406,2023-01-27,CARL,gemGrab,Undermine,0,9,10,19,942
11407,2023-01-27,CARL,gemGrab,Deep Diner,0,59,98,157,6846
11408,2023-01-27,CARL,brawlBall,Sneaky Fields,1,101,92,194,23514
11409,2023-01-27,CARL,brawlBall,Pinhole Punt,0,9,18,27,738
11410,2023-01-27,CARL,bounty,Temple Ruins,0,14,15,29,1890
11411,2023-01-26,CARL,knockout,Riverside,0,118,105,223,19008
11412,2023-01-26,CARL,hotZone,Open Zone,0,86,93,179,10182
11413,2023-01-26,CARL,heist,Hot Potato,0,50,85,135,14610
11414,2023-01-26,CARL,gemGrab,Undermine,0,65,58,123,10062
11415,2023-01-26,CARL,gemGrab,Gem Fort,0,21,15,36,4674
11416,2023-01-26,CARL,brawlBall,Sunny Soccer,0,22,42,64,3660
11417,2023-01-26,CARL,brawlBall,Pinhole Punt,15,556,588,1159,67338
11418,2023-01-26,CARL,bounty,Temple Ruins,0,53,51,104,5610
11419,2023-01-25,CARL,knockout,Riverside,0,47,32,79,9906
11420,2023-01-25,CARL,hotZone,Open Zone,0,43,54,97,5262
11421,2023-01-25,CARL,heist,Safe Zone,1,99,114,214,9156
11422,2023-01-25,CARL,gemGrab,Gem Fort,0,26,23,49,5556
11423,2023-01-25,CARL,gemGrab,Crystal Arcade,0,77,138,215,7866
11424,2023-01-25,CARL,brawlBall,Sunny Soccer,8,272,265,545,40830
11425,2023-01-25,CARL,brawlBall,Beach Ball,1,37,55,93,6408
11426,2023-01-25,CARL,bounty,Excel,0,82,161,243,5790
11427,2023-01-24,CARL,knockout,New Perspective,0,56,36,92,10542
11428,2023-01-24,CARL,hotZone,Dueling Beetles,0,74,83,157,10662
11429,2023-01-24,CARL,heist,Safe Zone,0,163,173,336,15750
11430,2023-01-24,CARL,gemGrab,Minecart Madness,0,61,83,144,4002
11431,2023-01-24,CARL,gemGrab,Crystal Arcade,0,147,220,367,14460
11432,2023-01-24,CARL,brawlBall,Center Stage,2,45,45,92,7860
11433,2023-01-24,CARL,brawlBall,Beach Ball,23,512,610,1145,64614
11434,2023-01-24,CARL,bounty,Excel,0,114,172,286,10896
11435,2023-01-23,CARL,knockout,New Perspective,0,114,123,237,20676
11436,2023-01-23,CARL,hotZone,Dueling Beetles,0,172,232,404,17502
11437,2023-01-23,CARL,heist,Snaked Assault,0,66,34,100,15762
11438,2023-01-23,CARL,gemGrab,Minecart Madness,0,284,375,659,19062
11439,2023-01-23,CARL,gemGrab,Double Swoosh,0,44,58,102,7578
11440,2023-01-23,CARL,brawlBall,Center Stage,9,417,421,847,92862
11441,2023-01-23,CARL,brawlBall,Backyard Bowl,4,39,50,93,4224
11442,2023-01-23,CARL,bounty,Layer Cake,0,97,103,200,11142
11443,2023-01-22,CARL,knockout,X Marks the Spot,0,52,56,108,9174
11444,2023-01-22,CARL,hotZone,Ring of Fire,0,42,65,107,5730
11445,2023-01-22,CARL,heist,Snaked Assault,0,33,27,60,8232
11446,2023-01-22,CARL,gemGrab,Hard Rock Mine,0,45,57,102,4722
11447,2023-01-22,CARL,gemGrab,Double Swoosh,0,43,31,74,9426
11448,2023-01-22,CARL,brawlBall,Super Beach,1,47,58,106,7386
11449,2023-01-22,CARL,brawlBall,Backyard Bowl,10,310,352,672,34788
11450,2023-01-22,CARL,bounty,Layer Cake,0,72,67,139,6654
11451,2023-01-21,CARL,knockout,X Marks the Spot,0,217,160,377,31698
11452,2023-01-21,CARL,hotZone,Ring of Fire,1,129,159,289,16632
11453,2023-01-21,CARL,heist,Tornado Ring,0,37,43,80,11664
11454,2023-01-21,CARL,gemGrab,Hard Rock Mine,0,184,269,453,22980
11455,2023-01-21,CARL,gemGrab,Deep Diner,0,45,76,121,4470
11456,2023-01-21,CARL,brawlBall,Super Beach,16,674,740,1430,101364
11457,2023-01-21,CARL,brawlBall,Sneaky Fields,0,10,6,16,3750
11458,2023-01-21,CARL,bounty,Dry Season,0,106,108,214,14538
11459,2023-01-20,CARL,knockout,Out in the Open,0,174,182,356,20106
11460,2023-01-20,CARL,hotZone,Split,0,15,22,37,9678
11461,2023-01-20,CARL,heist,Tornado Ring,0,61,42,103,12672
11462,2023-01-20,CARL,gemGrab,Undermine,0,29,20,49,5442
11463,2023-01-20,CARL,gemGrab,Deep Diner,0,169,178,347,19050
11464,2023-01-20,CARL,brawlBall,Sneaky Fields,6,272,248,526,74778
11465,2023-01-20,CARL,brawlBall,Pinhole Punt,0,24,17,41,2886
11466,2023-01-20,CARL,bounty,Dry Season,0,79,99,178,11640
11467,2023-01-19,CARL,knockout,Out in the Open,2,265,259,526,26574
11468,2023-01-19,CARL,hotZone,Split,0,26,30,56,14856
11469,2023-01-19,CARL,heist,Kaboom Canyon,1,74,84,159,6732
11470,2023-01-19,CARL,gemGrab,Undermine,0,122,115,237,14154
11471,2023-01-19,CARL,gemGrab,Gem Fort,0,14,13,27,2934
11472,2023-01-19,CARL,brawlBall,Sunny Soccer,0,20,22,42,2274
11473,2023-01-19,CARL,brawlBall,Pinhole Punt,17,637,754,1408,72498
11474,2023-01-19,CARL,bounty,Shooting Star,0,43,32,75,11124
11475,2023-01-18,CARL,knockout,Goldarm Gulch,0,15,9,24,2784
11476,2023-01-18,CARL,hotZone,Parallel Plays,0,4,4,8,1158
11477,2023-01-18,CARL,heist,Kaboom Canyon,0,22,31,53,2592
11478,2023-01-18,CARL,gemGrab,Gem Fort,0,19,7,26,3006
11479,2023-01-18,CARL,gemGrab,Crystal Arcade,0,12,5,17,990
11480,2023-01-18,CARL,brawlBall,Sunny Soccer,6,129,143,278,18941
11481,2023-01-18,CARL,brawlBall,Beach Ball,0,3,2,5,774
11482,2023-01-18,CARL,bounty,Shooting Star,0,12,23,35,5088
11483,2023-01-17,CARL,knockout,Goldarm Gulch,0,20,13,33,2520
11484,2023-01-17,CARL,hotZone,Parallel Plays,0,3,7,10,1038
11485,2023-01-17,CARL,heist,Pit Stop,0,4,1,5,1290
11486,2023-01-17,CARL,gemGrab,Minecart Madness,0,4,10,14,216
11487,2023-01-17,CARL,gemGrab,Crystal Arcade,0,15,18,33,1266
11488,2023-01-17,CARL,brawlBall,Center Stage,0,2,1,3,288
11489,2023-01-17,CARL,brawlBall,Beach Ball,2,56,54,112,5886
11490,2023-01-17,CARL,bounty,Hideout,0,6,5,11,750
11491,2023-01-16,CARL,knockout,Belle's Rock,0,20,19,39,1788
11492,2023-01-16,CARL,hotZone,Quarter Pounder,0,6,15,21,1494
11493,2023-01-16,CARL,heist,Pit Stop,0,19,22,41,4044
11494,2023-01-16,CARL,gemGrab,Minecart Madness,0,23,44,67,1422
11495,2023-01-16,CARL,gemGrab,Double Swoosh,0,3,2,5,708
11496,2023-01-16,CARL,brawlBall,Center Stage,0,25,18,43,5778
11497,2023-01-16,CARL,brawlBall,Backyard Bowl,0,4,3,7,852
11498,2023-01-16,CARL,bounty,Hideout,0,7,13,20,1470
11499,2023-01-15,CARL,knockout,Belle's Rock,0,27,23,50,2904
11500,2023-01-15,CARL,hotZone,Quarter Pounder,0,23,70,93,3318
11501,2023-01-15,CARL,heist,Bridge Too Far,0,17,24,41,2736
11502,2023-01-15,CARL,gemGrab,Hard Rock Mine,0,13,11,24,1014
11503,2023-01-15,CARL,gemGrab,Double Swoosh,0,6,5,11,2178
11504,2023-01-15,CARL,brawlBall,Super Beach,1,9,18,28,1074
11505,2023-01-15,CARL,brawlBall,Backyard Bowl,4,63,113,180,8946
11506,2023-01-15,CARL,bounty,Canal Grande,0,12,31,43,960
11507,2023-01-14,CARL,knockout,Flaring Phoenix,0,4,5,9,1080
11508,2023-01-14,CARL,hotZone,Controller Chaos,0,7,11,18,2772
11509,2023-01-14,CARL,heist,Bridge Too Far,0,30,13,43,4020
11510,2023-01-14,CARL,gemGrab,Hard Rock Mine,0,14,44,58,1272
11511,2023-01-14,CARL,gemGrab,Deep Diner,0,17,15,32,858
11512,2023-01-14,CARL,brawlBall,Super Beach,0,43,42,85,6336
11513,2023-01-14,CARL,brawlBall,Sneaky Fields,0,2,0,2,918
11514,2023-01-14,CARL,bounty,Canal Grande,0,11,9,20,1014
11515,2023-01-13,CARL,knockout,Flaring Phoenix,0,11,29,40,1182
11516,2023-01-13,CARL,hotZone,Controller Chaos,0,15,15,30,2928
11517,2023-01-13,CARL,heist,Hot Potato,0,4,1,5,600
11518,2023-01-13,CARL,gemGrab,Undermine,0,0,1,1,18
11519,2023-01-13,CARL,gemGrab,Deep Diner,0,22,37,59,1650
11520,2023-01-13,CARL,brawlBall,Sneaky Fields,0,17,11,28,6144
11521,2023-01-13,CARL,brawlBall,Pinhole Punt,0,1,2,3,156
11522,2023-01-13,CARL,bounty,Temple Ruins,0,0,4,4,270
11523,2023-01-12,CARL,knockout,Riverside,0,13,13,26,2532
11524,2023-01-12,CARL,hotZone,Open Zone,0,9,28,37,1488
11525,2023-01-12,CARL,heist,Hot Potato,0,0,2,2,330
11526,2023-01-12,CARL,gemGrab,Undermine,0,4,2,6,690
11527,2023-01-12,CARL,brawlBall,Pinhole Punt,1,13,21,35,2292
11528,2023-01-11,CARL,knockout,Riverside,0,2,0,2,528
11529,2023-01-11,CARL,hotZone,Open Zone,0,4,6,10,462
11530,2023-01-11,CARL,gemGrab,Gem Fort,0,2,0,2,414
11531,2023-01-11,CARL,brawlBall,Sunny Soccer,0,8,9,17,1638
11532,2023-01-11,CARL,bounty,Excel,0,2,0,2,282
11533,2023-01-10,CARL,knockout,New Perspective,0,2,4,6,720
11534,2023-01-10,CARL,hotZone,Dueling Beetles,0,30,53,83,2424
11535,2023-01-10,CARL,heist,Safe Zone,0,16,11,27,1176
11536,2023-01-10,CARL,gemGrab,Minecart Madness,0,11,19,30,828
11537,2023-01-10,CARL,gemGrab,Crystal Arcade,0,11,8,19,1746
11538,2023-01-10,CARL,brawlBall,Center Stage,0,5,1,6,708
11539,2023-01-10,CARL,brawlBall,Beach Ball,1,39,55,95,4392
11540,2023-01-10,CARL,bounty,Excel,0,3,12,15,330
11541,2023-01-09,CARL,knockout,New Perspective,0,3,3,6,876
11542,2023-01-09,CARL,hotZone,Dueling Beetles,0,17,24,41,1554
11543,2023-01-09,CARL,heist,Snaked Assault,0,7,3,10,2022
11544,2023-01-09,CARL,gemGrab,Minecart Madness,0,34,44,78,1884
11545,2023-01-09,CARL,gemGrab,Double Swoosh,0,5,3,8,1320
11546,2023-01-09,CARL,brawlBall,Center Stage,0,17,5,22,5460
11547,2023-01-09,CARL,brawlBall,Backyard Bowl,0,3,12,15,474
11548,2023-01-09,CARL,bounty,Layer Cake,0,18,28,46,1512
11549,2023-01-08,CARL,knockout,X Marks the Spot,0,20,11,31,1692
11550,2023-01-08,CARL,hotZone,Ring of Fire,0,6,17,23,1644
11551,2023-01-08,CARL,heist,Snaked Assault,0,5,2,7,1494
11552,2023-01-08,CARL,gemGrab,Hard Rock Mine,0,4,2,6,630
11553,2023-01-08,CARL,gemGrab,Double Swoosh,0,8,4,12,864
11554,2023-01-08,CARL,brawlBall,Super Beach,0,2,6,8,732
11555,2023-01-08,CARL,brawlBall,Backyard Bowl,2,46,53,101,4830
11556,2023-01-08,CARL,bounty,Layer Cake,0,6,1,7,528
11557,2023-01-07,CARL,knockout,X Marks the Spot,0,6,8,14,1014
11558,2023-01-07,CARL,hotZone,Ring of Fire,0,5,1,6,846
11559,2023-01-07,CARL,heist,Tornado Ring,0,5,0,5,1350
11560,2023-01-07,CARL,gemGrab,Hard Rock Mine,0,18,14,32,1158
11561,2023-01-07,CARL,gemGrab,Deep Diner,0,7,6,13,918
11562,2023-01-07,CARL,brawlBall,Super Beach,0,16,15,31,2622
11563,2023-01-07,CARL,brawlBall,Sneaky Fields,0,1,0,1,402
11564,2023-01-07,CARL,bounty,Dry Season,0,19,32,51,1320
11565,2023-01-06,CARL,knockout,Out in the Open,0,17,6,23,1446
11566,2023-01-06,CARL,hotZone,Split,0,1,1,2,1158
11567,2023-01-06,CARL,heist,Tornado Ring,0,1,1,2,2538
11568,2023-01-06,CARL,gemGrab,Undermine,0,4,5,9,540
11569,2023-01-06,CARL,gemGrab,Deep Diner,0,32,44,76,2226
11570,2023-01-06,CARL,brawlBall,Sneaky Fields,0,12,15,27,4896
11571,2023-01-06,CARL,brawlBall,Pinhole Punt,0,6,7,13,510
11572,2023-01-06,CARL,bounty,Dry Season,0,29,44,73,1944
11573,2023-01-05,CARL,knockout,Out in the Open,0,39,15,54,2958
11574,2023-01-05,CARL,hotZone,Split,0,5,1,6,3552
11575,2023-01-05,CARL,heist,Kaboom Canyon,0,10,15,25,954
11576,2023-01-05,CARL,gemGrab,Undermine,0,17,36,53,1812
11577,2023-01-05,CARL,gemGrab,Gem Fort,0,0,1,1,252
11578,2023-01-05,CARL,brawlBall,Sunny Soccer,0,0,1,1,84
11579,2023-01-05,CARL,brawlBall,Pinhole Punt,3,102,121,226,8118
11580,2023-01-05,CARL,bounty,Shooting Star,0,3,3,6,1362
11581,2023-01-04,CARL,knockout,Goldarm Gulch,0,2,3,5,696
11582,2023-01-04,CARL,hotZone,Parallel Plays,0,5,0,5,864
11583,2023-01-04,CARL,heist,Kaboom Canyon,0,15,15,30,1848
11584,2023-01-04,CARL,gemGrab,Gem Fort,0,16,49,65,1788
11585,2023-01-04,CARL,gemGrab,Crystal Arcade,0,5,24,29,642
11586,2023-01-04,CARL,brawlBall,Sunny Soccer,2,68,141,211,6312
11587,2023-01-04,CARL,brawlBall,Beach Ball,0,0,7,7,54
11588,2023-01-04,CARL,bounty,Shooting Star,0,12,5,17,3570
11589,2023-01-03,CARL,knockout,Goldarm Gulch,0,5,2,7,720
11590,2023-01-03,CARL,hotZone,Parallel Plays,0,11,5,16,1542
11591,2023-01-03,CARL,hotZone,Controller Chaos,0,0,1,1,12
11592,2023-01-03,CARL,heist,Pit Stop,0,8,19,27,1956
11593,2023-01-03,CARL,gemGrab,Minecart Madness,0,3,6,9,456
11594,2023-01-03,CARL,gemGrab,Crystal Arcade,0,29,59,88,2406
11595,2023-01-03,CARL,brawlBall,Center Stage,0,1,6,7,294
11596,2023-01-03,CARL,brawlBall,Beach Ball,0,55,72,127,5580
11597,2023-01-03,CARL,bounty,Hideout,0,10,14,24,1638
11598,2023-01-02,CARL,knockout,Belle's Rock,0,25,32,57,1794
11599,2023-01-02,CARL,hotZone,Quarter Pounder,1,18,31,50,2652
11600,2023-01-02,CARL,heist,Pit Stop,0,14,10,24,3498
11601,2023-01-02,CARL,gemGrab,Minecart Madness,0,40,30,70,2352
11602,2023-01-02,CARL,gemGrab,Double Swoosh,0,7,2,9,1512
11603,2023-01-02,CARL,brawlBall,Center Stage,0,39,27,66,7110
11604,2023-01-02,CARL,brawlBall,Backyard Bowl,0,1,11,12,492
11605,2023-01-02,CARL,bounty,Hideout,0,20,3,23,3090
11606,2023-01-01,CARL,knockout,Belle's Rock,0,15,6,21,858
11607,2023-01-01,CARL,hotZone,Quarter Pounder,0,8,5,13,1188
11608,2023-01-01,CARL,heist,Bridge Too Far,0,1,2,3,462
11609,2023-01-01,CARL,gemGrab,Minecart Madness,0,1,0,1,12
11610,2023-01-01,CARL,gemGrab,Hard Rock Mine,0,0,1,1,48
11611,2023-01-01,CARL,gemGrab,Double Swoosh,0,12,14,26,1140
11612,2023-01-01,CARL,brawlBall,Backyard Bowl,1,34,8,43,2658
11613,2023-01-01,CARL,bounty,Canal Grande,0,4,0,4,132
11614,2022-12-31,CARL,knockout,Flaring Phoenix,0,0,1,1,18
11615,2022-12-31,CARL,heist,Bridge Too Far,0,1,0,1,276
11616,2022-12-31,CARL,gemGrab,Hard Rock Mine,0,7,9,16,384
11617,2022-12-31,CARL,gemGrab,Deep Diner,0,2,0,2,306
11618,2022-12-31,CARL,brawlBall,Super Beach,0,3,0,3,618
11619,2022-12-31,CARL,bounty,Canal Grande,0,0,2,2,54
11620,2022-12-30,CARL,knockout,Flaring Phoenix,0,1,0,1,72
11621,2022-12-30,CARL,gemGrab,Deep Diner,0,9,12,21,438
11622,2022-12-30,CARL,brawlBall,Sneaky Fields,0,1,6,7,552
11623,2022-12-29,CARL,hotZone,Open Zone,0,0,1,1,54
11624,2022-12-29,CARL,hotZone,Controller Chaos,0,1,0,1,12
11625,2022-12-29,CARL,gemGrab,Undermine,0,0,1,1,102
11626,2022-12-29,CARL,brawlBall,Pinhole Punt,0,0,3,3,282
11627,2022-12-28,CARL,hotZone,Open Zone,0,2,0,2,108
11628,2022-12-28,CARL,brawlBall,Sunny Soccer,0,0,1,1,42
11629,2022-12-27,CARL,hotZone,Dueling Beetles,0,1,0,1,36
11630,2022-12-27,CARL,heist,Kaboom Canyon,0,0,1,1,18
11631,2022-12-27,CARL,gemGrab,Minecart Madness,0,1,1,2,30
11632,2022-12-27,CARL,brawlBall,Center Stage,0,0,1,1,30
11633,2022-12-27,CARL,brawlBall,Beach Ball,0,2,1,3,144
11634,2022-12-25,CARL,brawlBall,Backyard Bowl,0,1,0,1,78
11635,2022-12-25,CARL,bounty,Layer Cake,0,0,1,1,12
11636,2022-12-23,CARL,knockout,Out in the Open,0,5,6,11,132
11637,2022-12-22,CARL,brawlBall,Pinhole Punt,0,1,0,1,132
11638,2022-12-19,CARL,brawlBall,Center Stage,0,1,0,1,102
11639,2022-12-18,CARL,knockout,Belle's Rock,0,0,1,1,6
11640,2022-12-13,CARL,knockout,New Perspective,0,1,0,1,84
11641,2022-12-13,CARL,gemGrab,Crystal Arcade,0,1,0,1,72
11642,2022-12-13,CARL,brawlBall,Beach Ball,0,1,0,1,54
11643,2022-12-11,CARL,brawlBall,Backyard Bowl,0,0,1,1,24
11644,2022-12-10,CARL,knockout,X Marks the Spot,0,1,1,2,12
11645,2022-12-10,CARL,hotZone,Ring of Fire,0,1,0,1,6
11646,2022-12-10,CARL,gemGrab,Hard Rock Mine,0,0,1,1,24
11647,2022-11-11,CARL,knockout,New Perspective,0,1,0,1,12
11648,2022-11-11,CARL,brawlBall,Sneaky Fields,0,1,0,1,42
11649,2022-10-28,CARL,knockout,Out in the Open,0,3,1,4,18
11650,2022-10-28,CARL,hotZone,Dueling Beetles,0,0,2,2,12
11651,2022-10-28,CARL,heist,Safe Zone,0,0,1,1,6
11652,2022-10-10,CARL,knockout,Belle's Rock,0,0,1,1,48
11653,2023-01-28,BYRON,knockout,Flaring Phoenix,0,60,43,103,12366
11654,2023-01-28,BYRON,hotZone,Controller Chaos,0,19,7,26,10134
11655,2023-01-28,BYRON,heist,Bridge Too Far,2,180,138,320,24240
11656,2023-01-28,BYRON,gemGrab,Hard Rock Mine,0,69,57,126,16638
11657,2023-01-28,BYRON,gemGrab,Deep Diner,0,46,49,95,5478
11658,2023-01-28,BYRON,brawlBall,Super Beach,0,89,83,172,74430
11659,2023-01-28,BYRON,brawlBall,Sneaky Fields,0,4,5,9,3582
11660,2023-01-28,BYRON,bounty,Canal Grande,0,36,31,67,10902
11661,2023-01-27,BYRON,knockout,Flaring Phoenix,0,25,23,48,5928
11662,2023-01-27,BYRON,hotZone,Controller Chaos,0,11,3,14,2676
11663,2023-01-27,BYRON,heist,Hot Potato,0,3,0,3,3486
11664,2023-01-27,BYRON,gemGrab,Undermine,0,2,4,6,942
11665,2023-01-27,BYRON,gemGrab,Deep Diner,0,41,37,78,6846
11666,2023-01-27,BYRON,brawlBall,Sneaky Fields,0,41,36,77,23514
11667,2023-01-27,BYRON,brawlBall,Pinhole Punt,0,1,2,3,738
11668,2023-01-27,BYRON,bounty,Temple Ruins,0,24,19,43,1890
11669,2023-01-26,BYRON,knockout,Riverside,0,266,261,527,19008
11670,2023-01-26,BYRON,hotZone,Open Zone,0,57,52,109,10182
11671,2023-01-26,BYRON,heist,Hot Potato,0,9,4,13,14610
11672,2023-01-26,BYRON,gemGrab,Undermine,0,57,33,90,10062
11673,2023-01-26,BYRON,gemGrab,Gem Fort,0,13,10,23,4674
11674,2023-01-26,BYRON,brawlBall,Sunny Soccer,0,8,10,18,3660
11675,2023-01-26,BYRON,brawlBall,Pinhole Punt,7,232,194,433,67338
11676,2023-01-26,BYRON,bounty,Temple Ruins,0,44,39,83,5610
11677,2023-01-25,BYRON,knockout,Riverside,0,129,132,261,9906
11678,2023-01-25,BYRON,hotZone,Open Zone,0,24,14,38,5262
11679,2023-01-25,BYRON,heist,Safe Zone,0,47,39,86,9156
11680,2023-01-25,BYRON,gemGrab,Gem Fort,0,12,11,23,5556
11681,2023-01-25,BYRON,gemGrab,Crystal Arcade,0,54,47,101,7866
11682,2023-01-25,BYRON,brawlBall,Sunny Soccer,1,65,57,123,40830
11683,2023-01-25,BYRON,brawlBall,Beach Ball,3,18,12,33,6408
11684,2023-01-25,BYRON,bounty,Excel,0,18,24,42,5790
11685,2023-01-24,BYRON,knockout,New Perspective,0,86,60,146,10542
11686,2023-01-24,BYRON,hotZone,Dueling Beetles,0,22,15,37,10662
11687,2023-01-24,BYRON,heist,Safe Zone,1,74,58,133,15750
11688,2023-01-24,BYRON,gemGrab,Minecart Madness,0,33,24,57,4002
11689,2023-01-24,BYRON,gemGrab,Crystal Arcade,0,62,74,136,14460
11690,2023-01-24,BYRON,brawlBall,Center Stage,1,7,4,12,7860
11691,2023-01-24,BYRON,brawlBall,Beach Ball,2,106,70,178,64614
11692,2023-01-24,BYRON,bounty,Excel,0,50,38,88,10896
11693,2023-01-23,BYRON,knockout,New Perspective,0,118,72,190,20676
11694,2023-01-23,BYRON,hotZone,Dueling Beetles,0,28,25,53,17502
11695,2023-01-23,BYRON,heist,Snaked Assault,0,11,6,17,15762
11696,2023-01-23,BYRON,gemGrab,Minecart Madness,0,136,102,238,19062
11697,2023-01-23,BYRON,gemGrab,Double Swoosh,0,30,13,43,7578
11698,2023-01-23,BYRON,brawlBall,Center Stage,7,103,112,222,92862
11699,2023-01-23,BYRON,brawlBall,Backyard Bowl,1,14,19,34,4224
11700,2023-01-23,BYRON,bounty,Layer Cake,0,29,24,53,11142
11701,2023-01-22,BYRON,knockout,X Marks the Spot,0,61,52,113,9174
11702,2023-01-22,BYRON,hotZone,Ring of Fire,0,17,5,22,5730
11703,2023-01-22,BYRON,heist,Snaked Assault,0,7,0,7,8232
11704,2023-01-22,BYRON,gemGrab,Hard Rock Mine,0,17,4,21,4722
11705,2023-01-22,BYRON,gemGrab,Double Swoosh,0,16,11,27,9426
11706,2023-01-22,BYRON,brawlBall,Super Beach,1,6,3,10,7386
11707,2023-01-22,BYRON,brawlBall,Backyard Bowl,16,215,238,469,34788
11708,2023-01-22,BYRON,bounty,Layer Cake,0,15,12,27,6654
11709,2023-01-21,BYRON,knockout,X Marks the Spot,2,156,126,284,31698
11710,2023-01-21,BYRON,hotZone,Ring of Fire,0,59,32,91,16632
11711,2023-01-21,BYRON,heist,Tornado Ring,0,13,6,19,11664
11712,2023-01-21,BYRON,gemGrab,Hard Rock Mine,0,75,91,166,22980
11713,2023-01-21,BYRON,gemGrab,Deep Diner,0,19,17,36,4470
11714,2023-01-21,BYRON,brawlBall,Super Beach,6,133,138,277,101364
11715,2023-01-21,BYRON,brawlBall,Sneaky Fields,0,1,2,3,3750
11716,2023-01-21,BYRON,bounty,Dry Season,0,183,195,378,14538
11717,2023-01-20,BYRON,knockout,Out in the Open,0,170,112,282,20106
11718,2023-01-20,BYRON,hotZone,Split,0,12,3,15,9678
11719,2023-01-20,BYRON,heist,Tornado Ring,0,6,1,7,12672
11720,2023-01-20,BYRON,gemGrab,Undermine,0,48,22,70,5442
11721,2023-01-20,BYRON,gemGrab,Deep Diner,0,145,95,240,19050
11722,2023-01-20,BYRON,brawlBall,Sneaky Fields,4,95,71,170,74778
11723,2023-01-20,BYRON,brawlBall,Pinhole Punt,0,7,5,12,2886
11724,2023-01-20,BYRON,bounty,Dry Season,0,123,96,219,11640
11725,2023-01-19,BYRON,knockout,Out in the Open,0,191,186,377,26574
11726,2023-01-19,BYRON,hotZone,Split,0,23,14,37,14856
11727,2023-01-19,BYRON,heist,Kaboom Canyon,1,36,56,93,6732
11728,2023-01-19,BYRON,gemGrab,Undermine,0,77,51,128,14154
11729,2023-01-19,BYRON,gemGrab,Gem Fort,0,13,10,23,2934
11730,2023-01-19,BYRON,brawlBall,Sunny Soccer,0,6,2,8,2274
11731,2023-01-19,BYRON,brawlBall,Pinhole Punt,6,238,186,430,72498
11732,2023-01-19,BYRON,bounty,Shooting Star,0,166,147,313,11124
11733,2023-01-18,BYRON,knockout,Goldarm Gulch,0,16,10,26,2784
11734,2023-01-18,BYRON,hotZone,Parallel Plays,0,1,3,4,1158
11735,2023-01-18,BYRON,heist,Kaboom Canyon,0,14,19,33,2592
11736,2023-01-18,BYRON,gemGrab,Gem Fort,0,14,11,25,3006
11737,2023-01-18,BYRON,gemGrab,Crystal Arcade,0,11,4,15,990
11738,2023-01-18,BYRON,brawlBall,Sunny Soccer,0,27,12,39,18941
11739,2023-01-18,BYRON,brawlBall,Beach Ball,0,1,1,2,774
11740,2023-01-18,BYRON,bounty,Shooting Star,0,60,91,151,5088
11741,2023-01-17,BYRON,knockout,Goldarm Gulch,0,7,6,13,2520
11742,2023-01-17,BYRON,hotZone,Parallel Plays,0,7,5,12,1038
11743,2023-01-17,BYRON,heist,Pit Stop,0,1,0,1,1290
11744,2023-01-17,BYRON,gemGrab,Minecart Madness,0,4,1,5,216
11745,2023-01-17,BYRON,gemGrab,Crystal Arcade,0,5,3,8,1266
11746,2023-01-17,BYRON,brawlBall,Beach Ball,1,13,4,18,5886
11747,2023-01-17,BYRON,bounty,Hideout,0,8,3,11,750
11748,2023-01-16,BYRON,knockout,Belle's Rock,0,13,30,43,1788
11749,2023-01-16,BYRON,hotZone,Quarter Pounder,0,7,8,15,1494
11750,2023-01-16,BYRON,gemGrab,Minecart Madness,0,9,8,17,1422
11751,2023-01-16,BYRON,gemGrab,Double Swoosh,0,0,1,1,708
11752,2023-01-16,BYRON,brawlBall,Center Stage,0,2,4,6,5778
11753,2023-01-16,BYRON,brawlBall,Backyard Bowl,0,3,15,18,852
11754,2023-01-16,BYRON,bounty,Hideout,0,14,11,25,1470
11755,2023-01-15,BYRON,knockout,Belle's Rock,0,3,8,11,2904
11756,2023-01-15,BYRON,hotZone,Quarter Pounder,0,3,21,24,3318
11757,2023-01-15,BYRON,heist,Bridge Too Far,0,10,15,25,2736
11758,2023-01-15,BYRON,gemGrab,Hard Rock Mine,0,6,17,23,1014
11759,2023-01-15,BYRON,gemGrab,Double Swoosh,0,2,2,4,2178
11760,2023-01-15,BYRON,brawlBall,Backyard Bowl,2,36,21,59,8946
11761,2023-01-15,BYRON,bounty,Canal Grande,0,0,1,1,960
11762,2023-01-14,BYRON,knockout,Flaring Phoenix,0,10,4,14,1080
11763,2023-01-14,BYRON,hotZone,Controller Chaos,0,4,0,4,2772
11764,2023-01-14,BYRON,heist,Bridge Too Far,0,18,11,29,4020
11765,2023-01-14,BYRON,gemGrab,Hard Rock Mine,0,4,1,5,1272
11766,2023-01-14,BYRON,gemGrab,Deep Diner,0,3,0,3,858
11767,2023-01-14,BYRON,brawlBall,Super Beach,0,18,7,25,6336
11768,2023-01-14,BYRON,brawlBall,Sneaky Fields,0,1,0,1,918
11769,2023-01-13,BYRON,knockout,Flaring Phoenix,0,6,5,11,1182
11770,2023-01-13,BYRON,hotZone,Controller Chaos,0,2,1,3,2928
11771,2023-01-13,BYRON,heist,Hot Potato,0,1,0,1,600
11772,2023-01-13,BYRON,gemGrab,Deep Diner,0,4,3,7,1650
11773,2023-01-13,BYRON,brawlBall,Sneaky Fields,0,15,11,26,6144
11774,2023-01-13,BYRON,bounty,Temple Ruins,0,2,2,4,270
11775,2023-01-12,BYRON,knockout,Riverside,0,23,18,41,2532
11776,2023-01-12,BYRON,hotZone,Open Zone,0,8,18,26,1488
11777,2023-01-12,BYRON,gemGrab,Undermine,0,1,5,6,690
11778,2023-01-12,BYRON,gemGrab,Gem Fort,0,1,0,1,162
11779,2023-01-12,BYRON,brawlBall,Sunny Soccer,0,3,1,4,240
11780,2023-01-12,BYRON,brawlBall,Pinhole Punt,0,2,2,4,2292
11781,2023-01-11,BYRON,knockout,Riverside,0,4,2,6,528
11782,2023-01-11,BYRON,gemGrab,Gem Fort,0,1,0,1,414
11783,2023-01-11,BYRON,brawlBall,Sunny Soccer,0,2,1,3,1638
11784,2023-01-11,BYRON,bounty,Excel,0,2,0,2,282
11785,2023-01-10,BYRON,knockout,New Perspective,0,6,3,9,720
11786,2023-01-10,BYRON,hotZone,Dueling Beetles,0,5,9,14,2424
11787,2023-01-10,BYRON,heist,Safe Zone,0,2,0,2,1176
11788,2023-01-10,BYRON,gemGrab,Minecart Madness,0,7,5,12,828
11789,2023-01-10,BYRON,gemGrab,Crystal Arcade,0,11,30,41,1746
11790,2023-01-10,BYRON,brawlBall,Center Stage,0,1,0,1,708
11791,2023-01-10,BYRON,brawlBall,Beach Ball,0,10,52,62,4392
11792,2023-01-09,BYRON,knockout,New Perspective,0,1,1,2,876
11793,2023-01-09,BYRON,hotZone,Dueling Beetles,0,2,1,3,1554
11794,2023-01-09,BYRON,gemGrab,Minecart Madness,0,20,13,33,1884
11795,2023-01-09,BYRON,gemGrab,Double Swoosh,0,4,1,5,1320
11796,2023-01-09,BYRON,brawlBall,Center Stage,1,6,3,10,5460
11797,2023-01-09,BYRON,brawlBall,Backyard Bowl,0,1,1,2,474
11798,2023-01-09,BYRON,bounty,Layer Cake,0,10,24,34,1512
11799,2023-01-08,BYRON,knockout,X Marks the Spot,0,6,14,20,1692
11800,2023-01-08,BYRON,hotZone,Ring of Fire,0,3,0,3,1644
11801,2023-01-08,BYRON,heist,Snaked Assault,0,1,0,1,1494
11802,2023-01-08,BYRON,brawlBall,Super Beach,0,1,5,6,732
11803,2023-01-08,BYRON,brawlBall,Backyard Bowl,0,17,26,43,4830
11804,2023-01-08,BYRON,bounty,Layer Cake,0,2,0,2,528
11805,2023-01-07,BYRON,knockout,X Marks the Spot,0,3,12,15,1014
11806,2023-01-07,BYRON,gemGrab,Deep Diner,0,1,0,1,918
11807,2023-01-07,BYRON,brawlBall,Super Beach,0,3,20,23,2622
11808,2023-01-07,BYRON,bounty,Dry Season,0,12,10,22,1320
11809,2023-01-06,BYRON,knockout,Out in the Open,0,4,4,8,1446
11810,2023-01-06,BYRON,gemGrab,Undermine,0,1,0,1,540
11811,2023-01-06,BYRON,gemGrab,Deep Diner,0,9,44,53,2226
11812,2023-01-06,BYRON,brawlBall,Sneaky Fields,0,2,2,4,4896
11813,2023-01-06,BYRON,brawlBall,Pinhole Punt,0,1,3,4,510
11814,2023-01-06,BYRON,bounty,Dry Season,0,15,16,31,1944
11815,2023-01-05,BYRON,knockout,Out in the Open,0,8,7,15,2958
11816,2023-01-05,BYRON,hotZone,Split,0,1,1,2,3552
11817,2023-01-05,BYRON,heist,Kaboom Canyon,0,2,2,4,954
11818,2023-01-05,BYRON,gemGrab,Undermine,0,1,1,2,1812
11819,2023-01-05,BYRON,gemGrab,Gem Fort,0,2,0,2,252
11820,2023-01-05,BYRON,brawlBall,Pinhole Punt,1,9,32,42,8118
11821,2023-01-05,BYRON,bounty,Shooting Star,0,7,4,11,1362
11822,2023-01-04,BYRON,knockout,Goldarm Gulch,0,2,0,2,696
11823,2023-01-04,BYRON,heist,Kaboom Canyon,0,7,12,19,1848
11824,2023-01-04,BYRON,gemGrab,Crystal Arcade,0,1,0,1,642
11825,2023-01-04,BYRON,brawlBall,Sunny Soccer,0,3,7,10,6312
11826,2023-01-04,BYRON,bounty,Shooting Star,0,32,41,73,3570
11827,2023-01-03,BYRON,hotZone,Parallel Plays,0,2,11,13,1542
11828,2023-01-03,BYRON,gemGrab,Crystal Arcade,0,1,0,1,2406
11829,2023-01-03,BYRON,brawlBall,Beach Ball,0,4,3,7,5580
11830,2023-01-03,BYRON,bounty,Hideout,0,24,27,51,1638
11831,2023-01-02,BYRON,knockout,Belle's Rock,0,9,10,19,1794
11832,2023-01-02,BYRON,hotZone,Quarter Pounder,1,4,13,18,2652
11833,2023-01-02,BYRON,hotZone,Controller Chaos,0,0,1,1,18
11834,2023-01-02,BYRON,heist,Kaboom Canyon,0,0,1,1,30
11835,2023-01-02,BYRON,gemGrab,Minecart Madness,0,12,39,51,2352
11836,2023-01-02,BYRON,gemGrab,Double Swoosh,0,3,0,3,1512
11837,2023-01-02,BYRON,brawlBall,Center Stage,0,2,3,5,7110
11838,2023-01-02,BYRON,brawlBall,Backyard Bowl,0,3,4,7,492
11839,2023-01-02,BYRON,bounty,Hideout,0,9,3,12,3090
11840,2023-01-01,BYRON,knockout,Belle's Rock,0,7,2,9,858
11841,2023-01-01,BYRON,hotZone,Quarter Pounder,0,2,0,2,1188
11842,2023-01-01,BYRON,heist,Bridge Too Far,0,5,0,5,462
11843,2023-01-01,BYRON,gemGrab,Minecart Madness,0,0,1,1,12
11844,2023-01-01,BYRON,brawlBall,Backyard Bowl,0,11,8,19,2658
11845,2022-12-31,BYRON,heist,Bridge Too Far,0,2,1,3,276
11846,2022-12-31,BYRON,gemGrab,Minecart Madness,0,1,0,1,24
11847,2022-12-31,BYRON,gemGrab,Hard Rock Mine,0,3,14,17,384
11848,2022-12-31,BYRON,gemGrab,Deep Diner,0,0,2,2,306
11849,2022-12-31,BYRON,brawlBall,Super Beach,0,1,0,1,618
11850,2022-12-30,BYRON,gemGrab,Deep Diner,0,1,0,1,438
11851,2022-12-29,BYRON,brawlBall,Pinhole Punt,0,0,1,1,282
11852,2022-12-28,BYRON,hotZone,Open Zone,0,0,1,1,108
11853,2022-12-27,BYRON,hotZone,Dueling Beetles,0,1,0,1,36
11854,2022-12-27,BYRON,gemGrab,Minecart Madness,0,1,0,1,30
11855,2022-12-26,BYRON,gemGrab,Minecart Madness,0,0,1,1,60
11856,2022-12-25,BYRON,brawlBall,Backyard Bowl,0,0,1,1,78
11857,2022-12-23,BYRON,knockout,Out in the Open,0,1,0,1,132
11858,2022-12-13,BYRON,hotZone,Dueling Beetles,0,1,0,1,6
11859,2022-12-13,BYRON,heist,Safe Zone,0,0,1,1,42
11860,2022-12-10,BYRON,knockout,X Marks the Spot,0,0,1,1,12
11861,2022-11-07,BYRON,hotZone,Quarter Pounder,0,0,1,1,24
11862,2022-11-01,BYRON,knockout,New Perspective,0,0,3,3,54
11863,2022-10-26,BYRON,bounty,Shooting Star,0,1,0,1,36
11864,2022-10-15,BYRON,gemGrab,Hard Rock Mine,0,2,0,2,90
11865,2022-10-15,BYRON,brawlBall,Super Beach,0,0,1,1,12
11866,2022-10-10,BYRON,knockout,Belle's Rock,0,1,0,1,48
11867,2023-01-28,BUZZ,knockout,Flaring Phoenix,0,60,46,106,12366
11868,2023-01-28,BUZZ,hotZone,Controller Chaos,0,66,51,117,10134
11869,2023-01-28,BUZZ,heist,Bridge Too Far,0,90,96,186,24240
11870,2023-01-28,BUZZ,gemGrab,Hard Rock Mine,0,163,221,384,16638
11871,2023-01-28,BUZZ,gemGrab,Deep Diner,0,40,34,74,5478
11872,2023-01-28,BUZZ,brawlBall,Super Beach,22,1382,1349,2753,74430
11873,2023-01-28,BUZZ,brawlBall,Sneaky Fields,1,55,57,113,3582
11874,2023-01-28,BUZZ,bounty,Canal Grande,0,126,101,227,10902
11875,2023-01-27,BUZZ,knockout,Flaring Phoenix,0,31,27,58,5928
11876,2023-01-27,BUZZ,hotZone,Controller Chaos,0,18,14,32,2676
11877,2023-01-27,BUZZ,heist,Hot Potato,0,45,32,77,3486
11878,2023-01-27,BUZZ,gemGrab,Undermine,0,8,5,13,942
11879,2023-01-27,BUZZ,gemGrab,Deep Diner,0,47,45,92,6846
11880,2023-01-27,BUZZ,brawlBall,Sneaky Fields,7,523,472,1002,23514
11881,2023-01-27,BUZZ,brawlBall,Pinhole Punt,0,8,7,15,738
11882,2023-01-27,BUZZ,bounty,Temple Ruins,0,13,7,20,1890
11883,2023-01-26,BUZZ,knockout,Riverside,1,51,21,73,19008
11884,2023-01-26,BUZZ,hotZone,Open Zone,0,21,18,39,10182
11885,2023-01-26,BUZZ,heist,Hot Potato,1,159,208,368,14610
11886,2023-01-26,BUZZ,gemGrab,Undermine,0,83,97,180,10062
11887,2023-01-26,BUZZ,gemGrab,Gem Fort,0,55,75,130,4674
11888,2023-01-26,BUZZ,brawlBall,Sunny Soccer,0,64,70,134,3660
11889,2023-01-26,BUZZ,brawlBall,Pinhole Punt,19,996,943,1958,67338
11890,2023-01-26,BUZZ,bounty,Temple Ruins,0,58,48,106,5610
11891,2023-01-25,BUZZ,knockout,Riverside,0,32,11,43,9906
11892,2023-01-25,BUZZ,hotZone,Open Zone,0,11,3,14,5262
11893,2023-01-25,BUZZ,heist,Safe Zone,0,43,54,97,9156
11894,2023-01-25,BUZZ,gemGrab,Gem Fort,0,49,38,87,5556
11895,2023-01-25,BUZZ,gemGrab,Crystal Arcade,0,60,63,123,7866
11896,2023-01-25,BUZZ,brawlBall,Sunny Soccer,19,824,833,1676,40830
11897,2023-01-25,BUZZ,brawlBall,Beach Ball,8,126,128,262,6408
11898,2023-01-25,BUZZ,bounty,Excel,0,35,51,86,5790
11899,2023-01-24,BUZZ,knockout,New Perspective,0,54,46,100,10542
11900,2023-01-24,BUZZ,hotZone,Dueling Beetles,0,44,37,81,10662
11901,2023-01-24,BUZZ,heist,Safe Zone,0,99,79,178,15750
11902,2023-01-24,BUZZ,gemGrab,Minecart Madness,0,16,18,34,4002
11903,2023-01-24,BUZZ,gemGrab,Crystal Arcade,0,139,145,284,14460
11904,2023-01-24,BUZZ,brawlBall,Center Stage,2,154,175,331,7860
11905,2023-01-24,BUZZ,brawlBall,Beach Ball,25,1059,1053,2137,64614
11906,2023-01-24,BUZZ,bounty,Excel,0,121,167,288,10896
11907,2023-01-23,BUZZ,knockout,New Perspective,0,107,61,168,20676
11908,2023-01-23,BUZZ,hotZone,Dueling Beetles,0,73,45,118,17502
11909,2023-01-23,BUZZ,heist,Snaked Assault,0,129,143,272,15762
11910,2023-01-23,BUZZ,gemGrab,Minecart Madness,0,77,54,131,19062
11911,2023-01-23,BUZZ,gemGrab,Double Swoosh,0,70,48,118,7578
11912,2023-01-23,BUZZ,brawlBall,Center Stage,50,2125,2249,4424,92862
11913,2023-01-23,BUZZ,brawlBall,Backyard Bowl,1,28,24,53,4224
11914,2023-01-23,BUZZ,bounty,Layer Cake,0,71,92,163,11142
11915,2023-01-22,BUZZ,knockout,X Marks the Spot,0,34,25,59,9174
11916,2023-01-22,BUZZ,hotZone,Ring of Fire,0,20,9,29,5730
11917,2023-01-22,BUZZ,heist,Snaked Assault,0,79,59,138,8232
11918,2023-01-22,BUZZ,gemGrab,Hard Rock Mine,0,36,23,59,4722
11919,2023-01-22,BUZZ,gemGrab,Double Swoosh,0,111,57,168,9426
11920,2023-01-22,BUZZ,brawlBall,Super Beach,5,137,111,253,7386
11921,2023-01-22,BUZZ,brawlBall,Backyard Bowl,5,250,215,470,34788
11922,2023-01-22,BUZZ,bounty,Layer Cake,0,53,42,95,6654
11923,2023-01-21,BUZZ,knockout,X Marks the Spot,0,116,89,205,31698
11924,2023-01-21,BUZZ,hotZone,Ring of Fire,0,56,29,85,16632
11925,2023-01-21,BUZZ,heist,Tornado Ring,1,133,92,226,11664
11926,2023-01-21,BUZZ,gemGrab,Hard Rock Mine,0,203,154,357,22980
11927,2023-01-21,BUZZ,gemGrab,Deep Diner,0,32,36,68,4470
11928,2023-01-21,BUZZ,brawlBall,Super Beach,40,1964,1798,3802,101364
11929,2023-01-21,BUZZ,brawlBall,Sneaky Fields,0,66,58,124,3750
11930,2023-01-21,BUZZ,bounty,Dry Season,0,33,39,72,14538
11931,2023-01-20,BUZZ,knockout,Out in the Open,0,55,35,90,20106
11932,2023-01-20,BUZZ,hotZone,Split,0,95,65,160,9678
11933,2023-01-20,BUZZ,heist,Tornado Ring,2,139,185,326,12672
11934,2023-01-20,BUZZ,gemGrab,Undermine,0,50,38,88,5442
11935,2023-01-20,BUZZ,gemGrab,Deep Diner,0,151,105,256,19050
11936,2023-01-20,BUZZ,brawlBall,Sneaky Fields,34,1604,1483,3121,74778
11937,2023-01-20,BUZZ,brawlBall,Pinhole Punt,0,43,40,83,2886
11938,2023-01-20,BUZZ,bounty,Dry Season,0,37,21,58,11640
11939,2023-01-19,BUZZ,knockout,Out in the Open,0,87,68,155,26574
11940,2023-01-19,BUZZ,hotZone,Split,0,135,115,250,14856
11941,2023-01-19,BUZZ,heist,Kaboom Canyon,1,29,42,72,6732
11942,2023-01-19,BUZZ,gemGrab,Undermine,0,124,132,256,14154
11943,2023-01-19,BUZZ,gemGrab,Gem Fort,0,27,13,40,2934
11944,2023-01-19,BUZZ,brawlBall,Sunny Soccer,0,36,36,72,2274
11945,2023-01-19,BUZZ,brawlBall,Pinhole Punt,23,1035,950,2008,72498
11946,2023-01-19,BUZZ,bounty,Shooting Star,0,19,11,30,11124
11947,2023-01-18,BUZZ,knockout,Goldarm Gulch,0,13,6,19,2784
11948,2023-01-18,BUZZ,hotZone,Parallel Plays,0,7,3,10,1158
11949,2023-01-18,BUZZ,heist,Kaboom Canyon,0,15,14,29,2592
11950,2023-01-18,BUZZ,gemGrab,Gem Fort,0,31,25,56,3006
11951,2023-01-18,BUZZ,gemGrab,Crystal Arcade,0,10,5,15,990
11952,2023-01-18,BUZZ,brawlBall,Sunny Soccer,4,320,340,664,18941
11953,2023-01-18,BUZZ,brawlBall,Beach Ball,0,20,24,44,774
11954,2023-01-18,BUZZ,bounty,Shooting Star,0,6,2,8,5088
11955,2023-01-17,BUZZ,knockout,Goldarm Gulch,0,23,20,43,2520
11956,2023-01-17,BUZZ,hotZone,Parallel Plays,0,19,9,28,1038
11957,2023-01-17,BUZZ,heist,Pit Stop,0,34,35,69,1290
11958,2023-01-17,BUZZ,gemGrab,Minecart Madness,0,0,1,1,216
11959,2023-01-17,BUZZ,gemGrab,Crystal Arcade,0,14,14,28,1266
11960,2023-01-17,BUZZ,brawlBall,Center Stage,0,3,6,9,288
11961,2023-01-17,BUZZ,brawlBall,Beach Ball,4,107,105,216,5886
11962,2023-01-16,BUZZ,knockout,Belle's Rock,0,7,5,12,1788
11963,2023-01-16,BUZZ,hotZone,Quarter Pounder,0,9,10,19,1494
11964,2023-01-16,BUZZ,heist,Pit Stop,0,118,131,249,4044
11965,2023-01-16,BUZZ,gemGrab,Minecart Madness,0,4,3,7,1422
11966,2023-01-16,BUZZ,gemGrab,Double Swoosh,0,14,12,26,708
11967,2023-01-16,BUZZ,brawlBall,Center Stage,3,120,102,225,5778
11968,2023-01-16,BUZZ,brawlBall,Backyard Bowl,0,12,6,18,852
11969,2023-01-16,BUZZ,bounty,Hideout,0,3,0,3,1470
11970,2023-01-15,BUZZ,knockout,Belle's Rock,0,16,7,23,2904
11971,2023-01-15,BUZZ,hotZone,Quarter Pounder,0,22,19,41,3318
11972,2023-01-15,BUZZ,heist,Bridge Too Far,0,15,11,26,2736
11973,2023-01-15,BUZZ,gemGrab,Hard Rock Mine,0,8,10,18,1014
11974,2023-01-15,BUZZ,gemGrab,Double Swoosh,0,16,12,28,2178
11975,2023-01-15,BUZZ,brawlBall,Super Beach,0,15,17,32,1074
11976,2023-01-15,BUZZ,brawlBall,Backyard Bowl,1,68,42,111,8946
11977,2023-01-15,BUZZ,bounty,Canal Grande,0,11,8,19,960
11978,2023-01-14,BUZZ,knockout,Flaring Phoenix,0,0,1,1,1080
11979,2023-01-14,BUZZ,hotZone,Controller Chaos,0,22,8,30,2772
11980,2023-01-14,BUZZ,heist,Bridge Too Far,0,19,10,29,4020
11981,2023-01-14,BUZZ,gemGrab,Hard Rock Mine,0,6,25,31,1272
11982,2023-01-14,BUZZ,gemGrab,Deep Diner,0,2,3,5,858
11983,2023-01-14,BUZZ,brawlBall,Super Beach,3,96,99,198,6336
11984,2023-01-14,BUZZ,brawlBall,Sneaky Fields,0,13,4,17,918
11985,2023-01-14,BUZZ,bounty,Canal Grande,0,16,11,27,1014
11986,2023-01-13,BUZZ,knockout,Flaring Phoenix,0,11,4,15,1182
11987,2023-01-13,BUZZ,hotZone,Controller Chaos,0,12,3,15,2928
11988,2023-01-13,BUZZ,heist,Hot Potato,0,8,16,24,600
11989,2023-01-13,BUZZ,gemGrab,Deep Diner,0,25,21,46,1650
11990,2023-01-13,BUZZ,brawlBall,Sneaky Fields,0,120,113,233,6144
11991,2023-01-13,BUZZ,brawlBall,Pinhole Punt,1,0,0,1,156
11992,2023-01-13,BUZZ,bounty,Temple Ruins,0,2,4,6,270
11993,2023-01-12,BUZZ,knockout,Riverside,0,2,0,2,2532
11994,2023-01-12,BUZZ,hotZone,Open Zone,0,2,0,2,1488
11995,2023-01-12,BUZZ,heist,Hot Potato,0,3,1,4,330
11996,2023-01-12,BUZZ,gemGrab,Undermine,0,7,6,13,690
11997,2023-01-12,BUZZ,gemGrab,Gem Fort,0,1,0,1,162
11998,2023-01-12,BUZZ,brawlBall,Sunny Soccer,0,4,2,6,240
11999,2023-01-12,BUZZ,brawlBall,Pinhole Punt,0,38,63,101,2292
12000,2023-01-12,BUZZ,bounty,Temple Ruins,0,1,0,1,24
12001,2023-01-11,BUZZ,knockout,Riverside,0,0,1,1,528
12002,2023-01-11,BUZZ,hotZone,Open Zone,0,1,1,2,462
12003,2023-01-11,BUZZ,gemGrab,Gem Fort,0,4,2,6,414
12004,2023-01-11,BUZZ,brawlBall,Sunny Soccer,0,36,26,62,1638
12005,2023-01-11,BUZZ,brawlBall,Beach Ball,0,2,0,2,48
12006,2023-01-11,BUZZ,bounty,Excel,0,3,0,3,282
12007,2023-01-10,BUZZ,knockout,New Perspective,0,1,1,2,720
12008,2023-01-10,BUZZ,hotZone,Dueling Beetles,0,12,3,15,2424
12009,2023-01-10,BUZZ,heist,Safe Zone,0,8,6,14,1176
12010,2023-01-10,BUZZ,gemGrab,Minecart Madness,0,4,1,5,828
12011,2023-01-10,BUZZ,gemGrab,Crystal Arcade,0,14,26,40,1746
12012,2023-01-10,BUZZ,brawlBall,Center Stage,1,11,2,14,708
12013,2023-01-10,BUZZ,brawlBall,Beach Ball,0,59,64,123,4392
12014,2023-01-10,BUZZ,bounty,Excel,0,3,10,13,330
12015,2023-01-09,BUZZ,knockout,New Perspective,0,2,0,2,876
12016,2023-01-09,BUZZ,hotZone,Dueling Beetles,0,2,0,2,1554
12017,2023-01-09,BUZZ,heist,Snaked Assault,0,16,31,47,2022
12018,2023-01-09,BUZZ,gemGrab,Minecart Madness,0,10,6,16,1884
12019,2023-01-09,BUZZ,gemGrab,Double Swoosh,0,11,1,12,1320
12020,2023-01-09,BUZZ,brawlBall,Center Stage,4,136,99,239,5460
12021,2023-01-09,BUZZ,brawlBall,Backyard Bowl,1,5,20,26,474
12022,2023-01-09,BUZZ,bounty,Layer Cake,0,6,8,14,1512
12023,2023-01-08,BUZZ,knockout,X Marks the Spot,0,5,0,5,1692
12024,2023-01-08,BUZZ,hotZone,Ring of Fire,0,3,2,5,1644
12025,2023-01-08,BUZZ,heist,Snaked Assault,0,11,21,32,1494
12026,2023-01-08,BUZZ,gemGrab,Hard Rock Mine,0,2,1,3,630
12027,2023-01-08,BUZZ,gemGrab,Double Swoosh,0,10,2,12,864
12028,2023-01-08,BUZZ,brawlBall,Super Beach,0,18,9,27,732
12029,2023-01-08,BUZZ,brawlBall,Backyard Bowl,1,37,37,75,4830
12030,2023-01-08,BUZZ,bounty,Layer Cake,0,2,3,5,528
12031,2023-01-07,BUZZ,heist,Tornado Ring,0,20,37,57,1350
12032,2023-01-07,BUZZ,gemGrab,Hard Rock Mine,0,8,2,10,1158
12033,2023-01-07,BUZZ,gemGrab,Deep Diner,0,8,9,17,918
12034,2023-01-07,BUZZ,brawlBall,Super Beach,0,40,27,67,2622
12035,2023-01-07,BUZZ,brawlBall,Sneaky Fields,0,4,3,7,402
12036,2023-01-07,BUZZ,bounty,Dry Season,0,4,3,7,1320
12037,2023-01-06,BUZZ,knockout,Out in the Open,0,4,0,4,1446
12038,2023-01-06,BUZZ,hotZone,Split,0,5,19,24,1158
12039,2023-01-06,BUZZ,heist,Tornado Ring,0,35,23,58,2538
12040,2023-01-06,BUZZ,gemGrab,Undermine,0,3,0,3,540
12041,2023-01-06,BUZZ,gemGrab,Deep Diner,0,10,7,17,2226
12042,2023-01-06,BUZZ,brawlBall,Sneaky Fields,1,76,50,127,4896
12043,2023-01-06,BUZZ,brawlBall,Pinhole Punt,0,4,15,19,510
12044,2023-01-06,BUZZ,bounty,Dry Season,0,2,1,3,1944
12045,2023-01-05,BUZZ,knockout,Out in the Open,0,4,1,5,2958
12046,2023-01-05,BUZZ,hotZone,Split,0,24,38,62,3552
12047,2023-01-05,BUZZ,heist,Kaboom Canyon,0,5,0,5,954
12048,2023-01-05,BUZZ,gemGrab,Undermine,0,17,12,29,1812
12049,2023-01-05,BUZZ,gemGrab,Gem Fort,0,1,1,2,252
12050,2023-01-05,BUZZ,brawlBall,Sunny Soccer,0,3,1,4,84
12051,2023-01-05,BUZZ,brawlBall,Pinhole Punt,0,91,45,136,8118
12052,2023-01-04,BUZZ,knockout,Goldarm Gulch,0,3,0,3,696
12053,2023-01-04,BUZZ,hotZone,Parallel Plays,0,1,2,3,864
12054,2023-01-04,BUZZ,heist,Kaboom Canyon,0,10,4,14,1848
12055,2023-01-04,BUZZ,gemGrab,Gem Fort,0,18,33,51,1788
12056,2023-01-04,BUZZ,gemGrab,Crystal Arcade,0,6,5,11,642
12057,2023-01-04,BUZZ,brawlBall,Sunny Soccer,3,113,136,252,6312
12058,2023-01-04,BUZZ,brawlBall,Beach Ball,0,1,5,6,54
12059,2023-01-04,BUZZ,bounty,Shooting Star,0,1,0,1,3570
12060,2023-01-03,BUZZ,knockout,Goldarm Gulch,0,1,0,1,720
12061,2023-01-03,BUZZ,hotZone,Parallel Plays,0,14,20,34,1542
12062,2023-01-03,BUZZ,hotZone,Controller Chaos,0,1,0,1,12
12063,2023-01-03,BUZZ,heist,Pit Stop,0,50,61,111,1956
12064,2023-01-03,BUZZ,gemGrab,Minecart Madness,0,2,0,2,456
12065,2023-01-03,BUZZ,gemGrab,Crystal Arcade,0,15,20,35,2406
12066,2023-01-03,BUZZ,brawlBall,Center Stage,0,4,2,6,294
12067,2023-01-03,BUZZ,brawlBall,Beach Ball,2,76,56,134,5580
12068,2023-01-02,BUZZ,knockout,Belle's Rock,0,4,0,4,1794
12069,2023-01-02,BUZZ,hotZone,Quarter Pounder,0,15,4,19,2652
12070,2023-01-02,BUZZ,heist,Pit Stop,0,82,158,240,3498
12071,2023-01-02,BUZZ,gemGrab,Minecart Madness,0,6,3,9,2352
12072,2023-01-02,BUZZ,gemGrab,Double Swoosh,0,2,2,4,1512
12073,2023-01-02,BUZZ,brawlBall,Center Stage,3,113,130,246,7110
12074,2023-01-02,BUZZ,brawlBall,Backyard Bowl,0,3,0,3,492
12075,2023-01-02,BUZZ,bounty,Hideout,0,7,0,7,3090
12076,2023-01-01,BUZZ,knockout,Belle's Rock,0,3,1,4,858
12077,2023-01-01,BUZZ,hotZone,Quarter Pounder,0,5,10,15,1188
12078,2023-01-01,BUZZ,heist,Bridge Too Far,0,3,3,6,462
12079,2023-01-01,BUZZ,gemGrab,Double Swoosh,0,6,0,6,1140
12080,2023-01-01,BUZZ,brawlBall,Backyard Bowl,0,15,1,16,2658
12081,2023-01-01,BUZZ,bounty,Canal Grande,0,2,0,2,132
12082,2022-12-31,BUZZ,hotZone,Controller Chaos,0,4,6,10,198
12083,2022-12-31,BUZZ,heist,Bridge Too Far,0,1,1,2,276
12084,2022-12-31,BUZZ,gemGrab,Hard Rock Mine,0,5,0,5,384
12085,2022-12-31,BUZZ,gemGrab,Deep Diner,0,0,2,2,306
12086,2022-12-31,BUZZ,brawlBall,Super Beach,0,14,6,20,618
12087,2022-12-31,BUZZ,bounty,Canal Grande,0,2,0,2,54
12088,2022-12-30,BUZZ,hotZone,Controller Chaos,0,0,1,1,288
12089,2022-12-30,BUZZ,gemGrab,Minecart Madness,0,0,1,1,24
12090,2022-12-30,BUZZ,gemGrab,Deep Diner,0,3,2,5,438
12091,2022-12-30,BUZZ,brawlBall,Sneaky Fields,0,5,5,10,552
12092,2022-12-29,BUZZ,heist,Kaboom Canyon,0,1,0,1,18
12093,2022-12-29,BUZZ,brawlBall,Pinhole Punt,0,0,9,9,282
12094,2022-12-28,BUZZ,brawlBall,Sunny Soccer,0,0,1,1,42
12095,2022-12-27,BUZZ,hotZone,Controller Chaos,0,1,1,2,24
12096,2022-12-27,BUZZ,brawlBall,Center Stage,0,0,1,1,30
12097,2022-12-27,BUZZ,brawlBall,Beach Ball,0,3,1,4,144
12098,2022-12-27,BUZZ,bounty,Excel,0,3,1,4,18
12099,2022-12-26,BUZZ,hotZone,Controller Chaos,0,1,0,1,30
12100,2022-12-26,BUZZ,gemGrab,Minecart Madness,0,2,0,2,60
12101,2022-12-26,BUZZ,brawlBall,Center Stage,0,1,2,3,78
12102,2022-12-25,BUZZ,gemGrab,Double Swoosh,0,1,0,1,30
12103,2022-12-24,BUZZ,brawlBall,Super Beach,0,1,0,1,48
12104,2022-12-23,BUZZ,brawlBall,Sneaky Fields,0,0,1,1,12
12105,2022-12-22,BUZZ,brawlBall,Pinhole Punt,0,3,2,5,132
12106,2022-12-20,BUZZ,brawlBall,Beach Ball,0,4,4,8,96
12107,2022-12-19,BUZZ,brawlBall,Center Stage,0,1,1,2,102
12108,2022-12-11,BUZZ,brawlBall,Backyard Bowl,0,1,1,2,24
12109,2022-11-01,BUZZ,knockout,New Perspective,0,1,0,1,54
12110,2022-10-30,BUZZ,brawlBall,Beach Ball,0,1,0,1,12
12111,2022-10-15,BUZZ,gemGrab,Hard Rock Mine,0,1,1,2,90
12112,2022-10-10,BUZZ,knockout,Belle's Rock,0,0,1,1,48
12113,2023-01-28,BUSTER,knockout,Flaring Phoenix,0,24,31,55,12366
12114,2023-01-28,BUSTER,hotZone,Controller Chaos,0,80,77,157,10134
12115,2023-01-28,BUSTER,heist,Bridge Too Far,0,5,0,5,24240
12116,2023-01-28,BUSTER,gemGrab,Hard Rock Mine,0,52,70,122,16638
12117,2023-01-28,BUSTER,gemGrab,Deep Diner,0,16,12,28,5478
12118,2023-01-28,BUSTER,brawlBall,Super Beach,8,318,336,662,74430
12119,2023-01-28,BUSTER,brawlBall,Sneaky Fields,1,28,20,49,3582
12120,2023-01-28,BUSTER,bounty,Canal Grande,0,63,71,134,10902
12121,2023-01-27,BUSTER,knockout,Flaring Phoenix,0,18,18,36,5928
12122,2023-01-27,BUSTER,hotZone,Controller Chaos,0,12,10,22,2676
12123,2023-01-27,BUSTER,heist,Hot Potato,0,5,0,5,3486
12124,2023-01-27,BUSTER,gemGrab,Undermine,0,4,7,11,942
12125,2023-01-27,BUSTER,gemGrab,Deep Diner,0,27,19,46,6846
12126,2023-01-27,BUSTER,brawlBall,Sneaky Fields,3,107,119,229,23514
12127,2023-01-27,BUSTER,brawlBall,Pinhole Punt,0,1,0,1,738
12128,2023-01-27,BUSTER,bounty,Temple Ruins,0,17,33,50,1890
12129,2023-01-26,BUSTER,knockout,Riverside,0,18,4,22,19008
12130,2023-01-26,BUSTER,hotZone,Open Zone,0,22,16,38,10182
12131,2023-01-26,BUSTER,heist,Hot Potato,0,6,4,10,14610
12132,2023-01-26,BUSTER,gemGrab,Undermine,0,64,62,126,10062
12133,2023-01-26,BUSTER,gemGrab,Gem Fort,0,22,17,39,4674
12134,2023-01-26,BUSTER,brawlBall,Sunny Soccer,0,8,5,13,3660
12135,2023-01-26,BUSTER,brawlBall,Pinhole Punt,11,234,309,554,67338
12136,2023-01-26,BUSTER,bounty,Temple Ruins,0,18,17,35,5610
12137,2023-01-25,BUSTER,knockout,Riverside,0,1,4,5,9906
12138,2023-01-25,BUSTER,hotZone,Open Zone,0,5,8,13,5262
12139,2023-01-25,BUSTER,heist,Safe Zone,0,3,0,3,9156
12140,2023-01-25,BUSTER,gemGrab,Gem Fort,0,23,29,52,5556
12141,2023-01-25,BUSTER,gemGrab,Crystal Arcade,0,35,35,70,7866
12142,2023-01-25,BUSTER,brawlBall,Sunny Soccer,2,203,242,447,40830
12143,2023-01-25,BUSTER,brawlBall,Beach Ball,2,30,52,84,6408
12144,2023-01-25,BUSTER,bounty,Excel,0,2,3,5,5790
12145,2023-01-24,BUSTER,knockout,New Perspective,0,33,59,92,10542
12146,2023-01-24,BUSTER,hotZone,Dueling Beetles,0,73,71,144,10662
12147,2023-01-24,BUSTER,heist,Safe Zone,0,7,3,10,15750
12148,2023-01-24,BUSTER,gemGrab,Minecart Madness,0,4,3,7,4002
12149,2023-01-24,BUSTER,gemGrab,Crystal Arcade,0,68,61,129,14460
12150,2023-01-24,BUSTER,brawlBall,Center Stage,3,62,49,114,7860
12151,2023-01-24,BUSTER,brawlBall,Beach Ball,6,238,229,473,64614
12152,2023-01-24,BUSTER,bounty,Excel,0,18,13,31,10896
12153,2023-01-23,BUSTER,knockout,New Perspective,0,58,66,124,20676
12154,2023-01-23,BUSTER,hotZone,Dueling Beetles,0,108,69,177,17502
12155,2023-01-23,BUSTER,heist,Snaked Assault,0,6,1,7,15762
12156,2023-01-23,BUSTER,gemGrab,Minecart Madness,0,53,35,88,19062
12157,2023-01-23,BUSTER,gemGrab,Double Swoosh,0,37,34,71,7578
12158,2023-01-23,BUSTER,brawlBall,Center Stage,11,511,542,1064,92862
12159,2023-01-23,BUSTER,brawlBall,Backyard Bowl,0,1,4,5,4224
12160,2023-01-23,BUSTER,bounty,Layer Cake,0,28,31,59,11142
12161,2023-01-22,BUSTER,knockout,X Marks the Spot,0,25,10,35,9174
12162,2023-01-22,BUSTER,hotZone,Ring of Fire,0,39,36,75,5730
12163,2023-01-22,BUSTER,heist,Snaked Assault,0,4,0,4,8232
12164,2023-01-22,BUSTER,gemGrab,Hard Rock Mine,0,13,13,26,4722
12165,2023-01-22,BUSTER,gemGrab,Double Swoosh,0,54,52,106,9426
12166,2023-01-22,BUSTER,brawlBall,Super Beach,0,26,26,52,7386
12167,2023-01-22,BUSTER,brawlBall,Backyard Bowl,1,47,44,92,34788
12168,2023-01-22,BUSTER,bounty,Layer Cake,0,11,19,30,6654
12169,2023-01-21,BUSTER,knockout,X Marks the Spot,0,91,58,149,31698
12170,2023-01-21,BUSTER,hotZone,Ring of Fire,0,126,97,223,16632
12171,2023-01-21,BUSTER,heist,Tornado Ring,0,9,9,18,11664
12172,2023-01-21,BUSTER,gemGrab,Hard Rock Mine,0,95,77,172,22980
12173,2023-01-21,BUSTER,gemGrab,Deep Diner,0,12,15,27,4470
12174,2023-01-21,BUSTER,brawlBall,Super Beach,15,518,564,1097,101364
12175,2023-01-21,BUSTER,brawlBall,Sneaky Fields,0,20,15,35,3750
12176,2023-01-21,BUSTER,bounty,Dry Season,0,13,6,19,14538
12177,2023-01-20,BUSTER,knockout,Out in the Open,0,38,24,62,20106
12178,2023-01-20,BUSTER,hotZone,Split,0,62,56,118,9678
12179,2023-01-20,BUSTER,heist,Tornado Ring,0,9,2,11,12672
12180,2023-01-20,BUSTER,gemGrab,Undermine,0,21,13,34,5442
12181,2023-01-20,BUSTER,gemGrab,Deep Diner,0,71,79,150,19050
12182,2023-01-20,BUSTER,brawlBall,Sneaky Fields,7,463,459,929,74778
12183,2023-01-20,BUSTER,brawlBall,Pinhole Punt,0,12,10,22,2886
12184,2023-01-20,BUSTER,bounty,Dry Season,0,6,6,12,11640
12185,2023-01-19,BUSTER,knockout,Out in the Open,0,48,62,110,26574
12186,2023-01-19,BUSTER,hotZone,Split,0,84,91,175,14856
12187,2023-01-19,BUSTER,heist,Kaboom Canyon,0,4,3,7,6732
12188,2023-01-19,BUSTER,gemGrab,Undermine,0,75,76,151,14154
12189,2023-01-19,BUSTER,gemGrab,Gem Fort,0,16,22,38,2934
12190,2023-01-19,BUSTER,brawlBall,Sunny Soccer,1,8,10,19,2274
12191,2023-01-19,BUSTER,brawlBall,Pinhole Punt,4,303,370,677,72498
12192,2023-01-19,BUSTER,bounty,Shooting Star,0,11,5,16,11124
12193,2023-01-18,BUSTER,knockout,Goldarm Gulch,0,8,10,18,2784
12194,2023-01-18,BUSTER,hotZone,Parallel Plays,0,12,9,21,1158
12195,2023-01-18,BUSTER,heist,Kaboom Canyon,0,1,1,2,2592
12196,2023-01-18,BUSTER,gemGrab,Gem Fort,0,15,45,60,3006
12197,2023-01-18,BUSTER,gemGrab,Crystal Arcade,0,7,2,9,990
12198,2023-01-18,BUSTER,brawlBall,Sunny Soccer,4,84,126,214,18941
12199,2023-01-18,BUSTER,brawlBall,Beach Ball,0,0,2,2,774
12200,2023-01-18,BUSTER,bounty,Shooting Star,0,3,0,3,5088
12201,2023-01-17,BUSTER,knockout,Goldarm Gulch,0,13,25,38,2520
12202,2023-01-17,BUSTER,hotZone,Parallel Plays,0,7,17,24,1038
12203,2023-01-17,BUSTER,heist,Pit Stop,0,0,3,3,1290
12204,2023-01-17,BUSTER,gemGrab,Minecart Madness,0,1,2,3,216
12205,2023-01-17,BUSTER,gemGrab,Crystal Arcade,0,12,14,26,1266
12206,2023-01-17,BUSTER,brawlBall,Center Stage,1,3,9,13,288
12207,2023-01-17,BUSTER,brawlBall,Beach Ball,0,25,43,68,5886
12208,2023-01-16,BUSTER,knockout,Belle's Rock,0,2,0,2,1788
12209,2023-01-16,BUSTER,hotZone,Quarter Pounder,0,10,8,18,1494
12210,2023-01-16,BUSTER,heist,Pit Stop,0,1,0,1,4044
12211,2023-01-16,BUSTER,gemGrab,Minecart Madness,0,3,2,5,1422
12212,2023-01-16,BUSTER,gemGrab,Double Swoosh,0,5,2,7,708
12213,2023-01-16,BUSTER,brawlBall,Center Stage,2,38,30,70,5778
12214,2023-01-16,BUSTER,brawlBall,Backyard Bowl,0,2,1,3,852
12215,2023-01-16,BUSTER,bounty,Hideout,0,2,1,3,1470
12216,2023-01-15,BUSTER,knockout,Belle's Rock,0,5,6,11,2904
12217,2023-01-15,BUSTER,hotZone,Quarter Pounder,0,36,7,43,3318
12218,2023-01-15,BUSTER,heist,Bridge Too Far,0,1,0,1,2736
12219,2023-01-15,BUSTER,gemGrab,Hard Rock Mine,0,3,4,7,1014
12220,2023-01-15,BUSTER,gemGrab,Double Swoosh,0,27,31,58,2178
12221,2023-01-15,BUSTER,brawlBall,Super Beach,0,5,31,36,1074
12222,2023-01-15,BUSTER,brawlBall,Backyard Bowl,0,27,29,56,8946
12223,2023-01-15,BUSTER,bounty,Canal Grande,0,10,4,14,960
12224,2023-01-14,BUSTER,knockout,Flaring Phoenix,0,7,2,9,1080
12225,2023-01-14,BUSTER,hotZone,Controller Chaos,0,45,22,67,2772
12226,2023-01-14,BUSTER,heist,Bridge Too Far,0,2,0,2,4020
12227,2023-01-14,BUSTER,gemGrab,Hard Rock Mine,0,8,8,16,1272
12228,2023-01-14,BUSTER,gemGrab,Deep Diner,0,4,3,7,858
12229,2023-01-14,BUSTER,brawlBall,Super Beach,2,48,28,78,6336
12230,2023-01-14,BUSTER,brawlBall,Sneaky Fields,1,15,19,35,918
12231,2023-01-14,BUSTER,bounty,Canal Grande,0,9,7,16,1014
12232,2023-01-13,BUSTER,knockout,Flaring Phoenix,0,7,4,11,1182
12233,2023-01-13,BUSTER,hotZone,Controller Chaos,0,55,107,162,2928
12234,2023-01-13,BUSTER,gemGrab,Undermine,0,0,2,2,18
12235,2023-01-13,BUSTER,gemGrab,Deep Diner,0,6,13,19,1650
12236,2023-01-13,BUSTER,brawlBall,Sneaky Fields,1,74,105,180,6144
12237,2023-01-13,BUSTER,brawlBall,Pinhole Punt,0,2,2,4,156
12238,2023-01-13,BUSTER,bounty,Temple Ruins,0,1,2,3,270
12239,2023-01-12,BUSTER,knockout,Riverside,0,2,0,2,2532
12240,2023-01-12,BUSTER,hotZone,Open Zone,0,10,6,16,1488
12241,2023-01-12,BUSTER,gemGrab,Undermine,0,11,4,15,690
12242,2023-01-12,BUSTER,gemGrab,Gem Fort,0,7,9,16,162
12243,2023-01-12,BUSTER,brawlBall,Sunny Soccer,0,4,2,6,240
12244,2023-01-12,BUSTER,brawlBall,Pinhole Punt,0,32,34,66,2292
12245,2023-01-12,BUSTER,bounty,Temple Ruins,0,1,0,1,24
12246,2023-01-11,BUSTER,hotZone,Open Zone,0,1,0,1,462
12247,2023-01-11,BUSTER,gemGrab,Gem Fort,0,20,7,27,414
12248,2023-01-11,BUSTER,brawlBall,Sunny Soccer,0,40,36,76,1638
12249,2023-01-11,BUSTER,brawlBall,Beach Ball,0,1,0,1,48
12250,2023-01-11,BUSTER,bounty,Excel,0,1,1,2,282
12251,2023-01-10,BUSTER,knockout,New Perspective,0,4,1,5,720
12252,2023-01-10,BUSTER,hotZone,Dueling Beetles,0,50,66,116,2424
12253,2023-01-10,BUSTER,heist,Safe Zone,0,2,0,2,1176
12254,2023-01-10,BUSTER,gemGrab,Minecart Madness,0,5,4,9,828
12255,2023-01-10,BUSTER,gemGrab,Crystal Arcade,0,39,36,75,1746
12256,2023-01-10,BUSTER,brawlBall,Center Stage,0,18,19,37,708
12257,2023-01-10,BUSTER,brawlBall,Beach Ball,0,106,100,206,4392
12258,2023-01-10,BUSTER,bounty,Excel,0,4,1,5,330
12259,2023-01-09,BUSTER,knockout,New Perspective,0,16,2,18,876
12260,2023-01-09,BUSTER,hotZone,Dueling Beetles,0,41,34,75,1554
12261,2023-01-09,BUSTER,heist,Snaked Assault,0,4,0,4,2022
12262,2023-01-09,BUSTER,gemGrab,Minecart Madness,1,19,48,68,1884
12263,2023-01-09,BUSTER,gemGrab,Double Swoosh,0,27,31,58,1320
12264,2023-01-09,BUSTER,brawlBall,Center Stage,2,158,166,326,5460
12265,2023-01-09,BUSTER,brawlBall,Backyard Bowl,0,1,0,1,474
12266,2023-01-09,BUSTER,bounty,Layer Cake,0,10,8,18,1512
12267,2023-01-08,BUSTER,knockout,X Marks the Spot,0,20,26,46,1692
12268,2023-01-08,BUSTER,hotZone,Ring of Fire,0,53,29,82,1644
12269,2023-01-08,BUSTER,heist,Snaked Assault,0,0,1,1,1494
12270,2023-01-08,BUSTER,gemGrab,Hard Rock Mine,0,10,6,16,630
12271,2023-01-08,BUSTER,gemGrab,Double Swoosh,0,27,5,32,864
12272,2023-01-08,BUSTER,brawlBall,Super Beach,0,12,24,36,732
12273,2023-01-08,BUSTER,brawlBall,Backyard Bowl,0,25,25,50,4830
12274,2023-01-08,BUSTER,bounty,Layer Cake,0,4,6,10,528
12275,2023-01-07,BUSTER,knockout,X Marks the Spot,0,7,7,14,1014
12276,2023-01-07,BUSTER,hotZone,Ring of Fire,0,34,33,67,846
12277,2023-01-07,BUSTER,heist,Tornado Ring,0,3,0,3,1350
12278,2023-01-07,BUSTER,gemGrab,Hard Rock Mine,0,29,5,34,1158
12279,2023-01-07,BUSTER,gemGrab,Deep Diner,0,15,9,24,918
12280,2023-01-07,BUSTER,brawlBall,Super Beach,1,58,64,123,2622
12281,2023-01-07,BUSTER,brawlBall,Sneaky Fields,2,9,30,41,402
12282,2023-01-07,BUSTER,bounty,Dry Season,0,0,1,1,1320
12283,2023-01-06,BUSTER,knockout,Out in the Open,0,10,6,16,1446
12284,2023-01-06,BUSTER,hotZone,Split,0,37,65,102,1158
12285,2023-01-06,BUSTER,heist,Tornado Ring,0,6,1,7,2538
12286,2023-01-06,BUSTER,gemGrab,Undermine,0,17,8,25,540
12287,2023-01-06,BUSTER,gemGrab,Deep Diner,0,43,84,127,2226
12288,2023-01-06,BUSTER,brawlBall,Sneaky Fields,2,148,103,253,4896
12289,2023-01-06,BUSTER,brawlBall,Pinhole Punt,0,12,14,26,510
12290,2023-01-06,BUSTER,bounty,Dry Season,0,8,5,13,1944
12291,2023-01-05,BUSTER,knockout,Out in the Open,0,23,8,31,2958
12292,2023-01-05,BUSTER,hotZone,Split,0,94,108,202,3552
12293,2023-01-05,BUSTER,heist,Kaboom Canyon,0,2,0,2,954
12294,2023-01-05,BUSTER,gemGrab,Undermine,0,53,28,81,1812
12295,2023-01-05,BUSTER,gemGrab,Gem Fort,0,10,3,13,252
12296,2023-01-05,BUSTER,brawlBall,Sunny Soccer,0,2,4,6,84
12297,2023-01-05,BUSTER,brawlBall,Pinhole Punt,5,206,192,403,8118
12298,2023-01-05,BUSTER,bounty,Shooting Star,0,1,0,1,1362
12299,2023-01-04,BUSTER,knockout,Goldarm Gulch,0,5,9,14,696
12300,2023-01-04,BUSTER,hotZone,Parallel Plays,0,39,54,93,864
12301,2023-01-04,BUSTER,heist,Kaboom Canyon,0,4,1,5,1848
12302,2023-01-04,BUSTER,gemGrab,Gem Fort,0,63,58,121,1788
12303,2023-01-04,BUSTER,gemGrab,Crystal Arcade,0,9,2,11,642
12304,2023-01-04,BUSTER,brawlBall,Sunny Soccer,5,167,106,278,6312
12305,2023-01-04,BUSTER,brawlBall,Beach Ball,0,3,0,3,54
12306,2023-01-04,BUSTER,bounty,Shooting Star,0,4,1,5,3570
12307,2023-01-03,BUSTER,knockout,Goldarm Gulch,0,13,9,22,720
12308,2023-01-03,BUSTER,hotZone,Parallel Plays,0,67,40,107,1542
12309,2023-01-03,BUSTER,hotZone,Controller Chaos,0,0,1,1,12
12310,2023-01-03,BUSTER,gemGrab,Minecart Madness,0,7,3,10,456
12311,2023-01-03,BUSTER,gemGrab,Crystal Arcade,0,76,108,184,2406
12312,2023-01-03,BUSTER,brawlBall,Center Stage,0,9,0,9,294
12313,2023-01-03,BUSTER,brawlBall,Beach Ball,1,128,99,228,5580
12314,2023-01-03,BUSTER,bounty,Hideout,0,4,2,6,1638
12315,2023-01-02,BUSTER,knockout,Belle's Rock,0,5,0,5,1794
12316,2023-01-02,BUSTER,hotZone,Quarter Pounder,0,52,85,137,2652
12317,2023-01-02,BUSTER,hotZone,Controller Chaos,0,0,1,1,18
12318,2023-01-02,BUSTER,heist,Pit Stop,0,4,0,4,3498
12319,2023-01-02,BUSTER,gemGrab,Minecart Madness,0,26,27,53,2352
12320,2023-01-02,BUSTER,gemGrab,Double Swoosh,0,55,48,103,1512
12321,2023-01-02,BUSTER,brawlBall,Center Stage,3,218,280,501,7110
12322,2023-01-02,BUSTER,brawlBall,Backyard Bowl,1,3,2,6,492
12323,2023-01-02,BUSTER,bounty,Hideout,0,5,6,11,3090
12324,2023-01-01,BUSTER,knockout,Belle's Rock,0,5,2,7,858
12325,2023-01-01,BUSTER,hotZone,Quarter Pounder,0,27,10,37,1188
12326,2023-01-01,BUSTER,hotZone,Controller Chaos,0,1,0,1,12
12327,2023-01-01,BUSTER,heist,Bridge Too Far,0,1,4,5,462
12328,2023-01-01,BUSTER,gemGrab,Hard Rock Mine,0,1,1,2,48
12329,2023-01-01,BUSTER,gemGrab,Double Swoosh,0,36,56,92,1140
12330,2023-01-01,BUSTER,brawlBall,Backyard Bowl,0,19,12,31,2658
12331,2023-01-01,BUSTER,bounty,Canal Grande,0,5,9,14,132
12332,2022-12-31,BUSTER,knockout,Flaring Phoenix,0,0,1,1,18
12333,2022-12-31,BUSTER,hotZone,Controller Chaos,0,10,23,33,198
12334,2022-12-31,BUSTER,heist,Kaboom Canyon,0,0,1,1,12
12335,2022-12-31,BUSTER,gemGrab,Hard Rock Mine,0,7,14,21,384
12336,2022-12-31,BUSTER,gemGrab,Deep Diner,0,4,2,6,306
12337,2022-12-31,BUSTER,brawlBall,Super Beach,0,10,16,26,618
12338,2022-12-31,BUSTER,brawlBall,Sneaky Fields,0,1,1,2,60
12339,2022-12-30,BUSTER,knockout,Flaring Phoenix,0,1,1,2,72
12340,2022-12-30,BUSTER,hotZone,Controller Chaos,0,8,16,24,288
12341,2022-12-30,BUSTER,gemGrab,Undermine,0,5,0,5,102
12342,2022-12-30,BUSTER,gemGrab,Deep Diner,0,7,9,16,438
12343,2022-12-30,BUSTER,brawlBall,Sneaky Fields,0,5,11,16,552
12344,2022-12-29,BUSTER,hotZone,Open Zone,0,1,1,2,54
12345,2022-12-29,BUSTER,hotZone,Controller Chaos,0,0,1,1,12
12346,2022-12-29,BUSTER,gemGrab,Undermine,0,4,2,6,102
12347,2022-12-29,BUSTER,gemGrab,Gem Fort,0,1,1,2,30
12348,2022-12-29,BUSTER,brawlBall,Pinhole Punt,0,3,4,7,282
12349,2022-12-28,BUSTER,hotZone,Open Zone,0,1,0,1,108
12350,2022-12-28,BUSTER,brawlBall,Sunny Soccer,0,0,2,2,42
12351,2022-12-28,BUSTER,brawlBall,Beach Ball,0,0,1,1,6
12352,2022-12-27,BUSTER,heist,Kaboom Canyon,0,1,0,1,18
12353,2022-12-27,BUSTER,gemGrab,Minecart Madness,0,0,1,1,30
12354,2022-12-27,BUSTER,brawlBall,Center Stage,0,2,2,4,30
12355,2022-12-27,BUSTER,brawlBall,Beach Ball,0,4,12,16,144
12356,2022-12-26,BUSTER,brawlBall,Center Stage,0,3,4,7,78
12357,2022-12-25,BUSTER,hotZone,Ring of Fire,0,0,2,2,12
12358,2022-12-25,BUSTER,bounty,Layer Cake,0,1,1,2,12
12359,2022-12-24,BUSTER,brawlBall,Super Beach,0,1,1,2,48
12360,2022-12-23,BUSTER,knockout,Out in the Open,0,3,0,3,132
12361,2022-12-23,BUSTER,gemGrab,Deep Diner,0,0,1,1,6
12362,2022-12-23,BUSTER,brawlBall,Sneaky Fields,0,1,0,1,12
12363,2022-12-22,BUSTER,gemGrab,Gem Fort,0,1,0,1,90
12364,2022-12-22,BUSTER,brawlBall,Pinhole Punt,0,2,5,7,132
12365,2022-12-21,BUSTER,brawlBall,Sunny Soccer,0,1,5,6,54
12366,2022-12-20,BUSTER,brawlBall,Beach Ball,0,0,1,1,96
12367,2022-12-19,BUSTER,brawlBall,Center Stage,0,1,2,3,102
12368,2022-12-16,BUSTER,hotZone,Controller Chaos,0,0,1,1,6
12369,2022-12-16,BUSTER,brawlBall,Sneaky Fields,0,8,9,17,84
12370,2022-12-16,BUSTER,bounty,Temple Ruins,0,0,4,4,24
12371,2022-12-13,BUSTER,knockout,New Perspective,0,2,0,2,84
12372,2022-12-13,BUSTER,hotZone,Dueling Beetles,0,0,1,1,6
12373,2022-12-13,BUSTER,gemGrab,Crystal Arcade,0,3,8,11,72
12374,2022-12-11,BUSTER,brawlBall,Backyard Bowl,0,3,2,5,24
12375,2022-12-10,BUSTER,gemGrab,Hard Rock Mine,0,1,1,2,24
12376,2022-11-11,BUSTER,brawlBall,Sneaky Fields,0,1,0,1,42
12377,2022-11-07,BUSTER,hotZone,Quarter Pounder,0,0,1,1,24
12378,2023-01-28,BULL,knockout,Flaring Phoenix,0,9,14,23,12366
12379,2023-01-28,BULL,hotZone,Controller Chaos,0,16,9,25,10134
12380,2023-01-28,BULL,heist,Bridge Too Far,0,41,45,86,24240
12381,2023-01-28,BULL,gemGrab,Hard Rock Mine,0,75,68,143,16638
12382,2023-01-28,BULL,gemGrab,Deep Diner,0,7,5,12,5478
12383,2023-01-28,BULL,brawlBall,Super Beach,15,655,686,1356,74430
12384,2023-01-28,BULL,brawlBall,Sneaky Fields,2,44,40,86,3582
12385,2023-01-28,BULL,bounty,Canal Grande,0,24,36,60,10902
12386,2023-01-27,BULL,knockout,Flaring Phoenix,0,6,3,9,5928
12387,2023-01-27,BULL,hotZone,Controller Chaos,0,4,5,9,2676
12388,2023-01-27,BULL,heist,Hot Potato,0,71,75,146,3486
12389,2023-01-27,BULL,gemGrab,Undermine,0,1,1,2,942
12390,2023-01-27,BULL,gemGrab,Deep Diner,0,20,6,26,6846
12391,2023-01-27,BULL,brawlBall,Sneaky Fields,7,369,351,727,23514
12392,2023-01-27,BULL,brawlBall,Pinhole Punt,0,1,3,4,738
12393,2023-01-27,BULL,bounty,Temple Ruins,0,3,1,4,1890
12394,2023-01-26,BULL,knockout,Riverside,0,9,4,13,19008
12395,2023-01-26,BULL,hotZone,Open Zone,0,9,8,17,10182
12396,2023-01-26,BULL,heist,Hot Potato,2,519,511,1032,14610
12397,2023-01-26,BULL,gemGrab,Undermine,0,60,61,121,10062
12398,2023-01-26,BULL,gemGrab,Gem Fort,0,26,18,44,4674
12399,2023-01-26,BULL,brawlBall,Sunny Soccer,0,33,29,62,3660
12400,2023-01-26,BULL,brawlBall,Pinhole Punt,4,412,455,871,67338
12401,2023-01-26,BULL,bounty,Temple Ruins,0,8,9,17,5610
12402,2023-01-25,BULL,knockout,Riverside,0,13,5,18,9906
12403,2023-01-25,BULL,hotZone,Open Zone,0,5,1,6,5262
12404,2023-01-25,BULL,heist,Safe Zone,0,39,32,71,9156
12405,2023-01-25,BULL,gemGrab,Gem Fort,0,29,38,67,5556
12406,2023-01-25,BULL,gemGrab,Crystal Arcade,0,16,9,25,7866
12407,2023-01-25,BULL,brawlBall,Sunny Soccer,7,342,328,677,40830
12408,2023-01-25,BULL,brawlBall,Beach Ball,2,53,68,123,6408
12409,2023-01-25,BULL,bounty,Excel,0,7,24,31,5790
12410,2023-01-24,BULL,knockout,New Perspective,0,13,14,27,10542
12411,2023-01-24,BULL,hotZone,Dueling Beetles,0,10,2,12,10662
12412,2023-01-24,BULL,heist,Safe Zone,0,56,64,120,15750
12413,2023-01-24,BULL,gemGrab,Minecart Madness,0,7,4,11,4002
12414,2023-01-24,BULL,gemGrab,Crystal Arcade,0,45,36,81,14460
12415,2023-01-24,BULL,brawlBall,Center Stage,4,145,170,319,7860
12416,2023-01-24,BULL,brawlBall,Beach Ball,13,490,461,964,64614
12417,2023-01-24,BULL,bounty,Excel,0,14,10,24,10896
12418,2023-01-23,BULL,knockout,New Perspective,0,24,5,29,20676
12419,2023-01-23,BULL,hotZone,Dueling Beetles,0,15,2,17,17502
12420,2023-01-23,BULL,heist,Snaked Assault,0,330,348,678,15762
12421,2023-01-23,BULL,gemGrab,Minecart Madness,0,43,23,66,19062
12422,2023-01-23,BULL,gemGrab,Double Swoosh,0,20,19,39,7578
12423,2023-01-23,BULL,brawlBall,Center Stage,34,1483,1652,3169,92862
12424,2023-01-23,BULL,brawlBall,Backyard Bowl,0,17,7,24,4224
12425,2023-01-23,BULL,bounty,Layer Cake,0,11,6,17,11142
12426,2023-01-22,BULL,knockout,X Marks the Spot,0,2,1,3,9174
12427,2023-01-22,BULL,hotZone,Ring of Fire,0,6,5,11,5730
12428,2023-01-22,BULL,heist,Snaked Assault,0,220,175,395,8232
12429,2023-01-22,BULL,gemGrab,Hard Rock Mine,0,35,35,70,4722
12430,2023-01-22,BULL,gemGrab,Double Swoosh,0,47,39,86,9426
12431,2023-01-22,BULL,brawlBall,Super Beach,2,57,58,117,7386
12432,2023-01-22,BULL,brawlBall,Backyard Bowl,3,92,77,172,34788
12433,2023-01-22,BULL,bounty,Layer Cake,0,17,23,40,6654
12434,2023-01-21,BULL,knockout,X Marks the Spot,0,17,13,30,31698
12435,2023-01-21,BULL,hotZone,Ring of Fire,0,15,5,20,16632
12436,2023-01-21,BULL,heist,Tornado Ring,2,412,499,913,11664
12437,2023-01-21,BULL,gemGrab,Hard Rock Mine,0,128,128,256,22980
12438,2023-01-21,BULL,gemGrab,Deep Diner,0,17,21,38,4470
12439,2023-01-21,BULL,brawlBall,Super Beach,25,949,949,1923,101364
12440,2023-01-21,BULL,brawlBall,Sneaky Fields,0,82,87,169,3750
12441,2023-01-21,BULL,bounty,Dry Season,0,7,2,9,14538
12442,2023-01-20,BULL,knockout,Out in the Open,0,18,3,21,20106
12443,2023-01-20,BULL,hotZone,Split,0,41,40,81,9678
12444,2023-01-20,BULL,heist,Tornado Ring,4,425,446,875,12672
12445,2023-01-20,BULL,gemGrab,Undermine,0,24,17,41,5442
12446,2023-01-20,BULL,gemGrab,Deep Diner,0,42,47,89,19050
12447,2023-01-20,BULL,brawlBall,Sneaky Fields,17,1238,1279,2534,74778
12448,2023-01-20,BULL,brawlBall,Pinhole Punt,0,17,24,41,2886
12449,2023-01-20,BULL,bounty,Dry Season,0,4,5,9,11640
12450,2023-01-19,BULL,knockout,Out in the Open,0,27,22,49,26574
12451,2023-01-19,BULL,hotZone,Split,0,85,49,134,14856
12452,2023-01-19,BULL,heist,Kaboom Canyon,1,45,38,84,6732
12453,2023-01-19,BULL,gemGrab,Undermine,0,96,80,176,14154
12454,2023-01-19,BULL,gemGrab,Gem Fort,0,22,31,53,2934
12455,2023-01-19,BULL,brawlBall,Sunny Soccer,0,30,40,70,2274
12456,2023-01-19,BULL,brawlBall,Pinhole Punt,9,531,529,1069,72498
12457,2023-01-19,BULL,bounty,Shooting Star,0,3,3,6,11124
12458,2023-01-18,BULL,knockout,Goldarm Gulch,0,5,3,8,2784
12459,2023-01-18,BULL,hotZone,Parallel Plays,0,3,2,5,1158
12460,2023-01-18,BULL,heist,Kaboom Canyon,0,14,8,22,2592
12461,2023-01-18,BULL,gemGrab,Gem Fort,0,25,19,44,3006
12462,2023-01-18,BULL,gemGrab,Crystal Arcade,0,3,8,11,990
12463,2023-01-18,BULL,brawlBall,Sunny Soccer,6,201,214,421,18941
12464,2023-01-18,BULL,brawlBall,Beach Ball,0,6,6,12,774
12465,2023-01-18,BULL,bounty,Shooting Star,0,1,5,6,5088
12466,2023-01-17,BULL,knockout,Goldarm Gulch,0,6,2,8,2520
12467,2023-01-17,BULL,hotZone,Parallel Plays,0,1,2,3,1038
12468,2023-01-17,BULL,heist,Pit Stop,0,55,60,115,1290
12469,2023-01-17,BULL,gemGrab,Crystal Arcade,0,1,3,4,1266
12470,2023-01-17,BULL,brawlBall,Center Stage,0,11,6,17,288
12471,2023-01-17,BULL,brawlBall,Beach Ball,0,63,77,140,5886
12472,2023-01-17,BULL,bounty,Hideout,0,2,3,5,750
12473,2023-01-16,BULL,knockout,Belle's Rock,0,0,2,2,1788
12474,2023-01-16,BULL,hotZone,Quarter Pounder,0,3,0,3,1494
12475,2023-01-16,BULL,heist,Pit Stop,0,284,251,535,4044
12476,2023-01-16,BULL,gemGrab,Minecart Madness,0,2,4,6,1422
12477,2023-01-16,BULL,gemGrab,Double Swoosh,0,2,1,3,708
12478,2023-01-16,BULL,brawlBall,Center Stage,2,100,109,211,5778
12479,2023-01-16,BULL,brawlBall,Backyard Bowl,0,1,1,2,852
12480,2023-01-15,BULL,knockout,Belle's Rock,0,1,0,1,2904
12481,2023-01-15,BULL,hotZone,Quarter Pounder,0,5,13,18,3318
12482,2023-01-15,BULL,heist,Bridge Too Far,0,6,0,6,2736
12483,2023-01-15,BULL,gemGrab,Hard Rock Mine,0,5,0,5,1014
12484,2023-01-15,BULL,gemGrab,Double Swoosh,0,7,9,16,2178
12485,2023-01-15,BULL,brawlBall,Super Beach,0,9,5,14,1074
12486,2023-01-15,BULL,brawlBall,Backyard Bowl,0,22,20,42,8946
12487,2023-01-15,BULL,bounty,Canal Grande,0,3,2,5,960
12488,2023-01-14,BULL,knockout,Flaring Phoenix,0,3,0,3,1080
12489,2023-01-14,BULL,hotZone,Controller Chaos,0,6,1,7,2772
12490,2023-01-14,BULL,heist,Bridge Too Far,0,6,1,7,4020
12491,2023-01-14,BULL,gemGrab,Hard Rock Mine,0,2,1,3,1272
12492,2023-01-14,BULL,gemGrab,Deep Diner,0,1,0,1,858
12493,2023-01-14,BULL,brawlBall,Super Beach,1,33,45,79,6336
12494,2023-01-14,BULL,brawlBall,Sneaky Fields,0,12,3,15,918
12495,2023-01-13,BULL,hotZone,Controller Chaos,0,1,1,2,2928
12496,2023-01-13,BULL,heist,Hot Potato,0,8,20,28,600
12497,2023-01-13,BULL,gemGrab,Deep Diner,0,3,8,11,1650
12498,2023-01-13,BULL,brawlBall,Sneaky Fields,2,86,56,144,6144
12499,2023-01-12,BULL,knockout,Riverside,0,2,4,6,2532
12500,2023-01-12,BULL,hotZone,Open Zone,0,1,0,1,1488
12501,2023-01-12,BULL,heist,Hot Potato,0,8,7,15,330
12502,2023-01-12,BULL,gemGrab,Undermine,0,0,1,1,690
12503,2023-01-12,BULL,gemGrab,Gem Fort,0,1,0,1,162
12504,2023-01-12,BULL,brawlBall,Sunny Soccer,0,1,0,1,240
12505,2023-01-12,BULL,brawlBall,Pinhole Punt,0,12,11,23,2292
12506,2023-01-11,BULL,heist,Safe Zone,0,1,0,1,48
12507,2023-01-11,BULL,gemGrab,Gem Fort,0,2,0,2,414
12508,2023-01-11,BULL,brawlBall,Sunny Soccer,0,6,4,10,1638
12509,2023-01-11,BULL,bounty,Excel,0,1,0,1,282
12510,2023-01-10,BULL,hotZone,Dueling Beetles,0,1,0,1,2424
12511,2023-01-10,BULL,heist,Safe Zone,0,3,2,5,1176
12512,2023-01-10,BULL,gemGrab,Minecart Madness,0,1,0,1,828
12513,2023-01-10,BULL,gemGrab,Crystal Arcade,0,5,2,7,1746
12514,2023-01-10,BULL,brawlBall,Center Stage,0,5,4,9,708
12515,2023-01-10,BULL,brawlBall,Beach Ball,0,22,6,28,4392
12516,2023-01-10,BULL,bounty,Excel,0,1,0,1,330
12517,2023-01-09,BULL,hotZone,Dueling Beetles,0,4,1,5,1554
12518,2023-01-09,BULL,heist,Snaked Assault,0,40,40,80,2022
12519,2023-01-09,BULL,gemGrab,Minecart Madness,0,2,0,2,1884
12520,2023-01-09,BULL,gemGrab,Double Swoosh,0,3,0,3,1320
12521,2023-01-09,BULL,brawlBall,Center Stage,0,45,43,88,5460
12522,2023-01-09,BULL,brawlBall,Backyard Bowl,0,1,0,1,474
12523,2023-01-09,BULL,bounty,Layer Cake,0,4,2,6,1512
12524,2023-01-08,BULL,knockout,X Marks the Spot,0,1,1,2,1692
12525,2023-01-08,BULL,hotZone,Ring of Fire,0,2,0,2,1644
12526,2023-01-08,BULL,heist,Snaked Assault,0,30,36,66,1494
12527,2023-01-08,BULL,gemGrab,Hard Rock Mine,0,3,1,4,630
12528,2023-01-08,BULL,gemGrab,Double Swoosh,0,2,1,3,864
12529,2023-01-08,BULL,brawlBall,Super Beach,0,3,0,3,732
12530,2023-01-08,BULL,brawlBall,Backyard Bowl,0,10,5,15,4830
12531,2023-01-08,BULL,bounty,Layer Cake,0,1,1,2,528
12532,2023-01-07,BULL,hotZone,Ring of Fire,0,1,0,1,846
12533,2023-01-07,BULL,heist,Tornado Ring,0,37,35,72,1350
12534,2023-01-07,BULL,gemGrab,Hard Rock Mine,0,6,2,8,1158
12535,2023-01-07,BULL,gemGrab,Deep Diner,0,2,0,2,918
12536,2023-01-07,BULL,brawlBall,Super Beach,0,11,5,16,2622
12537,2023-01-07,BULL,brawlBall,Sneaky Fields,0,2,2,4,402
12538,2023-01-07,BULL,bounty,Dry Season,0,2,1,3,1320
12539,2023-01-06,BULL,hotZone,Split,0,6,3,9,1158
12540,2023-01-06,BULL,heist,Tornado Ring,0,77,114,191,2538
12541,2023-01-06,BULL,gemGrab,Undermine,0,1,0,1,540
12542,2023-01-06,BULL,gemGrab,Deep Diner,0,4,0,4,2226
12543,2023-01-06,BULL,brawlBall,Sneaky Fields,1,54,75,130,4896
12544,2023-01-06,BULL,brawlBall,Pinhole Punt,0,3,6,9,510
12545,2023-01-06,BULL,bounty,Dry Season,0,1,0,1,1944
12546,2023-01-05,BULL,knockout,Out in the Open,0,1,0,1,2958
12547,2023-01-05,BULL,hotZone,Split,0,18,11,29,3552
12548,2023-01-05,BULL,heist,Kaboom Canyon,0,2,1,3,954
12549,2023-01-05,BULL,gemGrab,Undermine,0,1,2,3,1812
12550,2023-01-05,BULL,gemGrab,Gem Fort,0,4,6,10,252
12551,2023-01-05,BULL,brawlBall,Sunny Soccer,0,1,2,3,84
12552,2023-01-05,BULL,brawlBall,Pinhole Punt,0,35,16,51,8118
12553,2023-01-05,BULL,bounty,Shooting Star,0,1,0,1,1362
12554,2023-01-04,BULL,hotZone,Parallel Plays,0,2,3,5,864
12555,2023-01-04,BULL,heist,Kaboom Canyon,0,13,10,23,1848
12556,2023-01-04,BULL,gemGrab,Gem Fort,0,3,0,3,1788
12557,2023-01-04,BULL,gemGrab,Crystal Arcade,0,1,1,2,642
12558,2023-01-04,BULL,brawlBall,Sunny Soccer,0,32,15,47,6312
12559,2023-01-03,BULL,hotZone,Parallel Plays,0,1,0,1,1542
12560,2023-01-03,BULL,heist,Pit Stop,1,126,138,265,1956
12561,2023-01-03,BULL,gemGrab,Minecart Madness,0,1,1,2,456
12562,2023-01-03,BULL,gemGrab,Crystal Arcade,0,4,0,4,2406
12563,2023-01-03,BULL,brawlBall,Center Stage,0,2,1,3,294
12564,2023-01-03,BULL,brawlBall,Beach Ball,0,9,18,27,5580
12565,2023-01-03,BULL,bounty,Hideout,0,2,1,3,1638
12566,2023-01-02,BULL,knockout,Belle's Rock,0,1,0,1,1794
12567,2023-01-02,BULL,hotZone,Quarter Pounder,0,2,0,2,2652
12568,2023-01-02,BULL,heist,Pit Stop,2,187,166,355,3498
12569,2023-01-02,BULL,gemGrab,Minecart Madness,0,5,3,8,2352
12570,2023-01-02,BULL,gemGrab,Double Swoosh,0,4,1,5,1512
12571,2023-01-02,BULL,brawlBall,Center Stage,1,77,63,141,7110
12572,2023-01-02,BULL,brawlBall,Backyard Bowl,0,3,2,5,492
12573,2023-01-02,BULL,bounty,Hideout,0,0,1,1,3090
12574,2023-01-01,BULL,hotZone,Quarter Pounder,0,1,1,2,1188
12575,2023-01-01,BULL,heist,Bridge Too Far,0,2,0,2,462
12576,2023-01-01,BULL,gemGrab,Double Swoosh,0,3,1,4,1140
12577,2023-01-01,BULL,brawlBall,Backyard Bowl,0,5,3,8,2658
12578,2023-01-01,BULL,bounty,Canal Grande,0,0,1,1,132
12579,2022-12-31,BULL,hotZone,Controller Chaos,0,1,0,1,198
12580,2022-12-31,BULL,heist,Bridge Too Far,0,0,1,1,276
12581,2022-12-31,BULL,brawlBall,Super Beach,0,5,2,7,618
12582,2022-12-31,BULL,brawlBall,Sneaky Fields,0,4,3,7,60
12583,2022-12-30,BULL,heist,Hot Potato,0,0,2,2,30
12584,2022-12-30,BULL,gemGrab,Undermine,0,1,0,1,102
12585,2022-12-30,BULL,brawlBall,Sneaky Fields,0,2,2,4,552
12586,2022-12-29,BULL,heist,Hot Potato,0,5,9,14,72
12587,2022-12-29,BULL,gemGrab,Gem Fort,0,0,1,1,30
12588,2022-12-27,BULL,gemGrab,Minecart Madness,0,1,0,1,30
12589,2022-12-27,BULL,brawlBall,Beach Ball,0,1,0,1,144
12590,2022-12-26,BULL,hotZone,Controller Chaos,0,0,1,1,30
12591,2022-12-23,BULL,knockout,Out in the Open,0,0,1,1,132
12592,2022-12-22,BULL,brawlBall,Pinhole Punt,0,0,1,1,132
12593,2022-12-19,BULL,brawlBall,Center Stage,0,1,1,2,102
12594,2022-12-13,BULL,hotZone,Dueling Beetles,0,1,0,1,6
12595,2022-10-30,BULL,heist,Safe Zone,0,0,1,1,6
12596,2022-10-30,BULL,brawlBall,Beach Ball,0,0,2,2,12
12597,2022-10-28,BULL,hotZone,Dueling Beetles,0,1,0,1,12
12598,2022-10-15,BULL,gemGrab,Hard Rock Mine,0,0,1,1,90
12599,2022-10-15,BULL,brawlBall,Super Beach,0,0,1,1,12
12600,2023-01-28,BROCK,knockout,Flaring Phoenix,1,243,192,436,12366
12601,2023-01-28,BROCK,hotZone,Controller Chaos,0,28,5,33,10134
12602,2023-01-28,BROCK,heist,Bridge Too Far,5,814,678,1497,24240
12603,2023-01-28,BROCK,gemGrab,Hard Rock Mine,0,95,53,148,16638
12604,2023-01-28,BROCK,gemGrab,Deep Diner,0,48,23,71,5478
12605,2023-01-28,BROCK,brawlBall,Super Beach,9,266,196,471,74430
12606,2023-01-28,BROCK,brawlBall,Sneaky Fields,0,5,4,9,3582
12607,2023-01-28,BROCK,bounty,Canal Grande,0,213,162,375,10902
12608,2023-01-27,BROCK,knockout,Flaring Phoenix,0,96,72,168,5928
12609,2023-01-27,BROCK,hotZone,Controller Chaos,0,11,3,14,2676
12610,2023-01-27,BROCK,heist,Hot Potato,0,77,35,112,3486
12611,2023-01-27,BROCK,gemGrab,Undermine,0,9,7,16,942
12612,2023-01-27,BROCK,gemGrab,Deep Diner,0,71,41,112,6846
12613,2023-01-27,BROCK,brawlBall,Sneaky Fields,1,54,36,91,23514
12614,2023-01-27,BROCK,brawlBall,Pinhole Punt,1,2,1,4,738
12615,2023-01-27,BROCK,bounty,Temple Ruins,0,41,24,65,1890
12616,2023-01-26,BROCK,knockout,Riverside,1,621,409,1031,19008
12617,2023-01-26,BROCK,hotZone,Open Zone,0,53,25,78,10182
12618,2023-01-26,BROCK,heist,Hot Potato,0,127,87,214,14610
12619,2023-01-26,BROCK,gemGrab,Undermine,0,90,48,138,10062
12620,2023-01-26,BROCK,gemGrab,Gem Fort,0,17,27,44,4674
12621,2023-01-26,BROCK,brawlBall,Sunny Soccer,0,5,2,7,3660
12622,2023-01-26,BROCK,brawlBall,Pinhole Punt,6,343,252,601,67338
12623,2023-01-26,BROCK,bounty,Temple Ruins,0,103,60,163,5610
12624,2023-01-25,BROCK,knockout,Riverside,0,319,242,561,9906
12625,2023-01-25,BROCK,hotZone,Open Zone,0,28,8,36,5262
12626,2023-01-25,BROCK,heist,Safe Zone,2,486,461,949,9156
12627,2023-01-25,BROCK,gemGrab,Gem Fort,0,29,34,63,5556
12628,2023-01-25,BROCK,gemGrab,Crystal Arcade,0,51,29,80,7866
12629,2023-01-25,BROCK,brawlBall,Sunny Soccer,3,127,122,252,40830
12630,2023-01-25,BROCK,brawlBall,Beach Ball,0,31,33,64,6408
12631,2023-01-25,BROCK,bounty,Excel,0,158,96,254,5790
12632,2023-01-24,BROCK,knockout,New Perspective,0,236,163,399,10542
12633,2023-01-24,BROCK,hotZone,Dueling Beetles,0,50,29,79,10662
12634,2023-01-24,BROCK,heist,Safe Zone,4,739,650,1393,15750
12635,2023-01-24,BROCK,gemGrab,Minecart Madness,0,64,45,109,4002
12636,2023-01-24,BROCK,gemGrab,Crystal Arcade,0,113,60,173,14460
12637,2023-01-24,BROCK,brawlBall,Center Stage,1,37,26,64,7860
12638,2023-01-24,BROCK,brawlBall,Beach Ball,12,277,217,506,64614
12639,2023-01-24,BROCK,bounty,Excel,0,239,173,412,10896
12640,2023-01-23,BROCK,knockout,New Perspective,0,422,325,747,20676
12641,2023-01-23,BROCK,hotZone,Dueling Beetles,1,64,19,84,17502
12642,2023-01-23,BROCK,heist,Snaked Assault,0,191,94,285,15762
12643,2023-01-23,BROCK,gemGrab,Minecart Madness,0,279,222,501,19062
12644,2023-01-23,BROCK,gemGrab,Double Swoosh,0,71,78,149,7578
12645,2023-01-23,BROCK,brawlBall,Center Stage,7,433,289,729,92862
12646,2023-01-23,BROCK,brawlBall,Backyard Bowl,2,60,64,126,4224
12647,2023-01-23,BROCK,bounty,Layer Cake,0,298,203,501,11142
12648,2023-01-22,BROCK,knockout,X Marks the Spot,1,296,254,551,9174
12649,2023-01-22,BROCK,hotZone,Ring of Fire,0,25,7,32,5730
12650,2023-01-22,BROCK,heist,Snaked Assault,1,110,54,165,8232
12651,2023-01-22,BROCK,gemGrab,Hard Rock Mine,0,24,15,39,4722
12652,2023-01-22,BROCK,gemGrab,Double Swoosh,0,49,29,78,9426
12653,2023-01-22,BROCK,brawlBall,Super Beach,0,34,29,63,7386
12654,2023-01-22,BROCK,brawlBall,Backyard Bowl,21,519,485,1025,34788
12655,2023-01-22,BROCK,bounty,Layer Cake,0,166,143,309,6654
12656,2023-01-21,BROCK,knockout,X Marks the Spot,0,1016,841,1857,31698
12657,2023-01-21,BROCK,hotZone,Ring of Fire,0,84,26,110,16632
12658,2023-01-21,BROCK,heist,Tornado Ring,0,107,83,190,11664
12659,2023-01-21,BROCK,gemGrab,Hard Rock Mine,0,125,79,204,22980
12660,2023-01-21,BROCK,gemGrab,Deep Diner,0,32,17,49,4470
12661,2023-01-21,BROCK,brawlBall,Super Beach,10,282,223,515,101364
12662,2023-01-21,BROCK,brawlBall,Sneaky Fields,0,5,1,6,3750
12663,2023-01-21,BROCK,bounty,Dry Season,0,546,490,1036,14538
12664,2023-01-20,BROCK,knockout,Out in the Open,1,672,597,1270,20106
12665,2023-01-20,BROCK,hotZone,Split,0,33,14,47,9678
12666,2023-01-20,BROCK,heist,Tornado Ring,0,100,48,148,12672
12667,2023-01-20,BROCK,gemGrab,Undermine,0,50,24,74,5442
12668,2023-01-20,BROCK,gemGrab,Deep Diner,0,179,106,285,19050
12669,2023-01-20,BROCK,brawlBall,Sneaky Fields,2,159,131,292,74778
12670,2023-01-20,BROCK,brawlBall,Pinhole Punt,0,23,17,40,2886
12671,2023-01-20,BROCK,bounty,Dry Season,0,391,259,650,11640
12672,2023-01-19,BROCK,knockout,Out in the Open,2,844,764,1610,26574
12673,2023-01-19,BROCK,hotZone,Split,0,47,21,68,14856
12674,2023-01-19,BROCK,heist,Kaboom Canyon,1,251,208,460,6732
12675,2023-01-19,BROCK,gemGrab,Undermine,0,129,110,239,14154
12676,2023-01-19,BROCK,gemGrab,Gem Fort,0,17,24,41,2934
12677,2023-01-19,BROCK,brawlBall,Sunny Soccer,0,9,3,12,2274
12678,2023-01-19,BROCK,brawlBall,Pinhole Punt,10,330,274,614,72498
12679,2023-01-19,BROCK,bounty,Shooting Star,0,389,294,683,11124
12680,2023-01-18,BROCK,knockout,Goldarm Gulch,0,70,40,110,2784
12681,2023-01-18,BROCK,hotZone,Parallel Plays,0,9,6,15,1158
12682,2023-01-18,BROCK,heist,Kaboom Canyon,1,95,120,216,2592
12683,2023-01-18,BROCK,gemGrab,Gem Fort,0,21,21,42,3006
12684,2023-01-18,BROCK,gemGrab,Crystal Arcade,0,9,4,13,990
12685,2023-01-18,BROCK,brawlBall,Sunny Soccer,1,64,48,113,18941
12686,2023-01-18,BROCK,brawlBall,Beach Ball,0,3,5,8,774
12687,2023-01-18,BROCK,bounty,Shooting Star,0,156,119,275,5088
12688,2023-01-17,BROCK,knockout,Goldarm Gulch,0,52,32,84,2520
12689,2023-01-17,BROCK,hotZone,Parallel Plays,0,4,1,5,1038
12690,2023-01-17,BROCK,heist,Pit Stop,0,6,8,14,1290
12691,2023-01-17,BROCK,gemGrab,Minecart Madness,0,6,2,8,216
12692,2023-01-17,BROCK,gemGrab,Crystal Arcade,0,10,5,15,1266
12693,2023-01-17,BROCK,brawlBall,Center Stage,1,1,1,3,288
12694,2023-01-17,BROCK,brawlBall,Beach Ball,1,21,21,43,5886
12695,2023-01-17,BROCK,bounty,Hideout,0,22,24,46,750
12696,2023-01-16,BROCK,knockout,Belle's Rock,0,53,31,84,1788
12697,2023-01-16,BROCK,hotZone,Quarter Pounder,0,4,2,6,1494
12698,2023-01-16,BROCK,heist,Pit Stop,0,9,8,17,4044
12699,2023-01-16,BROCK,gemGrab,Minecart Madness,0,17,11,28,1422
12700,2023-01-16,BROCK,gemGrab,Double Swoosh,0,3,5,8,708
12701,2023-01-16,BROCK,brawlBall,Center Stage,0,21,26,47,5778
12702,2023-01-16,BROCK,brawlBall,Backyard Bowl,0,10,7,17,852
12703,2023-01-16,BROCK,bounty,Hideout,0,52,35,87,1470
12704,2023-01-15,BROCK,knockout,Belle's Rock,0,96,80,176,2904
12705,2023-01-15,BROCK,hotZone,Quarter Pounder,0,18,2,20,3318
12706,2023-01-15,BROCK,heist,Bridge Too Far,1,107,73,181,2736
12707,2023-01-15,BROCK,gemGrab,Hard Rock Mine,0,4,1,5,1014
12708,2023-01-15,BROCK,gemGrab,Double Swoosh,0,7,1,8,2178
12709,2023-01-15,BROCK,brawlBall,Super Beach,0,2,0,2,1074
12710,2023-01-15,BROCK,brawlBall,Backyard Bowl,10,100,133,243,8946
12711,2023-01-15,BROCK,bounty,Canal Grande,0,20,8,28,960
12712,2023-01-14,BROCK,knockout,Flaring Phoenix,0,18,9,27,1080
12713,2023-01-14,BROCK,hotZone,Controller Chaos,0,13,1,14,2772
12714,2023-01-14,BROCK,heist,Bridge Too Far,0,133,94,227,4020
12715,2023-01-14,BROCK,gemGrab,Hard Rock Mine,0,10,2,12,1272
12716,2023-01-14,BROCK,gemGrab,Deep Diner,0,7,2,9,858
12717,2023-01-14,BROCK,brawlBall,Super Beach,0,21,8,29,6336
12718,2023-01-14,BROCK,brawlBall,Sneaky Fields,0,1,1,2,918
12719,2023-01-14,BROCK,bounty,Canal Grande,0,32,23,55,1014
12720,2023-01-13,BROCK,knockout,Flaring Phoenix,0,20,21,41,1182
12721,2023-01-13,BROCK,hotZone,Controller Chaos,0,6,0,6,2928
12722,2023-01-13,BROCK,heist,Hot Potato,0,4,1,5,600
12723,2023-01-13,BROCK,gemGrab,Deep Diner,0,13,2,15,1650
12724,2023-01-13,BROCK,brawlBall,Sneaky Fields,0,8,2,10,6144
12725,2023-01-13,BROCK,brawlBall,Pinhole Punt,2,1,3,6,156
12726,2023-01-13,BROCK,bounty,Temple Ruins,0,6,2,8,270
12727,2023-01-12,BROCK,knockout,Riverside,0,100,68,168,2532
12728,2023-01-12,BROCK,hotZone,Open Zone,0,8,0,8,1488
12729,2023-01-12,BROCK,gemGrab,Undermine,0,4,1,5,690
12730,2023-01-12,BROCK,brawlBall,Sunny Soccer,0,1,0,1,240
12731,2023-01-12,BROCK,brawlBall,Pinhole Punt,0,9,6,15,2292
12732,2023-01-12,BROCK,bounty,Temple Ruins,0,1,0,1,24
12733,2023-01-11,BROCK,knockout,Riverside,0,15,5,20,528
12734,2023-01-11,BROCK,hotZone,Open Zone,0,1,0,1,462
12735,2023-01-11,BROCK,heist,Safe Zone,0,2,1,3,48
12736,2023-01-11,BROCK,gemGrab,Gem Fort,0,0,1,1,414
12737,2023-01-11,BROCK,brawlBall,Sunny Soccer,0,7,0,7,1638
12738,2023-01-11,BROCK,brawlBall,Beach Ball,0,0,1,1,48
12739,2023-01-11,BROCK,bounty,Excel,0,3,0,3,282
12740,2023-01-10,BROCK,knockout,New Perspective,0,24,20,44,720
12741,2023-01-10,BROCK,hotZone,Dueling Beetles,0,10,16,26,2424
12742,2023-01-10,BROCK,heist,Safe Zone,0,63,54,117,1176
12743,2023-01-10,BROCK,gemGrab,Minecart Madness,0,15,8,23,828
12744,2023-01-10,BROCK,gemGrab,Crystal Arcade,0,9,9,18,1746
12745,2023-01-10,BROCK,brawlBall,Center Stage,0,6,2,8,708
12746,2023-01-10,BROCK,brawlBall,Beach Ball,0,13,11,24,4392
12747,2023-01-10,BROCK,bounty,Excel,0,8,1,9,330
12748,2023-01-09,BROCK,knockout,New Perspective,0,16,4,20,876
12749,2023-01-09,BROCK,hotZone,Dueling Beetles,0,5,0,5,1554
12750,2023-01-09,BROCK,heist,Snaked Assault,0,19,18,37,2022
12751,2023-01-09,BROCK,gemGrab,Minecart Madness,0,19,7,26,1884
12752,2023-01-09,BROCK,gemGrab,Double Swoosh,0,12,4,16,1320
12753,2023-01-09,BROCK,brawlBall,Center Stage,1,14,11,26,5460
12754,2023-01-09,BROCK,brawlBall,Backyard Bowl,0,8,2,10,474
12755,2023-01-09,BROCK,bounty,Layer Cake,0,37,29,66,1512
12756,2023-01-08,BROCK,knockout,X Marks the Spot,0,67,55,122,1692
12757,2023-01-08,BROCK,hotZone,Ring of Fire,0,8,9,17,1644
12758,2023-01-08,BROCK,heist,Snaked Assault,0,14,9,23,1494
12759,2023-01-08,BROCK,gemGrab,Hard Rock Mine,0,1,0,1,630
12760,2023-01-08,BROCK,gemGrab,Double Swoosh,0,1,2,3,864
12761,2023-01-08,BROCK,brawlBall,Super Beach,0,3,5,8,732
12762,2023-01-08,BROCK,brawlBall,Backyard Bowl,4,78,74,156,4830
12763,2023-01-08,BROCK,bounty,Layer Cake,0,18,8,26,528
12764,2023-01-07,BROCK,knockout,X Marks the Spot,0,43,23,66,1014
12765,2023-01-07,BROCK,hotZone,Ring of Fire,0,2,0,2,846
12766,2023-01-07,BROCK,heist,Tornado Ring,0,9,5,14,1350
12767,2023-01-07,BROCK,gemGrab,Hard Rock Mine,0,6,1,7,1158
12768,2023-01-07,BROCK,gemGrab,Deep Diner,0,6,5,11,918
12769,2023-01-07,BROCK,brawlBall,Super Beach,0,4,2,6,2622
12770,2023-01-07,BROCK,brawlBall,Sneaky Fields,0,1,0,1,402
12771,2023-01-07,BROCK,bounty,Dry Season,0,50,62,112,1320
12772,2023-01-06,BROCK,knockout,Out in the Open,0,45,31,76,1446
12773,2023-01-06,BROCK,hotZone,Split,0,4,0,4,1158
12774,2023-01-06,BROCK,heist,Tornado Ring,0,15,2,17,2538
12775,2023-01-06,BROCK,gemGrab,Undermine,0,2,2,4,540
12776,2023-01-06,BROCK,gemGrab,Deep Diner,0,9,5,14,2226
12777,2023-01-06,BROCK,brawlBall,Sneaky Fields,0,5,5,10,4896
12778,2023-01-06,BROCK,brawlBall,Pinhole Punt,0,0,1,1,510
12779,2023-01-06,BROCK,bounty,Dry Season,0,77,31,108,1944
12780,2023-01-05,BROCK,knockout,Out in the Open,0,115,100,215,2958
12781,2023-01-05,BROCK,hotZone,Split,0,9,0,9,3552
12782,2023-01-05,BROCK,heist,Kaboom Canyon,0,42,28,70,954
12783,2023-01-05,BROCK,gemGrab,Undermine,0,6,3,9,1812
12784,2023-01-05,BROCK,gemGrab,Gem Fort,0,5,1,6,252
12785,2023-01-05,BROCK,brawlBall,Sunny Soccer,0,1,0,1,84
12786,2023-01-05,BROCK,brawlBall,Pinhole Punt,1,20,10,31,8118
12787,2023-01-05,BROCK,bounty,Shooting Star,0,53,54,107,1362
12788,2023-01-04,BROCK,knockout,Goldarm Gulch,0,18,29,47,696
12789,2023-01-04,BROCK,hotZone,Parallel Plays,0,0,1,1,864
12790,2023-01-04,BROCK,heist,Kaboom Canyon,0,84,145,229,1848
12791,2023-01-04,BROCK,gemGrab,Gem Fort,0,6,4,10,1788
12792,2023-01-04,BROCK,gemGrab,Crystal Arcade,0,3,0,3,642
12793,2023-01-04,BROCK,brawlBall,Sunny Soccer,0,11,19,30,6312
12794,2023-01-04,BROCK,bounty,Shooting Star,0,136,131,267,3570
12795,2023-01-03,BROCK,knockout,Goldarm Gulch,0,14,13,27,720
12796,2023-01-03,BROCK,hotZone,Parallel Plays,0,3,0,3,1542
12797,2023-01-03,BROCK,heist,Pit Stop,0,7,1,8,1956
12798,2023-01-03,BROCK,heist,Kaboom Canyon,0,2,1,3,12
12799,2023-01-03,BROCK,gemGrab,Minecart Madness,0,0,1,1,456
12800,2023-01-03,BROCK,gemGrab,Crystal Arcade,0,15,39,54,2406
12801,2023-01-03,BROCK,brawlBall,Center Stage,0,1,0,1,294
12802,2023-01-03,BROCK,brawlBall,Beach Ball,1,22,30,53,5580
12803,2023-01-03,BROCK,bounty,Hideout,0,54,20,74,1638
12804,2023-01-02,BROCK,knockout,Belle's Rock,0,55,58,113,1794
12805,2023-01-02,BROCK,hotZone,Quarter Pounder,0,9,0,9,2652
12806,2023-01-02,BROCK,heist,Pit Stop,0,8,0,8,3498
12807,2023-01-02,BROCK,heist,Kaboom Canyon,0,0,2,2,30
12808,2023-01-02,BROCK,gemGrab,Minecart Madness,0,26,6,32,2352
12809,2023-01-02,BROCK,gemGrab,Double Swoosh,0,9,4,13,1512
12810,2023-01-02,BROCK,brawlBall,Center Stage,1,22,16,39,7110
12811,2023-01-02,BROCK,brawlBall,Backyard Bowl,0,4,2,6,492
12812,2023-01-02,BROCK,bounty,Hideout,0,128,87,215,3090
12813,2023-01-01,BROCK,knockout,Belle's Rock,0,34,15,49,858
12814,2023-01-01,BROCK,hotZone,Quarter Pounder,0,3,1,4,1188
12815,2023-01-01,BROCK,heist,Kaboom Canyon,0,1,1,2,12
12816,2023-01-01,BROCK,heist,Bridge Too Far,0,15,9,24,462
12817,2023-01-01,BROCK,gemGrab,Double Swoosh,0,3,1,4,1140
12818,2023-01-01,BROCK,brawlBall,Backyard Bowl,0,41,30,71,2658
12819,2023-01-01,BROCK,bounty,Canal Grande,0,5,4,9,132
12820,2022-12-31,BROCK,knockout,Flaring Phoenix,0,1,0,1,18
12821,2022-12-31,BROCK,heist,Bridge Too Far,0,13,19,32,276
12822,2022-12-31,BROCK,gemGrab,Hard Rock Mine,0,1,0,1,384
12823,2022-12-31,BROCK,gemGrab,Deep Diner,0,7,12,19,306
12824,2022-12-31,BROCK,brawlBall,Super Beach,0,2,3,5,618
12825,2022-12-30,BROCK,knockout,Flaring Phoenix,0,3,2,5,72
12826,2022-12-30,BROCK,heist,Kaboom Canyon,0,0,1,1,18
12827,2022-12-30,BROCK,gemGrab,Deep Diner,0,2,0,2,438
12828,2022-12-30,BROCK,brawlBall,Sneaky Fields,0,0,2,2,552
12829,2022-12-29,BROCK,heist,Kaboom Canyon,0,1,1,2,18
12830,2022-12-27,BROCK,knockout,New Perspective,0,2,3,5,30
12831,2022-12-27,BROCK,hotZone,Dueling Beetles,0,0,1,1,36
12832,2022-12-27,BROCK,heist,Safe Zone,0,1,1,2,12
12833,2022-12-27,BROCK,heist,Kaboom Canyon,0,1,0,1,18
12834,2022-12-27,BROCK,bounty,Excel,0,0,1,1,18
12835,2022-12-26,BROCK,heist,Kaboom Canyon,0,1,0,1,36
12836,2022-12-26,BROCK,gemGrab,Minecart Madness,0,2,0,2,60
12837,2022-12-25,BROCK,hotZone,Ring of Fire,0,1,0,1,12
12838,2022-12-25,BROCK,gemGrab,Double Swoosh,0,1,1,2,30
12839,2022-12-25,BROCK,brawlBall,Backyard Bowl,0,2,10,12,78
12840,2022-12-24,BROCK,knockout,X Marks the Spot,0,0,1,1,12
12841,2022-12-23,BROCK,knockout,Out in the Open,0,5,9,14,132
12842,2022-12-22,BROCK,heist,Kaboom Canyon,0,0,1,1,6
12843,2022-12-22,BROCK,brawlBall,Pinhole Punt,0,2,0,2,132
12844,2022-12-20,BROCK,brawlBall,Beach Ball,0,4,2,6,96
12845,2022-12-19,BROCK,brawlBall,Center Stage,0,1,1,2,102
12846,2022-12-18,BROCK,heist,Bridge Too Far,0,1,0,1,12
12847,2022-12-16,BROCK,bounty,Temple Ruins,0,2,0,2,24
12848,2022-12-13,BROCK,heist,Safe Zone,0,3,2,5,42
12849,2022-12-13,BROCK,gemGrab,Crystal Arcade,0,2,1,3,72
12850,2022-12-10,BROCK,knockout,X Marks the Spot,0,1,1,2,12
12851,2022-11-11,BROCK,knockout,New Perspective,0,0,2,2,12
12852,2022-11-03,BROCK,brawlBall,Pinhole Punt,0,1,0,1,12
12853,2022-11-03,BROCK,bounty,Temple Ruins,0,1,0,1,6
12854,2022-11-01,BROCK,knockout,New Perspective,0,4,4,8,54
12855,2022-10-28,BROCK,knockout,Out in the Open,0,1,0,1,18
12856,2022-10-28,BROCK,heist,Safe Zone,0,1,1,2,6
12857,2022-10-28,BROCK,bounty,Canal Grande,0,0,2,2,12
12858,2022-10-26,BROCK,bounty,Shooting Star,0,1,0,1,36
12859,2022-10-15,BROCK,gemGrab,Hard Rock Mine,0,1,0,1,90
12860,2022-10-15,BROCK,brawlBall,Super Beach,0,1,0,1,12
12861,2022-10-10,BROCK,knockout,Belle's Rock,0,3,2,5,48
12862,2023-01-28,BONNIE,knockout,Flaring Phoenix,1,49,44,94,12366
12863,2023-01-28,BONNIE,hotZone,Controller Chaos,0,11,8,19,10134
12864,2023-01-28,BONNIE,heist,Bridge Too Far,0,247,319,566,24240
12865,2023-01-28,BONNIE,gemGrab,Hard Rock Mine,0,43,65,108,16638
12866,2023-01-28,BONNIE,gemGrab,Deep Diner,0,7,9,16,5478
12867,2023-01-28,BONNIE,brawlBall,Super Beach,1,90,85,176,74430
12868,2023-01-28,BONNIE,brawlBall,Sneaky Fields,0,0,1,1,3582
12869,2023-01-28,BONNIE,bounty,Canal Grande,0,14,6,20,10902
12870,2023-01-27,BONNIE,knockout,Flaring Phoenix,1,24,12,37,5928
12871,2023-01-27,BONNIE,hotZone,Controller Chaos,0,2,2,4,2676
12872,2023-01-27,BONNIE,heist,Hot Potato,0,6,1,7,3486
12873,2023-01-27,BONNIE,gemGrab,Undermine,0,5,2,7,942
12874,2023-01-27,BONNIE,gemGrab,Deep Diner,0,14,14,28,6846
12875,2023-01-27,BONNIE,brawlBall,Sneaky Fields,0,28,36,64,23514
12876,2023-01-27,BONNIE,bounty,Temple Ruins,0,11,14,25,1890
12877,2023-01-26,BONNIE,knockout,Riverside,1,124,162,287,19008
12878,2023-01-26,BONNIE,hotZone,Open Zone,0,41,54,95,10182
12879,2023-01-26,BONNIE,heist,Hot Potato,0,15,16,31,14610
12880,2023-01-26,BONNIE,gemGrab,Undermine,0,26,27,53,10062
12881,2023-01-26,BONNIE,gemGrab,Gem Fort,0,7,6,13,4674
12882,2023-01-26,BONNIE,brawlBall,Sunny Soccer,0,2,15,17,3660
12883,2023-01-26,BONNIE,brawlBall,Pinhole Punt,3,170,227,400,67338
12884,2023-01-26,BONNIE,bounty,Temple Ruins,0,25,22,47,5610
12885,2023-01-25,BONNIE,knockout,Riverside,0,57,58,115,9906
12886,2023-01-25,BONNIE,hotZone,Open Zone,0,28,37,65,5262
12887,2023-01-25,BONNIE,heist,Safe Zone,0,83,116,199,9156
12888,2023-01-25,BONNIE,gemGrab,Gem Fort,0,8,3,11,5556
12889,2023-01-25,BONNIE,gemGrab,Crystal Arcade,0,9,17,26,7866
12890,2023-01-25,BONNIE,brawlBall,Sunny Soccer,0,49,40,89,40830
12891,2023-01-25,BONNIE,brawlBall,Beach Ball,1,16,9,26,6408
12892,2023-01-25,BONNIE,bounty,Excel,0,28,80,108,5790
12893,2023-01-24,BONNIE,knockout,New Perspective,0,59,84,143,10542
12894,2023-01-24,BONNIE,hotZone,Dueling Beetles,0,10,13,23,10662
12895,2023-01-24,BONNIE,heist,Safe Zone,2,117,245,364,15750
12896,2023-01-24,BONNIE,gemGrab,Minecart Madness,0,14,21,35,4002
12897,2023-01-24,BONNIE,gemGrab,Crystal Arcade,0,25,33,58,14460
12898,2023-01-24,BONNIE,brawlBall,Center Stage,2,12,15,29,7860
12899,2023-01-24,BONNIE,brawlBall,Beach Ball,2,117,138,257,64614
12900,2023-01-24,BONNIE,bounty,Excel,0,30,41,71,10896
12901,2023-01-23,BONNIE,knockout,New Perspective,0,87,95,182,20676
12902,2023-01-23,BONNIE,hotZone,Dueling Beetles,0,30,61,91,17502
12903,2023-01-23,BONNIE,heist,Snaked Assault,0,12,14,26,15762
12904,2023-01-23,BONNIE,gemGrab,Minecart Madness,0,89,154,243,19062
12905,2023-01-23,BONNIE,gemGrab,Double Swoosh,0,4,3,7,7578
12906,2023-01-23,BONNIE,brawlBall,Center Stage,4,80,76,160,92862
12907,2023-01-23,BONNIE,brawlBall,Backyard Bowl,0,31,31,62,4224
12908,2023-01-23,BONNIE,bounty,Layer Cake,0,38,50,88,11142
12909,2023-01-22,BONNIE,knockout,X Marks the Spot,0,35,26,61,9174
12910,2023-01-22,BONNIE,hotZone,Ring of Fire,0,7,6,13,5730
12911,2023-01-22,BONNIE,heist,Snaked Assault,0,10,8,18,8232
12912,2023-01-22,BONNIE,gemGrab,Hard Rock Mine,0,16,5,21,4722
12913,2023-01-22,BONNIE,gemGrab,Double Swoosh,0,13,8,21,9426
12914,2023-01-22,BONNIE,brawlBall,Super Beach,1,8,22,31,7386
12915,2023-01-22,BONNIE,brawlBall,Backyard Bowl,6,131,210,347,34788
12916,2023-01-22,BONNIE,bounty,Layer Cake,0,18,21,39,6654
12917,2023-01-21,BONNIE,knockout,X Marks the Spot,0,150,157,307,31698
12918,2023-01-21,BONNIE,hotZone,Ring of Fire,0,19,18,37,16632
12919,2023-01-21,BONNIE,heist,Tornado Ring,0,11,7,18,11664
12920,2023-01-21,BONNIE,gemGrab,Hard Rock Mine,0,48,42,90,22980
12921,2023-01-21,BONNIE,gemGrab,Deep Diner,0,18,18,36,4470
12922,2023-01-21,BONNIE,brawlBall,Super Beach,2,129,169,300,101364
12923,2023-01-21,BONNIE,brawlBall,Sneaky Fields,0,2,17,19,3750
12924,2023-01-21,BONNIE,bounty,Dry Season,0,74,108,182,14538
12925,2023-01-20,BONNIE,knockout,Out in the Open,0,101,128,229,20106
12926,2023-01-20,BONNIE,hotZone,Split,0,1,4,5,9678
12927,2023-01-20,BONNIE,heist,Tornado Ring,0,16,3,19,12672
12928,2023-01-20,BONNIE,gemGrab,Undermine,0,17,17,34,5442
12929,2023-01-20,BONNIE,gemGrab,Deep Diner,0,47,76,123,19050
12930,2023-01-20,BONNIE,brawlBall,Sneaky Fields,0,66,57,123,74778
12931,2023-01-20,BONNIE,brawlBall,Pinhole Punt,1,9,5,15,2886
12932,2023-01-20,BONNIE,bounty,Dry Season,0,58,76,134,11640
12933,2023-01-19,BONNIE,knockout,Out in the Open,1,148,143,292,26574
12934,2023-01-19,BONNIE,hotZone,Split,0,10,9,19,14856
12935,2023-01-19,BONNIE,heist,Kaboom Canyon,0,37,52,89,6732
12936,2023-01-19,BONNIE,gemGrab,Undermine,0,24,30,54,14154
12937,2023-01-19,BONNIE,gemGrab,Gem Fort,0,2,1,3,2934
12938,2023-01-19,BONNIE,brawlBall,Sunny Soccer,0,3,0,3,2274
12939,2023-01-19,BONNIE,brawlBall,Pinhole Punt,2,137,191,330,72498
12940,2023-01-19,BONNIE,bounty,Shooting Star,0,44,70,114,11124
12941,2023-01-18,BONNIE,knockout,Goldarm Gulch,0,15,21,36,2784
12942,2023-01-18,BONNIE,hotZone,Parallel Plays,0,2,0,2,1158
12943,2023-01-18,BONNIE,heist,Kaboom Canyon,0,12,31,43,2592
12944,2023-01-18,BONNIE,gemGrab,Gem Fort,0,1,3,4,3006
12945,2023-01-18,BONNIE,gemGrab,Crystal Arcade,0,5,3,8,990
12946,2023-01-18,BONNIE,brawlBall,Sunny Soccer,0,14,18,32,18941
12947,2023-01-18,BONNIE,brawlBall,Beach Ball,0,1,3,4,774
12948,2023-01-18,BONNIE,bounty,Shooting Star,0,19,21,40,5088
12949,2023-01-17,BONNIE,knockout,Goldarm Gulch,0,6,7,13,2520
12950,2023-01-17,BONNIE,hotZone,Parallel Plays,0,1,1,2,1038
12951,2023-01-17,BONNIE,heist,Pit Stop,0,3,2,5,1290
12952,2023-01-17,BONNIE,gemGrab,Crystal Arcade,0,5,1,6,1266
12953,2023-01-17,BONNIE,brawlBall,Beach Ball,1,11,16,28,5886
12954,2023-01-17,BONNIE,bounty,Hideout,0,4,3,7,750
12955,2023-01-16,BONNIE,knockout,Belle's Rock,0,11,3,14,1788
12956,2023-01-16,BONNIE,hotZone,Quarter Pounder,0,2,0,2,1494
12957,2023-01-16,BONNIE,heist,Pit Stop,0,2,0,2,4044
12958,2023-01-16,BONNIE,gemGrab,Minecart Madness,0,1,9,10,1422
12959,2023-01-16,BONNIE,gemGrab,Double Swoosh,0,1,1,2,708
12960,2023-01-16,BONNIE,brawlBall,Center Stage,0,2,2,4,5778
12961,2023-01-16,BONNIE,brawlBall,Backyard Bowl,0,0,4,4,852
12962,2023-01-16,BONNIE,bounty,Hideout,0,2,0,2,1470
12963,2023-01-15,BONNIE,knockout,Belle's Rock,0,27,50,77,2904
12964,2023-01-15,BONNIE,hotZone,Quarter Pounder,0,5,3,8,3318
12965,2023-01-15,BONNIE,heist,Bridge Too Far,0,34,43,77,2736
12966,2023-01-15,BONNIE,gemGrab,Double Swoosh,0,3,4,7,2178
12967,2023-01-15,BONNIE,brawlBall,Super Beach,0,4,13,17,1074
12968,2023-01-15,BONNIE,brawlBall,Backyard Bowl,1,40,42,83,8946
12969,2023-01-15,BONNIE,bounty,Canal Grande,0,2,1,3,960
12970,2023-01-14,BONNIE,knockout,Flaring Phoenix,0,3,4,7,1080
12971,2023-01-14,BONNIE,hotZone,Controller Chaos,0,4,3,7,2772
12972,2023-01-14,BONNIE,heist,Bridge Too Far,0,56,88,144,4020
12973,2023-01-14,BONNIE,gemGrab,Hard Rock Mine,0,2,0,2,1272
12974,2023-01-14,BONNIE,gemGrab,Deep Diner,0,3,4,7,858
12975,2023-01-14,BONNIE,brawlBall,Super Beach,0,12,7,19,6336
12976,2023-01-13,BONNIE,knockout,Flaring Phoenix,0,6,2,8,1182
12977,2023-01-13,BONNIE,hotZone,Controller Chaos,0,2,1,3,2928
12978,2023-01-13,BONNIE,gemGrab,Deep Diner,0,1,0,1,1650
12979,2023-01-13,BONNIE,brawlBall,Sneaky Fields,0,15,14,29,6144
12980,2023-01-13,BONNIE,brawlBall,Pinhole Punt,0,1,0,1,156
12981,2023-01-12,BONNIE,knockout,Riverside,0,29,46,75,2532
12982,2023-01-12,BONNIE,hotZone,Open Zone,0,8,1,9,1488
12983,2023-01-12,BONNIE,brawlBall,Pinhole Punt,0,4,4,8,2292
12984,2023-01-11,BONNIE,knockout,Riverside,0,2,0,2,528
12985,2023-01-11,BONNIE,hotZone,Open Zone,0,2,0,2,462
12986,2023-01-11,BONNIE,gemGrab,Gem Fort,0,1,0,1,414
12987,2023-01-11,BONNIE,brawlBall,Sunny Soccer,0,1,0,1,1638
12988,2023-01-11,BONNIE,bounty,Excel,0,0,1,1,282
12989,2023-01-10,BONNIE,knockout,New Perspective,0,2,1,3,720
12990,2023-01-10,BONNIE,hotZone,Dueling Beetles,0,2,1,3,2424
12991,2023-01-10,BONNIE,heist,Safe Zone,0,9,54,63,1176
12992,2023-01-10,BONNIE,gemGrab,Minecart Madness,0,1,1,2,828
12993,2023-01-10,BONNIE,gemGrab,Crystal Arcade,0,4,2,6,1746
12994,2023-01-10,BONNIE,brawlBall,Beach Ball,0,3,3,6,4392
12995,2023-01-09,BONNIE,knockout,New Perspective,0,3,9,12,876
12996,2023-01-09,BONNIE,hotZone,Dueling Beetles,0,2,7,9,1554
12997,2023-01-09,BONNIE,gemGrab,Minecart Madness,0,2,23,25,1884
12998,2023-01-09,BONNIE,gemGrab,Double Swoosh,0,5,4,9,1320
12999,2023-01-09,BONNIE,brawlBall,Center Stage,0,4,2,6,5460
13000,2023-01-09,BONNIE,brawlBall,Backyard Bowl,1,1,0,2,474
13001,2023-01-09,BONNIE,bounty,Layer Cake,0,6,1,7,1512
13002,2023-01-08,BONNIE,knockout,X Marks the Spot,0,7,7,14,1692
13003,2023-01-08,BONNIE,hotZone,Ring of Fire,0,2,2,4,1644
13004,2023-01-08,BONNIE,heist,Snaked Assault,0,6,2,8,1494
13005,2023-01-08,BONNIE,gemGrab,Double Swoosh,0,1,0,1,864
13006,2023-01-08,BONNIE,brawlBall,Super Beach,0,0,2,2,732
13007,2023-01-08,BONNIE,brawlBall,Backyard Bowl,2,15,29,46,4830
13008,2023-01-08,BONNIE,bounty,Layer Cake,0,7,3,10,528
13009,2023-01-07,BONNIE,knockout,X Marks the Spot,0,4,7,11,1014
13010,2023-01-07,BONNIE,hotZone,Ring of Fire,0,0,1,1,846
13011,2023-01-07,BONNIE,heist,Tornado Ring,0,0,2,2,1350
13012,2023-01-07,BONNIE,gemGrab,Hard Rock Mine,0,1,0,1,1158
13013,2023-01-07,BONNIE,brawlBall,Super Beach,1,3,4,8,2622
13014,2023-01-07,BONNIE,bounty,Dry Season,0,5,10,15,1320
13015,2023-01-06,BONNIE,knockout,Out in the Open,0,4,0,4,1446
13016,2023-01-06,BONNIE,hotZone,Split,0,1,0,1,1158
13017,2023-01-06,BONNIE,heist,Tornado Ring,0,3,2,5,2538
13018,2023-01-06,BONNIE,gemGrab,Undermine,0,1,3,4,540
13019,2023-01-06,BONNIE,gemGrab,Deep Diner,0,2,0,2,2226
13020,2023-01-06,BONNIE,brawlBall,Sneaky Fields,0,4,8,12,4896
13021,2023-01-06,BONNIE,brawlBall,Pinhole Punt,0,3,4,7,510
13022,2023-01-06,BONNIE,bounty,Dry Season,0,8,15,23,1944
13023,2023-01-05,BONNIE,knockout,Out in the Open,0,18,28,46,2958
13024,2023-01-05,BONNIE,hotZone,Split,0,2,0,2,3552
13025,2023-01-05,BONNIE,heist,Kaboom Canyon,0,6,5,11,954
13026,2023-01-05,BONNIE,gemGrab,Undermine,0,0,2,2,1812
13027,2023-01-05,BONNIE,gemGrab,Gem Fort,0,1,0,1,252
13028,2023-01-05,BONNIE,brawlBall,Pinhole Punt,0,17,30,47,8118
13029,2023-01-05,BONNIE,bounty,Shooting Star,0,9,5,14,1362
13030,2023-01-04,BONNIE,knockout,Goldarm Gulch,0,4,2,6,696
13031,2023-01-04,BONNIE,hotZone,Parallel Plays,0,1,0,1,864
13032,2023-01-04,BONNIE,heist,Kaboom Canyon,0,7,6,13,1848
13033,2023-01-04,BONNIE,gemGrab,Gem Fort,0,1,0,1,1788
13034,2023-01-04,BONNIE,gemGrab,Crystal Arcade,0,1,0,1,642
13035,2023-01-04,BONNIE,brawlBall,Sunny Soccer,0,0,3,3,6312
13036,2023-01-04,BONNIE,bounty,Shooting Star,0,23,14,37,3570
13037,2023-01-03,BONNIE,knockout,Goldarm Gulch,0,1,1,2,720
13038,2023-01-03,BONNIE,hotZone,Parallel Plays,0,3,0,3,1542
13039,2023-01-03,BONNIE,gemGrab,Minecart Madness,0,1,0,1,456
13040,2023-01-03,BONNIE,gemGrab,Crystal Arcade,0,6,6,12,2406
13041,2023-01-03,BONNIE,brawlBall,Beach Ball,0,6,12,18,5580
13042,2023-01-03,BONNIE,bounty,Hideout,0,13,52,65,1638
13043,2023-01-02,BONNIE,knockout,Belle's Rock,0,17,34,51,1794
13044,2023-01-02,BONNIE,hotZone,Quarter Pounder,0,6,0,6,2652
13045,2023-01-02,BONNIE,heist,Pit Stop,0,3,1,4,3498
13046,2023-01-02,BONNIE,gemGrab,Minecart Madness,0,12,38,50,2352
13047,2023-01-02,BONNIE,gemGrab,Double Swoosh,0,1,0,1,1512
13048,2023-01-02,BONNIE,brawlBall,Center Stage,0,6,2,8,7110
13049,2023-01-02,BONNIE,brawlBall,Backyard Bowl,1,7,13,21,492
13050,2023-01-02,BONNIE,bounty,Hideout,0,24,36,60,3090
13051,2023-01-01,BONNIE,knockout,Belle's Rock,0,4,5,9,858
13052,2023-01-01,BONNIE,hotZone,Quarter Pounder,0,1,0,1,1188
13053,2023-01-01,BONNIE,heist,Bridge Too Far,0,3,9,12,462
13054,2023-01-01,BONNIE,gemGrab,Hard Rock Mine,0,0,1,1,48
13055,2023-01-01,BONNIE,brawlBall,Backyard Bowl,0,11,7,18,2658
13056,2022-12-31,BONNIE,heist,Bridge Too Far,0,2,6,8,276
13057,2022-12-31,BONNIE,gemGrab,Hard Rock Mine,0,1,4,5,384
13058,2022-12-31,BONNIE,brawlBall,Super Beach,0,2,0,2,618
13059,2022-12-30,BONNIE,gemGrab,Minecart Madness,0,1,0,1,24
13060,2022-12-30,BONNIE,brawlBall,Sneaky Fields,0,1,0,1,552
13061,2022-12-29,BONNIE,gemGrab,Minecart Madness,0,1,1,2,24
13062,2022-12-26,BONNIE,heist,Kaboom Canyon,0,0,1,1,36
13063,2022-12-26,BONNIE,gemGrab,Minecart Madness,0,1,0,1,60
13064,2022-12-25,BONNIE,brawlBall,Backyard Bowl,0,1,0,1,78
13065,2022-12-24,BONNIE,knockout,X Marks the Spot,0,1,1,2,12
13066,2022-12-24,BONNIE,brawlBall,Super Beach,0,0,1,1,48
13067,2022-12-23,BONNIE,knockout,Out in the Open,0,0,1,1,132
13068,2022-12-19,BONNIE,brawlBall,Center Stage,0,0,1,1,102
13069,2022-12-13,BONNIE,brawlBall,Beach Ball,0,1,0,1,54
13070,2022-12-11,BONNIE,brawlBall,Backyard Bowl,0,1,0,1,24
13071,2022-11-03,BONNIE,brawlBall,Pinhole Punt,0,1,1,2,12
13072,2022-10-15,BONNIE,hotZone,Ring of Fire,0,0,1,1,24
13073,2022-10-15,BONNIE,bounty,Dry Season,0,1,0,1,6
13074,2022-10-10,BONNIE,knockout,Belle's Rock,0,0,3,3,48
13075,2023-01-28,BO,knockout,Flaring Phoenix,5,693,949,1647,12366
13076,2023-01-28,BO,hotZone,Controller Chaos,0,122,33,155,10134
13077,2023-01-28,BO,heist,Bridge Too Far,1,149,86,236,24240
13078,2023-01-28,BO,gemGrab,Hard Rock Mine,0,262,203,465,16638
13079,2023-01-28,BO,gemGrab,Deep Diner,0,116,71,187,5478
13080,2023-01-28,BO,brawlBall,Super Beach,12,277,202,491,74430
13081,2023-01-28,BO,brawlBall,Sneaky Fields,0,13,13,26,3582
13082,2023-01-28,BO,bounty,Canal Grande,0,149,78,227,10902
13083,2023-01-27,BO,knockout,Flaring Phoenix,3,382,470,855,5928
13084,2023-01-27,BO,hotZone,Controller Chaos,0,35,24,59,2676
13085,2023-01-27,BO,heist,Hot Potato,0,14,13,27,3486
13086,2023-01-27,BO,gemGrab,Undermine,0,21,11,32,942
13087,2023-01-27,BO,gemGrab,Deep Diner,0,127,90,217,6846
13088,2023-01-27,BO,brawlBall,Sneaky Fields,4,101,93,198,23514
13089,2023-01-27,BO,brawlBall,Pinhole Punt,0,6,9,15,738
13090,2023-01-27,BO,bounty,Temple Ruins,0,27,18,45,1890
13091,2023-01-26,BO,knockout,Riverside,0,127,81,208,19008
13092,2023-01-26,BO,hotZone,Open Zone,0,294,188,482,10182
13093,2023-01-26,BO,heist,Hot Potato,0,47,18,65,14610
13094,2023-01-26,BO,gemGrab,Undermine,0,149,139,288,10062
13095,2023-01-26,BO,gemGrab,Gem Fort,0,100,76,176,4674
13096,2023-01-26,BO,brawlBall,Sunny Soccer,0,8,9,17,3660
13097,2023-01-26,BO,brawlBall,Pinhole Punt,11,342,318,671,67338
13098,2023-01-26,BO,bounty,Temple Ruins,0,107,79,186,5610
13099,2023-01-25,BO,knockout,Riverside,0,64,46,110,9906
13100,2023-01-25,BO,hotZone,Open Zone,0,139,92,231,5262
13101,2023-01-25,BO,heist,Safe Zone,0,86,39,125,9156
13102,2023-01-25,BO,gemGrab,Gem Fort,0,104,98,202,5556
13103,2023-01-25,BO,gemGrab,Crystal Arcade,0,123,80,203,7866
13104,2023-01-25,BO,brawlBall,Sunny Soccer,2,174,134,310,40830
13105,2023-01-25,BO,brawlBall,Beach Ball,0,24,27,51,6408
13106,2023-01-25,BO,bounty,Excel,0,57,25,82,5790
13107,2023-01-24,BO,knockout,New Perspective,1,304,429,734,10542
13108,2023-01-24,BO,hotZone,Dueling Beetles,0,272,160,432,10662
13109,2023-01-24,BO,heist,Safe Zone,1,142,82,225,15750
13110,2023-01-24,BO,gemGrab,Minecart Madness,0,145,96,241,4002
13111,2023-01-24,BO,gemGrab,Crystal Arcade,0,300,267,567,14460
13112,2023-01-24,BO,brawlBall,Center Stage,2,60,34,96,7860
13113,2023-01-24,BO,brawlBall,Beach Ball,7,234,188,429,64614
13114,2023-01-24,BO,bounty,Excel,0,144,123,267,10896
13115,2023-01-23,BO,knockout,New Perspective,5,1149,1519,2673,20676
13116,2023-01-23,BO,hotZone,Dueling Beetles,0,379,256,635,17502
13117,2023-01-23,BO,heist,Snaked Assault,0,47,24,71,15762
13118,2023-01-23,BO,gemGrab,Minecart Madness,0,621,524,1145,19062
13119,2023-01-23,BO,gemGrab,Double Swoosh,0,190,232,422,7578
13120,2023-01-23,BO,brawlBall,Center Stage,17,434,301,752,92862
13121,2023-01-23,BO,brawlBall,Backyard Bowl,1,23,48,72,4224
13122,2023-01-23,BO,bounty,Layer Cake,0,177,158,335,11142
13123,2023-01-22,BO,knockout,X Marks the Spot,2,377,469,848,9174
13124,2023-01-22,BO,hotZone,Ring of Fire,0,239,158,397,5730
13125,2023-01-22,BO,heist,Snaked Assault,0,22,13,35,8232
13126,2023-01-22,BO,gemGrab,Hard Rock Mine,0,84,70,154,4722
13127,2023-01-22,BO,gemGrab,Double Swoosh,0,234,232,466,9426
13128,2023-01-22,BO,brawlBall,Super Beach,1,37,28,66,7386
13129,2023-01-22,BO,brawlBall,Backyard Bowl,8,223,188,419,34788
13130,2023-01-22,BO,bounty,Layer Cake,0,122,123,245,6654
13131,2023-01-21,BO,knockout,X Marks the Spot,6,1392,1716,3114,31698
13132,2023-01-21,BO,hotZone,Ring of Fire,1,541,453,995,16632
13133,2023-01-21,BO,heist,Tornado Ring,0,43,17,60,11664
13134,2023-01-21,BO,gemGrab,Hard Rock Mine,0,405,303,708,22980
13135,2023-01-21,BO,gemGrab,Deep Diner,0,107,88,195,4470
13136,2023-01-21,BO,brawlBall,Super Beach,12,403,332,747,101364
13137,2023-01-21,BO,brawlBall,Sneaky Fields,0,10,16,26,3750
13138,2023-01-21,BO,bounty,Dry Season,0,254,152,406,14538
13139,2023-01-20,BO,knockout,Out in the Open,10,591,813,1414,20106
13140,2023-01-20,BO,hotZone,Split,0,79,32,111,9678
13141,2023-01-20,BO,heist,Tornado Ring,0,48,26,74,12672
13142,2023-01-20,BO,gemGrab,Undermine,0,110,121,231,5442
13143,2023-01-20,BO,gemGrab,Deep Diner,0,362,277,639,19050
13144,2023-01-20,BO,brawlBall,Sneaky Fields,7,235,200,442,74778
13145,2023-01-20,BO,brawlBall,Pinhole Punt,0,21,21,42,2886
13146,2023-01-20,BO,bounty,Dry Season,0,146,96,242,11640
13147,2023-01-19,BO,knockout,Out in the Open,15,1230,1545,2790,26574
13148,2023-01-19,BO,hotZone,Split,0,81,25,106,14856
13149,2023-01-19,BO,heist,Kaboom Canyon,0,59,28,87,6732
13150,2023-01-19,BO,gemGrab,Undermine,0,282,222,504,14154
13151,2023-01-19,BO,gemGrab,Gem Fort,0,54,61,115,2934
13152,2023-01-19,BO,brawlBall,Sunny Soccer,0,5,6,11,2274
13153,2023-01-19,BO,brawlBall,Pinhole Punt,11,368,353,732,72498
13154,2023-01-19,BO,bounty,Shooting Star,0,129,89,218,11124
13155,2023-01-18,BO,knockout,Goldarm Gulch,3,100,132,235,2784
13156,2023-01-18,BO,hotZone,Parallel Plays,0,22,24,46,1158
13157,2023-01-18,BO,heist,Kaboom Canyon,0,22,4,26,2592
13158,2023-01-18,BO,gemGrab,Gem Fort,0,45,40,85,3006
13159,2023-01-18,BO,gemGrab,Crystal Arcade,0,19,11,30,990
13160,2023-01-18,BO,brawlBall,Sunny Soccer,0,53,49,102,18941
13161,2023-01-18,BO,brawlBall,Beach Ball,0,4,7,11,774
13162,2023-01-18,BO,bounty,Shooting Star,0,53,44,97,5088
13163,2023-01-17,BO,knockout,Goldarm Gulch,0,95,129,224,2520
13164,2023-01-17,BO,hotZone,Parallel Plays,0,9,4,13,1038
13165,2023-01-17,BO,heist,Pit Stop,0,6,0,6,1290
13166,2023-01-17,BO,gemGrab,Minecart Madness,0,3,3,6,216
13167,2023-01-17,BO,gemGrab,Crystal Arcade,0,25,28,53,1266
13168,2023-01-17,BO,brawlBall,Center Stage,0,4,1,5,288
13169,2023-01-17,BO,brawlBall,Beach Ball,1,12,13,26,5886
13170,2023-01-17,BO,bounty,Hideout,0,5,1,6,750
13171,2023-01-16,BO,knockout,Belle's Rock,0,22,55,77,1788
13172,2023-01-16,BO,hotZone,Quarter Pounder,0,48,31,79,1494
13173,2023-01-16,BO,heist,Pit Stop,0,5,0,5,4044
13174,2023-01-16,BO,gemGrab,Minecart Madness,0,40,27,67,1422
13175,2023-01-16,BO,gemGrab,Double Swoosh,0,24,17,41,708
13176,2023-01-16,BO,brawlBall,Center Stage,0,15,19,34,5778
13177,2023-01-16,BO,brawlBall,Backyard Bowl,0,5,3,8,852
13178,2023-01-16,BO,bounty,Hideout,0,21,11,32,1470
13179,2023-01-15,BO,knockout,Belle's Rock,0,71,64,135,2904
13180,2023-01-15,BO,hotZone,Quarter Pounder,0,57,25,82,3318
13181,2023-01-15,BO,heist,Bridge Too Far,0,18,5,23,2736
13182,2023-01-15,BO,gemGrab,Hard Rock Mine,0,13,10,23,1014
13183,2023-01-15,BO,gemGrab,Double Swoosh,0,53,46,99,2178
13184,2023-01-15,BO,brawlBall,Super Beach,0,11,25,36,1074
13185,2023-01-15,BO,brawlBall,Backyard Bowl,4,60,60,124,8946
13186,2023-01-15,BO,bounty,Canal Grande,0,11,9,20,960
13187,2023-01-14,BO,knockout,Flaring Phoenix,2,58,98,158,1080
13188,2023-01-14,BO,hotZone,Controller Chaos,0,31,3,34,2772
13189,2023-01-14,BO,heist,Bridge Too Far,0,25,25,50,4020
13190,2023-01-14,BO,gemGrab,Hard Rock Mine,0,22,9,31,1272
13191,2023-01-14,BO,gemGrab,Deep Diner,0,16,3,19,858
13192,2023-01-14,BO,brawlBall,Super Beach,0,23,31,54,6336
13193,2023-01-14,BO,brawlBall,Sneaky Fields,0,3,0,3,918
13194,2023-01-14,BO,bounty,Canal Grande,0,12,11,23,1014
13195,2023-01-13,BO,knockout,Flaring Phoenix,0,65,72,137,1182
13196,2023-01-13,BO,hotZone,Controller Chaos,0,24,3,27,2928
13197,2023-01-13,BO,heist,Hot Potato,0,4,1,5,600
13198,2023-01-13,BO,gemGrab,Deep Diner,0,35,18,53,1650
13199,2023-01-13,BO,brawlBall,Sneaky Fields,2,29,21,52,6144
13200,2023-01-13,BO,bounty,Temple Ruins,0,5,2,7,270
13201,2023-01-12,BO,knockout,Riverside,0,12,5,17,2532
13202,2023-01-12,BO,hotZone,Open Zone,0,48,9,57,1488
13203,2023-01-12,BO,heist,Hot Potato,0,3,0,3,330
13204,2023-01-12,BO,gemGrab,Undermine,0,13,3,16,690
13205,2023-01-12,BO,gemGrab,Gem Fort,0,3,1,4,162
13206,2023-01-12,BO,brawlBall,Pinhole Punt,0,13,3,16,2292
13207,2023-01-12,BO,bounty,Temple Ruins,0,1,0,1,24
13208,2023-01-11,BO,knockout,Riverside,0,1,0,1,528
13209,2023-01-11,BO,hotZone,Open Zone,0,14,18,32,462
13210,2023-01-11,BO,heist,Safe Zone,0,1,2,3,48
13211,2023-01-11,BO,gemGrab,Gem Fort,0,10,21,31,414
13212,2023-01-11,BO,brawlBall,Sunny Soccer,0,6,3,9,1638
13213,2023-01-11,BO,brawlBall,Beach Ball,0,0,1,1,48
13214,2023-01-11,BO,bounty,Excel,0,3,0,3,282
13215,2023-01-10,BO,knockout,New Perspective,0,16,34,50,720
13216,2023-01-10,BO,hotZone,Dueling Beetles,0,61,30,91,2424
13217,2023-01-10,BO,heist,Safe Zone,0,14,26,40,1176
13218,2023-01-10,BO,gemGrab,Minecart Madness,0,35,7,42,828
13219,2023-01-10,BO,gemGrab,Crystal Arcade,0,27,12,39,1746
13220,2023-01-10,BO,brawlBall,Center Stage,0,1,0,1,708
13221,2023-01-10,BO,brawlBall,Beach Ball,2,16,2,20,4392
13222,2023-01-10,BO,bounty,Excel,0,7,2,9,330
13223,2023-01-09,BO,knockout,New Perspective,0,65,82,147,876
13224,2023-01-09,BO,hotZone,Dueling Beetles,0,40,32,72,1554
13225,2023-01-09,BO,heist,Snaked Assault,0,11,0,11,2022
13226,2023-01-09,BO,gemGrab,Minecart Madness,0,70,45,115,1884
13227,2023-01-09,BO,gemGrab,Double Swoosh,0,31,26,57,1320
13228,2023-01-09,BO,brawlBall,Center Stage,1,10,11,22,5460
13229,2023-01-09,BO,brawlBall,Backyard Bowl,0,1,0,1,474
13230,2023-01-09,BO,bounty,Layer Cake,0,25,28,53,1512
13231,2023-01-08,BO,knockout,X Marks the Spot,0,59,100,159,1692
13232,2023-01-08,BO,hotZone,Ring of Fire,0,60,44,104,1644
13233,2023-01-08,BO,heist,Snaked Assault,0,4,0,4,1494
13234,2023-01-08,BO,gemGrab,Hard Rock Mine,0,5,5,10,630
13235,2023-01-08,BO,gemGrab,Double Swoosh,0,17,8,25,864
13236,2023-01-08,BO,brawlBall,Super Beach,0,4,0,4,732
13237,2023-01-08,BO,brawlBall,Backyard Bowl,2,30,35,67,4830
13238,2023-01-08,BO,bounty,Layer Cake,0,8,6,14,528
13239,2023-01-07,BO,knockout,X Marks the Spot,0,44,43,87,1014
13240,2023-01-07,BO,hotZone,Ring of Fire,0,36,27,63,846
13241,2023-01-07,BO,heist,Tornado Ring,0,8,8,16,1350
13242,2023-01-07,BO,gemGrab,Hard Rock Mine,0,15,23,38,1158
13243,2023-01-07,BO,gemGrab,Deep Diner,0,20,25,45,918
13244,2023-01-07,BO,brawlBall,Super Beach,0,11,11,22,2622
13245,2023-01-07,BO,brawlBall,Sneaky Fields,0,1,0,1,402
13246,2023-01-07,BO,bounty,Dry Season,0,27,11,38,1320
13247,2023-01-06,BO,knockout,Out in the Open,0,71,119,190,1446
13248,2023-01-06,BO,hotZone,Split,0,5,1,6,1158
13249,2023-01-06,BO,heist,Tornado Ring,0,6,3,9,2538
13250,2023-01-06,BO,gemGrab,Undermine,0,18,16,34,540
13251,2023-01-06,BO,gemGrab,Deep Diner,0,48,29,77,2226
13252,2023-01-06,BO,brawlBall,Sneaky Fields,0,12,6,18,4896
13253,2023-01-06,BO,brawlBall,Pinhole Punt,0,4,3,7,510
13254,2023-01-06,BO,bounty,Dry Season,0,18,13,31,1944
13255,2023-01-05,BO,knockout,Out in the Open,3,136,160,299,2958
13256,2023-01-05,BO,hotZone,Split,0,15,0,15,3552
13257,2023-01-05,BO,heist,Kaboom Canyon,0,9,0,9,954
13258,2023-01-05,BO,gemGrab,Undermine,0,49,63,112,1812
13259,2023-01-05,BO,gemGrab,Gem Fort,0,2,0,2,252
13260,2023-01-05,BO,brawlBall,Pinhole Punt,2,51,67,120,8118
13261,2023-01-05,BO,bounty,Shooting Star,0,12,2,14,1362
13262,2023-01-04,BO,knockout,Goldarm Gulch,0,26,35,61,696
13263,2023-01-04,BO,hotZone,Parallel Plays,0,12,2,14,864
13264,2023-01-04,BO,heist,Kaboom Canyon,0,15,1,16,1848
13265,2023-01-04,BO,gemGrab,Gem Fort,0,19,9,28,1788
13266,2023-01-04,BO,gemGrab,Crystal Arcade,0,12,11,23,642
13267,2023-01-04,BO,brawlBall,Sunny Soccer,0,6,4,10,6312
13268,2023-01-04,BO,bounty,Shooting Star,0,30,6,36,3570
13269,2023-01-03,BO,knockout,Goldarm Gulch,0,25,36,61,720
13270,2023-01-03,BO,hotZone,Parallel Plays,0,9,0,9,1542
13271,2023-01-03,BO,hotZone,Controller Chaos,0,1,0,1,12
13272,2023-01-03,BO,heist,Pit Stop,1,4,0,5,1956
13273,2023-01-03,BO,gemGrab,Minecart Madness,0,18,5,23,456
13274,2023-01-03,BO,gemGrab,Crystal Arcade,0,35,8,43,2406
13275,2023-01-03,BO,brawlBall,Beach Ball,0,21,23,44,5580
13276,2023-01-03,BO,bounty,Hideout,0,13,0,13,1638
13277,2023-01-02,BO,knockout,Belle's Rock,0,23,30,53,1794
13278,2023-01-02,BO,hotZone,Quarter Pounder,0,51,9,60,2652
13279,2023-01-02,BO,hotZone,Controller Chaos,0,1,0,1,18
13280,2023-01-02,BO,heist,Pit Stop,0,1,1,2,3498
13281,2023-01-02,BO,heist,Kaboom Canyon,0,1,0,1,30
13282,2023-01-02,BO,gemGrab,Minecart Madness,0,71,85,156,2352
13283,2023-01-02,BO,gemGrab,Double Swoosh,0,45,36,81,1512
13284,2023-01-02,BO,brawlBall,Center Stage,0,19,8,27,7110
13285,2023-01-02,BO,brawlBall,Backyard Bowl,0,3,0,3,492
13286,2023-01-02,BO,bounty,Hideout,0,34,10,44,3090
13287,2023-01-01,BO,knockout,Belle's Rock,0,10,21,31,858
13288,2023-01-01,BO,hotZone,Quarter Pounder,0,13,1,14,1188
13289,2023-01-01,BO,heist,Bridge Too Far,0,1,0,1,462
13290,2023-01-01,BO,gemGrab,Hard Rock Mine,0,0,1,1,48
13291,2023-01-01,BO,gemGrab,Double Swoosh,0,15,14,29,1140
13292,2023-01-01,BO,brawlBall,Backyard Bowl,1,17,13,31,2658
13293,2022-12-31,BO,knockout,Flaring Phoenix,0,2,2,4,18
13294,2022-12-31,BO,hotZone,Controller Chaos,0,2,1,3,198
13295,2022-12-31,BO,heist,Bridge Too Far,0,3,1,4,276
13296,2022-12-31,BO,gemGrab,Minecart Madness,0,1,0,1,24
13297,2022-12-31,BO,gemGrab,Hard Rock Mine,0,7,2,9,384
13298,2022-12-31,BO,gemGrab,Deep Diner,0,10,0,10,306
13299,2022-12-31,BO,brawlBall,Super Beach,0,0,1,1,618
13300,2022-12-31,BO,brawlBall,Sneaky Fields,0,1,0,1,60
13301,2022-12-30,BO,knockout,Flaring Phoenix,0,3,4,7,72
13302,2022-12-30,BO,hotZone,Controller Chaos,0,3,1,4,288
13303,2022-12-30,BO,gemGrab,Undermine,0,2,0,2,102
13304,2022-12-30,BO,gemGrab,Minecart Madness,0,0,1,1,24
13305,2022-12-30,BO,gemGrab,Deep Diner,0,5,2,7,438
13306,2022-12-30,BO,brawlBall,Sneaky Fields,0,2,1,3,552
13307,2022-12-29,BO,hotZone,Open Zone,0,5,2,7,54
13308,2022-12-29,BO,heist,Hot Potato,0,1,0,1,72
13309,2022-12-29,BO,gemGrab,Undermine,0,2,1,3,102
13310,2022-12-29,BO,gemGrab,Minecart Madness,0,1,0,1,24
13311,2022-12-29,BO,gemGrab,Gem Fort,0,2,2,4,30
13312,2022-12-29,BO,brawlBall,Pinhole Punt,0,4,11,15,282
13313,2022-12-28,BO,hotZone,Open Zone,0,1,0,1,108
13314,2022-12-28,BO,hotZone,Controller Chaos,0,1,0,1,6
13315,2022-12-28,BO,gemGrab,Crystal Arcade,0,0,1,1,6
13316,2022-12-28,BO,brawlBall,Sunny Soccer,0,0,1,1,42
13317,2022-12-27,BO,knockout,New Perspective,0,2,3,5,30
13318,2022-12-27,BO,hotZone,Dueling Beetles,0,0,1,1,36
13319,2022-12-27,BO,hotZone,Controller Chaos,0,1,0,1,24
13320,2022-12-27,BO,heist,Safe Zone,0,0,1,1,12
13321,2022-12-27,BO,heist,Kaboom Canyon,0,1,0,1,18
13322,2022-12-27,BO,gemGrab,Minecart Madness,0,0,1,1,30
13323,2022-12-27,BO,bounty,Excel,0,0,1,1,18
13324,2022-12-26,BO,heist,Kaboom Canyon,0,1,0,1,36
13325,2022-12-25,BO,gemGrab,Double Swoosh,0,1,0,1,30
13326,2022-12-25,BO,brawlBall,Backyard Bowl,0,1,0,1,78
13327,2022-12-24,BO,bounty,Dry Season,0,1,0,1,12
13328,2022-12-23,BO,knockout,Out in the Open,0,0,1,1,132
13329,2022-12-22,BO,gemGrab,Gem Fort,0,1,1,2,90
13330,2022-12-20,BO,brawlBall,Beach Ball,0,1,0,1,96
13331,2022-12-17,BO,knockout,Flaring Phoenix,0,2,4,6,30
13332,2022-12-16,BO,bounty,Temple Ruins,0,1,0,1,24
13333,2022-12-13,BO,knockout,New Perspective,0,2,1,3,84
13334,2022-12-13,BO,gemGrab,Crystal Arcade,0,3,1,4,72
13335,2022-12-10,BO,gemGrab,Hard Rock Mine,0,0,1,1,24
13336,2022-10-28,BO,bounty,Canal Grande,0,1,0,1,12
13337,2022-10-26,BO,bounty,Shooting Star,0,2,0,2,36
13338,2022-10-15,BO,gemGrab,Hard Rock Mine,0,1,2,3,90
13339,2023-01-28,BIBI,knockout,Flaring Phoenix,1,25,18,44,12366
13340,2023-01-28,BIBI,hotZone,Controller Chaos,0,164,110,274,10134
13341,2023-01-28,BIBI,heist,Bridge Too Far,0,71,55,126,24240
13342,2023-01-28,BIBI,gemGrab,Hard Rock Mine,0,106,107,213,16638
13343,2023-01-28,BIBI,gemGrab,Deep Diner,0,24,14,38,5478
13344,2023-01-28,BIBI,brawlBall,Super Beach,30,1619,1502,3151,74430
13345,2023-01-28,BIBI,brawlBall,Sneaky Fields,1,57,40,98,3582
13346,2023-01-28,BIBI,bounty,Canal Grande,0,58,35,93,10902
13347,2023-01-27,BIBI,knockout,Flaring Phoenix,0,9,4,13,5928
13348,2023-01-27,BIBI,hotZone,Controller Chaos,0,35,37,72,2676
13349,2023-01-27,BIBI,heist,Hot Potato,2,116,147,265,3486
13350,2023-01-27,BIBI,gemGrab,Undermine,0,5,4,9,942
13351,2023-01-27,BIBI,gemGrab,Deep Diner,0,29,20,49,6846
13352,2023-01-27,BIBI,brawlBall,Sneaky Fields,9,456,430,895,23514
13353,2023-01-27,BIBI,brawlBall,Pinhole Punt,0,9,9,18,738
13354,2023-01-27,BIBI,bounty,Temple Ruins,0,5,13,18,1890
13355,2023-01-26,BIBI,knockout,Riverside,0,14,6,20,19008
13356,2023-01-26,BIBI,hotZone,Open Zone,0,36,20,56,10182
13357,2023-01-26,BIBI,heist,Hot Potato,2,694,721,1417,14610
13358,2023-01-26,BIBI,gemGrab,Undermine,0,58,51,109,10062
13359,2023-01-26,BIBI,gemGrab,Gem Fort,0,30,21,51,4674
13360,2023-01-26,BIBI,brawlBall,Sunny Soccer,0,74,61,135,3660
13361,2023-01-26,BIBI,brawlBall,Pinhole Punt,26,1025,932,1983,67338
13362,2023-01-26,BIBI,bounty,Temple Ruins,0,22,9,31,5610
13363,2023-01-25,BIBI,knockout,Riverside,0,10,6,16,9906
13364,2023-01-25,BIBI,hotZone,Open Zone,0,13,8,21,5262
13365,2023-01-25,BIBI,heist,Safe Zone,1,72,113,186,9156
13366,2023-01-25,BIBI,gemGrab,Gem Fort,0,37,45,82,5556
13367,2023-01-25,BIBI,gemGrab,Crystal Arcade,0,55,59,114,7866
13368,2023-01-25,BIBI,brawlBall,Sunny Soccer,14,861,743,1618,40830
13369,2023-01-25,BIBI,brawlBall,Beach Ball,1,97,83,181,6408
13370,2023-01-25,BIBI,bounty,Excel,0,27,40,67,5790
13371,2023-01-24,BIBI,knockout,New Perspective,0,24,9,33,10542
13372,2023-01-24,BIBI,hotZone,Dueling Beetles,0,81,42,123,10662
13373,2023-01-24,BIBI,heist,Safe Zone,0,160,181,341,15750
13374,2023-01-24,BIBI,gemGrab,Minecart Madness,0,19,19,38,4002
13375,2023-01-24,BIBI,gemGrab,Crystal Arcade,0,80,72,152,14460
13376,2023-01-24,BIBI,brawlBall,Center Stage,4,128,81,213,7860
13377,2023-01-24,BIBI,brawlBall,Beach Ball,28,1216,1039,2283,64614
13378,2023-01-24,BIBI,bounty,Excel,0,51,40,91,10896
13379,2023-01-23,BIBI,knockout,New Perspective,0,42,26,68,20676
13380,2023-01-23,BIBI,hotZone,Dueling Beetles,0,101,123,224,17502
13381,2023-01-23,BIBI,heist,Snaked Assault,1,482,556,1039,15762
13382,2023-01-23,BIBI,gemGrab,Minecart Madness,0,113,65,178,19062
13383,2023-01-23,BIBI,gemGrab,Double Swoosh,0,34,23,57,7578
13384,2023-01-23,BIBI,brawlBall,Center Stage,43,1619,1348,3010,92862
13385,2023-01-23,BIBI,brawlBall,Backyard Bowl,0,38,23,61,4224
13386,2023-01-23,BIBI,bounty,Layer Cake,0,60,38,98,11142
13387,2023-01-22,BIBI,knockout,X Marks the Spot,0,17,8,25,9174
13388,2023-01-22,BIBI,hotZone,Ring of Fire,0,16,11,27,5730
13389,2023-01-22,BIBI,heist,Snaked Assault,3,287,284,574,8232
13390,2023-01-22,BIBI,gemGrab,Hard Rock Mine,0,34,19,53,4722
13391,2023-01-22,BIBI,gemGrab,Double Swoosh,0,52,38,90,9426
13392,2023-01-22,BIBI,brawlBall,Super Beach,6,166,159,331,7386
13393,2023-01-22,BIBI,brawlBall,Backyard Bowl,9,288,260,557,34788
13394,2023-01-22,BIBI,bounty,Layer Cake,0,25,30,55,6654
13395,2023-01-21,BIBI,knockout,X Marks the Spot,1,63,34,98,31698
13396,2023-01-21,BIBI,hotZone,Ring of Fire,0,38,34,72,16632
13397,2023-01-21,BIBI,heist,Tornado Ring,2,535,614,1151,11664
13398,2023-01-21,BIBI,gemGrab,Hard Rock Mine,0,129,113,242,22980
13399,2023-01-21,BIBI,gemGrab,Deep Diner,0,25,10,35,4470
13400,2023-01-21,BIBI,brawlBall,Super Beach,43,2166,2053,4262,101364
13401,2023-01-21,BIBI,brawlBall,Sneaky Fields,0,70,65,135,3750
13402,2023-01-21,BIBI,bounty,Dry Season,0,23,15,38,14538
13403,2023-01-20,BIBI,knockout,Out in the Open,0,32,19,51,20106
13404,2023-01-20,BIBI,hotZone,Split,0,179,198,377,9678
13405,2023-01-20,BIBI,heist,Tornado Ring,4,713,826,1543,12672
13406,2023-01-20,BIBI,gemGrab,Undermine,0,27,14,41,5442
13407,2023-01-20,BIBI,gemGrab,Deep Diner,0,99,92,191,19050
13408,2023-01-20,BIBI,brawlBall,Sneaky Fields,24,1690,1510,3224,74778
13409,2023-01-20,BIBI,brawlBall,Pinhole Punt,0,38,44,82,2886
13410,2023-01-20,BIBI,bounty,Dry Season,0,15,14,29,11640
13411,2023-01-19,BIBI,knockout,Out in the Open,0,35,24,59,26574
13412,2023-01-19,BIBI,hotZone,Split,0,300,291,591,14856
13413,2023-01-19,BIBI,heist,Kaboom Canyon,0,71,62,133,6732
13414,2023-01-19,BIBI,gemGrab,Undermine,0,91,81,172,14154
13415,2023-01-19,BIBI,gemGrab,Gem Fort,0,18,10,28,2934
13416,2023-01-19,BIBI,brawlBall,Sunny Soccer,0,54,44,98,2274
13417,2023-01-19,BIBI,brawlBall,Pinhole Punt,23,1135,962,2120,72498
13418,2023-01-19,BIBI,bounty,Shooting Star,0,13,5,18,11124
13419,2023-01-18,BIBI,knockout,Goldarm Gulch,0,4,2,6,2784
13420,2023-01-18,BIBI,hotZone,Parallel Plays,0,12,11,23,1158
13421,2023-01-18,BIBI,heist,Kaboom Canyon,0,22,15,37,2592
13422,2023-01-18,BIBI,gemGrab,Gem Fort,0,15,12,27,3006
13423,2023-01-18,BIBI,gemGrab,Crystal Arcade,0,5,1,6,990
13424,2023-01-18,BIBI,brawlBall,Sunny Soccer,9,396,392,797,18941
13425,2023-01-18,BIBI,brawlBall,Beach Ball,0,16,15,31,774
13426,2023-01-18,BIBI,bounty,Shooting Star,0,5,3,8,5088
13427,2023-01-17,BIBI,knockout,Goldarm Gulch,0,3,6,9,2520
13428,2023-01-17,BIBI,hotZone,Parallel Plays,0,11,10,21,1038
13429,2023-01-17,BIBI,heist,Pit Stop,0,53,74,127,1290
13430,2023-01-17,BIBI,gemGrab,Minecart Madness,0,1,1,2,216
13431,2023-01-17,BIBI,gemGrab,Crystal Arcade,0,11,5,16,1266
13432,2023-01-17,BIBI,brawlBall,Center Stage,0,7,2,9,288
13433,2023-01-17,BIBI,brawlBall,Beach Ball,2,125,105,232,5886
13434,2023-01-17,BIBI,bounty,Hideout,0,2,3,5,750
13435,2023-01-16,BIBI,knockout,Belle's Rock,0,1,3,4,1788
13436,2023-01-16,BIBI,hotZone,Quarter Pounder,0,13,10,23,1494
13437,2023-01-16,BIBI,heist,Pit Stop,0,247,295,542,4044
13438,2023-01-16,BIBI,gemGrab,Minecart Madness,0,10,5,15,1422
13439,2023-01-16,BIBI,gemGrab,Double Swoosh,0,3,0,3,708
13440,2023-01-16,BIBI,brawlBall,Center Stage,1,104,87,192,5778
13441,2023-01-16,BIBI,brawlBall,Backyard Bowl,0,9,5,14,852
13442,2023-01-16,BIBI,bounty,Hideout,0,4,2,6,1470
13443,2023-01-15,BIBI,knockout,Belle's Rock,0,9,2,11,2904
13444,2023-01-15,BIBI,hotZone,Quarter Pounder,0,40,8,48,3318
13445,2023-01-15,BIBI,heist,Bridge Too Far,0,14,15,29,2736
13446,2023-01-15,BIBI,gemGrab,Hard Rock Mine,0,6,0,6,1014
13447,2023-01-15,BIBI,gemGrab,Double Swoosh,0,13,4,17,2178
13448,2023-01-15,BIBI,brawlBall,Super Beach,0,22,23,45,1074
13449,2023-01-15,BIBI,brawlBall,Backyard Bowl,2,79,39,120,8946
13450,2023-01-15,BIBI,bounty,Canal Grande,0,8,2,10,960
13451,2023-01-14,BIBI,hotZone,Controller Chaos,0,36,39,75,2772
13452,2023-01-14,BIBI,heist,Bridge Too Far,0,18,17,35,4020
13453,2023-01-14,BIBI,gemGrab,Hard Rock Mine,0,4,0,4,1272
13454,2023-01-14,BIBI,gemGrab,Deep Diner,0,2,1,3,858
13455,2023-01-14,BIBI,brawlBall,Super Beach,1,129,98,228,6336
13456,2023-01-14,BIBI,brawlBall,Sneaky Fields,0,12,13,25,918
13457,2023-01-14,BIBI,bounty,Canal Grande,0,7,4,11,1014
13458,2023-01-13,BIBI,knockout,Flaring Phoenix,0,1,1,2,1182
13459,2023-01-13,BIBI,hotZone,Controller Chaos,0,22,19,41,2928
13460,2023-01-13,BIBI,heist,Hot Potato,0,25,23,48,600
13461,2023-01-13,BIBI,gemGrab,Undermine,0,1,0,1,18
13462,2023-01-13,BIBI,gemGrab,Deep Diner,0,11,1,12,1650
13463,2023-01-13,BIBI,brawlBall,Sneaky Fields,1,83,54,138,6144
13464,2023-01-13,BIBI,brawlBall,Pinhole Punt,0,3,0,3,156
13465,2023-01-13,BIBI,bounty,Temple Ruins,0,2,0,2,270
13466,2023-01-12,BIBI,knockout,Riverside,0,1,0,1,2532
13467,2023-01-12,BIBI,hotZone,Open Zone,0,3,0,3,1488
13468,2023-01-12,BIBI,heist,Hot Potato,0,19,5,24,330
13469,2023-01-12,BIBI,gemGrab,Undermine,0,0,1,1,690
13470,2023-01-12,BIBI,brawlBall,Sunny Soccer,0,2,2,4,240
13471,2023-01-12,BIBI,brawlBall,Pinhole Punt,1,34,34,69,2292
13472,2023-01-11,BIBI,hotZone,Open Zone,0,2,0,2,462
13473,2023-01-11,BIBI,gemGrab,Gem Fort,0,1,0,1,414
13474,2023-01-11,BIBI,brawlBall,Sunny Soccer,1,29,27,57,1638
13475,2023-01-11,BIBI,brawlBall,Beach Ball,0,0,1,1,48
13476,2023-01-11,BIBI,bounty,Excel,0,4,0,4,282
13477,2023-01-10,BIBI,hotZone,Dueling Beetles,0,19,5,24,2424
13478,2023-01-10,BIBI,heist,Safe Zone,0,9,3,12,1176
13479,2023-01-10,BIBI,gemGrab,Minecart Madness,0,5,0,5,828
13480,2023-01-10,BIBI,gemGrab,Crystal Arcade,0,11,8,19,1746
13481,2023-01-10,BIBI,brawlBall,Center Stage,0,10,0,10,708
13482,2023-01-10,BIBI,brawlBall,Beach Ball,1,69,32,102,4392
13483,2023-01-10,BIBI,bounty,Excel,0,2,0,2,330
13484,2023-01-09,BIBI,knockout,New Perspective,0,3,0,3,876
13485,2023-01-09,BIBI,hotZone,Dueling Beetles,0,12,2,14,1554
13486,2023-01-09,BIBI,heist,Snaked Assault,0,44,129,173,2022
13487,2023-01-09,BIBI,gemGrab,Minecart Madness,0,8,1,9,1884
13488,2023-01-09,BIBI,gemGrab,Double Swoosh,0,2,1,3,1320
13489,2023-01-09,BIBI,brawlBall,Center Stage,0,90,50,140,5460
13490,2023-01-09,BIBI,brawlBall,Backyard Bowl,0,3,3,6,474
13491,2023-01-09,BIBI,bounty,Layer Cake,0,4,0,4,1512
13492,2023-01-08,BIBI,knockout,X Marks the Spot,0,7,0,7,1692
13493,2023-01-08,BIBI,hotZone,Ring of Fire,0,4,2,6,1644
13494,2023-01-08,BIBI,heist,Snaked Assault,0,61,52,113,1494
13495,2023-01-08,BIBI,gemGrab,Hard Rock Mine,0,4,1,5,630
13496,2023-01-08,BIBI,gemGrab,Double Swoosh,0,1,0,1,864
13497,2023-01-08,BIBI,brawlBall,Super Beach,2,19,17,38,732
13498,2023-01-08,BIBI,brawlBall,Backyard Bowl,0,39,14,53,4830
13499,2023-01-08,BIBI,bounty,Layer Cake,0,2,0,2,528
13500,2023-01-07,BIBI,hotZone,Ring of Fire,0,1,0,1,846
13501,2023-01-07,BIBI,heist,Tornado Ring,1,48,67,116,1350
13502,2023-01-07,BIBI,gemGrab,Hard Rock Mine,0,4,2,6,1158
13503,2023-01-07,BIBI,gemGrab,Deep Diner,0,1,1,2,918
13504,2023-01-07,BIBI,brawlBall,Super Beach,0,44,41,85,2622
13505,2023-01-07,BIBI,brawlBall,Sneaky Fields,0,3,1,4,402
13506,2023-01-07,BIBI,bounty,Dry Season,0,2,0,2,1320
13507,2023-01-06,BIBI,hotZone,Split,0,20,26,46,1158
13508,2023-01-06,BIBI,heist,Tornado Ring,2,133,132,267,2538
13509,2023-01-06,BIBI,gemGrab,Deep Diner,0,12,1,13,2226
13510,2023-01-06,BIBI,brawlBall,Sneaky Fields,0,71,25,96,4896
13511,2023-01-06,BIBI,brawlBall,Pinhole Punt,0,9,4,13,510
13512,2023-01-06,BIBI,bounty,Dry Season,0,4,0,4,1944
13513,2023-01-05,BIBI,knockout,Out in the Open,0,1,0,1,2958
13514,2023-01-05,BIBI,hotZone,Split,0,69,60,129,3552
13515,2023-01-05,BIBI,heist,Kaboom Canyon,0,16,4,20,954
13516,2023-01-05,BIBI,gemGrab,Undermine,0,9,3,12,1812
13517,2023-01-05,BIBI,gemGrab,Gem Fort,0,0,1,1,252
13518,2023-01-05,BIBI,brawlBall,Sunny Soccer,0,2,1,3,84
13519,2023-01-05,BIBI,brawlBall,Pinhole Punt,0,102,57,159,8118
13520,2023-01-04,BIBI,knockout,Goldarm Gulch,0,4,2,6,696
13521,2023-01-04,BIBI,hotZone,Parallel Plays,0,11,9,20,864
13522,2023-01-04,BIBI,heist,Kaboom Canyon,0,12,2,14,1848
13523,2023-01-04,BIBI,gemGrab,Gem Fort,0,5,1,6,1788
13524,2023-01-04,BIBI,gemGrab,Crystal Arcade,0,4,1,5,642
13525,2023-01-04,BIBI,brawlBall,Sunny Soccer,1,116,57,174,6312
13526,2023-01-04,BIBI,brawlBall,Beach Ball,0,1,0,1,54
13527,2023-01-04,BIBI,bounty,Shooting Star,0,7,3,10,3570
13528,2023-01-03,BIBI,knockout,Goldarm Gulch,0,3,0,3,720
13529,2023-01-03,BIBI,hotZone,Parallel Plays,0,26,6,32,1542
13530,2023-01-03,BIBI,heist,Pit Stop,0,113,93,206,1956
13531,2023-01-03,BIBI,gemGrab,Minecart Madness,0,3,0,3,456
13532,2023-01-03,BIBI,gemGrab,Crystal Arcade,0,5,3,8,2406
13533,2023-01-03,BIBI,brawlBall,Center Stage,0,3,1,4,294
13534,2023-01-03,BIBI,brawlBall,Beach Ball,3,98,73,174,5580
13535,2023-01-03,BIBI,bounty,Hideout,0,1,2,3,1638
13536,2023-01-02,BIBI,knockout,Belle's Rock,0,5,1,6,1794
13537,2023-01-02,BIBI,hotZone,Quarter Pounder,0,14,3,17,2652
13538,2023-01-02,BIBI,heist,Pit Stop,0,221,176,397,3498
13539,2023-01-02,BIBI,gemGrab,Minecart Madness,0,14,0,14,2352
13540,2023-01-02,BIBI,gemGrab,Double Swoosh,0,2,2,4,1512
13541,2023-01-02,BIBI,brawlBall,Center Stage,2,73,56,131,7110
13542,2023-01-02,BIBI,brawlBall,Backyard Bowl,0,6,6,12,492
13543,2023-01-02,BIBI,bounty,Hideout,0,5,0,5,3090
13544,2023-01-01,BIBI,knockout,Belle's Rock,0,4,11,15,858
13545,2023-01-01,BIBI,hotZone,Quarter Pounder,0,10,10,20,1188
13546,2023-01-01,BIBI,hotZone,Controller Chaos,0,0,1,1,12
13547,2023-01-01,BIBI,heist,Kaboom Canyon,0,0,1,1,12
13548,2023-01-01,BIBI,heist,Bridge Too Far,0,3,0,3,462
13549,2023-01-01,BIBI,gemGrab,Double Swoosh,0,1,4,5,1140
13550,2023-01-01,BIBI,brawlBall,Backyard Bowl,1,16,16,33,2658
13551,2023-01-01,BIBI,bounty,Canal Grande,0,2,0,2,132
13552,2022-12-31,BIBI,hotZone,Controller Chaos,0,3,2,5,198
13553,2022-12-31,BIBI,heist,Bridge Too Far,0,1,0,1,276
13554,2022-12-31,BIBI,gemGrab,Hard Rock Mine,0,1,0,1,384
13555,2022-12-31,BIBI,gemGrab,Deep Diner,0,5,1,6,306
13556,2022-12-31,BIBI,brawlBall,Super Beach,0,7,4,11,618
13557,2022-12-31,BIBI,brawlBall,Sneaky Fields,0,1,0,1,60
13558,2022-12-30,BIBI,hotZone,Controller Chaos,0,3,0,3,288
13559,2022-12-30,BIBI,heist,Hot Potato,0,1,2,3,30
13560,2022-12-30,BIBI,gemGrab,Deep Diner,0,1,1,2,438
13561,2022-12-30,BIBI,brawlBall,Sneaky Fields,0,14,8,22,552
13562,2022-12-29,BIBI,heist,Hot Potato,0,6,0,6,72
13563,2022-12-29,BIBI,brawlBall,Pinhole Punt,0,3,4,7,282
13564,2022-12-28,BIBI,brawlBall,Sunny Soccer,0,4,0,4,42
13565,2022-12-27,BIBI,heist,Safe Zone,0,0,1,1,12
13566,2022-12-27,BIBI,brawlBall,Beach Ball,0,3,6,9,144
13567,2022-12-26,BIBI,hotZone,Controller Chaos,0,1,0,1,30
13568,2022-12-26,BIBI,heist,Kaboom Canyon,0,1,0,1,36
13569,2022-12-25,BIBI,brawlBall,Backyard Bowl,0,1,0,1,78
13570,2022-12-24,BIBI,brawlBall,Super Beach,0,0,2,2,48
13571,2022-12-22,BIBI,heist,Kaboom Canyon,0,1,0,1,6
13572,2022-12-21,BIBI,brawlBall,Sunny Soccer,0,1,0,1,54
13573,2022-12-20,BIBI,brawlBall,Beach Ball,0,2,3,5,96
13574,2022-12-19,BIBI,brawlBall,Center Stage,0,2,0,2,102
13575,2022-12-13,BIBI,heist,Safe Zone,0,0,1,1,42
13576,2022-12-13,BIBI,gemGrab,Crystal Arcade,0,1,1,2,72
13577,2022-12-13,BIBI,brawlBall,Beach Ball,0,1,0,1,54
13578,2022-11-11,BIBI,brawlBall,Sneaky Fields,0,2,0,2,42
13579,2022-10-28,BIBI,brawlBall,Beach Ball,0,1,0,1,12
13580,2022-10-26,BIBI,brawlBall,Sunny Soccer,0,0,1,1,18
13581,2023-01-28,BELLE,knockout,Flaring Phoenix,0,90,81,171,12366
13582,2023-01-28,BELLE,hotZone,Controller Chaos,0,8,7,15,10134
13583,2023-01-28,BELLE,heist,Bridge Too Far,6,601,553,1160,24240
13584,2023-01-28,BELLE,gemGrab,Hard Rock Mine,0,123,135,258,16638
13585,2023-01-28,BELLE,gemGrab,Deep Diner,0,42,69,111,5478
13586,2023-01-28,BELLE,brawlBall,Super Beach,5,165,183,353,74430
13587,2023-01-28,BELLE,brawlBall,Sneaky Fields,0,4,0,4,3582
13588,2023-01-28,BELLE,bounty,Canal Grande,0,25,15,40,10902
13589,2023-01-27,BELLE,knockout,Flaring Phoenix,0,31,31,62,5928
13590,2023-01-27,BELLE,hotZone,Controller Chaos,0,1,4,5,2676
13591,2023-01-27,BELLE,heist,Hot Potato,0,8,8,16,3486
13592,2023-01-27,BELLE,gemGrab,Undermine,0,5,1,6,942
13593,2023-01-27,BELLE,gemGrab,Deep Diner,0,40,45,85,6846
13594,2023-01-27,BELLE,brawlBall,Sneaky Fields,3,37,41,81,23514
13595,2023-01-27,BELLE,brawlBall,Pinhole Punt,0,6,1,7,738
13596,2023-01-27,BELLE,bounty,Temple Ruins,0,13,4,17,1890
13597,2023-01-26,BELLE,knockout,Riverside,1,435,446,882,19008
13598,2023-01-26,BELLE,hotZone,Open Zone,0,100,135,235,10182
13599,2023-01-26,BELLE,heist,Hot Potato,0,6,4,10,14610
13600,2023-01-26,BELLE,gemGrab,Undermine,0,46,59,105,10062
13601,2023-01-26,BELLE,gemGrab,Gem Fort,0,9,4,13,4674
13602,2023-01-26,BELLE,brawlBall,Sunny Soccer,0,6,4,10,3660
13603,2023-01-26,BELLE,brawlBall,Pinhole Punt,6,165,196,367,67338
13604,2023-01-26,BELLE,bounty,Temple Ruins,0,43,59,102,5610
13605,2023-01-25,BELLE,knockout,Riverside,0,221,198,419,9906
13606,2023-01-25,BELLE,hotZone,Open Zone,0,53,62,115,5262
13607,2023-01-25,BELLE,heist,Safe Zone,1,163,174,338,9156
13608,2023-01-25,BELLE,gemGrab,Gem Fort,0,12,11,23,5556
13609,2023-01-25,BELLE,gemGrab,Crystal Arcade,0,58,45,103,7866
13610,2023-01-25,BELLE,brawlBall,Sunny Soccer,2,36,49,87,40830
13611,2023-01-25,BELLE,brawlBall,Beach Ball,0,7,7,14,6408
13612,2023-01-25,BELLE,bounty,Excel,0,32,90,122,5790
13613,2023-01-24,BELLE,knockout,New Perspective,0,101,113,214,10542
13614,2023-01-24,BELLE,hotZone,Dueling Beetles,0,41,62,103,10662
13615,2023-01-24,BELLE,heist,Safe Zone,4,253,263,520,15750
13616,2023-01-24,BELLE,gemGrab,Minecart Madness,0,42,55,97,4002
13617,2023-01-24,BELLE,gemGrab,Crystal Arcade,0,87,89,176,14460
13618,2023-01-24,BELLE,brawlBall,Center Stage,0,7,6,13,7860
13619,2023-01-24,BELLE,brawlBall,Beach Ball,1,92,86,179,64614
13620,2023-01-24,BELLE,bounty,Excel,0,61,121,182,10896
13621,2023-01-23,BELLE,knockout,New Perspective,0,157,168,325,20676
13622,2023-01-23,BELLE,hotZone,Dueling Beetles,1,72,87,160,17502
13623,2023-01-23,BELLE,heist,Snaked Assault,0,13,5,18,15762
13624,2023-01-23,BELLE,gemGrab,Minecart Madness,0,179,233,412,19062
13625,2023-01-23,BELLE,gemGrab,Double Swoosh,0,11,12,23,7578
13626,2023-01-23,BELLE,brawlBall,Center Stage,6,83,68,157,92862
13627,2023-01-23,BELLE,brawlBall,Backyard Bowl,0,58,51,109,4224
13628,2023-01-23,BELLE,bounty,Layer Cake,0,51,73,124,11142
13629,2023-01-22,BELLE,knockout,X Marks the Spot,1,102,105,208,9174
13630,2023-01-22,BELLE,hotZone,Ring of Fire,0,31,36,67,5730
13631,2023-01-22,BELLE,heist,Snaked Assault,0,13,5,18,8232
13632,2023-01-22,BELLE,gemGrab,Hard Rock Mine,0,28,11,39,4722
13633,2023-01-22,BELLE,gemGrab,Double Swoosh,0,15,18,33,9426
13634,2023-01-22,BELLE,brawlBall,Super Beach,0,24,15,39,7386
13635,2023-01-22,BELLE,brawlBall,Backyard Bowl,28,316,358,702,34788
13636,2023-01-22,BELLE,bounty,Layer Cake,0,43,39,82,6654
13637,2023-01-21,BELLE,knockout,X Marks the Spot,1,366,387,754,31698
13638,2023-01-21,BELLE,hotZone,Ring of Fire,0,104,96,200,16632
13639,2023-01-21,BELLE,heist,Tornado Ring,0,11,2,13,11664
13640,2023-01-21,BELLE,gemGrab,Hard Rock Mine,0,176,196,372,22980
13641,2023-01-21,BELLE,gemGrab,Deep Diner,0,15,20,35,4470
13642,2023-01-21,BELLE,brawlBall,Super Beach,10,207,255,472,101364
13643,2023-01-21,BELLE,brawlBall,Sneaky Fields,0,4,3,7,3750
13644,2023-01-21,BELLE,bounty,Dry Season,0,238,195,433,14538
13645,2023-01-20,BELLE,knockout,Out in the Open,0,276,272,548,20106
13646,2023-01-20,BELLE,hotZone,Split,0,3,5,8,9678
13647,2023-01-20,BELLE,heist,Tornado Ring,0,6,8,14,12672
13648,2023-01-20,BELLE,gemGrab,Undermine,0,20,29,49,5442
13649,2023-01-20,BELLE,gemGrab,Deep Diner,0,92,121,213,19050
13650,2023-01-20,BELLE,brawlBall,Sneaky Fields,1,75,69,145,74778
13651,2023-01-20,BELLE,brawlBall,Pinhole Punt,0,17,23,40,2886
13652,2023-01-20,BELLE,bounty,Dry Season,0,186,190,376,11640
13653,2023-01-19,BELLE,knockout,Out in the Open,0,319,303,622,26574
13654,2023-01-19,BELLE,hotZone,Split,0,8,3,11,14856
13655,2023-01-19,BELLE,heist,Kaboom Canyon,0,71,61,132,6732
13656,2023-01-19,BELLE,gemGrab,Undermine,0,75,84,159,14154
13657,2023-01-19,BELLE,gemGrab,Gem Fort,0,8,6,14,2934
13658,2023-01-19,BELLE,brawlBall,Sunny Soccer,0,3,8,11,2274
13659,2023-01-19,BELLE,brawlBall,Pinhole Punt,10,207,226,443,72498
13660,2023-01-19,BELLE,bounty,Shooting Star,0,229,247,476,11124
13661,2023-01-18,BELLE,knockout,Goldarm Gulch,0,23,38,61,2784
13662,2023-01-18,BELLE,hotZone,Parallel Plays,0,2,0,2,1158
13663,2023-01-18,BELLE,heist,Kaboom Canyon,1,35,34,70,2592
13664,2023-01-18,BELLE,gemGrab,Gem Fort,0,6,8,14,3006
13665,2023-01-18,BELLE,gemGrab,Crystal Arcade,0,6,7,13,990
13666,2023-01-18,BELLE,brawlBall,Sunny Soccer,0,12,17,29,18941
13667,2023-01-18,BELLE,bounty,Shooting Star,0,108,93,201,5088
13668,2023-01-17,BELLE,knockout,Goldarm Gulch,0,20,37,57,2520
13669,2023-01-17,BELLE,hotZone,Parallel Plays,0,5,3,8,1038
13670,2023-01-17,BELLE,gemGrab,Minecart Madness,0,1,5,6,216
13671,2023-01-17,BELLE,gemGrab,Crystal Arcade,0,9,10,19,1266
13672,2023-01-17,BELLE,brawlBall,Beach Ball,0,8,5,13,5886
13673,2023-01-17,BELLE,bounty,Hideout,0,7,41,48,750
13674,2023-01-16,BELLE,knockout,Belle's Rock,0,34,30,64,1788
13675,2023-01-16,BELLE,hotZone,Quarter Pounder,0,4,11,15,1494
13676,2023-01-16,BELLE,gemGrab,Minecart Madness,0,15,26,41,1422
13677,2023-01-16,BELLE,gemGrab,Double Swoosh,0,0,1,1,708
13678,2023-01-16,BELLE,brawlBall,Center Stage,0,4,0,4,5778
13679,2023-01-16,BELLE,brawlBall,Backyard Bowl,0,10,14,24,852
13680,2023-01-16,BELLE,bounty,Hideout,0,28,45,73,1470
13681,2023-01-15,BELLE,knockout,Belle's Rock,0,41,46,87,2904
13682,2023-01-15,BELLE,hotZone,Quarter Pounder,0,15,45,60,3318
13683,2023-01-15,BELLE,heist,Bridge Too Far,0,70,48,118,2736
13684,2023-01-15,BELLE,gemGrab,Hard Rock Mine,0,7,1,8,1014
13685,2023-01-15,BELLE,gemGrab,Double Swoosh,0,4,4,8,2178
13686,2023-01-15,BELLE,brawlBall,Super Beach,0,1,1,2,1074
13687,2023-01-15,BELLE,brawlBall,Backyard Bowl,4,105,120,229,8946
13688,2023-01-15,BELLE,bounty,Canal Grande,0,3,9,12,960
13689,2023-01-14,BELLE,knockout,Flaring Phoenix,0,6,2,8,1080
13690,2023-01-14,BELLE,hotZone,Controller Chaos,0,2,2,4,2772
13691,2023-01-14,BELLE,heist,Bridge Too Far,0,61,97,158,4020
13692,2023-01-14,BELLE,gemGrab,Hard Rock Mine,0,16,20,36,1272
13693,2023-01-14,BELLE,gemGrab,Deep Diner,0,2,2,4,858
13694,2023-01-14,BELLE,brawlBall,Super Beach,1,2,13,16,6336
13695,2023-01-14,BELLE,brawlBall,Sneaky Fields,0,3,0,3,918
13696,2023-01-14,BELLE,bounty,Canal Grande,0,4,0,4,1014
13697,2023-01-13,BELLE,knockout,Flaring Phoenix,0,9,1,10,1182
13698,2023-01-13,BELLE,hotZone,Controller Chaos,0,0,2,2,2928
13699,2023-01-13,BELLE,gemGrab,Deep Diner,0,3,5,8,1650
13700,2023-01-13,BELLE,brawlBall,Sneaky Fields,0,7,2,9,6144
13701,2023-01-13,BELLE,bounty,Temple Ruins,0,0,1,1,270
13702,2023-01-12,BELLE,knockout,Riverside,0,45,74,119,2532
13703,2023-01-12,BELLE,hotZone,Open Zone,0,10,6,16,1488
13704,2023-01-12,BELLE,gemGrab,Undermine,0,0,1,1,690
13705,2023-01-12,BELLE,gemGrab,Gem Fort,0,0,1,1,162
13706,2023-01-12,BELLE,brawlBall,Pinhole Punt,0,11,16,27,2292
13707,2023-01-11,BELLE,knockout,Riverside,0,6,1,7,528
13708,2023-01-11,BELLE,hotZone,Open Zone,0,2,1,3,462
13709,2023-01-11,BELLE,heist,Safe Zone,0,0,3,3,48
13710,2023-01-11,BELLE,gemGrab,Gem Fort,0,1,4,5,414
13711,2023-01-11,BELLE,brawlBall,Beach Ball,0,0,1,1,48
13712,2023-01-11,BELLE,bounty,Excel,0,1,0,1,282
13713,2023-01-10,BELLE,knockout,New Perspective,0,7,21,28,720
13714,2023-01-10,BELLE,hotZone,Dueling Beetles,0,13,9,22,2424
13715,2023-01-10,BELLE,heist,Safe Zone,0,26,23,49,1176
13716,2023-01-10,BELLE,gemGrab,Minecart Madness,0,7,2,9,828
13717,2023-01-10,BELLE,gemGrab,Crystal Arcade,0,20,15,35,1746
13718,2023-01-10,BELLE,brawlBall,Center Stage,0,0,3,3,708
13719,2023-01-10,BELLE,brawlBall,Beach Ball,0,7,3,10,4392
13720,2023-01-10,BELLE,bounty,Excel,0,1,0,1,330
13721,2023-01-09,BELLE,knockout,New Perspective,0,3,13,16,876
13722,2023-01-09,BELLE,hotZone,Dueling Beetles,0,7,20,27,1554
13723,2023-01-09,BELLE,heist,Snaked Assault,0,2,0,2,2022
13724,2023-01-09,BELLE,gemGrab,Minecart Madness,0,33,20,53,1884
13725,2023-01-09,BELLE,gemGrab,Double Swoosh,0,1,6,7,1320
13726,2023-01-09,BELLE,brawlBall,Center Stage,0,1,8,9,5460
13727,2023-01-09,BELLE,brawlBall,Backyard Bowl,0,6,3,9,474
13728,2023-01-09,BELLE,bounty,Layer Cake,0,17,17,34,1512
13729,2023-01-08,BELLE,knockout,X Marks the Spot,0,16,30,46,1692
13730,2023-01-08,BELLE,hotZone,Ring of Fire,0,10,26,36,1644
13731,2023-01-08,BELLE,heist,Snaked Assault,0,1,0,1,1494
13732,2023-01-08,BELLE,gemGrab,Hard Rock Mine,0,6,2,8,630
13733,2023-01-08,BELLE,brawlBall,Super Beach,1,3,13,17,732
13734,2023-01-08,BELLE,brawlBall,Backyard Bowl,0,54,63,117,4830
13735,2023-01-08,BELLE,bounty,Layer Cake,0,7,10,17,528
13736,2023-01-07,BELLE,knockout,X Marks the Spot,0,22,23,45,1014
13737,2023-01-07,BELLE,hotZone,Ring of Fire,0,5,13,18,846
13738,2023-01-07,BELLE,gemGrab,Hard Rock Mine,0,8,11,19,1158
13739,2023-01-07,BELLE,gemGrab,Deep Diner,0,4,5,9,918
13740,2023-01-07,BELLE,brawlBall,Super Beach,0,8,4,12,2622
13741,2023-01-07,BELLE,bounty,Dry Season,0,25,39,64,1320
13742,2023-01-06,BELLE,knockout,Out in the Open,0,25,23,48,1446
13743,2023-01-06,BELLE,hotZone,Split,0,2,0,2,1158
13744,2023-01-06,BELLE,heist,Tornado Ring,0,3,12,15,2538
13745,2023-01-06,BELLE,gemGrab,Undermine,0,4,10,14,540
13746,2023-01-06,BELLE,gemGrab,Deep Diner,0,11,8,19,2226
13747,2023-01-06,BELLE,brawlBall,Sneaky Fields,0,4,2,6,4896
13748,2023-01-06,BELLE,bounty,Dry Season,0,39,50,89,1944
13749,2023-01-05,BELLE,knockout,Out in the Open,0,46,69,115,2958
13750,2023-01-05,BELLE,hotZone,Split,0,1,0,1,3552
13751,2023-01-05,BELLE,heist,Kaboom Canyon,0,2,3,5,954
13752,2023-01-05,BELLE,gemGrab,Undermine,0,8,14,22,1812
13753,2023-01-05,BELLE,brawlBall,Pinhole Punt,0,35,41,76,8118
13754,2023-01-05,BELLE,bounty,Shooting Star,0,32,46,78,1362
13755,2023-01-04,BELLE,knockout,Goldarm Gulch,0,8,4,12,696
13756,2023-01-04,BELLE,heist,Kaboom Canyon,0,19,19,38,1848
13757,2023-01-04,BELLE,gemGrab,Gem Fort,0,4,1,5,1788
13758,2023-01-04,BELLE,gemGrab,Crystal Arcade,0,2,0,2,642
13759,2023-01-04,BELLE,brawlBall,Sunny Soccer,0,5,1,6,6312
13760,2023-01-04,BELLE,brawlBall,Beach Ball,0,1,0,1,54
13761,2023-01-04,BELLE,bounty,Shooting Star,0,86,76,162,3570
13762,2023-01-03,BELLE,knockout,Goldarm Gulch,0,4,1,5,720
13763,2023-01-03,BELLE,hotZone,Parallel Plays,0,4,1,5,1542
13764,2023-01-03,BELLE,gemGrab,Minecart Madness,0,8,8,16,456
13765,2023-01-03,BELLE,gemGrab,Crystal Arcade,0,14,1,15,2406
13766,2023-01-03,BELLE,brawlBall,Beach Ball,0,12,6,18,5580
13767,2023-01-03,BELLE,bounty,Hideout,0,29,48,77,1638
13768,2023-01-02,BELLE,knockout,Belle's Rock,0,39,64,103,1794
13769,2023-01-02,BELLE,hotZone,Quarter Pounder,0,4,7,11,2652
13770,2023-01-02,BELLE,gemGrab,Minecart Madness,0,16,19,35,2352
13771,2023-01-02,BELLE,gemGrab,Double Swoosh,0,1,0,1,1512
13772,2023-01-02,BELLE,brawlBall,Center Stage,0,8,1,9,7110
13773,2023-01-02,BELLE,brawlBall,Backyard Bowl,1,5,10,16,492
13774,2023-01-02,BELLE,bounty,Hideout,0,68,98,166,3090
13775,2023-01-01,BELLE,knockout,Belle's Rock,0,10,7,17,858
13776,2023-01-01,BELLE,hotZone,Quarter Pounder,0,9,1,10,1188
13777,2023-01-01,BELLE,heist,Bridge Too Far,0,15,25,40,462
13778,2023-01-01,BELLE,gemGrab,Double Swoosh,0,1,0,1,1140
13779,2023-01-01,BELLE,brawlBall,Backyard Bowl,0,23,29,52,2658
13780,2022-12-31,BELLE,heist,Kaboom Canyon,0,0,1,1,12
13781,2022-12-31,BELLE,heist,Bridge Too Far,0,6,17,23,276
13782,2022-12-31,BELLE,gemGrab,Minecart Madness,0,1,0,1,24
13783,2022-12-31,BELLE,gemGrab,Hard Rock Mine,0,2,0,2,384
13784,2022-12-31,BELLE,gemGrab,Deep Diner,0,1,0,1,306
13785,2022-12-30,BELLE,heist,Kaboom Canyon,0,1,1,2,18
13786,2022-12-30,BELLE,gemGrab,Undermine,0,1,0,1,102
13787,2022-12-30,BELLE,gemGrab,Deep Diner,0,5,17,22,438
13788,2022-12-30,BELLE,brawlBall,Sneaky Fields,0,1,0,1,552
13789,2022-12-29,BELLE,heist,Kaboom Canyon,0,0,1,1,18
13790,2022-12-28,BELLE,hotZone,Open Zone,0,1,1,2,108
13791,2022-12-27,BELLE,knockout,New Perspective,0,1,0,1,30
13792,2022-12-27,BELLE,heist,Kaboom Canyon,0,0,1,1,18
13793,2022-12-27,BELLE,brawlBall,Beach Ball,0,1,0,1,144
13794,2022-12-26,BELLE,gemGrab,Minecart Madness,0,0,2,2,60
13795,2022-12-25,BELLE,brawlBall,Backyard Bowl,0,2,0,2,78
13796,2022-12-23,BELLE,knockout,Out in the Open,0,0,1,1,132
13797,2022-12-19,BELLE,brawlBall,Center Stage,0,1,0,1,102
13798,2022-12-18,BELLE,heist,Bridge Too Far,0,1,0,1,12
13799,2022-12-16,BELLE,brawlBall,Sneaky Fields,0,0,1,1,84
13800,2022-12-13,BELLE,heist,Safe Zone,0,0,2,2,42
13801,2022-12-11,BELLE,brawlBall,Backyard Bowl,0,0,1,1,24
13802,2022-12-10,BELLE,hotZone,Ring of Fire,0,1,0,1,6
13803,2022-11-07,BELLE,hotZone,Quarter Pounder,0,0,1,1,24
13804,2022-11-01,BELLE,knockout,New Perspective,0,4,2,6,54
13805,2022-10-30,BELLE,knockout,Out in the Open,0,1,0,1,12
13806,2022-10-28,BELLE,knockout,Out in the Open,0,1,2,3,18
13807,2022-10-26,BELLE,bounty,Shooting Star,0,1,1,2,36
13808,2022-10-15,BELLE,gemGrab,Hard Rock Mine,0,2,2,4,90
13809,2022-10-10,BELLE,knockout,Belle's Rock,0,4,1,5,48
13810,2023-01-28,BEA,knockout,Flaring Phoenix,0,74,28,102,12366
13811,2023-01-28,BEA,hotZone,Controller Chaos,0,119,234,353,10134
13812,2023-01-28,BEA,heist,Bridge Too Far,1,409,378,788,24240
13813,2023-01-28,BEA,gemGrab,Hard Rock Mine,0,139,120,259,16638
13814,2023-01-28,BEA,gemGrab,Deep Diner,0,37,22,59,5478
13815,2023-01-28,BEA,brawlBall,Super Beach,51,1521,1858,3430,74430
13816,2023-01-28,BEA,brawlBall,Sneaky Fields,5,94,128,227,3582
13817,2023-01-28,BEA,bounty,Canal Grande,0,44,34,78,10902
13818,2023-01-27,BEA,knockout,Flaring Phoenix,0,22,16,38,5928
13819,2023-01-27,BEA,hotZone,Controller Chaos,0,45,48,93,2676
13820,2023-01-27,BEA,heist,Hot Potato,0,9,8,17,3486
13821,2023-01-27,BEA,gemGrab,Undermine,0,6,1,7,942
13822,2023-01-27,BEA,gemGrab,Deep Diner,0,58,69,127,6846
13823,2023-01-27,BEA,brawlBall,Sneaky Fields,6,408,497,911,23514
13824,2023-01-27,BEA,brawlBall,Pinhole Punt,0,20,14,34,738
13825,2023-01-27,BEA,bounty,Temple Ruins,0,17,9,26,1890
13826,2023-01-26,BEA,knockout,Riverside,0,404,259,663,19008
13827,2023-01-26,BEA,hotZone,Open Zone,0,361,397,758,10182
13828,2023-01-26,BEA,heist,Hot Potato,0,79,108,187,14610
13829,2023-01-26,BEA,gemGrab,Undermine,0,115,117,232,10062
13830,2023-01-26,BEA,gemGrab,Gem Fort,0,31,14,45,4674
13831,2023-01-26,BEA,brawlBall,Sunny Soccer,0,24,18,42,3660
13832,2023-01-26,BEA,brawlBall,Pinhole Punt,47,1413,1560,3020,67338
13833,2023-01-26,BEA,bounty,Temple Ruins,0,50,35,85,5610
13834,2023-01-25,BEA,knockout,Riverside,0,231,124,355,9906
13835,2023-01-25,BEA,hotZone,Open Zone,0,230,255,485,5262
13836,2023-01-25,BEA,heist,Safe Zone,0,70,97,167,9156
13837,2023-01-25,BEA,gemGrab,Gem Fort,0,28,20,48,5556
13838,2023-01-25,BEA,gemGrab,Crystal Arcade,0,74,58,132,7866
13839,2023-01-25,BEA,brawlBall,Sunny Soccer,12,324,365,701,40830
13840,2023-01-25,BEA,brawlBall,Beach Ball,4,75,95,174,6408
13841,2023-01-25,BEA,bounty,Excel,0,32,27,59,5790
13842,2023-01-24,BEA,knockout,New Perspective,0,150,88,238,10542
13843,2023-01-24,BEA,hotZone,Dueling Beetles,0,105,158,263,10662
13844,2023-01-24,BEA,heist,Safe Zone,1,194,153,348,15750
13845,2023-01-24,BEA,gemGrab,Minecart Madness,0,53,69,122,4002
13846,2023-01-24,BEA,gemGrab,Crystal Arcade,0,131,135,266,14460
13847,2023-01-24,BEA,brawlBall,Center Stage,3,51,82,136,7860
13848,2023-01-24,BEA,brawlBall,Beach Ball,39,764,893,1696,64614
13849,2023-01-24,BEA,bounty,Excel,0,53,19,72,10896
13850,2023-01-23,BEA,knockout,New Perspective,0,223,154,377,20676
13851,2023-01-23,BEA,hotZone,Dueling Beetles,2,353,402,757,17502
13852,2023-01-23,BEA,heist,Snaked Assault,0,231,471,702,15762
13853,2023-01-23,BEA,gemGrab,Minecart Madness,0,238,197,435,19062
13854,2023-01-23,BEA,gemGrab,Double Swoosh,0,43,41,84,7578
13855,2023-01-23,BEA,brawlBall,Center Stage,24,554,462,1040,92862
13856,2023-01-23,BEA,brawlBall,Backyard Bowl,2,118,94,214,4224
13857,2023-01-23,BEA,bounty,Layer Cake,0,58,68,126,11142
13858,2023-01-22,BEA,knockout,X Marks the Spot,0,74,53,127,9174
13859,2023-01-22,BEA,hotZone,Ring of Fire,0,145,174,319,5730
13860,2023-01-22,BEA,heist,Snaked Assault,2,184,253,439,8232
13861,2023-01-22,BEA,gemGrab,Hard Rock Mine,0,47,31,78,4722
13862,2023-01-22,BEA,gemGrab,Double Swoosh,0,49,50,99,9426
13863,2023-01-22,BEA,brawlBall,Super Beach,5,168,142,315,7386
13864,2023-01-22,BEA,brawlBall,Backyard Bowl,69,1154,1109,2332,34788
13865,2023-01-22,BEA,bounty,Layer Cake,0,26,13,39,6654
13866,2023-01-21,BEA,knockout,X Marks the Spot,0,293,190,483,31698
13867,2023-01-21,BEA,hotZone,Ring of Fire,2,467,554,1023,16632
13868,2023-01-21,BEA,heist,Tornado Ring,1,120,166,287,11664
13869,2023-01-21,BEA,gemGrab,Hard Rock Mine,0,199,206,405,22980
13870,2023-01-21,BEA,gemGrab,Deep Diner,0,39,36,75,4470
13871,2023-01-21,BEA,brawlBall,Super Beach,86,2165,2483,4734,101364
13872,2023-01-21,BEA,brawlBall,Sneaky Fields,3,74,111,188,3750
13873,2023-01-21,BEA,bounty,Dry Season,0,224,174,398,14538
13874,2023-01-20,BEA,knockout,Out in the Open,1,269,168,438,20106
13875,2023-01-20,BEA,hotZone,Split,0,10,4,14,9678
13876,2023-01-20,BEA,heist,Tornado Ring,5,156,221,382,12672
13877,2023-01-20,BEA,gemGrab,Undermine,0,55,51,106,5442
13878,2023-01-20,BEA,gemGrab,Deep Diner,0,196,198,394,19050
13879,2023-01-20,BEA,brawlBall,Sneaky Fields,44,1054,1438,2536,74778
13880,2023-01-20,BEA,brawlBall,Pinhole Punt,3,48,51,102,2886
13881,2023-01-20,BEA,bounty,Dry Season,0,178,117,295,11640
13882,2023-01-19,BEA,knockout,Out in the Open,0,349,263,612,26574
13883,2023-01-19,BEA,hotZone,Split,0,20,20,40,14856
13884,2023-01-19,BEA,heist,Kaboom Canyon,0,85,110,195,6732
13885,2023-01-19,BEA,gemGrab,Undermine,0,127,131,258,14154
13886,2023-01-19,BEA,gemGrab,Gem Fort,0,18,23,41,2934
13887,2023-01-19,BEA,brawlBall,Sunny Soccer,1,18,26,45,2274
13888,2023-01-19,BEA,brawlBall,Pinhole Punt,60,1637,1823,3520,72498
13889,2023-01-19,BEA,bounty,Shooting Star,0,241,187,428,11124
13890,2023-01-18,BEA,knockout,Goldarm Gulch,0,18,12,30,2784
13891,2023-01-18,BEA,hotZone,Parallel Plays,0,5,4,9,1158
13892,2023-01-18,BEA,heist,Kaboom Canyon,1,34,36,71,2592
13893,2023-01-18,BEA,gemGrab,Gem Fort,0,13,14,27,3006
13894,2023-01-18,BEA,gemGrab,Crystal Arcade,0,6,10,16,990
13895,2023-01-18,BEA,brawlBall,Sunny Soccer,4,166,157,327,18941
13896,2023-01-18,BEA,brawlBall,Beach Ball,0,12,9,21,774
13897,2023-01-18,BEA,bounty,Shooting Star,0,104,73,177,5088
13898,2023-01-17,BEA,knockout,Goldarm Gulch,0,15,7,22,2520
13899,2023-01-17,BEA,hotZone,Parallel Plays,0,12,17,29,1038
13900,2023-01-17,BEA,gemGrab,Minecart Madness,0,2,6,8,216
13901,2023-01-17,BEA,gemGrab,Crystal Arcade,0,18,19,37,1266
13902,2023-01-17,BEA,brawlBall,Center Stage,0,2,4,6,288
13903,2023-01-17,BEA,brawlBall,Beach Ball,3,68,88,159,5886
13904,2023-01-17,BEA,bounty,Hideout,0,9,2,11,750
13905,2023-01-16,BEA,knockout,Belle's Rock,0,14,13,27,1788
13906,2023-01-16,BEA,hotZone,Quarter Pounder,0,28,82,110,1494
13907,2023-01-16,BEA,heist,Pit Stop,0,1,1,2,4044
13908,2023-01-16,BEA,gemGrab,Minecart Madness,0,13,13,26,1422
13909,2023-01-16,BEA,gemGrab,Double Swoosh,0,3,2,5,708
13910,2023-01-16,BEA,brawlBall,Center Stage,3,33,26,62,5778
13911,2023-01-16,BEA,brawlBall,Backyard Bowl,1,30,41,72,852
13912,2023-01-16,BEA,bounty,Hideout,0,27,15,42,1470
13913,2023-01-15,BEA,knockout,Belle's Rock,0,26,12,38,2904
13914,2023-01-15,BEA,hotZone,Quarter Pounder,0,138,135,273,3318
13915,2023-01-15,BEA,heist,Bridge Too Far,0,48,32,80,2736
13916,2023-01-15,BEA,gemGrab,Hard Rock Mine,0,5,0,5,1014
13917,2023-01-15,BEA,gemGrab,Double Swoosh,0,6,14,20,2178
13918,2023-01-15,BEA,brawlBall,Super Beach,1,27,52,80,1074
13919,2023-01-15,BEA,brawlBall,Backyard Bowl,20,343,322,685,8946
13920,2023-01-15,BEA,bounty,Canal Grande,0,4,1,5,960
13921,2023-01-14,BEA,knockout,Flaring Phoenix,0,5,2,7,1080
13922,2023-01-14,BEA,hotZone,Controller Chaos,0,43,92,135,2772
13923,2023-01-14,BEA,heist,Bridge Too Far,0,99,78,177,4020
13924,2023-01-14,BEA,gemGrab,Hard Rock Mine,0,11,12,23,1272
13925,2023-01-14,BEA,gemGrab,Deep Diner,0,10,18,28,858
13926,2023-01-14,BEA,brawlBall,Super Beach,8,169,194,371,6336
13927,2023-01-14,BEA,brawlBall,Sneaky Fields,1,35,36,72,918
13928,2023-01-14,BEA,bounty,Canal Grande,0,4,0,4,1014
13929,2023-01-13,BEA,knockout,Flaring Phoenix,0,10,0,10,1182
13930,2023-01-13,BEA,hotZone,Controller Chaos,0,76,119,195,2928
13931,2023-01-13,BEA,heist,Hot Potato,0,1,1,2,600
13932,2023-01-13,BEA,gemGrab,Deep Diner,0,13,7,20,1650
13933,2023-01-13,BEA,brawlBall,Sneaky Fields,2,179,185,366,6144
13934,2023-01-13,BEA,brawlBall,Pinhole Punt,1,8,2,11,156
13935,2023-01-13,BEA,bounty,Temple Ruins,0,2,3,5,270
13936,2023-01-12,BEA,knockout,Riverside,0,53,25,78,2532
13937,2023-01-12,BEA,hotZone,Open Zone,0,51,71,122,1488
13938,2023-01-12,BEA,heist,Hot Potato,0,1,0,1,330
13939,2023-01-12,BEA,gemGrab,Undermine,0,7,5,12,690
13940,2023-01-12,BEA,gemGrab,Gem Fort,0,3,11,14,162
13941,2023-01-12,BEA,brawlBall,Sunny Soccer,0,3,1,4,240
13942,2023-01-12,BEA,brawlBall,Pinhole Punt,2,56,71,129,2292
13943,2023-01-12,BEA,bounty,Temple Ruins,0,0,1,1,24
13944,2023-01-11,BEA,knockout,Riverside,0,15,24,39,528
13945,2023-01-11,BEA,hotZone,Open Zone,0,28,23,51,462
13946,2023-01-11,BEA,heist,Safe Zone,0,1,0,1,48
13947,2023-01-11,BEA,gemGrab,Gem Fort,0,1,0,1,414
13948,2023-01-11,BEA,brawlBall,Sunny Soccer,1,26,30,57,1638
13949,2023-01-11,BEA,brawlBall,Beach Ball,0,1,1,2,48
13950,2023-01-11,BEA,bounty,Excel,0,1,0,1,282
13951,2023-01-10,BEA,knockout,New Perspective,0,7,3,10,720
13952,2023-01-10,BEA,hotZone,Dueling Beetles,0,43,29,72,2424
13953,2023-01-10,BEA,heist,Safe Zone,0,17,20,37,1176
13954,2023-01-10,BEA,gemGrab,Minecart Madness,0,11,36,47,828
13955,2023-01-10,BEA,gemGrab,Crystal Arcade,0,32,45,77,1746
13956,2023-01-10,BEA,brawlBall,Center Stage,0,5,0,5,708
13957,2023-01-10,BEA,brawlBall,Beach Ball,1,85,76,162,4392
13958,2023-01-10,BEA,bounty,Excel,0,4,21,25,330
13959,2023-01-09,BEA,knockout,New Perspective,0,7,4,11,876
13960,2023-01-09,BEA,hotZone,Dueling Beetles,0,30,50,80,1554
13961,2023-01-09,BEA,heist,Snaked Assault,0,16,46,62,2022
13962,2023-01-09,BEA,gemGrab,Minecart Madness,0,24,26,50,1884
13963,2023-01-09,BEA,gemGrab,Double Swoosh,0,7,32,39,1320
13964,2023-01-09,BEA,brawlBall,Center Stage,2,38,20,60,5460
13965,2023-01-09,BEA,brawlBall,Backyard Bowl,3,25,11,39,474
13966,2023-01-09,BEA,bounty,Layer Cake,0,6,4,10,1512
13967,2023-01-08,BEA,knockout,X Marks the Spot,0,19,18,37,1692
13968,2023-01-08,BEA,hotZone,Ring of Fire,0,42,67,109,1644
13969,2023-01-08,BEA,heist,Snaked Assault,0,27,67,94,1494
13970,2023-01-08,BEA,gemGrab,Hard Rock Mine,0,9,12,21,630
13971,2023-01-08,BEA,gemGrab,Double Swoosh,0,5,9,14,864
13972,2023-01-08,BEA,brawlBall,Super Beach,2,30,22,54,732
13973,2023-01-08,BEA,brawlBall,Backyard Bowl,9,183,254,446,4830
13974,2023-01-08,BEA,bounty,Layer Cake,0,4,2,6,528
13975,2023-01-07,BEA,knockout,X Marks the Spot,0,8,4,12,1014
13976,2023-01-07,BEA,hotZone,Ring of Fire,0,15,12,27,846
13977,2023-01-07,BEA,heist,Tornado Ring,0,4,10,14,1350
13978,2023-01-07,BEA,gemGrab,Hard Rock Mine,0,13,5,18,1158
13979,2023-01-07,BEA,gemGrab,Deep Diner,0,14,26,40,918
13980,2023-01-07,BEA,brawlBall,Super Beach,1,80,107,188,2622
13981,2023-01-07,BEA,brawlBall,Sneaky Fields,2,13,15,30,402
13982,2023-01-07,BEA,bounty,Dry Season,0,24,9,33,1320
13983,2023-01-06,BEA,knockout,Out in the Open,0,19,9,28,1446
13984,2023-01-06,BEA,hotZone,Split,0,2,10,12,1158
13985,2023-01-06,BEA,heist,Tornado Ring,0,33,83,116,2538
13986,2023-01-06,BEA,gemGrab,Undermine,0,8,10,18,540
13987,2023-01-06,BEA,gemGrab,Deep Diner,0,29,24,53,2226
13988,2023-01-06,BEA,brawlBall,Sneaky Fields,2,137,221,360,4896
13989,2023-01-06,BEA,brawlBall,Pinhole Punt,0,18,17,35,510
13990,2023-01-06,BEA,bounty,Dry Season,0,18,17,35,1944
13991,2023-01-05,BEA,knockout,Out in the Open,0,45,53,98,2958
13992,2023-01-05,BEA,hotZone,Split,0,29,42,71,3552
13993,2023-01-05,BEA,heist,Kaboom Canyon,0,16,30,46,954
13994,2023-01-05,BEA,gemGrab,Undermine,0,28,23,51,1812
13995,2023-01-05,BEA,gemGrab,Gem Fort,0,2,2,4,252
13996,2023-01-05,BEA,brawlBall,Sunny Soccer,0,1,4,5,84
13997,2023-01-05,BEA,brawlBall,Pinhole Punt,9,285,290,584,8118
13998,2023-01-05,BEA,bounty,Shooting Star,0,26,7,33,1362
13999,2023-01-04,BEA,knockout,Goldarm Gulch,0,2,0,2,696
14000,2023-01-04,BEA,hotZone,Parallel Plays,0,12,12,24,864
14001,2023-01-04,BEA,heist,Kaboom Canyon,0,31,33,64,1848
14002,2023-01-04,BEA,gemGrab,Gem Fort,0,16,11,27,1788
14003,2023-01-04,BEA,gemGrab,Crystal Arcade,0,12,8,20,642
14004,2023-01-04,BEA,brawlBall,Sunny Soccer,5,89,94,188,6312
14005,2023-01-04,BEA,brawlBall,Beach Ball,0,0,4,4,54
14006,2023-01-04,BEA,bounty,Shooting Star,0,57,25,82,3570
14007,2023-01-03,BEA,knockout,Goldarm Gulch,0,1,0,1,720
14008,2023-01-03,BEA,hotZone,Parallel Plays,0,24,30,54,1542
14009,2023-01-03,BEA,heist,Pit Stop,0,1,15,16,1956
14010,2023-01-03,BEA,gemGrab,Minecart Madness,0,8,0,8,456
14011,2023-01-03,BEA,gemGrab,Crystal Arcade,0,34,53,87,2406
14012,2023-01-03,BEA,brawlBall,Center Stage,0,1,4,5,294
14013,2023-01-03,BEA,brawlBall,Beach Ball,0,104,144,248,5580
14014,2023-01-03,BEA,bounty,Hideout,0,36,5,41,1638
14015,2023-01-02,BEA,knockout,Belle's Rock,0,11,10,21,1794
14016,2023-01-02,BEA,hotZone,Quarter Pounder,2,73,121,196,2652
14017,2023-01-02,BEA,heist,Pit Stop,0,15,40,55,3498
14018,2023-01-02,BEA,gemGrab,Minecart Madness,0,24,28,52,2352
14019,2023-01-02,BEA,gemGrab,Double Swoosh,0,11,22,33,1512
14020,2023-01-02,BEA,brawlBall,Center Stage,0,47,58,105,7110
14021,2023-01-02,BEA,brawlBall,Backyard Bowl,1,24,12,37,492
14022,2023-01-02,BEA,bounty,Hideout,0,39,17,56,3090
14023,2023-01-01,BEA,knockout,Belle's Rock,0,4,1,5,858
14024,2023-01-01,BEA,hotZone,Quarter Pounder,0,69,93,162,1188
14025,2023-01-01,BEA,heist,Bridge Too Far,0,5,5,10,462
14026,2023-01-01,BEA,gemGrab,Double Swoosh,0,6,5,11,1140
14027,2023-01-01,BEA,brawlBall,Backyard Bowl,2,110,128,240,2658
14028,2023-01-01,BEA,bounty,Canal Grande,0,2,0,2,132
14029,2022-12-31,BEA,hotZone,Controller Chaos,0,4,5,9,198
14030,2022-12-31,BEA,heist,Bridge Too Far,0,12,4,16,276
14031,2022-12-31,BEA,gemGrab,Hard Rock Mine,0,5,1,6,384
14032,2022-12-31,BEA,gemGrab,Deep Diner,0,2,1,3,306
14033,2022-12-31,BEA,brawlBall,Super Beach,0,12,9,21,618
14034,2022-12-31,BEA,bounty,Canal Grande,0,0,1,1,54
14035,2022-12-30,BEA,knockout,Flaring Phoenix,0,0,1,1,72
14036,2022-12-30,BEA,hotZone,Controller Chaos,0,2,2,4,288
14037,2022-12-30,BEA,gemGrab,Undermine,0,1,1,2,102
14038,2022-12-30,BEA,gemGrab,Deep Diner,0,9,17,26,438
14039,2022-12-30,BEA,brawlBall,Sneaky Fields,0,10,11,21,552
14040,2022-12-29,BEA,hotZone,Open Zone,0,3,2,5,54
14041,2022-12-29,BEA,gemGrab,Undermine,0,1,0,1,102
14042,2022-12-29,BEA,brawlBall,Pinhole Punt,0,16,5,21,282
14043,2022-12-28,BEA,hotZone,Open Zone,0,9,1,10,108
14044,2022-12-27,BEA,knockout,New Perspective,0,0,1,1,30
14045,2022-12-27,BEA,gemGrab,Minecart Madness,0,0,1,1,30
14046,2022-12-27,BEA,brawlBall,Center Stage,0,4,1,5,30
14047,2022-12-27,BEA,brawlBall,Beach Ball,0,1,1,2,144
14048,2022-12-26,BEA,heist,Kaboom Canyon,0,0,1,1,36
14049,2022-12-26,BEA,gemGrab,Minecart Madness,0,1,1,2,60
14050,2022-12-26,BEA,brawlBall,Center Stage,0,1,0,1,78
14051,2022-12-25,BEA,brawlBall,Backyard Bowl,0,3,1,4,78
14052,2022-12-25,BEA,bounty,Layer Cake,0,1,1,2,12
14053,2022-12-24,BEA,knockout,X Marks the Spot,0,0,1,1,12
14054,2022-12-24,BEA,brawlBall,Super Beach,0,1,3,4,48
14055,2022-12-24,BEA,bounty,Dry Season,0,0,1,1,12
14056,2022-12-23,BEA,knockout,Out in the Open,0,0,1,1,132
14057,2022-12-22,BEA,brawlBall,Pinhole Punt,0,3,0,3,132
14058,2022-12-21,BEA,brawlBall,Sunny Soccer,0,2,2,4,54
14059,2022-12-20,BEA,brawlBall,Beach Ball,0,1,2,3,96
14060,2022-12-19,BEA,brawlBall,Center Stage,0,2,0,2,102
14061,2022-12-18,BEA,heist,Bridge Too Far,0,1,0,1,12
14062,2022-12-17,BEA,knockout,Flaring Phoenix,0,1,0,1,30
14063,2022-12-16,BEA,brawlBall,Sneaky Fields,0,1,1,2,84
14064,2022-12-13,BEA,knockout,New Perspective,0,3,13,16,84
14065,2022-12-13,BEA,heist,Safe Zone,0,0,1,1,42
14066,2022-12-13,BEA,gemGrab,Crystal Arcade,0,0,1,1,72
14067,2022-11-03,BEA,bounty,Temple Ruins,0,1,0,1,6
14068,2022-11-01,BEA,knockout,New Perspective,0,0,1,1,54
14069,2022-10-28,BEA,bounty,Canal Grande,0,1,0,1,12
14070,2022-10-15,BEA,hotZone,Ring of Fire,0,1,0,1,24
14071,2022-10-15,BEA,gemGrab,Hard Rock Mine,0,2,0,2,90
14072,2023-01-28,BARLEY,knockout,Flaring Phoenix,0,34,24,58,12366
14073,2023-01-28,BARLEY,hotZone,Controller Chaos,0,50,58,108,10134
14074,2023-01-28,BARLEY,heist,Bridge Too Far,0,18,14,32,24240
14075,2023-01-28,BARLEY,gemGrab,Hard Rock Mine,0,15,18,33,16638
14076,2023-01-28,BARLEY,gemGrab,Deep Diner,0,30,50,80,5478
14077,2023-01-28,BARLEY,brawlBall,Super Beach,14,420,557,991,74430
14078,2023-01-28,BARLEY,brawlBall,Sneaky Fields,0,1,3,4,3582
14079,2023-01-28,BARLEY,bounty,Canal Grande,0,35,35,70,10902
14080,2023-01-27,BARLEY,knockout,Flaring Phoenix,0,10,5,15,5928
14081,2023-01-27,BARLEY,hotZone,Controller Chaos,0,35,17,52,2676
14082,2023-01-27,BARLEY,heist,Hot Potato,0,62,112,174,3486
14083,2023-01-27,BARLEY,gemGrab,Undermine,0,4,0,4,942
14084,2023-01-27,BARLEY,gemGrab,Deep Diner,0,78,92,170,6846
14085,2023-01-27,BARLEY,brawlBall,Sneaky Fields,0,44,43,87,23514
14086,2023-01-27,BARLEY,bounty,Temple Ruins,0,1,1,2,1890
14087,2023-01-26,BARLEY,knockout,Riverside,1,16,2,19,19008
14088,2023-01-26,BARLEY,hotZone,Open Zone,0,18,7,25,10182
14089,2023-01-26,BARLEY,heist,Hot Potato,0,282,364,646,14610
14090,2023-01-26,BARLEY,gemGrab,Undermine,0,3,10,13,10062
14091,2023-01-26,BARLEY,gemGrab,Gem Fort,0,3,1,4,4674
14092,2023-01-26,BARLEY,brawlBall,Sunny Soccer,0,5,4,9,3660
14093,2023-01-26,BARLEY,brawlBall,Pinhole Punt,2,65,40,107,67338
14094,2023-01-26,BARLEY,bounty,Temple Ruins,0,6,7,13,5610
14095,2023-01-25,BARLEY,knockout,Riverside,0,4,3,7,9906
14096,2023-01-25,BARLEY,hotZone,Open Zone,0,3,0,3,5262
14097,2023-01-25,BARLEY,heist,Safe Zone,0,22,7,29,9156
14098,2023-01-25,BARLEY,gemGrab,Gem Fort,0,4,5,9,5556
14099,2023-01-25,BARLEY,gemGrab,Crystal Arcade,0,2,10,12,7866
14100,2023-01-25,BARLEY,brawlBall,Sunny Soccer,1,138,134,273,40830
14101,2023-01-25,BARLEY,brawlBall,Beach Ball,0,13,10,23,6408
14102,2023-01-25,BARLEY,bounty,Excel,0,16,15,31,5790
14103,2023-01-24,BARLEY,knockout,New Perspective,0,19,10,29,10542
14104,2023-01-24,BARLEY,hotZone,Dueling Beetles,0,49,20,69,10662
14105,2023-01-24,BARLEY,heist,Safe Zone,0,32,16,48,15750
14106,2023-01-24,BARLEY,gemGrab,Minecart Madness,0,6,13,19,4002
14107,2023-01-24,BARLEY,gemGrab,Crystal Arcade,0,22,10,32,14460
14108,2023-01-24,BARLEY,brawlBall,Center Stage,0,6,3,9,7860
14109,2023-01-24,BARLEY,brawlBall,Beach Ball,10,154,163,327,64614
14110,2023-01-24,BARLEY,bounty,Excel,0,31,23,54,10896
14111,2023-01-23,BARLEY,knockout,New Perspective,0,23,7,30,20676
14112,2023-01-23,BARLEY,hotZone,Dueling Beetles,0,76,82,158,17502
14113,2023-01-23,BARLEY,heist,Snaked Assault,1,56,25,82,15762
14114,2023-01-23,BARLEY,gemGrab,Minecart Madness,0,33,25,58,19062
14115,2023-01-23,BARLEY,gemGrab,Double Swoosh,0,4,2,6,7578
14116,2023-01-23,BARLEY,brawlBall,Center Stage,4,72,55,131,92862
14117,2023-01-23,BARLEY,bounty,Layer Cake,0,30,9,39,11142
14118,2023-01-22,BARLEY,knockout,X Marks the Spot,0,14,7,21,9174
14119,2023-01-22,BARLEY,hotZone,Ring of Fire,0,5,0,5,5730
14120,2023-01-22,BARLEY,heist,Snaked Assault,0,35,22,57,8232
14121,2023-01-22,BARLEY,gemGrab,Hard Rock Mine,0,7,1,8,4722
14122,2023-01-22,BARLEY,gemGrab,Double Swoosh,0,10,14,24,9426
14123,2023-01-22,BARLEY,brawlBall,Super Beach,2,34,38,74,7386
14124,2023-01-22,BARLEY,brawlBall,Backyard Bowl,2,16,5,23,34788
14125,2023-01-22,BARLEY,bounty,Layer Cake,0,9,5,14,6654
14126,2023-01-21,BARLEY,knockout,X Marks the Spot,0,17,17,34,31698
14127,2023-01-21,BARLEY,hotZone,Ring of Fire,0,26,7,33,16632
14128,2023-01-21,BARLEY,heist,Tornado Ring,0,58,35,93,11664
14129,2023-01-21,BARLEY,gemGrab,Hard Rock Mine,0,26,13,39,22980
14130,2023-01-21,BARLEY,gemGrab,Deep Diner,0,44,56,100,4470
14131,2023-01-21,BARLEY,brawlBall,Super Beach,31,554,895,1480,101364
14132,2023-01-21,BARLEY,brawlBall,Sneaky Fields,0,7,4,11,3750
14133,2023-01-21,BARLEY,bounty,Dry Season,0,13,9,22,14538
14134,2023-01-20,BARLEY,knockout,Out in the Open,0,21,10,31,20106
14135,2023-01-20,BARLEY,hotZone,Split,0,130,189,319,9678
14136,2023-01-20,BARLEY,heist,Tornado Ring,1,40,34,75,12672
14137,2023-01-20,BARLEY,gemGrab,Undermine,0,8,1,9,5442
14138,2023-01-20,BARLEY,gemGrab,Deep Diner,0,153,227,380,19050
14139,2023-01-20,BARLEY,brawlBall,Sneaky Fields,4,85,66,155,74778
14140,2023-01-20,BARLEY,brawlBall,Pinhole Punt,0,5,4,9,2886
14141,2023-01-20,BARLEY,bounty,Dry Season,0,13,13,26,11640
14142,2023-01-19,BARLEY,knockout,Out in the Open,0,16,24,40,26574
14143,2023-01-19,BARLEY,hotZone,Split,0,212,325,537,14856
14144,2023-01-19,BARLEY,heist,Kaboom Canyon,0,23,14,37,6732
14145,2023-01-19,BARLEY,gemGrab,Undermine,0,15,5,20,14154
14146,2023-01-19,BARLEY,gemGrab,Gem Fort,0,1,0,1,2934
14147,2023-01-19,BARLEY,brawlBall,Sunny Soccer,0,9,3,12,2274
14148,2023-01-19,BARLEY,brawlBall,Pinhole Punt,1,35,19,55,72498
14149,2023-01-19,BARLEY,bounty,Shooting Star,0,10,6,16,11124
14150,2023-01-18,BARLEY,knockout,Goldarm Gulch,0,2,1,3,2784
14151,2023-01-18,BARLEY,hotZone,Parallel Plays,0,26,55,81,1158
14152,2023-01-18,BARLEY,heist,Kaboom Canyon,0,9,3,12,2592
14153,2023-01-18,BARLEY,gemGrab,Gem Fort,0,1,3,4,3006
14154,2023-01-18,BARLEY,gemGrab,Crystal Arcade,0,1,2,3,990
14155,2023-01-18,BARLEY,brawlBall,Sunny Soccer,1,74,64,139,18941
14156,2023-01-18,BARLEY,brawlBall,Beach Ball,1,2,2,5,774
14157,2023-01-18,BARLEY,bounty,Shooting Star,0,0,2,2,5088
14158,2023-01-17,BARLEY,knockout,Goldarm Gulch,0,2,10,12,2520
14159,2023-01-17,BARLEY,hotZone,Parallel Plays,0,26,31,57,1038
14160,2023-01-17,BARLEY,heist,Pit Stop,0,24,20,44,1290
14161,2023-01-17,BARLEY,gemGrab,Minecart Madness,0,2,0,2,216
14162,2023-01-17,BARLEY,gemGrab,Crystal Arcade,0,4,11,15,1266
14163,2023-01-17,BARLEY,brawlBall,Beach Ball,0,23,10,33,5886
14164,2023-01-16,BARLEY,knockout,Belle's Rock,0,3,2,5,1788
14165,2023-01-16,BARLEY,hotZone,Quarter Pounder,0,10,15,25,1494
14166,2023-01-16,BARLEY,heist,Pit Stop,0,72,110,182,4044
14167,2023-01-16,BARLEY,gemGrab,Minecart Madness,0,1,2,3,1422
14168,2023-01-16,BARLEY,gemGrab,Double Swoosh,0,1,0,1,708
14169,2023-01-16,BARLEY,brawlBall,Center Stage,0,3,2,5,5778
14170,2023-01-15,BARLEY,knockout,Belle's Rock,0,4,6,10,2904
14171,2023-01-15,BARLEY,hotZone,Quarter Pounder,0,47,82,129,3318
14172,2023-01-15,BARLEY,heist,Bridge Too Far,0,1,0,1,2736
14173,2023-01-15,BARLEY,gemGrab,Double Swoosh,0,1,1,2,2178
14174,2023-01-15,BARLEY,brawlBall,Super Beach,0,4,15,19,1074
14175,2023-01-15,BARLEY,brawlBall,Backyard Bowl,0,2,0,2,8946
14176,2023-01-15,BARLEY,bounty,Canal Grande,0,1,1,2,960
14177,2023-01-14,BARLEY,hotZone,Controller Chaos,0,11,0,11,2772
14178,2023-01-14,BARLEY,heist,Bridge Too Far,0,1,0,1,4020
14179,2023-01-14,BARLEY,gemGrab,Deep Diner,0,8,2,10,858
14180,2023-01-14,BARLEY,brawlBall,Super Beach,0,26,63,89,6336
14181,2023-01-14,BARLEY,bounty,Canal Grande,0,3,0,3,1014
14182,2023-01-13,BARLEY,hotZone,Controller Chaos,0,18,37,55,2928
14183,2023-01-13,BARLEY,heist,Hot Potato,0,11,5,16,600
14184,2023-01-13,BARLEY,gemGrab,Deep Diner,0,10,15,25,1650
14185,2023-01-13,BARLEY,brawlBall,Sneaky Fields,0,7,17,24,6144
14186,2023-01-12,BARLEY,knockout,Riverside,0,1,0,1,2532
14187,2023-01-12,BARLEY,hotZone,Open Zone,0,1,0,1,1488
14188,2023-01-12,BARLEY,heist,Hot Potato,0,5,4,9,330
14189,2023-01-11,BARLEY,heist,Safe Zone,0,0,1,1,48
14190,2023-01-11,BARLEY,brawlBall,Sunny Soccer,0,3,7,10,1638
14191,2023-01-10,BARLEY,hotZone,Dueling Beetles,0,10,17,27,2424
14192,2023-01-10,BARLEY,gemGrab,Crystal Arcade,0,1,0,1,1746
14193,2023-01-10,BARLEY,brawlBall,Beach Ball,0,5,8,13,4392
14194,2023-01-09,BARLEY,knockout,New Perspective,0,1,1,2,876
14195,2023-01-09,BARLEY,hotZone,Dueling Beetles,0,5,3,8,1554
14196,2023-01-09,BARLEY,heist,Snaked Assault,0,5,0,5,2022
14197,2023-01-09,BARLEY,gemGrab,Minecart Madness,0,1,2,3,1884
14198,2023-01-09,BARLEY,brawlBall,Center Stage,1,0,0,1,5460
14199,2023-01-09,BARLEY,bounty,Layer Cake,0,2,0,2,1512
14200,2023-01-08,BARLEY,hotZone,Ring of Fire,0,1,0,1,1644
14201,2023-01-08,BARLEY,heist,Snaked Assault,0,2,3,5,1494
14202,2023-01-08,BARLEY,gemGrab,Hard Rock Mine,0,1,0,1,630
14203,2023-01-08,BARLEY,brawlBall,Super Beach,0,9,13,22,732
14204,2023-01-08,BARLEY,brawlBall,Backyard Bowl,0,1,1,2,4830
14205,2023-01-08,BARLEY,bounty,Layer Cake,0,1,0,1,528
14206,2023-01-07,BARLEY,hotZone,Ring of Fire,0,1,0,1,846
14207,2023-01-07,BARLEY,heist,Tornado Ring,0,6,0,6,1350
14208,2023-01-07,BARLEY,gemGrab,Deep Diner,0,12,36,48,918
14209,2023-01-07,BARLEY,brawlBall,Super Beach,1,17,41,59,2622
14210,2023-01-06,BARLEY,hotZone,Split,0,13,21,34,1158
14211,2023-01-06,BARLEY,heist,Tornado Ring,0,6,2,8,2538
14212,2023-01-06,BARLEY,gemGrab,Deep Diner,0,20,58,78,2226
14213,2023-01-06,BARLEY,brawlBall,Sneaky Fields,0,1,0,1,4896
14214,2023-01-06,BARLEY,bounty,Dry Season,0,1,0,1,1944
14215,2023-01-05,BARLEY,hotZone,Split,0,35,37,72,3552
14216,2023-01-05,BARLEY,gemGrab,Undermine,0,1,0,1,1812
14217,2023-01-05,BARLEY,gemGrab,Gem Fort,0,2,0,2,252
14218,2023-01-05,BARLEY,brawlBall,Pinhole Punt,0,1,0,1,8118
14219,2023-01-04,BARLEY,hotZone,Parallel Plays,0,23,35,58,864
14220,2023-01-04,BARLEY,heist,Kaboom Canyon,0,2,0,2,1848
14221,2023-01-04,BARLEY,brawlBall,Sunny Soccer,0,26,54,80,6312
14222,2023-01-03,BARLEY,hotZone,Parallel Plays,2,27,77,106,1542
14223,2023-01-03,BARLEY,heist,Pit Stop,0,26,63,89,1956
14224,2023-01-03,BARLEY,gemGrab,Crystal Arcade,0,1,0,1,2406
14225,2023-01-03,BARLEY,brawlBall,Beach Ball,0,10,6,16,5580
14226,2023-01-03,BARLEY,bounty,Hideout,0,2,0,2,1638
14227,2023-01-02,BARLEY,knockout,Belle's Rock,0,4,0,4,1794
14228,2023-01-02,BARLEY,hotZone,Quarter Pounder,0,47,83,130,2652
14229,2023-01-02,BARLEY,heist,Pit Stop,0,44,60,104,3498
14230,2023-01-02,BARLEY,gemGrab,Minecart Madness,0,1,0,1,2352
14231,2023-01-02,BARLEY,brawlBall,Center Stage,0,1,0,1,7110
14232,2023-01-02,BARLEY,bounty,Hideout,0,2,1,3,3090
14233,2023-01-01,BARLEY,hotZone,Quarter Pounder,0,31,48,79,1188
14234,2023-01-01,BARLEY,gemGrab,Double Swoosh,0,1,0,1,1140
14235,2023-01-01,BARLEY,brawlBall,Backyard Bowl,0,1,0,1,2658
14236,2022-12-31,BARLEY,hotZone,Controller Chaos,0,1,0,1,198
14237,2022-12-31,BARLEY,gemGrab,Minecart Madness,0,0,2,2,24
14238,2022-12-31,BARLEY,gemGrab,Hard Rock Mine,0,1,0,1,384
14239,2022-12-31,BARLEY,gemGrab,Deep Diner,0,1,11,12,306
14240,2022-12-31,BARLEY,brawlBall,Super Beach,0,1,6,7,618
14241,2022-12-30,BARLEY,hotZone,Controller Chaos,0,1,0,1,288
14242,2022-12-30,BARLEY,heist,Hot Potato,0,1,0,1,30
14243,2022-12-30,BARLEY,gemGrab,Minecart Madness,0,1,0,1,24
14244,2022-12-30,BARLEY,gemGrab,Deep Diner,0,3,11,14,438
14245,2022-12-30,BARLEY,brawlBall,Sneaky Fields,0,1,0,1,552
14246,2022-12-29,BARLEY,heist,Hot Potato,0,2,0,2,72
14247,2022-12-25,BARLEY,hotZone,Ring of Fire,0,1,0,1,12
14248,2022-12-24,BARLEY,brawlBall,Super Beach,0,1,0,1,48
14249,2022-12-21,BARLEY,brawlBall,Sunny Soccer,0,2,0,2,54
14250,2022-12-13,BARLEY,brawlBall,Beach Ball,0,1,0,1,54
14251,2022-11-07,BARLEY,hotZone,Quarter Pounder,0,0,1,1,24
14252,2022-11-01,BARLEY,knockout,New Perspective,0,0,1,1,54
14253,2023-01-28,ASH,knockout,Flaring Phoenix,0,11,15,26,12366
14254,2023-01-28,ASH,hotZone,Controller Chaos,0,114,179,293,10134
14255,2023-01-28,ASH,heist,Bridge Too Far,0,6,2,8,24240
14256,2023-01-28,ASH,gemGrab,Hard Rock Mine,0,254,348,602,16638
14257,2023-01-28,ASH,gemGrab,Deep Diner,0,29,47,76,5478
14258,2023-01-28,ASH,brawlBall,Super Beach,19,613,856,1488,74430
14259,2023-01-28,ASH,brawlBall,Sneaky Fields,1,69,98,168,3582
14260,2023-01-28,ASH,bounty,Canal Grande,0,120,193,313,10902
14261,2023-01-27,ASH,knockout,Flaring Phoenix,0,8,2,10,5928
14262,2023-01-27,ASH,hotZone,Controller Chaos,0,39,55,94,2676
14263,2023-01-27,ASH,heist,Hot Potato,1,7,16,24,3486
14264,2023-01-27,ASH,gemGrab,Undermine,0,13,9,22,942
14265,2023-01-27,ASH,gemGrab,Deep Diner,0,22,26,48,6846
14266,2023-01-27,ASH,brawlBall,Sneaky Fields,6,323,388,717,23514
14267,2023-01-27,ASH,brawlBall,Pinhole Punt,0,2,1,3,738
14268,2023-01-27,ASH,bounty,Temple Ruins,0,9,4,13,1890
14269,2023-01-26,ASH,knockout,Riverside,0,1,0,1,19008
14270,2023-01-26,ASH,hotZone,Open Zone,0,9,7,16,10182
14271,2023-01-26,ASH,heist,Hot Potato,0,4,3,7,14610
14272,2023-01-26,ASH,gemGrab,Undermine,0,80,114,194,10062
14273,2023-01-26,ASH,gemGrab,Gem Fort,0,67,123,190,4674
14274,2023-01-26,ASH,brawlBall,Sunny Soccer,0,34,49,83,3660
14275,2023-01-26,ASH,brawlBall,Pinhole Punt,10,331,485,826,67338
14276,2023-01-26,ASH,bounty,Temple Ruins,0,54,81,135,5610
14277,2023-01-25,ASH,knockout,Riverside,0,3,4,7,9906
14278,2023-01-25,ASH,hotZone,Open Zone,0,4,1,5,5262
14279,2023-01-25,ASH,heist,Safe Zone,0,1,1,2,9156
14280,2023-01-25,ASH,gemGrab,Gem Fort,0,70,133,203,5556
14281,2023-01-25,ASH,gemGrab,Crystal Arcade,0,118,198,316,7866
14282,2023-01-25,ASH,brawlBall,Sunny Soccer,6,279,361,646,40830
14283,2023-01-25,ASH,brawlBall,Beach Ball,0,45,66,111,6408
14284,2023-01-25,ASH,bounty,Excel,0,5,4,9,5790
14285,2023-01-24,ASH,knockout,New Perspective,0,6,9,15,10542
14286,2023-01-24,ASH,hotZone,Dueling Beetles,0,38,27,65,10662
14287,2023-01-24,ASH,heist,Safe Zone,0,2,2,4,15750
14288,2023-01-24,ASH,gemGrab,Minecart Madness,0,3,2,5,4002
14289,2023-01-24,ASH,gemGrab,Crystal Arcade,0,197,282,479,14460
14290,2023-01-24,ASH,brawlBall,Center Stage,5,84,106,195,7860
14291,2023-01-24,ASH,brawlBall,Beach Ball,12,389,501,902,64614
14292,2023-01-24,ASH,bounty,Excel,0,13,22,35,10896
14293,2023-01-23,ASH,knockout,New Perspective,0,11,15,26,20676
14294,2023-01-23,ASH,hotZone,Dueling Beetles,0,39,47,86,17502
14295,2023-01-23,ASH,heist,Snaked Assault,0,24,14,38,15762
14296,2023-01-23,ASH,gemGrab,Minecart Madness,0,22,20,42,19062
14297,2023-01-23,ASH,gemGrab,Double Swoosh,0,106,120,226,7578
14298,2023-01-23,ASH,brawlBall,Center Stage,20,835,1223,2078,92862
14299,2023-01-23,ASH,brawlBall,Backyard Bowl,1,2,0,3,4224
14300,2023-01-23,ASH,bounty,Layer Cake,0,34,40,74,11142
14301,2023-01-22,ASH,knockout,X Marks the Spot,0,4,3,7,9174
14302,2023-01-22,ASH,hotZone,Ring of Fire,0,39,72,111,5730
14303,2023-01-22,ASH,heist,Snaked Assault,0,12,10,22,8232
14304,2023-01-22,ASH,gemGrab,Hard Rock Mine,0,86,123,209,4722
14305,2023-01-22,ASH,gemGrab,Double Swoosh,0,120,157,277,9426
14306,2023-01-22,ASH,brawlBall,Super Beach,1,36,55,92,7386
14307,2023-01-22,ASH,brawlBall,Backyard Bowl,0,26,23,49,34788
14308,2023-01-22,ASH,bounty,Layer Cake,0,24,49,73,6654
14309,2023-01-21,ASH,knockout,X Marks the Spot,0,29,36,65,31698
14310,2023-01-21,ASH,hotZone,Ring of Fire,0,94,117,211,16632
14311,2023-01-21,ASH,heist,Tornado Ring,0,18,9,27,11664
14312,2023-01-21,ASH,gemGrab,Hard Rock Mine,0,324,464,788,22980
14313,2023-01-21,ASH,gemGrab,Deep Diner,0,19,46,65,4470
14314,2023-01-21,ASH,brawlBall,Super Beach,30,847,1127,2004,101364
14315,2023-01-21,ASH,brawlBall,Sneaky Fields,0,58,73,131,3750
14316,2023-01-21,ASH,bounty,Dry Season,0,10,3,13,14538
14317,2023-01-20,ASH,knockout,Out in the Open,0,8,5,13,20106
14318,2023-01-20,ASH,hotZone,Split,0,54,86,140,9678
14319,2023-01-20,ASH,heist,Tornado Ring,0,19,21,40,12672
14320,2023-01-20,ASH,gemGrab,Undermine,0,79,141,220,5442
14321,2023-01-20,ASH,gemGrab,Deep Diner,0,81,97,178,19050
14322,2023-01-20,ASH,brawlBall,Sneaky Fields,32,915,1328,2275,74778
14323,2023-01-20,ASH,brawlBall,Pinhole Punt,0,11,25,36,2886
14324,2023-01-20,ASH,bounty,Dry Season,0,4,3,7,11640
14325,2023-01-19,ASH,knockout,Out in the Open,0,9,20,29,26574
14326,2023-01-19,ASH,hotZone,Split,0,113,274,387,14856
14327,2023-01-19,ASH,heist,Kaboom Canyon,0,7,3,10,6732
14328,2023-01-19,ASH,gemGrab,Undermine,0,160,181,341,14154
14329,2023-01-19,ASH,gemGrab,Gem Fort,0,52,104,156,2934
14330,2023-01-19,ASH,brawlBall,Sunny Soccer,1,15,47,63,2274
14331,2023-01-19,ASH,brawlBall,Pinhole Punt,18,356,537,911,72498
14332,2023-01-19,ASH,bounty,Shooting Star,0,5,19,24,11124
14333,2023-01-18,ASH,knockout,Goldarm Gulch,0,1,3,4,2784
14334,2023-01-18,ASH,hotZone,Parallel Plays,0,13,22,35,1158
14335,2023-01-18,ASH,heist,Kaboom Canyon,0,2,0,2,2592
14336,2023-01-18,ASH,gemGrab,Gem Fort,0,29,41,70,3006
14337,2023-01-18,ASH,gemGrab,Crystal Arcade,0,14,28,42,990
14338,2023-01-18,ASH,brawlBall,Sunny Soccer,1,148,188,337,18941
14339,2023-01-18,ASH,brawlBall,Beach Ball,0,3,4,7,774
14340,2023-01-17,ASH,knockout,Goldarm Gulch,0,2,0,2,2520
14341,2023-01-17,ASH,hotZone,Parallel Plays,0,21,26,47,1038
14342,2023-01-17,ASH,heist,Pit Stop,0,2,0,2,1290
14343,2023-01-17,ASH,gemGrab,Minecart Madness,0,0,2,2,216
14344,2023-01-17,ASH,gemGrab,Crystal Arcade,0,22,25,47,1266
14345,2023-01-17,ASH,brawlBall,Center Stage,1,3,6,10,288
14346,2023-01-17,ASH,brawlBall,Beach Ball,2,23,31,56,5886
14347,2023-01-16,ASH,knockout,Belle's Rock,0,1,0,1,1788
14348,2023-01-16,ASH,hotZone,Quarter Pounder,0,11,11,22,1494
14349,2023-01-16,ASH,heist,Pit Stop,0,2,1,3,4044
14350,2023-01-16,ASH,gemGrab,Minecart Madness,0,1,1,2,1422
14351,2023-01-16,ASH,gemGrab,Double Swoosh,0,8,12,20,708
14352,2023-01-16,ASH,brawlBall,Center Stage,0,57,62,119,5778
14353,2023-01-16,ASH,brawlBall,Backyard Bowl,0,1,2,3,852
14354,2023-01-16,ASH,bounty,Hideout,0,2,1,3,1470
14355,2023-01-15,ASH,hotZone,Quarter Pounder,0,18,14,32,3318
14356,2023-01-15,ASH,heist,Bridge Too Far,0,2,0,2,2736
14357,2023-01-15,ASH,gemGrab,Hard Rock Mine,0,17,18,35,1014
14358,2023-01-15,ASH,gemGrab,Double Swoosh,0,20,10,30,2178
14359,2023-01-15,ASH,brawlBall,Super Beach,2,12,31,45,1074
14360,2023-01-15,ASH,brawlBall,Backyard Bowl,0,10,11,21,8946
14361,2023-01-15,ASH,bounty,Canal Grande,0,12,40,52,960
14362,2023-01-14,ASH,knockout,Flaring Phoenix,0,3,10,13,1080
14363,2023-01-14,ASH,hotZone,Controller Chaos,0,36,68,104,2772
14364,2023-01-14,ASH,heist,Bridge Too Far,0,1,0,1,4020
14365,2023-01-14,ASH,gemGrab,Hard Rock Mine,0,25,30,55,1272
14366,2023-01-14,ASH,gemGrab,Deep Diner,0,8,3,11,858
14367,2023-01-14,ASH,brawlBall,Super Beach,0,68,98,166,6336
14368,2023-01-14,ASH,brawlBall,Sneaky Fields,1,16,18,35,918
14369,2023-01-14,ASH,bounty,Canal Grande,0,7,12,19,1014
14370,2023-01-13,ASH,knockout,Flaring Phoenix,0,2,0,2,1182
14371,2023-01-13,ASH,hotZone,Controller Chaos,0,33,58,91,2928
14372,2023-01-13,ASH,gemGrab,Deep Diner,0,11,7,18,1650
14373,2023-01-13,ASH,brawlBall,Sneaky Fields,1,110,184,295,6144
14374,2023-01-13,ASH,brawlBall,Pinhole Punt,0,2,1,3,156
14375,2023-01-13,ASH,bounty,Temple Ruins,0,1,1,2,270
14376,2023-01-12,ASH,hotZone,Open Zone,0,0,1,1,1488
14377,2023-01-12,ASH,gemGrab,Undermine,0,14,22,36,690
14378,2023-01-12,ASH,gemGrab,Gem Fort,0,5,7,12,162
14379,2023-01-12,ASH,brawlBall,Sunny Soccer,0,3,2,5,240
14380,2023-01-12,ASH,brawlBall,Pinhole Punt,2,16,26,44,2292
14381,2023-01-11,ASH,gemGrab,Gem Fort,0,6,14,20,414
14382,2023-01-11,ASH,brawlBall,Sunny Soccer,1,13,9,23,1638
14383,2023-01-11,ASH,brawlBall,Beach Ball,0,0,2,2,48
14384,2023-01-10,ASH,hotZone,Dueling Beetles,0,10,5,15,2424
14385,2023-01-10,ASH,gemGrab,Minecart Madness,0,3,0,3,828
14386,2023-01-10,ASH,gemGrab,Crystal Arcade,0,21,54,75,1746
14387,2023-01-10,ASH,brawlBall,Center Stage,0,11,15,26,708
14388,2023-01-10,ASH,brawlBall,Beach Ball,1,24,82,107,4392
14389,2023-01-09,ASH,hotZone,Dueling Beetles,0,8,1,9,1554
14390,2023-01-09,ASH,heist,Snaked Assault,0,5,1,6,2022
14391,2023-01-09,ASH,gemGrab,Minecart Madness,0,5,19,24,1884
14392,2023-01-09,ASH,gemGrab,Double Swoosh,0,31,60,91,1320
14393,2023-01-09,ASH,brawlBall,Center Stage,3,35,77,115,5460
14394,2023-01-09,ASH,bounty,Layer Cake,0,3,18,21,1512
14395,2023-01-08,ASH,knockout,X Marks the Spot,0,0,4,4,1692
14396,2023-01-08,ASH,hotZone,Ring of Fire,0,8,5,13,1644
14397,2023-01-08,ASH,heist,Snaked Assault,0,1,0,1,1494
14398,2023-01-08,ASH,gemGrab,Hard Rock Mine,0,6,4,10,630
14399,2023-01-08,ASH,gemGrab,Double Swoosh,0,7,1,8,864
14400,2023-01-08,ASH,brawlBall,Super Beach,1,4,2,7,732
14401,2023-01-08,ASH,brawlBall,Backyard Bowl,1,7,5,13,4830
14402,2023-01-08,ASH,bounty,Layer Cake,0,3,6,9,528
14403,2023-01-07,ASH,hotZone,Ring of Fire,0,2,0,2,846
14404,2023-01-07,ASH,heist,Tornado Ring,0,1,0,1,1350
14405,2023-01-07,ASH,gemGrab,Hard Rock Mine,0,13,25,38,1158
14406,2023-01-07,ASH,gemGrab,Deep Diner,0,4,1,5,918
14407,2023-01-07,ASH,brawlBall,Super Beach,1,14,34,49,2622
14408,2023-01-07,ASH,brawlBall,Sneaky Fields,1,14,32,47,402
14409,2023-01-06,ASH,hotZone,Split,0,10,8,18,1158
14410,2023-01-06,ASH,heist,Tornado Ring,0,2,5,7,2538
14411,2023-01-06,ASH,gemGrab,Undermine,0,6,3,9,540
14412,2023-01-06,ASH,gemGrab,Deep Diner,0,8,15,23,2226
14413,2023-01-06,ASH,brawlBall,Sneaky Fields,3,96,147,246,4896
14414,2023-01-06,ASH,bounty,Dry Season,0,0,3,3,1944
14415,2023-01-05,ASH,knockout,Out in the Open,0,1,0,1,2958
14416,2023-01-05,ASH,hotZone,Split,1,19,41,61,3552
14417,2023-01-05,ASH,gemGrab,Undermine,0,22,28,50,1812
14418,2023-01-05,ASH,gemGrab,Gem Fort,0,4,1,5,252
14419,2023-01-05,ASH,brawlBall,Sunny Soccer,0,0,1,1,84
14420,2023-01-05,ASH,brawlBall,Pinhole Punt,3,65,66,134,8118
14421,2023-01-04,ASH,knockout,Goldarm Gulch,0,1,0,1,696
14422,2023-01-04,ASH,hotZone,Parallel Plays,0,12,8,20,864
14423,2023-01-04,ASH,heist,Kaboom Canyon,0,2,1,3,1848
14424,2023-01-04,ASH,gemGrab,Gem Fort,0,28,41,69,1788
14425,2023-01-04,ASH,gemGrab,Crystal Arcade,0,12,38,50,642
14426,2023-01-04,ASH,brawlBall,Sunny Soccer,1,45,55,101,6312
14427,2023-01-04,ASH,bounty,Shooting Star,0,2,1,3,3570
14428,2023-01-03,ASH,knockout,Goldarm Gulch,0,0,1,1,720
14429,2023-01-03,ASH,hotZone,Parallel Plays,0,14,6,20,1542
14430,2023-01-03,ASH,heist,Pit Stop,0,2,1,3,1956
14431,2023-01-03,ASH,gemGrab,Crystal Arcade,0,19,28,47,2406
14432,2023-01-03,ASH,brawlBall,Center Stage,0,1,0,1,294
14433,2023-01-03,ASH,brawlBall,Beach Ball,0,22,16,38,5580
14434,2023-01-03,ASH,bounty,Hideout,0,1,0,1,1638
14435,2023-01-02,ASH,knockout,Belle's Rock,0,0,5,5,1794
14436,2023-01-02,ASH,hotZone,Quarter Pounder,0,10,4,14,2652
14437,2023-01-02,ASH,heist,Pit Stop,0,0,1,1,3498
14438,2023-01-02,ASH,gemGrab,Minecart Madness,0,3,0,3,2352
14439,2023-01-02,ASH,gemGrab,Double Swoosh,0,7,12,19,1512
14440,2023-01-02,ASH,brawlBall,Center Stage,1,60,82,143,7110
14441,2023-01-02,ASH,bounty,Hideout,0,1,1,2,3090
14442,2023-01-01,ASH,hotZone,Quarter Pounder,0,2,0,2,1188
14443,2023-01-01,ASH,gemGrab,Hard Rock Mine,0,4,4,8,48
14444,2023-01-01,ASH,gemGrab,Double Swoosh,0,13,20,33,1140
14445,2023-01-01,ASH,brawlBall,Backyard Bowl,0,0,1,1,2658
14446,2022-12-31,ASH,hotZone,Controller Chaos,0,1,0,1,198
14447,2022-12-31,ASH,gemGrab,Hard Rock Mine,0,2,0,2,384
14448,2022-12-31,ASH,gemGrab,Deep Diner,0,1,0,1,306
14449,2022-12-31,ASH,brawlBall,Super Beach,0,4,4,8,618
14450,2022-12-31,ASH,brawlBall,Sneaky Fields,0,1,1,2,60
14451,2022-12-30,ASH,hotZone,Controller Chaos,0,4,3,7,288
14452,2022-12-30,ASH,gemGrab,Undermine,0,1,1,2,102
14453,2022-12-30,ASH,gemGrab,Minecart Madness,0,1,0,1,24
14454,2022-12-30,ASH,gemGrab,Deep Diner,0,1,0,1,438
14455,2022-12-30,ASH,brawlBall,Sneaky Fields,0,4,5,9,552
14456,2022-12-29,ASH,heist,Kaboom Canyon,0,1,0,1,18
14457,2022-12-29,ASH,gemGrab,Undermine,0,0,1,1,102
14458,2022-12-29,ASH,brawlBall,Pinhole Punt,0,2,4,6,282
14459,2022-12-24,ASH,brawlBall,Super Beach,0,1,0,1,48
14460,2022-12-22,ASH,gemGrab,Gem Fort,0,0,1,1,90
14461,2022-12-21,ASH,brawlBall,Sunny Soccer,0,1,0,1,54
14462,2022-12-19,ASH,brawlBall,Center Stage,0,3,2,5,102
14463,2022-12-16,ASH,brawlBall,Sneaky Fields,0,2,5,7,84
14464,2022-12-13,ASH,gemGrab,Crystal Arcade,0,0,1,1,72
14465,2022-12-10,ASH,gemGrab,Hard Rock Mine,0,1,0,1,24
14466,2022-11-01,ASH,knockout,New Perspective,0,1,0,1,54
14467,2023-01-28,AMBER,knockout,Flaring Phoenix,0,9,8,17,12366
14468,2023-01-28,AMBER,hotZone,Controller Chaos,0,54,90,144,10134
14469,2023-01-28,AMBER,heist,Bridge Too Far,0,129,128,257,24240
14470,2023-01-28,AMBER,gemGrab,Hard Rock Mine,0,19,11,30,16638
14471,2023-01-28,AMBER,gemGrab,Deep Diner,0,5,5,10,5478
14472,2023-01-28,AMBER,brawlBall,Super Beach,6,106,127,239,74430
14473,2023-01-28,AMBER,brawlBall,Sneaky Fields,0,4,1,5,3582
14474,2023-01-28,AMBER,bounty,Canal Grande,0,5,8,13,10902
14475,2023-01-27,AMBER,knockout,Flaring Phoenix,0,6,3,9,5928
14476,2023-01-27,AMBER,hotZone,Controller Chaos,0,16,16,32,2676
14477,2023-01-27,AMBER,heist,Hot Potato,0,12,10,22,3486
14478,2023-01-27,AMBER,gemGrab,Undermine,0,8,10,18,942
14479,2023-01-27,AMBER,gemGrab,Deep Diner,0,20,21,41,6846
14480,2023-01-27,AMBER,brawlBall,Sneaky Fields,2,41,62,105,23514
14481,2023-01-27,AMBER,brawlBall,Pinhole Punt,0,1,3,4,738
14482,2023-01-27,AMBER,bounty,Temple Ruins,0,8,26,34,1890
14483,2023-01-26,AMBER,knockout,Riverside,0,24,13,37,19008
14484,2023-01-26,AMBER,hotZone,Open Zone,0,119,222,341,10182
14485,2023-01-26,AMBER,heist,Hot Potato,0,33,31,64,14610
14486,2023-01-26,AMBER,gemGrab,Undermine,0,55,78,133,10062
14487,2023-01-26,AMBER,gemGrab,Gem Fort,0,8,8,16,4674
14488,2023-01-26,AMBER,brawlBall,Sunny Soccer,0,6,3,9,3660
14489,2023-01-26,AMBER,brawlBall,Pinhole Punt,6,187,251,444,67338
14490,2023-01-26,AMBER,bounty,Temple Ruins,0,23,39,62,5610
14491,2023-01-25,AMBER,knockout,Riverside,0,14,7,21,9906
14492,2023-01-25,AMBER,hotZone,Open Zone,0,69,80,149,5262
14493,2023-01-25,AMBER,heist,Safe Zone,0,23,22,45,9156
14494,2023-01-25,AMBER,gemGrab,Gem Fort,0,28,39,67,5556
14495,2023-01-25,AMBER,gemGrab,Crystal Arcade,0,15,13,28,7866
14496,2023-01-25,AMBER,brawlBall,Sunny Soccer,4,71,86,161,40830
14497,2023-01-25,AMBER,brawlBall,Beach Ball,0,15,9,24,6408
14498,2023-01-25,AMBER,bounty,Excel,0,5,0,5,5790
14499,2023-01-24,AMBER,knockout,New Perspective,0,20,18,38,10542
14500,2023-01-24,AMBER,hotZone,Dueling Beetles,0,54,61,115,10662
14501,2023-01-24,AMBER,heist,Safe Zone,1,67,55,123,15750
14502,2023-01-24,AMBER,gemGrab,Minecart Madness,0,17,16,33,4002
14503,2023-01-24,AMBER,gemGrab,Crystal Arcade,0,55,55,110,14460
14504,2023-01-24,AMBER,brawlBall,Center Stage,1,15,22,38,7860
14505,2023-01-24,AMBER,brawlBall,Beach Ball,5,116,112,233,64614
14506,2023-01-24,AMBER,bounty,Excel,0,11,8,19,10896
14507,2023-01-23,AMBER,knockout,New Perspective,0,40,26,66,20676
14508,2023-01-23,AMBER,hotZone,Dueling Beetles,0,91,112,203,17502
14509,2023-01-23,AMBER,heist,Snaked Assault,1,106,85,192,15762
14510,2023-01-23,AMBER,gemGrab,Minecart Madness,0,89,108,197,19062
14511,2023-01-23,AMBER,gemGrab,Double Swoosh,0,82,142,224,7578
14512,2023-01-23,AMBER,brawlBall,Center Stage,9,181,182,372,92862
14513,2023-01-23,AMBER,brawlBall,Backyard Bowl,0,8,38,46,4224
14514,2023-01-23,AMBER,bounty,Layer Cake,0,13,5,18,11142
14515,2023-01-22,AMBER,knockout,X Marks the Spot,0,8,3,11,9174
14516,2023-01-22,AMBER,hotZone,Ring of Fire,0,58,89,147,5730
14517,2023-01-22,AMBER,heist,Snaked Assault,0,48,39,87,8232
14518,2023-01-22,AMBER,gemGrab,Hard Rock Mine,0,11,9,20,4722
14519,2023-01-22,AMBER,gemGrab,Double Swoosh,0,83,133,216,9426
14520,2023-01-22,AMBER,brawlBall,Super Beach,0,13,7,20,7386
14521,2023-01-22,AMBER,brawlBall,Backyard Bowl,6,104,128,238,34788
14522,2023-01-22,AMBER,bounty,Layer Cake,0,7,6,13,6654
14523,2023-01-21,AMBER,knockout,X Marks the Spot,0,34,21,55,31698
14524,2023-01-21,AMBER,hotZone,Ring of Fire,0,137,210,347,16632
14525,2023-01-21,AMBER,heist,Tornado Ring,1,32,20,53,11664
14526,2023-01-21,AMBER,gemGrab,Hard Rock Mine,0,56,39,95,22980
14527,2023-01-21,AMBER,gemGrab,Deep Diner,0,24,13,37,4470
14528,2023-01-21,AMBER,brawlBall,Super Beach,7,110,118,235,101364
14529,2023-01-21,AMBER,brawlBall,Sneaky Fields,0,2,0,2,3750
14530,2023-01-21,AMBER,bounty,Dry Season,0,18,12,30,14538
14531,2023-01-20,AMBER,knockout,Out in the Open,0,35,21,56,20106
14532,2023-01-20,AMBER,hotZone,Split,0,20,9,29,9678
14533,2023-01-20,AMBER,heist,Tornado Ring,0,34,35,69,12672
14534,2023-01-20,AMBER,gemGrab,Undermine,0,24,51,75,5442
14535,2023-01-20,AMBER,gemGrab,Deep Diner,0,55,37,92,19050
14536,2023-01-20,AMBER,brawlBall,Sneaky Fields,3,111,101,215,74778
14537,2023-01-20,AMBER,brawlBall,Pinhole Punt,1,3,4,8,2886
14538,2023-01-20,AMBER,bounty,Dry Season,0,6,10,16,11640
14539,2023-01-19,AMBER,knockout,Out in the Open,0,33,19,52,26574
14540,2023-01-19,AMBER,hotZone,Split,0,19,13,32,14856
14541,2023-01-19,AMBER,heist,Kaboom Canyon,0,39,73,112,6732
14542,2023-01-19,AMBER,gemGrab,Undermine,0,94,134,228,14154
14543,2023-01-19,AMBER,gemGrab,Gem Fort,0,8,21,29,2934
14544,2023-01-19,AMBER,brawlBall,Sunny Soccer,1,3,3,7,2274
14545,2023-01-19,AMBER,brawlBall,Pinhole Punt,8,203,255,466,72498
14546,2023-01-19,AMBER,bounty,Shooting Star,0,15,7,22,11124
14547,2023-01-18,AMBER,knockout,Goldarm Gulch,0,3,2,5,2784
14548,2023-01-18,AMBER,hotZone,Parallel Plays,0,5,10,15,1158
14549,2023-01-18,AMBER,heist,Kaboom Canyon,0,26,41,67,2592
14550,2023-01-18,AMBER,gemGrab,Gem Fort,0,14,14,28,3006
14551,2023-01-18,AMBER,gemGrab,Crystal Arcade,0,3,3,6,990
14552,2023-01-18,AMBER,brawlBall,Sunny Soccer,2,35,31,68,18941
14553,2023-01-18,AMBER,brawlBall,Beach Ball,0,1,0,1,774
14554,2023-01-18,AMBER,bounty,Shooting Star,0,6,8,14,5088
14555,2023-01-17,AMBER,knockout,Goldarm Gulch,0,3,5,8,2520
14556,2023-01-17,AMBER,hotZone,Parallel Plays,0,5,6,11,1038
14557,2023-01-17,AMBER,heist,Pit Stop,0,1,1,2,1290
14558,2023-01-17,AMBER,gemGrab,Crystal Arcade,0,4,3,7,1266
14559,2023-01-17,AMBER,brawlBall,Center Stage,0,0,1,1,288
14560,2023-01-17,AMBER,brawlBall,Beach Ball,1,13,11,25,5886
14561,2023-01-17,AMBER,bounty,Hideout,0,1,0,1,750
14562,2023-01-16,AMBER,knockout,Belle's Rock,0,1,1,2,1788
14563,2023-01-16,AMBER,hotZone,Quarter Pounder,0,12,12,24,1494
14564,2023-01-16,AMBER,heist,Pit Stop,0,0,2,2,4044
14565,2023-01-16,AMBER,gemGrab,Minecart Madness,0,2,2,4,1422
14566,2023-01-16,AMBER,gemGrab,Double Swoosh,0,10,18,28,708
14567,2023-01-16,AMBER,brawlBall,Center Stage,0,5,6,11,5778
14568,2023-01-16,AMBER,brawlBall,Backyard Bowl,0,2,2,4,852
14569,2023-01-15,AMBER,knockout,Belle's Rock,0,2,1,3,2904
14570,2023-01-15,AMBER,hotZone,Quarter Pounder,0,12,6,18,3318
14571,2023-01-15,AMBER,heist,Bridge Too Far,0,18,42,60,2736
14572,2023-01-15,AMBER,gemGrab,Hard Rock Mine,0,0,2,2,1014
14573,2023-01-15,AMBER,gemGrab,Double Swoosh,0,20,38,58,2178
14574,2023-01-15,AMBER,brawlBall,Super Beach,0,1,1,2,1074
14575,2023-01-15,AMBER,brawlBall,Backyard Bowl,1,29,29,59,8946
14576,2023-01-14,AMBER,hotZone,Controller Chaos,0,17,27,44,2772
14577,2023-01-14,AMBER,heist,Bridge Too Far,0,27,29,56,4020
14578,2023-01-14,AMBER,gemGrab,Hard Rock Mine,0,1,1,2,1272
14579,2023-01-14,AMBER,gemGrab,Deep Diner,0,1,2,3,858
14580,2023-01-14,AMBER,brawlBall,Super Beach,0,10,2,12,6336
14581,2023-01-14,AMBER,bounty,Canal Grande,0,1,0,1,1014
14582,2023-01-13,AMBER,knockout,Flaring Phoenix,0,2,1,3,1182
14583,2023-01-13,AMBER,hotZone,Controller Chaos,0,19,12,31,2928
14584,2023-01-13,AMBER,heist,Hot Potato,0,2,0,2,600
14585,2023-01-13,AMBER,gemGrab,Deep Diner,0,5,1,6,1650
14586,2023-01-13,AMBER,brawlBall,Sneaky Fields,0,5,7,12,6144
14587,2023-01-13,AMBER,brawlBall,Pinhole Punt,0,2,5,7,156
14588,2023-01-13,AMBER,bounty,Temple Ruins,0,4,2,6,270
14589,2023-01-12,AMBER,knockout,Riverside,0,16,23,39,2532
14590,2023-01-12,AMBER,hotZone,Open Zone,0,15,36,51,1488
14591,2023-01-12,AMBER,heist,Hot Potato,0,2,0,2,330
14592,2023-01-12,AMBER,gemGrab,Undermine,0,11,15,26,690
14593,2023-01-12,AMBER,gemGrab,Gem Fort,0,0,4,4,162
14594,2023-01-12,AMBER,brawlBall,Pinhole Punt,0,6,6,12,2292
14595,2023-01-11,AMBER,knockout,Riverside,0,2,0,2,528
14596,2023-01-11,AMBER,hotZone,Open Zone,0,8,14,22,462
14597,2023-01-11,AMBER,gemGrab,Gem Fort,0,3,1,4,414
14598,2023-01-11,AMBER,brawlBall,Sunny Soccer,0,1,0,1,1638
14599,2023-01-10,AMBER,hotZone,Dueling Beetles,0,9,9,18,2424
14600,2023-01-10,AMBER,heist,Safe Zone,0,2,1,3,1176
14601,2023-01-10,AMBER,gemGrab,Minecart Madness,0,4,6,10,828
14602,2023-01-10,AMBER,gemGrab,Crystal Arcade,0,4,0,4,1746
14603,2023-01-10,AMBER,brawlBall,Center Stage,1,2,2,5,708
14604,2023-01-10,AMBER,brawlBall,Beach Ball,0,2,6,8,4392
14605,2023-01-09,AMBER,knockout,New Perspective,0,0,1,1,876
14606,2023-01-09,AMBER,hotZone,Dueling Beetles,0,12,7,19,1554
14607,2023-01-09,AMBER,heist,Snaked Assault,0,6,6,12,2022
14608,2023-01-09,AMBER,gemGrab,Minecart Madness,0,5,3,8,1884
14609,2023-01-09,AMBER,gemGrab,Double Swoosh,0,12,35,47,1320
14610,2023-01-09,AMBER,brawlBall,Center Stage,0,16,30,46,5460
14611,2023-01-09,AMBER,brawlBall,Backyard Bowl,0,2,0,2,474
14612,2023-01-09,AMBER,bounty,Layer Cake,0,2,0,2,1512
14613,2023-01-08,AMBER,hotZone,Ring of Fire,0,17,20,37,1644
14614,2023-01-08,AMBER,heist,Snaked Assault,0,10,6,16,1494
14615,2023-01-08,AMBER,gemGrab,Double Swoosh,0,4,6,10,864
14616,2023-01-08,AMBER,brawlBall,Backyard Bowl,1,25,62,88,4830
14617,2023-01-08,AMBER,bounty,Layer Cake,0,1,13,14,528
14618,2023-01-07,AMBER,knockout,X Marks the Spot,0,2,0,2,1014
14619,2023-01-07,AMBER,hotZone,Ring of Fire,0,0,2,2,846
14620,2023-01-07,AMBER,heist,Tornado Ring,0,3,0,3,1350
14621,2023-01-07,AMBER,gemGrab,Hard Rock Mine,0,1,1,2,1158
14622,2023-01-07,AMBER,brawlBall,Super Beach,0,0,2,2,2622
14623,2023-01-07,AMBER,bounty,Dry Season,0,0,10,10,1320
14624,2023-01-06,AMBER,knockout,Out in the Open,0,1,0,1,1446
14625,2023-01-06,AMBER,hotZone,Split,0,1,8,9,1158
14626,2023-01-06,AMBER,heist,Tornado Ring,0,2,1,3,2538
14627,2023-01-06,AMBER,gemGrab,Undermine,0,4,12,16,540
14628,2023-01-06,AMBER,gemGrab,Deep Diner,0,4,1,5,2226
14629,2023-01-06,AMBER,brawlBall,Sneaky Fields,0,5,8,13,4896
14630,2023-01-06,AMBER,brawlBall,Pinhole Punt,0,1,0,1,510
14631,2023-01-05,AMBER,knockout,Out in the Open,0,1,2,3,2958
14632,2023-01-05,AMBER,hotZone,Split,0,4,16,20,3552
14633,2023-01-05,AMBER,heist,Kaboom Canyon,0,10,29,39,954
14634,2023-01-05,AMBER,gemGrab,Undermine,0,16,23,39,1812
14635,2023-01-05,AMBER,brawlBall,Pinhole Punt,0,6,37,43,8118
14636,2023-01-05,AMBER,bounty,Shooting Star,0,2,0,2,1362
14637,2023-01-04,AMBER,hotZone,Parallel Plays,0,6,8,14,864
14638,2023-01-04,AMBER,heist,Kaboom Canyon,0,24,18,42,1848
14639,2023-01-04,AMBER,gemGrab,Gem Fort,0,6,4,10,1788
14640,2023-01-04,AMBER,brawlBall,Sunny Soccer,0,4,4,8,6312
14641,2023-01-04,AMBER,bounty,Shooting Star,0,2,0,2,3570
14642,2023-01-03,AMBER,hotZone,Parallel Plays,0,5,10,15,1542
14643,2023-01-03,AMBER,heist,Pit Stop,0,2,0,2,1956
14644,2023-01-03,AMBER,gemGrab,Minecart Madness,0,2,0,2,456
14645,2023-01-03,AMBER,gemGrab,Crystal Arcade,0,3,2,5,2406
14646,2023-01-03,AMBER,brawlBall,Center Stage,0,1,0,1,294
14647,2023-01-03,AMBER,brawlBall,Beach Ball,0,13,10,23,5580
14648,2023-01-03,AMBER,bounty,Hideout,0,0,1,1,1638
14649,2023-01-02,AMBER,knockout,Belle's Rock,0,2,1,3,1794
14650,2023-01-02,AMBER,hotZone,Quarter Pounder,1,12,2,15,2652
14651,2023-01-02,AMBER,hotZone,Controller Chaos,0,1,0,1,18
14652,2023-01-02,AMBER,heist,Pit Stop,0,1,0,1,3498
14653,2023-01-02,AMBER,gemGrab,Minecart Madness,0,11,1,12,2352
14654,2023-01-02,AMBER,gemGrab,Double Swoosh,0,22,39,61,1512
14655,2023-01-02,AMBER,brawlBall,Center Stage,0,16,23,39,7110
14656,2023-01-02,AMBER,bounty,Hideout,0,2,0,2,3090
14657,2023-01-01,AMBER,knockout,Belle's Rock,0,0,1,1,858
14658,2023-01-01,AMBER,hotZone,Quarter Pounder,0,4,11,15,1188
14659,2023-01-01,AMBER,heist,Bridge Too Far,0,5,5,10,462
14660,2023-01-01,AMBER,gemGrab,Double Swoosh,0,16,17,33,1140
14661,2023-01-01,AMBER,brawlBall,Backyard Bowl,0,11,9,20,2658
14662,2022-12-31,AMBER,hotZone,Controller Chaos,0,1,0,1,198
14663,2022-12-31,AMBER,heist,Bridge Too Far,0,2,1,3,276
14664,2022-12-31,AMBER,gemGrab,Hard Rock Mine,0,2,0,2,384
14665,2022-12-31,AMBER,gemGrab,Deep Diner,0,4,10,14,306
14666,2022-12-30,AMBER,hotZone,Controller Chaos,0,1,0,1,288
14667,2022-12-30,AMBER,brawlBall,Sneaky Fields,0,2,0,2,552
14668,2022-12-29,AMBER,hotZone,Open Zone,0,0,2,2,54
14669,2022-12-29,AMBER,gemGrab,Undermine,0,6,13,19,102
14670,2022-12-29,AMBER,gemGrab,Gem Fort,0,1,0,1,30
14671,2022-12-29,AMBER,brawlBall,Pinhole Punt,0,1,1,2,282
14672,2022-12-28,AMBER,hotZone,Open Zone,0,2,3,5,108
14673,2022-12-27,AMBER,hotZone,Controller Chaos,0,1,0,1,24
14674,2022-12-27,AMBER,brawlBall,Beach Ball,0,1,0,1,144
14675,2022-12-26,AMBER,gemGrab,Minecart Madness,0,0,1,1,60
14676,2022-12-25,AMBER,hotZone,Ring of Fire,0,1,0,1,12
14677,2022-12-25,AMBER,brawlBall,Backyard Bowl,0,3,2,5,78
14678,2022-12-24,AMBER,brawlBall,Super Beach,0,2,1,3,48
14679,2022-12-18,AMBER,heist,Bridge Too Far,0,0,1,1,12
14680,2022-12-16,AMBER,brawlBall,Sneaky Fields,0,1,0,1,84
14681,2022-12-10,AMBER,hotZone,Ring of Fire,0,0,1,1,6
14682,2023-01-28,8-BIT,knockout,Flaring Phoenix,1,38,60,99,12366
14683,2023-01-28,8-BIT,hotZone,Controller Chaos,0,7,3,10,10134
14684,2023-01-28,8-BIT,heist,Bridge Too Far,4,564,701,1269,24240
14685,2023-01-28,8-BIT,gemGrab,Hard Rock Mine,0,163,268,431,16638
14686,2023-01-28,8-BIT,gemGrab,Deep Diner,0,26,30,56,5478
14687,2023-01-28,8-BIT,brawlBall,Super Beach,2,35,43,80,74430
14688,2023-01-28,8-BIT,brawlBall,Sneaky Fields,0,0,4,4,3582
14689,2023-01-28,8-BIT,bounty,Canal Grande,0,8,3,11,10902
14690,2023-01-27,8-BIT,knockout,Flaring Phoenix,0,22,27,49,5928
14691,2023-01-27,8-BIT,hotZone,Controller Chaos,0,3,1,4,2676
14692,2023-01-27,8-BIT,heist,Hot Potato,0,20,9,29,3486
14693,2023-01-27,8-BIT,gemGrab,Undermine,0,6,20,26,942
14694,2023-01-27,8-BIT,gemGrab,Deep Diner,0,20,39,59,6846
14695,2023-01-27,8-BIT,brawlBall,Sneaky Fields,1,16,18,35,23514
14696,2023-01-27,8-BIT,brawlBall,Pinhole Punt,0,2,0,2,738
14697,2023-01-27,8-BIT,bounty,Temple Ruins,0,9,14,23,1890
14698,2023-01-26,8-BIT,knockout,Riverside,0,56,52,108,19008
14699,2023-01-26,8-BIT,hotZone,Open Zone,0,32,30,62,10182
14700,2023-01-26,8-BIT,heist,Hot Potato,0,67,62,129,14610
14701,2023-01-26,8-BIT,gemGrab,Undermine,0,48,57,105,10062
14702,2023-01-26,8-BIT,gemGrab,Gem Fort,0,22,27,49,4674
14703,2023-01-26,8-BIT,brawlBall,Sunny Soccer,0,2,2,4,3660
14704,2023-01-26,8-BIT,brawlBall,Pinhole Punt,7,104,168,279,67338
14705,2023-01-26,8-BIT,bounty,Temple Ruins,0,12,5,17,5610
14706,2023-01-25,8-BIT,knockout,Riverside,0,20,27,47,9906
14707,2023-01-25,8-BIT,hotZone,Open Zone,0,34,30,64,5262
14708,2023-01-25,8-BIT,heist,Safe Zone,0,102,131,233,9156
14709,2023-01-25,8-BIT,gemGrab,Gem Fort,0,16,18,34,5556
14710,2023-01-25,8-BIT,gemGrab,Crystal Arcade,0,27,47,74,7866
14711,2023-01-25,8-BIT,brawlBall,Sunny Soccer,0,15,33,48,40830
14712,2023-01-25,8-BIT,brawlBall,Beach Ball,0,4,3,7,6408
14713,2023-01-25,8-BIT,bounty,Excel,0,5,5,10,5790
14714,2023-01-24,8-BIT,knockout,New Perspective,0,17,12,29,10542
14715,2023-01-24,8-BIT,hotZone,Dueling Beetles,0,17,7,24,10662
14716,2023-01-24,8-BIT,heist,Safe Zone,3,172,253,428,15750
14717,2023-01-24,8-BIT,gemGrab,Minecart Madness,0,20,14,34,4002
14718,2023-01-24,8-BIT,gemGrab,Crystal Arcade,0,52,102,154,14460
14719,2023-01-24,8-BIT,brawlBall,Center Stage,1,2,3,6,7860
14720,2023-01-24,8-BIT,brawlBall,Beach Ball,1,54,43,98,64614
14721,2023-01-24,8-BIT,bounty,Excel,0,8,12,20,10896
14722,2023-01-23,8-BIT,knockout,New Perspective,0,40,60,100,20676
14723,2023-01-23,8-BIT,hotZone,Dueling Beetles,0,15,9,24,17502
14724,2023-01-23,8-BIT,heist,Snaked Assault,0,119,113,232,15762
14725,2023-01-23,8-BIT,gemGrab,Minecart Madness,0,121,151,272,19062
14726,2023-01-23,8-BIT,gemGrab,Double Swoosh,0,14,13,27,7578
14727,2023-01-23,8-BIT,brawlBall,Center Stage,3,69,57,129,92862
14728,2023-01-23,8-BIT,brawlBall,Backyard Bowl,0,10,7,17,4224
14729,2023-01-23,8-BIT,bounty,Layer Cake,0,6,4,10,11142
14730,2023-01-22,8-BIT,knockout,X Marks the Spot,0,47,78,125,9174
14731,2023-01-22,8-BIT,hotZone,Ring of Fire,0,13,8,21,5730
14732,2023-01-22,8-BIT,heist,Snaked Assault,0,53,93,146,8232
14733,2023-01-22,8-BIT,gemGrab,Hard Rock Mine,0,28,63,91,4722
14734,2023-01-22,8-BIT,gemGrab,Double Swoosh,0,19,10,29,9426
14735,2023-01-22,8-BIT,brawlBall,Super Beach,0,2,2,4,7386
14736,2023-01-22,8-BIT,brawlBall,Backyard Bowl,7,121,133,261,34788
14737,2023-01-22,8-BIT,bounty,Layer Cake,0,3,7,10,6654
14738,2023-01-21,8-BIT,knockout,X Marks the Spot,3,164,253,420,31698
14739,2023-01-21,8-BIT,hotZone,Ring of Fire,0,53,40,93,16632
14740,2023-01-21,8-BIT,heist,Tornado Ring,0,43,28,71,11664
14741,2023-01-21,8-BIT,gemGrab,Hard Rock Mine,0,213,416,629,22980
14742,2023-01-21,8-BIT,gemGrab,Deep Diner,0,10,17,27,4470
14743,2023-01-21,8-BIT,brawlBall,Super Beach,8,76,122,206,101364
14744,2023-01-21,8-BIT,brawlBall,Sneaky Fields,0,2,0,2,3750
14745,2023-01-21,8-BIT,bounty,Dry Season,0,29,26,55,14538
14746,2023-01-20,8-BIT,knockout,Out in the Open,0,31,42,73,20106
14747,2023-01-20,8-BIT,hotZone,Split,0,3,5,8,9678
14748,2023-01-20,8-BIT,heist,Tornado Ring,0,61,39,100,12672
14749,2023-01-20,8-BIT,gemGrab,Undermine,0,21,59,80,5442
14750,2023-01-20,8-BIT,gemGrab,Deep Diner,0,61,57,118,19050
14751,2023-01-20,8-BIT,brawlBall,Sneaky Fields,2,41,52,95,74778
14752,2023-01-20,8-BIT,brawlBall,Pinhole Punt,0,2,2,4,2886
14753,2023-01-20,8-BIT,bounty,Dry Season,0,26,46,72,11640
14754,2023-01-19,8-BIT,knockout,Out in the Open,0,42,61,103,26574
14755,2023-01-19,8-BIT,hotZone,Split,0,9,4,13,14856
14756,2023-01-19,8-BIT,heist,Kaboom Canyon,0,84,82,166,6732
14757,2023-01-19,8-BIT,gemGrab,Undermine,0,67,122,189,14154
14758,2023-01-19,8-BIT,gemGrab,Gem Fort,0,17,28,45,2934
14759,2023-01-19,8-BIT,brawlBall,Sunny Soccer,0,0,2,2,2274
14760,2023-01-19,8-BIT,brawlBall,Pinhole Punt,7,95,100,202,72498
14761,2023-01-19,8-BIT,bounty,Shooting Star,0,21,15,36,11124
14762,2023-01-18,8-BIT,knockout,Goldarm Gulch,0,3,17,20,2784
14763,2023-01-18,8-BIT,hotZone,Parallel Plays,0,1,1,2,1158
14764,2023-01-18,8-BIT,heist,Kaboom Canyon,1,42,35,78,2592
14765,2023-01-18,8-BIT,gemGrab,Gem Fort,0,5,8,13,3006
14766,2023-01-18,8-BIT,gemGrab,Crystal Arcade,0,10,27,37,990
14767,2023-01-18,8-BIT,brawlBall,Sunny Soccer,1,7,7,15,18941
14768,2023-01-18,8-BIT,bounty,Shooting Star,0,20,19,39,5088
14769,2023-01-17,8-BIT,knockout,Goldarm Gulch,0,2,0,2,2520
14770,2023-01-17,8-BIT,hotZone,Parallel Plays,0,1,1,2,1038
14771,2023-01-17,8-BIT,gemGrab,Minecart Madness,0,1,1,2,216
14772,2023-01-17,8-BIT,gemGrab,Crystal Arcade,0,3,6,9,1266
14773,2023-01-17,8-BIT,brawlBall,Center Stage,0,1,0,1,288
14774,2023-01-17,8-BIT,brawlBall,Beach Ball,0,5,1,6,5886
14775,2023-01-17,8-BIT,bounty,Hideout,0,1,0,1,750
14776,2023-01-16,8-BIT,knockout,Belle's Rock,0,3,1,4,1788
14777,2023-01-16,8-BIT,hotZone,Quarter Pounder,0,3,3,6,1494
14778,2023-01-16,8-BIT,gemGrab,Minecart Madness,0,8,5,13,1422
14779,2023-01-16,8-BIT,gemGrab,Double Swoosh,0,1,0,1,708
14780,2023-01-16,8-BIT,brawlBall,Center Stage,0,7,5,12,5778
14781,2023-01-16,8-BIT,brawlBall,Backyard Bowl,0,3,2,5,852
14782,2023-01-15,8-BIT,hotZone,Quarter Pounder,0,8,3,11,3318
14783,2023-01-15,8-BIT,heist,Bridge Too Far,0,76,102,178,2736
14784,2023-01-15,8-BIT,gemGrab,Hard Rock Mine,0,6,14,20,1014
14785,2023-01-15,8-BIT,gemGrab,Double Swoosh,0,2,0,2,2178
14786,2023-01-15,8-BIT,brawlBall,Backyard Bowl,2,34,37,73,8946
14787,2023-01-15,8-BIT,bounty,Canal Grande,0,2,0,2,960
14788,2023-01-14,8-BIT,knockout,Flaring Phoenix,0,0,2,2,1080
14789,2023-01-14,8-BIT,hotZone,Controller Chaos,0,2,0,2,2772
14790,2023-01-14,8-BIT,heist,Bridge Too Far,0,103,184,287,4020
14791,2023-01-14,8-BIT,gemGrab,Hard Rock Mine,0,17,55,72,1272
14792,2023-01-14,8-BIT,gemGrab,Deep Diner,0,5,5,10,858
14793,2023-01-14,8-BIT,brawlBall,Super Beach,0,2,0,2,6336
14794,2023-01-14,8-BIT,bounty,Canal Grande,0,2,0,2,1014
14795,2023-01-13,8-BIT,heist,Hot Potato,0,1,0,1,600
14796,2023-01-13,8-BIT,gemGrab,Deep Diner,0,5,54,59,1650
14797,2023-01-13,8-BIT,brawlBall,Sneaky Fields,0,2,0,2,6144
14798,2023-01-13,8-BIT,bounty,Temple Ruins,0,0,1,1,270
14799,2023-01-12,8-BIT,knockout,Riverside,0,8,2,10,2532
14800,2023-01-12,8-BIT,hotZone,Open Zone,0,4,0,4,1488
14801,2023-01-12,8-BIT,gemGrab,Undermine,0,1,0,1,690
14802,2023-01-12,8-BIT,gemGrab,Gem Fort,0,1,3,4,162
14803,2023-01-12,8-BIT,brawlBall,Pinhole Punt,0,2,3,5,2292
14804,2023-01-11,8-BIT,knockout,Riverside,0,2,0,2,528
14805,2023-01-11,8-BIT,heist,Safe Zone,0,1,1,2,48
14806,2023-01-10,8-BIT,knockout,New Perspective,0,0,1,1,720
14807,2023-01-10,8-BIT,hotZone,Dueling Beetles,0,2,1,3,2424
14808,2023-01-10,8-BIT,heist,Safe Zone,0,10,3,13,1176
14809,2023-01-10,8-BIT,gemGrab,Minecart Madness,0,2,11,13,828
14810,2023-01-10,8-BIT,gemGrab,Crystal Arcade,0,1,1,2,1746
14811,2023-01-10,8-BIT,brawlBall,Beach Ball,0,2,5,7,4392
14812,2023-01-09,8-BIT,knockout,New Perspective,0,0,3,3,876
14813,2023-01-09,8-BIT,heist,Snaked Assault,0,14,62,76,2022
14814,2023-01-09,8-BIT,gemGrab,Minecart Madness,0,5,42,47,1884
14815,2023-01-09,8-BIT,gemGrab,Double Swoosh,0,2,0,2,1320
14816,2023-01-09,8-BIT,brawlBall,Center Stage,0,2,1,3,5460
14817,2023-01-09,8-BIT,brawlBall,Backyard Bowl,0,2,0,2,474
14818,2023-01-09,8-BIT,bounty,Layer Cake,0,2,0,2,1512
14819,2023-01-08,8-BIT,knockout,X Marks the Spot,0,3,0,3,1692
14820,2023-01-08,8-BIT,hotZone,Ring of Fire,0,1,0,1,1644
14821,2023-01-08,8-BIT,heist,Snaked Assault,0,6,4,10,1494
14822,2023-01-08,8-BIT,gemGrab,Hard Rock Mine,0,2,10,12,630
14823,2023-01-08,8-BIT,brawlBall,Backyard Bowl,3,10,36,49,4830
14824,2023-01-08,8-BIT,bounty,Layer Cake,0,1,0,1,528
14825,2023-01-07,8-BIT,knockout,X Marks the Spot,0,6,3,9,1014
14826,2023-01-07,8-BIT,hotZone,Ring of Fire,0,1,3,4,846
14827,2023-01-07,8-BIT,heist,Tornado Ring,0,5,22,27,1350
14828,2023-01-07,8-BIT,gemGrab,Hard Rock Mine,0,9,25,34,1158
14829,2023-01-07,8-BIT,gemGrab,Deep Diner,0,2,24,26,918
14830,2023-01-07,8-BIT,bounty,Dry Season,0,1,0,1,1320
14831,2023-01-06,8-BIT,heist,Tornado Ring,0,14,24,38,2538
14832,2023-01-06,8-BIT,gemGrab,Undermine,0,1,0,1,540
14833,2023-01-06,8-BIT,gemGrab,Deep Diner,0,10,45,55,2226
14834,2023-01-06,8-BIT,brawlBall,Sneaky Fields,0,2,1,3,4896
14835,2023-01-06,8-BIT,brawlBall,Pinhole Punt,0,1,0,1,510
14836,2023-01-06,8-BIT,bounty,Dry Season,0,2,0,2,1944
14837,2023-01-05,8-BIT,knockout,Out in the Open,0,1,2,3,2958
14838,2023-01-05,8-BIT,heist,Kaboom Canyon,0,10,31,41,954
14839,2023-01-05,8-BIT,gemGrab,Undermine,0,3,5,8,1812
14840,2023-01-05,8-BIT,brawlBall,Pinhole Punt,0,1,2,3,8118
14841,2023-01-05,8-BIT,bounty,Shooting Star,0,3,0,3,1362
14842,2023-01-04,8-BIT,knockout,Goldarm Gulch,0,2,10,12,696
14843,2023-01-04,8-BIT,hotZone,Parallel Plays,0,2,0,2,864
14844,2023-01-04,8-BIT,heist,Kaboom Canyon,0,10,11,21,1848
14845,2023-01-04,8-BIT,gemGrab,Gem Fort,0,1,1,2,1788
14846,2023-01-04,8-BIT,gemGrab,Crystal Arcade,0,1,1,2,642
14847,2023-01-04,8-BIT,brawlBall,Sunny Soccer,1,4,9,14,6312
14848,2023-01-04,8-BIT,bounty,Shooting Star,0,2,0,2,3570
14849,2023-01-03,8-BIT,heist,Pit Stop,0,4,1,5,1956
14850,2023-01-03,8-BIT,gemGrab,Crystal Arcade,0,11,24,35,2406
14851,2023-01-03,8-BIT,brawlBall,Beach Ball,0,2,0,2,5580
14852,2023-01-03,8-BIT,bounty,Hideout,0,3,0,3,1638
14853,2023-01-02,8-BIT,hotZone,Quarter Pounder,0,3,1,4,2652
14854,2023-01-02,8-BIT,heist,Pit Stop,0,2,0,2,3498
14855,2023-01-02,8-BIT,heist,Kaboom Canyon,0,1,0,1,30
14856,2023-01-02,8-BIT,gemGrab,Minecart Madness,0,11,12,23,2352
14857,2023-01-02,8-BIT,gemGrab,Double Swoosh,0,8,22,30,1512
14858,2023-01-02,8-BIT,brawlBall,Center Stage,0,2,3,5,7110
14859,2023-01-02,8-BIT,bounty,Hideout,0,2,3,5,3090
14860,2023-01-01,8-BIT,knockout,Belle's Rock,0,0,1,1,858
14861,2023-01-01,8-BIT,heist,Bridge Too Far,0,16,26,42,462
14862,2023-01-01,8-BIT,gemGrab,Hard Rock Mine,0,5,3,8,48
14863,2023-01-01,8-BIT,gemGrab,Double Swoosh,0,6,12,18,1140
14864,2023-01-01,8-BIT,brawlBall,Backyard Bowl,0,7,16,23,2658
14865,2022-12-31,8-BIT,heist,Bridge Too Far,0,6,7,13,276
14866,2022-12-31,8-BIT,gemGrab,Hard Rock Mine,0,4,9,13,384
14867,2022-12-30,8-BIT,hotZone,Controller Chaos,0,0,1,1,288
14868,2022-12-30,8-BIT,heist,Kaboom Canyon,0,2,0,2,18
14869,2022-12-30,8-BIT,gemGrab,Undermine,0,0,1,1,102
14870,2022-12-30,8-BIT,gemGrab,Minecart Madness,0,1,1,2,24
14871,2022-12-30,8-BIT,gemGrab,Deep Diner,0,2,7,9,438
14872,2022-12-30,8-BIT,brawlBall,Sneaky Fields,0,1,0,1,552
14873,2022-12-29,8-BIT,gemGrab,Undermine,0,1,0,1,102
14874,2022-12-28,8-BIT,hotZone,Controller Chaos,0,0,1,1,6
14875,2022-12-27,8-BIT,heist,Kaboom Canyon,0,1,0,1,18
14876,2022-12-27,8-BIT,gemGrab,Minecart Madness,0,1,0,1,30
14877,2022-12-26,8-BIT,gemGrab,Minecart Madness,0,2,0,2,60
14878,2022-10-30,8-BIT,heist,Safe Zone,0,1,0,1,6
14879,2022-10-15,8-BIT,gemGrab,Hard Rock Mine,0,0,2,2,90
14880,2022-10-15,8-BIT,brawlBall,Super Beach,0,1,0,1,12
