,battleTime,brawlername,event_mode,event_map,no,yes,total_games
0,2023-02-05,TICK,knockout,X Marks the Spot,307,266,573
1,2023-02-05,TICK,knockout,Goldarm Gulch,53,33,86
2,2023-02-05,TICK,hotZone,Ring of Fire,364,117,481
3,2023-02-05,TICK,heist,Snaked Assault,16,5,21
4,2023-02-05,TICK,heist,Pit Stop,5,0,5
5,2023-02-05,TICK,gemGrab,Hard Rock Mine,36,6,42
6,2023-02-05,TICK,gemGrab,Double Swoosh,186,86,272
7,2023-02-05,TICK,brawlBall,Super Beach,13,10,23
8,2023-02-05,TICK,brawlBall,Sneaky Fields,9,2,11
9,2023-02-05,TICK,brawlBall,Backyard Bowl,336,205,541
10,2023-02-05,TICK,bounty,Layer Cake,600,494,1094
11,2023-02-04,TICK,knockout,X Marks the Spot,112,108,220
12,2023-02-04,TICK,knockout,Goldarm Gulch,31,21,52
13,2023-02-04,TICK,hotZone,Ring of Fire,67,47,114
14,2023-02-04,TICK,heist,Tornado Ring,3,1,4
15,2023-02-04,TICK,heist,Pit Stop,1,0,1
16,2023-02-04,TICK,gemGrab,Hard Rock Mine,37,14,51
17,2023-02-04,TICK,gemGrab,Double Swoosh,25,6,31
18,2023-02-04,TICK,gemGrab,Deep Diner,18,9,27
19,2023-02-04,TICK,brawlBall,Super Beach,128,82,210
20,2023-02-04,TICK,brawlBall,Sneaky Fields,11,7,18
21,2023-02-04,TICK,bounty,Dry Season,147,112,259
22,2023-02-03,TICK,knockout,Out in the Open,343,303,646
23,2023-02-03,TICK,knockout,Goldarm Gulch,176,139,315
24,2023-02-03,TICK,hotZone,Split,361,126,487
25,2023-02-03,TICK,heist,Tornado Ring,27,6,33
26,2023-02-03,TICK,heist,Pit Stop,25,2,27
27,2023-02-03,TICK,gemGrab,Undermine,29,16,45
28,2023-02-03,TICK,gemGrab,Double Swoosh,166,17,183
29,2023-02-03,TICK,gemGrab,Deep Diner,396,250,646
30,2023-02-03,TICK,brawlBall,Sneaky Fields,527,310,837
31,2023-02-03,TICK,brawlBall,Pinhole Punt,21,10,31
32,2023-02-03,TICK,bounty,Dry Season,941,777,1718
33,2023-02-02,TICK,knockout,Out in the Open,136,106,242
34,2023-02-02,TICK,hotZone,Split,160,99,259
35,2023-02-02,TICK,heist,Kaboom Canyon,4,3,7
36,2023-02-02,TICK,gemGrab,Undermine,45,14,59
37,2023-02-02,TICK,gemGrab,Gem Fort,9,5,14
38,2023-02-02,TICK,brawlBall,Sunny Soccer,14,12,26
39,2023-02-02,TICK,brawlBall,Pinhole Punt,108,68,176
40,2023-02-02,TICK,bounty,Shooting Star,126,141,267
41,2023-02-01,TICK,knockout,Goldarm Gulch,341,285,626
42,2023-02-01,TICK,hotZone,Parallel Plays,328,86,414
43,2023-02-01,TICK,heist,Kaboom Canyon,25,7,32
44,2023-02-01,TICK,gemGrab,Gem Fort,84,51,135
45,2023-02-01,TICK,gemGrab,Crystal Arcade,66,28,94
46,2023-02-01,TICK,brawlBall,Sunny Soccer,525,402,927
47,2023-02-01,TICK,brawlBall,Beach Ball,16,6,22
48,2023-02-01,TICK,bounty,Shooting Star,358,283,641
49,2023-01-31,TICK,knockout,Goldarm Gulch,146,149,295
50,2023-01-31,TICK,hotZone,Parallel Plays,130,43,173
51,2023-01-31,TICK,heist,Pit Stop,8,1,9
52,2023-01-31,TICK,gemGrab,Minecart Madness,63,47,110
53,2023-01-31,TICK,gemGrab,Crystal Arcade,73,54,127
54,2023-01-31,TICK,brawlBall,Center Stage,5,4,9
55,2023-01-31,TICK,brawlBall,Beach Ball,242,154,396
56,2023-01-31,TICK,bounty,Hideout,180,113,293
57,2023-01-30,TICK,knockout,Belle's Rock,1037,910,1947
58,2023-01-30,TICK,hotZone,Quarter Pounder,513,144,657
59,2023-01-30,TICK,heist,Pit Stop,20,7,27
60,2023-01-30,TICK,gemGrab,Minecart Madness,638,402,1040
61,2023-01-30,TICK,gemGrab,Double Swoosh,73,31,104
62,2023-01-30,TICK,brawlBall,Center Stage,384,266,650
63,2023-01-30,TICK,brawlBall,Backyard Bowl,37,20,57
64,2023-01-30,TICK,bounty,Hideout,284,190,474
65,2023-01-29,TICK,knockout,Belle's Rock,947,849,1796
66,2023-01-29,TICK,hotZone,Quarter Pounder,304,62,366
67,2023-01-29,TICK,heist,Bridge Too Far,16,5,21
68,2023-01-29,TICK,gemGrab,Hard Rock Mine,23,9,32
69,2023-01-29,TICK,gemGrab,Double Swoosh,144,85,229
70,2023-01-29,TICK,brawlBall,Super Beach,10,2,12
71,2023-01-29,TICK,brawlBall,Backyard Bowl,318,160,478
72,2023-01-29,TICK,bounty,Canal Grande,363,207,570
73,2023-01-28,TICK,knockout,Flaring Phoenix,318,232,550
74,2023-01-28,TICK,hotZone,Controller Chaos,211,46,257
75,2023-01-28,TICK,heist,Bridge Too Far,31,11,42
76,2023-01-28,TICK,gemGrab,Hard Rock Mine,153,74,227
77,2023-01-28,TICK,gemGrab,Deep Diner,95,58,153
78,2023-01-28,TICK,brawlBall,Super Beach,517,353,870
79,2023-01-28,TICK,brawlBall,Sneaky Fields,19,8,27
80,2023-01-28,TICK,bounty,Canal Grande,580,370,950
81,2023-01-27,TICK,knockout,Flaring Phoenix,132,94,226
82,2023-01-27,TICK,hotZone,Controller Chaos,62,20,82
83,2023-01-27,TICK,heist,Hot Potato,8,1,9
84,2023-01-27,TICK,gemGrab,Undermine,9,5,14
85,2023-01-27,TICK,gemGrab,Deep Diner,123,71,194
86,2023-01-27,TICK,brawlBall,Sneaky Fields,110,84,194
87,2023-01-27,TICK,brawlBall,Pinhole Punt,5,3,8
88,2023-01-27,TICK,bounty,Temple Ruins,46,20,66
89,2023-01-26,TICK,knockout,Riverside,305,186,491
90,2023-01-26,TICK,hotZone,Open Zone,212,58,270
91,2023-01-26,TICK,heist,Hot Potato,17,5,22
92,2023-01-26,TICK,gemGrab,Undermine,71,35,106
93,2023-01-26,TICK,gemGrab,Gem Fort,23,16,39
94,2023-01-26,TICK,brawlBall,Sunny Soccer,36,20,56
95,2023-01-26,TICK,brawlBall,Pinhole Punt,410,235,645
96,2023-01-26,TICK,bounty,Temple Ruins,146,97,243
97,2023-01-25,TICK,knockout,Riverside,123,102,225
98,2023-01-25,TICK,hotZone,Open Zone,84,41,125
99,2023-01-25,TICK,heist,Safe Zone,28,5,33
100,2023-01-25,TICK,gemGrab,Gem Fort,43,26,69
101,2023-01-25,TICK,gemGrab,Crystal Arcade,101,29,130
102,2023-01-25,TICK,brawlBall,Sunny Soccer,375,276,651
103,2023-01-25,TICK,brawlBall,Beach Ball,63,46,109
104,2023-01-25,TICK,bounty,Excel,496,305,801
105,2023-01-24,TICK,knockout,New Perspective,194,177,371
106,2023-01-24,TICK,hotZone,Dueling Beetles,390,144,534
107,2023-01-24,TICK,heist,Safe Zone,80,23,103
108,2023-01-24,TICK,gemGrab,Minecart Madness,213,118,331
109,2023-01-24,TICK,gemGrab,Crystal Arcade,148,69,217
110,2023-01-24,TICK,brawlBall,Center Stage,41,39,80
111,2023-01-24,TICK,brawlBall,Beach Ball,554,345,899
112,2023-01-24,TICK,bounty,Excel,816,558,1374
113,2023-01-23,TICK,knockout,New Perspective,339,229,568
114,2023-01-23,TICK,hotZone,Dueling Beetles,548,175,723
115,2023-01-23,TICK,heist,Snaked Assault,24,2,26
116,2023-01-23,TICK,gemGrab,Minecart Madness,889,518,1407
117,2023-01-23,TICK,gemGrab,Double Swoosh,51,27,78
118,2023-01-23,TICK,brawlBall,Center Stage,564,409,973
119,2023-01-23,TICK,brawlBall,Backyard Bowl,27,15,42
120,2023-01-23,TICK,bounty,Layer Cake,845,599,1444
121,2023-01-22,TICK,knockout,X Marks the Spot,204,146,350
122,2023-01-22,TICK,hotZone,Ring of Fire,186,55,241
123,2023-01-22,TICK,heist,Snaked Assault,15,2,17
124,2023-01-22,TICK,gemGrab,Hard Rock Mine,36,16,52
125,2023-01-22,TICK,gemGrab,Double Swoosh,67,39,106
126,2023-01-22,TICK,brawlBall,Super Beach,55,29,84
127,2023-01-22,TICK,brawlBall,Backyard Bowl,169,96,265
128,2023-01-22,TICK,bounty,Layer Cake,397,322,719
129,2023-01-21,TICK,knockout,X Marks the Spot,737,571,1308
130,2023-01-21,TICK,hotZone,Ring of Fire,513,206,719
131,2023-01-21,TICK,heist,Tornado Ring,14,9,23
132,2023-01-21,TICK,gemGrab,Hard Rock Mine,213,98,311
133,2023-01-21,TICK,gemGrab,Deep Diner,68,63,131
134,2023-01-21,TICK,brawlBall,Super Beach,666,417,1083
135,2023-01-21,TICK,brawlBall,Sneaky Fields,19,18,37
136,2023-01-21,TICK,bounty,Dry Season,739,603,1342
137,2023-01-20,TICK,knockout,Out in the Open,376,298,674
138,2023-01-20,TICK,hotZone,Split,459,190,649
139,2023-01-20,TICK,heist,Tornado Ring,12,1,13
140,2023-01-20,TICK,gemGrab,Undermine,51,23,74
141,2023-01-20,TICK,gemGrab,Deep Diner,428,258,686
142,2023-01-20,TICK,brawlBall,Sneaky Fields,389,226,615
143,2023-01-20,TICK,brawlBall,Pinhole Punt,28,15,43
144,2023-01-20,TICK,bounty,Dry Season,506,470,976
145,2023-01-19,TICK,knockout,Out in the Open,482,420,902
146,2023-01-19,TICK,hotZone,Split,596,297,893
147,2023-01-19,TICK,heist,Kaboom Canyon,25,6,31
148,2023-01-19,TICK,gemGrab,Undermine,158,70,228
149,2023-01-19,TICK,gemGrab,Gem Fort,26,14,40
150,2023-01-19,TICK,brawlBall,Sunny Soccer,27,21,48
151,2023-01-19,TICK,brawlBall,Pinhole Punt,440,310,750
152,2023-01-19,TICK,bounty,Shooting Star,520,361,881
153,2023-01-18,TICK,knockout,Goldarm Gulch,46,46,92
154,2023-01-18,TICK,hotZone,Parallel Plays,49,16,65
155,2023-01-18,TICK,heist,Kaboom Canyon,5,0,5
156,2023-01-18,TICK,gemGrab,Gem Fort,22,17,39
157,2023-01-18,TICK,gemGrab,Crystal Arcade,5,3,8
158,2023-01-18,TICK,brawlBall,Sunny Soccer,185,136,321
159,2023-01-18,TICK,brawlBall,Beach Ball,5,7,12
160,2023-01-18,TICK,bounty,Shooting Star,213,176,389
161,2023-01-17,TICK,knockout,Goldarm Gulch,29,12,41
162,2023-01-17,TICK,hotZone,Parallel Plays,7,7,14
163,2023-01-17,TICK,heist,Pit Stop,1,1,2
164,2023-01-17,TICK,gemGrab,Minecart Madness,9,4,13
165,2023-01-17,TICK,gemGrab,Crystal Arcade,13,4,17
166,2023-01-17,TICK,brawlBall,Center Stage,1,1,2
167,2023-01-17,TICK,brawlBall,Beach Ball,45,24,69
168,2023-01-17,TICK,bounty,Hideout,26,27,53
169,2023-01-16,TICK,knockout,Belle's Rock,61,44,105
170,2023-01-16,TICK,hotZone,Quarter Pounder,59,2,61
171,2023-01-16,TICK,heist,Pit Stop,0,1,1
172,2023-01-16,TICK,gemGrab,Minecart Madness,66,38,104
173,2023-01-16,TICK,gemGrab,Double Swoosh,3,1,4
174,2023-01-16,TICK,brawlBall,Center Stage,24,19,43
175,2023-01-16,TICK,brawlBall,Backyard Bowl,6,1,7
176,2023-01-16,TICK,bounty,Hideout,79,55,134
177,2023-01-15,TICK,knockout,Belle's Rock,118,79,197
178,2023-01-15,TICK,hotZone,Quarter Pounder,85,4,89
179,2023-01-15,TICK,heist,Bridge Too Far,4,1,5
180,2023-01-15,TICK,gemGrab,Hard Rock Mine,3,1,4
181,2023-01-15,TICK,gemGrab,Double Swoosh,12,6,18
182,2023-01-15,TICK,brawlBall,Super Beach,6,2,8
183,2023-01-15,TICK,brawlBall,Backyard Bowl,39,13,52
184,2023-01-15,TICK,bounty,Canal Grande,39,11,50
185,2023-01-14,TICK,knockout,Flaring Phoenix,23,12,35
186,2023-01-14,TICK,hotZone,Controller Chaos,61,7,68
187,2023-01-14,TICK,heist,Bridge Too Far,4,1,5
188,2023-01-14,TICK,gemGrab,Hard Rock Mine,6,0,6
189,2023-01-14,TICK,gemGrab,Deep Diner,14,4,18
190,2023-01-14,TICK,brawlBall,Super Beach,39,22,61
191,2023-01-14,TICK,brawlBall,Sneaky Fields,4,1,5
192,2023-01-14,TICK,bounty,Canal Grande,41,12,53
193,2023-01-13,TICK,knockout,Flaring Phoenix,28,9,37
194,2023-01-13,TICK,hotZone,Controller Chaos,43,15,58
195,2023-01-13,TICK,heist,Hot Potato,1,0,1
196,2023-01-13,TICK,gemGrab,Deep Diner,28,6,34
197,2023-01-13,TICK,brawlBall,Sneaky Fields,15,6,21
198,2023-01-13,TICK,bounty,Temple Ruins,8,5,13
199,2023-01-12,TICK,knockout,Riverside,25,13,38
200,2023-01-12,TICK,hotZone,Open Zone,23,0,23
201,2023-01-12,TICK,gemGrab,Undermine,5,2,7
202,2023-01-12,TICK,brawlBall,Sunny Soccer,1,0,1
203,2023-01-12,TICK,brawlBall,Pinhole Punt,13,2,15
204,2023-01-11,TICK,knockout,Riverside,2,2,4
205,2023-01-11,TICK,hotZone,Open Zone,6,1,7
206,2023-01-11,TICK,heist,Safe Zone,1,0,1
207,2023-01-11,TICK,gemGrab,Gem Fort,2,0,2
208,2023-01-11,TICK,brawlBall,Sunny Soccer,14,9,23
209,2023-01-11,TICK,brawlBall,Beach Ball,2,0,2
210,2023-01-11,TICK,bounty,Excel,33,9,42
211,2023-01-10,TICK,knockout,New Perspective,9,3,12
212,2023-01-10,TICK,hotZone,Dueling Beetles,63,11,74
213,2023-01-10,TICK,heist,Safe Zone,2,0,2
214,2023-01-10,TICK,gemGrab,Minecart Madness,31,5,36
215,2023-01-10,TICK,gemGrab,Crystal Arcade,15,1,16
216,2023-01-10,TICK,brawlBall,Center Stage,7,1,8
217,2023-01-10,TICK,brawlBall,Beach Ball,16,8,24
218,2023-01-10,TICK,bounty,Excel,19,4,23
219,2023-01-09,TICK,knockout,New Perspective,17,1,18
220,2023-01-09,TICK,hotZone,Dueling Beetles,35,11,46
221,2023-01-09,TICK,gemGrab,Minecart Madness,58,14,72
222,2023-01-09,TICK,gemGrab,Double Swoosh,5,0,5
223,2023-01-09,TICK,brawlBall,Center Stage,36,27,63
224,2023-01-09,TICK,brawlBall,Backyard Bowl,2,0,2
225,2023-01-09,TICK,bounty,Layer Cake,99,42,141
226,2023-01-08,TICK,knockout,X Marks the Spot,42,9,51
227,2023-01-08,TICK,hotZone,Ring of Fire,49,1,50
228,2023-01-08,TICK,heist,Snaked Assault,1,0,1
229,2023-01-08,TICK,gemGrab,Hard Rock Mine,2,0,2
230,2023-01-08,TICK,gemGrab,Double Swoosh,5,0,5
231,2023-01-08,TICK,brawlBall,Super Beach,4,2,6
232,2023-01-08,TICK,brawlBall,Backyard Bowl,18,4,22
233,2023-01-08,TICK,bounty,Layer Cake,21,6,27
234,2023-01-07,TICK,knockout,X Marks the Spot,27,9,36
235,2023-01-07,TICK,hotZone,Ring of Fire,16,4,20
236,2023-01-07,TICK,gemGrab,Hard Rock Mine,6,1,7
237,2023-01-07,TICK,gemGrab,Deep Diner,6,1,7
238,2023-01-07,TICK,brawlBall,Super Beach,11,3,14
239,2023-01-07,TICK,brawlBall,Sneaky Fields,3,0,3
240,2023-01-07,TICK,bounty,Dry Season,47,17,64
241,2023-01-06,TICK,knockout,Out in the Open,25,4,29
242,2023-01-06,TICK,hotZone,Split,40,4,44
243,2023-01-06,TICK,heist,Tornado Ring,2,1,3
244,2023-01-06,TICK,gemGrab,Undermine,1,2,3
245,2023-01-06,TICK,gemGrab,Deep Diner,32,1,33
246,2023-01-06,TICK,brawlBall,Sneaky Fields,10,7,17
247,2023-01-06,TICK,bounty,Dry Season,59,43,102
248,2023-01-05,TICK,knockout,Out in the Open,44,24,68
249,2023-01-05,TICK,hotZone,Split,83,10,93
250,2023-01-05,TICK,heist,Kaboom Canyon,1,0,1
251,2023-01-05,TICK,gemGrab,Undermine,5,1,6
252,2023-01-05,TICK,brawlBall,Sunny Soccer,3,0,3
253,2023-01-05,TICK,brawlBall,Pinhole Punt,20,3,23
254,2023-01-05,TICK,bounty,Shooting Star,49,23,72
255,2023-01-04,TICK,knockout,Goldarm Gulch,13,5,18
256,2023-01-04,TICK,hotZone,Parallel Plays,19,0,19
257,2023-01-04,TICK,gemGrab,Gem Fort,4,1,5
258,2023-01-04,TICK,gemGrab,Crystal Arcade,3,0,3
259,2023-01-04,TICK,brawlBall,Sunny Soccer,29,7,36
260,2023-01-04,TICK,brawlBall,Beach Ball,2,0,2
261,2023-01-04,TICK,bounty,Shooting Star,131,188,319
262,2023-01-03,TICK,knockout,Goldarm Gulch,10,15,25
263,2023-01-03,TICK,hotZone,Parallel Plays,24,1,25
264,2023-01-03,TICK,heist,Kaboom Canyon,1,0,1
265,2023-01-03,TICK,gemGrab,Minecart Madness,16,1,17
266,2023-01-03,TICK,gemGrab,Crystal Arcade,14,4,18
267,2023-01-03,TICK,brawlBall,Center Stage,1,1,2
268,2023-01-03,TICK,brawlBall,Beach Ball,28,5,33
269,2023-01-03,TICK,bounty,Hideout,72,55,127
270,2023-01-02,TICK,knockout,Belle's Rock,76,56,132
271,2023-01-02,TICK,hotZone,Quarter Pounder,72,2,74
272,2023-01-02,TICK,heist,Pit Stop,1,0,1
273,2023-01-02,TICK,gemGrab,Minecart Madness,61,7,68
274,2023-01-02,TICK,gemGrab,Double Swoosh,2,1,3
275,2023-01-02,TICK,brawlBall,Center Stage,11,6,17
276,2023-01-02,TICK,brawlBall,Backyard Bowl,2,1,3
277,2023-01-02,TICK,bounty,Hideout,96,80,176
278,2023-01-01,TICK,knockout,Belle's Rock,18,19,37
279,2023-01-01,TICK,hotZone,Quarter Pounder,22,1,23
280,2023-01-01,TICK,hotZone,Controller Chaos,1,0,1
281,2023-01-01,TICK,heist,Bridge Too Far,1,0,1
282,2023-01-01,TICK,gemGrab,Minecart Madness,0,1,1
283,2023-01-01,TICK,gemGrab,Double Swoosh,3,1,4
284,2023-01-01,TICK,brawlBall,Backyard Bowl,6,4,10
285,2023-01-01,TICK,bounty,Canal Grande,7,5,12
286,2022-12-31,TICK,hotZone,Controller Chaos,5,0,5
287,2022-12-31,TICK,gemGrab,Minecart Madness,1,0,1
288,2022-12-31,TICK,gemGrab,Hard Rock Mine,2,1,3
289,2022-12-31,TICK,gemGrab,Deep Diner,8,2,10
290,2022-12-31,TICK,brawlBall,Super Beach,1,0,1
291,2022-12-31,TICK,bounty,Canal Grande,3,1,4
292,2022-12-30,TICK,knockout,Flaring Phoenix,1,2,3
293,2022-12-30,TICK,hotZone,Controller Chaos,5,0,5
294,2022-12-30,TICK,gemGrab,Deep Diner,7,1,8
295,2022-12-30,TICK,brawlBall,Sneaky Fields,1,1,2
296,2022-12-29,TICK,gemGrab,Minecart Madness,1,1,2
297,2022-12-29,TICK,brawlBall,Pinhole Punt,2,6,8
298,2022-12-27,TICK,hotZone,Dueling Beetles,1,1,2
299,2022-12-27,TICK,gemGrab,Minecart Madness,0,2,2
300,2022-12-27,TICK,brawlBall,Beach Ball,1,1,2
301,2022-12-27,TICK,bounty,Excel,2,2,4
302,2022-12-26,TICK,hotZone,Controller Chaos,1,0,1
303,2022-12-26,TICK,gemGrab,Minecart Madness,1,0,1
304,2022-12-25,TICK,bounty,Layer Cake,1,0,1
305,2022-12-23,TICK,knockout,Out in the Open,2,1,3
306,2022-12-22,TICK,brawlBall,Pinhole Punt,0,1,1
307,2022-12-21,TICK,brawlBall,Sunny Soccer,1,1,2
308,2022-12-20,TICK,brawlBall,Beach Ball,0,2,2
309,2022-12-19,TICK,brawlBall,Center Stage,0,1,1
310,2022-12-18,TICK,knockout,Belle's Rock,1,1,2
311,2022-12-16,TICK,brawlBall,Sneaky Fields,0,1,1
312,2022-12-16,TICK,bounty,Temple Ruins,2,0,2
313,2022-12-13,TICK,knockout,New Perspective,1,0,1
314,2022-12-13,TICK,heist,Safe Zone,1,0,1
315,2022-12-11,TICK,gemGrab,Double Swoosh,2,0,2
316,2022-12-10,TICK,hotZone,Ring of Fire,1,0,1
317,2022-11-11,TICK,knockout,New Perspective,2,0,2
318,2022-11-11,TICK,brawlBall,Sneaky Fields,1,0,1
319,2022-11-01,TICK,knockout,New Perspective,2,0,2
320,2022-10-30,TICK,hotZone,Dueling Beetles,1,2,3
321,2022-10-28,TICK,knockout,Out in the Open,0,2,2
322,2022-10-28,TICK,hotZone,Dueling Beetles,0,2,2
323,2022-10-28,TICK,heist,Safe Zone,1,0,1
324,2022-10-26,TICK,brawlBall,Sunny Soccer,0,1,1
325,2022-10-26,TICK,bounty,Shooting Star,1,1,2
326,2022-10-15,TICK,hotZone,Ring of Fire,2,0,2
327,2022-10-15,TICK,gemGrab,Hard Rock Mine,2,0,2
328,2022-10-10,TICK,knockout,Belle's Rock,1,3,4
329,2023-02-05,TARA,knockout,X Marks the Spot,20,13,33
330,2023-02-05,TARA,knockout,Goldarm Gulch,8,15,23
331,2023-02-05,TARA,hotZone,Ring of Fire,50,43,93
332,2023-02-05,TARA,heist,Snaked Assault,98,112,210
333,2023-02-05,TARA,heist,Pit Stop,6,4,10
334,2023-02-05,TARA,gemGrab,Hard Rock Mine,76,70,146
335,2023-02-05,TARA,gemGrab,Double Swoosh,712,795,1507
336,2023-02-05,TARA,brawlBall,Super Beach,13,9,22
337,2023-02-05,TARA,brawlBall,Sneaky Fields,104,60,164
338,2023-02-05,TARA,brawlBall,Backyard Bowl,218,134,352
339,2023-02-05,TARA,bounty,Layer Cake,20,14,34
340,2023-02-04,TARA,knockout,X Marks the Spot,21,11,32
341,2023-02-04,TARA,knockout,Goldarm Gulch,4,2,6
342,2023-02-04,TARA,hotZone,Ring of Fire,5,3,8
343,2023-02-04,TARA,heist,Tornado Ring,10,7,17
344,2023-02-04,TARA,heist,Pit Stop,14,4,18
345,2023-02-04,TARA,gemGrab,Hard Rock Mine,91,81,172
346,2023-02-04,TARA,gemGrab,Double Swoosh,106,121,227
347,2023-02-04,TARA,gemGrab,Deep Diner,3,10,13
348,2023-02-04,TARA,brawlBall,Super Beach,122,117,239
349,2023-02-04,TARA,brawlBall,Sneaky Fields,68,49,117
350,2023-02-03,TARA,knockout,Out in the Open,72,92,164
351,2023-02-03,TARA,knockout,Goldarm Gulch,27,17,44
352,2023-02-03,TARA,hotZone,Split,26,10,36
353,2023-02-03,TARA,heist,Tornado Ring,112,108,220
354,2023-02-03,TARA,heist,Pit Stop,36,23,59
355,2023-02-03,TARA,gemGrab,Undermine,89,152,241
356,2023-02-03,TARA,gemGrab,Double Swoosh,708,861,1569
357,2023-02-03,TARA,gemGrab,Deep Diner,172,137,309
358,2023-02-03,TARA,brawlBall,Sneaky Fields,1283,995,2278
359,2023-02-03,TARA,brawlBall,Pinhole Punt,23,29,52
360,2023-02-03,TARA,bounty,Dry Season,15,12,27
361,2023-02-02,TARA,knockout,Out in the Open,39,48,87
362,2023-02-02,TARA,hotZone,Split,8,6,14
363,2023-02-02,TARA,heist,Kaboom Canyon,3,0,3
364,2023-02-02,TARA,gemGrab,Undermine,84,107,191
365,2023-02-02,TARA,gemGrab,Gem Fort,18,26,44
366,2023-02-02,TARA,brawlBall,Sunny Soccer,3,2,5
367,2023-02-02,TARA,brawlBall,Pinhole Punt,172,158,330
368,2023-02-02,TARA,bounty,Shooting Star,2,0,2
369,2023-02-01,TARA,knockout,Goldarm Gulch,107,104,211
370,2023-02-01,TARA,hotZone,Parallel Plays,52,21,73
371,2023-02-01,TARA,heist,Kaboom Canyon,11,8,19
372,2023-02-01,TARA,gemGrab,Gem Fort,265,340,605
373,2023-02-01,TARA,gemGrab,Crystal Arcade,100,108,208
374,2023-02-01,TARA,brawlBall,Sunny Soccer,421,400,821
375,2023-02-01,TARA,brawlBall,Beach Ball,7,7,14
376,2023-02-01,TARA,bounty,Shooting Star,2,1,3
377,2023-01-31,TARA,knockout,Goldarm Gulch,75,101,176
378,2023-01-31,TARA,hotZone,Parallel Plays,18,20,38
379,2023-01-31,TARA,heist,Pit Stop,27,33,60
380,2023-01-31,TARA,gemGrab,Minecart Madness,1,1,2
381,2023-01-31,TARA,gemGrab,Crystal Arcade,117,171,288
382,2023-01-31,TARA,brawlBall,Center Stage,3,13,16
383,2023-01-31,TARA,brawlBall,Beach Ball,221,184,405
384,2023-01-31,TARA,bounty,Hideout,1,0,1
385,2023-01-30,TARA,knockout,Belle's Rock,28,10,38
386,2023-01-30,TARA,hotZone,Quarter Pounder,67,19,86
387,2023-01-30,TARA,heist,Pit Stop,39,40,79
388,2023-01-30,TARA,gemGrab,Minecart Madness,47,27,74
389,2023-01-30,TARA,gemGrab,Double Swoosh,295,286,581
390,2023-01-30,TARA,brawlBall,Center Stage,599,605,1204
391,2023-01-30,TARA,brawlBall,Backyard Bowl,20,14,34
392,2023-01-30,TARA,bounty,Hideout,2,4,6
393,2023-01-29,TARA,knockout,Belle's Rock,10,5,15
394,2023-01-29,TARA,hotZone,Quarter Pounder,38,14,52
395,2023-01-29,TARA,heist,Bridge Too Far,5,4,9
396,2023-01-29,TARA,gemGrab,Hard Rock Mine,48,54,102
397,2023-01-29,TARA,gemGrab,Double Swoosh,507,548,1055
398,2023-01-29,TARA,brawlBall,Super Beach,7,2,9
399,2023-01-29,TARA,brawlBall,Backyard Bowl,242,206,448
400,2023-01-29,TARA,bounty,Canal Grande,20,5,25
401,2023-01-28,TARA,knockout,Flaring Phoenix,333,365,698
402,2023-01-28,TARA,hotZone,Controller Chaos,65,42,107
403,2023-01-28,TARA,heist,Bridge Too Far,10,13,23
404,2023-01-28,TARA,gemGrab,Hard Rock Mine,309,254,563
405,2023-01-28,TARA,gemGrab,Deep Diner,43,38,81
406,2023-01-28,TARA,brawlBall,Super Beach,605,529,1134
407,2023-01-28,TARA,brawlBall,Sneaky Fields,24,26,50
408,2023-01-28,TARA,bounty,Canal Grande,68,72,140
409,2023-01-27,TARA,knockout,Flaring Phoenix,160,204,364
410,2023-01-27,TARA,hotZone,Controller Chaos,14,8,22
411,2023-01-27,TARA,heist,Hot Potato,17,17,34
412,2023-01-27,TARA,gemGrab,Undermine,17,42,59
413,2023-01-27,TARA,gemGrab,Deep Diner,49,49,98
414,2023-01-27,TARA,brawlBall,Sneaky Fields,239,231,470
415,2023-01-27,TARA,brawlBall,Pinhole Punt,4,6,10
416,2023-01-27,TARA,bounty,Temple Ruins,14,15,29
417,2023-01-26,TARA,knockout,Riverside,12,9,21
418,2023-01-26,TARA,hotZone,Open Zone,38,14,52
419,2023-01-26,TARA,heist,Hot Potato,72,58,130
420,2023-01-26,TARA,gemGrab,Undermine,281,276,557
421,2023-01-26,TARA,gemGrab,Gem Fort,135,172,307
422,2023-01-26,TARA,brawlBall,Sunny Soccer,28,37,65
423,2023-01-26,TARA,brawlBall,Pinhole Punt,557,592,1149
424,2023-01-26,TARA,bounty,Temple Ruins,74,82,156
425,2023-01-25,TARA,knockout,Riverside,7,6,13
426,2023-01-25,TARA,hotZone,Open Zone,17,8,25
427,2023-01-25,TARA,heist,Safe Zone,11,9,20
428,2023-01-25,TARA,gemGrab,Gem Fort,156,165,321
429,2023-01-25,TARA,gemGrab,Crystal Arcade,124,138,262
430,2023-01-25,TARA,brawlBall,Sunny Soccer,321,317,638
431,2023-01-25,TARA,brawlBall,Beach Ball,39,30,69
432,2023-01-25,TARA,bounty,Excel,7,1,8
433,2023-01-24,TARA,knockout,New Perspective,72,134,206
434,2023-01-24,TARA,hotZone,Dueling Beetles,54,14,68
435,2023-01-24,TARA,heist,Safe Zone,14,8,22
436,2023-01-24,TARA,gemGrab,Minecart Madness,9,9,18
437,2023-01-24,TARA,gemGrab,Crystal Arcade,277,242,519
438,2023-01-24,TARA,brawlBall,Center Stage,95,100,195
439,2023-01-24,TARA,brawlBall,Beach Ball,525,456,981
440,2023-01-24,TARA,bounty,Excel,16,3,19
441,2023-01-23,TARA,knockout,New Perspective,360,524,884
442,2023-01-23,TARA,hotZone,Dueling Beetles,52,19,71
443,2023-01-23,TARA,heist,Snaked Assault,110,143,253
444,2023-01-23,TARA,gemGrab,Minecart Madness,88,46,134
445,2023-01-23,TARA,gemGrab,Double Swoosh,228,324,552
446,2023-01-23,TARA,brawlBall,Center Stage,1139,1158,2297
447,2023-01-23,TARA,brawlBall,Backyard Bowl,20,10,30
448,2023-01-23,TARA,bounty,Layer Cake,25,20,45
449,2023-01-22,TARA,knockout,X Marks the Spot,14,17,31
450,2023-01-22,TARA,hotZone,Ring of Fire,29,17,46
451,2023-01-22,TARA,heist,Snaked Assault,78,89,167
452,2023-01-22,TARA,gemGrab,Hard Rock Mine,75,51,126
453,2023-01-22,TARA,gemGrab,Double Swoosh,320,318,638
454,2023-01-22,TARA,brawlBall,Super Beach,57,34,91
455,2023-01-22,TARA,brawlBall,Backyard Bowl,124,106,230
456,2023-01-22,TARA,bounty,Layer Cake,22,33,55
457,2023-01-21,TARA,knockout,X Marks the Spot,72,38,110
458,2023-01-21,TARA,hotZone,Ring of Fire,73,30,103
459,2023-01-21,TARA,heist,Tornado Ring,98,127,225
460,2023-01-21,TARA,gemGrab,Hard Rock Mine,372,320,692
461,2023-01-21,TARA,gemGrab,Deep Diner,43,39,82
462,2023-01-21,TARA,brawlBall,Super Beach,747,688,1435
463,2023-01-21,TARA,brawlBall,Sneaky Fields,22,29,51
464,2023-01-21,TARA,bounty,Dry Season,8,3,11
465,2023-01-20,TARA,knockout,Out in the Open,72,71,143
466,2023-01-20,TARA,hotZone,Split,19,9,28
467,2023-01-20,TARA,heist,Tornado Ring,86,65,151
468,2023-01-20,TARA,gemGrab,Undermine,100,96,196
469,2023-01-20,TARA,gemGrab,Deep Diner,207,161,368
470,2023-01-20,TARA,brawlBall,Sneaky Fields,799,775,1574
471,2023-01-20,TARA,brawlBall,Pinhole Punt,14,17,31
472,2023-01-20,TARA,bounty,Dry Season,13,7,20
473,2023-01-19,TARA,knockout,Out in the Open,171,166,337
474,2023-01-19,TARA,hotZone,Split,37,20,57
475,2023-01-19,TARA,heist,Kaboom Canyon,18,15,33
476,2023-01-19,TARA,gemGrab,Undermine,399,471,870
477,2023-01-19,TARA,gemGrab,Gem Fort,103,81,184
478,2023-01-19,TARA,brawlBall,Sunny Soccer,19,17,36
479,2023-01-19,TARA,brawlBall,Pinhole Punt,536,582,1118
480,2023-01-19,TARA,bounty,Shooting Star,9,2,11
481,2023-01-18,TARA,knockout,Goldarm Gulch,11,6,17
482,2023-01-18,TARA,hotZone,Parallel Plays,5,4,9
483,2023-01-18,TARA,heist,Kaboom Canyon,3,0,3
484,2023-01-18,TARA,gemGrab,Gem Fort,69,109,178
485,2023-01-18,TARA,gemGrab,Crystal Arcade,13,8,21
486,2023-01-18,TARA,brawlBall,Sunny Soccer,142,128,270
487,2023-01-18,TARA,brawlBall,Beach Ball,2,8,10
488,2023-01-18,TARA,bounty,Shooting Star,1,1,2
489,2023-01-17,TARA,knockout,Goldarm Gulch,18,6,24
490,2023-01-17,TARA,hotZone,Parallel Plays,2,2,4
491,2023-01-17,TARA,heist,Pit Stop,8,8,16
492,2023-01-17,TARA,gemGrab,Crystal Arcade,24,32,56
493,2023-01-17,TARA,brawlBall,Center Stage,2,2,4
494,2023-01-17,TARA,brawlBall,Beach Ball,34,40,74
495,2023-01-17,TARA,bounty,Hideout,1,0,1
496,2023-01-16,TARA,knockout,Belle's Rock,0,3,3
497,2023-01-16,TARA,hotZone,Quarter Pounder,6,3,9
498,2023-01-16,TARA,heist,Pit Stop,16,12,28
499,2023-01-16,TARA,gemGrab,Minecart Madness,5,5,10
500,2023-01-16,TARA,gemGrab,Double Swoosh,30,47,77
501,2023-01-16,TARA,brawlBall,Center Stage,65,75,140
502,2023-01-16,TARA,brawlBall,Backyard Bowl,5,0,5
503,2023-01-16,TARA,bounty,Hideout,1,0,1
504,2023-01-15,TARA,knockout,Belle's Rock,5,2,7
505,2023-01-15,TARA,hotZone,Quarter Pounder,21,2,23
506,2023-01-15,TARA,heist,Bridge Too Far,3,1,4
507,2023-01-15,TARA,gemGrab,Hard Rock Mine,19,8,27
508,2023-01-15,TARA,gemGrab,Double Swoosh,95,66,161
509,2023-01-15,TARA,brawlBall,Super Beach,12,0,12
510,2023-01-15,TARA,brawlBall,Backyard Bowl,30,20,50
511,2023-01-15,TARA,bounty,Canal Grande,4,2,6
512,2023-01-14,TARA,knockout,Flaring Phoenix,18,27,45
513,2023-01-14,TARA,hotZone,Controller Chaos,26,2,28
514,2023-01-14,TARA,heist,Bridge Too Far,4,1,5
515,2023-01-14,TARA,gemGrab,Hard Rock Mine,23,7,30
516,2023-01-14,TARA,gemGrab,Deep Diner,17,6,23
517,2023-01-14,TARA,brawlBall,Super Beach,44,21,65
518,2023-01-14,TARA,brawlBall,Sneaky Fields,11,8,19
519,2023-01-14,TARA,bounty,Canal Grande,7,17,24
520,2023-01-13,TARA,knockout,Flaring Phoenix,21,31,52
521,2023-01-13,TARA,hotZone,Controller Chaos,9,5,14
522,2023-01-13,TARA,heist,Hot Potato,3,0,3
523,2023-01-13,TARA,gemGrab,Undermine,1,0,1
524,2023-01-13,TARA,gemGrab,Deep Diner,16,10,26
525,2023-01-13,TARA,brawlBall,Sneaky Fields,52,20,72
526,2023-01-13,TARA,brawlBall,Pinhole Punt,4,0,4
527,2023-01-13,TARA,bounty,Temple Ruins,5,0,5
528,2023-01-12,TARA,knockout,Riverside,1,0,1
529,2023-01-12,TARA,hotZone,Open Zone,7,1,8
530,2023-01-12,TARA,heist,Hot Potato,1,1,2
531,2023-01-12,TARA,gemGrab,Undermine,24,17,41
532,2023-01-12,TARA,gemGrab,Gem Fort,6,1,7
533,2023-01-12,TARA,brawlBall,Sunny Soccer,1,0,1
534,2023-01-12,TARA,brawlBall,Pinhole Punt,20,4,24
535,2023-01-12,TARA,bounty,Temple Ruins,0,2,2
536,2023-01-11,TARA,hotZone,Open Zone,1,0,1
537,2023-01-11,TARA,gemGrab,Gem Fort,18,13,31
538,2023-01-11,TARA,brawlBall,Sunny Soccer,6,10,16
539,2023-01-10,TARA,knockout,New Perspective,4,1,5
540,2023-01-10,TARA,hotZone,Dueling Beetles,7,0,7
541,2023-01-10,TARA,heist,Safe Zone,1,0,1
542,2023-01-10,TARA,gemGrab,Minecart Madness,3,2,5
543,2023-01-10,TARA,gemGrab,Crystal Arcade,43,39,82
544,2023-01-10,TARA,brawlBall,Center Stage,6,1,7
545,2023-01-10,TARA,brawlBall,Beach Ball,24,14,38
546,2023-01-10,TARA,bounty,Excel,1,0,1
547,2023-01-09,TARA,knockout,New Perspective,24,26,50
548,2023-01-09,TARA,hotZone,Dueling Beetles,1,0,1
549,2023-01-09,TARA,heist,Snaked Assault,10,7,17
550,2023-01-09,TARA,gemGrab,Minecart Madness,7,1,8
551,2023-01-09,TARA,gemGrab,Double Swoosh,43,55,98
552,2023-01-09,TARA,brawlBall,Center Stage,70,60,130
553,2023-01-09,TARA,brawlBall,Backyard Bowl,4,0,4
554,2023-01-09,TARA,bounty,Layer Cake,0,1,1
555,2023-01-08,TARA,knockout,X Marks the Spot,1,0,1
556,2023-01-08,TARA,hotZone,Ring of Fire,7,23,30
557,2023-01-08,TARA,heist,Snaked Assault,12,14,26
558,2023-01-08,TARA,gemGrab,Hard Rock Mine,12,9,21
559,2023-01-08,TARA,gemGrab,Double Swoosh,39,18,57
560,2023-01-08,TARA,brawlBall,Super Beach,8,2,10
561,2023-01-08,TARA,brawlBall,Backyard Bowl,15,4,19
562,2023-01-08,TARA,bounty,Layer Cake,0,2,2
563,2023-01-07,TARA,knockout,X Marks the Spot,0,1,1
564,2023-01-07,TARA,hotZone,Ring of Fire,6,11,17
565,2023-01-07,TARA,heist,Tornado Ring,11,12,23
566,2023-01-07,TARA,gemGrab,Hard Rock Mine,32,36,68
567,2023-01-07,TARA,gemGrab,Deep Diner,21,3,24
568,2023-01-07,TARA,brawlBall,Super Beach,18,15,33
569,2023-01-07,TARA,brawlBall,Sneaky Fields,5,1,6
570,2023-01-07,TARA,bounty,Dry Season,2,1,3
571,2023-01-06,TARA,knockout,Out in the Open,9,23,32
572,2023-01-06,TARA,heist,Tornado Ring,11,4,15
573,2023-01-06,TARA,gemGrab,Undermine,19,14,33
574,2023-01-06,TARA,gemGrab,Deep Diner,29,7,36
575,2023-01-06,TARA,brawlBall,Sneaky Fields,48,36,84
576,2023-01-06,TARA,brawlBall,Pinhole Punt,5,1,6
577,2023-01-06,TARA,bounty,Dry Season,0,1,1
578,2023-01-05,TARA,knockout,Out in the Open,23,9,32
579,2023-01-05,TARA,hotZone,Split,12,0,12
580,2023-01-05,TARA,heist,Kaboom Canyon,3,0,3
581,2023-01-05,TARA,gemGrab,Undermine,66,52,118
582,2023-01-05,TARA,gemGrab,Gem Fort,12,7,19
583,2023-01-05,TARA,brawlBall,Sunny Soccer,0,1,1
584,2023-01-05,TARA,brawlBall,Pinhole Punt,65,31,96
585,2023-01-04,TARA,knockout,Goldarm Gulch,3,0,3
586,2023-01-04,TARA,hotZone,Parallel Plays,1,0,1
587,2023-01-04,TARA,heist,Kaboom Canyon,1,1,2
588,2023-01-04,TARA,gemGrab,Gem Fort,85,62,147
589,2023-01-04,TARA,gemGrab,Crystal Arcade,16,2,18
590,2023-01-04,TARA,brawlBall,Sunny Soccer,45,27,72
591,2023-01-04,TARA,bounty,Shooting Star,1,0,1
592,2023-01-03,TARA,knockout,Goldarm Gulch,8,1,9
593,2023-01-03,TARA,hotZone,Parallel Plays,2,1,3
594,2023-01-03,TARA,heist,Pit Stop,4,0,4
595,2023-01-03,TARA,gemGrab,Crystal Arcade,63,19,82
596,2023-01-03,TARA,brawlBall,Center Stage,2,0,2
597,2023-01-03,TARA,brawlBall,Beach Ball,56,45,101
598,2023-01-03,TARA,bounty,Hideout,1,0,1
599,2023-01-02,TARA,knockout,Belle's Rock,4,0,4
600,2023-01-02,TARA,hotZone,Quarter Pounder,10,2,12
601,2023-01-02,TARA,heist,Pit Stop,7,1,8
602,2023-01-02,TARA,gemGrab,Minecart Madness,14,4,18
603,2023-01-02,TARA,gemGrab,Double Swoosh,39,14,53
604,2023-01-02,TARA,brawlBall,Center Stage,95,71,166
605,2023-01-02,TARA,brawlBall,Backyard Bowl,1,1,2
606,2023-01-02,TARA,bounty,Hideout,3,0,3
607,2023-01-01,TARA,hotZone,Quarter Pounder,3,1,4
608,2023-01-01,TARA,heist,Bridge Too Far,0,1,1
609,2023-01-01,TARA,gemGrab,Minecart Madness,1,0,1
610,2023-01-01,TARA,gemGrab,Hard Rock Mine,1,2,3
611,2023-01-01,TARA,gemGrab,Double Swoosh,36,41,77
612,2023-01-01,TARA,brawlBall,Backyard Bowl,8,3,11
613,2022-12-31,TARA,knockout,Flaring Phoenix,2,0,2
614,2022-12-31,TARA,hotZone,Controller Chaos,1,0,1
615,2022-12-31,TARA,gemGrab,Hard Rock Mine,9,6,15
616,2022-12-31,TARA,gemGrab,Deep Diner,3,2,5
617,2022-12-31,TARA,brawlBall,Super Beach,2,3,5
618,2022-12-30,TARA,knockout,Flaring Phoenix,3,2,5
619,2022-12-30,TARA,hotZone,Controller Chaos,2,1,3
620,2022-12-30,TARA,heist,Kaboom Canyon,0,1,1
621,2022-12-30,TARA,heist,Hot Potato,1,0,1
622,2022-12-30,TARA,gemGrab,Undermine,3,0,3
623,2022-12-30,TARA,gemGrab,Deep Diner,2,1,3
624,2022-12-30,TARA,brawlBall,Sneaky Fields,4,10,14
625,2022-12-29,TARA,hotZone,Controller Chaos,1,0,1
626,2022-12-29,TARA,gemGrab,Undermine,1,0,1
627,2022-12-29,TARA,gemGrab,Gem Fort,0,1,1
628,2022-12-29,TARA,brawlBall,Pinhole Punt,3,2,5
629,2022-12-28,TARA,brawlBall,Sunny Soccer,0,1,1
630,2022-12-28,TARA,brawlBall,Beach Ball,0,1,1
631,2022-12-27,TARA,knockout,New Perspective,2,3,5
632,2022-12-27,TARA,brawlBall,Beach Ball,0,2,2
633,2022-12-26,TARA,gemGrab,Minecart Madness,0,1,1
634,2022-12-26,TARA,brawlBall,Center Stage,1,2,3
635,2022-12-23,TARA,knockout,Out in the Open,1,0,1
636,2022-12-22,TARA,gemGrab,Gem Fort,7,12,19
637,2022-12-22,TARA,brawlBall,Pinhole Punt,4,2,6
638,2022-12-20,TARA,brawlBall,Beach Ball,1,2,3
639,2022-12-19,TARA,brawlBall,Center Stage,0,1,1
640,2022-12-17,TARA,knockout,Flaring Phoenix,2,4,6
641,2022-12-16,TARA,brawlBall,Sneaky Fields,0,1,1
642,2022-12-13,TARA,knockout,New Perspective,2,1,3
643,2022-12-13,TARA,gemGrab,Crystal Arcade,1,0,1
644,2022-12-10,TARA,gemGrab,Hard Rock Mine,0,1,1
645,2022-11-11,TARA,brawlBall,Sneaky Fields,1,3,4
646,2022-10-28,TARA,hotZone,Dueling Beetles,1,0,1
647,2022-10-15,TARA,hotZone,Ring of Fire,1,0,1
648,2023-02-05,SURGE,knockout,X Marks the Spot,41,7,48
649,2023-02-05,SURGE,knockout,Goldarm Gulch,3,1,4
650,2023-02-05,SURGE,hotZone,Ring of Fire,49,23,72
651,2023-02-05,SURGE,heist,Snaked Assault,57,53,110
652,2023-02-05,SURGE,heist,Pit Stop,19,12,31
653,2023-02-05,SURGE,gemGrab,Hard Rock Mine,109,84,193
654,2023-02-05,SURGE,gemGrab,Double Swoosh,486,469,955
655,2023-02-05,SURGE,brawlBall,Super Beach,57,62,119
656,2023-02-05,SURGE,brawlBall,Sneaky Fields,154,195,349
657,2023-02-05,SURGE,brawlBall,Backyard Bowl,520,375,895
658,2023-02-05,SURGE,bounty,Layer Cake,52,32,84
659,2023-02-04,SURGE,knockout,X Marks the Spot,8,11,19
660,2023-02-04,SURGE,knockout,Goldarm Gulch,2,2,4
661,2023-02-04,SURGE,hotZone,Ring of Fire,11,7,18
662,2023-02-04,SURGE,heist,Tornado Ring,8,2,10
663,2023-02-04,SURGE,heist,Pit Stop,27,23,50
664,2023-02-04,SURGE,gemGrab,Hard Rock Mine,79,69,148
665,2023-02-04,SURGE,gemGrab,Double Swoosh,64,90,154
666,2023-02-04,SURGE,gemGrab,Deep Diner,7,7,14
667,2023-02-04,SURGE,brawlBall,Super Beach,474,475,949
668,2023-02-04,SURGE,brawlBall,Sneaky Fields,147,165,312
669,2023-02-04,SURGE,bounty,Dry Season,1,1,2
670,2023-02-03,SURGE,knockout,Out in the Open,61,21,82
671,2023-02-03,SURGE,knockout,Goldarm Gulch,18,5,23
672,2023-02-03,SURGE,hotZone,Split,221,265,486
673,2023-02-03,SURGE,heist,Tornado Ring,105,137,242
674,2023-02-03,SURGE,heist,Pit Stop,121,137,258
675,2023-02-03,SURGE,gemGrab,Undermine,72,42,114
676,2023-02-03,SURGE,gemGrab,Double Swoosh,493,460,953
677,2023-02-03,SURGE,gemGrab,Deep Diner,285,232,517
678,2023-02-03,SURGE,brawlBall,Sneaky Fields,2999,3040,6039
679,2023-02-03,SURGE,brawlBall,Pinhole Punt,47,50,97
680,2023-02-03,SURGE,bounty,Dry Season,31,17,48
681,2023-02-02,SURGE,knockout,Out in the Open,20,13,33
682,2023-02-02,SURGE,hotZone,Split,146,166,312
683,2023-02-02,SURGE,heist,Kaboom Canyon,1,0,1
684,2023-02-02,SURGE,gemGrab,Undermine,69,67,136
685,2023-02-02,SURGE,gemGrab,Gem Fort,22,26,48
686,2023-02-02,SURGE,brawlBall,Sunny Soccer,20,19,39
687,2023-02-02,SURGE,brawlBall,Pinhole Punt,270,294,564
688,2023-02-02,SURGE,bounty,Shooting Star,3,2,5
689,2023-02-01,SURGE,knockout,Goldarm Gulch,102,63,165
690,2023-02-01,SURGE,hotZone,Parallel Plays,305,325,630
691,2023-02-01,SURGE,heist,Kaboom Canyon,12,5,17
692,2023-02-01,SURGE,gemGrab,Gem Fort,242,193,435
693,2023-02-01,SURGE,gemGrab,Crystal Arcade,145,186,331
694,2023-02-01,SURGE,brawlBall,Sunny Soccer,1389,1478,2867
695,2023-02-01,SURGE,brawlBall,Beach Ball,44,53,97
696,2023-02-01,SURGE,bounty,Shooting Star,6,1,7
697,2023-01-31,SURGE,knockout,Goldarm Gulch,45,27,72
698,2023-01-31,SURGE,hotZone,Parallel Plays,181,149,330
699,2023-01-31,SURGE,heist,Pit Stop,21,34,55
700,2023-01-31,SURGE,gemGrab,Minecart Madness,2,1,3
701,2023-01-31,SURGE,gemGrab,Crystal Arcade,165,192,357
702,2023-01-31,SURGE,brawlBall,Center Stage,14,19,33
703,2023-01-31,SURGE,brawlBall,Beach Ball,571,545,1116
704,2023-01-31,SURGE,bounty,Hideout,8,1,9
705,2023-01-30,SURGE,knockout,Belle's Rock,51,18,69
706,2023-01-30,SURGE,hotZone,Quarter Pounder,193,108,301
707,2023-01-30,SURGE,heist,Pit Stop,114,88,202
708,2023-01-30,SURGE,gemGrab,Minecart Madness,58,42,100
709,2023-01-30,SURGE,gemGrab,Double Swoosh,246,240,486
710,2023-01-30,SURGE,brawlBall,Center Stage,1000,960,1960
711,2023-01-30,SURGE,brawlBall,Backyard Bowl,58,45,103
712,2023-01-30,SURGE,bounty,Hideout,11,2,13
713,2023-01-29,SURGE,knockout,Belle's Rock,49,21,70
714,2023-01-29,SURGE,hotZone,Quarter Pounder,121,67,188
715,2023-01-29,SURGE,heist,Bridge Too Far,5,1,6
716,2023-01-29,SURGE,gemGrab,Hard Rock Mine,68,69,137
717,2023-01-29,SURGE,gemGrab,Double Swoosh,374,313,687
718,2023-01-29,SURGE,brawlBall,Super Beach,48,49,97
719,2023-01-29,SURGE,brawlBall,Backyard Bowl,544,383,927
720,2023-01-29,SURGE,bounty,Canal Grande,166,155,321
721,2023-01-28,SURGE,knockout,Flaring Phoenix,60,40,100
722,2023-01-28,SURGE,hotZone,Controller Chaos,210,201,411
723,2023-01-28,SURGE,heist,Bridge Too Far,17,6,23
724,2023-01-28,SURGE,gemGrab,Hard Rock Mine,320,297,617
725,2023-01-28,SURGE,gemGrab,Deep Diner,92,91,183
726,2023-01-28,SURGE,brawlBall,Super Beach,2001,1929,3930
727,2023-01-28,SURGE,brawlBall,Sneaky Fields,117,159,276
728,2023-01-28,SURGE,bounty,Canal Grande,266,274,540
729,2023-01-27,SURGE,knockout,Flaring Phoenix,19,9,28
730,2023-01-27,SURGE,hotZone,Controller Chaos,77,91,168
731,2023-01-27,SURGE,heist,Hot Potato,10,6,16
732,2023-01-27,SURGE,gemGrab,Undermine,12,24,36
733,2023-01-27,SURGE,gemGrab,Deep Diner,103,84,187
734,2023-01-27,SURGE,brawlBall,Sneaky Fields,610,636,1246
735,2023-01-27,SURGE,brawlBall,Pinhole Punt,14,16,30
736,2023-01-27,SURGE,bounty,Temple Ruins,21,20,41
737,2023-01-26,SURGE,knockout,Riverside,24,5,29
738,2023-01-26,SURGE,hotZone,Open Zone,34,15,49
739,2023-01-26,SURGE,heist,Hot Potato,72,76,148
740,2023-01-26,SURGE,gemGrab,Undermine,191,137,328
741,2023-01-26,SURGE,gemGrab,Gem Fort,109,103,212
742,2023-01-26,SURGE,brawlBall,Sunny Soccer,108,129,237
743,2023-01-26,SURGE,brawlBall,Pinhole Punt,1034,866,1900
744,2023-01-26,SURGE,bounty,Temple Ruins,87,88,175
745,2023-01-25,SURGE,knockout,Riverside,11,3,14
746,2023-01-25,SURGE,hotZone,Open Zone,12,5,17
747,2023-01-25,SURGE,heist,Safe Zone,7,1,8
748,2023-01-25,SURGE,gemGrab,Gem Fort,118,79,197
749,2023-01-25,SURGE,gemGrab,Crystal Arcade,198,258,456
750,2023-01-25,SURGE,brawlBall,Sunny Soccer,1003,1024,2027
751,2023-01-25,SURGE,brawlBall,Beach Ball,128,143,271
752,2023-01-25,SURGE,bounty,Excel,34,68,102
753,2023-01-24,SURGE,knockout,New Perspective,51,28,79
754,2023-01-24,SURGE,hotZone,Dueling Beetles,79,32,111
755,2023-01-24,SURGE,heist,Safe Zone,13,7,20
756,2023-01-24,SURGE,gemGrab,Minecart Madness,24,16,40
757,2023-01-24,SURGE,gemGrab,Crystal Arcade,300,330,630
758,2023-01-24,SURGE,brawlBall,Center Stage,162,164,326
759,2023-01-24,SURGE,brawlBall,Beach Ball,1375,1472,2847
760,2023-01-24,SURGE,bounty,Excel,42,13,55
761,2023-01-23,SURGE,knockout,New Perspective,85,48,133
762,2023-01-23,SURGE,hotZone,Dueling Beetles,93,47,140
763,2023-01-23,SURGE,heist,Snaked Assault,66,32,98
764,2023-01-23,SURGE,gemGrab,Minecart Madness,103,62,165
765,2023-01-23,SURGE,gemGrab,Double Swoosh,200,168,368
766,2023-01-23,SURGE,brawlBall,Center Stage,1653,1518,3171
767,2023-01-23,SURGE,brawlBall,Backyard Bowl,33,21,54
768,2023-01-23,SURGE,bounty,Layer Cake,113,86,199
769,2023-01-22,SURGE,knockout,X Marks the Spot,29,14,43
770,2023-01-22,SURGE,hotZone,Ring of Fire,56,47,103
771,2023-01-22,SURGE,heist,Snaked Assault,28,16,44
772,2023-01-22,SURGE,gemGrab,Hard Rock Mine,92,128,220
773,2023-01-22,SURGE,gemGrab,Double Swoosh,193,146,339
774,2023-01-22,SURGE,brawlBall,Super Beach,178,149,327
775,2023-01-22,SURGE,brawlBall,Backyard Bowl,233,192,425
776,2023-01-22,SURGE,bounty,Layer Cake,46,39,85
777,2023-01-21,SURGE,knockout,X Marks the Spot,102,71,173
778,2023-01-21,SURGE,hotZone,Ring of Fire,63,34,97
779,2023-01-21,SURGE,heist,Tornado Ring,43,27,70
780,2023-01-21,SURGE,gemGrab,Hard Rock Mine,444,424,868
781,2023-01-21,SURGE,gemGrab,Deep Diner,62,65,127
782,2023-01-21,SURGE,brawlBall,Super Beach,2533,2464,4997
783,2023-01-21,SURGE,brawlBall,Sneaky Fields,115,104,219
784,2023-01-21,SURGE,bounty,Dry Season,28,9,37
785,2023-01-20,SURGE,knockout,Out in the Open,63,29,92
786,2023-01-20,SURGE,hotZone,Split,208,214,422
787,2023-01-20,SURGE,heist,Tornado Ring,56,45,101
788,2023-01-20,SURGE,gemGrab,Undermine,106,115,221
789,2023-01-20,SURGE,gemGrab,Deep Diner,286,338,624
790,2023-01-20,SURGE,brawlBall,Sneaky Fields,1845,1848,3693
791,2023-01-20,SURGE,brawlBall,Pinhole Punt,40,24,64
792,2023-01-20,SURGE,bounty,Dry Season,19,11,30
793,2023-01-19,SURGE,knockout,Out in the Open,83,38,121
794,2023-01-19,SURGE,hotZone,Split,422,489,911
795,2023-01-19,SURGE,heist,Kaboom Canyon,13,14,27
796,2023-01-19,SURGE,gemGrab,Undermine,208,166,374
797,2023-01-19,SURGE,gemGrab,Gem Fort,55,63,118
798,2023-01-19,SURGE,brawlBall,Sunny Soccer,57,47,104
799,2023-01-19,SURGE,brawlBall,Pinhole Punt,1179,989,2168
800,2023-01-19,SURGE,bounty,Shooting Star,19,10,29
801,2023-01-18,SURGE,knockout,Goldarm Gulch,12,6,18
802,2023-01-18,SURGE,hotZone,Parallel Plays,31,16,47
803,2023-01-18,SURGE,heist,Kaboom Canyon,2,1,3
804,2023-01-18,SURGE,gemGrab,Gem Fort,48,39,87
805,2023-01-18,SURGE,gemGrab,Crystal Arcade,26,38,64
806,2023-01-18,SURGE,brawlBall,Sunny Soccer,420,473,893
807,2023-01-18,SURGE,brawlBall,Beach Ball,12,17,29
808,2023-01-18,SURGE,bounty,Shooting Star,4,3,7
809,2023-01-17,SURGE,knockout,Goldarm Gulch,12,4,16
810,2023-01-17,SURGE,hotZone,Parallel Plays,34,41,75
811,2023-01-17,SURGE,heist,Pit Stop,10,15,25
812,2023-01-17,SURGE,gemGrab,Minecart Madness,1,0,1
813,2023-01-17,SURGE,gemGrab,Crystal Arcade,29,30,59
814,2023-01-17,SURGE,brawlBall,Center Stage,6,6,12
815,2023-01-17,SURGE,brawlBall,Beach Ball,131,126,257
816,2023-01-17,SURGE,bounty,Hideout,0,1,1
817,2023-01-16,SURGE,knockout,Belle's Rock,1,1,2
818,2023-01-16,SURGE,hotZone,Quarter Pounder,21,21,42
819,2023-01-16,SURGE,heist,Pit Stop,26,63,89
820,2023-01-16,SURGE,gemGrab,Minecart Madness,9,2,11
821,2023-01-16,SURGE,gemGrab,Double Swoosh,23,21,44
822,2023-01-16,SURGE,brawlBall,Center Stage,107,100,207
823,2023-01-16,SURGE,brawlBall,Backyard Bowl,9,4,13
824,2023-01-16,SURGE,bounty,Hideout,5,2,7
825,2023-01-15,SURGE,knockout,Belle's Rock,3,0,3
826,2023-01-15,SURGE,hotZone,Quarter Pounder,52,8,60
827,2023-01-15,SURGE,heist,Bridge Too Far,1,0,1
828,2023-01-15,SURGE,gemGrab,Hard Rock Mine,23,27,50
829,2023-01-15,SURGE,gemGrab,Double Swoosh,55,48,103
830,2023-01-15,SURGE,brawlBall,Super Beach,41,36,77
831,2023-01-15,SURGE,brawlBall,Backyard Bowl,66,41,107
832,2023-01-15,SURGE,bounty,Canal Grande,25,8,33
833,2023-01-14,SURGE,knockout,Flaring Phoenix,1,3,4
834,2023-01-14,SURGE,hotZone,Controller Chaos,76,62,138
835,2023-01-14,SURGE,gemGrab,Hard Rock Mine,28,23,51
836,2023-01-14,SURGE,gemGrab,Deep Diner,20,14,34
837,2023-01-14,SURGE,brawlBall,Super Beach,186,169,355
838,2023-01-14,SURGE,brawlBall,Sneaky Fields,37,24,61
839,2023-01-14,SURGE,bounty,Canal Grande,21,17,38
840,2023-01-13,SURGE,knockout,Flaring Phoenix,2,2,4
841,2023-01-13,SURGE,hotZone,Controller Chaos,87,75,162
842,2023-01-13,SURGE,heist,Hot Potato,5,2,7
843,2023-01-13,SURGE,gemGrab,Deep Diner,24,66,90
844,2023-01-13,SURGE,brawlBall,Sneaky Fields,201,151,352
845,2023-01-13,SURGE,brawlBall,Pinhole Punt,1,6,7
846,2023-01-13,SURGE,bounty,Temple Ruins,4,2,6
847,2023-01-12,SURGE,knockout,Riverside,3,0,3
848,2023-01-12,SURGE,hotZone,Open Zone,10,0,10
849,2023-01-12,SURGE,heist,Hot Potato,3,0,3
850,2023-01-12,SURGE,gemGrab,Undermine,6,6,12
851,2023-01-12,SURGE,gemGrab,Gem Fort,2,0,2
852,2023-01-12,SURGE,brawlBall,Sunny Soccer,4,0,4
853,2023-01-12,SURGE,brawlBall,Pinhole Punt,22,18,40
854,2023-01-11,SURGE,gemGrab,Gem Fort,8,3,11
855,2023-01-11,SURGE,brawlBall,Sunny Soccer,43,57,100
856,2023-01-11,SURGE,brawlBall,Beach Ball,1,0,1
857,2023-01-11,SURGE,bounty,Excel,1,0,1
858,2023-01-10,SURGE,knockout,New Perspective,2,0,2
859,2023-01-10,SURGE,hotZone,Dueling Beetles,17,7,24
860,2023-01-10,SURGE,heist,Safe Zone,0,1,1
861,2023-01-10,SURGE,gemGrab,Minecart Madness,4,5,9
862,2023-01-10,SURGE,gemGrab,Crystal Arcade,34,44,78
863,2023-01-10,SURGE,brawlBall,Center Stage,9,11,20
864,2023-01-10,SURGE,brawlBall,Beach Ball,89,84,173
865,2023-01-09,SURGE,knockout,New Perspective,3,0,3
866,2023-01-09,SURGE,hotZone,Dueling Beetles,7,0,7
867,2023-01-09,SURGE,heist,Snaked Assault,8,9,17
868,2023-01-09,SURGE,gemGrab,Minecart Madness,9,3,12
869,2023-01-09,SURGE,gemGrab,Double Swoosh,33,12,45
870,2023-01-09,SURGE,brawlBall,Center Stage,83,78,161
871,2023-01-09,SURGE,brawlBall,Backyard Bowl,3,1,4
872,2023-01-09,SURGE,bounty,Layer Cake,11,2,13
873,2023-01-08,SURGE,knockout,X Marks the Spot,3,0,3
874,2023-01-08,SURGE,hotZone,Ring of Fire,7,1,8
875,2023-01-08,SURGE,heist,Snaked Assault,2,2,4
876,2023-01-08,SURGE,gemGrab,Hard Rock Mine,11,19,30
877,2023-01-08,SURGE,gemGrab,Double Swoosh,17,4,21
878,2023-01-08,SURGE,brawlBall,Super Beach,20,14,34
879,2023-01-08,SURGE,brawlBall,Backyard Bowl,19,4,23
880,2023-01-08,SURGE,bounty,Layer Cake,4,0,4
881,2023-01-07,SURGE,hotZone,Ring of Fire,3,2,5
882,2023-01-07,SURGE,heist,Tornado Ring,5,0,5
883,2023-01-07,SURGE,gemGrab,Hard Rock Mine,16,10,26
884,2023-01-07,SURGE,gemGrab,Deep Diner,10,30,40
885,2023-01-07,SURGE,brawlBall,Super Beach,61,99,160
886,2023-01-07,SURGE,brawlBall,Sneaky Fields,7,10,17
887,2023-01-07,SURGE,bounty,Dry Season,1,0,1
888,2023-01-06,SURGE,hotZone,Split,31,33,64
889,2023-01-06,SURGE,heist,Tornado Ring,14,4,18
890,2023-01-06,SURGE,gemGrab,Undermine,4,7,11
891,2023-01-06,SURGE,gemGrab,Deep Diner,30,46,76
892,2023-01-06,SURGE,brawlBall,Sneaky Fields,109,100,209
893,2023-01-06,SURGE,brawlBall,Pinhole Punt,3,7,10
894,2023-01-06,SURGE,bounty,Dry Season,1,0,1
895,2023-01-05,SURGE,knockout,Out in the Open,4,1,5
896,2023-01-05,SURGE,hotZone,Split,106,98,204
897,2023-01-05,SURGE,heist,Kaboom Canyon,1,0,1
898,2023-01-05,SURGE,gemGrab,Undermine,21,45,66
899,2023-01-05,SURGE,gemGrab,Gem Fort,2,10,12
900,2023-01-05,SURGE,brawlBall,Sunny Soccer,3,4,7
901,2023-01-05,SURGE,brawlBall,Pinhole Punt,87,105,192
902,2023-01-04,SURGE,hotZone,Parallel Plays,18,14,32
903,2023-01-04,SURGE,heist,Kaboom Canyon,4,0,4
904,2023-01-04,SURGE,gemGrab,Gem Fort,32,9,41
905,2023-01-04,SURGE,gemGrab,Crystal Arcade,16,6,22
906,2023-01-04,SURGE,brawlBall,Sunny Soccer,149,111,260
907,2023-01-04,SURGE,brawlBall,Beach Ball,1,1,2
908,2023-01-04,SURGE,bounty,Shooting Star,3,0,3
909,2023-01-03,SURGE,knockout,Goldarm Gulch,2,0,2
910,2023-01-03,SURGE,hotZone,Parallel Plays,34,38,72
911,2023-01-03,SURGE,heist,Pit Stop,16,10,26
912,2023-01-03,SURGE,heist,Kaboom Canyon,0,1,1
913,2023-01-03,SURGE,gemGrab,Minecart Madness,7,0,7
914,2023-01-03,SURGE,gemGrab,Crystal Arcade,44,26,70
915,2023-01-03,SURGE,brawlBall,Center Stage,1,5,6
916,2023-01-03,SURGE,brawlBall,Beach Ball,104,100,204
917,2023-01-03,SURGE,bounty,Hideout,2,1,3
918,2023-01-02,SURGE,knockout,Belle's Rock,2,0,2
919,2023-01-02,SURGE,hotZone,Quarter Pounder,30,7,37
920,2023-01-02,SURGE,heist,Pit Stop,23,12,35
921,2023-01-02,SURGE,gemGrab,Minecart Madness,12,0,12
922,2023-01-02,SURGE,gemGrab,Double Swoosh,42,43,85
923,2023-01-02,SURGE,brawlBall,Center Stage,130,111,241
924,2023-01-02,SURGE,brawlBall,Backyard Bowl,5,0,5
925,2023-01-02,SURGE,bounty,Hideout,1,3,4
926,2023-01-01,SURGE,knockout,Belle's Rock,1,0,1
927,2023-01-01,SURGE,hotZone,Quarter Pounder,9,4,13
928,2023-01-01,SURGE,hotZone,Controller Chaos,1,1,2
929,2023-01-01,SURGE,gemGrab,Double Swoosh,24,27,51
930,2023-01-01,SURGE,brawlBall,Backyard Bowl,11,3,14
931,2023-01-01,SURGE,bounty,Canal Grande,3,0,3
932,2022-12-31,SURGE,hotZone,Controller Chaos,4,4,8
933,2022-12-31,SURGE,gemGrab,Hard Rock Mine,9,4,13
934,2022-12-31,SURGE,gemGrab,Deep Diner,3,2,5
935,2022-12-31,SURGE,brawlBall,Super Beach,16,25,41
936,2022-12-31,SURGE,brawlBall,Sneaky Fields,2,0,2
937,2022-12-31,SURGE,bounty,Canal Grande,0,1,1
938,2022-12-30,SURGE,hotZone,Controller Chaos,2,2,4
939,2022-12-30,SURGE,gemGrab,Undermine,2,0,2
940,2022-12-30,SURGE,gemGrab,Deep Diner,3,2,5
941,2022-12-30,SURGE,brawlBall,Sneaky Fields,6,4,10
942,2022-12-29,SURGE,heist,Hot Potato,0,2,2
943,2022-12-29,SURGE,gemGrab,Undermine,1,0,1
944,2022-12-29,SURGE,brawlBall,Pinhole Punt,4,0,4
945,2022-12-28,SURGE,brawlBall,Sunny Soccer,0,2,2
946,2022-12-27,SURGE,hotZone,Dueling Beetles,0,1,1
947,2022-12-27,SURGE,hotZone,Controller Chaos,0,1,1
948,2022-12-27,SURGE,gemGrab,Minecart Madness,1,0,1
949,2022-12-27,SURGE,brawlBall,Center Stage,0,1,1
950,2022-12-27,SURGE,brawlBall,Beach Ball,1,1,2
951,2022-12-26,SURGE,hotZone,Controller Chaos,0,1,1
952,2022-12-26,SURGE,heist,Kaboom Canyon,1,0,1
953,2022-12-26,SURGE,brawlBall,Center Stage,0,1,1
954,2022-12-25,SURGE,gemGrab,Double Swoosh,0,1,1
955,2022-12-24,SURGE,brawlBall,Super Beach,0,1,1
956,2022-12-21,SURGE,brawlBall,Sunny Soccer,3,1,4
957,2022-12-20,SURGE,brawlBall,Beach Ball,0,1,1
958,2022-12-19,SURGE,brawlBall,Center Stage,1,1,2
959,2022-12-16,SURGE,hotZone,Controller Chaos,1,0,1
960,2022-12-16,SURGE,brawlBall,Sneaky Fields,0,2,2
961,2022-12-16,SURGE,bounty,Temple Ruins,1,0,1
962,2022-12-13,SURGE,brawlBall,Beach Ball,1,0,1
963,2022-12-11,SURGE,gemGrab,Double Swoosh,1,0,1
964,2022-11-11,SURGE,brawlBall,Sneaky Fields,0,1,1
965,2022-10-30,SURGE,brawlBall,Beach Ball,0,2,2
966,2022-10-26,SURGE,brawlBall,Sunny Soccer,1,0,1
967,2022-10-15,SURGE,gemGrab,Hard Rock Mine,1,0,1
968,2022-10-15,SURGE,brawlBall,Super Beach,0,1,1
969,2023-02-05,STU,knockout,X Marks the Spot,41,22,63
970,2023-02-05,STU,knockout,Goldarm Gulch,6,5,11
971,2023-02-05,STU,hotZone,Ring of Fire,67,117,184
972,2023-02-05,STU,heist,Snaked Assault,7,5,12
973,2023-02-05,STU,heist,Pit Stop,10,5,15
974,2023-02-05,STU,gemGrab,Hard Rock Mine,45,53,98
975,2023-02-05,STU,gemGrab,Double Swoosh,124,130,254
976,2023-02-05,STU,brawlBall,Super Beach,43,40,83
977,2023-02-05,STU,brawlBall,Sneaky Fields,17,7,24
978,2023-02-05,STU,brawlBall,Backyard Bowl,1505,1531,3036
979,2023-02-05,STU,bounty,Layer Cake,45,34,79
980,2023-02-04,STU,knockout,X Marks the Spot,13,11,24
981,2023-02-04,STU,knockout,Goldarm Gulch,10,5,15
982,2023-02-04,STU,hotZone,Ring of Fire,24,39,63
983,2023-02-04,STU,heist,Tornado Ring,1,0,1
984,2023-02-04,STU,heist,Pit Stop,10,11,21
985,2023-02-04,STU,gemGrab,Hard Rock Mine,46,48,94
986,2023-02-04,STU,gemGrab,Double Swoosh,26,30,56
987,2023-02-04,STU,gemGrab,Deep Diner,25,40,65
988,2023-02-04,STU,brawlBall,Super Beach,328,296,624
989,2023-02-04,STU,brawlBall,Sneaky Fields,15,6,21
990,2023-02-04,STU,bounty,Dry Season,10,4,14
991,2023-02-03,STU,knockout,Out in the Open,120,78,198
992,2023-02-03,STU,knockout,Goldarm Gulch,44,12,56
993,2023-02-03,STU,hotZone,Split,160,262,422
994,2023-02-03,STU,heist,Tornado Ring,16,2,18
995,2023-02-03,STU,heist,Pit Stop,59,50,109
996,2023-02-03,STU,gemGrab,Undermine,30,21,51
997,2023-02-03,STU,gemGrab,Double Swoosh,146,150,296
998,2023-02-03,STU,gemGrab,Deep Diner,405,483,888
999,2023-02-03,STU,brawlBall,Sneaky Fields,649,564,1213
1000,2023-02-03,STU,brawlBall,Pinhole Punt,50,54,104
1001,2023-02-03,STU,bounty,Dry Season,98,84,182
1002,2023-02-02,STU,knockout,Out in the Open,36,36,72
1003,2023-02-02,STU,hotZone,Split,79,111,190
1004,2023-02-02,STU,heist,Kaboom Canyon,2,2,4
1005,2023-02-02,STU,gemGrab,Undermine,14,17,31
1006,2023-02-02,STU,gemGrab,Gem Fort,5,7,12
1007,2023-02-02,STU,brawlBall,Sunny Soccer,13,24,37
1008,2023-02-02,STU,brawlBall,Pinhole Punt,355,353,708
1009,2023-02-02,STU,bounty,Shooting Star,7,5,12
1010,2023-02-01,STU,knockout,Goldarm Gulch,80,65,145
1011,2023-02-01,STU,hotZone,Parallel Plays,223,311,534
1012,2023-02-01,STU,heist,Kaboom Canyon,7,14,21
1013,2023-02-01,STU,gemGrab,Gem Fort,83,48,131
1014,2023-02-01,STU,gemGrab,Crystal Arcade,106,119,225
1015,2023-02-01,STU,brawlBall,Sunny Soccer,947,958,1905
1016,2023-02-01,STU,brawlBall,Beach Ball,35,37,72
1017,2023-02-01,STU,bounty,Shooting Star,23,8,31
1018,2023-01-31,STU,knockout,Goldarm Gulch,47,19,66
1019,2023-01-31,STU,hotZone,Parallel Plays,89,108,197
1020,2023-01-31,STU,heist,Pit Stop,5,4,9
1021,2023-01-31,STU,gemGrab,Minecart Madness,9,14,23
1022,2023-01-31,STU,gemGrab,Crystal Arcade,75,67,142
1023,2023-01-31,STU,brawlBall,Center Stage,6,6,12
1024,2023-01-31,STU,brawlBall,Beach Ball,515,604,1119
1025,2023-01-31,STU,bounty,Hideout,23,6,29
1026,2023-01-30,STU,knockout,Belle's Rock,130,84,214
1027,2023-01-30,STU,hotZone,Quarter Pounder,252,433,685
1028,2023-01-30,STU,heist,Pit Stop,20,10,30
1029,2023-01-30,STU,gemGrab,Minecart Madness,106,125,231
1030,2023-01-30,STU,gemGrab,Double Swoosh,55,69,124
1031,2023-01-30,STU,brawlBall,Center Stage,431,370,801
1032,2023-01-30,STU,brawlBall,Backyard Bowl,117,116,233
1033,2023-01-30,STU,bounty,Hideout,27,12,39
1034,2023-01-29,STU,knockout,Belle's Rock,95,74,169
1035,2023-01-29,STU,hotZone,Quarter Pounder,296,397,693
1036,2023-01-29,STU,heist,Bridge Too Far,8,2,10
1037,2023-01-29,STU,gemGrab,Hard Rock Mine,26,30,56
1038,2023-01-29,STU,gemGrab,Double Swoosh,87,67,154
1039,2023-01-29,STU,brawlBall,Super Beach,30,24,54
1040,2023-01-29,STU,brawlBall,Backyard Bowl,1557,1647,3204
1041,2023-01-29,STU,bounty,Canal Grande,27,34,61
1042,2023-01-28,STU,knockout,Flaring Phoenix,43,40,83
1043,2023-01-28,STU,hotZone,Controller Chaos,208,308,516
1044,2023-01-28,STU,heist,Bridge Too Far,17,4,21
1045,2023-01-28,STU,gemGrab,Hard Rock Mine,163,160,323
1046,2023-01-28,STU,gemGrab,Deep Diner,99,153,252
1047,2023-01-28,STU,brawlBall,Super Beach,1392,1454,2846
1048,2023-01-28,STU,brawlBall,Sneaky Fields,24,14,38
1049,2023-01-28,STU,bounty,Canal Grande,47,65,112
1050,2023-01-27,STU,knockout,Flaring Phoenix,35,21,56
1051,2023-01-27,STU,hotZone,Controller Chaos,46,72,118
1052,2023-01-27,STU,heist,Hot Potato,9,5,14
1053,2023-01-27,STU,gemGrab,Undermine,9,7,16
1054,2023-01-27,STU,gemGrab,Deep Diner,128,172,300
1055,2023-01-27,STU,brawlBall,Sneaky Fields,163,125,288
1056,2023-01-27,STU,brawlBall,Pinhole Punt,12,15,27
1057,2023-01-27,STU,bounty,Temple Ruins,17,8,25
1058,2023-01-26,STU,knockout,Riverside,47,19,66
1059,2023-01-26,STU,hotZone,Open Zone,200,245,445
1060,2023-01-26,STU,heist,Hot Potato,16,12,28
1061,2023-01-26,STU,gemGrab,Undermine,62,56,118
1062,2023-01-26,STU,gemGrab,Gem Fort,28,13,41
1063,2023-01-26,STU,brawlBall,Sunny Soccer,51,46,97
1064,2023-01-26,STU,brawlBall,Pinhole Punt,1114,1118,2232
1065,2023-01-26,STU,bounty,Temple Ruins,25,21,46
1066,2023-01-25,STU,knockout,Riverside,10,2,12
1067,2023-01-25,STU,hotZone,Open Zone,124,111,235
1068,2023-01-25,STU,heist,Safe Zone,6,10,16
1069,2023-01-25,STU,gemGrab,Gem Fort,36,30,66
1070,2023-01-25,STU,gemGrab,Crystal Arcade,102,106,208
1071,2023-01-25,STU,brawlBall,Sunny Soccer,713,717,1430
1072,2023-01-25,STU,brawlBall,Beach Ball,108,121,229
1073,2023-01-25,STU,bounty,Excel,36,42,78
1074,2023-01-24,STU,knockout,New Perspective,99,77,176
1075,2023-01-24,STU,hotZone,Dueling Beetles,114,161,275
1076,2023-01-24,STU,heist,Safe Zone,24,11,35
1077,2023-01-24,STU,gemGrab,Minecart Madness,35,44,79
1078,2023-01-24,STU,gemGrab,Crystal Arcade,171,126,297
1079,2023-01-24,STU,brawlBall,Center Stage,54,35,89
1080,2023-01-24,STU,brawlBall,Beach Ball,1256,1453,2709
1081,2023-01-24,STU,bounty,Excel,53,55,108
1082,2023-01-23,STU,knockout,New Perspective,143,85,228
1083,2023-01-23,STU,hotZone,Dueling Beetles,264,264,528
1084,2023-01-23,STU,heist,Snaked Assault,13,3,16
1085,2023-01-23,STU,gemGrab,Minecart Madness,166,205,371
1086,2023-01-23,STU,gemGrab,Double Swoosh,35,25,60
1087,2023-01-23,STU,brawlBall,Center Stage,716,614,1330
1088,2023-01-23,STU,brawlBall,Backyard Bowl,100,81,181
1089,2023-01-23,STU,bounty,Layer Cake,86,47,133
1090,2023-01-22,STU,knockout,X Marks the Spot,41,13,54
1091,2023-01-22,STU,hotZone,Ring of Fire,31,61,92
1092,2023-01-22,STU,heist,Snaked Assault,3,3,6
1093,2023-01-22,STU,gemGrab,Hard Rock Mine,48,58,106
1094,2023-01-22,STU,gemGrab,Double Swoosh,46,50,96
1095,2023-01-22,STU,brawlBall,Super Beach,124,158,282
1096,2023-01-22,STU,brawlBall,Backyard Bowl,784,792,1576
1097,2023-01-22,STU,bounty,Layer Cake,45,33,78
1098,2023-01-21,STU,knockout,X Marks the Spot,112,45,157
1099,2023-01-21,STU,hotZone,Ring of Fire,120,143,263
1100,2023-01-21,STU,heist,Tornado Ring,11,9,20
1101,2023-01-21,STU,gemGrab,Hard Rock Mine,257,302,559
1102,2023-01-21,STU,gemGrab,Deep Diner,71,83,154
1103,2023-01-21,STU,brawlBall,Super Beach,1780,1884,3664
1104,2023-01-21,STU,brawlBall,Sneaky Fields,29,28,57
1105,2023-01-21,STU,bounty,Dry Season,81,107,188
1106,2023-01-20,STU,knockout,Out in the Open,106,63,169
1107,2023-01-20,STU,hotZone,Split,207,316,523
1108,2023-01-20,STU,heist,Tornado Ring,6,8,14
1109,2023-01-20,STU,gemGrab,Undermine,25,40,65
1110,2023-01-20,STU,gemGrab,Deep Diner,364,506,870
1111,2023-01-20,STU,brawlBall,Sneaky Fields,504,424,928
1112,2023-01-20,STU,brawlBall,Pinhole Punt,66,72,138
1113,2023-01-20,STU,bounty,Dry Season,61,29,90
1114,2023-01-19,STU,knockout,Out in the Open,114,66,180
1115,2023-01-19,STU,hotZone,Split,348,541,889
1116,2023-01-19,STU,heist,Kaboom Canyon,18,20,38
1117,2023-01-19,STU,gemGrab,Undermine,88,66,154
1118,2023-01-19,STU,gemGrab,Gem Fort,19,14,33
1119,2023-01-19,STU,brawlBall,Sunny Soccer,40,51,91
1120,2023-01-19,STU,brawlBall,Pinhole Punt,1198,1166,2364
1121,2023-01-19,STU,bounty,Shooting Star,30,16,46
1122,2023-01-18,STU,knockout,Goldarm Gulch,12,10,22
1123,2023-01-18,STU,hotZone,Parallel Plays,28,29,57
1124,2023-01-18,STU,heist,Kaboom Canyon,3,0,3
1125,2023-01-18,STU,gemGrab,Gem Fort,17,35,52
1126,2023-01-18,STU,gemGrab,Crystal Arcade,10,40,50
1127,2023-01-18,STU,brawlBall,Sunny Soccer,288,264,552
1128,2023-01-18,STU,brawlBall,Beach Ball,10,15,25
1129,2023-01-18,STU,bounty,Shooting Star,11,10,21
1130,2023-01-17,STU,knockout,Goldarm Gulch,7,8,15
1131,2023-01-17,STU,hotZone,Parallel Plays,31,40,71
1132,2023-01-17,STU,heist,Pit Stop,3,0,3
1133,2023-01-17,STU,gemGrab,Minecart Madness,2,0,2
1134,2023-01-17,STU,gemGrab,Crystal Arcade,26,21,47
1135,2023-01-17,STU,brawlBall,Center Stage,2,0,2
1136,2023-01-17,STU,brawlBall,Beach Ball,106,98,204
1137,2023-01-17,STU,bounty,Hideout,3,1,4
1138,2023-01-16,STU,knockout,Belle's Rock,13,9,22
1139,2023-01-16,STU,hotZone,Quarter Pounder,32,90,122
1140,2023-01-16,STU,heist,Pit Stop,4,0,4
1141,2023-01-16,STU,gemGrab,Minecart Madness,20,14,34
1142,2023-01-16,STU,gemGrab,Double Swoosh,5,1,6
1143,2023-01-16,STU,brawlBall,Center Stage,43,37,80
1144,2023-01-16,STU,brawlBall,Backyard Bowl,24,34,58
1145,2023-01-16,STU,bounty,Hideout,10,2,12
1146,2023-01-15,STU,knockout,Belle's Rock,17,5,22
1147,2023-01-15,STU,hotZone,Quarter Pounder,64,143,207
1148,2023-01-15,STU,gemGrab,Hard Rock Mine,16,8,24
1149,2023-01-15,STU,gemGrab,Double Swoosh,8,1,9
1150,2023-01-15,STU,brawlBall,Super Beach,18,14,32
1151,2023-01-15,STU,brawlBall,Backyard Bowl,235,280,515
1152,2023-01-15,STU,bounty,Canal Grande,7,9,16
1153,2023-01-14,STU,knockout,Flaring Phoenix,5,1,6
1154,2023-01-14,STU,hotZone,Controller Chaos,39,62,101
1155,2023-01-14,STU,gemGrab,Hard Rock Mine,23,21,44
1156,2023-01-14,STU,gemGrab,Deep Diner,13,13,26
1157,2023-01-14,STU,brawlBall,Super Beach,107,89,196
1158,2023-01-14,STU,brawlBall,Sneaky Fields,11,7,18
1159,2023-01-14,STU,bounty,Canal Grande,2,0,2
1160,2023-01-13,STU,knockout,Flaring Phoenix,10,0,10
1161,2023-01-13,STU,hotZone,Controller Chaos,41,55,96
1162,2023-01-13,STU,gemGrab,Deep Diner,37,24,61
1163,2023-01-13,STU,brawlBall,Sneaky Fields,24,14,38
1164,2023-01-13,STU,brawlBall,Pinhole Punt,3,3,6
1165,2023-01-13,STU,bounty,Temple Ruins,2,0,2
1166,2023-01-12,STU,knockout,Riverside,1,0,1
1167,2023-01-12,STU,hotZone,Open Zone,32,17,49
1168,2023-01-12,STU,gemGrab,Undermine,3,3,6
1169,2023-01-12,STU,brawlBall,Sunny Soccer,4,0,4
1170,2023-01-12,STU,brawlBall,Pinhole Punt,42,40,82
1171,2023-01-11,STU,knockout,Riverside,1,0,1
1172,2023-01-11,STU,hotZone,Open Zone,8,12,20
1173,2023-01-11,STU,gemGrab,Gem Fort,2,3,5
1174,2023-01-11,STU,brawlBall,Sunny Soccer,32,43,75
1175,2023-01-11,STU,bounty,Excel,3,7,10
1176,2023-01-10,STU,knockout,New Perspective,8,1,9
1177,2023-01-10,STU,hotZone,Dueling Beetles,27,10,37
1178,2023-01-10,STU,heist,Safe Zone,0,2,2
1179,2023-01-10,STU,gemGrab,Minecart Madness,5,4,9
1180,2023-01-10,STU,gemGrab,Crystal Arcade,24,12,36
1181,2023-01-10,STU,brawlBall,Center Stage,5,0,5
1182,2023-01-10,STU,brawlBall,Beach Ball,99,97,196
1183,2023-01-10,STU,bounty,Excel,1,1,2
1184,2023-01-09,STU,knockout,New Perspective,3,1,4
1185,2023-01-09,STU,hotZone,Dueling Beetles,16,25,41
1186,2023-01-09,STU,heist,Snaked Assault,1,0,1
1187,2023-01-09,STU,gemGrab,Minecart Madness,20,12,32
1188,2023-01-09,STU,gemGrab,Double Swoosh,10,9,19
1189,2023-01-09,STU,brawlBall,Center Stage,35,14,49
1190,2023-01-09,STU,brawlBall,Backyard Bowl,3,5,8
1191,2023-01-09,STU,bounty,Layer Cake,7,20,27
1192,2023-01-08,STU,knockout,X Marks the Spot,3,2,5
1193,2023-01-08,STU,hotZone,Ring of Fire,7,17,24
1194,2023-01-08,STU,heist,Snaked Assault,2,0,2
1195,2023-01-08,STU,gemGrab,Hard Rock Mine,5,7,12
1196,2023-01-08,STU,gemGrab,Double Swoosh,3,5,8
1197,2023-01-08,STU,brawlBall,Super Beach,7,8,15
1198,2023-01-08,STU,brawlBall,Backyard Bowl,99,94,193
1199,2023-01-08,STU,bounty,Layer Cake,1,3,4
1200,2023-01-07,STU,knockout,X Marks the Spot,2,0,2
1201,2023-01-07,STU,hotZone,Ring of Fire,5,19,24
1202,2023-01-07,STU,gemGrab,Hard Rock Mine,13,38,51
1203,2023-01-07,STU,gemGrab,Deep Diner,13,1,14
1204,2023-01-07,STU,brawlBall,Super Beach,38,35,73
1205,2023-01-07,STU,brawlBall,Sneaky Fields,2,7,9
1206,2023-01-07,STU,bounty,Dry Season,3,0,3
1207,2023-01-06,STU,knockout,Out in the Open,5,4,9
1208,2023-01-06,STU,hotZone,Split,24,67,91
1209,2023-01-06,STU,heist,Tornado Ring,1,0,1
1210,2023-01-06,STU,gemGrab,Undermine,2,1,3
1211,2023-01-06,STU,gemGrab,Deep Diner,49,42,91
1212,2023-01-06,STU,brawlBall,Sneaky Fields,32,22,54
1213,2023-01-06,STU,brawlBall,Pinhole Punt,5,6,11
1214,2023-01-06,STU,bounty,Dry Season,6,2,8
1215,2023-01-05,STU,knockout,Out in the Open,10,4,14
1216,2023-01-05,STU,hotZone,Split,75,111,186
1217,2023-01-05,STU,heist,Kaboom Canyon,1,0,1
1218,2023-01-05,STU,gemGrab,Undermine,10,4,14
1219,2023-01-05,STU,gemGrab,Gem Fort,1,1,2
1220,2023-01-05,STU,brawlBall,Sunny Soccer,1,6,7
1221,2023-01-05,STU,brawlBall,Pinhole Punt,116,143,259
1222,2023-01-04,STU,knockout,Goldarm Gulch,0,2,2
1223,2023-01-04,STU,hotZone,Parallel Plays,18,29,47
1224,2023-01-04,STU,heist,Kaboom Canyon,4,1,5
1225,2023-01-04,STU,gemGrab,Gem Fort,10,5,15
1226,2023-01-04,STU,gemGrab,Crystal Arcade,7,12,19
1227,2023-01-04,STU,brawlBall,Sunny Soccer,109,134,243
1228,2023-01-04,STU,brawlBall,Beach Ball,1,1,2
1229,2023-01-04,STU,bounty,Shooting Star,3,2,5
1230,2023-01-03,STU,knockout,Goldarm Gulch,4,0,4
1231,2023-01-03,STU,hotZone,Parallel Plays,29,22,51
1232,2023-01-03,STU,heist,Pit Stop,1,0,1
1233,2023-01-03,STU,gemGrab,Minecart Madness,3,6,9
1234,2023-01-03,STU,gemGrab,Crystal Arcade,29,78,107
1235,2023-01-03,STU,brawlBall,Center Stage,2,11,13
1236,2023-01-03,STU,brawlBall,Beach Ball,150,178,328
1237,2023-01-03,STU,bounty,Hideout,9,1,10
1238,2023-01-02,STU,knockout,Belle's Rock,8,1,9
1239,2023-01-02,STU,hotZone,Quarter Pounder,52,65,117
1240,2023-01-02,STU,heist,Pit Stop,2,0,2
1241,2023-01-02,STU,gemGrab,Minecart Madness,25,28,53
1242,2023-01-02,STU,gemGrab,Double Swoosh,7,2,9
1243,2023-01-02,STU,brawlBall,Center Stage,46,37,83
1244,2023-01-02,STU,brawlBall,Backyard Bowl,17,12,29
1245,2023-01-02,STU,bounty,Hideout,7,9,16
1246,2023-01-01,STU,knockout,Belle's Rock,3,0,3
1247,2023-01-01,STU,hotZone,Quarter Pounder,20,17,37
1248,2023-01-01,STU,hotZone,Controller Chaos,0,1,1
1249,2023-01-01,STU,heist,Kaboom Canyon,0,1,1
1250,2023-01-01,STU,heist,Bridge Too Far,0,1,1
1251,2023-01-01,STU,gemGrab,Minecart Madness,0,1,1
1252,2023-01-01,STU,gemGrab,Double Swoosh,5,4,9
1253,2023-01-01,STU,brawlBall,Backyard Bowl,55,91,146
1254,2023-01-01,STU,bounty,Canal Grande,1,0,1
1255,2022-12-31,STU,knockout,Flaring Phoenix,1,0,1
1256,2022-12-31,STU,hotZone,Controller Chaos,2,1,3
1257,2022-12-31,STU,gemGrab,Minecart Madness,1,0,1
1258,2022-12-31,STU,gemGrab,Hard Rock Mine,8,23,31
1259,2022-12-31,STU,gemGrab,Deep Diner,5,8,13
1260,2022-12-31,STU,brawlBall,Super Beach,13,9,22
1261,2022-12-31,STU,brawlBall,Sneaky Fields,1,0,1
1262,2022-12-30,STU,knockout,Flaring Phoenix,1,0,1
1263,2022-12-30,STU,hotZone,Controller Chaos,4,1,5
1264,2022-12-30,STU,gemGrab,Undermine,0,1,1
1265,2022-12-30,STU,gemGrab,Minecart Madness,1,0,1
1266,2022-12-30,STU,gemGrab,Deep Diner,10,7,17
1267,2022-12-30,STU,brawlBall,Sneaky Fields,6,2,8
1268,2022-12-29,STU,hotZone,Open Zone,1,1,2
1269,2022-12-29,STU,gemGrab,Minecart Madness,0,1,1
1270,2022-12-29,STU,brawlBall,Pinhole Punt,6,1,7
1271,2022-12-28,STU,hotZone,Open Zone,4,0,4
1272,2022-12-27,STU,hotZone,Controller Chaos,0,2,2
1273,2022-12-27,STU,brawlBall,Center Stage,1,0,1
1274,2022-12-27,STU,brawlBall,Beach Ball,3,3,6
1275,2022-12-26,STU,hotZone,Controller Chaos,1,1,2
1276,2022-12-26,STU,brawlBall,Center Stage,1,0,1
1277,2022-12-25,STU,hotZone,Ring of Fire,1,0,1
1278,2022-12-25,STU,brawlBall,Backyard Bowl,2,0,2
1279,2022-12-24,STU,brawlBall,Super Beach,1,0,1
1280,2022-12-23,STU,knockout,Out in the Open,2,1,3
1281,2022-12-22,STU,brawlBall,Pinhole Punt,3,2,5
1282,2022-12-21,STU,brawlBall,Sunny Soccer,0,1,1
1283,2022-12-19,STU,brawlBall,Center Stage,1,1,2
1284,2022-12-16,STU,brawlBall,Sneaky Fields,0,2,2
1285,2022-12-13,STU,brawlBall,Beach Ball,0,1,1
1286,2022-11-03,STU,brawlBall,Pinhole Punt,0,1,1
1287,2022-10-30,STU,brawlBall,Beach Ball,0,2,2
1288,2022-10-15,STU,gemGrab,Hard Rock Mine,4,2,6
1289,2022-10-10,STU,knockout,Belle's Rock,1,0,1
1290,2023-02-05,SQUEAK,knockout,X Marks the Spot,44,28,72
1291,2023-02-05,SQUEAK,knockout,Goldarm Gulch,4,2,6
1292,2023-02-05,SQUEAK,hotZone,Ring of Fire,83,67,150
1293,2023-02-05,SQUEAK,heist,Snaked Assault,19,11,30
1294,2023-02-05,SQUEAK,heist,Pit Stop,4,2,6
1295,2023-02-05,SQUEAK,gemGrab,Hard Rock Mine,11,14,25
1296,2023-02-05,SQUEAK,gemGrab,Double Swoosh,95,104,199
1297,2023-02-05,SQUEAK,brawlBall,Super Beach,8,14,22
1298,2023-02-05,SQUEAK,brawlBall,Sneaky Fields,8,9,17
1299,2023-02-05,SQUEAK,brawlBall,Backyard Bowl,119,113,232
1300,2023-02-05,SQUEAK,bounty,Layer Cake,25,21,46
1301,2023-02-04,SQUEAK,knockout,X Marks the Spot,14,15,29
1302,2023-02-04,SQUEAK,knockout,Goldarm Gulch,3,3,6
1303,2023-02-04,SQUEAK,hotZone,Ring of Fire,31,20,51
1304,2023-02-04,SQUEAK,heist,Tornado Ring,3,0,3
1305,2023-02-04,SQUEAK,heist,Pit Stop,3,1,4
1306,2023-02-04,SQUEAK,gemGrab,Hard Rock Mine,13,15,28
1307,2023-02-04,SQUEAK,gemGrab,Double Swoosh,16,9,25
1308,2023-02-04,SQUEAK,gemGrab,Deep Diner,10,6,16
1309,2023-02-04,SQUEAK,brawlBall,Super Beach,63,64,127
1310,2023-02-04,SQUEAK,brawlBall,Sneaky Fields,11,7,18
1311,2023-02-04,SQUEAK,bounty,Dry Season,11,7,18
1312,2023-02-03,SQUEAK,knockout,Out in the Open,127,136,263
1313,2023-02-03,SQUEAK,knockout,Goldarm Gulch,23,7,30
1314,2023-02-03,SQUEAK,hotZone,Split,39,32,71
1315,2023-02-03,SQUEAK,heist,Tornado Ring,24,16,40
1316,2023-02-03,SQUEAK,heist,Pit Stop,16,10,26
1317,2023-02-03,SQUEAK,gemGrab,Undermine,18,15,33
1318,2023-02-03,SQUEAK,gemGrab,Double Swoosh,93,95,188
1319,2023-02-03,SQUEAK,gemGrab,Deep Diner,125,109,234
1320,2023-02-03,SQUEAK,brawlBall,Sneaky Fields,329,335,664
1321,2023-02-03,SQUEAK,brawlBall,Pinhole Punt,10,2,12
1322,2023-02-03,SQUEAK,bounty,Dry Season,64,52,116
1323,2023-02-02,SQUEAK,knockout,Out in the Open,47,60,107
1324,2023-02-02,SQUEAK,hotZone,Split,13,7,20
1325,2023-02-02,SQUEAK,heist,Kaboom Canyon,6,5,11
1326,2023-02-02,SQUEAK,gemGrab,Undermine,15,19,34
1327,2023-02-02,SQUEAK,gemGrab,Gem Fort,10,4,14
1328,2023-02-02,SQUEAK,brawlBall,Sunny Soccer,3,2,5
1329,2023-02-02,SQUEAK,brawlBall,Pinhole Punt,52,60,112
1330,2023-02-02,SQUEAK,bounty,Shooting Star,4,3,7
1331,2023-02-01,SQUEAK,knockout,Goldarm Gulch,76,52,128
1332,2023-02-01,SQUEAK,hotZone,Parallel Plays,70,84,154
1333,2023-02-01,SQUEAK,heist,Kaboom Canyon,21,12,33
1334,2023-02-01,SQUEAK,gemGrab,Gem Fort,60,42,102
1335,2023-02-01,SQUEAK,gemGrab,Crystal Arcade,49,41,90
1336,2023-02-01,SQUEAK,brawlBall,Sunny Soccer,221,277,498
1337,2023-02-01,SQUEAK,brawlBall,Beach Ball,9,17,26
1338,2023-02-01,SQUEAK,bounty,Shooting Star,19,9,28
1339,2023-01-31,SQUEAK,knockout,Goldarm Gulch,33,28,61
1340,2023-01-31,SQUEAK,hotZone,Parallel Plays,52,49,101
1341,2023-01-31,SQUEAK,heist,Pit Stop,8,2,10
1342,2023-01-31,SQUEAK,gemGrab,Minecart Madness,19,24,43
1343,2023-01-31,SQUEAK,gemGrab,Crystal Arcade,51,50,101
1344,2023-01-31,SQUEAK,brawlBall,Center Stage,2,4,6
1345,2023-01-31,SQUEAK,brawlBall,Beach Ball,114,115,229
1346,2023-01-31,SQUEAK,bounty,Hideout,10,10,20
1347,2023-01-30,SQUEAK,knockout,Belle's Rock,155,153,308
1348,2023-01-30,SQUEAK,hotZone,Quarter Pounder,100,134,234
1349,2023-01-30,SQUEAK,heist,Pit Stop,5,2,7
1350,2023-01-30,SQUEAK,gemGrab,Minecart Madness,120,128,248
1351,2023-01-30,SQUEAK,gemGrab,Double Swoosh,43,66,109
1352,2023-01-30,SQUEAK,brawlBall,Center Stage,155,161,316
1353,2023-01-30,SQUEAK,brawlBall,Backyard Bowl,15,7,22
1354,2023-01-30,SQUEAK,bounty,Hideout,19,20,39
1355,2023-01-29,SQUEAK,knockout,Belle's Rock,125,137,262
1356,2023-01-29,SQUEAK,hotZone,Quarter Pounder,62,74,136
1357,2023-01-29,SQUEAK,heist,Bridge Too Far,29,16,45
1358,2023-01-29,SQUEAK,gemGrab,Hard Rock Mine,17,7,24
1359,2023-01-29,SQUEAK,gemGrab,Double Swoosh,96,102,198
1360,2023-01-29,SQUEAK,brawlBall,Super Beach,1,1,2
1361,2023-01-29,SQUEAK,brawlBall,Backyard Bowl,129,176,305
1362,2023-01-29,SQUEAK,bounty,Canal Grande,48,83,131
1363,2023-01-28,SQUEAK,knockout,Flaring Phoenix,37,24,61
1364,2023-01-28,SQUEAK,hotZone,Controller Chaos,119,196,315
1365,2023-01-28,SQUEAK,heist,Bridge Too Far,64,52,116
1366,2023-01-28,SQUEAK,gemGrab,Hard Rock Mine,42,37,79
1367,2023-01-28,SQUEAK,gemGrab,Deep Diner,47,53,100
1368,2023-01-28,SQUEAK,brawlBall,Super Beach,190,232,422
1369,2023-01-28,SQUEAK,brawlBall,Sneaky Fields,4,8,12
1370,2023-01-28,SQUEAK,bounty,Canal Grande,65,112,177
1371,2023-01-27,SQUEAK,knockout,Flaring Phoenix,14,16,30
1372,2023-01-27,SQUEAK,hotZone,Controller Chaos,28,15,43
1373,2023-01-27,SQUEAK,heist,Hot Potato,11,6,17
1374,2023-01-27,SQUEAK,gemGrab,Undermine,4,2,6
1375,2023-01-27,SQUEAK,gemGrab,Deep Diner,42,25,67
1376,2023-01-27,SQUEAK,brawlBall,Sneaky Fields,72,75,147
1377,2023-01-27,SQUEAK,brawlBall,Pinhole Punt,2,2,4
1378,2023-01-27,SQUEAK,bounty,Temple Ruins,9,5,14
1379,2023-01-26,SQUEAK,knockout,Riverside,64,53,117
1380,2023-01-26,SQUEAK,hotZone,Open Zone,36,37,73
1381,2023-01-26,SQUEAK,heist,Hot Potato,21,13,34
1382,2023-01-26,SQUEAK,gemGrab,Undermine,40,15,55
1383,2023-01-26,SQUEAK,gemGrab,Gem Fort,16,14,30
1384,2023-01-26,SQUEAK,brawlBall,Sunny Soccer,17,16,33
1385,2023-01-26,SQUEAK,brawlBall,Pinhole Punt,212,243,455
1386,2023-01-26,SQUEAK,bounty,Temple Ruins,16,10,26
1387,2023-01-25,SQUEAK,knockout,Riverside,26,24,50
1388,2023-01-25,SQUEAK,hotZone,Open Zone,10,13,23
1389,2023-01-25,SQUEAK,heist,Safe Zone,30,21,51
1390,2023-01-25,SQUEAK,gemGrab,Gem Fort,20,16,36
1391,2023-01-25,SQUEAK,gemGrab,Crystal Arcade,43,31,74
1392,2023-01-25,SQUEAK,brawlBall,Sunny Soccer,125,151,276
1393,2023-01-25,SQUEAK,brawlBall,Beach Ball,13,12,25
1394,2023-01-25,SQUEAK,bounty,Excel,27,20,47
1395,2023-01-24,SQUEAK,knockout,New Perspective,47,38,85
1396,2023-01-24,SQUEAK,hotZone,Dueling Beetles,204,313,517
1397,2023-01-24,SQUEAK,heist,Safe Zone,49,44,93
1398,2023-01-24,SQUEAK,gemGrab,Minecart Madness,39,52,91
1399,2023-01-24,SQUEAK,gemGrab,Crystal Arcade,79,93,172
1400,2023-01-24,SQUEAK,brawlBall,Center Stage,25,33,58
1401,2023-01-24,SQUEAK,brawlBall,Beach Ball,232,238,470
1402,2023-01-24,SQUEAK,bounty,Excel,35,43,78
1403,2023-01-23,SQUEAK,knockout,New Perspective,67,76,143
1404,2023-01-23,SQUEAK,hotZone,Dueling Beetles,361,547,908
1405,2023-01-23,SQUEAK,heist,Snaked Assault,25,26,51
1406,2023-01-23,SQUEAK,gemGrab,Minecart Madness,196,210,406
1407,2023-01-23,SQUEAK,gemGrab,Double Swoosh,41,30,71
1408,2023-01-23,SQUEAK,brawlBall,Center Stage,350,412,762
1409,2023-01-23,SQUEAK,brawlBall,Backyard Bowl,5,5,10
1410,2023-01-23,SQUEAK,bounty,Layer Cake,58,64,122
1411,2023-01-22,SQUEAK,knockout,X Marks the Spot,36,38,74
1412,2023-01-22,SQUEAK,hotZone,Ring of Fire,33,24,57
1413,2023-01-22,SQUEAK,heist,Snaked Assault,8,2,10
1414,2023-01-22,SQUEAK,gemGrab,Hard Rock Mine,18,10,28
1415,2023-01-22,SQUEAK,gemGrab,Double Swoosh,51,58,109
1416,2023-01-22,SQUEAK,brawlBall,Super Beach,18,15,33
1417,2023-01-22,SQUEAK,brawlBall,Backyard Bowl,56,27,83
1418,2023-01-22,SQUEAK,bounty,Layer Cake,36,45,81
1419,2023-01-21,SQUEAK,knockout,X Marks the Spot,127,97,224
1420,2023-01-21,SQUEAK,hotZone,Ring of Fire,119,122,241
1421,2023-01-21,SQUEAK,heist,Tornado Ring,22,7,29
1422,2023-01-21,SQUEAK,gemGrab,Hard Rock Mine,95,59,154
1423,2023-01-21,SQUEAK,gemGrab,Deep Diner,24,34,58
1424,2023-01-21,SQUEAK,brawlBall,Super Beach,312,289,601
1425,2023-01-21,SQUEAK,brawlBall,Sneaky Fields,10,7,17
1426,2023-01-21,SQUEAK,bounty,Dry Season,42,58,100
1427,2023-01-20,SQUEAK,knockout,Out in the Open,123,148,271
1428,2023-01-20,SQUEAK,hotZone,Split,47,53,100
1429,2023-01-20,SQUEAK,heist,Tornado Ring,12,13,25
1430,2023-01-20,SQUEAK,gemGrab,Undermine,28,21,49
1431,2023-01-20,SQUEAK,gemGrab,Deep Diner,122,181,303
1432,2023-01-20,SQUEAK,brawlBall,Sneaky Fields,260,249,509
1433,2023-01-20,SQUEAK,brawlBall,Pinhole Punt,11,14,25
1434,2023-01-20,SQUEAK,bounty,Dry Season,49,61,110
1435,2023-01-19,SQUEAK,knockout,Out in the Open,136,120,256
1436,2023-01-19,SQUEAK,hotZone,Split,44,21,65
1437,2023-01-19,SQUEAK,heist,Kaboom Canyon,19,13,32
1438,2023-01-19,SQUEAK,gemGrab,Undermine,60,58,118
1439,2023-01-19,SQUEAK,gemGrab,Gem Fort,14,4,18
1440,2023-01-19,SQUEAK,brawlBall,Sunny Soccer,7,13,20
1441,2023-01-19,SQUEAK,brawlBall,Pinhole Punt,195,202,397
1442,2023-01-19,SQUEAK,bounty,Shooting Star,24,19,43
1443,2023-01-18,SQUEAK,knockout,Goldarm Gulch,7,12,19
1444,2023-01-18,SQUEAK,hotZone,Parallel Plays,4,5,9
1445,2023-01-18,SQUEAK,heist,Kaboom Canyon,5,9,14
1446,2023-01-18,SQUEAK,gemGrab,Gem Fort,12,5,17
1447,2023-01-18,SQUEAK,gemGrab,Crystal Arcade,6,0,6
1448,2023-01-18,SQUEAK,brawlBall,Sunny Soccer,99,87,186
1449,2023-01-18,SQUEAK,brawlBall,Beach Ball,3,1,4
1450,2023-01-18,SQUEAK,bounty,Shooting Star,11,8,19
1451,2023-01-17,SQUEAK,knockout,Goldarm Gulch,7,7,14
1452,2023-01-17,SQUEAK,hotZone,Parallel Plays,9,4,13
1453,2023-01-17,SQUEAK,heist,Pit Stop,3,1,4
1454,2023-01-17,SQUEAK,gemGrab,Minecart Madness,1,3,4
1455,2023-01-17,SQUEAK,gemGrab,Crystal Arcade,6,9,15
1456,2023-01-17,SQUEAK,brawlBall,Beach Ball,31,18,49
1457,2023-01-17,SQUEAK,bounty,Hideout,2,0,2
1458,2023-01-16,SQUEAK,knockout,Belle's Rock,5,3,8
1459,2023-01-16,SQUEAK,hotZone,Quarter Pounder,9,0,9
1460,2023-01-16,SQUEAK,heist,Pit Stop,3,0,3
1461,2023-01-16,SQUEAK,gemGrab,Minecart Madness,15,16,31
1462,2023-01-16,SQUEAK,gemGrab,Double Swoosh,3,12,15
1463,2023-01-16,SQUEAK,brawlBall,Center Stage,27,44,71
1464,2023-01-16,SQUEAK,brawlBall,Backyard Bowl,2,7,9
1465,2023-01-16,SQUEAK,bounty,Hideout,5,3,8
1466,2023-01-15,SQUEAK,knockout,Belle's Rock,8,3,11
1467,2023-01-15,SQUEAK,hotZone,Quarter Pounder,16,38,54
1468,2023-01-15,SQUEAK,heist,Bridge Too Far,8,3,11
1469,2023-01-15,SQUEAK,gemGrab,Hard Rock Mine,4,0,4
1470,2023-01-15,SQUEAK,gemGrab,Double Swoosh,4,4,8
1471,2023-01-15,SQUEAK,brawlBall,Super Beach,3,4,7
1472,2023-01-15,SQUEAK,brawlBall,Backyard Bowl,11,9,20
1473,2023-01-15,SQUEAK,bounty,Canal Grande,4,8,12
1474,2023-01-14,SQUEAK,knockout,Flaring Phoenix,5,0,5
1475,2023-01-14,SQUEAK,hotZone,Controller Chaos,17,35,52
1476,2023-01-14,SQUEAK,heist,Bridge Too Far,6,6,12
1477,2023-01-14,SQUEAK,gemGrab,Hard Rock Mine,2,0,2
1478,2023-01-14,SQUEAK,gemGrab,Deep Diner,2,0,2
1479,2023-01-14,SQUEAK,brawlBall,Super Beach,11,20,31
1480,2023-01-14,SQUEAK,brawlBall,Sneaky Fields,4,4,8
1481,2023-01-14,SQUEAK,bounty,Canal Grande,5,0,5
1482,2023-01-13,SQUEAK,knockout,Flaring Phoenix,3,1,4
1483,2023-01-13,SQUEAK,hotZone,Controller Chaos,32,74,106
1484,2023-01-13,SQUEAK,heist,Hot Potato,1,1,2
1485,2023-01-13,SQUEAK,gemGrab,Deep Diner,11,34,45
1486,2023-01-13,SQUEAK,brawlBall,Sneaky Fields,11,9,20
1487,2023-01-13,SQUEAK,bounty,Temple Ruins,0,1,1
1488,2023-01-12,SQUEAK,knockout,Riverside,6,0,6
1489,2023-01-12,SQUEAK,hotZone,Open Zone,8,5,13
1490,2023-01-12,SQUEAK,heist,Hot Potato,1,1,2
1491,2023-01-12,SQUEAK,gemGrab,Undermine,1,0,1
1492,2023-01-12,SQUEAK,brawlBall,Pinhole Punt,4,3,7
1493,2023-01-11,SQUEAK,brawlBall,Sunny Soccer,3,3,6
1494,2023-01-11,SQUEAK,bounty,Excel,3,14,17
1495,2023-01-10,SQUEAK,knockout,New Perspective,6,0,6
1496,2023-01-10,SQUEAK,hotZone,Dueling Beetles,29,53,82
1497,2023-01-10,SQUEAK,gemGrab,Minecart Madness,5,2,7
1498,2023-01-10,SQUEAK,gemGrab,Crystal Arcade,3,0,3
1499,2023-01-10,SQUEAK,brawlBall,Center Stage,2,7,9
1500,2023-01-10,SQUEAK,brawlBall,Beach Ball,17,44,61
1501,2023-01-10,SQUEAK,bounty,Excel,1,0,1
1502,2023-01-09,SQUEAK,knockout,New Perspective,1,0,1
1503,2023-01-09,SQUEAK,hotZone,Dueling Beetles,33,66,99
1504,2023-01-09,SQUEAK,heist,Snaked Assault,2,2,4
1505,2023-01-09,SQUEAK,gemGrab,Minecart Madness,6,4,10
1506,2023-01-09,SQUEAK,gemGrab,Double Swoosh,8,8,16
1507,2023-01-09,SQUEAK,brawlBall,Center Stage,9,7,16
1508,2023-01-09,SQUEAK,brawlBall,Backyard Bowl,2,2,4
1509,2023-01-09,SQUEAK,bounty,Layer Cake,2,1,3
1510,2023-01-08,SQUEAK,knockout,X Marks the Spot,5,1,6
1511,2023-01-08,SQUEAK,hotZone,Ring of Fire,14,5,19
1512,2023-01-08,SQUEAK,heist,Snaked Assault,2,1,3
1513,2023-01-08,SQUEAK,gemGrab,Hard Rock Mine,3,0,3
1514,2023-01-08,SQUEAK,gemGrab,Double Swoosh,4,2,6
1515,2023-01-08,SQUEAK,brawlBall,Super Beach,5,3,8
1516,2023-01-08,SQUEAK,brawlBall,Backyard Bowl,10,2,12
1517,2023-01-08,SQUEAK,bounty,Layer Cake,6,8,14
1518,2023-01-07,SQUEAK,knockout,X Marks the Spot,1,0,1
1519,2023-01-07,SQUEAK,hotZone,Ring of Fire,2,1,3
1520,2023-01-07,SQUEAK,gemGrab,Deep Diner,2,2,4
1521,2023-01-07,SQUEAK,brawlBall,Super Beach,7,9,16
1522,2023-01-07,SQUEAK,bounty,Dry Season,6,0,6
1523,2023-01-06,SQUEAK,knockout,Out in the Open,4,2,6
1524,2023-01-06,SQUEAK,heist,Tornado Ring,2,0,2
1525,2023-01-06,SQUEAK,gemGrab,Undermine,2,14,16
1526,2023-01-06,SQUEAK,gemGrab,Deep Diner,9,15,24
1527,2023-01-06,SQUEAK,brawlBall,Sneaky Fields,13,12,25
1528,2023-01-06,SQUEAK,brawlBall,Pinhole Punt,0,2,2
1529,2023-01-06,SQUEAK,bounty,Dry Season,1,2,3
1530,2023-01-05,SQUEAK,knockout,Out in the Open,6,2,8
1531,2023-01-05,SQUEAK,hotZone,Split,11,19,30
1532,2023-01-05,SQUEAK,heist,Kaboom Canyon,2,1,3
1533,2023-01-05,SQUEAK,gemGrab,Undermine,4,10,14
1534,2023-01-05,SQUEAK,gemGrab,Gem Fort,1,0,1
1535,2023-01-05,SQUEAK,brawlBall,Pinhole Punt,16,15,31
1536,2023-01-04,SQUEAK,hotZone,Parallel Plays,4,1,5
1537,2023-01-04,SQUEAK,heist,Kaboom Canyon,3,0,3
1538,2023-01-04,SQUEAK,gemGrab,Gem Fort,1,0,1
1539,2023-01-04,SQUEAK,gemGrab,Crystal Arcade,1,0,1
1540,2023-01-04,SQUEAK,brawlBall,Sunny Soccer,22,26,48
1541,2023-01-04,SQUEAK,bounty,Shooting Star,1,1,2
1542,2023-01-03,SQUEAK,knockout,Goldarm Gulch,0,2,2
1543,2023-01-03,SQUEAK,hotZone,Parallel Plays,4,1,5
1544,2023-01-03,SQUEAK,heist,Pit Stop,4,17,21
1545,2023-01-03,SQUEAK,gemGrab,Minecart Madness,4,11,15
1546,2023-01-03,SQUEAK,gemGrab,Crystal Arcade,7,5,12
1547,2023-01-03,SQUEAK,brawlBall,Center Stage,0,1,1
1548,2023-01-03,SQUEAK,brawlBall,Beach Ball,8,25,33
1549,2023-01-03,SQUEAK,bounty,Hideout,2,1,3
1550,2023-01-02,SQUEAK,knockout,Belle's Rock,4,3,7
1551,2023-01-02,SQUEAK,hotZone,Quarter Pounder,11,19,30
1552,2023-01-02,SQUEAK,heist,Pit Stop,5,0,5
1553,2023-01-02,SQUEAK,heist,Kaboom Canyon,1,0,1
1554,2023-01-02,SQUEAK,gemGrab,Minecart Madness,16,10,26
1555,2023-01-02,SQUEAK,gemGrab,Double Swoosh,3,2,5
1556,2023-01-02,SQUEAK,brawlBall,Center Stage,19,12,31
1557,2023-01-02,SQUEAK,brawlBall,Backyard Bowl,0,1,1
1558,2023-01-02,SQUEAK,bounty,Hideout,6,0,6
1559,2023-01-01,SQUEAK,knockout,Belle's Rock,1,2,3
1560,2023-01-01,SQUEAK,hotZone,Quarter Pounder,8,14,22
1561,2023-01-01,SQUEAK,heist,Bridge Too Far,1,0,1
1562,2023-01-01,SQUEAK,gemGrab,Minecart Madness,1,0,1
1563,2023-01-01,SQUEAK,gemGrab,Double Swoosh,2,5,7
1564,2023-01-01,SQUEAK,brawlBall,Backyard Bowl,2,0,2
1565,2023-01-01,SQUEAK,bounty,Canal Grande,0,1,1
1566,2022-12-31,SQUEAK,heist,Bridge Too Far,1,0,1
1567,2022-12-31,SQUEAK,gemGrab,Minecart Madness,1,0,1
1568,2022-12-31,SQUEAK,gemGrab,Hard Rock Mine,2,0,2
1569,2022-12-31,SQUEAK,gemGrab,Deep Diner,1,5,6
1570,2022-12-31,SQUEAK,brawlBall,Super Beach,5,0,5
1571,2022-12-30,SQUEAK,hotZone,Controller Chaos,2,1,3
1572,2022-12-30,SQUEAK,gemGrab,Undermine,4,14,18
1573,2022-12-30,SQUEAK,gemGrab,Deep Diner,4,0,4
1574,2022-12-30,SQUEAK,brawlBall,Sneaky Fields,3,0,3
1575,2022-12-29,SQUEAK,hotZone,Open Zone,0,1,1
1576,2022-12-29,SQUEAK,gemGrab,Minecart Madness,0,1,1
1577,2022-12-27,SQUEAK,hotZone,Dueling Beetles,1,1,2
1578,2022-12-27,SQUEAK,hotZone,Controller Chaos,0,1,1
1579,2022-12-27,SQUEAK,heist,Kaboom Canyon,0,1,1
1580,2022-12-27,SQUEAK,brawlBall,Beach Ball,1,0,1
1581,2022-12-26,SQUEAK,hotZone,Controller Chaos,0,1,1
1582,2022-12-26,SQUEAK,heist,Kaboom Canyon,0,1,1
1583,2022-12-26,SQUEAK,gemGrab,Minecart Madness,1,0,1
1584,2022-12-23,SQUEAK,knockout,Out in the Open,1,0,1
1585,2022-12-21,SQUEAK,brawlBall,Sunny Soccer,1,0,1
1586,2022-12-20,SQUEAK,brawlBall,Beach Ball,1,0,1
1587,2022-12-16,SQUEAK,hotZone,Controller Chaos,1,0,1
1588,2022-12-13,SQUEAK,gemGrab,Crystal Arcade,1,0,1
1589,2022-12-11,SQUEAK,brawlBall,Backyard Bowl,1,0,1
1590,2022-11-07,SQUEAK,hotZone,Quarter Pounder,2,2,4
1591,2022-10-15,SQUEAK,gemGrab,Hard Rock Mine,1,0,1
1592,2023-02-05,SPROUT,knockout,X Marks the Spot,49,71,120
1593,2023-02-05,SPROUT,knockout,Goldarm Gulch,15,11,26
1594,2023-02-05,SPROUT,hotZone,Ring of Fire,13,6,19
1595,2023-02-05,SPROUT,heist,Snaked Assault,3,0,3
1596,2023-02-05,SPROUT,gemGrab,Hard Rock Mine,2,1,3
1597,2023-02-05,SPROUT,gemGrab,Double Swoosh,17,9,26
1598,2023-02-05,SPROUT,brawlBall,Super Beach,3,1,4
1599,2023-02-05,SPROUT,brawlBall,Sneaky Fields,3,0,3
1600,2023-02-05,SPROUT,brawlBall,Backyard Bowl,77,97,174
1601,2023-02-05,SPROUT,bounty,Layer Cake,102,154,256
1602,2023-02-04,SPROUT,knockout,X Marks the Spot,30,43,73
1603,2023-02-04,SPROUT,knockout,Goldarm Gulch,16,8,24
1604,2023-02-04,SPROUT,hotZone,Ring of Fire,2,2,4
1605,2023-02-04,SPROUT,heist,Pit Stop,2,0,2
1606,2023-02-04,SPROUT,gemGrab,Hard Rock Mine,4,8,12
1607,2023-02-04,SPROUT,gemGrab,Double Swoosh,2,0,2
1608,2023-02-04,SPROUT,gemGrab,Deep Diner,3,2,5
1609,2023-02-04,SPROUT,brawlBall,Super Beach,29,28,57
1610,2023-02-04,SPROUT,brawlBall,Sneaky Fields,0,5,5
1611,2023-02-04,SPROUT,bounty,Dry Season,16,19,35
1612,2023-02-03,SPROUT,knockout,Out in the Open,96,137,233
1613,2023-02-03,SPROUT,knockout,Goldarm Gulch,80,43,123
1614,2023-02-03,SPROUT,hotZone,Split,56,45,101
1615,2023-02-03,SPROUT,heist,Tornado Ring,8,2,10
1616,2023-02-03,SPROUT,heist,Pit Stop,4,5,9
1617,2023-02-03,SPROUT,gemGrab,Undermine,3,5,8
1618,2023-02-03,SPROUT,gemGrab,Double Swoosh,11,6,17
1619,2023-02-03,SPROUT,gemGrab,Deep Diner,43,50,93
1620,2023-02-03,SPROUT,brawlBall,Sneaky Fields,67,65,132
1621,2023-02-03,SPROUT,brawlBall,Pinhole Punt,3,0,3
1622,2023-02-03,SPROUT,bounty,Dry Season,195,226,421
1623,2023-02-02,SPROUT,knockout,Out in the Open,45,38,83
1624,2023-02-02,SPROUT,hotZone,Split,48,59,107
1625,2023-02-02,SPROUT,heist,Kaboom Canyon,1,0,1
1626,2023-02-02,SPROUT,gemGrab,Undermine,9,16,25
1627,2023-02-02,SPROUT,gemGrab,Gem Fort,0,1,1
1628,2023-02-02,SPROUT,brawlBall,Sunny Soccer,2,1,3
1629,2023-02-02,SPROUT,brawlBall,Pinhole Punt,13,9,22
1630,2023-02-02,SPROUT,bounty,Shooting Star,17,26,43
1631,2023-02-01,SPROUT,knockout,Goldarm Gulch,158,195,353
1632,2023-02-01,SPROUT,hotZone,Parallel Plays,35,38,73
1633,2023-02-01,SPROUT,heist,Kaboom Canyon,2,0,2
1634,2023-02-01,SPROUT,gemGrab,Gem Fort,15,13,28
1635,2023-02-01,SPROUT,gemGrab,Crystal Arcade,5,8,13
1636,2023-02-01,SPROUT,brawlBall,Sunny Soccer,89,103,192
1637,2023-02-01,SPROUT,brawlBall,Beach Ball,6,3,9
1638,2023-02-01,SPROUT,bounty,Shooting Star,70,89,159
1639,2023-01-31,SPROUT,knockout,Goldarm Gulch,88,95,183
1640,2023-01-31,SPROUT,hotZone,Parallel Plays,5,8,13
1641,2023-01-31,SPROUT,heist,Pit Stop,3,1,4
1642,2023-01-31,SPROUT,gemGrab,Minecart Madness,5,3,8
1643,2023-01-31,SPROUT,gemGrab,Crystal Arcade,7,5,12
1644,2023-01-31,SPROUT,brawlBall,Center Stage,2,0,2
1645,2023-01-31,SPROUT,brawlBall,Beach Ball,35,46,81
1646,2023-01-31,SPROUT,bounty,Hideout,16,27,43
1647,2023-01-30,SPROUT,knockout,Belle's Rock,430,485,915
1648,2023-01-30,SPROUT,hotZone,Quarter Pounder,35,39,74
1649,2023-01-30,SPROUT,heist,Pit Stop,2,0,2
1650,2023-01-30,SPROUT,gemGrab,Minecart Madness,67,59,126
1651,2023-01-30,SPROUT,gemGrab,Double Swoosh,4,2,6
1652,2023-01-30,SPROUT,brawlBall,Center Stage,56,24,80
1653,2023-01-30,SPROUT,brawlBall,Backyard Bowl,8,3,11
1654,2023-01-30,SPROUT,bounty,Hideout,54,47,101
1655,2023-01-29,SPROUT,knockout,Belle's Rock,427,495,922
1656,2023-01-29,SPROUT,hotZone,Quarter Pounder,22,20,42
1657,2023-01-29,SPROUT,heist,Bridge Too Far,23,18,41
1658,2023-01-29,SPROUT,gemGrab,Hard Rock Mine,5,3,8
1659,2023-01-29,SPROUT,gemGrab,Double Swoosh,16,4,20
1660,2023-01-29,SPROUT,brawlBall,Super Beach,0,3,3
1661,2023-01-29,SPROUT,brawlBall,Backyard Bowl,75,76,151
1662,2023-01-29,SPROUT,bounty,Canal Grande,30,42,72
1663,2023-01-28,SPROUT,knockout,Flaring Phoenix,98,114,212
1664,2023-01-28,SPROUT,hotZone,Controller Chaos,25,21,46
1665,2023-01-28,SPROUT,heist,Bridge Too Far,24,8,32
1666,2023-01-28,SPROUT,gemGrab,Hard Rock Mine,33,23,56
1667,2023-01-28,SPROUT,gemGrab,Deep Diner,18,20,38
1668,2023-01-28,SPROUT,brawlBall,Super Beach,91,44,135
1669,2023-01-28,SPROUT,brawlBall,Sneaky Fields,2,0,2
1670,2023-01-28,SPROUT,bounty,Canal Grande,54,57,111
1671,2023-01-27,SPROUT,knockout,Flaring Phoenix,36,39,75
1672,2023-01-27,SPROUT,hotZone,Controller Chaos,8,4,12
1673,2023-01-27,SPROUT,heist,Hot Potato,2,1,3
1674,2023-01-27,SPROUT,gemGrab,Undermine,1,0,1
1675,2023-01-27,SPROUT,gemGrab,Deep Diner,23,29,52
1676,2023-01-27,SPROUT,brawlBall,Sneaky Fields,40,24,64
1677,2023-01-27,SPROUT,brawlBall,Pinhole Punt,1,0,1
1678,2023-01-27,SPROUT,bounty,Temple Ruins,4,7,11
1679,2023-01-26,SPROUT,knockout,Riverside,60,69,129
1680,2023-01-26,SPROUT,hotZone,Open Zone,7,3,10
1681,2023-01-26,SPROUT,heist,Hot Potato,6,3,9
1682,2023-01-26,SPROUT,gemGrab,Undermine,17,13,30
1683,2023-01-26,SPROUT,gemGrab,Gem Fort,7,2,9
1684,2023-01-26,SPROUT,brawlBall,Sunny Soccer,7,4,11
1685,2023-01-26,SPROUT,brawlBall,Pinhole Punt,52,45,97
1686,2023-01-26,SPROUT,bounty,Temple Ruins,5,10,15
1687,2023-01-25,SPROUT,knockout,Riverside,30,40,70
1688,2023-01-25,SPROUT,hotZone,Open Zone,3,0,3
1689,2023-01-25,SPROUT,heist,Safe Zone,10,8,18
1690,2023-01-25,SPROUT,gemGrab,Gem Fort,9,13,22
1691,2023-01-25,SPROUT,gemGrab,Crystal Arcade,18,12,30
1692,2023-01-25,SPROUT,brawlBall,Sunny Soccer,64,56,120
1693,2023-01-25,SPROUT,brawlBall,Beach Ball,10,13,23
1694,2023-01-25,SPROUT,bounty,Excel,43,44,87
1695,2023-01-24,SPROUT,knockout,New Perspective,50,56,106
1696,2023-01-24,SPROUT,hotZone,Dueling Beetles,76,76,152
1697,2023-01-24,SPROUT,heist,Safe Zone,17,3,20
1698,2023-01-24,SPROUT,gemGrab,Minecart Madness,24,29,53
1699,2023-01-24,SPROUT,gemGrab,Crystal Arcade,20,2,22
1700,2023-01-24,SPROUT,brawlBall,Center Stage,1,4,5
1701,2023-01-24,SPROUT,brawlBall,Beach Ball,94,87,181
1702,2023-01-24,SPROUT,bounty,Excel,106,108,214
1703,2023-01-23,SPROUT,knockout,New Perspective,77,76,153
1704,2023-01-23,SPROUT,hotZone,Dueling Beetles,112,135,247
1705,2023-01-23,SPROUT,heist,Snaked Assault,2,0,2
1706,2023-01-23,SPROUT,gemGrab,Minecart Madness,83,87,170
1707,2023-01-23,SPROUT,gemGrab,Double Swoosh,3,1,4
1708,2023-01-23,SPROUT,brawlBall,Center Stage,89,65,154
1709,2023-01-23,SPROUT,brawlBall,Backyard Bowl,11,29,40
1710,2023-01-23,SPROUT,bounty,Layer Cake,106,155,261
1711,2023-01-22,SPROUT,knockout,X Marks the Spot,49,57,106
1712,2023-01-22,SPROUT,hotZone,Ring of Fire,10,3,13
1713,2023-01-22,SPROUT,heist,Snaked Assault,0,1,1
1714,2023-01-22,SPROUT,gemGrab,Hard Rock Mine,5,1,6
1715,2023-01-22,SPROUT,gemGrab,Double Swoosh,3,4,7
1716,2023-01-22,SPROUT,brawlBall,Super Beach,10,14,24
1717,2023-01-22,SPROUT,brawlBall,Backyard Bowl,36,32,68
1718,2023-01-22,SPROUT,bounty,Layer Cake,67,64,131
1719,2023-01-21,SPROUT,knockout,X Marks the Spot,165,180,345
1720,2023-01-21,SPROUT,hotZone,Ring of Fire,24,9,33
1721,2023-01-21,SPROUT,heist,Tornado Ring,1,3,4
1722,2023-01-21,SPROUT,gemGrab,Hard Rock Mine,34,11,45
1723,2023-01-21,SPROUT,gemGrab,Deep Diner,14,11,25
1724,2023-01-21,SPROUT,brawlBall,Super Beach,94,68,162
1725,2023-01-21,SPROUT,brawlBall,Sneaky Fields,4,3,7
1726,2023-01-21,SPROUT,bounty,Dry Season,139,187,326
1727,2023-01-20,SPROUT,knockout,Out in the Open,89,113,202
1728,2023-01-20,SPROUT,hotZone,Split,80,51,131
1729,2023-01-20,SPROUT,heist,Tornado Ring,5,2,7
1730,2023-01-20,SPROUT,gemGrab,Undermine,8,8,16
1731,2023-01-20,SPROUT,gemGrab,Deep Diner,43,23,66
1732,2023-01-20,SPROUT,brawlBall,Sneaky Fields,65,58,123
1733,2023-01-20,SPROUT,brawlBall,Pinhole Punt,1,0,1
1734,2023-01-20,SPROUT,bounty,Dry Season,108,101,209
1735,2023-01-19,SPROUT,knockout,Out in the Open,110,136,246
1736,2023-01-19,SPROUT,hotZone,Split,120,138,258
1737,2023-01-19,SPROUT,heist,Kaboom Canyon,4,7,11
1738,2023-01-19,SPROUT,gemGrab,Undermine,10,16,26
1739,2023-01-19,SPROUT,gemGrab,Gem Fort,3,1,4
1740,2023-01-19,SPROUT,brawlBall,Sunny Soccer,3,5,8
1741,2023-01-19,SPROUT,brawlBall,Pinhole Punt,55,56,111
1742,2023-01-19,SPROUT,bounty,Shooting Star,99,132,231
1743,2023-01-18,SPROUT,knockout,Goldarm Gulch,17,22,39
1744,2023-01-18,SPROUT,hotZone,Parallel Plays,3,2,5
1745,2023-01-18,SPROUT,heist,Kaboom Canyon,2,3,5
1746,2023-01-18,SPROUT,gemGrab,Gem Fort,2,0,2
1747,2023-01-18,SPROUT,gemGrab,Crystal Arcade,1,1,2
1748,2023-01-18,SPROUT,brawlBall,Sunny Soccer,17,25,42
1749,2023-01-18,SPROUT,brawlBall,Beach Ball,4,3,7
1750,2023-01-18,SPROUT,bounty,Shooting Star,60,70,130
1751,2023-01-17,SPROUT,knockout,Goldarm Gulch,17,18,35
1752,2023-01-17,SPROUT,gemGrab,Minecart Madness,0,1,1
1753,2023-01-17,SPROUT,gemGrab,Crystal Arcade,2,1,3
1754,2023-01-17,SPROUT,brawlBall,Beach Ball,11,5,16
1755,2023-01-17,SPROUT,bounty,Hideout,3,8,11
1756,2023-01-16,SPROUT,knockout,Belle's Rock,49,55,104
1757,2023-01-16,SPROUT,hotZone,Quarter Pounder,1,0,1
1758,2023-01-16,SPROUT,gemGrab,Minecart Madness,8,6,14
1759,2023-01-16,SPROUT,brawlBall,Center Stage,10,13,23
1760,2023-01-16,SPROUT,brawlBall,Backyard Bowl,2,4,6
1761,2023-01-16,SPROUT,bounty,Hideout,8,11,19
1762,2023-01-15,SPROUT,knockout,Belle's Rock,38,60,98
1763,2023-01-15,SPROUT,hotZone,Quarter Pounder,18,51,69
1764,2023-01-15,SPROUT,heist,Bridge Too Far,4,1,5
1765,2023-01-15,SPROUT,gemGrab,Hard Rock Mine,2,0,2
1766,2023-01-15,SPROUT,gemGrab,Double Swoosh,1,1,2
1767,2023-01-15,SPROUT,brawlBall,Backyard Bowl,24,27,51
1768,2023-01-15,SPROUT,bounty,Canal Grande,0,2,2
1769,2023-01-14,SPROUT,knockout,Flaring Phoenix,12,10,22
1770,2023-01-14,SPROUT,hotZone,Controller Chaos,2,0,2
1771,2023-01-14,SPROUT,heist,Bridge Too Far,1,0,1
1772,2023-01-14,SPROUT,gemGrab,Hard Rock Mine,1,0,1
1773,2023-01-14,SPROUT,gemGrab,Deep Diner,3,10,13
1774,2023-01-14,SPROUT,brawlBall,Super Beach,6,6,12
1775,2023-01-14,SPROUT,bounty,Canal Grande,4,0,4
1776,2023-01-13,SPROUT,knockout,Flaring Phoenix,13,8,21
1777,2023-01-13,SPROUT,hotZone,Controller Chaos,7,23,30
1778,2023-01-13,SPROUT,gemGrab,Deep Diner,4,28,32
1779,2023-01-13,SPROUT,brawlBall,Sneaky Fields,6,4,10
1780,2023-01-12,SPROUT,knockout,Riverside,16,28,44
1781,2023-01-12,SPROUT,gemGrab,Undermine,1,0,1
1782,2023-01-12,SPROUT,brawlBall,Pinhole Punt,4,8,12
1783,2023-01-11,SPROUT,gemGrab,Gem Fort,0,1,1
1784,2023-01-11,SPROUT,brawlBall,Sunny Soccer,1,0,1
1785,2023-01-11,SPROUT,bounty,Excel,1,0,1
1786,2023-01-10,SPROUT,knockout,New Perspective,5,5,10
1787,2023-01-10,SPROUT,hotZone,Dueling Beetles,34,61,95
1788,2023-01-10,SPROUT,heist,Safe Zone,1,0,1
1789,2023-01-10,SPROUT,gemGrab,Minecart Madness,0,1,1
1790,2023-01-10,SPROUT,brawlBall,Beach Ball,11,13,24
1791,2023-01-10,SPROUT,bounty,Excel,1,1,2
1792,2023-01-09,SPROUT,knockout,New Perspective,0,1,1
1793,2023-01-09,SPROUT,hotZone,Dueling Beetles,18,16,34
1794,2023-01-09,SPROUT,gemGrab,Minecart Madness,3,3,6
1795,2023-01-09,SPROUT,brawlBall,Center Stage,1,0,1
1796,2023-01-09,SPROUT,brawlBall,Backyard Bowl,2,0,2
1797,2023-01-09,SPROUT,bounty,Layer Cake,20,16,36
1798,2023-01-08,SPROUT,knockout,X Marks the Spot,5,1,6
1799,2023-01-08,SPROUT,hotZone,Ring of Fire,2,14,16
1800,2023-01-08,SPROUT,heist,Snaked Assault,1,0,1
1801,2023-01-08,SPROUT,gemGrab,Double Swoosh,1,0,1
1802,2023-01-08,SPROUT,brawlBall,Super Beach,0,3,3
1803,2023-01-08,SPROUT,brawlBall,Backyard Bowl,2,4,6
1804,2023-01-08,SPROUT,bounty,Layer Cake,4,3,7
1805,2023-01-07,SPROUT,knockout,X Marks the Spot,8,6,14
1806,2023-01-07,SPROUT,gemGrab,Hard Rock Mine,1,1,2
1807,2023-01-07,SPROUT,brawlBall,Super Beach,2,1,3
1808,2023-01-07,SPROUT,bounty,Dry Season,11,10,21
1809,2023-01-06,SPROUT,knockout,Out in the Open,3,5,8
1810,2023-01-06,SPROUT,hotZone,Split,4,0,4
1811,2023-01-06,SPROUT,brawlBall,Sneaky Fields,4,1,5
1812,2023-01-06,SPROUT,brawlBall,Pinhole Punt,1,2,3
1813,2023-01-06,SPROUT,bounty,Dry Season,18,13,31
1814,2023-01-05,SPROUT,knockout,Out in the Open,3,3,6
1815,2023-01-05,SPROUT,hotZone,Split,17,8,25
1816,2023-01-05,SPROUT,gemGrab,Undermine,0,2,2
1817,2023-01-05,SPROUT,gemGrab,Gem Fort,1,0,1
1818,2023-01-05,SPROUT,bounty,Shooting Star,8,2,10
1819,2023-01-04,SPROUT,knockout,Goldarm Gulch,5,4,9
1820,2023-01-04,SPROUT,gemGrab,Gem Fort,1,0,1
1821,2023-01-04,SPROUT,brawlBall,Sunny Soccer,5,11,16
1822,2023-01-04,SPROUT,bounty,Shooting Star,27,53,80
1823,2023-01-03,SPROUT,knockout,Goldarm Gulch,1,2,3
1824,2023-01-03,SPROUT,hotZone,Parallel Plays,2,0,2
1825,2023-01-03,SPROUT,gemGrab,Crystal Arcade,1,0,1
1826,2023-01-03,SPROUT,brawlBall,Beach Ball,1,0,1
1827,2023-01-03,SPROUT,bounty,Hideout,5,17,22
1828,2023-01-02,SPROUT,knockout,Belle's Rock,25,24,49
1829,2023-01-02,SPROUT,hotZone,Quarter Pounder,10,18,28
1830,2023-01-02,SPROUT,gemGrab,Minecart Madness,3,3,6
1831,2023-01-02,SPROUT,brawlBall,Center Stage,3,0,3
1832,2023-01-02,SPROUT,bounty,Hideout,14,5,19
1833,2023-01-01,SPROUT,knockout,Belle's Rock,22,11,33
1834,2023-01-01,SPROUT,hotZone,Quarter Pounder,3,9,12
1835,2023-01-01,SPROUT,hotZone,Controller Chaos,1,0,1
1836,2023-01-01,SPROUT,heist,Kaboom Canyon,1,0,1
1837,2023-01-01,SPROUT,brawlBall,Backyard Bowl,7,19,26
1838,2022-12-31,SPROUT,hotZone,Controller Chaos,1,0,1
1839,2022-12-31,SPROUT,gemGrab,Deep Diner,0,1,1
1840,2022-12-31,SPROUT,brawlBall,Super Beach,0,2,2
1841,2022-12-29,SPROUT,hotZone,Controller Chaos,0,1,1
1842,2022-12-29,SPROUT,brawlBall,Pinhole Punt,0,1,1
1843,2022-12-28,SPROUT,brawlBall,Sunny Soccer,1,0,1
1844,2022-12-27,SPROUT,hotZone,Dueling Beetles,2,0,2
1845,2022-12-26,SPROUT,gemGrab,Minecart Madness,1,0,1
1846,2022-12-24,SPROUT,knockout,X Marks the Spot,2,1,3
1847,2022-12-24,SPROUT,bounty,Dry Season,1,0,1
1848,2022-12-23,SPROUT,knockout,Out in the Open,9,9,18
1849,2022-12-22,SPROUT,brawlBall,Pinhole Punt,0,10,10
1850,2022-12-13,SPROUT,knockout,New Perspective,1,0,1
1851,2022-11-01,SPROUT,knockout,New Perspective,0,1,1
1852,2022-10-28,SPROUT,brawlBall,Beach Ball,1,0,1
1853,2022-10-26,SPROUT,bounty,Shooting Star,0,1,1
1854,2022-10-15,SPROUT,gemGrab,Hard Rock Mine,1,0,1
1855,2022-10-10,SPROUT,knockout,Belle's Rock,4,5,9
1856,2023-02-05,SPIKE,knockout,X Marks the Spot,101,50,151
1857,2023-02-05,SPIKE,knockout,Goldarm Gulch,28,9,37
1858,2023-02-05,SPIKE,hotZone,Ring of Fire,91,116,207
1859,2023-02-05,SPIKE,heist,Snaked Assault,119,61,180
1860,2023-02-05,SPIKE,heist,Pit Stop,43,31,74
1861,2023-02-05,SPIKE,gemGrab,Hard Rock Mine,33,30,63
1862,2023-02-05,SPIKE,gemGrab,Double Swoosh,286,279,565
1863,2023-02-05,SPIKE,brawlBall,Super Beach,22,16,38
1864,2023-02-05,SPIKE,brawlBall,Sneaky Fields,88,86,174
1865,2023-02-05,SPIKE,brawlBall,Backyard Bowl,837,841,1678
1866,2023-02-05,SPIKE,bounty,Layer Cake,41,15,56
1867,2023-02-04,SPIKE,knockout,X Marks the Spot,44,29,73
1868,2023-02-04,SPIKE,knockout,Goldarm Gulch,17,7,24
1869,2023-02-04,SPIKE,hotZone,Ring of Fire,29,29,58
1870,2023-02-04,SPIKE,heist,Tornado Ring,18,18,36
1871,2023-02-04,SPIKE,heist,Pit Stop,43,28,71
1872,2023-02-04,SPIKE,gemGrab,Hard Rock Mine,50,51,101
1873,2023-02-04,SPIKE,gemGrab,Double Swoosh,42,70,112
1874,2023-02-04,SPIKE,gemGrab,Deep Diner,16,28,44
1875,2023-02-04,SPIKE,brawlBall,Super Beach,186,259,445
1876,2023-02-04,SPIKE,brawlBall,Sneaky Fields,78,69,147
1877,2023-02-04,SPIKE,bounty,Dry Season,16,7,23
1878,2023-02-03,SPIKE,knockout,Out in the Open,149,95,244
1879,2023-02-03,SPIKE,knockout,Goldarm Gulch,113,57,170
1880,2023-02-03,SPIKE,hotZone,Split,26,9,35
1881,2023-02-03,SPIKE,heist,Tornado Ring,124,82,206
1882,2023-02-03,SPIKE,heist,Pit Stop,206,116,322
1883,2023-02-03,SPIKE,gemGrab,Undermine,63,46,109
1884,2023-02-03,SPIKE,gemGrab,Double Swoosh,245,301,546
1885,2023-02-03,SPIKE,gemGrab,Deep Diner,212,223,435
1886,2023-02-03,SPIKE,brawlBall,Sneaky Fields,1019,1122,2141
1887,2023-02-03,SPIKE,brawlBall,Pinhole Punt,44,45,89
1888,2023-02-03,SPIKE,bounty,Dry Season,122,63,185
1889,2023-02-02,SPIKE,knockout,Out in the Open,55,48,103
1890,2023-02-02,SPIKE,hotZone,Split,12,22,34
1891,2023-02-02,SPIKE,heist,Kaboom Canyon,19,7,26
1892,2023-02-02,SPIKE,gemGrab,Undermine,41,48,89
1893,2023-02-02,SPIKE,gemGrab,Gem Fort,27,24,51
1894,2023-02-02,SPIKE,brawlBall,Sunny Soccer,5,7,12
1895,2023-02-02,SPIKE,brawlBall,Pinhole Punt,248,235,483
1896,2023-02-02,SPIKE,bounty,Shooting Star,19,11,30
1897,2023-02-01,SPIKE,knockout,Goldarm Gulch,154,93,247
1898,2023-02-01,SPIKE,hotZone,Parallel Plays,153,122,275
1899,2023-02-01,SPIKE,heist,Kaboom Canyon,56,49,105
1900,2023-02-01,SPIKE,gemGrab,Gem Fort,89,82,171
1901,2023-02-01,SPIKE,gemGrab,Crystal Arcade,83,61,144
1902,2023-02-01,SPIKE,brawlBall,Sunny Soccer,676,691,1367
1903,2023-02-01,SPIKE,brawlBall,Beach Ball,24,19,43
1904,2023-02-01,SPIKE,bounty,Shooting Star,32,16,48
1905,2023-01-31,SPIKE,knockout,Goldarm Gulch,70,68,138
1906,2023-01-31,SPIKE,hotZone,Parallel Plays,59,61,120
1907,2023-01-31,SPIKE,heist,Pit Stop,19,16,35
1908,2023-01-31,SPIKE,gemGrab,Minecart Madness,10,9,19
1909,2023-01-31,SPIKE,gemGrab,Crystal Arcade,94,94,188
1910,2023-01-31,SPIKE,brawlBall,Center Stage,11,12,23
1911,2023-01-31,SPIKE,brawlBall,Beach Ball,329,333,662
1912,2023-01-31,SPIKE,bounty,Hideout,21,15,36
1913,2023-01-30,SPIKE,knockout,Belle's Rock,190,133,323
1914,2023-01-30,SPIKE,hotZone,Quarter Pounder,211,178,389
1915,2023-01-30,SPIKE,heist,Pit Stop,62,30,92
1916,2023-01-30,SPIKE,gemGrab,Minecart Madness,193,270,463
1917,2023-01-30,SPIKE,gemGrab,Double Swoosh,154,143,297
1918,2023-01-30,SPIKE,brawlBall,Center Stage,497,512,1009
1919,2023-01-30,SPIKE,brawlBall,Backyard Bowl,80,69,149
1920,2023-01-30,SPIKE,bounty,Hideout,43,42,85
1921,2023-01-29,SPIKE,knockout,Belle's Rock,213,108,321
1922,2023-01-29,SPIKE,hotZone,Quarter Pounder,141,109,250
1923,2023-01-29,SPIKE,heist,Bridge Too Far,69,50,119
1924,2023-01-29,SPIKE,gemGrab,Hard Rock Mine,23,13,36
1925,2023-01-29,SPIKE,gemGrab,Double Swoosh,190,190,380
1926,2023-01-29,SPIKE,brawlBall,Super Beach,11,9,20
1927,2023-01-29,SPIKE,brawlBall,Backyard Bowl,836,884,1720
1928,2023-01-29,SPIKE,bounty,Canal Grande,34,22,56
1929,2023-01-28,SPIKE,knockout,Flaring Phoenix,78,41,119
1930,2023-01-28,SPIKE,hotZone,Controller Chaos,120,165,285
1931,2023-01-28,SPIKE,heist,Bridge Too Far,198,159,357
1932,2023-01-28,SPIKE,gemGrab,Hard Rock Mine,127,102,229
1933,2023-01-28,SPIKE,gemGrab,Deep Diner,64,51,115
1934,2023-01-28,SPIKE,brawlBall,Super Beach,751,708,1459
1935,2023-01-28,SPIKE,brawlBall,Sneaky Fields,41,38,79
1936,2023-01-28,SPIKE,bounty,Canal Grande,72,51,123
1937,2023-01-27,SPIKE,knockout,Flaring Phoenix,39,19,58
1938,2023-01-27,SPIKE,hotZone,Controller Chaos,36,23,59
1939,2023-01-27,SPIKE,heist,Hot Potato,30,24,54
1940,2023-01-27,SPIKE,gemGrab,Undermine,16,11,27
1941,2023-01-27,SPIKE,gemGrab,Deep Diner,84,99,183
1942,2023-01-27,SPIKE,brawlBall,Sneaky Fields,214,207,421
1943,2023-01-27,SPIKE,brawlBall,Pinhole Punt,11,7,18
1944,2023-01-27,SPIKE,bounty,Temple Ruins,27,21,48
1945,2023-01-26,SPIKE,knockout,Riverside,129,73,202
1946,2023-01-26,SPIKE,hotZone,Open Zone,132,90,222
1947,2023-01-26,SPIKE,heist,Hot Potato,88,80,168
1948,2023-01-26,SPIKE,gemGrab,Undermine,96,151,247
1949,2023-01-26,SPIKE,gemGrab,Gem Fort,36,35,71
1950,2023-01-26,SPIKE,brawlBall,Sunny Soccer,40,40,80
1951,2023-01-26,SPIKE,brawlBall,Pinhole Punt,794,809,1603
1952,2023-01-26,SPIKE,bounty,Temple Ruins,59,47,106
1953,2023-01-25,SPIKE,knockout,Riverside,56,36,92
1954,2023-01-25,SPIKE,hotZone,Open Zone,58,65,123
1955,2023-01-25,SPIKE,heist,Safe Zone,65,37,102
1956,2023-01-25,SPIKE,gemGrab,Gem Fort,40,32,72
1957,2023-01-25,SPIKE,gemGrab,Crystal Arcade,97,116,213
1958,2023-01-25,SPIKE,brawlBall,Sunny Soccer,522,515,1037
1959,2023-01-25,SPIKE,brawlBall,Beach Ball,90,94,184
1960,2023-01-25,SPIKE,bounty,Excel,40,22,62
1961,2023-01-24,SPIKE,knockout,New Perspective,104,107,211
1962,2023-01-24,SPIKE,hotZone,Dueling Beetles,109,109,218
1963,2023-01-24,SPIKE,heist,Safe Zone,97,69,166
1964,2023-01-24,SPIKE,gemGrab,Minecart Madness,61,75,136
1965,2023-01-24,SPIKE,gemGrab,Crystal Arcade,182,253,435
1966,2023-01-24,SPIKE,brawlBall,Center Stage,86,95,181
1967,2023-01-24,SPIKE,brawlBall,Beach Ball,711,753,1464
1968,2023-01-24,SPIKE,bounty,Excel,69,35,104
1969,2023-01-23,SPIKE,knockout,New Perspective,167,87,254
1970,2023-01-23,SPIKE,hotZone,Dueling Beetles,192,155,347
1971,2023-01-23,SPIKE,heist,Snaked Assault,135,75,210
1972,2023-01-23,SPIKE,gemGrab,Minecart Madness,302,401,703
1973,2023-01-23,SPIKE,gemGrab,Double Swoosh,107,92,199
1974,2023-01-23,SPIKE,brawlBall,Center Stage,980,839,1819
1975,2023-01-23,SPIKE,brawlBall,Backyard Bowl,47,63,110
1976,2023-01-23,SPIKE,bounty,Layer Cake,56,32,88
1977,2023-01-22,SPIKE,knockout,X Marks the Spot,86,57,143
1978,2023-01-22,SPIKE,hotZone,Ring of Fire,49,43,92
1979,2023-01-22,SPIKE,heist,Snaked Assault,82,52,134
1980,2023-01-22,SPIKE,gemGrab,Hard Rock Mine,33,26,59
1981,2023-01-22,SPIKE,gemGrab,Double Swoosh,111,136,247
1982,2023-01-22,SPIKE,brawlBall,Super Beach,81,104,185
1983,2023-01-22,SPIKE,brawlBall,Backyard Bowl,484,450,934
1984,2023-01-22,SPIKE,bounty,Layer Cake,20,10,30
1985,2023-01-21,SPIKE,knockout,X Marks the Spot,264,155,419
1986,2023-01-21,SPIKE,hotZone,Ring of Fire,215,202,417
1987,2023-01-21,SPIKE,heist,Tornado Ring,122,75,197
1988,2023-01-21,SPIKE,gemGrab,Hard Rock Mine,168,154,322
1989,2023-01-21,SPIKE,gemGrab,Deep Diner,45,26,71
1990,2023-01-21,SPIKE,brawlBall,Super Beach,1076,1055,2131
1991,2023-01-21,SPIKE,brawlBall,Sneaky Fields,35,23,58
1992,2023-01-21,SPIKE,bounty,Dry Season,99,56,155
1993,2023-01-20,SPIKE,knockout,Out in the Open,194,113,307
1994,2023-01-20,SPIKE,hotZone,Split,55,50,105
1995,2023-01-20,SPIKE,heist,Tornado Ring,106,92,198
1996,2023-01-20,SPIKE,gemGrab,Undermine,66,69,135
1997,2023-01-20,SPIKE,gemGrab,Deep Diner,221,204,425
1998,2023-01-20,SPIKE,brawlBall,Sneaky Fields,676,755,1431
1999,2023-01-20,SPIKE,brawlBall,Pinhole Punt,45,56,101
2000,2023-01-20,SPIKE,bounty,Dry Season,83,49,132
2001,2023-01-19,SPIKE,knockout,Out in the Open,221,138,359
2002,2023-01-19,SPIKE,hotZone,Split,63,24,87
2003,2023-01-19,SPIKE,heist,Kaboom Canyon,90,71,161
2004,2023-01-19,SPIKE,gemGrab,Undermine,187,190,377
2005,2023-01-19,SPIKE,gemGrab,Gem Fort,33,20,53
2006,2023-01-19,SPIKE,brawlBall,Sunny Soccer,30,42,72
2007,2023-01-19,SPIKE,brawlBall,Pinhole Punt,876,907,1783
2008,2023-01-19,SPIKE,bounty,Shooting Star,59,36,95
2009,2023-01-18,SPIKE,knockout,Goldarm Gulch,24,17,41
2010,2023-01-18,SPIKE,hotZone,Parallel Plays,16,22,38
2011,2023-01-18,SPIKE,heist,Kaboom Canyon,20,19,39
2012,2023-01-18,SPIKE,gemGrab,Gem Fort,22,17,39
2013,2023-01-18,SPIKE,gemGrab,Crystal Arcade,11,21,32
2014,2023-01-18,SPIKE,brawlBall,Sunny Soccer,230,258,488
2015,2023-01-18,SPIKE,brawlBall,Beach Ball,12,4,16
2016,2023-01-18,SPIKE,bounty,Shooting Star,26,19,45
2017,2023-01-17,SPIKE,knockout,Goldarm Gulch,19,15,34
2018,2023-01-17,SPIKE,hotZone,Parallel Plays,13,13,26
2019,2023-01-17,SPIKE,heist,Pit Stop,11,7,18
2020,2023-01-17,SPIKE,gemGrab,Minecart Madness,7,3,10
2021,2023-01-17,SPIKE,gemGrab,Crystal Arcade,25,47,72
2022,2023-01-17,SPIKE,brawlBall,Center Stage,2,3,5
2023,2023-01-17,SPIKE,brawlBall,Beach Ball,83,83,166
2024,2023-01-17,SPIKE,bounty,Hideout,7,2,9
2025,2023-01-16,SPIKE,knockout,Belle's Rock,13,7,20
2026,2023-01-16,SPIKE,hotZone,Quarter Pounder,19,12,31
2027,2023-01-16,SPIKE,heist,Pit Stop,27,13,40
2028,2023-01-16,SPIKE,gemGrab,Minecart Madness,15,20,35
2029,2023-01-16,SPIKE,gemGrab,Double Swoosh,7,2,9
2030,2023-01-16,SPIKE,brawlBall,Center Stage,90,51,141
2031,2023-01-16,SPIKE,brawlBall,Backyard Bowl,10,11,21
2032,2023-01-16,SPIKE,bounty,Hideout,10,2,12
2033,2023-01-15,SPIKE,knockout,Belle's Rock,24,8,32
2034,2023-01-15,SPIKE,hotZone,Quarter Pounder,37,21,58
2035,2023-01-15,SPIKE,heist,Bridge Too Far,18,30,48
2036,2023-01-15,SPIKE,gemGrab,Hard Rock Mine,5,1,6
2037,2023-01-15,SPIKE,gemGrab,Double Swoosh,17,6,23
2038,2023-01-15,SPIKE,brawlBall,Super Beach,22,22,44
2039,2023-01-15,SPIKE,brawlBall,Backyard Bowl,110,94,204
2040,2023-01-15,SPIKE,bounty,Canal Grande,3,5,8
2041,2023-01-14,SPIKE,knockout,Flaring Phoenix,3,0,3
2042,2023-01-14,SPIKE,hotZone,Controller Chaos,27,11,38
2043,2023-01-14,SPIKE,heist,Bridge Too Far,12,2,14
2044,2023-01-14,SPIKE,gemGrab,Hard Rock Mine,6,1,7
2045,2023-01-14,SPIKE,gemGrab,Deep Diner,7,23,30
2046,2023-01-14,SPIKE,brawlBall,Super Beach,51,76,127
2047,2023-01-14,SPIKE,brawlBall,Sneaky Fields,5,22,27
2048,2023-01-14,SPIKE,bounty,Canal Grande,7,2,9
2049,2023-01-13,SPIKE,knockout,Flaring Phoenix,13,2,15
2050,2023-01-13,SPIKE,hotZone,Controller Chaos,64,59,123
2051,2023-01-13,SPIKE,heist,Hot Potato,5,0,5
2052,2023-01-13,SPIKE,gemGrab,Deep Diner,15,21,36
2053,2023-01-13,SPIKE,brawlBall,Sneaky Fields,60,75,135
2054,2023-01-13,SPIKE,brawlBall,Pinhole Punt,1,2,3
2055,2023-01-13,SPIKE,bounty,Temple Ruins,5,2,7
2056,2023-01-12,SPIKE,knockout,Riverside,15,6,21
2057,2023-01-12,SPIKE,hotZone,Open Zone,14,23,37
2058,2023-01-12,SPIKE,gemGrab,Undermine,3,4,7
2059,2023-01-12,SPIKE,brawlBall,Sunny Soccer,5,2,7
2060,2023-01-12,SPIKE,brawlBall,Pinhole Punt,28,35,63
2061,2023-01-11,SPIKE,knockout,Riverside,1,0,1
2062,2023-01-11,SPIKE,hotZone,Open Zone,5,2,7
2063,2023-01-11,SPIKE,brawlBall,Sunny Soccer,21,37,58
2064,2023-01-11,SPIKE,brawlBall,Beach Ball,2,2,4
2065,2023-01-10,SPIKE,knockout,New Perspective,3,2,5
2066,2023-01-10,SPIKE,hotZone,Dueling Beetles,27,36,63
2067,2023-01-10,SPIKE,heist,Safe Zone,9,0,9
2068,2023-01-10,SPIKE,gemGrab,Minecart Madness,8,11,19
2069,2023-01-10,SPIKE,gemGrab,Crystal Arcade,9,7,16
2070,2023-01-10,SPIKE,brawlBall,Center Stage,3,2,5
2071,2023-01-10,SPIKE,brawlBall,Beach Ball,54,54,108
2072,2023-01-10,SPIKE,bounty,Excel,2,0,2
2073,2023-01-09,SPIKE,knockout,New Perspective,6,2,8
2074,2023-01-09,SPIKE,hotZone,Dueling Beetles,13,17,30
2075,2023-01-09,SPIKE,heist,Snaked Assault,24,34,58
2076,2023-01-09,SPIKE,gemGrab,Minecart Madness,23,50,73
2077,2023-01-09,SPIKE,gemGrab,Double Swoosh,9,5,14
2078,2023-01-09,SPIKE,brawlBall,Center Stage,26,16,42
2079,2023-01-09,SPIKE,brawlBall,Backyard Bowl,10,29,39
2080,2023-01-09,SPIKE,bounty,Layer Cake,6,0,6
2081,2023-01-08,SPIKE,knockout,X Marks the Spot,11,35,46
2082,2023-01-08,SPIKE,hotZone,Ring of Fire,19,26,45
2083,2023-01-08,SPIKE,heist,Snaked Assault,11,8,19
2084,2023-01-08,SPIKE,gemGrab,Hard Rock Mine,5,5,10
2085,2023-01-08,SPIKE,gemGrab,Double Swoosh,6,28,34
2086,2023-01-08,SPIKE,brawlBall,Super Beach,7,23,30
2087,2023-01-08,SPIKE,brawlBall,Backyard Bowl,50,49,99
2088,2023-01-08,SPIKE,bounty,Layer Cake,3,0,3
2089,2023-01-07,SPIKE,knockout,X Marks the Spot,10,5,15
2090,2023-01-07,SPIKE,hotZone,Ring of Fire,7,8,15
2091,2023-01-07,SPIKE,heist,Tornado Ring,9,19,28
2092,2023-01-07,SPIKE,gemGrab,Hard Rock Mine,10,5,15
2093,2023-01-07,SPIKE,gemGrab,Deep Diner,4,4,8
2094,2023-01-07,SPIKE,brawlBall,Super Beach,25,21,46
2095,2023-01-07,SPIKE,brawlBall,Sneaky Fields,2,1,3
2096,2023-01-07,SPIKE,bounty,Dry Season,10,0,10
2097,2023-01-06,SPIKE,knockout,Out in the Open,9,2,11
2098,2023-01-06,SPIKE,hotZone,Split,3,0,3
2099,2023-01-06,SPIKE,heist,Tornado Ring,24,19,43
2100,2023-01-06,SPIKE,gemGrab,Undermine,5,2,7
2101,2023-01-06,SPIKE,gemGrab,Deep Diner,21,3,24
2102,2023-01-06,SPIKE,brawlBall,Sneaky Fields,54,68,122
2103,2023-01-06,SPIKE,brawlBall,Pinhole Punt,7,4,11
2104,2023-01-06,SPIKE,bounty,Dry Season,3,5,8
2105,2023-01-05,SPIKE,knockout,Out in the Open,12,4,16
2106,2023-01-05,SPIKE,hotZone,Split,28,37,65
2107,2023-01-05,SPIKE,heist,Kaboom Canyon,11,3,14
2108,2023-01-05,SPIKE,gemGrab,Undermine,12,18,30
2109,2023-01-05,SPIKE,gemGrab,Gem Fort,2,0,2
2110,2023-01-05,SPIKE,brawlBall,Pinhole Punt,115,131,246
2111,2023-01-05,SPIKE,bounty,Shooting Star,5,0,5
2112,2023-01-04,SPIKE,knockout,Goldarm Gulch,2,13,15
2113,2023-01-04,SPIKE,hotZone,Parallel Plays,3,2,5
2114,2023-01-04,SPIKE,heist,Kaboom Canyon,17,33,50
2115,2023-01-04,SPIKE,gemGrab,Gem Fort,5,17,22
2116,2023-01-04,SPIKE,gemGrab,Crystal Arcade,8,11,19
2117,2023-01-04,SPIKE,brawlBall,Sunny Soccer,87,85,172
2118,2023-01-04,SPIKE,bounty,Shooting Star,11,5,16
2119,2023-01-03,SPIKE,knockout,Goldarm Gulch,7,3,10
2120,2023-01-03,SPIKE,hotZone,Parallel Plays,19,9,28
2121,2023-01-03,SPIKE,heist,Pit Stop,7,12,19
2122,2023-01-03,SPIKE,gemGrab,Minecart Madness,4,1,5
2123,2023-01-03,SPIKE,gemGrab,Crystal Arcade,26,15,41
2124,2023-01-03,SPIKE,brawlBall,Center Stage,2,0,2
2125,2023-01-03,SPIKE,brawlBall,Beach Ball,54,48,102
2126,2023-01-03,SPIKE,bounty,Hideout,10,2,12
2127,2023-01-02,SPIKE,knockout,Belle's Rock,5,8,13
2128,2023-01-02,SPIKE,hotZone,Quarter Pounder,30,44,74
2129,2023-01-02,SPIKE,heist,Pit Stop,16,17,33
2130,2023-01-02,SPIKE,gemGrab,Minecart Madness,44,32,76
2131,2023-01-02,SPIKE,gemGrab,Double Swoosh,15,31,46
2132,2023-01-02,SPIKE,brawlBall,Center Stage,57,51,108
2133,2023-01-02,SPIKE,brawlBall,Backyard Bowl,6,1,7
2134,2023-01-02,SPIKE,bounty,Hideout,23,30,53
2135,2023-01-01,SPIKE,knockout,Belle's Rock,5,2,7
2136,2023-01-01,SPIKE,hotZone,Quarter Pounder,14,3,17
2137,2023-01-01,SPIKE,hotZone,Controller Chaos,0,1,1
2138,2023-01-01,SPIKE,heist,Bridge Too Far,1,2,3
2139,2023-01-01,SPIKE,gemGrab,Minecart Madness,1,0,1
2140,2023-01-01,SPIKE,gemGrab,Double Swoosh,8,7,15
2141,2023-01-01,SPIKE,brawlBall,Backyard Bowl,38,12,50
2142,2023-01-01,SPIKE,bounty,Canal Grande,1,0,1
2143,2022-12-31,SPIKE,hotZone,Controller Chaos,1,0,1
2144,2022-12-31,SPIKE,heist,Kaboom Canyon,1,0,1
2145,2022-12-31,SPIKE,heist,Bridge Too Far,2,0,2
2146,2022-12-31,SPIKE,gemGrab,Hard Rock Mine,1,0,1
2147,2022-12-31,SPIKE,gemGrab,Deep Diner,4,3,7
2148,2022-12-31,SPIKE,brawlBall,Super Beach,7,3,10
2149,2022-12-31,SPIKE,bounty,Canal Grande,1,0,1
2150,2022-12-30,SPIKE,knockout,Flaring Phoenix,1,0,1
2151,2022-12-30,SPIKE,hotZone,Controller Chaos,3,1,4
2152,2022-12-30,SPIKE,heist,Kaboom Canyon,1,0,1
2153,2022-12-30,SPIKE,gemGrab,Undermine,1,1,2
2154,2022-12-30,SPIKE,gemGrab,Deep Diner,2,0,2
2155,2022-12-30,SPIKE,brawlBall,Sneaky Fields,3,1,4
2156,2022-12-29,SPIKE,hotZone,Controller Chaos,1,1,2
2157,2022-12-29,SPIKE,heist,Hot Potato,1,0,1
2158,2022-12-29,SPIKE,gemGrab,Undermine,1,1,2
2159,2022-12-29,SPIKE,gemGrab,Minecart Madness,2,0,2
2160,2022-12-29,SPIKE,brawlBall,Pinhole Punt,6,2,8
2161,2022-12-28,SPIKE,brawlBall,Sunny Soccer,1,0,1
2162,2022-12-27,SPIKE,knockout,New Perspective,0,1,1
2163,2022-12-27,SPIKE,hotZone,Dueling Beetles,0,1,1
2164,2022-12-27,SPIKE,hotZone,Controller Chaos,1,1,2
2165,2022-12-27,SPIKE,gemGrab,Minecart Madness,0,1,1
2166,2022-12-27,SPIKE,brawlBall,Beach Ball,1,0,1
2167,2022-12-26,SPIKE,hotZone,Controller Chaos,0,1,1
2168,2022-12-26,SPIKE,heist,Kaboom Canyon,2,0,2
2169,2022-12-26,SPIKE,gemGrab,Minecart Madness,2,1,3
2170,2022-12-26,SPIKE,brawlBall,Center Stage,1,1,2
2171,2022-12-25,SPIKE,hotZone,Ring of Fire,0,1,1
2172,2022-12-25,SPIKE,gemGrab,Double Swoosh,2,0,2
2173,2022-12-25,SPIKE,brawlBall,Backyard Bowl,1,0,1
2174,2022-12-24,SPIKE,knockout,X Marks the Spot,1,0,1
2175,2022-12-23,SPIKE,knockout,Out in the Open,3,2,5
2176,2022-12-21,SPIKE,brawlBall,Sunny Soccer,0,1,1
2177,2022-12-19,SPIKE,brawlBall,Center Stage,2,1,3
2178,2022-12-16,SPIKE,brawlBall,Sneaky Fields,1,0,1
2179,2022-12-13,SPIKE,knockout,New Perspective,1,0,1
2180,2022-12-13,SPIKE,gemGrab,Crystal Arcade,1,0,1
2181,2022-12-11,SPIKE,brawlBall,Backyard Bowl,1,1,2
2182,2022-12-10,SPIKE,gemGrab,Hard Rock Mine,0,1,1
2183,2022-11-07,SPIKE,hotZone,Quarter Pounder,0,1,1
2184,2022-10-30,SPIKE,hotZone,Dueling Beetles,1,0,1
2185,2022-10-30,SPIKE,bounty,Canal Grande,1,0,1
2186,2022-10-28,SPIKE,knockout,Out in the Open,0,1,1
2187,2022-10-28,SPIKE,brawlBall,Beach Ball,0,1,1
2188,2023-02-05,SHELLY,knockout,X Marks the Spot,63,90,153
2189,2023-02-05,SHELLY,knockout,Goldarm Gulch,26,40,66
2190,2023-02-05,SHELLY,hotZone,Ring of Fire,17,5,22
2191,2023-02-05,SHELLY,heist,Snaked Assault,20,2,22
2192,2023-02-05,SHELLY,heist,Pit Stop,2,1,3
2193,2023-02-05,SHELLY,gemGrab,Hard Rock Mine,24,25,49
2194,2023-02-05,SHELLY,gemGrab,Double Swoosh,105,83,188
2195,2023-02-05,SHELLY,brawlBall,Super Beach,15,13,28
2196,2023-02-05,SHELLY,brawlBall,Sneaky Fields,67,42,109
2197,2023-02-05,SHELLY,brawlBall,Backyard Bowl,210,114,324
2198,2023-02-05,SHELLY,bounty,Layer Cake,9,3,12
2199,2023-02-04,SHELLY,knockout,X Marks the Spot,14,10,24
2200,2023-02-04,SHELLY,knockout,Goldarm Gulch,12,33,45
2201,2023-02-04,SHELLY,hotZone,Ring of Fire,3,0,3
2202,2023-02-04,SHELLY,heist,Tornado Ring,6,3,9
2203,2023-02-04,SHELLY,heist,Pit Stop,1,0,1
2204,2023-02-04,SHELLY,gemGrab,Hard Rock Mine,19,12,31
2205,2023-02-04,SHELLY,gemGrab,Double Swoosh,21,4,25
2206,2023-02-04,SHELLY,gemGrab,Deep Diner,2,0,2
2207,2023-02-04,SHELLY,brawlBall,Super Beach,132,91,223
2208,2023-02-04,SHELLY,brawlBall,Sneaky Fields,60,37,97
2209,2023-02-04,SHELLY,bounty,Dry Season,0,1,1
2210,2023-02-03,SHELLY,knockout,Out in the Open,60,70,130
2211,2023-02-03,SHELLY,knockout,Goldarm Gulch,62,103,165
2212,2023-02-03,SHELLY,hotZone,Split,29,35,64
2213,2023-02-03,SHELLY,heist,Tornado Ring,19,7,26
2214,2023-02-03,SHELLY,heist,Pit Stop,12,5,17
2215,2023-02-03,SHELLY,gemGrab,Undermine,16,6,22
2216,2023-02-03,SHELLY,gemGrab,Double Swoosh,143,27,170
2217,2023-02-03,SHELLY,gemGrab,Deep Diner,41,15,56
2218,2023-02-03,SHELLY,brawlBall,Sneaky Fields,1646,1548,3194
2219,2023-02-03,SHELLY,brawlBall,Pinhole Punt,14,6,20
2220,2023-02-03,SHELLY,bounty,Dry Season,8,4,12
2221,2023-02-02,SHELLY,knockout,Out in the Open,35,38,73
2222,2023-02-02,SHELLY,hotZone,Split,12,7,19
2223,2023-02-02,SHELLY,heist,Kaboom Canyon,5,1,6
2224,2023-02-02,SHELLY,gemGrab,Undermine,8,11,19
2225,2023-02-02,SHELLY,gemGrab,Gem Fort,14,8,22
2226,2023-02-02,SHELLY,brawlBall,Sunny Soccer,5,6,11
2227,2023-02-02,SHELLY,brawlBall,Pinhole Punt,120,80,200
2228,2023-02-02,SHELLY,bounty,Shooting Star,0,1,1
2229,2023-02-01,SHELLY,knockout,Goldarm Gulch,162,302,464
2230,2023-02-01,SHELLY,hotZone,Parallel Plays,33,9,42
2231,2023-02-01,SHELLY,heist,Kaboom Canyon,6,0,6
2232,2023-02-01,SHELLY,gemGrab,Gem Fort,64,40,104
2233,2023-02-01,SHELLY,gemGrab,Crystal Arcade,29,37,66
2234,2023-02-01,SHELLY,brawlBall,Sunny Soccer,353,260,613
2235,2023-02-01,SHELLY,brawlBall,Beach Ball,7,8,15
2236,2023-02-01,SHELLY,bounty,Shooting Star,6,2,8
2237,2023-01-31,SHELLY,knockout,Goldarm Gulch,76,73,149
2238,2023-01-31,SHELLY,hotZone,Parallel Plays,13,12,25
2239,2023-01-31,SHELLY,heist,Pit Stop,9,3,12
2240,2023-01-31,SHELLY,gemGrab,Minecart Madness,1,2,3
2241,2023-01-31,SHELLY,gemGrab,Crystal Arcade,20,11,31
2242,2023-01-31,SHELLY,brawlBall,Center Stage,12,12,24
2243,2023-01-31,SHELLY,brawlBall,Beach Ball,187,147,334
2244,2023-01-31,SHELLY,bounty,Hideout,1,2,3
2245,2023-01-30,SHELLY,knockout,Belle's Rock,49,34,83
2246,2023-01-30,SHELLY,hotZone,Quarter Pounder,34,19,53
2247,2023-01-30,SHELLY,heist,Pit Stop,28,15,43
2248,2023-01-30,SHELLY,gemGrab,Minecart Madness,14,13,27
2249,2023-01-30,SHELLY,gemGrab,Double Swoosh,60,25,85
2250,2023-01-30,SHELLY,brawlBall,Center Stage,829,837,1666
2251,2023-01-30,SHELLY,brawlBall,Backyard Bowl,25,14,39
2252,2023-01-30,SHELLY,bounty,Hideout,3,0,3
2253,2023-01-29,SHELLY,knockout,Belle's Rock,82,120,202
2254,2023-01-29,SHELLY,hotZone,Quarter Pounder,26,5,31
2255,2023-01-29,SHELLY,heist,Bridge Too Far,9,1,10
2256,2023-01-29,SHELLY,gemGrab,Hard Rock Mine,20,4,24
2257,2023-01-29,SHELLY,gemGrab,Double Swoosh,87,76,163
2258,2023-01-29,SHELLY,brawlBall,Super Beach,9,9,18
2259,2023-01-29,SHELLY,brawlBall,Backyard Bowl,226,122,348
2260,2023-01-29,SHELLY,bounty,Canal Grande,8,6,14
2261,2023-01-28,SHELLY,knockout,Flaring Phoenix,81,126,207
2262,2023-01-28,SHELLY,hotZone,Controller Chaos,37,9,46
2263,2023-01-28,SHELLY,heist,Bridge Too Far,16,4,20
2264,2023-01-28,SHELLY,gemGrab,Hard Rock Mine,50,41,91
2265,2023-01-28,SHELLY,gemGrab,Deep Diner,8,2,10
2266,2023-01-28,SHELLY,brawlBall,Super Beach,549,447,996
2267,2023-01-28,SHELLY,brawlBall,Sneaky Fields,49,39,88
2268,2023-01-28,SHELLY,bounty,Canal Grande,32,5,37
2269,2023-01-27,SHELLY,knockout,Flaring Phoenix,31,53,84
2270,2023-01-27,SHELLY,hotZone,Controller Chaos,9,0,9
2271,2023-01-27,SHELLY,heist,Hot Potato,6,5,11
2272,2023-01-27,SHELLY,gemGrab,Undermine,3,2,5
2273,2023-01-27,SHELLY,gemGrab,Deep Diner,10,4,14
2274,2023-01-27,SHELLY,brawlBall,Sneaky Fields,330,260,590
2275,2023-01-27,SHELLY,brawlBall,Pinhole Punt,3,4,7
2276,2023-01-27,SHELLY,bounty,Temple Ruins,4,2,6
2277,2023-01-26,SHELLY,knockout,Riverside,10,7,17
2278,2023-01-26,SHELLY,hotZone,Open Zone,19,2,21
2279,2023-01-26,SHELLY,heist,Hot Potato,18,14,32
2280,2023-01-26,SHELLY,gemGrab,Undermine,31,13,44
2281,2023-01-26,SHELLY,gemGrab,Gem Fort,48,34,82
2282,2023-01-26,SHELLY,brawlBall,Sunny Soccer,22,45,67
2283,2023-01-26,SHELLY,brawlBall,Pinhole Punt,424,325,749
2284,2023-01-26,SHELLY,bounty,Temple Ruins,22,27,49
2285,2023-01-25,SHELLY,knockout,Riverside,14,8,22
2286,2023-01-25,SHELLY,hotZone,Open Zone,6,0,6
2287,2023-01-25,SHELLY,heist,Safe Zone,7,2,9
2288,2023-01-25,SHELLY,gemGrab,Gem Fort,37,32,69
2289,2023-01-25,SHELLY,gemGrab,Crystal Arcade,29,6,35
2290,2023-01-25,SHELLY,brawlBall,Sunny Soccer,299,235,534
2291,2023-01-25,SHELLY,brawlBall,Beach Ball,31,51,82
2292,2023-01-25,SHELLY,bounty,Excel,3,1,4
2293,2023-01-24,SHELLY,knockout,New Perspective,27,31,58
2294,2023-01-24,SHELLY,hotZone,Dueling Beetles,10,3,13
2295,2023-01-24,SHELLY,heist,Safe Zone,8,1,9
2296,2023-01-24,SHELLY,gemGrab,Minecart Madness,2,1,3
2297,2023-01-24,SHELLY,gemGrab,Crystal Arcade,28,24,52
2298,2023-01-24,SHELLY,brawlBall,Center Stage,87,94,181
2299,2023-01-24,SHELLY,brawlBall,Beach Ball,419,372,791
2300,2023-01-24,SHELLY,bounty,Excel,17,15,32
2301,2023-01-23,SHELLY,knockout,New Perspective,151,159,310
2302,2023-01-23,SHELLY,hotZone,Dueling Beetles,22,10,32
2303,2023-01-23,SHELLY,heist,Snaked Assault,27,5,32
2304,2023-01-23,SHELLY,gemGrab,Minecart Madness,31,15,46
2305,2023-01-23,SHELLY,gemGrab,Double Swoosh,38,23,61
2306,2023-01-23,SHELLY,brawlBall,Center Stage,1213,1152,2365
2307,2023-01-23,SHELLY,brawlBall,Backyard Bowl,21,8,29
2308,2023-01-23,SHELLY,bounty,Layer Cake,19,2,21
2309,2023-01-22,SHELLY,knockout,X Marks the Spot,76,93,169
2310,2023-01-22,SHELLY,hotZone,Ring of Fire,9,3,12
2311,2023-01-22,SHELLY,heist,Snaked Assault,9,4,13
2312,2023-01-22,SHELLY,gemGrab,Hard Rock Mine,16,14,30
2313,2023-01-22,SHELLY,gemGrab,Double Swoosh,53,45,98
2314,2023-01-22,SHELLY,brawlBall,Super Beach,38,25,63
2315,2023-01-22,SHELLY,brawlBall,Backyard Bowl,100,70,170
2316,2023-01-22,SHELLY,bounty,Layer Cake,7,1,8
2317,2023-01-21,SHELLY,knockout,X Marks the Spot,190,259,449
2318,2023-01-21,SHELLY,hotZone,Ring of Fire,16,6,22
2319,2023-01-21,SHELLY,heist,Tornado Ring,19,5,24
2320,2023-01-21,SHELLY,gemGrab,Hard Rock Mine,56,23,79
2321,2023-01-21,SHELLY,gemGrab,Deep Diner,7,3,10
2322,2023-01-21,SHELLY,brawlBall,Super Beach,667,524,1191
2323,2023-01-21,SHELLY,brawlBall,Sneaky Fields,39,42,81
2324,2023-01-21,SHELLY,bounty,Dry Season,15,4,19
2325,2023-01-20,SHELLY,knockout,Out in the Open,65,72,137
2326,2023-01-20,SHELLY,hotZone,Split,33,40,73
2327,2023-01-20,SHELLY,heist,Tornado Ring,18,9,27
2328,2023-01-20,SHELLY,gemGrab,Undermine,19,11,30
2329,2023-01-20,SHELLY,gemGrab,Deep Diner,34,9,43
2330,2023-01-20,SHELLY,brawlBall,Sneaky Fields,1079,1074,2153
2331,2023-01-20,SHELLY,brawlBall,Pinhole Punt,15,10,25
2332,2023-01-20,SHELLY,bounty,Dry Season,8,5,13
2333,2023-01-19,SHELLY,knockout,Out in the Open,114,140,254
2334,2023-01-19,SHELLY,hotZone,Split,37,9,46
2335,2023-01-19,SHELLY,heist,Kaboom Canyon,8,7,15
2336,2023-01-19,SHELLY,gemGrab,Undermine,51,47,98
2337,2023-01-19,SHELLY,gemGrab,Gem Fort,26,16,42
2338,2023-01-19,SHELLY,brawlBall,Sunny Soccer,16,14,30
2339,2023-01-19,SHELLY,brawlBall,Pinhole Punt,439,310,749
2340,2023-01-19,SHELLY,bounty,Shooting Star,15,4,19
2341,2023-01-18,SHELLY,knockout,Goldarm Gulch,28,34,62
2342,2023-01-18,SHELLY,hotZone,Parallel Plays,2,1,3
2343,2023-01-18,SHELLY,heist,Kaboom Canyon,1,1,2
2344,2023-01-18,SHELLY,gemGrab,Gem Fort,18,15,33
2345,2023-01-18,SHELLY,gemGrab,Crystal Arcade,1,1,2
2346,2023-01-18,SHELLY,brawlBall,Sunny Soccer,117,103,220
2347,2023-01-18,SHELLY,brawlBall,Beach Ball,3,6,9
2348,2023-01-18,SHELLY,bounty,Shooting Star,1,1,2
2349,2023-01-17,SHELLY,knockout,Goldarm Gulch,21,24,45
2350,2023-01-17,SHELLY,hotZone,Parallel Plays,1,1,2
2351,2023-01-17,SHELLY,heist,Pit Stop,3,4,7
2352,2023-01-17,SHELLY,gemGrab,Crystal Arcade,5,2,7
2353,2023-01-17,SHELLY,brawlBall,Center Stage,6,5,11
2354,2023-01-17,SHELLY,brawlBall,Beach Ball,34,26,60
2355,2023-01-16,SHELLY,knockout,Belle's Rock,5,0,5
2356,2023-01-16,SHELLY,hotZone,Quarter Pounder,6,0,6
2357,2023-01-16,SHELLY,heist,Pit Stop,8,8,16
2358,2023-01-16,SHELLY,gemGrab,Minecart Madness,1,0,1
2359,2023-01-16,SHELLY,gemGrab,Double Swoosh,4,2,6
2360,2023-01-16,SHELLY,brawlBall,Center Stage,85,63,148
2361,2023-01-16,SHELLY,brawlBall,Backyard Bowl,3,1,4
2362,2023-01-16,SHELLY,bounty,Hideout,1,0,1
2363,2023-01-15,SHELLY,knockout,Belle's Rock,9,20,29
2364,2023-01-15,SHELLY,hotZone,Quarter Pounder,6,0,6
2365,2023-01-15,SHELLY,heist,Bridge Too Far,2,0,2
2366,2023-01-15,SHELLY,gemGrab,Hard Rock Mine,5,0,5
2367,2023-01-15,SHELLY,gemGrab,Double Swoosh,7,3,10
2368,2023-01-15,SHELLY,brawlBall,Super Beach,8,2,10
2369,2023-01-15,SHELLY,brawlBall,Backyard Bowl,32,12,44
2370,2023-01-15,SHELLY,bounty,Canal Grande,7,1,8
2371,2023-01-14,SHELLY,knockout,Flaring Phoenix,11,8,19
2372,2023-01-14,SHELLY,hotZone,Controller Chaos,10,1,11
2373,2023-01-14,SHELLY,heist,Bridge Too Far,3,0,3
2374,2023-01-14,SHELLY,gemGrab,Hard Rock Mine,3,1,4
2375,2023-01-14,SHELLY,gemGrab,Deep Diner,2,1,3
2376,2023-01-14,SHELLY,brawlBall,Super Beach,42,34,76
2377,2023-01-14,SHELLY,brawlBall,Sneaky Fields,3,16,19
2378,2023-01-14,SHELLY,bounty,Canal Grande,3,8,11
2379,2023-01-13,SHELLY,knockout,Flaring Phoenix,6,6,12
2380,2023-01-13,SHELLY,hotZone,Controller Chaos,5,3,8
2381,2023-01-13,SHELLY,gemGrab,Deep Diner,5,3,8
2382,2023-01-13,SHELLY,brawlBall,Sneaky Fields,63,91,154
2383,2023-01-13,SHELLY,bounty,Temple Ruins,3,0,3
2384,2023-01-12,SHELLY,knockout,Riverside,4,0,4
2385,2023-01-12,SHELLY,hotZone,Open Zone,1,1,2
2386,2023-01-12,SHELLY,gemGrab,Undermine,2,0,2
2387,2023-01-12,SHELLY,gemGrab,Gem Fort,2,1,3
2388,2023-01-12,SHELLY,brawlBall,Sunny Soccer,2,0,2
2389,2023-01-12,SHELLY,brawlBall,Pinhole Punt,7,1,8
2390,2023-01-12,SHELLY,bounty,Temple Ruins,0,1,1
2391,2023-01-11,SHELLY,knockout,Riverside,1,0,1
2392,2023-01-11,SHELLY,gemGrab,Gem Fort,3,1,4
2393,2023-01-11,SHELLY,brawlBall,Sunny Soccer,11,11,22
2394,2023-01-11,SHELLY,brawlBall,Beach Ball,1,1,2
2395,2023-01-10,SHELLY,knockout,New Perspective,5,15,20
2396,2023-01-10,SHELLY,hotZone,Dueling Beetles,2,0,2
2397,2023-01-10,SHELLY,heist,Safe Zone,1,0,1
2398,2023-01-10,SHELLY,gemGrab,Minecart Madness,3,0,3
2399,2023-01-10,SHELLY,gemGrab,Crystal Arcade,3,0,3
2400,2023-01-10,SHELLY,brawlBall,Center Stage,5,3,8
2401,2023-01-10,SHELLY,brawlBall,Beach Ball,23,8,31
2402,2023-01-10,SHELLY,bounty,Excel,2,0,2
2403,2023-01-09,SHELLY,knockout,New Perspective,6,23,29
2404,2023-01-09,SHELLY,hotZone,Dueling Beetles,1,4,5
2405,2023-01-09,SHELLY,heist,Snaked Assault,4,1,5
2406,2023-01-09,SHELLY,gemGrab,Minecart Madness,2,0,2
2407,2023-01-09,SHELLY,gemGrab,Double Swoosh,8,0,8
2408,2023-01-09,SHELLY,brawlBall,Center Stage,80,68,148
2409,2023-01-09,SHELLY,brawlBall,Backyard Bowl,2,0,2
2410,2023-01-09,SHELLY,bounty,Layer Cake,5,0,5
2411,2023-01-08,SHELLY,knockout,X Marks the Spot,3,3,6
2412,2023-01-08,SHELLY,hotZone,Ring of Fire,1,0,1
2413,2023-01-08,SHELLY,heist,Snaked Assault,5,0,5
2414,2023-01-08,SHELLY,gemGrab,Hard Rock Mine,4,2,6
2415,2023-01-08,SHELLY,gemGrab,Double Swoosh,7,3,10
2416,2023-01-08,SHELLY,brawlBall,Super Beach,2,1,3
2417,2023-01-08,SHELLY,brawlBall,Backyard Bowl,21,4,25
2418,2023-01-08,SHELLY,bounty,Layer Cake,1,0,1
2419,2023-01-07,SHELLY,hotZone,Ring of Fire,1,0,1
2420,2023-01-07,SHELLY,heist,Tornado Ring,2,0,2
2421,2023-01-07,SHELLY,gemGrab,Hard Rock Mine,1,0,1
2422,2023-01-07,SHELLY,gemGrab,Deep Diner,3,0,3
2423,2023-01-07,SHELLY,brawlBall,Super Beach,7,2,9
2424,2023-01-07,SHELLY,brawlBall,Sneaky Fields,3,0,3
2425,2023-01-07,SHELLY,bounty,Dry Season,2,0,2
2426,2023-01-06,SHELLY,knockout,Out in the Open,12,24,36
2427,2023-01-06,SHELLY,hotZone,Split,5,0,5
2428,2023-01-06,SHELLY,heist,Tornado Ring,3,0,3
2429,2023-01-06,SHELLY,gemGrab,Deep Diner,2,0,2
2430,2023-01-06,SHELLY,brawlBall,Sneaky Fields,46,60,106
2431,2023-01-06,SHELLY,brawlBall,Pinhole Punt,4,1,5
2432,2023-01-06,SHELLY,bounty,Dry Season,1,0,1
2433,2023-01-05,SHELLY,knockout,Out in the Open,16,13,29
2434,2023-01-05,SHELLY,hotZone,Split,8,0,8
2435,2023-01-05,SHELLY,heist,Kaboom Canyon,3,1,4
2436,2023-01-05,SHELLY,gemGrab,Undermine,5,1,6
2437,2023-01-05,SHELLY,gemGrab,Gem Fort,0,1,1
2438,2023-01-05,SHELLY,brawlBall,Pinhole Punt,31,13,44
2439,2023-01-05,SHELLY,bounty,Shooting Star,1,0,1
2440,2023-01-04,SHELLY,knockout,Goldarm Gulch,7,5,12
2441,2023-01-04,SHELLY,hotZone,Parallel Plays,3,0,3
2442,2023-01-04,SHELLY,heist,Kaboom Canyon,3,0,3
2443,2023-01-04,SHELLY,gemGrab,Gem Fort,5,2,7
2444,2023-01-04,SHELLY,gemGrab,Crystal Arcade,1,3,4
2445,2023-01-04,SHELLY,brawlBall,Sunny Soccer,46,27,73
2446,2023-01-04,SHELLY,brawlBall,Beach Ball,1,0,1
2447,2023-01-03,SHELLY,knockout,Goldarm Gulch,3,0,3
2448,2023-01-03,SHELLY,hotZone,Parallel Plays,3,0,3
2449,2023-01-03,SHELLY,heist,Pit Stop,3,0,3
2450,2023-01-03,SHELLY,gemGrab,Minecart Madness,1,0,1
2451,2023-01-03,SHELLY,gemGrab,Crystal Arcade,2,1,3
2452,2023-01-03,SHELLY,brawlBall,Center Stage,4,10,14
2453,2023-01-03,SHELLY,brawlBall,Beach Ball,24,1,25
2454,2023-01-02,SHELLY,knockout,Belle's Rock,4,0,4
2455,2023-01-02,SHELLY,hotZone,Quarter Pounder,10,1,11
2456,2023-01-02,SHELLY,heist,Pit Stop,5,1,6
2457,2023-01-02,SHELLY,heist,Kaboom Canyon,0,1,1
2458,2023-01-02,SHELLY,gemGrab,Minecart Madness,1,0,1
2459,2023-01-02,SHELLY,gemGrab,Double Swoosh,9,15,24
2460,2023-01-02,SHELLY,brawlBall,Center Stage,68,79,147
2461,2023-01-02,SHELLY,brawlBall,Backyard Bowl,2,3,5
2462,2023-01-02,SHELLY,bounty,Hideout,4,0,4
2463,2023-01-01,SHELLY,knockout,Belle's Rock,2,4,6
2464,2023-01-01,SHELLY,hotZone,Quarter Pounder,1,0,1
2465,2023-01-01,SHELLY,gemGrab,Hard Rock Mine,0,1,1
2466,2023-01-01,SHELLY,gemGrab,Double Swoosh,5,1,6
2467,2023-01-01,SHELLY,brawlBall,Backyard Bowl,6,6,12
2468,2022-12-31,SHELLY,knockout,Flaring Phoenix,0,1,1
2469,2022-12-31,SHELLY,hotZone,Controller Chaos,2,0,2
2470,2022-12-31,SHELLY,gemGrab,Deep Diner,1,0,1
2471,2022-12-31,SHELLY,brawlBall,Super Beach,5,2,7
2472,2022-12-31,SHELLY,brawlBall,Sneaky Fields,0,1,1
2473,2022-12-30,SHELLY,knockout,Flaring Phoenix,2,1,3
2474,2022-12-30,SHELLY,hotZone,Controller Chaos,3,0,3
2475,2022-12-30,SHELLY,gemGrab,Minecart Madness,0,1,1
2476,2022-12-30,SHELLY,gemGrab,Deep Diner,1,0,1
2477,2022-12-30,SHELLY,brawlBall,Sneaky Fields,3,1,4
2478,2022-12-29,SHELLY,gemGrab,Undermine,1,0,1
2479,2022-12-29,SHELLY,brawlBall,Pinhole Punt,0,1,1
2480,2022-12-28,SHELLY,hotZone,Controller Chaos,0,1,1
2481,2022-12-28,SHELLY,gemGrab,Crystal Arcade,1,0,1
2482,2022-12-28,SHELLY,brawlBall,Beach Ball,1,0,1
2483,2022-12-27,SHELLY,brawlBall,Beach Ball,1,1,2
2484,2022-12-26,SHELLY,hotZone,Controller Chaos,0,1,1
2485,2022-12-26,SHELLY,heist,Kaboom Canyon,0,1,1
2486,2022-12-26,SHELLY,gemGrab,Minecart Madness,1,1,2
2487,2022-12-26,SHELLY,brawlBall,Center Stage,1,0,1
2488,2022-12-24,SHELLY,brawlBall,Super Beach,1,0,1
2489,2022-12-23,SHELLY,brawlBall,Sneaky Fields,0,1,1
2490,2022-12-22,SHELLY,brawlBall,Pinhole Punt,1,0,1
2491,2022-12-20,SHELLY,brawlBall,Beach Ball,1,1,2
2492,2022-12-13,SHELLY,brawlBall,Beach Ball,0,1,1
2493,2022-10-26,SHELLY,brawlBall,Sunny Soccer,0,1,1
2494,2023-02-05,SANDY,knockout,X Marks the Spot,3,3,6
2495,2023-02-05,SANDY,hotZone,Ring of Fire,35,51,86
2496,2023-02-05,SANDY,heist,Snaked Assault,3,0,3
2497,2023-02-05,SANDY,gemGrab,Hard Rock Mine,21,23,44
2498,2023-02-05,SANDY,gemGrab,Double Swoosh,114,108,222
2499,2023-02-05,SANDY,brawlBall,Super Beach,15,22,37
2500,2023-02-05,SANDY,brawlBall,Sneaky Fields,17,3,20
2501,2023-02-05,SANDY,brawlBall,Backyard Bowl,64,61,125
2502,2023-02-05,SANDY,bounty,Layer Cake,8,13,21
2503,2023-02-04,SANDY,knockout,X Marks the Spot,3,0,3
2504,2023-02-04,SANDY,hotZone,Ring of Fire,6,12,18
2505,2023-02-04,SANDY,heist,Pit Stop,0,1,1
2506,2023-02-04,SANDY,gemGrab,Hard Rock Mine,14,7,21
2507,2023-02-04,SANDY,gemGrab,Double Swoosh,17,17,34
2508,2023-02-04,SANDY,gemGrab,Deep Diner,1,4,5
2509,2023-02-04,SANDY,brawlBall,Super Beach,78,81,159
2510,2023-02-04,SANDY,brawlBall,Sneaky Fields,6,4,10
2511,2023-02-04,SANDY,bounty,Dry Season,2,0,2
2512,2023-02-03,SANDY,knockout,Out in the Open,8,6,14
2513,2023-02-03,SANDY,knockout,Goldarm Gulch,4,5,9
2514,2023-02-03,SANDY,hotZone,Split,14,7,21
2515,2023-02-03,SANDY,heist,Tornado Ring,2,1,3
2516,2023-02-03,SANDY,heist,Pit Stop,0,5,5
2517,2023-02-03,SANDY,gemGrab,Undermine,17,26,43
2518,2023-02-03,SANDY,gemGrab,Double Swoosh,140,126,266
2519,2023-02-03,SANDY,gemGrab,Deep Diner,86,114,200
2520,2023-02-03,SANDY,brawlBall,Sneaky Fields,297,331,628
2521,2023-02-03,SANDY,brawlBall,Pinhole Punt,8,10,18
2522,2023-02-03,SANDY,bounty,Dry Season,5,3,8
2523,2023-02-02,SANDY,knockout,Out in the Open,2,4,6
2524,2023-02-02,SANDY,hotZone,Split,7,7,14
2525,2023-02-02,SANDY,gemGrab,Undermine,21,20,41
2526,2023-02-02,SANDY,gemGrab,Gem Fort,5,10,15
2527,2023-02-02,SANDY,brawlBall,Sunny Soccer,2,3,5
2528,2023-02-02,SANDY,brawlBall,Pinhole Punt,57,85,142
2529,2023-02-02,SANDY,bounty,Shooting Star,2,1,3
2530,2023-02-01,SANDY,knockout,Goldarm Gulch,20,19,39
2531,2023-02-01,SANDY,hotZone,Parallel Plays,23,15,38
2532,2023-02-01,SANDY,heist,Kaboom Canyon,0,1,1
2533,2023-02-01,SANDY,gemGrab,Gem Fort,55,69,124
2534,2023-02-01,SANDY,gemGrab,Crystal Arcade,46,63,109
2535,2023-02-01,SANDY,brawlBall,Sunny Soccer,214,267,481
2536,2023-02-01,SANDY,brawlBall,Beach Ball,6,15,21
2537,2023-02-01,SANDY,bounty,Shooting Star,2,0,2
2538,2023-01-31,SANDY,knockout,Goldarm Gulch,8,9,17
2539,2023-01-31,SANDY,hotZone,Parallel Plays,13,7,20
2540,2023-01-31,SANDY,heist,Pit Stop,1,0,1
2541,2023-01-31,SANDY,gemGrab,Minecart Madness,0,2,2
2542,2023-01-31,SANDY,gemGrab,Crystal Arcade,42,65,107
2543,2023-01-31,SANDY,brawlBall,Center Stage,0,1,1
2544,2023-01-31,SANDY,brawlBall,Beach Ball,89,99,188
2545,2023-01-31,SANDY,bounty,Hideout,2,2,4
2546,2023-01-30,SANDY,knockout,Belle's Rock,6,5,11
2547,2023-01-30,SANDY,hotZone,Quarter Pounder,47,67,114
2548,2023-01-30,SANDY,heist,Pit Stop,1,0,1
2549,2023-01-30,SANDY,gemGrab,Minecart Madness,31,35,66
2550,2023-01-30,SANDY,gemGrab,Double Swoosh,59,73,132
2551,2023-01-30,SANDY,brawlBall,Center Stage,148,175,323
2552,2023-01-30,SANDY,brawlBall,Backyard Bowl,4,2,6
2553,2023-01-30,SANDY,bounty,Hideout,2,1,3
2554,2023-01-29,SANDY,knockout,Belle's Rock,9,4,13
2555,2023-01-29,SANDY,hotZone,Quarter Pounder,21,18,39
2556,2023-01-29,SANDY,heist,Bridge Too Far,1,1,2
2557,2023-01-29,SANDY,gemGrab,Hard Rock Mine,10,23,33
2558,2023-01-29,SANDY,gemGrab,Double Swoosh,100,100,200
2559,2023-01-29,SANDY,brawlBall,Super Beach,10,20,30
2560,2023-01-29,SANDY,brawlBall,Backyard Bowl,75,61,136
2561,2023-01-29,SANDY,bounty,Canal Grande,15,9,24
2562,2023-01-28,SANDY,knockout,Flaring Phoenix,6,7,13
2563,2023-01-28,SANDY,hotZone,Controller Chaos,36,54,90
2564,2023-01-28,SANDY,heist,Bridge Too Far,3,0,3
2565,2023-01-28,SANDY,gemGrab,Hard Rock Mine,66,76,142
2566,2023-01-28,SANDY,gemGrab,Deep Diner,20,43,63
2567,2023-01-28,SANDY,brawlBall,Super Beach,310,342,652
2568,2023-01-28,SANDY,brawlBall,Sneaky Fields,7,9,16
2569,2023-01-28,SANDY,bounty,Canal Grande,23,26,49
2570,2023-01-27,SANDY,knockout,Flaring Phoenix,1,2,3
2571,2023-01-27,SANDY,hotZone,Controller Chaos,14,16,30
2572,2023-01-27,SANDY,gemGrab,Undermine,5,6,11
2573,2023-01-27,SANDY,gemGrab,Deep Diner,38,57,95
2574,2023-01-27,SANDY,brawlBall,Sneaky Fields,62,69,131
2575,2023-01-27,SANDY,brawlBall,Pinhole Punt,1,1,2
2576,2023-01-27,SANDY,bounty,Temple Ruins,3,7,10
2577,2023-01-26,SANDY,knockout,Riverside,8,9,17
2578,2023-01-26,SANDY,hotZone,Open Zone,28,12,40
2579,2023-01-26,SANDY,heist,Hot Potato,3,1,4
2580,2023-01-26,SANDY,gemGrab,Undermine,61,86,147
2581,2023-01-26,SANDY,gemGrab,Gem Fort,29,24,53
2582,2023-01-26,SANDY,brawlBall,Sunny Soccer,16,4,20
2583,2023-01-26,SANDY,brawlBall,Pinhole Punt,257,273,530
2584,2023-01-26,SANDY,bounty,Temple Ruins,13,10,23
2585,2023-01-25,SANDY,hotZone,Open Zone,1,6,7
2586,2023-01-25,SANDY,heist,Safe Zone,2,0,2
2587,2023-01-25,SANDY,gemGrab,Gem Fort,24,22,46
2588,2023-01-25,SANDY,gemGrab,Crystal Arcade,52,58,110
2589,2023-01-25,SANDY,brawlBall,Sunny Soccer,133,194,327
2590,2023-01-25,SANDY,brawlBall,Beach Ball,24,17,41
2591,2023-01-25,SANDY,bounty,Excel,2,1,3
2592,2023-01-24,SANDY,knockout,New Perspective,12,6,18
2593,2023-01-24,SANDY,hotZone,Dueling Beetles,57,41,98
2594,2023-01-24,SANDY,gemGrab,Minecart Madness,16,13,29
2595,2023-01-24,SANDY,gemGrab,Crystal Arcade,136,183,319
2596,2023-01-24,SANDY,brawlBall,Center Stage,23,35,58
2597,2023-01-24,SANDY,brawlBall,Beach Ball,273,320,593
2598,2023-01-24,SANDY,bounty,Excel,9,2,11
2599,2023-01-23,SANDY,knockout,New Perspective,18,7,25
2600,2023-01-23,SANDY,hotZone,Dueling Beetles,64,52,116
2601,2023-01-23,SANDY,heist,Snaked Assault,1,2,3
2602,2023-01-23,SANDY,gemGrab,Minecart Madness,41,35,76
2603,2023-01-23,SANDY,gemGrab,Double Swoosh,52,61,113
2604,2023-01-23,SANDY,brawlBall,Center Stage,242,329,571
2605,2023-01-23,SANDY,brawlBall,Backyard Bowl,5,3,8
2606,2023-01-23,SANDY,bounty,Layer Cake,3,7,10
2607,2023-01-22,SANDY,knockout,X Marks the Spot,3,3,6
2608,2023-01-22,SANDY,hotZone,Ring of Fire,22,17,39
2609,2023-01-22,SANDY,heist,Snaked Assault,1,0,1
2610,2023-01-22,SANDY,gemGrab,Hard Rock Mine,19,21,40
2611,2023-01-22,SANDY,gemGrab,Double Swoosh,92,112,204
2612,2023-01-22,SANDY,brawlBall,Super Beach,27,28,55
2613,2023-01-22,SANDY,brawlBall,Backyard Bowl,36,42,78
2614,2023-01-22,SANDY,bounty,Layer Cake,5,4,9
2615,2023-01-21,SANDY,knockout,X Marks the Spot,20,9,29
2616,2023-01-21,SANDY,hotZone,Ring of Fire,76,77,153
2617,2023-01-21,SANDY,heist,Tornado Ring,2,0,2
2618,2023-01-21,SANDY,gemGrab,Hard Rock Mine,113,101,214
2619,2023-01-21,SANDY,gemGrab,Deep Diner,16,10,26
2620,2023-01-21,SANDY,brawlBall,Super Beach,415,485,900
2621,2023-01-21,SANDY,brawlBall,Sneaky Fields,6,8,14
2622,2023-01-21,SANDY,bounty,Dry Season,1,4,5
2623,2023-01-20,SANDY,knockout,Out in the Open,14,21,35
2624,2023-01-20,SANDY,hotZone,Split,17,17,34
2625,2023-01-20,SANDY,heist,Tornado Ring,0,2,2
2626,2023-01-20,SANDY,gemGrab,Undermine,35,31,66
2627,2023-01-20,SANDY,gemGrab,Deep Diner,83,90,173
2628,2023-01-20,SANDY,brawlBall,Sneaky Fields,300,297,597
2629,2023-01-20,SANDY,brawlBall,Pinhole Punt,3,6,9
2630,2023-01-20,SANDY,bounty,Dry Season,5,11,16
2631,2023-01-19,SANDY,knockout,Out in the Open,20,9,29
2632,2023-01-19,SANDY,hotZone,Split,18,16,34
2633,2023-01-19,SANDY,heist,Kaboom Canyon,3,4,7
2634,2023-01-19,SANDY,gemGrab,Undermine,68,122,190
2635,2023-01-19,SANDY,gemGrab,Gem Fort,10,12,22
2636,2023-01-19,SANDY,brawlBall,Sunny Soccer,7,7,14
2637,2023-01-19,SANDY,brawlBall,Pinhole Punt,240,285,525
2638,2023-01-19,SANDY,bounty,Shooting Star,3,2,5
2639,2023-01-18,SANDY,knockout,Goldarm Gulch,4,4,8
2640,2023-01-18,SANDY,hotZone,Parallel Plays,5,12,17
2641,2023-01-18,SANDY,heist,Kaboom Canyon,0,1,1
2642,2023-01-18,SANDY,gemGrab,Gem Fort,17,14,31
2643,2023-01-18,SANDY,gemGrab,Crystal Arcade,9,15,24
2644,2023-01-18,SANDY,brawlBall,Sunny Soccer,88,95,183
2645,2023-01-18,SANDY,brawlBall,Beach Ball,4,2,6
2646,2023-01-18,SANDY,bounty,Shooting Star,2,0,2
2647,2023-01-17,SANDY,knockout,Goldarm Gulch,5,8,13
2648,2023-01-17,SANDY,hotZone,Parallel Plays,5,4,9
2649,2023-01-17,SANDY,heist,Pit Stop,0,1,1
2650,2023-01-17,SANDY,gemGrab,Crystal Arcade,7,8,15
2651,2023-01-17,SANDY,brawlBall,Beach Ball,23,31,54
2652,2023-01-17,SANDY,bounty,Hideout,4,4,8
2653,2023-01-16,SANDY,knockout,Belle's Rock,1,0,1
2654,2023-01-16,SANDY,hotZone,Quarter Pounder,7,3,10
2655,2023-01-16,SANDY,heist,Pit Stop,1,1,2
2656,2023-01-16,SANDY,gemGrab,Minecart Madness,1,0,1
2657,2023-01-16,SANDY,gemGrab,Double Swoosh,7,4,11
2658,2023-01-16,SANDY,brawlBall,Center Stage,13,4,17
2659,2023-01-16,SANDY,brawlBall,Backyard Bowl,1,0,1
2660,2023-01-15,SANDY,hotZone,Quarter Pounder,2,0,2
2661,2023-01-15,SANDY,heist,Bridge Too Far,0,1,1
2662,2023-01-15,SANDY,gemGrab,Hard Rock Mine,7,22,29
2663,2023-01-15,SANDY,gemGrab,Double Swoosh,16,17,33
2664,2023-01-15,SANDY,brawlBall,Super Beach,5,8,13
2665,2023-01-15,SANDY,brawlBall,Backyard Bowl,11,3,14
2666,2023-01-15,SANDY,bounty,Canal Grande,1,1,2
2667,2023-01-14,SANDY,hotZone,Controller Chaos,16,32,48
2668,2023-01-14,SANDY,gemGrab,Hard Rock Mine,4,2,6
2669,2023-01-14,SANDY,gemGrab,Deep Diner,1,4,5
2670,2023-01-14,SANDY,brawlBall,Super Beach,21,30,51
2671,2023-01-14,SANDY,brawlBall,Sneaky Fields,0,5,5
2672,2023-01-14,SANDY,bounty,Canal Grande,9,8,17
2673,2023-01-13,SANDY,knockout,Flaring Phoenix,1,0,1
2674,2023-01-13,SANDY,hotZone,Controller Chaos,3,0,3
2675,2023-01-13,SANDY,gemGrab,Undermine,0,1,1
2676,2023-01-13,SANDY,gemGrab,Deep Diner,6,2,8
2677,2023-01-13,SANDY,brawlBall,Sneaky Fields,10,6,16
2678,2023-01-13,SANDY,brawlBall,Pinhole Punt,0,1,1
2679,2023-01-12,SANDY,hotZone,Open Zone,4,0,4
2680,2023-01-12,SANDY,gemGrab,Undermine,4,5,9
2681,2023-01-12,SANDY,gemGrab,Gem Fort,2,3,5
2682,2023-01-12,SANDY,brawlBall,Sunny Soccer,2,13,15
2683,2023-01-12,SANDY,brawlBall,Pinhole Punt,10,11,21
2684,2023-01-11,SANDY,hotZone,Open Zone,0,3,3
2685,2023-01-11,SANDY,gemGrab,Gem Fort,1,0,1
2686,2023-01-11,SANDY,brawlBall,Sunny Soccer,6,2,8
2687,2023-01-11,SANDY,brawlBall,Beach Ball,0,1,1
2688,2023-01-10,SANDY,knockout,New Perspective,1,1,2
2689,2023-01-10,SANDY,hotZone,Dueling Beetles,13,12,25
2690,2023-01-10,SANDY,gemGrab,Crystal Arcade,15,43,58
2691,2023-01-10,SANDY,brawlBall,Center Stage,0,1,1
2692,2023-01-10,SANDY,brawlBall,Beach Ball,24,8,32
2693,2023-01-09,SANDY,knockout,New Perspective,2,0,2
2694,2023-01-09,SANDY,hotZone,Dueling Beetles,12,14,26
2695,2023-01-09,SANDY,gemGrab,Minecart Madness,2,1,3
2696,2023-01-09,SANDY,gemGrab,Double Swoosh,7,4,11
2697,2023-01-09,SANDY,brawlBall,Center Stage,7,15,22
2698,2023-01-09,SANDY,brawlBall,Backyard Bowl,2,0,2
2699,2023-01-08,SANDY,knockout,X Marks the Spot,2,0,2
2700,2023-01-08,SANDY,hotZone,Ring of Fire,3,4,7
2701,2023-01-08,SANDY,gemGrab,Hard Rock Mine,1,0,1
2702,2023-01-08,SANDY,gemGrab,Double Swoosh,7,22,29
2703,2023-01-08,SANDY,brawlBall,Super Beach,2,0,2
2704,2023-01-08,SANDY,brawlBall,Backyard Bowl,2,5,7
2705,2023-01-07,SANDY,hotZone,Ring of Fire,4,6,10
2706,2023-01-07,SANDY,gemGrab,Hard Rock Mine,6,3,9
2707,2023-01-07,SANDY,gemGrab,Deep Diner,4,7,11
2708,2023-01-07,SANDY,brawlBall,Super Beach,13,18,31
2709,2023-01-07,SANDY,brawlBall,Sneaky Fields,1,0,1
2710,2023-01-06,SANDY,hotZone,Split,2,4,6
2711,2023-01-06,SANDY,heist,Tornado Ring,1,0,1
2712,2023-01-06,SANDY,gemGrab,Undermine,4,1,5
2713,2023-01-06,SANDY,gemGrab,Deep Diner,12,7,19
2714,2023-01-06,SANDY,brawlBall,Sneaky Fields,11,11,22
2715,2023-01-06,SANDY,brawlBall,Pinhole Punt,4,1,5
2716,2023-01-06,SANDY,bounty,Dry Season,1,0,1
2717,2023-01-05,SANDY,hotZone,Split,6,13,19
2718,2023-01-05,SANDY,gemGrab,Undermine,5,3,8
2719,2023-01-05,SANDY,gemGrab,Gem Fort,2,12,14
2720,2023-01-05,SANDY,brawlBall,Pinhole Punt,24,23,47
2721,2023-01-04,SANDY,knockout,Goldarm Gulch,1,0,1
2722,2023-01-04,SANDY,hotZone,Parallel Plays,1,1,2
2723,2023-01-04,SANDY,gemGrab,Gem Fort,6,17,23
2724,2023-01-04,SANDY,gemGrab,Crystal Arcade,5,5,10
2725,2023-01-04,SANDY,brawlBall,Sunny Soccer,19,22,41
2726,2023-01-03,SANDY,gemGrab,Minecart Madness,1,0,1
2727,2023-01-03,SANDY,gemGrab,Crystal Arcade,22,5,27
2728,2023-01-03,SANDY,brawlBall,Beach Ball,13,11,24
2729,2023-01-02,SANDY,knockout,Belle's Rock,1,0,1
2730,2023-01-02,SANDY,hotZone,Quarter Pounder,2,1,3
2731,2023-01-02,SANDY,gemGrab,Minecart Madness,7,0,7
2732,2023-01-02,SANDY,gemGrab,Double Swoosh,8,16,24
2733,2023-01-02,SANDY,brawlBall,Center Stage,10,10,20
2734,2023-01-02,SANDY,brawlBall,Backyard Bowl,0,1,1
2735,2023-01-01,SANDY,hotZone,Quarter Pounder,6,11,17
2736,2023-01-01,SANDY,gemGrab,Double Swoosh,14,18,32
2737,2023-01-01,SANDY,brawlBall,Backyard Bowl,3,6,9
2738,2022-12-31,SANDY,hotZone,Controller Chaos,0,1,1
2739,2022-12-31,SANDY,gemGrab,Deep Diner,1,0,1
2740,2022-12-31,SANDY,brawlBall,Super Beach,5,2,7
2741,2022-12-30,SANDY,hotZone,Controller Chaos,1,2,3
2742,2022-12-30,SANDY,gemGrab,Minecart Madness,1,0,1
2743,2022-12-30,SANDY,gemGrab,Deep Diner,0,2,2
2744,2022-12-30,SANDY,brawlBall,Sneaky Fields,5,8,13
2745,2022-12-29,SANDY,brawlBall,Pinhole Punt,4,4,8
2746,2022-12-28,SANDY,gemGrab,Crystal Arcade,0,1,1
2747,2022-12-27,SANDY,hotZone,Dueling Beetles,1,0,1
2748,2022-12-27,SANDY,brawlBall,Beach Ball,0,1,1
2749,2022-12-21,SANDY,brawlBall,Sunny Soccer,0,1,1
2750,2022-12-20,SANDY,brawlBall,Beach Ball,0,1,1
2751,2022-12-19,SANDY,brawlBall,Center Stage,0,1,1
2752,2022-12-13,SANDY,knockout,New Perspective,1,0,1
2753,2022-12-13,SANDY,brawlBall,Beach Ball,0,1,1
2754,2022-10-30,SANDY,brawlBall,Beach Ball,1,0,1
2755,2022-10-15,SANDY,gemGrab,Hard Rock Mine,1,2,3
2756,2023-02-05,SAM,knockout,X Marks the Spot,19,13,32
2757,2023-02-05,SAM,knockout,Goldarm Gulch,3,5,8
2758,2023-02-05,SAM,hotZone,Ring of Fire,38,40,78
2759,2023-02-05,SAM,heist,Snaked Assault,89,118,207
2760,2023-02-05,SAM,heist,Pit Stop,37,54,91
2761,2023-02-05,SAM,gemGrab,Hard Rock Mine,53,114,167
2762,2023-02-05,SAM,gemGrab,Double Swoosh,106,115,221
2763,2023-02-05,SAM,brawlBall,Super Beach,28,29,57
2764,2023-02-05,SAM,brawlBall,Sneaky Fields,63,54,117
2765,2023-02-05,SAM,brawlBall,Backyard Bowl,284,363,647
2766,2023-02-05,SAM,bounty,Layer Cake,23,12,35
2767,2023-02-04,SAM,knockout,X Marks the Spot,10,5,15
2768,2023-02-04,SAM,knockout,Goldarm Gulch,2,8,10
2769,2023-02-04,SAM,hotZone,Ring of Fire,8,5,13
2770,2023-02-04,SAM,heist,Tornado Ring,9,9,18
2771,2023-02-04,SAM,heist,Pit Stop,27,53,80
2772,2023-02-04,SAM,gemGrab,Hard Rock Mine,27,50,77
2773,2023-02-04,SAM,gemGrab,Double Swoosh,23,6,29
2774,2023-02-04,SAM,gemGrab,Deep Diner,3,4,7
2775,2023-02-04,SAM,brawlBall,Super Beach,183,228,411
2776,2023-02-04,SAM,brawlBall,Sneaky Fields,49,38,87
2777,2023-02-04,SAM,bounty,Dry Season,4,0,4
2778,2023-02-03,SAM,knockout,Out in the Open,39,52,91
2779,2023-02-03,SAM,knockout,Goldarm Gulch,14,21,35
2780,2023-02-03,SAM,hotZone,Split,116,202,318
2781,2023-02-03,SAM,heist,Tornado Ring,105,146,251
2782,2023-02-03,SAM,heist,Pit Stop,222,280,502
2783,2023-02-03,SAM,gemGrab,Undermine,19,30,49
2784,2023-02-03,SAM,gemGrab,Double Swoosh,128,103,231
2785,2023-02-03,SAM,gemGrab,Deep Diner,69,86,155
2786,2023-02-03,SAM,brawlBall,Sneaky Fields,825,923,1748
2787,2023-02-03,SAM,brawlBall,Pinhole Punt,20,33,53
2788,2023-02-03,SAM,bounty,Dry Season,30,25,55
2789,2023-02-02,SAM,knockout,Out in the Open,17,19,36
2790,2023-02-02,SAM,hotZone,Split,48,104,152
2791,2023-02-02,SAM,heist,Kaboom Canyon,6,7,13
2792,2023-02-02,SAM,gemGrab,Undermine,25,17,42
2793,2023-02-02,SAM,gemGrab,Gem Fort,4,2,6
2794,2023-02-02,SAM,brawlBall,Sunny Soccer,7,11,18
2795,2023-02-02,SAM,brawlBall,Pinhole Punt,153,163,316
2796,2023-02-02,SAM,bounty,Shooting Star,5,2,7
2797,2023-02-01,SAM,knockout,Goldarm Gulch,72,76,148
2798,2023-02-01,SAM,hotZone,Parallel Plays,184,283,467
2799,2023-02-01,SAM,heist,Kaboom Canyon,23,28,51
2800,2023-02-01,SAM,gemGrab,Gem Fort,58,72,130
2801,2023-02-01,SAM,gemGrab,Crystal Arcade,33,53,86
2802,2023-02-01,SAM,brawlBall,Sunny Soccer,545,679,1224
2803,2023-02-01,SAM,brawlBall,Beach Ball,20,32,52
2804,2023-02-01,SAM,bounty,Shooting Star,7,5,12
2805,2023-01-31,SAM,knockout,Goldarm Gulch,44,35,79
2806,2023-01-31,SAM,hotZone,Parallel Plays,74,137,211
2807,2023-01-31,SAM,heist,Pit Stop,52,62,114
2808,2023-01-31,SAM,gemGrab,Minecart Madness,7,3,10
2809,2023-01-31,SAM,gemGrab,Crystal Arcade,32,20,52
2810,2023-01-31,SAM,brawlBall,Center Stage,8,4,12
2811,2023-01-31,SAM,brawlBall,Beach Ball,185,226,411
2812,2023-01-31,SAM,bounty,Hideout,2,1,3
2813,2023-01-30,SAM,knockout,Belle's Rock,85,81,166
2814,2023-01-30,SAM,hotZone,Quarter Pounder,110,139,249
2815,2023-01-30,SAM,heist,Pit Stop,142,145,287
2816,2023-01-30,SAM,gemGrab,Minecart Madness,29,30,59
2817,2023-01-30,SAM,gemGrab,Double Swoosh,32,30,62
2818,2023-01-30,SAM,brawlBall,Center Stage,414,626,1040
2819,2023-01-30,SAM,brawlBall,Backyard Bowl,33,45,78
2820,2023-01-30,SAM,bounty,Hideout,10,9,19
2821,2023-01-29,SAM,knockout,Belle's Rock,86,90,176
2822,2023-01-29,SAM,hotZone,Quarter Pounder,93,149,242
2823,2023-01-29,SAM,heist,Bridge Too Far,203,318,521
2824,2023-01-29,SAM,gemGrab,Hard Rock Mine,25,38,63
2825,2023-01-29,SAM,gemGrab,Double Swoosh,65,76,141
2826,2023-01-29,SAM,brawlBall,Super Beach,10,16,26
2827,2023-01-29,SAM,brawlBall,Backyard Bowl,303,451,754
2828,2023-01-29,SAM,bounty,Canal Grande,39,36,75
2829,2023-01-28,SAM,knockout,Flaring Phoenix,45,32,77
2830,2023-01-28,SAM,hotZone,Controller Chaos,73,143,216
2831,2023-01-28,SAM,heist,Bridge Too Far,306,424,730
2832,2023-01-28,SAM,gemGrab,Hard Rock Mine,101,158,259
2833,2023-01-28,SAM,gemGrab,Deep Diner,27,19,46
2834,2023-01-28,SAM,brawlBall,Super Beach,647,834,1481
2835,2023-01-28,SAM,brawlBall,Sneaky Fields,31,39,70
2836,2023-01-28,SAM,bounty,Canal Grande,42,35,77
2837,2023-01-27,SAM,knockout,Flaring Phoenix,15,29,44
2838,2023-01-27,SAM,hotZone,Controller Chaos,21,39,60
2839,2023-01-27,SAM,heist,Hot Potato,46,74,120
2840,2023-01-27,SAM,gemGrab,Undermine,5,6,11
2841,2023-01-27,SAM,gemGrab,Deep Diner,33,52,85
2842,2023-01-27,SAM,brawlBall,Sneaky Fields,203,208,411
2843,2023-01-27,SAM,brawlBall,Pinhole Punt,6,8,14
2844,2023-01-27,SAM,bounty,Temple Ruins,8,7,15
2845,2023-01-26,SAM,knockout,Riverside,29,24,53
2846,2023-01-26,SAM,hotZone,Open Zone,30,24,54
2847,2023-01-26,SAM,heist,Hot Potato,117,133,250
2848,2023-01-26,SAM,gemGrab,Undermine,68,67,135
2849,2023-01-26,SAM,gemGrab,Gem Fort,33,41,74
2850,2023-01-26,SAM,brawlBall,Sunny Soccer,33,43,76
2851,2023-01-26,SAM,brawlBall,Pinhole Punt,481,620,1101
2852,2023-01-26,SAM,bounty,Temple Ruins,28,32,60
2853,2023-01-25,SAM,knockout,Riverside,6,9,15
2854,2023-01-25,SAM,hotZone,Open Zone,7,1,8
2855,2023-01-25,SAM,heist,Safe Zone,41,53,94
2856,2023-01-25,SAM,gemGrab,Gem Fort,44,38,82
2857,2023-01-25,SAM,gemGrab,Crystal Arcade,30,23,53
2858,2023-01-25,SAM,brawlBall,Sunny Soccer,381,463,844
2859,2023-01-25,SAM,brawlBall,Beach Ball,72,78,150
2860,2023-01-25,SAM,bounty,Excel,17,27,44
2861,2023-01-24,SAM,knockout,New Perspective,37,29,66
2862,2023-01-24,SAM,hotZone,Dueling Beetles,82,108,190
2863,2023-01-24,SAM,heist,Safe Zone,54,112,166
2864,2023-01-24,SAM,gemGrab,Minecart Madness,15,23,38
2865,2023-01-24,SAM,gemGrab,Crystal Arcade,75,101,176
2866,2023-01-24,SAM,brawlBall,Center Stage,77,82,159
2867,2023-01-24,SAM,brawlBall,Beach Ball,473,629,1102
2868,2023-01-24,SAM,bounty,Excel,73,130,203
2869,2023-01-23,SAM,knockout,New Perspective,48,61,109
2870,2023-01-23,SAM,hotZone,Dueling Beetles,93,120,213
2871,2023-01-23,SAM,heist,Snaked Assault,123,97,220
2872,2023-01-23,SAM,gemGrab,Minecart Madness,71,80,151
2873,2023-01-23,SAM,gemGrab,Double Swoosh,16,28,44
2874,2023-01-23,SAM,brawlBall,Center Stage,648,823,1471
2875,2023-01-23,SAM,brawlBall,Backyard Bowl,15,22,37
2876,2023-01-23,SAM,bounty,Layer Cake,25,41,66
2877,2023-01-22,SAM,knockout,X Marks the Spot,18,21,39
2878,2023-01-22,SAM,hotZone,Ring of Fire,37,38,75
2879,2023-01-22,SAM,heist,Snaked Assault,43,48,91
2880,2023-01-22,SAM,gemGrab,Hard Rock Mine,26,33,59
2881,2023-01-22,SAM,gemGrab,Double Swoosh,47,53,100
2882,2023-01-22,SAM,brawlBall,Super Beach,60,99,159
2883,2023-01-22,SAM,brawlBall,Backyard Bowl,133,210,343
2884,2023-01-22,SAM,bounty,Layer Cake,16,18,34
2885,2023-01-21,SAM,knockout,X Marks the Spot,82,68,150
2886,2023-01-21,SAM,hotZone,Ring of Fire,74,76,150
2887,2023-01-21,SAM,heist,Tornado Ring,109,101,210
2888,2023-01-21,SAM,gemGrab,Hard Rock Mine,110,214,324
2889,2023-01-21,SAM,gemGrab,Deep Diner,21,34,55
2890,2023-01-21,SAM,brawlBall,Super Beach,735,997,1732
2891,2023-01-21,SAM,brawlBall,Sneaky Fields,52,65,117
2892,2023-01-21,SAM,bounty,Dry Season,20,32,52
2893,2023-01-20,SAM,knockout,Out in the Open,41,59,100
2894,2023-01-20,SAM,hotZone,Split,78,120,198
2895,2023-01-20,SAM,heist,Tornado Ring,69,85,154
2896,2023-01-20,SAM,gemGrab,Undermine,43,55,98
2897,2023-01-20,SAM,gemGrab,Deep Diner,84,93,177
2898,2023-01-20,SAM,brawlBall,Sneaky Fields,606,716,1322
2899,2023-01-20,SAM,brawlBall,Pinhole Punt,22,24,46
2900,2023-01-20,SAM,bounty,Dry Season,24,20,44
2901,2023-01-19,SAM,knockout,Out in the Open,46,49,95
2902,2023-01-19,SAM,hotZone,Split,195,296,491
2903,2023-01-19,SAM,heist,Kaboom Canyon,32,33,65
2904,2023-01-19,SAM,gemGrab,Undermine,55,69,124
2905,2023-01-19,SAM,gemGrab,Gem Fort,24,21,45
2906,2023-01-19,SAM,brawlBall,Sunny Soccer,23,16,39
2907,2023-01-19,SAM,brawlBall,Pinhole Punt,434,611,1045
2908,2023-01-19,SAM,bounty,Shooting Star,6,12,18
2909,2023-01-18,SAM,knockout,Goldarm Gulch,7,7,14
2910,2023-01-18,SAM,hotZone,Parallel Plays,21,16,37
2911,2023-01-18,SAM,heist,Kaboom Canyon,9,5,14
2912,2023-01-18,SAM,gemGrab,Gem Fort,12,8,20
2913,2023-01-18,SAM,gemGrab,Crystal Arcade,9,11,20
2914,2023-01-18,SAM,brawlBall,Sunny Soccer,161,210,371
2915,2023-01-18,SAM,brawlBall,Beach Ball,4,3,7
2916,2023-01-18,SAM,bounty,Shooting Star,2,6,8
2917,2023-01-17,SAM,knockout,Goldarm Gulch,19,12,31
2918,2023-01-17,SAM,hotZone,Parallel Plays,12,24,36
2919,2023-01-17,SAM,heist,Pit Stop,21,18,39
2920,2023-01-17,SAM,gemGrab,Minecart Madness,1,3,4
2921,2023-01-17,SAM,gemGrab,Crystal Arcade,7,5,12
2922,2023-01-17,SAM,brawlBall,Center Stage,0,2,2
2923,2023-01-17,SAM,brawlBall,Beach Ball,42,31,73
2924,2023-01-16,SAM,knockout,Belle's Rock,1,2,3
2925,2023-01-16,SAM,hotZone,Quarter Pounder,19,5,24
2926,2023-01-16,SAM,heist,Pit Stop,63,68,131
2927,2023-01-16,SAM,gemGrab,Minecart Madness,9,12,21
2928,2023-01-16,SAM,gemGrab,Double Swoosh,4,3,7
2929,2023-01-16,SAM,brawlBall,Center Stage,45,42,87
2930,2023-01-16,SAM,brawlBall,Backyard Bowl,5,1,6
2931,2023-01-16,SAM,bounty,Hideout,1,4,5
2932,2023-01-15,SAM,knockout,Belle's Rock,4,0,4
2933,2023-01-15,SAM,hotZone,Quarter Pounder,20,28,48
2934,2023-01-15,SAM,heist,Bridge Too Far,20,32,52
2935,2023-01-15,SAM,gemGrab,Hard Rock Mine,6,5,11
2936,2023-01-15,SAM,gemGrab,Double Swoosh,4,3,7
2937,2023-01-15,SAM,brawlBall,Super Beach,7,27,34
2938,2023-01-15,SAM,brawlBall,Backyard Bowl,17,25,42
2939,2023-01-15,SAM,bounty,Canal Grande,6,4,10
2940,2023-01-14,SAM,knockout,Flaring Phoenix,3,0,3
2941,2023-01-14,SAM,hotZone,Controller Chaos,24,12,36
2942,2023-01-14,SAM,heist,Bridge Too Far,25,17,42
2943,2023-01-14,SAM,gemGrab,Hard Rock Mine,4,2,6
2944,2023-01-14,SAM,gemGrab,Deep Diner,2,4,6
2945,2023-01-14,SAM,brawlBall,Super Beach,53,56,109
2946,2023-01-14,SAM,brawlBall,Sneaky Fields,3,1,4
2947,2023-01-14,SAM,bounty,Canal Grande,1,3,4
2948,2023-01-13,SAM,knockout,Flaring Phoenix,4,6,10
2949,2023-01-13,SAM,hotZone,Controller Chaos,9,4,13
2950,2023-01-13,SAM,heist,Hot Potato,7,18,25
2951,2023-01-13,SAM,gemGrab,Deep Diner,10,7,17
2952,2023-01-13,SAM,brawlBall,Sneaky Fields,20,38,58
2953,2023-01-12,SAM,hotZone,Open Zone,4,3,7
2954,2023-01-12,SAM,heist,Hot Potato,1,1,2
2955,2023-01-12,SAM,gemGrab,Undermine,2,0,2
2956,2023-01-12,SAM,gemGrab,Gem Fort,1,0,1
2957,2023-01-12,SAM,brawlBall,Sunny Soccer,1,5,6
2958,2023-01-12,SAM,brawlBall,Pinhole Punt,6,13,19
2959,2023-01-11,SAM,knockout,Riverside,1,0,1
2960,2023-01-11,SAM,hotZone,Open Zone,1,1,2
2961,2023-01-11,SAM,gemGrab,Gem Fort,1,2,3
2962,2023-01-11,SAM,brawlBall,Sunny Soccer,9,19,28
2963,2023-01-11,SAM,brawlBall,Beach Ball,0,2,2
2964,2023-01-11,SAM,bounty,Excel,1,0,1
2965,2023-01-10,SAM,knockout,New Perspective,0,1,1
2966,2023-01-10,SAM,hotZone,Dueling Beetles,11,4,15
2967,2023-01-10,SAM,gemGrab,Minecart Madness,2,8,10
2968,2023-01-10,SAM,gemGrab,Crystal Arcade,2,3,5
2969,2023-01-10,SAM,brawlBall,Center Stage,4,0,4
2970,2023-01-10,SAM,brawlBall,Beach Ball,18,9,27
2971,2023-01-09,SAM,knockout,New Perspective,0,1,1
2972,2023-01-09,SAM,hotZone,Dueling Beetles,1,7,8
2973,2023-01-09,SAM,heist,Snaked Assault,12,21,33
2974,2023-01-09,SAM,gemGrab,Minecart Madness,5,0,5
2975,2023-01-09,SAM,gemGrab,Double Swoosh,5,0,5
2976,2023-01-09,SAM,brawlBall,Center Stage,22,39,61
2977,2023-01-09,SAM,bounty,Layer Cake,2,4,6
2978,2023-01-08,SAM,knockout,X Marks the Spot,3,0,3
2979,2023-01-08,SAM,hotZone,Ring of Fire,2,8,10
2980,2023-01-08,SAM,heist,Snaked Assault,4,1,5
2981,2023-01-08,SAM,gemGrab,Hard Rock Mine,4,2,6
2982,2023-01-08,SAM,gemGrab,Double Swoosh,1,0,1
2983,2023-01-08,SAM,brawlBall,Backyard Bowl,15,3,18
2984,2023-01-07,SAM,hotZone,Ring of Fire,3,2,5
2985,2023-01-07,SAM,heist,Tornado Ring,7,1,8
2986,2023-01-07,SAM,gemGrab,Hard Rock Mine,0,4,4
2987,2023-01-07,SAM,gemGrab,Deep Diner,3,0,3
2988,2023-01-07,SAM,brawlBall,Super Beach,7,4,11
2989,2023-01-07,SAM,brawlBall,Sneaky Fields,4,0,4
2990,2023-01-07,SAM,bounty,Dry Season,0,1,1
2991,2023-01-06,SAM,hotZone,Split,8,14,22
2992,2023-01-06,SAM,heist,Tornado Ring,6,1,7
2993,2023-01-06,SAM,gemGrab,Deep Diner,3,2,5
2994,2023-01-06,SAM,brawlBall,Sneaky Fields,28,65,93
2995,2023-01-06,SAM,brawlBall,Pinhole Punt,1,0,1
2996,2023-01-06,SAM,bounty,Dry Season,2,9,11
2997,2023-01-05,SAM,knockout,Out in the Open,2,0,2
2998,2023-01-05,SAM,hotZone,Split,14,2,16
2999,2023-01-05,SAM,heist,Kaboom Canyon,7,0,7
3000,2023-01-05,SAM,gemGrab,Undermine,5,11,16
3001,2023-01-05,SAM,brawlBall,Sunny Soccer,1,0,1
3002,2023-01-05,SAM,brawlBall,Pinhole Punt,21,9,30
3003,2023-01-04,SAM,hotZone,Parallel Plays,2,1,3
3004,2023-01-04,SAM,heist,Kaboom Canyon,8,1,9
3005,2023-01-04,SAM,gemGrab,Gem Fort,7,2,9
3006,2023-01-04,SAM,gemGrab,Crystal Arcade,2,1,3
3007,2023-01-04,SAM,brawlBall,Sunny Soccer,36,31,67
3008,2023-01-04,SAM,bounty,Shooting Star,4,15,19
3009,2023-01-03,SAM,knockout,Goldarm Gulch,3,1,4
3010,2023-01-03,SAM,hotZone,Parallel Plays,5,14,19
3011,2023-01-03,SAM,heist,Pit Stop,21,44,65
3012,2023-01-03,SAM,gemGrab,Minecart Madness,1,0,1
3013,2023-01-03,SAM,gemGrab,Crystal Arcade,5,0,5
3014,2023-01-03,SAM,brawlBall,Center Stage,1,0,1
3015,2023-01-03,SAM,brawlBall,Beach Ball,18,36,54
3016,2023-01-03,SAM,bounty,Hideout,1,2,3
3017,2023-01-02,SAM,knockout,Belle's Rock,2,1,3
3018,2023-01-02,SAM,hotZone,Quarter Pounder,9,24,33
3019,2023-01-02,SAM,heist,Pit Stop,24,33,57
3020,2023-01-02,SAM,gemGrab,Minecart Madness,8,1,9
3021,2023-01-02,SAM,brawlBall,Center Stage,27,50,77
3022,2023-01-02,SAM,brawlBall,Backyard Bowl,1,2,3
3023,2023-01-02,SAM,bounty,Hideout,2,2,4
3024,2023-01-01,SAM,knockout,Belle's Rock,1,0,1
3025,2023-01-01,SAM,hotZone,Quarter Pounder,1,0,1
3026,2023-01-01,SAM,heist,Bridge Too Far,5,3,8
3027,2023-01-01,SAM,gemGrab,Double Swoosh,3,0,3
3028,2023-01-01,SAM,brawlBall,Backyard Bowl,1,3,4
3029,2023-01-01,SAM,bounty,Canal Grande,0,1,1
3030,2022-12-31,SAM,hotZone,Controller Chaos,3,0,3
3031,2022-12-31,SAM,heist,Bridge Too Far,2,3,5
3032,2022-12-31,SAM,gemGrab,Hard Rock Mine,1,0,1
3033,2022-12-31,SAM,brawlBall,Super Beach,6,6,12
3034,2022-12-31,SAM,brawlBall,Sneaky Fields,1,0,1
3035,2022-12-30,SAM,hotZone,Controller Chaos,1,0,1
3036,2022-12-30,SAM,gemGrab,Deep Diner,2,6,8
3037,2022-12-30,SAM,brawlBall,Sneaky Fields,2,2,4
3038,2022-12-29,SAM,gemGrab,Undermine,1,0,1
3039,2022-12-29,SAM,brawlBall,Pinhole Punt,1,1,2
3040,2022-12-28,SAM,gemGrab,Crystal Arcade,1,0,1
3041,2022-12-28,SAM,brawlBall,Beach Ball,1,0,1
3042,2022-12-27,SAM,brawlBall,Center Stage,0,1,1
3043,2022-12-26,SAM,brawlBall,Center Stage,1,0,1
3044,2022-12-23,SAM,knockout,Out in the Open,0,1,1
3045,2022-12-21,SAM,brawlBall,Sunny Soccer,1,0,1
3046,2022-12-20,SAM,brawlBall,Beach Ball,1,1,2
3047,2022-12-18,SAM,heist,Bridge Too Far,0,1,1
3048,2022-12-16,SAM,brawlBall,Sneaky Fields,0,1,1
3049,2022-12-13,SAM,brawlBall,Beach Ball,1,0,1
3050,2022-11-07,SAM,hotZone,Quarter Pounder,0,1,1
3051,2022-10-28,SAM,brawlBall,Beach Ball,0,1,1
3052,2022-10-15,SAM,brawlBall,Super Beach,0,1,1
3053,2022-10-10,SAM,knockout,Belle's Rock,0,1,1
3054,2023-02-05,RUFFS,knockout,X Marks the Spot,19,15,34
3055,2023-02-05,RUFFS,knockout,Goldarm Gulch,3,4,7
3056,2023-02-05,RUFFS,hotZone,Ring of Fire,31,46,77
3057,2023-02-05,RUFFS,heist,Snaked Assault,7,17,24
3058,2023-02-05,RUFFS,heist,Pit Stop,9,14,23
3059,2023-02-05,RUFFS,gemGrab,Hard Rock Mine,40,73,113
3060,2023-02-05,RUFFS,gemGrab,Double Swoosh,29,34,63
3061,2023-02-05,RUFFS,brawlBall,Super Beach,1,7,8
3062,2023-02-05,RUFFS,brawlBall,Sneaky Fields,2,4,6
3063,2023-02-05,RUFFS,brawlBall,Backyard Bowl,181,183,364
3064,2023-02-05,RUFFS,bounty,Layer Cake,37,72,109
3065,2023-02-04,RUFFS,knockout,X Marks the Spot,15,19,34
3066,2023-02-04,RUFFS,knockout,Goldarm Gulch,6,6,12
3067,2023-02-04,RUFFS,hotZone,Ring of Fire,8,6,14
3068,2023-02-04,RUFFS,heist,Tornado Ring,2,2,4
3069,2023-02-04,RUFFS,heist,Pit Stop,6,10,16
3070,2023-02-04,RUFFS,gemGrab,Hard Rock Mine,66,98,164
3071,2023-02-04,RUFFS,gemGrab,Double Swoosh,5,5,10
3072,2023-02-04,RUFFS,gemGrab,Deep Diner,24,30,54
3073,2023-02-04,RUFFS,brawlBall,Super Beach,68,110,178
3074,2023-02-04,RUFFS,brawlBall,Sneaky Fields,4,5,9
3075,2023-02-04,RUFFS,bounty,Dry Season,12,5,17
3076,2023-02-03,RUFFS,knockout,Out in the Open,36,31,67
3077,2023-02-03,RUFFS,knockout,Goldarm Gulch,24,14,38
3078,2023-02-03,RUFFS,hotZone,Split,78,100,178
3079,2023-02-03,RUFFS,heist,Tornado Ring,10,16,26
3080,2023-02-03,RUFFS,heist,Pit Stop,45,58,103
3081,2023-02-03,RUFFS,gemGrab,Undermine,12,17,29
3082,2023-02-03,RUFFS,gemGrab,Double Swoosh,14,21,35
3083,2023-02-03,RUFFS,gemGrab,Deep Diner,127,229,356
3084,2023-02-03,RUFFS,brawlBall,Sneaky Fields,226,262,488
3085,2023-02-03,RUFFS,brawlBall,Pinhole Punt,7,12,19
3086,2023-02-03,RUFFS,bounty,Dry Season,145,184,329
3087,2023-02-02,RUFFS,knockout,Out in the Open,26,22,48
3088,2023-02-02,RUFFS,hotZone,Split,46,65,111
3089,2023-02-02,RUFFS,heist,Kaboom Canyon,3,5,8
3090,2023-02-02,RUFFS,gemGrab,Undermine,14,12,26
3091,2023-02-02,RUFFS,gemGrab,Gem Fort,9,5,14
3092,2023-02-02,RUFFS,brawlBall,Sunny Soccer,3,2,5
3093,2023-02-02,RUFFS,brawlBall,Pinhole Punt,73,108,181
3094,2023-02-02,RUFFS,bounty,Shooting Star,2,1,3
3095,2023-02-01,RUFFS,knockout,Goldarm Gulch,45,49,94
3096,2023-02-01,RUFFS,hotZone,Parallel Plays,21,38,59
3097,2023-02-01,RUFFS,heist,Kaboom Canyon,2,2,4
3098,2023-02-01,RUFFS,gemGrab,Gem Fort,45,58,103
3099,2023-02-01,RUFFS,gemGrab,Crystal Arcade,72,112,184
3100,2023-02-01,RUFFS,brawlBall,Sunny Soccer,138,224,362
3101,2023-02-01,RUFFS,brawlBall,Beach Ball,6,4,10
3102,2023-02-01,RUFFS,bounty,Shooting Star,5,2,7
3103,2023-01-31,RUFFS,knockout,Goldarm Gulch,28,25,53
3104,2023-01-31,RUFFS,hotZone,Parallel Plays,13,16,29
3105,2023-01-31,RUFFS,heist,Pit Stop,5,10,15
3106,2023-01-31,RUFFS,gemGrab,Minecart Madness,3,5,8
3107,2023-01-31,RUFFS,gemGrab,Crystal Arcade,49,68,117
3108,2023-01-31,RUFFS,brawlBall,Center Stage,3,3,6
3109,2023-01-31,RUFFS,brawlBall,Beach Ball,94,152,246
3110,2023-01-31,RUFFS,bounty,Hideout,8,6,14
3111,2023-01-30,RUFFS,knockout,Belle's Rock,31,43,74
3112,2023-01-30,RUFFS,hotZone,Quarter Pounder,61,120,181
3113,2023-01-30,RUFFS,heist,Pit Stop,17,17,34
3114,2023-01-30,RUFFS,gemGrab,Minecart Madness,41,67,108
3115,2023-01-30,RUFFS,gemGrab,Double Swoosh,29,34,63
3116,2023-01-30,RUFFS,brawlBall,Center Stage,149,154,303
3117,2023-01-30,RUFFS,brawlBall,Backyard Bowl,11,17,28
3118,2023-01-30,RUFFS,bounty,Hideout,4,2,6
3119,2023-01-29,RUFFS,knockout,Belle's Rock,50,72,122
3120,2023-01-29,RUFFS,hotZone,Quarter Pounder,97,221,318
3121,2023-01-29,RUFFS,heist,Bridge Too Far,9,1,10
3122,2023-01-29,RUFFS,gemGrab,Hard Rock Mine,27,39,66
3123,2023-01-29,RUFFS,gemGrab,Double Swoosh,28,22,50
3124,2023-01-29,RUFFS,brawlBall,Super Beach,1,2,3
3125,2023-01-29,RUFFS,brawlBall,Backyard Bowl,163,202,365
3126,2023-01-29,RUFFS,bounty,Canal Grande,13,24,37
3127,2023-01-28,RUFFS,knockout,Flaring Phoenix,28,26,54
3128,2023-01-28,RUFFS,hotZone,Controller Chaos,18,28,46
3129,2023-01-28,RUFFS,heist,Bridge Too Far,16,6,22
3130,2023-01-28,RUFFS,gemGrab,Hard Rock Mine,182,303,485
3131,2023-01-28,RUFFS,gemGrab,Deep Diner,67,103,170
3132,2023-01-28,RUFFS,brawlBall,Super Beach,215,248,463
3133,2023-01-28,RUFFS,brawlBall,Sneaky Fields,11,15,26
3134,2023-01-28,RUFFS,bounty,Canal Grande,33,60,93
3135,2023-01-27,RUFFS,knockout,Flaring Phoenix,19,26,45
3136,2023-01-27,RUFFS,hotZone,Controller Chaos,6,4,10
3137,2023-01-27,RUFFS,heist,Hot Potato,9,7,16
3138,2023-01-27,RUFFS,gemGrab,Undermine,5,1,6
3139,2023-01-27,RUFFS,gemGrab,Deep Diner,67,99,166
3140,2023-01-27,RUFFS,brawlBall,Sneaky Fields,62,65,127
3141,2023-01-27,RUFFS,brawlBall,Pinhole Punt,3,1,4
3142,2023-01-27,RUFFS,bounty,Temple Ruins,4,4,8
3143,2023-01-26,RUFFS,knockout,Riverside,18,34,52
3144,2023-01-26,RUFFS,hotZone,Open Zone,7,9,16
3145,2023-01-26,RUFFS,heist,Hot Potato,29,26,55
3146,2023-01-26,RUFFS,gemGrab,Undermine,12,19,31
3147,2023-01-26,RUFFS,gemGrab,Gem Fort,19,24,43
3148,2023-01-26,RUFFS,brawlBall,Sunny Soccer,5,10,15
3149,2023-01-26,RUFFS,brawlBall,Pinhole Punt,226,286,512
3150,2023-01-26,RUFFS,bounty,Temple Ruins,14,10,24
3151,2023-01-25,RUFFS,knockout,Riverside,7,8,15
3152,2023-01-25,RUFFS,hotZone,Open Zone,12,6,18
3153,2023-01-25,RUFFS,heist,Safe Zone,19,23,42
3154,2023-01-25,RUFFS,gemGrab,Gem Fort,16,14,30
3155,2023-01-25,RUFFS,gemGrab,Crystal Arcade,48,71,119
3156,2023-01-25,RUFFS,brawlBall,Sunny Soccer,135,139,274
3157,2023-01-25,RUFFS,brawlBall,Beach Ball,25,22,47
3158,2023-01-25,RUFFS,bounty,Excel,27,51,78
3159,2023-01-24,RUFFS,knockout,New Perspective,47,32,79
3160,2023-01-24,RUFFS,hotZone,Dueling Beetles,34,14,48
3161,2023-01-24,RUFFS,heist,Safe Zone,24,43,67
3162,2023-01-24,RUFFS,gemGrab,Minecart Madness,10,6,16
3163,2023-01-24,RUFFS,gemGrab,Crystal Arcade,79,88,167
3164,2023-01-24,RUFFS,brawlBall,Center Stage,19,30,49
3165,2023-01-24,RUFFS,brawlBall,Beach Ball,193,304,497
3166,2023-01-24,RUFFS,bounty,Excel,42,70,112
3167,2023-01-23,RUFFS,knockout,New Perspective,45,53,98
3168,2023-01-23,RUFFS,hotZone,Dueling Beetles,34,27,61
3169,2023-01-23,RUFFS,heist,Snaked Assault,6,3,9
3170,2023-01-23,RUFFS,gemGrab,Minecart Madness,44,86,130
3171,2023-01-23,RUFFS,gemGrab,Double Swoosh,13,14,27
3172,2023-01-23,RUFFS,brawlBall,Center Stage,265,338,603
3173,2023-01-23,RUFFS,brawlBall,Backyard Bowl,15,10,25
3174,2023-01-23,RUFFS,bounty,Layer Cake,25,15,40
3175,2023-01-22,RUFFS,knockout,X Marks the Spot,5,7,12
3176,2023-01-22,RUFFS,hotZone,Ring of Fire,21,25,46
3177,2023-01-22,RUFFS,heist,Snaked Assault,6,4,10
3178,2023-01-22,RUFFS,gemGrab,Hard Rock Mine,43,93,136
3179,2023-01-22,RUFFS,gemGrab,Double Swoosh,18,21,39
3180,2023-01-22,RUFFS,brawlBall,Super Beach,13,24,37
3181,2023-01-22,RUFFS,brawlBall,Backyard Bowl,75,125,200
3182,2023-01-22,RUFFS,bounty,Layer Cake,27,53,80
3183,2023-01-21,RUFFS,knockout,X Marks the Spot,40,45,85
3184,2023-01-21,RUFFS,hotZone,Ring of Fire,87,111,198
3185,2023-01-21,RUFFS,heist,Tornado Ring,5,10,15
3186,2023-01-21,RUFFS,gemGrab,Hard Rock Mine,271,474,745
3187,2023-01-21,RUFFS,gemGrab,Deep Diner,20,46,66
3188,2023-01-21,RUFFS,brawlBall,Super Beach,236,266,502
3189,2023-01-21,RUFFS,brawlBall,Sneaky Fields,2,7,9
3190,2023-01-21,RUFFS,bounty,Dry Season,48,63,111
3191,2023-01-20,RUFFS,knockout,Out in the Open,59,66,125
3192,2023-01-20,RUFFS,hotZone,Split,74,130,204
3193,2023-01-20,RUFFS,heist,Tornado Ring,8,12,20
3194,2023-01-20,RUFFS,gemGrab,Undermine,6,14,20
3195,2023-01-20,RUFFS,gemGrab,Deep Diner,168,338,506
3196,2023-01-20,RUFFS,brawlBall,Sneaky Fields,162,212,374
3197,2023-01-20,RUFFS,brawlBall,Pinhole Punt,5,4,9
3198,2023-01-20,RUFFS,bounty,Dry Season,74,140,214
3199,2023-01-19,RUFFS,knockout,Out in the Open,51,55,106
3200,2023-01-19,RUFFS,hotZone,Split,97,189,286
3201,2023-01-19,RUFFS,heist,Kaboom Canyon,10,6,16
3202,2023-01-19,RUFFS,gemGrab,Undermine,19,29,48
3203,2023-01-19,RUFFS,gemGrab,Gem Fort,6,17,23
3204,2023-01-19,RUFFS,brawlBall,Sunny Soccer,6,7,13
3205,2023-01-19,RUFFS,brawlBall,Pinhole Punt,242,366,608
3206,2023-01-19,RUFFS,bounty,Shooting Star,12,13,25
3207,2023-01-18,RUFFS,knockout,Goldarm Gulch,10,11,21
3208,2023-01-18,RUFFS,hotZone,Parallel Plays,7,3,10
3209,2023-01-18,RUFFS,heist,Kaboom Canyon,1,0,1
3210,2023-01-18,RUFFS,gemGrab,Gem Fort,9,18,27
3211,2023-01-18,RUFFS,gemGrab,Crystal Arcade,5,6,11
3212,2023-01-18,RUFFS,brawlBall,Sunny Soccer,64,76,140
3213,2023-01-18,RUFFS,brawlBall,Beach Ball,1,4,5
3214,2023-01-18,RUFFS,bounty,Shooting Star,3,7,10
3215,2023-01-17,RUFFS,knockout,Goldarm Gulch,11,9,20
3216,2023-01-17,RUFFS,hotZone,Parallel Plays,14,7,21
3217,2023-01-17,RUFFS,heist,Pit Stop,2,3,5
3218,2023-01-17,RUFFS,gemGrab,Crystal Arcade,7,8,15
3219,2023-01-17,RUFFS,brawlBall,Center Stage,1,0,1
3220,2023-01-17,RUFFS,brawlBall,Beach Ball,18,20,38
3221,2023-01-17,RUFFS,bounty,Hideout,1,1,2
3222,2023-01-16,RUFFS,knockout,Belle's Rock,1,2,3
3223,2023-01-16,RUFFS,hotZone,Quarter Pounder,7,7,14
3224,2023-01-16,RUFFS,heist,Pit Stop,11,14,25
3225,2023-01-16,RUFFS,gemGrab,Minecart Madness,3,6,9
3226,2023-01-16,RUFFS,gemGrab,Double Swoosh,1,0,1
3227,2023-01-16,RUFFS,brawlBall,Center Stage,15,13,28
3228,2023-01-16,RUFFS,brawlBall,Backyard Bowl,0,1,1
3229,2023-01-16,RUFFS,bounty,Hideout,1,0,1
3230,2023-01-15,RUFFS,knockout,Belle's Rock,3,2,5
3231,2023-01-15,RUFFS,hotZone,Quarter Pounder,7,9,16
3232,2023-01-15,RUFFS,heist,Bridge Too Far,1,1,2
3233,2023-01-15,RUFFS,gemGrab,Hard Rock Mine,13,11,24
3234,2023-01-15,RUFFS,gemGrab,Double Swoosh,3,4,7
3235,2023-01-15,RUFFS,brawlBall,Super Beach,0,1,1
3236,2023-01-15,RUFFS,brawlBall,Backyard Bowl,16,24,40
3237,2023-01-15,RUFFS,bounty,Canal Grande,3,2,5
3238,2023-01-14,RUFFS,knockout,Flaring Phoenix,0,2,2
3239,2023-01-14,RUFFS,hotZone,Controller Chaos,3,4,7
3240,2023-01-14,RUFFS,heist,Bridge Too Far,1,0,1
3241,2023-01-14,RUFFS,gemGrab,Hard Rock Mine,18,43,61
3242,2023-01-14,RUFFS,gemGrab,Deep Diner,1,4,5
3243,2023-01-14,RUFFS,brawlBall,Super Beach,14,18,32
3244,2023-01-14,RUFFS,bounty,Canal Grande,3,2,5
3245,2023-01-13,RUFFS,knockout,Flaring Phoenix,5,6,11
3246,2023-01-13,RUFFS,hotZone,Controller Chaos,8,9,17
3247,2023-01-13,RUFFS,heist,Hot Potato,1,0,1
3248,2023-01-13,RUFFS,gemGrab,Deep Diner,5,21,26
3249,2023-01-13,RUFFS,brawlBall,Sneaky Fields,8,9,17
3250,2023-01-13,RUFFS,bounty,Temple Ruins,1,0,1
3251,2023-01-12,RUFFS,knockout,Riverside,1,0,1
3252,2023-01-12,RUFFS,gemGrab,Undermine,4,2,6
3253,2023-01-12,RUFFS,gemGrab,Gem Fort,1,0,1
3254,2023-01-12,RUFFS,brawlBall,Pinhole Punt,3,19,22
3255,2023-01-11,RUFFS,hotZone,Open Zone,1,0,1
3256,2023-01-11,RUFFS,gemGrab,Gem Fort,1,1,2
3257,2023-01-11,RUFFS,brawlBall,Sunny Soccer,13,20,33
3258,2023-01-11,RUFFS,bounty,Excel,2,3,5
3259,2023-01-10,RUFFS,knockout,New Perspective,2,8,10
3260,2023-01-10,RUFFS,hotZone,Dueling Beetles,6,6,12
3261,2023-01-10,RUFFS,heist,Safe Zone,9,20,29
3262,2023-01-10,RUFFS,gemGrab,Minecart Madness,2,6,8
3263,2023-01-10,RUFFS,gemGrab,Crystal Arcade,1,0,1
3264,2023-01-10,RUFFS,brawlBall,Center Stage,2,0,2
3265,2023-01-10,RUFFS,brawlBall,Beach Ball,17,60,77
3266,2023-01-10,RUFFS,bounty,Excel,3,0,3
3267,2023-01-09,RUFFS,knockout,New Perspective,1,0,1
3268,2023-01-09,RUFFS,hotZone,Dueling Beetles,2,4,6
3269,2023-01-09,RUFFS,heist,Snaked Assault,1,1,2
3270,2023-01-09,RUFFS,gemGrab,Minecart Madness,6,6,12
3271,2023-01-09,RUFFS,gemGrab,Double Swoosh,2,0,2
3272,2023-01-09,RUFFS,brawlBall,Center Stage,6,15,21
3273,2023-01-09,RUFFS,bounty,Layer Cake,1,3,4
3274,2023-01-08,RUFFS,knockout,X Marks the Spot,3,2,5
3275,2023-01-08,RUFFS,hotZone,Ring of Fire,5,21,26
3276,2023-01-08,RUFFS,gemGrab,Hard Rock Mine,7,16,23
3277,2023-01-08,RUFFS,brawlBall,Backyard Bowl,6,4,10
3278,2023-01-08,RUFFS,bounty,Layer Cake,2,0,2
3279,2023-01-07,RUFFS,knockout,X Marks the Spot,2,5,7
3280,2023-01-07,RUFFS,hotZone,Ring of Fire,5,8,13
3281,2023-01-07,RUFFS,heist,Tornado Ring,1,0,1
3282,2023-01-07,RUFFS,gemGrab,Hard Rock Mine,7,25,32
3283,2023-01-07,RUFFS,gemGrab,Deep Diner,7,6,13
3284,2023-01-07,RUFFS,brawlBall,Super Beach,2,2,4
3285,2023-01-07,RUFFS,bounty,Dry Season,13,11,24
3286,2023-01-06,RUFFS,hotZone,Split,7,12,19
3287,2023-01-06,RUFFS,heist,Tornado Ring,2,1,3
3288,2023-01-06,RUFFS,gemGrab,Deep Diner,23,15,38
3289,2023-01-06,RUFFS,brawlBall,Sneaky Fields,2,0,2
3290,2023-01-06,RUFFS,brawlBall,Pinhole Punt,2,0,2
3291,2023-01-06,RUFFS,bounty,Dry Season,13,24,37
3292,2023-01-05,RUFFS,knockout,Out in the Open,6,3,9
3293,2023-01-05,RUFFS,hotZone,Split,28,67,95
3294,2023-01-05,RUFFS,heist,Kaboom Canyon,1,3,4
3295,2023-01-05,RUFFS,gemGrab,Undermine,2,1,3
3296,2023-01-05,RUFFS,brawlBall,Sunny Soccer,1,0,1
3297,2023-01-05,RUFFS,brawlBall,Pinhole Punt,49,63,112
3298,2023-01-04,RUFFS,knockout,Goldarm Gulch,1,1,2
3299,2023-01-04,RUFFS,hotZone,Parallel Plays,1,2,3
3300,2023-01-04,RUFFS,gemGrab,Crystal Arcade,3,0,3
3301,2023-01-04,RUFFS,brawlBall,Sunny Soccer,27,35,62
3302,2023-01-04,RUFFS,bounty,Shooting Star,1,0,1
3303,2023-01-03,RUFFS,knockout,Goldarm Gulch,6,2,8
3304,2023-01-03,RUFFS,hotZone,Parallel Plays,8,2,10
3305,2023-01-03,RUFFS,heist,Pit Stop,4,1,5
3306,2023-01-03,RUFFS,gemGrab,Crystal Arcade,9,18,27
3307,2023-01-03,RUFFS,brawlBall,Center Stage,3,0,3
3308,2023-01-03,RUFFS,brawlBall,Beach Ball,24,26,50
3309,2023-01-02,RUFFS,knockout,Belle's Rock,7,2,9
3310,2023-01-02,RUFFS,hotZone,Quarter Pounder,10,5,15
3311,2023-01-02,RUFFS,heist,Pit Stop,3,5,8
3312,2023-01-02,RUFFS,gemGrab,Minecart Madness,4,6,10
3313,2023-01-02,RUFFS,gemGrab,Double Swoosh,6,5,11
3314,2023-01-02,RUFFS,brawlBall,Center Stage,15,11,26
3315,2023-01-02,RUFFS,brawlBall,Backyard Bowl,2,0,2
3316,2023-01-02,RUFFS,bounty,Hideout,1,1,2
3317,2023-01-01,RUFFS,knockout,Belle's Rock,1,0,1
3318,2023-01-01,RUFFS,hotZone,Quarter Pounder,3,16,19
3319,2023-01-01,RUFFS,gemGrab,Hard Rock Mine,1,1,2
3320,2023-01-01,RUFFS,brawlBall,Backyard Bowl,5,5,10
3321,2022-12-31,RUFFS,gemGrab,Minecart Madness,0,1,1
3322,2022-12-31,RUFFS,gemGrab,Hard Rock Mine,2,3,5
3323,2022-12-31,RUFFS,brawlBall,Super Beach,1,0,1
3324,2022-12-31,RUFFS,brawlBall,Sneaky Fields,1,0,1
3325,2022-12-30,RUFFS,hotZone,Controller Chaos,1,0,1
3326,2022-12-30,RUFFS,gemGrab,Undermine,0,1,1
3327,2022-12-30,RUFFS,gemGrab,Deep Diner,1,0,1
3328,2022-12-30,RUFFS,brawlBall,Sneaky Fields,2,0,2
3329,2022-12-29,RUFFS,brawlBall,Pinhole Punt,1,0,1
3330,2022-12-25,RUFFS,brawlBall,Backyard Bowl,1,1,2
3331,2022-12-22,RUFFS,brawlBall,Pinhole Punt,0,1,1
3332,2022-12-19,RUFFS,brawlBall,Center Stage,2,1,3
3333,2022-11-01,RUFFS,knockout,New Perspective,1,0,1
3334,2022-10-30,RUFFS,knockout,Out in the Open,1,0,1
3335,2022-10-15,RUFFS,gemGrab,Hard Rock Mine,7,8,15
3336,2022-10-15,RUFFS,brawlBall,Super Beach,2,0,2
3337,2023-02-05,ROSA,knockout,X Marks the Spot,15,17,32
3338,2023-02-05,ROSA,knockout,Goldarm Gulch,5,8,13
3339,2023-02-05,ROSA,hotZone,Ring of Fire,14,27,41
3340,2023-02-05,ROSA,heist,Snaked Assault,13,8,21
3341,2023-02-05,ROSA,heist,Pit Stop,2,0,2
3342,2023-02-05,ROSA,gemGrab,Hard Rock Mine,21,16,37
3343,2023-02-05,ROSA,gemGrab,Double Swoosh,297,281,578
3344,2023-02-05,ROSA,brawlBall,Super Beach,2,2,4
3345,2023-02-05,ROSA,brawlBall,Sneaky Fields,137,115,252
3346,2023-02-05,ROSA,brawlBall,Backyard Bowl,20,8,28
3347,2023-02-05,ROSA,bounty,Layer Cake,6,17,23
3348,2023-02-04,ROSA,knockout,X Marks the Spot,0,1,1
3349,2023-02-04,ROSA,knockout,Goldarm Gulch,2,1,3
3350,2023-02-04,ROSA,hotZone,Ring of Fire,6,3,9
3351,2023-02-04,ROSA,heist,Tornado Ring,2,0,2
3352,2023-02-04,ROSA,gemGrab,Hard Rock Mine,22,31,53
3353,2023-02-04,ROSA,gemGrab,Double Swoosh,72,59,131
3354,2023-02-04,ROSA,brawlBall,Super Beach,18,24,42
3355,2023-02-04,ROSA,brawlBall,Sneaky Fields,81,71,152
3356,2023-02-04,ROSA,bounty,Dry Season,2,0,2
3357,2023-02-03,ROSA,knockout,Out in the Open,3,5,8
3358,2023-02-03,ROSA,knockout,Goldarm Gulch,3,3,6
3359,2023-02-03,ROSA,hotZone,Split,25,23,48
3360,2023-02-03,ROSA,heist,Tornado Ring,19,9,28
3361,2023-02-03,ROSA,heist,Pit Stop,4,6,10
3362,2023-02-03,ROSA,gemGrab,Undermine,14,6,20
3363,2023-02-03,ROSA,gemGrab,Double Swoosh,541,388,929
3364,2023-02-03,ROSA,gemGrab,Deep Diner,13,6,19
3365,2023-02-03,ROSA,brawlBall,Sneaky Fields,1431,1733,3164
3366,2023-02-03,ROSA,brawlBall,Pinhole Punt,5,7,12
3367,2023-02-03,ROSA,bounty,Dry Season,5,2,7
3368,2023-02-02,ROSA,knockout,Out in the Open,4,1,5
3369,2023-02-02,ROSA,hotZone,Split,14,10,24
3370,2023-02-02,ROSA,heist,Kaboom Canyon,1,1,2
3371,2023-02-02,ROSA,gemGrab,Undermine,15,8,23
3372,2023-02-02,ROSA,gemGrab,Gem Fort,11,7,18
3373,2023-02-02,ROSA,brawlBall,Sunny Soccer,3,0,3
3374,2023-02-02,ROSA,brawlBall,Pinhole Punt,39,51,90
3375,2023-02-01,ROSA,knockout,Goldarm Gulch,9,9,18
3376,2023-02-01,ROSA,hotZone,Parallel Plays,36,32,68
3377,2023-02-01,ROSA,heist,Kaboom Canyon,3,0,3
3378,2023-02-01,ROSA,gemGrab,Gem Fort,153,206,359
3379,2023-02-01,ROSA,gemGrab,Crystal Arcade,20,28,48
3380,2023-02-01,ROSA,brawlBall,Sunny Soccer,81,70,151
3381,2023-02-01,ROSA,brawlBall,Beach Ball,1,0,1
3382,2023-01-31,ROSA,knockout,Goldarm Gulch,9,7,16
3383,2023-01-31,ROSA,hotZone,Parallel Plays,14,18,32
3384,2023-01-31,ROSA,heist,Pit Stop,1,5,6
3385,2023-01-31,ROSA,gemGrab,Crystal Arcade,26,21,47
3386,2023-01-31,ROSA,brawlBall,Center Stage,3,1,4
3387,2023-01-31,ROSA,brawlBall,Beach Ball,27,24,51
3388,2023-01-30,ROSA,knockout,Belle's Rock,6,8,14
3389,2023-01-30,ROSA,hotZone,Quarter Pounder,9,6,15
3390,2023-01-30,ROSA,heist,Pit Stop,2,3,5
3391,2023-01-30,ROSA,gemGrab,Minecart Madness,11,2,13
3392,2023-01-30,ROSA,gemGrab,Double Swoosh,89,68,157
3393,2023-01-30,ROSA,brawlBall,Center Stage,321,505,826
3394,2023-01-30,ROSA,brawlBall,Backyard Bowl,0,2,2
3395,2023-01-29,ROSA,knockout,Belle's Rock,1,1,2
3396,2023-01-29,ROSA,hotZone,Quarter Pounder,9,2,11
3397,2023-01-29,ROSA,heist,Bridge Too Far,2,2,4
3398,2023-01-29,ROSA,gemGrab,Hard Rock Mine,17,31,48
3399,2023-01-29,ROSA,gemGrab,Double Swoosh,179,237,416
3400,2023-01-29,ROSA,brawlBall,Super Beach,2,1,3
3401,2023-01-29,ROSA,brawlBall,Backyard Bowl,13,8,21
3402,2023-01-29,ROSA,bounty,Canal Grande,25,43,68
3403,2023-01-28,ROSA,knockout,Flaring Phoenix,15,48,63
3404,2023-01-28,ROSA,hotZone,Controller Chaos,45,61,106
3405,2023-01-28,ROSA,heist,Bridge Too Far,8,2,10
3406,2023-01-28,ROSA,gemGrab,Hard Rock Mine,114,109,223
3407,2023-01-28,ROSA,gemGrab,Deep Diner,8,7,15
3408,2023-01-28,ROSA,brawlBall,Super Beach,114,86,200
3409,2023-01-28,ROSA,brawlBall,Sneaky Fields,36,33,69
3410,2023-01-28,ROSA,bounty,Canal Grande,75,113,188
3411,2023-01-27,ROSA,knockout,Flaring Phoenix,2,1,3
3412,2023-01-27,ROSA,hotZone,Controller Chaos,13,20,33
3413,2023-01-27,ROSA,heist,Hot Potato,2,0,2
3414,2023-01-27,ROSA,gemGrab,Undermine,1,1,2
3415,2023-01-27,ROSA,gemGrab,Deep Diner,6,15,21
3416,2023-01-27,ROSA,brawlBall,Sneaky Fields,218,286,504
3417,2023-01-27,ROSA,brawlBall,Pinhole Punt,1,0,1
3418,2023-01-27,ROSA,bounty,Temple Ruins,7,19,26
3419,2023-01-26,ROSA,knockout,Riverside,3,0,3
3420,2023-01-26,ROSA,hotZone,Open Zone,13,4,17
3421,2023-01-26,ROSA,heist,Hot Potato,2,6,8
3422,2023-01-26,ROSA,gemGrab,Undermine,68,59,127
3423,2023-01-26,ROSA,gemGrab,Gem Fort,73,106,179
3424,2023-01-26,ROSA,brawlBall,Sunny Soccer,3,1,4
3425,2023-01-26,ROSA,brawlBall,Pinhole Punt,120,165,285
3426,2023-01-26,ROSA,bounty,Temple Ruins,17,24,41
3427,2023-01-25,ROSA,knockout,Riverside,0,1,1
3428,2023-01-25,ROSA,hotZone,Open Zone,1,5,6
3429,2023-01-25,ROSA,heist,Safe Zone,1,2,3
3430,2023-01-25,ROSA,gemGrab,Gem Fort,71,123,194
3431,2023-01-25,ROSA,gemGrab,Crystal Arcade,29,33,62
3432,2023-01-25,ROSA,brawlBall,Sunny Soccer,48,53,101
3433,2023-01-25,ROSA,brawlBall,Beach Ball,2,4,6
3434,2023-01-25,ROSA,bounty,Excel,1,2,3
3435,2023-01-24,ROSA,knockout,New Perspective,13,15,28
3436,2023-01-24,ROSA,hotZone,Dueling Beetles,19,15,34
3437,2023-01-24,ROSA,heist,Safe Zone,6,0,6
3438,2023-01-24,ROSA,gemGrab,Minecart Madness,1,1,2
3439,2023-01-24,ROSA,gemGrab,Crystal Arcade,56,119,175
3440,2023-01-24,ROSA,brawlBall,Center Stage,39,55,94
3441,2023-01-24,ROSA,brawlBall,Beach Ball,72,82,154
3442,2023-01-24,ROSA,bounty,Excel,1,5,6
3443,2023-01-23,ROSA,knockout,New Perspective,11,14,25
3444,2023-01-23,ROSA,hotZone,Dueling Beetles,33,40,73
3445,2023-01-23,ROSA,heist,Snaked Assault,14,3,17
3446,2023-01-23,ROSA,gemGrab,Minecart Madness,9,12,21
3447,2023-01-23,ROSA,gemGrab,Double Swoosh,60,82,142
3448,2023-01-23,ROSA,brawlBall,Center Stage,615,947,1562
3449,2023-01-23,ROSA,brawlBall,Backyard Bowl,1,1,2
3450,2023-01-23,ROSA,bounty,Layer Cake,12,11,23
3451,2023-01-22,ROSA,knockout,X Marks the Spot,1,2,3
3452,2023-01-22,ROSA,hotZone,Ring of Fire,15,12,27
3453,2023-01-22,ROSA,heist,Snaked Assault,5,2,7
3454,2023-01-22,ROSA,gemGrab,Hard Rock Mine,41,38,79
3455,2023-01-22,ROSA,gemGrab,Double Swoosh,90,121,211
3456,2023-01-22,ROSA,brawlBall,Super Beach,4,6,10
3457,2023-01-22,ROSA,brawlBall,Backyard Bowl,7,21,28
3458,2023-01-22,ROSA,bounty,Layer Cake,8,19,27
3459,2023-01-21,ROSA,knockout,X Marks the Spot,9,7,16
3460,2023-01-21,ROSA,hotZone,Ring of Fire,35,66,101
3461,2023-01-21,ROSA,heist,Tornado Ring,23,14,37
3462,2023-01-21,ROSA,gemGrab,Hard Rock Mine,153,166,319
3463,2023-01-21,ROSA,gemGrab,Deep Diner,3,1,4
3464,2023-01-21,ROSA,brawlBall,Super Beach,102,125,227
3465,2023-01-21,ROSA,brawlBall,Sneaky Fields,40,51,91
3466,2023-01-21,ROSA,bounty,Dry Season,4,2,6
3467,2023-01-20,ROSA,knockout,Out in the Open,6,10,16
3468,2023-01-20,ROSA,hotZone,Split,32,41,73
3469,2023-01-20,ROSA,heist,Tornado Ring,12,12,24
3470,2023-01-20,ROSA,gemGrab,Undermine,20,48,68
3471,2023-01-20,ROSA,gemGrab,Deep Diner,19,12,31
3472,2023-01-20,ROSA,brawlBall,Sneaky Fields,649,876,1525
3473,2023-01-20,ROSA,brawlBall,Pinhole Punt,7,4,11
3474,2023-01-20,ROSA,bounty,Dry Season,2,1,3
3475,2023-01-19,ROSA,knockout,Out in the Open,11,18,29
3476,2023-01-19,ROSA,hotZone,Split,51,65,116
3477,2023-01-19,ROSA,heist,Kaboom Canyon,3,3,6
3478,2023-01-19,ROSA,gemGrab,Undermine,68,108,176
3479,2023-01-19,ROSA,gemGrab,Gem Fort,39,56,95
3480,2023-01-19,ROSA,brawlBall,Sunny Soccer,0,4,4
3481,2023-01-19,ROSA,brawlBall,Pinhole Punt,94,160,254
3482,2023-01-19,ROSA,bounty,Shooting Star,2,1,3
3483,2023-01-18,ROSA,knockout,Goldarm Gulch,2,2,4
3484,2023-01-18,ROSA,hotZone,Parallel Plays,2,2,4
3485,2023-01-18,ROSA,heist,Kaboom Canyon,3,0,3
3486,2023-01-18,ROSA,gemGrab,Gem Fort,44,52,96
3487,2023-01-18,ROSA,gemGrab,Crystal Arcade,1,0,1
3488,2023-01-18,ROSA,brawlBall,Sunny Soccer,39,46,85
3489,2023-01-18,ROSA,brawlBall,Beach Ball,0,1,1
3490,2023-01-18,ROSA,bounty,Shooting Star,2,2,4
3491,2023-01-17,ROSA,knockout,Goldarm Gulch,4,0,4
3492,2023-01-17,ROSA,hotZone,Parallel Plays,3,7,10
3493,2023-01-17,ROSA,heist,Pit Stop,0,1,1
3494,2023-01-17,ROSA,gemGrab,Crystal Arcade,2,2,4
3495,2023-01-17,ROSA,brawlBall,Center Stage,1,2,3
3496,2023-01-17,ROSA,brawlBall,Beach Ball,6,8,14
3497,2023-01-17,ROSA,bounty,Hideout,0,1,1
3498,2023-01-16,ROSA,knockout,Belle's Rock,2,0,2
3499,2023-01-16,ROSA,hotZone,Quarter Pounder,1,1,2
3500,2023-01-16,ROSA,gemGrab,Double Swoosh,2,1,3
3501,2023-01-16,ROSA,brawlBall,Center Stage,30,61,91
3502,2023-01-16,ROSA,bounty,Hideout,1,0,1
3503,2023-01-15,ROSA,hotZone,Quarter Pounder,2,0,2
3504,2023-01-15,ROSA,gemGrab,Hard Rock Mine,8,24,32
3505,2023-01-15,ROSA,gemGrab,Double Swoosh,21,47,68
3506,2023-01-15,ROSA,brawlBall,Backyard Bowl,3,0,3
3507,2023-01-15,ROSA,bounty,Canal Grande,8,22,30
3508,2023-01-14,ROSA,knockout,Flaring Phoenix,2,0,2
3509,2023-01-14,ROSA,hotZone,Controller Chaos,13,32,45
3510,2023-01-14,ROSA,gemGrab,Hard Rock Mine,7,33,40
3511,2023-01-14,ROSA,gemGrab,Deep Diner,1,0,1
3512,2023-01-14,ROSA,brawlBall,Super Beach,5,2,7
3513,2023-01-14,ROSA,brawlBall,Sneaky Fields,8,9,17
3514,2023-01-14,ROSA,bounty,Canal Grande,3,3,6
3515,2023-01-13,ROSA,hotZone,Controller Chaos,11,16,27
3516,2023-01-13,ROSA,gemGrab,Deep Diner,7,0,7
3517,2023-01-13,ROSA,brawlBall,Sneaky Fields,75,98,173
3518,2023-01-13,ROSA,bounty,Temple Ruins,0,1,1
3519,2023-01-12,ROSA,hotZone,Open Zone,2,0,2
3520,2023-01-12,ROSA,gemGrab,Undermine,0,1,1
3521,2023-01-12,ROSA,gemGrab,Gem Fort,3,5,8
3522,2023-01-12,ROSA,brawlBall,Pinhole Punt,4,0,4
3523,2023-01-11,ROSA,gemGrab,Gem Fort,4,4,8
3524,2023-01-11,ROSA,brawlBall,Sunny Soccer,2,0,2
3525,2023-01-10,ROSA,hotZone,Dueling Beetles,4,3,7
3526,2023-01-10,ROSA,heist,Safe Zone,0,1,1
3527,2023-01-10,ROSA,gemGrab,Crystal Arcade,7,2,9
3528,2023-01-10,ROSA,brawlBall,Center Stage,5,2,7
3529,2023-01-10,ROSA,brawlBall,Beach Ball,5,1,6
3530,2023-01-09,ROSA,hotZone,Dueling Beetles,8,3,11
3531,2023-01-09,ROSA,gemGrab,Double Swoosh,3,3,6
3532,2023-01-09,ROSA,brawlBall,Center Stage,35,57,92
3533,2023-01-09,ROSA,bounty,Layer Cake,3,4,7
3534,2023-01-08,ROSA,hotZone,Ring of Fire,3,5,8
3535,2023-01-08,ROSA,heist,Snaked Assault,0,1,1
3536,2023-01-08,ROSA,gemGrab,Hard Rock Mine,5,1,6
3537,2023-01-08,ROSA,gemGrab,Double Swoosh,7,5,12
3538,2023-01-08,ROSA,brawlBall,Super Beach,1,0,1
3539,2023-01-08,ROSA,bounty,Layer Cake,1,6,7
3540,2023-01-07,ROSA,hotZone,Ring of Fire,2,0,2
3541,2023-01-07,ROSA,heist,Tornado Ring,3,1,4
3542,2023-01-07,ROSA,gemGrab,Hard Rock Mine,4,2,6
3543,2023-01-07,ROSA,gemGrab,Deep Diner,2,0,2
3544,2023-01-07,ROSA,brawlBall,Super Beach,2,0,2
3545,2023-01-07,ROSA,brawlBall,Sneaky Fields,4,1,5
3546,2023-01-06,ROSA,hotZone,Split,2,0,2
3547,2023-01-06,ROSA,heist,Tornado Ring,1,0,1
3548,2023-01-06,ROSA,gemGrab,Undermine,3,1,4
3549,2023-01-06,ROSA,brawlBall,Sneaky Fields,51,46,97
3550,2023-01-06,ROSA,brawlBall,Pinhole Punt,1,0,1
3551,2023-01-05,ROSA,knockout,Out in the Open,1,0,1
3552,2023-01-05,ROSA,hotZone,Split,6,5,11
3553,2023-01-05,ROSA,gemGrab,Undermine,2,0,2
3554,2023-01-05,ROSA,gemGrab,Gem Fort,2,1,3
3555,2023-01-05,ROSA,brawlBall,Pinhole Punt,12,6,18
3556,2023-01-04,ROSA,hotZone,Parallel Plays,1,1,2
3557,2023-01-04,ROSA,gemGrab,Gem Fort,20,22,42
3558,2023-01-04,ROSA,brawlBall,Sunny Soccer,5,3,8
3559,2023-01-04,ROSA,bounty,Shooting Star,1,0,1
3560,2023-01-03,ROSA,knockout,Goldarm Gulch,1,0,1
3561,2023-01-03,ROSA,hotZone,Parallel Plays,2,0,2
3562,2023-01-03,ROSA,heist,Pit Stop,2,1,3
3563,2023-01-03,ROSA,gemGrab,Crystal Arcade,13,1,14
3564,2023-01-03,ROSA,brawlBall,Center Stage,1,1,2
3565,2023-01-03,ROSA,brawlBall,Beach Ball,8,1,9
3566,2023-01-02,ROSA,hotZone,Quarter Pounder,1,0,1
3567,2023-01-02,ROSA,heist,Pit Stop,1,0,1
3568,2023-01-02,ROSA,heist,Kaboom Canyon,1,0,1
3569,2023-01-02,ROSA,gemGrab,Double Swoosh,10,2,12
3570,2023-01-02,ROSA,brawlBall,Center Stage,52,53,105
3571,2023-01-02,ROSA,bounty,Hideout,1,0,1
3572,2023-01-01,ROSA,hotZone,Quarter Pounder,7,10,17
3573,2023-01-01,ROSA,gemGrab,Double Swoosh,8,2,10
3574,2023-01-01,ROSA,brawlBall,Backyard Bowl,0,1,1
3575,2023-01-01,ROSA,bounty,Canal Grande,2,0,2
3576,2022-12-31,ROSA,hotZone,Controller Chaos,0,1,1
3577,2022-12-31,ROSA,gemGrab,Minecart Madness,1,0,1
3578,2022-12-31,ROSA,gemGrab,Hard Rock Mine,2,0,2
3579,2022-12-30,ROSA,hotZone,Controller Chaos,0,1,1
3580,2022-12-30,ROSA,gemGrab,Undermine,1,0,1
3581,2022-12-30,ROSA,brawlBall,Sneaky Fields,3,5,8
3582,2022-12-29,ROSA,heist,Hot Potato,0,3,3
3583,2022-12-27,ROSA,brawlBall,Center Stage,0,1,1
3584,2022-12-26,ROSA,brawlBall,Center Stage,0,2,2
3585,2022-12-22,ROSA,gemGrab,Gem Fort,6,1,7
3586,2022-12-19,ROSA,brawlBall,Center Stage,1,0,1
3587,2022-12-16,ROSA,brawlBall,Sneaky Fields,0,1,1
3588,2022-12-13,ROSA,gemGrab,Crystal Arcade,0,1,1
3589,2022-12-10,ROSA,gemGrab,Hard Rock Mine,0,1,1
3590,2022-10-30,ROSA,bounty,Canal Grande,1,1,2
3591,2023-02-05,RICO,knockout,X Marks the Spot,14,4,18
3592,2023-02-05,RICO,knockout,Goldarm Gulch,104,76,180
3593,2023-02-05,RICO,hotZone,Ring of Fire,88,68,156
3594,2023-02-05,RICO,heist,Snaked Assault,23,12,35
3595,2023-02-05,RICO,heist,Pit Stop,97,82,179
3596,2023-02-05,RICO,gemGrab,Hard Rock Mine,223,278,501
3597,2023-02-05,RICO,gemGrab,Double Swoosh,65,26,91
3598,2023-02-05,RICO,brawlBall,Super Beach,12,25,37
3599,2023-02-05,RICO,brawlBall,Sneaky Fields,44,54,98
3600,2023-02-05,RICO,brawlBall,Backyard Bowl,150,87,237
3601,2023-02-05,RICO,bounty,Layer Cake,36,39,75
3602,2023-02-04,RICO,knockout,X Marks the Spot,4,2,6
3603,2023-02-04,RICO,knockout,Goldarm Gulch,72,59,131
3604,2023-02-04,RICO,hotZone,Ring of Fire,30,12,42
3605,2023-02-04,RICO,heist,Tornado Ring,4,9,13
3606,2023-02-04,RICO,heist,Pit Stop,74,62,136
3607,2023-02-04,RICO,gemGrab,Hard Rock Mine,250,242,492
3608,2023-02-04,RICO,gemGrab,Double Swoosh,11,3,14
3609,2023-02-04,RICO,gemGrab,Deep Diner,6,3,9
3610,2023-02-04,RICO,brawlBall,Super Beach,70,60,130
3611,2023-02-04,RICO,brawlBall,Sneaky Fields,43,61,104
3612,2023-02-04,RICO,bounty,Dry Season,3,6,9
3613,2023-02-03,RICO,knockout,Out in the Open,40,33,73
3614,2023-02-03,RICO,knockout,Goldarm Gulch,548,411,959
3615,2023-02-03,RICO,hotZone,Split,483,597,1080
3616,2023-02-03,RICO,heist,Tornado Ring,43,43,86
3617,2023-02-03,RICO,heist,Pit Stop,457,447,904
3618,2023-02-03,RICO,gemGrab,Undermine,16,11,27
3619,2023-02-03,RICO,gemGrab,Double Swoosh,58,20,78
3620,2023-02-03,RICO,gemGrab,Deep Diner,74,80,154
3621,2023-02-03,RICO,brawlBall,Sneaky Fields,1268,1541,2809
3622,2023-02-03,RICO,brawlBall,Pinhole Punt,23,24,47
3623,2023-02-03,RICO,bounty,Dry Season,17,12,29
3624,2023-02-02,RICO,knockout,Out in the Open,17,13,30
3625,2023-02-02,RICO,hotZone,Split,324,367,691
3626,2023-02-02,RICO,heist,Kaboom Canyon,2,8,10
3627,2023-02-02,RICO,gemGrab,Undermine,15,10,25
3628,2023-02-02,RICO,gemGrab,Gem Fort,16,13,29
3629,2023-02-02,RICO,brawlBall,Sunny Soccer,4,3,7
3630,2023-02-02,RICO,brawlBall,Pinhole Punt,194,162,356
3631,2023-02-02,RICO,bounty,Shooting Star,2,0,2
3632,2023-02-01,RICO,knockout,Goldarm Gulch,411,306,717
3633,2023-02-01,RICO,hotZone,Parallel Plays,27,15,42
3634,2023-02-01,RICO,heist,Kaboom Canyon,14,13,27
3635,2023-02-01,RICO,gemGrab,Gem Fort,140,125,265
3636,2023-02-01,RICO,gemGrab,Crystal Arcade,26,36,62
3637,2023-02-01,RICO,brawlBall,Sunny Soccer,363,388,751
3638,2023-02-01,RICO,brawlBall,Beach Ball,14,24,38
3639,2023-02-01,RICO,bounty,Shooting Star,2,1,3
3640,2023-01-31,RICO,knockout,Goldarm Gulch,250,228,478
3641,2023-01-31,RICO,hotZone,Parallel Plays,4,4,8
3642,2023-01-31,RICO,heist,Pit Stop,54,27,81
3643,2023-01-31,RICO,gemGrab,Minecart Madness,1,3,4
3644,2023-01-31,RICO,gemGrab,Crystal Arcade,39,16,55
3645,2023-01-31,RICO,brawlBall,Center Stage,21,18,39
3646,2023-01-31,RICO,brawlBall,Beach Ball,210,218,428
3647,2023-01-31,RICO,bounty,Hideout,9,6,15
3648,2023-01-30,RICO,knockout,Belle's Rock,133,126,259
3649,2023-01-30,RICO,hotZone,Quarter Pounder,72,181,253
3650,2023-01-30,RICO,heist,Pit Stop,159,100,259
3651,2023-01-30,RICO,gemGrab,Minecart Madness,39,31,70
3652,2023-01-30,RICO,gemGrab,Double Swoosh,19,9,28
3653,2023-01-30,RICO,brawlBall,Center Stage,1360,1456,2816
3654,2023-01-30,RICO,brawlBall,Backyard Bowl,24,20,44
3655,2023-01-30,RICO,bounty,Hideout,5,3,8
3656,2023-01-29,RICO,knockout,Belle's Rock,217,192,409
3657,2023-01-29,RICO,hotZone,Quarter Pounder,68,73,141
3658,2023-01-29,RICO,heist,Bridge Too Far,36,20,56
3659,2023-01-29,RICO,gemGrab,Hard Rock Mine,139,142,281
3660,2023-01-29,RICO,gemGrab,Double Swoosh,40,19,59
3661,2023-01-29,RICO,brawlBall,Super Beach,3,1,4
3662,2023-01-29,RICO,brawlBall,Backyard Bowl,141,107,248
3663,2023-01-29,RICO,bounty,Canal Grande,9,3,12
3664,2023-01-28,RICO,knockout,Flaring Phoenix,13,13,26
3665,2023-01-28,RICO,hotZone,Controller Chaos,17,4,21
3666,2023-01-28,RICO,heist,Bridge Too Far,91,33,124
3667,2023-01-28,RICO,gemGrab,Hard Rock Mine,821,922,1743
3668,2023-01-28,RICO,gemGrab,Deep Diner,36,27,63
3669,2023-01-28,RICO,brawlBall,Super Beach,347,316,663
3670,2023-01-28,RICO,brawlBall,Sneaky Fields,55,58,113
3671,2023-01-28,RICO,bounty,Canal Grande,20,9,29
3672,2023-01-27,RICO,knockout,Flaring Phoenix,5,6,11
3673,2023-01-27,RICO,hotZone,Controller Chaos,11,3,14
3674,2023-01-27,RICO,heist,Hot Potato,67,94,161
3675,2023-01-27,RICO,gemGrab,Undermine,8,3,11
3676,2023-01-27,RICO,gemGrab,Deep Diner,33,49,82
3677,2023-01-27,RICO,brawlBall,Sneaky Fields,354,350,704
3678,2023-01-27,RICO,brawlBall,Pinhole Punt,5,6,11
3679,2023-01-27,RICO,bounty,Temple Ruins,14,45,59
3680,2023-01-26,RICO,knockout,Riverside,32,27,59
3681,2023-01-26,RICO,hotZone,Open Zone,12,4,16
3682,2023-01-26,RICO,heist,Hot Potato,362,311,673
3683,2023-01-26,RICO,gemGrab,Undermine,56,76,132
3684,2023-01-26,RICO,gemGrab,Gem Fort,68,80,148
3685,2023-01-26,RICO,brawlBall,Sunny Soccer,18,32,50
3686,2023-01-26,RICO,brawlBall,Pinhole Punt,490,568,1058
3687,2023-01-26,RICO,bounty,Temple Ruins,55,77,132
3688,2023-01-25,RICO,knockout,Riverside,8,5,13
3689,2023-01-25,RICO,hotZone,Open Zone,5,2,7
3690,2023-01-25,RICO,heist,Safe Zone,229,321,550
3691,2023-01-25,RICO,gemGrab,Gem Fort,80,72,152
3692,2023-01-25,RICO,gemGrab,Crystal Arcade,26,31,57
3693,2023-01-25,RICO,brawlBall,Sunny Soccer,272,291,563
3694,2023-01-25,RICO,brawlBall,Beach Ball,26,26,52
3695,2023-01-25,RICO,bounty,Excel,82,70,152
3696,2023-01-24,RICO,knockout,New Perspective,63,56,119
3697,2023-01-24,RICO,hotZone,Dueling Beetles,18,10,28
3698,2023-01-24,RICO,heist,Safe Zone,519,677,1196
3699,2023-01-24,RICO,gemGrab,Minecart Madness,7,1,8
3700,2023-01-24,RICO,gemGrab,Crystal Arcade,52,52,104
3701,2023-01-24,RICO,brawlBall,Center Stage,208,172,380
3702,2023-01-24,RICO,brawlBall,Beach Ball,437,496,933
3703,2023-01-24,RICO,bounty,Excel,218,287,505
3704,2023-01-23,RICO,knockout,New Perspective,110,108,218
3705,2023-01-23,RICO,hotZone,Dueling Beetles,28,9,37
3706,2023-01-23,RICO,heist,Snaked Assault,24,12,36
3707,2023-01-23,RICO,gemGrab,Minecart Madness,57,27,84
3708,2023-01-23,RICO,gemGrab,Double Swoosh,12,8,20
3709,2023-01-23,RICO,brawlBall,Center Stage,2205,2146,4351
3710,2023-01-23,RICO,brawlBall,Backyard Bowl,16,18,34
3711,2023-01-23,RICO,bounty,Layer Cake,31,30,61
3712,2023-01-22,RICO,knockout,X Marks the Spot,12,6,18
3713,2023-01-22,RICO,hotZone,Ring of Fire,54,65,119
3714,2023-01-22,RICO,heist,Snaked Assault,14,8,22
3715,2023-01-22,RICO,gemGrab,Hard Rock Mine,204,202,406
3716,2023-01-22,RICO,gemGrab,Double Swoosh,24,19,43
3717,2023-01-22,RICO,brawlBall,Super Beach,45,25,70
3718,2023-01-22,RICO,brawlBall,Backyard Bowl,79,64,143
3719,2023-01-22,RICO,bounty,Layer Cake,33,48,81
3720,2023-01-21,RICO,knockout,X Marks the Spot,34,16,50
3721,2023-01-21,RICO,hotZone,Ring of Fire,194,159,353
3722,2023-01-21,RICO,heist,Tornado Ring,23,16,39
3723,2023-01-21,RICO,gemGrab,Hard Rock Mine,994,1132,2126
3724,2023-01-21,RICO,gemGrab,Deep Diner,31,18,49
3725,2023-01-21,RICO,brawlBall,Super Beach,467,413,880
3726,2023-01-21,RICO,brawlBall,Sneaky Fields,56,54,110
3727,2023-01-21,RICO,bounty,Dry Season,18,9,27
3728,2023-01-20,RICO,knockout,Out in the Open,44,23,67
3729,2023-01-20,RICO,hotZone,Split,556,691,1247
3730,2023-01-20,RICO,heist,Tornado Ring,25,9,34
3731,2023-01-20,RICO,gemGrab,Undermine,29,51,80
3732,2023-01-20,RICO,gemGrab,Deep Diner,91,72,163
3733,2023-01-20,RICO,brawlBall,Sneaky Fields,922,956,1878
3734,2023-01-20,RICO,brawlBall,Pinhole Punt,20,33,53
3735,2023-01-20,RICO,bounty,Dry Season,22,18,40
3736,2023-01-19,RICO,knockout,Out in the Open,43,43,86
3737,2023-01-19,RICO,hotZone,Split,972,1034,2006
3738,2023-01-19,RICO,heist,Kaboom Canyon,23,8,31
3739,2023-01-19,RICO,gemGrab,Undermine,73,99,172
3740,2023-01-19,RICO,gemGrab,Gem Fort,61,98,159
3741,2023-01-19,RICO,brawlBall,Sunny Soccer,18,17,35
3742,2023-01-19,RICO,brawlBall,Pinhole Punt,529,639,1168
3743,2023-01-19,RICO,bounty,Shooting Star,12,7,19
3744,2023-01-18,RICO,knockout,Goldarm Gulch,87,72,159
3745,2023-01-18,RICO,hotZone,Parallel Plays,1,0,1
3746,2023-01-18,RICO,heist,Kaboom Canyon,10,4,14
3747,2023-01-18,RICO,gemGrab,Gem Fort,35,40,75
3748,2023-01-18,RICO,gemGrab,Crystal Arcade,1,3,4
3749,2023-01-18,RICO,brawlBall,Sunny Soccer,98,88,186
3750,2023-01-18,RICO,brawlBall,Beach Ball,1,7,8
3751,2023-01-18,RICO,bounty,Shooting Star,4,1,5
3752,2023-01-17,RICO,knockout,Goldarm Gulch,68,69,137
3753,2023-01-17,RICO,hotZone,Parallel Plays,2,1,3
3754,2023-01-17,RICO,heist,Pit Stop,19,22,41
3755,2023-01-17,RICO,gemGrab,Crystal Arcade,2,3,5
3756,2023-01-17,RICO,brawlBall,Center Stage,4,3,7
3757,2023-01-17,RICO,brawlBall,Beach Ball,30,51,81
3758,2023-01-17,RICO,bounty,Hideout,2,0,2
3759,2023-01-16,RICO,knockout,Belle's Rock,12,7,19
3760,2023-01-16,RICO,hotZone,Quarter Pounder,13,39,52
3761,2023-01-16,RICO,heist,Pit Stop,54,43,97
3762,2023-01-16,RICO,gemGrab,Minecart Madness,1,1,2
3763,2023-01-16,RICO,gemGrab,Double Swoosh,4,0,4
3764,2023-01-16,RICO,brawlBall,Center Stage,157,166,323
3765,2023-01-16,RICO,brawlBall,Backyard Bowl,1,0,1
3766,2023-01-16,RICO,bounty,Hideout,2,3,5
3767,2023-01-15,RICO,knockout,Belle's Rock,21,28,49
3768,2023-01-15,RICO,hotZone,Quarter Pounder,25,23,48
3769,2023-01-15,RICO,heist,Bridge Too Far,5,14,19
3770,2023-01-15,RICO,gemGrab,Hard Rock Mine,39,43,82
3771,2023-01-15,RICO,gemGrab,Double Swoosh,6,2,8
3772,2023-01-15,RICO,brawlBall,Super Beach,2,1,3
3773,2023-01-15,RICO,brawlBall,Backyard Bowl,16,6,22
3774,2023-01-15,RICO,bounty,Canal Grande,1,6,7
3775,2023-01-14,RICO,knockout,Flaring Phoenix,0,2,2
3776,2023-01-14,RICO,hotZone,Controller Chaos,8,5,13
3777,2023-01-14,RICO,heist,Bridge Too Far,7,0,7
3778,2023-01-14,RICO,gemGrab,Hard Rock Mine,73,74,147
3779,2023-01-14,RICO,gemGrab,Deep Diner,5,6,11
3780,2023-01-14,RICO,brawlBall,Super Beach,28,16,44
3781,2023-01-14,RICO,brawlBall,Sneaky Fields,19,42,61
3782,2023-01-14,RICO,bounty,Canal Grande,2,0,2
3783,2023-01-13,RICO,knockout,Flaring Phoenix,2,0,2
3784,2023-01-13,RICO,hotZone,Controller Chaos,5,4,9
3785,2023-01-13,RICO,heist,Hot Potato,15,9,24
3786,2023-01-13,RICO,gemGrab,Deep Diner,9,3,12
3787,2023-01-13,RICO,brawlBall,Sneaky Fields,122,116,238
3788,2023-01-13,RICO,brawlBall,Pinhole Punt,1,1,2
3789,2023-01-13,RICO,bounty,Temple Ruins,3,19,22
3790,2023-01-12,RICO,knockout,Riverside,2,1,3
3791,2023-01-12,RICO,heist,Hot Potato,8,32,40
3792,2023-01-12,RICO,gemGrab,Undermine,2,3,5
3793,2023-01-12,RICO,gemGrab,Gem Fort,6,5,11
3794,2023-01-12,RICO,brawlBall,Sunny Soccer,4,2,6
3795,2023-01-12,RICO,brawlBall,Pinhole Punt,30,40,70
3796,2023-01-12,RICO,bounty,Temple Ruins,1,0,1
3797,2023-01-11,RICO,heist,Safe Zone,2,1,3
3798,2023-01-11,RICO,gemGrab,Gem Fort,5,2,7
3799,2023-01-11,RICO,brawlBall,Sunny Soccer,12,11,23
3800,2023-01-11,RICO,brawlBall,Beach Ball,2,0,2
3801,2023-01-11,RICO,bounty,Excel,1,5,6
3802,2023-01-10,RICO,knockout,New Perspective,6,4,10
3803,2023-01-10,RICO,hotZone,Dueling Beetles,2,0,2
3804,2023-01-10,RICO,heist,Safe Zone,38,75,113
3805,2023-01-10,RICO,gemGrab,Minecart Madness,1,0,1
3806,2023-01-10,RICO,gemGrab,Crystal Arcade,7,2,9
3807,2023-01-10,RICO,brawlBall,Center Stage,12,7,19
3808,2023-01-10,RICO,brawlBall,Beach Ball,26,41,67
3809,2023-01-10,RICO,bounty,Excel,3,6,9
3810,2023-01-09,RICO,knockout,New Perspective,2,2,4
3811,2023-01-09,RICO,hotZone,Dueling Beetles,2,0,2
3812,2023-01-09,RICO,heist,Snaked Assault,9,4,13
3813,2023-01-09,RICO,gemGrab,Minecart Madness,3,1,4
3814,2023-01-09,RICO,gemGrab,Double Swoosh,3,1,4
3815,2023-01-09,RICO,brawlBall,Center Stage,122,129,251
3816,2023-01-09,RICO,bounty,Layer Cake,5,15,20
3817,2023-01-08,RICO,knockout,X Marks the Spot,1,0,1
3818,2023-01-08,RICO,hotZone,Ring of Fire,10,0,10
3819,2023-01-08,RICO,heist,Snaked Assault,3,1,4
3820,2023-01-08,RICO,gemGrab,Hard Rock Mine,35,50,85
3821,2023-01-08,RICO,gemGrab,Double Swoosh,1,0,1
3822,2023-01-08,RICO,brawlBall,Super Beach,4,1,5
3823,2023-01-08,RICO,brawlBall,Backyard Bowl,12,9,21
3824,2023-01-08,RICO,bounty,Layer Cake,0,1,1
3825,2023-01-07,RICO,knockout,X Marks the Spot,1,0,1
3826,2023-01-07,RICO,hotZone,Ring of Fire,14,9,23
3827,2023-01-07,RICO,heist,Tornado Ring,1,0,1
3828,2023-01-07,RICO,gemGrab,Hard Rock Mine,58,73,131
3829,2023-01-07,RICO,gemGrab,Deep Diner,4,3,7
3830,2023-01-07,RICO,brawlBall,Super Beach,6,3,9
3831,2023-01-07,RICO,brawlBall,Sneaky Fields,4,1,5
3832,2023-01-06,RICO,knockout,Out in the Open,1,0,1
3833,2023-01-06,RICO,hotZone,Split,67,42,109
3834,2023-01-06,RICO,heist,Tornado Ring,3,2,5
3835,2023-01-06,RICO,gemGrab,Undermine,1,0,1
3836,2023-01-06,RICO,gemGrab,Deep Diner,16,27,43
3837,2023-01-06,RICO,brawlBall,Sneaky Fields,71,77,148
3838,2023-01-06,RICO,brawlBall,Pinhole Punt,9,11,20
3839,2023-01-05,RICO,knockout,Out in the Open,3,1,4
3840,2023-01-05,RICO,hotZone,Split,203,232,435
3841,2023-01-05,RICO,heist,Kaboom Canyon,2,1,3
3842,2023-01-05,RICO,gemGrab,Undermine,7,5,12
3843,2023-01-05,RICO,gemGrab,Gem Fort,0,11,11
3844,2023-01-05,RICO,brawlBall,Sunny Soccer,2,3,5
3845,2023-01-05,RICO,brawlBall,Pinhole Punt,77,88,165
3846,2023-01-05,RICO,bounty,Shooting Star,3,0,3
3847,2023-01-04,RICO,knockout,Goldarm Gulch,21,34,55
3848,2023-01-04,RICO,hotZone,Parallel Plays,1,1,2
3849,2023-01-04,RICO,heist,Kaboom Canyon,1,1,2
3850,2023-01-04,RICO,gemGrab,Gem Fort,23,30,53
3851,2023-01-04,RICO,gemGrab,Crystal Arcade,4,1,5
3852,2023-01-04,RICO,brawlBall,Sunny Soccer,45,59,104
3853,2023-01-04,RICO,brawlBall,Beach Ball,1,0,1
3854,2023-01-04,RICO,bounty,Shooting Star,1,0,1
3855,2023-01-03,RICO,knockout,Goldarm Gulch,23,23,46
3856,2023-01-03,RICO,hotZone,Controller Chaos,0,1,1
3857,2023-01-03,RICO,heist,Pit Stop,37,36,73
3858,2023-01-03,RICO,gemGrab,Crystal Arcade,7,2,9
3859,2023-01-03,RICO,brawlBall,Center Stage,6,2,8
3860,2023-01-03,RICO,brawlBall,Beach Ball,30,29,59
3861,2023-01-03,RICO,bounty,Hideout,1,0,1
3862,2023-01-02,RICO,knockout,Belle's Rock,17,10,27
3863,2023-01-02,RICO,hotZone,Quarter Pounder,11,16,27
3864,2023-01-02,RICO,heist,Pit Stop,57,25,82
3865,2023-01-02,RICO,heist,Kaboom Canyon,1,0,1
3866,2023-01-02,RICO,gemGrab,Minecart Madness,6,3,9
3867,2023-01-02,RICO,gemGrab,Double Swoosh,2,0,2
3868,2023-01-02,RICO,brawlBall,Center Stage,150,101,251
3869,2023-01-02,RICO,bounty,Hideout,2,0,2
3870,2023-01-01,RICO,knockout,Belle's Rock,10,5,15
3871,2023-01-01,RICO,hotZone,Quarter Pounder,5,1,6
3872,2023-01-01,RICO,gemGrab,Double Swoosh,3,0,3
3873,2023-01-01,RICO,brawlBall,Backyard Bowl,2,2,4
3874,2022-12-31,RICO,hotZone,Controller Chaos,1,0,1
3875,2022-12-31,RICO,gemGrab,Hard Rock Mine,15,11,26
3876,2022-12-31,RICO,gemGrab,Deep Diner,5,3,8
3877,2022-12-31,RICO,brawlBall,Super Beach,2,0,2
3878,2022-12-31,RICO,brawlBall,Sneaky Fields,1,1,2
3879,2022-12-30,RICO,heist,Hot Potato,0,1,1
3880,2022-12-30,RICO,gemGrab,Undermine,1,0,1
3881,2022-12-30,RICO,gemGrab,Deep Diner,4,0,4
3882,2022-12-30,RICO,brawlBall,Sneaky Fields,3,11,14
3883,2022-12-29,RICO,heist,Hot Potato,1,1,2
3884,2022-12-29,RICO,gemGrab,Gem Fort,2,0,2
3885,2022-12-29,RICO,brawlBall,Pinhole Punt,2,0,2
3886,2022-12-28,RICO,brawlBall,Sunny Soccer,3,1,4
3887,2022-12-27,RICO,hotZone,Dueling Beetles,0,1,1
3888,2022-12-27,RICO,hotZone,Controller Chaos,0,1,1
3889,2022-12-27,RICO,brawlBall,Center Stage,2,1,3
3890,2022-12-27,RICO,bounty,Excel,0,1,1
3891,2022-12-26,RICO,brawlBall,Center Stage,2,2,4
3892,2022-12-25,RICO,brawlBall,Backyard Bowl,1,0,1
3893,2022-12-20,RICO,brawlBall,Beach Ball,2,1,3
3894,2022-12-19,RICO,brawlBall,Center Stage,4,7,11
3895,2022-12-18,RICO,knockout,Belle's Rock,1,0,1
3896,2022-12-16,RICO,brawlBall,Sneaky Fields,2,0,2
3897,2022-12-13,RICO,heist,Safe Zone,2,0,2
3898,2022-12-13,RICO,gemGrab,Crystal Arcade,1,0,1
3899,2022-12-11,RICO,gemGrab,Double Swoosh,0,1,1
3900,2022-12-10,RICO,gemGrab,Hard Rock Mine,2,1,3
3901,2022-11-11,RICO,knockout,New Perspective,0,2,2
3902,2022-11-11,RICO,brawlBall,Sneaky Fields,1,1,2
3903,2022-11-01,RICO,knockout,New Perspective,2,0,2
3904,2022-10-15,RICO,gemGrab,Hard Rock Mine,2,3,5
3905,2023-02-05,POCO,knockout,X Marks the Spot,35,14,49
3906,2023-02-05,POCO,knockout,Goldarm Gulch,3,1,4
3907,2023-02-05,POCO,hotZone,Ring of Fire,442,574,1016
3908,2023-02-05,POCO,heist,Snaked Assault,12,5,17
3909,2023-02-05,POCO,heist,Pit Stop,1,1,2
3910,2023-02-05,POCO,gemGrab,Hard Rock Mine,37,27,64
3911,2023-02-05,POCO,gemGrab,Double Swoosh,373,330,703
3912,2023-02-05,POCO,brawlBall,Super Beach,23,16,39
3913,2023-02-05,POCO,brawlBall,Sneaky Fields,142,169,311
3914,2023-02-05,POCO,brawlBall,Backyard Bowl,315,301,616
3915,2023-02-05,POCO,bounty,Layer Cake,32,26,58
3916,2023-02-04,POCO,knockout,X Marks the Spot,12,8,20
3917,2023-02-04,POCO,knockout,Goldarm Gulch,4,1,5
3918,2023-02-04,POCO,hotZone,Ring of Fire,95,129,224
3919,2023-02-04,POCO,heist,Tornado Ring,1,2,3
3920,2023-02-04,POCO,gemGrab,Hard Rock Mine,35,28,63
3921,2023-02-04,POCO,gemGrab,Double Swoosh,59,41,100
3922,2023-02-04,POCO,gemGrab,Deep Diner,9,13,22
3923,2023-02-04,POCO,brawlBall,Super Beach,164,196,360
3924,2023-02-04,POCO,brawlBall,Sneaky Fields,110,137,247
3925,2023-02-04,POCO,bounty,Dry Season,6,2,8
3926,2023-02-03,POCO,knockout,Out in the Open,62,43,105
3927,2023-02-03,POCO,knockout,Goldarm Gulch,6,9,15
3928,2023-02-03,POCO,hotZone,Split,90,51,141
3929,2023-02-03,POCO,heist,Tornado Ring,15,8,23
3930,2023-02-03,POCO,heist,Pit Stop,3,4,7
3931,2023-02-03,POCO,gemGrab,Undermine,42,47,89
3932,2023-02-03,POCO,gemGrab,Double Swoosh,372,338,710
3933,2023-02-03,POCO,gemGrab,Deep Diner,190,158,348
3934,2023-02-03,POCO,brawlBall,Sneaky Fields,1353,1546,2899
3935,2023-02-03,POCO,brawlBall,Pinhole Punt,50,54,104
3936,2023-02-03,POCO,bounty,Dry Season,42,32,74
3937,2023-02-02,POCO,knockout,Out in the Open,27,14,41
3938,2023-02-02,POCO,hotZone,Split,26,25,51
3939,2023-02-02,POCO,heist,Kaboom Canyon,6,4,10
3940,2023-02-02,POCO,gemGrab,Undermine,39,39,78
3941,2023-02-02,POCO,gemGrab,Gem Fort,13,14,27
3942,2023-02-02,POCO,brawlBall,Sunny Soccer,3,5,8
3943,2023-02-02,POCO,brawlBall,Pinhole Punt,208,282,490
3944,2023-02-02,POCO,bounty,Shooting Star,7,3,10
3945,2023-02-01,POCO,knockout,Goldarm Gulch,42,39,81
3946,2023-02-01,POCO,hotZone,Parallel Plays,176,110,286
3947,2023-02-01,POCO,heist,Kaboom Canyon,16,5,21
3948,2023-02-01,POCO,gemGrab,Gem Fort,238,225,463
3949,2023-02-01,POCO,gemGrab,Crystal Arcade,83,57,140
3950,2023-02-01,POCO,brawlBall,Sunny Soccer,406,459,865
3951,2023-02-01,POCO,brawlBall,Beach Ball,17,16,33
3952,2023-02-01,POCO,bounty,Shooting Star,4,6,10
3953,2023-01-31,POCO,knockout,Goldarm Gulch,29,16,45
3954,2023-01-31,POCO,hotZone,Parallel Plays,69,83,152
3955,2023-01-31,POCO,heist,Pit Stop,12,2,14
3956,2023-01-31,POCO,gemGrab,Minecart Madness,14,10,24
3957,2023-01-31,POCO,gemGrab,Crystal Arcade,109,111,220
3958,2023-01-31,POCO,brawlBall,Center Stage,4,1,5
3959,2023-01-31,POCO,brawlBall,Beach Ball,243,238,481
3960,2023-01-31,POCO,bounty,Hideout,8,6,14
3961,2023-01-30,POCO,knockout,Belle's Rock,37,36,73
3962,2023-01-30,POCO,hotZone,Quarter Pounder,261,157,418
3963,2023-01-30,POCO,heist,Pit Stop,7,2,9
3964,2023-01-30,POCO,gemGrab,Minecart Madness,103,77,180
3965,2023-01-30,POCO,gemGrab,Double Swoosh,132,141,273
3966,2023-01-30,POCO,brawlBall,Center Stage,377,462,839
3967,2023-01-30,POCO,brawlBall,Backyard Bowl,47,33,80
3968,2023-01-30,POCO,bounty,Hideout,7,2,9
3969,2023-01-29,POCO,knockout,Belle's Rock,30,13,43
3970,2023-01-29,POCO,hotZone,Quarter Pounder,184,116,300
3971,2023-01-29,POCO,heist,Bridge Too Far,11,3,14
3972,2023-01-29,POCO,gemGrab,Hard Rock Mine,51,22,73
3973,2023-01-29,POCO,gemGrab,Double Swoosh,245,270,515
3974,2023-01-29,POCO,brawlBall,Super Beach,9,16,25
3975,2023-01-29,POCO,brawlBall,Backyard Bowl,344,388,732
3976,2023-01-29,POCO,bounty,Canal Grande,21,30,51
3977,2023-01-28,POCO,knockout,Flaring Phoenix,19,12,31
3978,2023-01-28,POCO,hotZone,Controller Chaos,302,319,621
3979,2023-01-28,POCO,heist,Bridge Too Far,15,6,21
3980,2023-01-28,POCO,gemGrab,Hard Rock Mine,146,99,245
3981,2023-01-28,POCO,gemGrab,Deep Diner,69,61,130
3982,2023-01-28,POCO,brawlBall,Super Beach,728,778,1506
3983,2023-01-28,POCO,brawlBall,Sneaky Fields,50,45,95
3984,2023-01-28,POCO,bounty,Canal Grande,44,47,91
3985,2023-01-27,POCO,knockout,Flaring Phoenix,10,6,16
3986,2023-01-27,POCO,hotZone,Controller Chaos,86,110,196
3987,2023-01-27,POCO,heist,Hot Potato,6,3,9
3988,2023-01-27,POCO,gemGrab,Undermine,12,10,22
3989,2023-01-27,POCO,gemGrab,Deep Diner,69,45,114
3990,2023-01-27,POCO,brawlBall,Sneaky Fields,275,294,569
3991,2023-01-27,POCO,brawlBall,Pinhole Punt,17,16,33
3992,2023-01-27,POCO,bounty,Temple Ruins,9,2,11
3993,2023-01-26,POCO,knockout,Riverside,45,22,67
3994,2023-01-26,POCO,hotZone,Open Zone,451,578,1029
3995,2023-01-26,POCO,heist,Hot Potato,26,15,41
3996,2023-01-26,POCO,gemGrab,Undermine,125,97,222
3997,2023-01-26,POCO,gemGrab,Gem Fort,69,91,160
3998,2023-01-26,POCO,brawlBall,Sunny Soccer,41,43,84
3999,2023-01-26,POCO,brawlBall,Pinhole Punt,946,979,1925
4000,2023-01-26,POCO,bounty,Temple Ruins,31,24,55
4001,2023-01-25,POCO,knockout,Riverside,17,6,23
4002,2023-01-25,POCO,hotZone,Open Zone,213,260,473
4003,2023-01-25,POCO,heist,Safe Zone,17,7,24
4004,2023-01-25,POCO,gemGrab,Gem Fort,108,133,241
4005,2023-01-25,POCO,gemGrab,Crystal Arcade,117,80,197
4006,2023-01-25,POCO,brawlBall,Sunny Soccer,344,393,737
4007,2023-01-25,POCO,brawlBall,Beach Ball,60,54,114
4008,2023-01-25,POCO,bounty,Excel,19,6,25
4009,2023-01-24,POCO,knockout,New Perspective,36,19,55
4010,2023-01-24,POCO,hotZone,Dueling Beetles,520,684,1204
4011,2023-01-24,POCO,heist,Safe Zone,20,20,40
4012,2023-01-24,POCO,gemGrab,Minecart Madness,33,29,62
4013,2023-01-24,POCO,gemGrab,Crystal Arcade,189,129,318
4014,2023-01-24,POCO,brawlBall,Center Stage,46,57,103
4015,2023-01-24,POCO,brawlBall,Beach Ball,561,625,1186
4016,2023-01-24,POCO,bounty,Excel,46,41,87
4017,2023-01-23,POCO,knockout,New Perspective,52,24,76
4018,2023-01-23,POCO,hotZone,Dueling Beetles,805,1061,1866
4019,2023-01-23,POCO,heist,Snaked Assault,18,3,21
4020,2023-01-23,POCO,gemGrab,Minecart Madness,170,137,307
4021,2023-01-23,POCO,gemGrab,Double Swoosh,116,88,204
4022,2023-01-23,POCO,brawlBall,Center Stage,643,622,1265
4023,2023-01-23,POCO,brawlBall,Backyard Bowl,17,10,27
4024,2023-01-23,POCO,bounty,Layer Cake,38,44,82
4025,2023-01-22,POCO,knockout,X Marks the Spot,18,9,27
4026,2023-01-22,POCO,hotZone,Ring of Fire,239,250,489
4027,2023-01-22,POCO,heist,Snaked Assault,9,10,19
4028,2023-01-22,POCO,gemGrab,Hard Rock Mine,36,49,85
4029,2023-01-22,POCO,gemGrab,Double Swoosh,135,88,223
4030,2023-01-22,POCO,brawlBall,Super Beach,76,70,146
4031,2023-01-22,POCO,brawlBall,Backyard Bowl,176,140,316
4032,2023-01-22,POCO,bounty,Layer Cake,40,67,107
4033,2023-01-21,POCO,knockout,X Marks the Spot,70,43,113
4034,2023-01-21,POCO,hotZone,Ring of Fire,776,961,1737
4035,2023-01-21,POCO,heist,Tornado Ring,19,6,25
4036,2023-01-21,POCO,gemGrab,Hard Rock Mine,207,183,390
4037,2023-01-21,POCO,gemGrab,Deep Diner,66,26,92
4038,2023-01-21,POCO,brawlBall,Super Beach,863,940,1803
4039,2023-01-21,POCO,brawlBall,Sneaky Fields,47,43,90
4040,2023-01-21,POCO,bounty,Dry Season,48,18,66
4041,2023-01-20,POCO,knockout,Out in the Open,81,48,129
4042,2023-01-20,POCO,hotZone,Split,88,44,132
4043,2023-01-20,POCO,heist,Tornado Ring,25,10,35
4044,2023-01-20,POCO,gemGrab,Undermine,64,49,113
4045,2023-01-20,POCO,gemGrab,Deep Diner,218,197,415
4046,2023-01-20,POCO,brawlBall,Sneaky Fields,789,868,1657
4047,2023-01-20,POCO,brawlBall,Pinhole Punt,36,43,79
4048,2023-01-20,POCO,bounty,Dry Season,25,19,44
4049,2023-01-19,POCO,knockout,Out in the Open,78,49,127
4050,2023-01-19,POCO,hotZone,Split,103,65,168
4051,2023-01-19,POCO,heist,Kaboom Canyon,29,19,48
4052,2023-01-19,POCO,gemGrab,Undermine,199,149,348
4053,2023-01-19,POCO,gemGrab,Gem Fort,36,43,79
4054,2023-01-19,POCO,brawlBall,Sunny Soccer,17,16,33
4055,2023-01-19,POCO,brawlBall,Pinhole Punt,915,1117,2032
4056,2023-01-19,POCO,bounty,Shooting Star,44,38,82
4057,2023-01-18,POCO,knockout,Goldarm Gulch,7,1,8
4058,2023-01-18,POCO,hotZone,Parallel Plays,21,13,34
4059,2023-01-18,POCO,heist,Kaboom Canyon,2,3,5
4060,2023-01-18,POCO,gemGrab,Gem Fort,49,42,91
4061,2023-01-18,POCO,gemGrab,Crystal Arcade,18,11,29
4062,2023-01-18,POCO,brawlBall,Sunny Soccer,146,143,289
4063,2023-01-18,POCO,brawlBall,Beach Ball,3,5,8
4064,2023-01-18,POCO,bounty,Shooting Star,10,11,21
4065,2023-01-17,POCO,knockout,Goldarm Gulch,7,2,9
4066,2023-01-17,POCO,hotZone,Parallel Plays,7,8,15
4067,2023-01-17,POCO,heist,Pit Stop,3,0,3
4068,2023-01-17,POCO,gemGrab,Minecart Madness,1,0,1
4069,2023-01-17,POCO,gemGrab,Crystal Arcade,13,9,22
4070,2023-01-17,POCO,brawlBall,Center Stage,1,4,5
4071,2023-01-17,POCO,brawlBall,Beach Ball,48,45,93
4072,2023-01-17,POCO,bounty,Hideout,4,3,7
4073,2023-01-16,POCO,knockout,Belle's Rock,1,1,2
4074,2023-01-16,POCO,hotZone,Quarter Pounder,36,13,49
4075,2023-01-16,POCO,heist,Pit Stop,4,0,4
4076,2023-01-16,POCO,gemGrab,Minecart Madness,18,9,27
4077,2023-01-16,POCO,gemGrab,Double Swoosh,10,4,14
4078,2023-01-16,POCO,brawlBall,Center Stage,40,38,78
4079,2023-01-16,POCO,brawlBall,Backyard Bowl,2,1,3
4080,2023-01-16,POCO,bounty,Hideout,1,1,2
4081,2023-01-15,POCO,knockout,Belle's Rock,1,0,1
4082,2023-01-15,POCO,hotZone,Quarter Pounder,60,35,95
4083,2023-01-15,POCO,heist,Bridge Too Far,3,0,3
4084,2023-01-15,POCO,gemGrab,Hard Rock Mine,3,2,5
4085,2023-01-15,POCO,gemGrab,Double Swoosh,38,35,73
4086,2023-01-15,POCO,brawlBall,Super Beach,9,7,16
4087,2023-01-15,POCO,brawlBall,Backyard Bowl,39,31,70
4088,2023-01-15,POCO,bounty,Canal Grande,3,1,4
4089,2023-01-14,POCO,knockout,Flaring Phoenix,2,0,2
4090,2023-01-14,POCO,hotZone,Controller Chaos,58,117,175
4091,2023-01-14,POCO,heist,Bridge Too Far,4,1,5
4092,2023-01-14,POCO,gemGrab,Hard Rock Mine,10,7,17
4093,2023-01-14,POCO,gemGrab,Deep Diner,11,4,15
4094,2023-01-14,POCO,brawlBall,Super Beach,55,53,108
4095,2023-01-14,POCO,brawlBall,Sneaky Fields,12,1,13
4096,2023-01-14,POCO,bounty,Canal Grande,8,14,22
4097,2023-01-13,POCO,knockout,Flaring Phoenix,2,1,3
4098,2023-01-13,POCO,hotZone,Controller Chaos,104,89,193
4099,2023-01-13,POCO,gemGrab,Undermine,0,2,2
4100,2023-01-13,POCO,gemGrab,Deep Diner,19,14,33
4101,2023-01-13,POCO,brawlBall,Sneaky Fields,96,136,232
4102,2023-01-13,POCO,brawlBall,Pinhole Punt,3,2,5
4103,2023-01-13,POCO,bounty,Temple Ruins,2,1,3
4104,2023-01-12,POCO,knockout,Riverside,6,2,8
4105,2023-01-12,POCO,hotZone,Open Zone,89,102,191
4106,2023-01-12,POCO,gemGrab,Undermine,3,1,4
4107,2023-01-12,POCO,gemGrab,Gem Fort,2,5,7
4108,2023-01-12,POCO,brawlBall,Sunny Soccer,2,1,3
4109,2023-01-12,POCO,brawlBall,Pinhole Punt,33,39,72
4110,2023-01-12,POCO,bounty,Temple Ruins,0,1,1
4111,2023-01-11,POCO,hotZone,Open Zone,22,21,43
4112,2023-01-11,POCO,heist,Safe Zone,0,1,1
4113,2023-01-11,POCO,gemGrab,Gem Fort,5,1,6
4114,2023-01-11,POCO,brawlBall,Sunny Soccer,7,7,14
4115,2023-01-11,POCO,brawlBall,Beach Ball,1,0,1
4116,2023-01-11,POCO,bounty,Excel,1,0,1
4117,2023-01-10,POCO,knockout,New Perspective,2,2,4
4118,2023-01-10,POCO,hotZone,Dueling Beetles,101,130,231
4119,2023-01-10,POCO,heist,Safe Zone,1,3,4
4120,2023-01-10,POCO,gemGrab,Minecart Madness,9,1,10
4121,2023-01-10,POCO,gemGrab,Crystal Arcade,21,6,27
4122,2023-01-10,POCO,brawlBall,Center Stage,6,0,6
4123,2023-01-10,POCO,brawlBall,Beach Ball,44,32,76
4124,2023-01-09,POCO,knockout,New Perspective,2,2,4
4125,2023-01-09,POCO,hotZone,Dueling Beetles,57,38,95
4126,2023-01-09,POCO,heist,Snaked Assault,2,0,2
4127,2023-01-09,POCO,gemGrab,Minecart Madness,11,3,14
4128,2023-01-09,POCO,gemGrab,Double Swoosh,34,47,81
4129,2023-01-09,POCO,brawlBall,Center Stage,28,20,48
4130,2023-01-09,POCO,brawlBall,Backyard Bowl,3,1,4
4131,2023-01-09,POCO,bounty,Layer Cake,1,0,1
4132,2023-01-08,POCO,knockout,X Marks the Spot,7,0,7
4133,2023-01-08,POCO,hotZone,Ring of Fire,82,87,169
4134,2023-01-08,POCO,heist,Snaked Assault,1,0,1
4135,2023-01-08,POCO,gemGrab,Hard Rock Mine,6,1,7
4136,2023-01-08,POCO,gemGrab,Double Swoosh,8,6,14
4137,2023-01-08,POCO,brawlBall,Super Beach,4,4,8
4138,2023-01-08,POCO,brawlBall,Backyard Bowl,33,10,43
4139,2023-01-08,POCO,bounty,Layer Cake,1,6,7
4140,2023-01-07,POCO,knockout,X Marks the Spot,1,0,1
4141,2023-01-07,POCO,hotZone,Ring of Fire,46,29,75
4142,2023-01-07,POCO,heist,Tornado Ring,1,0,1
4143,2023-01-07,POCO,gemGrab,Hard Rock Mine,10,8,18
4144,2023-01-07,POCO,gemGrab,Deep Diner,7,2,9
4145,2023-01-07,POCO,brawlBall,Super Beach,23,15,38
4146,2023-01-07,POCO,brawlBall,Sneaky Fields,3,3,6
4147,2023-01-07,POCO,bounty,Dry Season,1,0,1
4148,2023-01-06,POCO,knockout,Out in the Open,2,0,2
4149,2023-01-06,POCO,hotZone,Split,7,1,8
4150,2023-01-06,POCO,gemGrab,Undermine,3,0,3
4151,2023-01-06,POCO,gemGrab,Deep Diner,28,8,36
4152,2023-01-06,POCO,brawlBall,Sneaky Fields,78,85,163
4153,2023-01-06,POCO,brawlBall,Pinhole Punt,2,9,11
4154,2023-01-06,POCO,bounty,Dry Season,3,4,7
4155,2023-01-05,POCO,knockout,Out in the Open,3,0,3
4156,2023-01-05,POCO,hotZone,Split,22,23,45
4157,2023-01-05,POCO,heist,Kaboom Canyon,2,0,2
4158,2023-01-05,POCO,gemGrab,Undermine,10,3,13
4159,2023-01-05,POCO,gemGrab,Gem Fort,4,5,9
4160,2023-01-05,POCO,brawlBall,Sunny Soccer,1,0,1
4161,2023-01-05,POCO,brawlBall,Pinhole Punt,112,72,184
4162,2023-01-05,POCO,bounty,Shooting Star,0,1,1
4163,2023-01-04,POCO,hotZone,Parallel Plays,15,4,19
4164,2023-01-04,POCO,heist,Kaboom Canyon,2,0,2
4165,2023-01-04,POCO,gemGrab,Gem Fort,44,41,85
4166,2023-01-04,POCO,gemGrab,Crystal Arcade,8,13,21
4167,2023-01-04,POCO,brawlBall,Sunny Soccer,43,50,93
4168,2023-01-04,POCO,brawlBall,Beach Ball,1,1,2
4169,2023-01-04,POCO,bounty,Shooting Star,3,15,18
4170,2023-01-03,POCO,knockout,Goldarm Gulch,1,0,1
4171,2023-01-03,POCO,hotZone,Parallel Plays,24,27,51
4172,2023-01-03,POCO,heist,Pit Stop,0,1,1
4173,2023-01-03,POCO,gemGrab,Minecart Madness,4,0,4
4174,2023-01-03,POCO,gemGrab,Crystal Arcade,32,6,38
4175,2023-01-03,POCO,brawlBall,Center Stage,1,0,1
4176,2023-01-03,POCO,brawlBall,Beach Ball,45,39,84
4177,2023-01-03,POCO,bounty,Hideout,3,0,3
4178,2023-01-02,POCO,knockout,Belle's Rock,1,0,1
4179,2023-01-02,POCO,hotZone,Quarter Pounder,68,75,143
4180,2023-01-02,POCO,hotZone,Controller Chaos,0,2,2
4181,2023-01-02,POCO,heist,Pit Stop,0,1,1
4182,2023-01-02,POCO,gemGrab,Minecart Madness,28,7,35
4183,2023-01-02,POCO,gemGrab,Double Swoosh,24,16,40
4184,2023-01-02,POCO,brawlBall,Center Stage,63,66,129
4185,2023-01-02,POCO,brawlBall,Backyard Bowl,2,1,3
4186,2023-01-02,POCO,bounty,Hideout,3,0,3
4187,2023-01-01,POCO,knockout,Belle's Rock,1,0,1
4188,2023-01-01,POCO,hotZone,Quarter Pounder,11,1,12
4189,2023-01-01,POCO,heist,Bridge Too Far,1,0,1
4190,2023-01-01,POCO,gemGrab,Minecart Madness,1,0,1
4191,2023-01-01,POCO,gemGrab,Double Swoosh,15,12,27
4192,2023-01-01,POCO,brawlBall,Backyard Bowl,10,4,14
4193,2023-01-01,POCO,bounty,Canal Grande,2,2,4
4194,2022-12-31,POCO,hotZone,Controller Chaos,7,2,9
4195,2022-12-31,POCO,gemGrab,Hard Rock Mine,3,1,4
4196,2022-12-31,POCO,gemGrab,Deep Diner,2,0,2
4197,2022-12-31,POCO,brawlBall,Super Beach,7,3,10
4198,2022-12-31,POCO,brawlBall,Sneaky Fields,0,1,1
4199,2022-12-31,POCO,bounty,Canal Grande,2,2,4
4200,2022-12-30,POCO,hotZone,Controller Chaos,5,2,7
4201,2022-12-30,POCO,gemGrab,Deep Diner,6,3,9
4202,2022-12-30,POCO,brawlBall,Sneaky Fields,4,3,7
4203,2022-12-29,POCO,hotZone,Open Zone,1,2,3
4204,2022-12-29,POCO,gemGrab,Gem Fort,1,0,1
4205,2022-12-29,POCO,brawlBall,Pinhole Punt,3,1,4
4206,2022-12-28,POCO,hotZone,Open Zone,4,3,7
4207,2022-12-27,POCO,hotZone,Dueling Beetles,2,0,2
4208,2022-12-26,POCO,brawlBall,Center Stage,1,0,1
4209,2022-12-23,POCO,knockout,Out in the Open,0,1,1
4210,2022-12-23,POCO,gemGrab,Deep Diner,1,0,1
4211,2022-12-22,POCO,gemGrab,Gem Fort,3,0,3
4212,2022-12-22,POCO,brawlBall,Pinhole Punt,3,0,3
4213,2022-12-21,POCO,brawlBall,Sunny Soccer,1,0,1
4214,2022-12-16,POCO,hotZone,Controller Chaos,1,0,1
4215,2022-12-13,POCO,knockout,New Perspective,1,0,1
4216,2022-12-13,POCO,heist,Safe Zone,2,0,2
4217,2022-12-11,POCO,gemGrab,Double Swoosh,0,1,1
4218,2022-12-10,POCO,gemGrab,Hard Rock Mine,0,1,1
4219,2022-11-11,POCO,brawlBall,Sneaky Fields,0,1,1
4220,2022-10-30,POCO,bounty,Canal Grande,1,0,1
4221,2022-10-28,POCO,knockout,Out in the Open,1,0,1
4222,2022-10-15,POCO,hotZone,Ring of Fire,1,2,3
4223,2022-10-15,POCO,gemGrab,Hard Rock Mine,0,3,3
4224,2022-10-10,POCO,knockout,Belle's Rock,1,0,1
4225,2023-02-05,PIPER,knockout,X Marks the Spot,288,223,511
4226,2023-02-05,PIPER,knockout,Goldarm Gulch,63,51,114
4227,2023-02-05,PIPER,hotZone,Ring of Fire,32,10,42
4228,2023-02-05,PIPER,heist,Snaked Assault,26,11,37
4229,2023-02-05,PIPER,gemGrab,Hard Rock Mine,41,41,82
4230,2023-02-05,PIPER,gemGrab,Double Swoosh,61,54,115
4231,2023-02-05,PIPER,brawlBall,Super Beach,0,1,1
4232,2023-02-05,PIPER,brawlBall,Sneaky Fields,1,0,1
4233,2023-02-05,PIPER,brawlBall,Backyard Bowl,1359,1307,2666
4234,2023-02-05,PIPER,bounty,Layer Cake,159,155,314
4235,2023-02-04,PIPER,knockout,X Marks the Spot,100,114,214
4236,2023-02-04,PIPER,knockout,Goldarm Gulch,56,35,91
4237,2023-02-04,PIPER,hotZone,Ring of Fire,8,7,15
4238,2023-02-04,PIPER,heist,Tornado Ring,2,0,2
4239,2023-02-04,PIPER,gemGrab,Hard Rock Mine,77,84,161
4240,2023-02-04,PIPER,gemGrab,Double Swoosh,3,4,7
4241,2023-02-04,PIPER,gemGrab,Deep Diner,7,15,22
4242,2023-02-04,PIPER,brawlBall,Super Beach,30,19,49
4243,2023-02-04,PIPER,bounty,Dry Season,111,100,211
4244,2023-02-03,PIPER,knockout,Out in the Open,558,519,1077
4245,2023-02-03,PIPER,knockout,Goldarm Gulch,351,330,681
4246,2023-02-03,PIPER,hotZone,Split,6,3,9
4247,2023-02-03,PIPER,heist,Tornado Ring,18,11,29
4248,2023-02-03,PIPER,heist,Pit Stop,1,0,1
4249,2023-02-03,PIPER,gemGrab,Undermine,54,94,148
4250,2023-02-03,PIPER,gemGrab,Double Swoosh,20,31,51
4251,2023-02-03,PIPER,gemGrab,Deep Diner,135,116,251
4252,2023-02-03,PIPER,brawlBall,Sneaky Fields,74,68,142
4253,2023-02-03,PIPER,brawlBall,Pinhole Punt,10,8,18
4254,2023-02-03,PIPER,bounty,Dry Season,988,898,1886
4255,2023-02-02,PIPER,knockout,Out in the Open,236,198,434
4256,2023-02-02,PIPER,hotZone,Split,2,3,5
4257,2023-02-02,PIPER,heist,Kaboom Canyon,19,21,40
4258,2023-02-02,PIPER,gemGrab,Undermine,37,43,80
4259,2023-02-02,PIPER,gemGrab,Gem Fort,4,2,6
4260,2023-02-02,PIPER,brawlBall,Sunny Soccer,1,0,1
4261,2023-02-02,PIPER,brawlBall,Pinhole Punt,52,46,98
4262,2023-02-02,PIPER,bounty,Shooting Star,258,279,537
4263,2023-02-01,PIPER,knockout,Goldarm Gulch,422,329,751
4264,2023-02-01,PIPER,hotZone,Parallel Plays,15,7,22
4265,2023-02-01,PIPER,heist,Kaboom Canyon,94,98,192
4266,2023-02-01,PIPER,gemGrab,Gem Fort,59,36,95
4267,2023-02-01,PIPER,gemGrab,Crystal Arcade,70,74,144
4268,2023-02-01,PIPER,brawlBall,Sunny Soccer,51,47,98
4269,2023-02-01,PIPER,brawlBall,Beach Ball,6,0,6
4270,2023-02-01,PIPER,bounty,Shooting Star,614,614,1228
4271,2023-01-31,PIPER,knockout,Goldarm Gulch,155,110,265
4272,2023-01-31,PIPER,hotZone,Parallel Plays,6,4,10
4273,2023-01-31,PIPER,gemGrab,Minecart Madness,15,16,31
4274,2023-01-31,PIPER,gemGrab,Crystal Arcade,74,62,136
4275,2023-01-31,PIPER,brawlBall,Center Stage,2,2,4
4276,2023-01-31,PIPER,brawlBall,Beach Ball,29,32,61
4277,2023-01-31,PIPER,bounty,Hideout,136,133,269
4278,2023-01-30,PIPER,knockout,Belle's Rock,466,450,916
4279,2023-01-30,PIPER,hotZone,Quarter Pounder,26,23,49
4280,2023-01-30,PIPER,heist,Pit Stop,2,2,4
4281,2023-01-30,PIPER,gemGrab,Minecart Madness,208,298,506
4282,2023-01-30,PIPER,gemGrab,Double Swoosh,32,35,67
4283,2023-01-30,PIPER,brawlBall,Center Stage,49,15,64
4284,2023-01-30,PIPER,brawlBall,Backyard Bowl,112,117,229
4285,2023-01-30,PIPER,bounty,Hideout,309,343,652
4286,2023-01-29,PIPER,knockout,Belle's Rock,474,494,968
4287,2023-01-29,PIPER,hotZone,Quarter Pounder,35,16,51
4288,2023-01-29,PIPER,heist,Bridge Too Far,384,313,697
4289,2023-01-29,PIPER,gemGrab,Hard Rock Mine,30,54,84
4290,2023-01-29,PIPER,gemGrab,Double Swoosh,70,41,111
4291,2023-01-29,PIPER,brawlBall,Super Beach,2,1,3
4292,2023-01-29,PIPER,brawlBall,Backyard Bowl,1231,1175,2406
4293,2023-01-29,PIPER,bounty,Canal Grande,58,72,130
4294,2023-01-28,PIPER,knockout,Flaring Phoenix,214,148,362
4295,2023-01-28,PIPER,hotZone,Controller Chaos,12,1,13
4296,2023-01-28,PIPER,heist,Bridge Too Far,918,877,1795
4297,2023-01-28,PIPER,gemGrab,Hard Rock Mine,260,288,548
4298,2023-01-28,PIPER,gemGrab,Deep Diner,46,56,102
4299,2023-01-28,PIPER,brawlBall,Super Beach,86,66,152
4300,2023-01-28,PIPER,brawlBall,Sneaky Fields,3,0,3
4301,2023-01-28,PIPER,bounty,Canal Grande,95,51,146
4302,2023-01-27,PIPER,knockout,Flaring Phoenix,91,87,178
4303,2023-01-27,PIPER,hotZone,Controller Chaos,4,2,6
4304,2023-01-27,PIPER,heist,Hot Potato,12,4,16
4305,2023-01-27,PIPER,gemGrab,Undermine,11,9,20
4306,2023-01-27,PIPER,gemGrab,Deep Diner,68,59,127
4307,2023-01-27,PIPER,brawlBall,Sneaky Fields,14,11,25
4308,2023-01-27,PIPER,brawlBall,Pinhole Punt,6,8,14
4309,2023-01-27,PIPER,bounty,Temple Ruins,42,44,86
4310,2023-01-26,PIPER,knockout,Riverside,1503,1603,3106
4311,2023-01-26,PIPER,hotZone,Open Zone,77,47,124
4312,2023-01-26,PIPER,heist,Hot Potato,15,22,37
4313,2023-01-26,PIPER,gemGrab,Undermine,132,156,288
4314,2023-01-26,PIPER,gemGrab,Gem Fort,13,9,22
4315,2023-01-26,PIPER,brawlBall,Sunny Soccer,6,2,8
4316,2023-01-26,PIPER,brawlBall,Pinhole Punt,170,97,267
4317,2023-01-26,PIPER,bounty,Temple Ruins,133,120,253
4318,2023-01-25,PIPER,knockout,Riverside,789,837,1626
4319,2023-01-25,PIPER,hotZone,Open Zone,33,15,48
4320,2023-01-25,PIPER,heist,Safe Zone,175,153,328
4321,2023-01-25,PIPER,gemGrab,Gem Fort,29,17,46
4322,2023-01-25,PIPER,gemGrab,Crystal Arcade,75,76,151
4323,2023-01-25,PIPER,brawlBall,Sunny Soccer,27,20,47
4324,2023-01-25,PIPER,brawlBall,Beach Ball,12,6,18
4325,2023-01-25,PIPER,bounty,Excel,68,81,149
4326,2023-01-24,PIPER,knockout,New Perspective,268,254,522
4327,2023-01-24,PIPER,hotZone,Dueling Beetles,20,3,23
4328,2023-01-24,PIPER,heist,Safe Zone,313,237,550
4329,2023-01-24,PIPER,gemGrab,Minecart Madness,75,106,181
4330,2023-01-24,PIPER,gemGrab,Crystal Arcade,178,173,351
4331,2023-01-24,PIPER,brawlBall,Center Stage,3,7,10
4332,2023-01-24,PIPER,brawlBall,Beach Ball,68,47,115
4333,2023-01-24,PIPER,bounty,Excel,105,71,176
4334,2023-01-23,PIPER,knockout,New Perspective,392,330,722
4335,2023-01-23,PIPER,hotZone,Dueling Beetles,29,25,54
4336,2023-01-23,PIPER,heist,Snaked Assault,26,8,34
4337,2023-01-23,PIPER,gemGrab,Minecart Madness,317,371,688
4338,2023-01-23,PIPER,gemGrab,Double Swoosh,42,49,91
4339,2023-01-23,PIPER,brawlBall,Center Stage,90,53,143
4340,2023-01-23,PIPER,brawlBall,Backyard Bowl,69,71,140
4341,2023-01-23,PIPER,bounty,Layer Cake,205,201,406
4342,2023-01-22,PIPER,knockout,X Marks the Spot,264,224,488
4343,2023-01-22,PIPER,hotZone,Ring of Fire,22,4,26
4344,2023-01-22,PIPER,heist,Snaked Assault,5,4,9
4345,2023-01-22,PIPER,gemGrab,Hard Rock Mine,66,97,163
4346,2023-01-22,PIPER,gemGrab,Double Swoosh,37,29,66
4347,2023-01-22,PIPER,brawlBall,Super Beach,6,2,8
4348,2023-01-22,PIPER,brawlBall,Backyard Bowl,680,594,1274
4349,2023-01-22,PIPER,bounty,Layer Cake,125,143,268
4350,2023-01-21,PIPER,knockout,X Marks the Spot,832,834,1666
4351,2023-01-21,PIPER,hotZone,Ring of Fire,79,31,110
4352,2023-01-21,PIPER,heist,Tornado Ring,21,6,27
4353,2023-01-21,PIPER,gemGrab,Hard Rock Mine,365,368,733
4354,2023-01-21,PIPER,gemGrab,Deep Diner,42,14,56
4355,2023-01-21,PIPER,brawlBall,Super Beach,126,98,224
4356,2023-01-21,PIPER,brawlBall,Sneaky Fields,1,0,1
4357,2023-01-21,PIPER,bounty,Dry Season,706,723,1429
4358,2023-01-20,PIPER,knockout,Out in the Open,682,580,1262
4359,2023-01-20,PIPER,hotZone,Split,5,2,7
4360,2023-01-20,PIPER,heist,Tornado Ring,10,8,18
4361,2023-01-20,PIPER,gemGrab,Undermine,54,47,101
4362,2023-01-20,PIPER,gemGrab,Deep Diner,148,122,270
4363,2023-01-20,PIPER,brawlBall,Sneaky Fields,55,39,94
4364,2023-01-20,PIPER,brawlBall,Pinhole Punt,9,8,17
4365,2023-01-20,PIPER,bounty,Dry Season,581,498,1079
4366,2023-01-19,PIPER,knockout,Out in the Open,808,689,1497
4367,2023-01-19,PIPER,hotZone,Split,6,3,9
4368,2023-01-19,PIPER,heist,Kaboom Canyon,55,68,123
4369,2023-01-19,PIPER,gemGrab,Undermine,171,214,385
4370,2023-01-19,PIPER,gemGrab,Gem Fort,14,6,20
4371,2023-01-19,PIPER,brawlBall,Sunny Soccer,2,1,3
4372,2023-01-19,PIPER,brawlBall,Pinhole Punt,184,128,312
4373,2023-01-19,PIPER,bounty,Shooting Star,759,774,1533
4374,2023-01-18,PIPER,knockout,Goldarm Gulch,47,33,80
4375,2023-01-18,PIPER,hotZone,Parallel Plays,0,2,2
4376,2023-01-18,PIPER,heist,Kaboom Canyon,22,17,39
4377,2023-01-18,PIPER,gemGrab,Gem Fort,12,6,18
4378,2023-01-18,PIPER,gemGrab,Crystal Arcade,4,4,8
4379,2023-01-18,PIPER,brawlBall,Sunny Soccer,28,15,43
4380,2023-01-18,PIPER,bounty,Shooting Star,351,353,704
4381,2023-01-17,PIPER,knockout,Goldarm Gulch,69,54,123
4382,2023-01-17,PIPER,hotZone,Parallel Plays,2,0,2
4383,2023-01-17,PIPER,gemGrab,Minecart Madness,6,1,7
4384,2023-01-17,PIPER,gemGrab,Crystal Arcade,12,8,20
4385,2023-01-17,PIPER,brawlBall,Beach Ball,7,2,9
4386,2023-01-17,PIPER,bounty,Hideout,49,54,103
4387,2023-01-16,PIPER,knockout,Belle's Rock,50,61,111
4388,2023-01-16,PIPER,hotZone,Quarter Pounder,2,1,3
4389,2023-01-16,PIPER,heist,Pit Stop,1,0,1
4390,2023-01-16,PIPER,gemGrab,Minecart Madness,24,27,51
4391,2023-01-16,PIPER,gemGrab,Double Swoosh,2,0,2
4392,2023-01-16,PIPER,brawlBall,Center Stage,5,0,5
4393,2023-01-16,PIPER,brawlBall,Backyard Bowl,8,10,18
4394,2023-01-16,PIPER,bounty,Hideout,74,70,144
4395,2023-01-15,PIPER,knockout,Belle's Rock,58,100,158
4396,2023-01-15,PIPER,hotZone,Quarter Pounder,7,14,21
4397,2023-01-15,PIPER,heist,Bridge Too Far,103,97,200
4398,2023-01-15,PIPER,gemGrab,Hard Rock Mine,18,18,36
4399,2023-01-15,PIPER,gemGrab,Double Swoosh,10,2,12
4400,2023-01-15,PIPER,brawlBall,Super Beach,0,1,1
4401,2023-01-15,PIPER,brawlBall,Backyard Bowl,154,180,334
4402,2023-01-15,PIPER,bounty,Canal Grande,11,3,14
4403,2023-01-14,PIPER,knockout,Flaring Phoenix,22,5,27
4404,2023-01-14,PIPER,hotZone,Controller Chaos,1,1,2
4405,2023-01-14,PIPER,heist,Bridge Too Far,164,136,300
4406,2023-01-14,PIPER,gemGrab,Hard Rock Mine,16,23,39
4407,2023-01-14,PIPER,gemGrab,Deep Diner,7,11,18
4408,2023-01-14,PIPER,brawlBall,Super Beach,4,8,12
4409,2023-01-14,PIPER,bounty,Canal Grande,4,0,4
4410,2023-01-13,PIPER,knockout,Flaring Phoenix,13,3,16
4411,2023-01-13,PIPER,hotZone,Controller Chaos,1,6,7
4412,2023-01-13,PIPER,gemGrab,Deep Diner,18,13,31
4413,2023-01-13,PIPER,brawlBall,Sneaky Fields,8,2,10
4414,2023-01-13,PIPER,bounty,Temple Ruins,8,9,17
4415,2023-01-12,PIPER,knockout,Riverside,223,240,463
4416,2023-01-12,PIPER,hotZone,Open Zone,13,16,29
4417,2023-01-12,PIPER,gemGrab,Undermine,16,23,39
4418,2023-01-12,PIPER,brawlBall,Pinhole Punt,8,3,11
4419,2023-01-12,PIPER,bounty,Temple Ruins,1,0,1
4420,2023-01-11,PIPER,knockout,Riverside,68,73,141
4421,2023-01-11,PIPER,hotZone,Open Zone,0,1,1
4422,2023-01-11,PIPER,brawlBall,Sunny Soccer,1,0,1
4423,2023-01-11,PIPER,bounty,Excel,1,1,2
4424,2023-01-10,PIPER,knockout,New Perspective,19,10,29
4425,2023-01-10,PIPER,hotZone,Dueling Beetles,1,1,2
4426,2023-01-10,PIPER,heist,Safe Zone,32,38,70
4427,2023-01-10,PIPER,gemGrab,Minecart Madness,16,34,50
4428,2023-01-10,PIPER,gemGrab,Crystal Arcade,22,16,38
4429,2023-01-10,PIPER,brawlBall,Beach Ball,6,7,13
4430,2023-01-10,PIPER,bounty,Excel,4,0,4
4431,2023-01-09,PIPER,knockout,New Perspective,15,7,22
4432,2023-01-09,PIPER,hotZone,Dueling Beetles,1,1,2
4433,2023-01-09,PIPER,heist,Snaked Assault,2,1,3
4434,2023-01-09,PIPER,gemGrab,Minecart Madness,46,39,85
4435,2023-01-09,PIPER,gemGrab,Double Swoosh,4,1,5
4436,2023-01-09,PIPER,brawlBall,Center Stage,9,0,9
4437,2023-01-09,PIPER,brawlBall,Backyard Bowl,4,8,12
4438,2023-01-09,PIPER,bounty,Layer Cake,26,18,44
4439,2023-01-08,PIPER,knockout,X Marks the Spot,48,33,81
4440,2023-01-08,PIPER,hotZone,Ring of Fire,11,11,22
4441,2023-01-08,PIPER,heist,Snaked Assault,7,10,17
4442,2023-01-08,PIPER,gemGrab,Hard Rock Mine,9,20,29
4443,2023-01-08,PIPER,gemGrab,Double Swoosh,2,1,3
4444,2023-01-08,PIPER,brawlBall,Super Beach,0,1,1
4445,2023-01-08,PIPER,brawlBall,Backyard Bowl,116,104,220
4446,2023-01-08,PIPER,bounty,Layer Cake,10,5,15
4447,2023-01-07,PIPER,knockout,X Marks the Spot,54,56,110
4448,2023-01-07,PIPER,hotZone,Ring of Fire,4,1,5
4449,2023-01-07,PIPER,heist,Tornado Ring,0,1,1
4450,2023-01-07,PIPER,gemGrab,Hard Rock Mine,18,5,23
4451,2023-01-07,PIPER,gemGrab,Deep Diner,15,14,29
4452,2023-01-07,PIPER,brawlBall,Super Beach,5,0,5
4453,2023-01-07,PIPER,bounty,Dry Season,57,69,126
4454,2023-01-06,PIPER,knockout,Out in the Open,60,56,116
4455,2023-01-06,PIPER,hotZone,Split,4,0,4
4456,2023-01-06,PIPER,heist,Tornado Ring,3,0,3
4457,2023-01-06,PIPER,gemGrab,Undermine,13,15,28
4458,2023-01-06,PIPER,gemGrab,Deep Diner,27,17,44
4459,2023-01-06,PIPER,brawlBall,Sneaky Fields,7,1,8
4460,2023-01-06,PIPER,brawlBall,Pinhole Punt,4,7,11
4461,2023-01-06,PIPER,bounty,Dry Season,110,72,182
4462,2023-01-05,PIPER,knockout,Out in the Open,81,84,165
4463,2023-01-05,PIPER,heist,Kaboom Canyon,9,21,30
4464,2023-01-05,PIPER,gemGrab,Undermine,45,32,77
4465,2023-01-05,PIPER,brawlBall,Pinhole Punt,23,15,38
4466,2023-01-05,PIPER,bounty,Shooting Star,119,131,250
4467,2023-01-04,PIPER,knockout,Goldarm Gulch,14,5,19
4468,2023-01-04,PIPER,hotZone,Parallel Plays,1,1,2
4469,2023-01-04,PIPER,heist,Kaboom Canyon,35,30,65
4470,2023-01-04,PIPER,gemGrab,Gem Fort,1,0,1
4471,2023-01-04,PIPER,gemGrab,Crystal Arcade,6,2,8
4472,2023-01-04,PIPER,brawlBall,Sunny Soccer,2,2,4
4473,2023-01-04,PIPER,bounty,Shooting Star,326,294,620
4474,2023-01-03,PIPER,knockout,Goldarm Gulch,13,14,27
4475,2023-01-03,PIPER,hotZone,Parallel Plays,2,0,2
4476,2023-01-03,PIPER,heist,Kaboom Canyon,0,1,1
4477,2023-01-03,PIPER,gemGrab,Minecart Madness,5,11,16
4478,2023-01-03,PIPER,gemGrab,Crystal Arcade,22,18,40
4479,2023-01-03,PIPER,brawlBall,Center Stage,1,0,1
4480,2023-01-03,PIPER,brawlBall,Beach Ball,8,1,9
4481,2023-01-03,PIPER,bounty,Hideout,112,100,212
4482,2023-01-02,PIPER,knockout,Belle's Rock,49,84,133
4483,2023-01-02,PIPER,hotZone,Quarter Pounder,7,11,18
4484,2023-01-02,PIPER,heist,Pit Stop,2,0,2
4485,2023-01-02,PIPER,heist,Kaboom Canyon,1,0,1
4486,2023-01-02,PIPER,gemGrab,Minecart Madness,51,38,89
4487,2023-01-02,PIPER,gemGrab,Double Swoosh,2,1,3
4488,2023-01-02,PIPER,brawlBall,Center Stage,9,7,16
4489,2023-01-02,PIPER,brawlBall,Backyard Bowl,3,11,14
4490,2023-01-02,PIPER,bounty,Hideout,193,228,421
4491,2023-01-01,PIPER,knockout,Belle's Rock,44,66,110
4492,2023-01-01,PIPER,hotZone,Quarter Pounder,2,0,2
4493,2023-01-01,PIPER,heist,Bridge Too Far,20,10,30
4494,2023-01-01,PIPER,gemGrab,Hard Rock Mine,2,2,4
4495,2023-01-01,PIPER,gemGrab,Double Swoosh,2,0,2
4496,2023-01-01,PIPER,brawlBall,Backyard Bowl,66,45,111
4497,2023-01-01,PIPER,bounty,Canal Grande,1,0,1
4498,2022-12-31,PIPER,heist,Bridge Too Far,14,17,31
4499,2022-12-31,PIPER,gemGrab,Hard Rock Mine,3,1,4
4500,2022-12-31,PIPER,gemGrab,Deep Diner,4,1,5
4501,2022-12-31,PIPER,brawlBall,Super Beach,0,1,1
4502,2022-12-31,PIPER,bounty,Canal Grande,0,1,1
4503,2022-12-30,PIPER,knockout,Flaring Phoenix,3,4,7
4504,2022-12-30,PIPER,gemGrab,Deep Diner,2,1,3
4505,2022-12-30,PIPER,brawlBall,Sneaky Fields,1,0,1
4506,2022-12-29,PIPER,gemGrab,Undermine,1,1,2
4507,2022-12-29,PIPER,gemGrab,Minecart Madness,1,2,3
4508,2022-12-29,PIPER,gemGrab,Gem Fort,1,2,3
4509,2022-12-29,PIPER,brawlBall,Pinhole Punt,0,1,1
4510,2022-12-27,PIPER,knockout,New Perspective,1,1,2
4511,2022-12-27,PIPER,brawlBall,Beach Ball,0,1,1
4512,2022-12-26,PIPER,heist,Kaboom Canyon,0,2,2
4513,2022-12-26,PIPER,gemGrab,Minecart Madness,1,4,5
4514,2022-12-26,PIPER,brawlBall,Center Stage,1,2,3
4515,2022-12-25,PIPER,brawlBall,Backyard Bowl,3,12,15
4516,2022-12-25,PIPER,bounty,Layer Cake,0,1,1
4517,2022-12-24,PIPER,bounty,Dry Season,1,1,2
4518,2022-12-23,PIPER,knockout,Out in the Open,3,2,5
4519,2022-12-21,PIPER,bounty,Shooting Star,1,1,2
4520,2022-12-20,PIPER,brawlBall,Beach Ball,1,0,1
4521,2022-12-18,PIPER,heist,Bridge Too Far,1,1,2
4522,2022-12-17,PIPER,knockout,Flaring Phoenix,1,0,1
4523,2022-12-16,PIPER,bounty,Temple Ruins,1,0,1
4524,2022-12-13,PIPER,knockout,New Perspective,1,0,1
4525,2022-11-11,PIPER,knockout,New Perspective,1,0,1
4526,2022-11-01,PIPER,knockout,New Perspective,2,4,6
4527,2022-10-30,PIPER,knockout,Out in the Open,1,0,1
4528,2022-10-28,PIPER,knockout,Out in the Open,1,1,2
4529,2022-10-26,PIPER,bounty,Shooting Star,6,3,9
4530,2022-10-15,PIPER,gemGrab,Hard Rock Mine,1,2,3
4531,2022-10-10,PIPER,knockout,Belle's Rock,0,2,2
4532,2023-02-05,PENNY,knockout,X Marks the Spot,36,34,70
4533,2023-02-05,PENNY,knockout,Goldarm Gulch,17,18,35
4534,2023-02-05,PENNY,hotZone,Ring of Fire,234,322,556
4535,2023-02-05,PENNY,heist,Snaked Assault,82,49,131
4536,2023-02-05,PENNY,heist,Pit Stop,29,8,37
4537,2023-02-05,PENNY,gemGrab,Hard Rock Mine,58,74,132
4538,2023-02-05,PENNY,gemGrab,Double Swoosh,306,525,831
4539,2023-02-05,PENNY,brawlBall,Super Beach,6,16,22
4540,2023-02-05,PENNY,brawlBall,Sneaky Fields,12,11,23
4541,2023-02-05,PENNY,brawlBall,Backyard Bowl,275,474,749
4542,2023-02-05,PENNY,bounty,Layer Cake,188,224,412
4543,2023-02-04,PENNY,knockout,X Marks the Spot,14,13,27
4544,2023-02-04,PENNY,knockout,Goldarm Gulch,19,19,38
4545,2023-02-04,PENNY,hotZone,Ring of Fire,61,84,145
4546,2023-02-04,PENNY,heist,Tornado Ring,15,5,20
4547,2023-02-04,PENNY,heist,Pit Stop,18,11,29
4548,2023-02-04,PENNY,gemGrab,Hard Rock Mine,48,76,124
4549,2023-02-04,PENNY,gemGrab,Double Swoosh,29,75,104
4550,2023-02-04,PENNY,gemGrab,Deep Diner,13,17,30
4551,2023-02-04,PENNY,brawlBall,Super Beach,93,115,208
4552,2023-02-04,PENNY,brawlBall,Sneaky Fields,2,5,7
4553,2023-02-04,PENNY,bounty,Dry Season,33,39,72
4554,2023-02-03,PENNY,knockout,Out in the Open,86,69,155
4555,2023-02-03,PENNY,knockout,Goldarm Gulch,63,56,119
4556,2023-02-03,PENNY,hotZone,Split,50,47,97
4557,2023-02-03,PENNY,heist,Tornado Ring,64,48,112
4558,2023-02-03,PENNY,heist,Pit Stop,125,45,170
4559,2023-02-03,PENNY,gemGrab,Undermine,32,46,78
4560,2023-02-03,PENNY,gemGrab,Double Swoosh,227,467,694
4561,2023-02-03,PENNY,gemGrab,Deep Diner,314,466,780
4562,2023-02-03,PENNY,brawlBall,Sneaky Fields,234,250,484
4563,2023-02-03,PENNY,brawlBall,Pinhole Punt,22,34,56
4564,2023-02-03,PENNY,bounty,Dry Season,185,218,403
4565,2023-02-02,PENNY,knockout,Out in the Open,50,40,90
4566,2023-02-02,PENNY,hotZone,Split,20,16,36
4567,2023-02-02,PENNY,heist,Kaboom Canyon,20,12,32
4568,2023-02-02,PENNY,gemGrab,Undermine,41,46,87
4569,2023-02-02,PENNY,gemGrab,Gem Fort,8,12,20
4570,2023-02-02,PENNY,brawlBall,Sunny Soccer,13,18,31
4571,2023-02-02,PENNY,brawlBall,Pinhole Punt,63,70,133
4572,2023-02-02,PENNY,bounty,Shooting Star,8,2,10
4573,2023-02-01,PENNY,knockout,Goldarm Gulch,92,97,189
4574,2023-02-01,PENNY,hotZone,Parallel Plays,96,133,229
4575,2023-02-01,PENNY,heist,Kaboom Canyon,61,38,99
4576,2023-02-01,PENNY,gemGrab,Gem Fort,81,143,224
4577,2023-02-01,PENNY,gemGrab,Crystal Arcade,102,153,255
4578,2023-02-01,PENNY,brawlBall,Sunny Soccer,202,245,447
4579,2023-02-01,PENNY,brawlBall,Beach Ball,11,13,24
4580,2023-02-01,PENNY,bounty,Shooting Star,35,31,66
4581,2023-01-31,PENNY,knockout,Goldarm Gulch,58,58,116
4582,2023-01-31,PENNY,hotZone,Parallel Plays,62,58,120
4583,2023-01-31,PENNY,heist,Pit Stop,11,22,33
4584,2023-01-31,PENNY,gemGrab,Minecart Madness,17,14,31
4585,2023-01-31,PENNY,gemGrab,Crystal Arcade,91,129,220
4586,2023-01-31,PENNY,brawlBall,Center Stage,3,0,3
4587,2023-01-31,PENNY,brawlBall,Beach Ball,150,157,307
4588,2023-01-31,PENNY,bounty,Hideout,14,18,32
4589,2023-01-30,PENNY,knockout,Belle's Rock,84,99,183
4590,2023-01-30,PENNY,hotZone,Quarter Pounder,221,177,398
4591,2023-01-30,PENNY,heist,Pit Stop,47,19,66
4592,2023-01-30,PENNY,gemGrab,Minecart Madness,143,122,265
4593,2023-01-30,PENNY,gemGrab,Double Swoosh,85,149,234
4594,2023-01-30,PENNY,brawlBall,Center Stage,151,145,296
4595,2023-01-30,PENNY,brawlBall,Backyard Bowl,24,35,59
4596,2023-01-30,PENNY,bounty,Hideout,31,41,72
4597,2023-01-29,PENNY,knockout,Belle's Rock,126,117,243
4598,2023-01-29,PENNY,hotZone,Quarter Pounder,158,176,334
4599,2023-01-29,PENNY,heist,Bridge Too Far,45,24,69
4600,2023-01-29,PENNY,gemGrab,Hard Rock Mine,40,43,83
4601,2023-01-29,PENNY,gemGrab,Double Swoosh,187,295,482
4602,2023-01-29,PENNY,brawlBall,Super Beach,13,17,30
4603,2023-01-29,PENNY,brawlBall,Backyard Bowl,301,514,815
4604,2023-01-29,PENNY,bounty,Canal Grande,98,137,235
4605,2023-01-28,PENNY,knockout,Flaring Phoenix,95,85,180
4606,2023-01-28,PENNY,hotZone,Controller Chaos,132,134,266
4607,2023-01-28,PENNY,heist,Bridge Too Far,91,46,137
4608,2023-01-28,PENNY,gemGrab,Hard Rock Mine,188,188,376
4609,2023-01-28,PENNY,gemGrab,Deep Diner,100,122,222
4610,2023-01-28,PENNY,brawlBall,Super Beach,378,421,799
4611,2023-01-28,PENNY,brawlBall,Sneaky Fields,12,6,18
4612,2023-01-28,PENNY,bounty,Canal Grande,215,286,501
4613,2023-01-27,PENNY,knockout,Flaring Phoenix,38,52,90
4614,2023-01-27,PENNY,hotZone,Controller Chaos,31,18,49
4615,2023-01-27,PENNY,heist,Hot Potato,28,25,53
4616,2023-01-27,PENNY,gemGrab,Undermine,14,18,32
4617,2023-01-27,PENNY,gemGrab,Deep Diner,133,193,326
4618,2023-01-27,PENNY,brawlBall,Sneaky Fields,59,71,130
4619,2023-01-27,PENNY,brawlBall,Pinhole Punt,1,2,3
4620,2023-01-27,PENNY,bounty,Temple Ruins,6,3,9
4621,2023-01-26,PENNY,knockout,Riverside,32,38,70
4622,2023-01-26,PENNY,hotZone,Open Zone,113,133,246
4623,2023-01-26,PENNY,heist,Hot Potato,62,29,91
4624,2023-01-26,PENNY,gemGrab,Undermine,94,79,173
4625,2023-01-26,PENNY,gemGrab,Gem Fort,25,20,45
4626,2023-01-26,PENNY,brawlBall,Sunny Soccer,13,21,34
4627,2023-01-26,PENNY,brawlBall,Pinhole Punt,282,339,621
4628,2023-01-26,PENNY,bounty,Temple Ruins,47,77,124
4629,2023-01-25,PENNY,knockout,Riverside,19,20,39
4630,2023-01-25,PENNY,hotZone,Open Zone,52,66,118
4631,2023-01-25,PENNY,heist,Safe Zone,140,95,235
4632,2023-01-25,PENNY,gemGrab,Gem Fort,35,30,65
4633,2023-01-25,PENNY,gemGrab,Crystal Arcade,96,144,240
4634,2023-01-25,PENNY,brawlBall,Sunny Soccer,180,207,387
4635,2023-01-25,PENNY,brawlBall,Beach Ball,39,51,90
4636,2023-01-25,PENNY,bounty,Excel,53,62,115
4637,2023-01-24,PENNY,knockout,New Perspective,31,30,61
4638,2023-01-24,PENNY,hotZone,Dueling Beetles,385,417,802
4639,2023-01-24,PENNY,heist,Safe Zone,173,157,330
4640,2023-01-24,PENNY,gemGrab,Minecart Madness,41,49,90
4641,2023-01-24,PENNY,gemGrab,Crystal Arcade,165,204,369
4642,2023-01-24,PENNY,brawlBall,Center Stage,22,27,49
4643,2023-01-24,PENNY,brawlBall,Beach Ball,285,375,660
4644,2023-01-24,PENNY,bounty,Excel,114,205,319
4645,2023-01-23,PENNY,knockout,New Perspective,72,52,124
4646,2023-01-23,PENNY,hotZone,Dueling Beetles,640,860,1500
4647,2023-01-23,PENNY,heist,Snaked Assault,71,24,95
4648,2023-01-23,PENNY,gemGrab,Minecart Madness,247,250,497
4649,2023-01-23,PENNY,gemGrab,Double Swoosh,84,149,233
4650,2023-01-23,PENNY,brawlBall,Center Stage,225,267,492
4651,2023-01-23,PENNY,brawlBall,Backyard Bowl,17,25,42
4652,2023-01-23,PENNY,bounty,Layer Cake,202,303,505
4653,2023-01-22,PENNY,knockout,X Marks the Spot,37,28,65
4654,2023-01-22,PENNY,hotZone,Ring of Fire,155,169,324
4655,2023-01-22,PENNY,heist,Snaked Assault,46,18,64
4656,2023-01-22,PENNY,gemGrab,Hard Rock Mine,42,31,73
4657,2023-01-22,PENNY,gemGrab,Double Swoosh,112,174,286
4658,2023-01-22,PENNY,brawlBall,Super Beach,35,41,76
4659,2023-01-22,PENNY,brawlBall,Backyard Bowl,140,197,337
4660,2023-01-22,PENNY,bounty,Layer Cake,133,172,305
4661,2023-01-21,PENNY,knockout,X Marks the Spot,86,101,187
4662,2023-01-21,PENNY,hotZone,Ring of Fire,447,562,1009
4663,2023-01-21,PENNY,heist,Tornado Ring,59,27,86
4664,2023-01-21,PENNY,gemGrab,Hard Rock Mine,241,340,581
4665,2023-01-21,PENNY,gemGrab,Deep Diner,61,81,142
4666,2023-01-21,PENNY,brawlBall,Super Beach,415,551,966
4667,2023-01-21,PENNY,brawlBall,Sneaky Fields,18,11,29
4668,2023-01-21,PENNY,bounty,Dry Season,135,177,312
4669,2023-01-20,PENNY,knockout,Out in the Open,94,95,189
4670,2023-01-20,PENNY,hotZone,Split,61,54,115
4671,2023-01-20,PENNY,heist,Tornado Ring,45,23,68
4672,2023-01-20,PENNY,gemGrab,Undermine,58,64,122
4673,2023-01-20,PENNY,gemGrab,Deep Diner,306,393,699
4674,2023-01-20,PENNY,brawlBall,Sneaky Fields,167,222,389
4675,2023-01-20,PENNY,brawlBall,Pinhole Punt,8,10,18
4676,2023-01-20,PENNY,bounty,Dry Season,111,159,270
4677,2023-01-19,PENNY,knockout,Out in the Open,137,162,299
4678,2023-01-19,PENNY,hotZone,Split,74,43,117
4679,2023-01-19,PENNY,heist,Kaboom Canyon,67,42,109
4680,2023-01-19,PENNY,gemGrab,Undermine,160,222,382
4681,2023-01-19,PENNY,gemGrab,Gem Fort,17,31,48
4682,2023-01-19,PENNY,brawlBall,Sunny Soccer,7,7,14
4683,2023-01-19,PENNY,brawlBall,Pinhole Punt,225,272,497
4684,2023-01-19,PENNY,bounty,Shooting Star,59,25,84
4685,2023-01-18,PENNY,knockout,Goldarm Gulch,7,7,14
4686,2023-01-18,PENNY,hotZone,Parallel Plays,14,14,28
4687,2023-01-18,PENNY,heist,Kaboom Canyon,20,19,39
4688,2023-01-18,PENNY,gemGrab,Gem Fort,27,32,59
4689,2023-01-18,PENNY,gemGrab,Crystal Arcade,15,22,37
4690,2023-01-18,PENNY,brawlBall,Sunny Soccer,72,92,164
4691,2023-01-18,PENNY,brawlBall,Beach Ball,2,1,3
4692,2023-01-18,PENNY,bounty,Shooting Star,10,16,26
4693,2023-01-17,PENNY,knockout,Goldarm Gulch,9,11,20
4694,2023-01-17,PENNY,hotZone,Parallel Plays,11,25,36
4695,2023-01-17,PENNY,heist,Pit Stop,7,3,10
4696,2023-01-17,PENNY,gemGrab,Minecart Madness,1,5,6
4697,2023-01-17,PENNY,gemGrab,Crystal Arcade,17,13,30
4698,2023-01-17,PENNY,brawlBall,Center Stage,0,2,2
4699,2023-01-17,PENNY,brawlBall,Beach Ball,20,24,44
4700,2023-01-17,PENNY,bounty,Hideout,2,6,8
4701,2023-01-16,PENNY,knockout,Belle's Rock,18,30,48
4702,2023-01-16,PENNY,hotZone,Quarter Pounder,16,37,53
4703,2023-01-16,PENNY,heist,Pit Stop,11,5,16
4704,2023-01-16,PENNY,gemGrab,Minecart Madness,7,16,23
4705,2023-01-16,PENNY,gemGrab,Double Swoosh,3,3,6
4706,2023-01-16,PENNY,brawlBall,Center Stage,8,5,13
4707,2023-01-16,PENNY,brawlBall,Backyard Bowl,3,30,33
4708,2023-01-16,PENNY,bounty,Hideout,4,1,5
4709,2023-01-15,PENNY,knockout,Belle's Rock,17,7,24
4710,2023-01-15,PENNY,hotZone,Quarter Pounder,35,68,103
4711,2023-01-15,PENNY,heist,Bridge Too Far,11,17,28
4712,2023-01-15,PENNY,gemGrab,Hard Rock Mine,10,7,17
4713,2023-01-15,PENNY,gemGrab,Double Swoosh,29,58,87
4714,2023-01-15,PENNY,brawlBall,Super Beach,4,3,7
4715,2023-01-15,PENNY,brawlBall,Backyard Bowl,39,97,136
4716,2023-01-15,PENNY,bounty,Canal Grande,12,30,42
4717,2023-01-14,PENNY,knockout,Flaring Phoenix,3,2,5
4718,2023-01-14,PENNY,hotZone,Controller Chaos,35,37,72
4719,2023-01-14,PENNY,heist,Bridge Too Far,10,18,28
4720,2023-01-14,PENNY,gemGrab,Hard Rock Mine,13,14,27
4721,2023-01-14,PENNY,gemGrab,Deep Diner,14,3,17
4722,2023-01-14,PENNY,brawlBall,Super Beach,15,43,58
4723,2023-01-14,PENNY,brawlBall,Sneaky Fields,1,6,7
4724,2023-01-14,PENNY,bounty,Canal Grande,15,22,37
4725,2023-01-13,PENNY,knockout,Flaring Phoenix,5,16,21
4726,2023-01-13,PENNY,hotZone,Controller Chaos,33,69,102
4727,2023-01-13,PENNY,heist,Hot Potato,1,0,1
4728,2023-01-13,PENNY,gemGrab,Deep Diner,28,31,59
4729,2023-01-13,PENNY,brawlBall,Sneaky Fields,11,10,21
4730,2023-01-13,PENNY,bounty,Temple Ruins,3,0,3
4731,2023-01-12,PENNY,knockout,Riverside,5,1,6
4732,2023-01-12,PENNY,hotZone,Open Zone,14,26,40
4733,2023-01-12,PENNY,heist,Hot Potato,1,0,1
4734,2023-01-12,PENNY,gemGrab,Undermine,10,9,19
4735,2023-01-12,PENNY,gemGrab,Gem Fort,1,1,2
4736,2023-01-12,PENNY,brawlBall,Sunny Soccer,2,1,3
4737,2023-01-12,PENNY,brawlBall,Pinhole Punt,8,9,17
4738,2023-01-11,PENNY,knockout,Riverside,1,0,1
4739,2023-01-11,PENNY,hotZone,Open Zone,2,0,2
4740,2023-01-11,PENNY,heist,Safe Zone,0,1,1
4741,2023-01-11,PENNY,gemGrab,Gem Fort,2,3,5
4742,2023-01-11,PENNY,brawlBall,Sunny Soccer,8,11,19
4743,2023-01-11,PENNY,brawlBall,Beach Ball,1,0,1
4744,2023-01-11,PENNY,bounty,Excel,6,0,6
4745,2023-01-10,PENNY,knockout,New Perspective,2,1,3
4746,2023-01-10,PENNY,hotZone,Dueling Beetles,63,84,147
4747,2023-01-10,PENNY,heist,Safe Zone,10,3,13
4748,2023-01-10,PENNY,gemGrab,Minecart Madness,10,2,12
4749,2023-01-10,PENNY,gemGrab,Crystal Arcade,34,53,87
4750,2023-01-10,PENNY,brawlBall,Beach Ball,20,42,62
4751,2023-01-10,PENNY,bounty,Excel,2,6,8
4752,2023-01-09,PENNY,knockout,New Perspective,2,1,3
4753,2023-01-09,PENNY,hotZone,Dueling Beetles,44,62,106
4754,2023-01-09,PENNY,heist,Snaked Assault,12,2,14
4755,2023-01-09,PENNY,gemGrab,Minecart Madness,17,11,28
4756,2023-01-09,PENNY,gemGrab,Double Swoosh,15,6,21
4757,2023-01-09,PENNY,brawlBall,Center Stage,4,5,9
4758,2023-01-09,PENNY,brawlBall,Backyard Bowl,2,0,2
4759,2023-01-09,PENNY,bounty,Layer Cake,25,30,55
4760,2023-01-08,PENNY,knockout,X Marks the Spot,4,2,6
4761,2023-01-08,PENNY,hotZone,Ring of Fire,25,48,73
4762,2023-01-08,PENNY,heist,Snaked Assault,6,2,8
4763,2023-01-08,PENNY,gemGrab,Hard Rock Mine,11,13,24
4764,2023-01-08,PENNY,gemGrab,Double Swoosh,3,8,11
4765,2023-01-08,PENNY,brawlBall,Super Beach,4,8,12
4766,2023-01-08,PENNY,brawlBall,Backyard Bowl,14,28,42
4767,2023-01-08,PENNY,bounty,Layer Cake,5,5,10
4768,2023-01-07,PENNY,knockout,X Marks the Spot,3,1,4
4769,2023-01-07,PENNY,hotZone,Ring of Fire,14,40,54
4770,2023-01-07,PENNY,heist,Tornado Ring,5,2,7
4771,2023-01-07,PENNY,gemGrab,Hard Rock Mine,6,18,24
4772,2023-01-07,PENNY,gemGrab,Deep Diner,8,2,10
4773,2023-01-07,PENNY,brawlBall,Super Beach,12,20,32
4774,2023-01-07,PENNY,brawlBall,Sneaky Fields,0,1,1
4775,2023-01-07,PENNY,bounty,Dry Season,10,14,24
4776,2023-01-06,PENNY,knockout,Out in the Open,12,13,25
4777,2023-01-06,PENNY,hotZone,Split,3,1,4
4778,2023-01-06,PENNY,heist,Tornado Ring,6,2,8
4779,2023-01-06,PENNY,gemGrab,Undermine,3,0,3
4780,2023-01-06,PENNY,gemGrab,Deep Diner,49,49,98
4781,2023-01-06,PENNY,brawlBall,Sneaky Fields,7,19,26
4782,2023-01-06,PENNY,bounty,Dry Season,21,20,41
4783,2023-01-05,PENNY,knockout,Out in the Open,15,21,36
4784,2023-01-05,PENNY,hotZone,Split,12,10,22
4785,2023-01-05,PENNY,heist,Kaboom Canyon,11,14,25
4786,2023-01-05,PENNY,gemGrab,Undermine,13,47,60
4787,2023-01-05,PENNY,gemGrab,Gem Fort,0,2,2
4788,2023-01-05,PENNY,brawlBall,Sunny Soccer,1,0,1
4789,2023-01-05,PENNY,brawlBall,Pinhole Punt,24,35,59
4790,2023-01-05,PENNY,bounty,Shooting Star,7,0,7
4791,2023-01-04,PENNY,knockout,Goldarm Gulch,3,15,18
4792,2023-01-04,PENNY,hotZone,Parallel Plays,7,6,13
4793,2023-01-04,PENNY,heist,Kaboom Canyon,14,2,16
4794,2023-01-04,PENNY,gemGrab,Gem Fort,21,32,53
4795,2023-01-04,PENNY,gemGrab,Crystal Arcade,6,4,10
4796,2023-01-04,PENNY,brawlBall,Sunny Soccer,29,36,65
4797,2023-01-04,PENNY,bounty,Shooting Star,14,2,16
4798,2023-01-03,PENNY,knockout,Goldarm Gulch,4,5,9
4799,2023-01-03,PENNY,hotZone,Parallel Plays,6,11,17
4800,2023-01-03,PENNY,hotZone,Controller Chaos,1,1,2
4801,2023-01-03,PENNY,heist,Pit Stop,5,0,5
4802,2023-01-03,PENNY,gemGrab,Minecart Madness,10,18,28
4803,2023-01-03,PENNY,gemGrab,Crystal Arcade,23,23,46
4804,2023-01-03,PENNY,brawlBall,Center Stage,1,0,1
4805,2023-01-03,PENNY,brawlBall,Beach Ball,11,35,46
4806,2023-01-03,PENNY,bounty,Hideout,11,2,13
4807,2023-01-02,PENNY,knockout,Belle's Rock,6,3,9
4808,2023-01-02,PENNY,hotZone,Quarter Pounder,21,23,44
4809,2023-01-02,PENNY,heist,Pit Stop,3,3,6
4810,2023-01-02,PENNY,heist,Kaboom Canyon,0,1,1
4811,2023-01-02,PENNY,gemGrab,Minecart Madness,27,42,69
4812,2023-01-02,PENNY,gemGrab,Double Swoosh,25,36,61
4813,2023-01-02,PENNY,brawlBall,Center Stage,12,5,17
4814,2023-01-02,PENNY,brawlBall,Backyard Bowl,3,7,10
4815,2023-01-02,PENNY,bounty,Hideout,17,7,24
4816,2023-01-01,PENNY,knockout,Belle's Rock,2,2,4
4817,2023-01-01,PENNY,hotZone,Quarter Pounder,5,9,14
4818,2023-01-01,PENNY,heist,Kaboom Canyon,1,0,1
4819,2023-01-01,PENNY,heist,Bridge Too Far,1,0,1
4820,2023-01-01,PENNY,gemGrab,Minecart Madness,1,1,2
4821,2023-01-01,PENNY,gemGrab,Double Swoosh,15,38,53
4822,2023-01-01,PENNY,brawlBall,Backyard Bowl,11,5,16
4823,2023-01-01,PENNY,bounty,Canal Grande,0,1,1
4824,2022-12-31,PENNY,hotZone,Controller Chaos,0,1,1
4825,2022-12-31,PENNY,heist,Bridge Too Far,1,1,2
4826,2022-12-31,PENNY,gemGrab,Minecart Madness,1,2,3
4827,2022-12-31,PENNY,gemGrab,Hard Rock Mine,6,5,11
4828,2022-12-31,PENNY,gemGrab,Deep Diner,6,20,26
4829,2022-12-31,PENNY,brawlBall,Super Beach,4,7,11
4830,2022-12-31,PENNY,bounty,Canal Grande,1,2,3
4831,2022-12-30,PENNY,heist,Hot Potato,1,0,1
4832,2022-12-30,PENNY,gemGrab,Minecart Madness,0,1,1
4833,2022-12-30,PENNY,gemGrab,Deep Diner,10,16,26
4834,2022-12-30,PENNY,brawlBall,Sneaky Fields,1,0,1
4835,2022-12-29,PENNY,hotZone,Controller Chaos,1,0,1
4836,2022-12-29,PENNY,heist,Kaboom Canyon,0,1,1
4837,2022-12-29,PENNY,gemGrab,Undermine,1,0,1
4838,2022-12-29,PENNY,brawlBall,Pinhole Punt,3,0,3
4839,2022-12-27,PENNY,hotZone,Dueling Beetles,2,1,3
4840,2022-12-27,PENNY,heist,Kaboom Canyon,0,1,1
4841,2022-12-27,PENNY,gemGrab,Minecart Madness,1,0,1
4842,2022-12-27,PENNY,bounty,Excel,1,0,1
4843,2022-12-26,PENNY,brawlBall,Center Stage,2,1,3
4844,2022-12-25,PENNY,gemGrab,Double Swoosh,2,4,6
4845,2022-12-24,PENNY,bounty,Dry Season,1,1,2
4846,2022-12-23,PENNY,knockout,Out in the Open,2,0,2
4847,2022-12-22,PENNY,gemGrab,Gem Fort,1,0,1
4848,2022-12-20,PENNY,brawlBall,Beach Ball,1,1,2
4849,2022-12-18,PENNY,heist,Bridge Too Far,1,0,1
4850,2022-12-17,PENNY,brawlBall,Super Beach,0,1,1
4851,2022-12-16,PENNY,gemGrab,Undermine,0,1,1
4852,2022-12-16,PENNY,brawlBall,Sneaky Fields,1,0,1
4853,2022-12-16,PENNY,bounty,Temple Ruins,1,4,5
4854,2022-12-13,PENNY,heist,Safe Zone,1,1,2
4855,2022-12-13,PENNY,gemGrab,Crystal Arcade,0,2,2
4856,2022-10-30,PENNY,hotZone,Dueling Beetles,0,2,2
4857,2022-10-28,PENNY,hotZone,Dueling Beetles,1,0,1
4858,2022-10-26,PENNY,bounty,Shooting Star,0,1,1
4859,2022-10-15,PENNY,hotZone,Ring of Fire,2,2,4
4860,2022-10-15,PENNY,gemGrab,Hard Rock Mine,1,0,1
4861,2022-10-15,PENNY,bounty,Dry Season,1,0,1
4862,2022-10-10,PENNY,knockout,Belle's Rock,1,0,1
4863,2023-02-05,PAM,knockout,X Marks the Spot,8,1,9
4864,2023-02-05,PAM,knockout,Goldarm Gulch,0,1,1
4865,2023-02-05,PAM,hotZone,Ring of Fire,65,98,163
4866,2023-02-05,PAM,heist,Snaked Assault,8,3,11
4867,2023-02-05,PAM,heist,Pit Stop,0,1,1
4868,2023-02-05,PAM,gemGrab,Hard Rock Mine,15,10,25
4869,2023-02-05,PAM,gemGrab,Double Swoosh,148,216,364
4870,2023-02-05,PAM,brawlBall,Super Beach,5,6,11
4871,2023-02-05,PAM,brawlBall,Sneaky Fields,8,7,15
4872,2023-02-05,PAM,brawlBall,Backyard Bowl,209,367,576
4873,2023-02-05,PAM,bounty,Layer Cake,2,4,6
4874,2023-02-04,PAM,knockout,X Marks the Spot,3,3,6
4875,2023-02-04,PAM,knockout,Goldarm Gulch,3,1,4
4876,2023-02-04,PAM,hotZone,Ring of Fire,27,14,41
4877,2023-02-04,PAM,heist,Tornado Ring,5,4,9
4878,2023-02-04,PAM,heist,Pit Stop,0,1,1
4879,2023-02-04,PAM,gemGrab,Hard Rock Mine,18,25,43
4880,2023-02-04,PAM,gemGrab,Double Swoosh,19,32,51
4881,2023-02-04,PAM,gemGrab,Deep Diner,1,1,2
4882,2023-02-04,PAM,brawlBall,Super Beach,34,47,81
4883,2023-02-04,PAM,brawlBall,Sneaky Fields,7,7,14
4884,2023-02-04,PAM,bounty,Dry Season,2,2,4
4885,2023-02-03,PAM,knockout,Out in the Open,19,11,30
4886,2023-02-03,PAM,knockout,Goldarm Gulch,4,0,4
4887,2023-02-03,PAM,hotZone,Split,25,16,41
4888,2023-02-03,PAM,heist,Tornado Ring,16,12,28
4889,2023-02-03,PAM,heist,Pit Stop,4,6,10
4890,2023-02-03,PAM,gemGrab,Undermine,33,67,100
4891,2023-02-03,PAM,gemGrab,Double Swoosh,98,144,242
4892,2023-02-03,PAM,gemGrab,Deep Diner,69,76,145
4893,2023-02-03,PAM,brawlBall,Sneaky Fields,105,143,248
4894,2023-02-03,PAM,brawlBall,Pinhole Punt,10,8,18
4895,2023-02-03,PAM,bounty,Dry Season,16,10,26
4896,2023-02-02,PAM,knockout,Out in the Open,9,27,36
4897,2023-02-02,PAM,hotZone,Split,14,15,29
4898,2023-02-02,PAM,heist,Kaboom Canyon,13,10,23
4899,2023-02-02,PAM,gemGrab,Undermine,25,48,73
4900,2023-02-02,PAM,gemGrab,Gem Fort,9,11,20
4901,2023-02-02,PAM,brawlBall,Sunny Soccer,6,0,6
4902,2023-02-02,PAM,brawlBall,Pinhole Punt,69,97,166
4903,2023-02-02,PAM,bounty,Shooting Star,2,4,6
4904,2023-02-01,PAM,knockout,Goldarm Gulch,24,10,34
4905,2023-02-01,PAM,hotZone,Parallel Plays,110,179,289
4906,2023-02-01,PAM,heist,Kaboom Canyon,12,5,17
4907,2023-02-01,PAM,gemGrab,Gem Fort,91,137,228
4908,2023-02-01,PAM,gemGrab,Crystal Arcade,29,36,65
4909,2023-02-01,PAM,brawlBall,Sunny Soccer,83,76,159
4910,2023-02-01,PAM,brawlBall,Beach Ball,3,9,12
4911,2023-02-01,PAM,bounty,Shooting Star,6,6,12
4912,2023-01-31,PAM,knockout,Goldarm Gulch,8,6,14
4913,2023-01-31,PAM,hotZone,Parallel Plays,61,52,113
4914,2023-01-31,PAM,heist,Pit Stop,9,6,15
4915,2023-01-31,PAM,gemGrab,Minecart Madness,12,11,23
4916,2023-01-31,PAM,gemGrab,Crystal Arcade,36,31,67
4917,2023-01-31,PAM,brawlBall,Center Stage,2,2,4
4918,2023-01-31,PAM,brawlBall,Beach Ball,41,54,95
4919,2023-01-31,PAM,bounty,Hideout,5,1,6
4920,2023-01-30,PAM,knockout,Belle's Rock,9,7,16
4921,2023-01-30,PAM,hotZone,Quarter Pounder,94,114,208
4922,2023-01-30,PAM,heist,Pit Stop,5,6,11
4923,2023-01-30,PAM,gemGrab,Minecart Madness,50,44,94
4924,2023-01-30,PAM,gemGrab,Double Swoosh,51,75,126
4925,2023-01-30,PAM,brawlBall,Center Stage,64,103,167
4926,2023-01-30,PAM,brawlBall,Backyard Bowl,34,45,79
4927,2023-01-30,PAM,bounty,Hideout,3,2,5
4928,2023-01-29,PAM,knockout,Belle's Rock,7,5,12
4929,2023-01-29,PAM,hotZone,Quarter Pounder,40,55,95
4930,2023-01-29,PAM,heist,Bridge Too Far,22,23,45
4931,2023-01-29,PAM,gemGrab,Hard Rock Mine,11,22,33
4932,2023-01-29,PAM,gemGrab,Double Swoosh,90,115,205
4933,2023-01-29,PAM,brawlBall,Super Beach,3,3,6
4934,2023-01-29,PAM,brawlBall,Backyard Bowl,282,389,671
4935,2023-01-29,PAM,bounty,Canal Grande,6,3,9
4936,2023-01-28,PAM,knockout,Flaring Phoenix,18,8,26
4937,2023-01-28,PAM,hotZone,Controller Chaos,81,72,153
4938,2023-01-28,PAM,heist,Bridge Too Far,32,27,59
4939,2023-01-28,PAM,gemGrab,Hard Rock Mine,65,91,156
4940,2023-01-28,PAM,gemGrab,Deep Diner,22,18,40
4941,2023-01-28,PAM,brawlBall,Super Beach,92,99,191
4942,2023-01-28,PAM,brawlBall,Sneaky Fields,4,3,7
4943,2023-01-28,PAM,bounty,Canal Grande,13,20,33
4944,2023-01-27,PAM,knockout,Flaring Phoenix,4,4,8
4945,2023-01-27,PAM,hotZone,Controller Chaos,36,40,76
4946,2023-01-27,PAM,heist,Hot Potato,4,4,8
4947,2023-01-27,PAM,gemGrab,Undermine,2,11,13
4948,2023-01-27,PAM,gemGrab,Deep Diner,33,32,65
4949,2023-01-27,PAM,brawlBall,Sneaky Fields,37,61,98
4950,2023-01-27,PAM,brawlBall,Pinhole Punt,3,2,5
4951,2023-01-27,PAM,bounty,Temple Ruins,4,3,7
4952,2023-01-26,PAM,knockout,Riverside,12,17,29
4953,2023-01-26,PAM,hotZone,Open Zone,137,208,345
4954,2023-01-26,PAM,heist,Hot Potato,19,15,34
4955,2023-01-26,PAM,gemGrab,Undermine,76,146,222
4956,2023-01-26,PAM,gemGrab,Gem Fort,37,54,91
4957,2023-01-26,PAM,brawlBall,Sunny Soccer,5,1,6
4958,2023-01-26,PAM,brawlBall,Pinhole Punt,193,255,448
4959,2023-01-26,PAM,bounty,Temple Ruins,17,14,31
4960,2023-01-25,PAM,knockout,Riverside,6,2,8
4961,2023-01-25,PAM,hotZone,Open Zone,73,115,188
4962,2023-01-25,PAM,heist,Safe Zone,5,3,8
4963,2023-01-25,PAM,gemGrab,Gem Fort,29,28,57
4964,2023-01-25,PAM,gemGrab,Crystal Arcade,34,33,67
4965,2023-01-25,PAM,brawlBall,Sunny Soccer,67,56,123
4966,2023-01-25,PAM,brawlBall,Beach Ball,7,7,14
4967,2023-01-25,PAM,bounty,Excel,3,2,5
4968,2023-01-24,PAM,knockout,New Perspective,15,22,37
4969,2023-01-24,PAM,hotZone,Dueling Beetles,66,79,145
4970,2023-01-24,PAM,heist,Safe Zone,15,25,40
4971,2023-01-24,PAM,gemGrab,Minecart Madness,13,12,25
4972,2023-01-24,PAM,gemGrab,Crystal Arcade,54,68,122
4973,2023-01-24,PAM,brawlBall,Center Stage,13,27,40
4974,2023-01-24,PAM,brawlBall,Beach Ball,120,161,281
4975,2023-01-24,PAM,bounty,Excel,5,18,23
4976,2023-01-23,PAM,knockout,New Perspective,13,8,21
4977,2023-01-23,PAM,hotZone,Dueling Beetles,77,66,143
4978,2023-01-23,PAM,heist,Snaked Assault,13,5,18
4979,2023-01-23,PAM,gemGrab,Minecart Madness,55,79,134
4980,2023-01-23,PAM,gemGrab,Double Swoosh,43,40,83
4981,2023-01-23,PAM,brawlBall,Center Stage,123,128,251
4982,2023-01-23,PAM,brawlBall,Backyard Bowl,18,38,56
4983,2023-01-23,PAM,bounty,Layer Cake,3,3,6
4984,2023-01-22,PAM,knockout,X Marks the Spot,6,11,17
4985,2023-01-22,PAM,hotZone,Ring of Fire,27,38,65
4986,2023-01-22,PAM,heist,Snaked Assault,8,10,18
4987,2023-01-22,PAM,gemGrab,Hard Rock Mine,6,12,18
4988,2023-01-22,PAM,gemGrab,Double Swoosh,58,68,126
4989,2023-01-22,PAM,brawlBall,Super Beach,3,5,8
4990,2023-01-22,PAM,brawlBall,Backyard Bowl,146,256,402
4991,2023-01-22,PAM,bounty,Layer Cake,3,1,4
4992,2023-01-21,PAM,knockout,X Marks the Spot,25,25,50
4993,2023-01-21,PAM,hotZone,Ring of Fire,118,128,246
4994,2023-01-21,PAM,heist,Tornado Ring,22,20,42
4995,2023-01-21,PAM,gemGrab,Hard Rock Mine,66,84,150
4996,2023-01-21,PAM,gemGrab,Deep Diner,21,30,51
4997,2023-01-21,PAM,brawlBall,Super Beach,102,101,203
4998,2023-01-21,PAM,brawlBall,Sneaky Fields,7,9,16
4999,2023-01-21,PAM,bounty,Dry Season,13,8,21
5000,2023-01-20,PAM,knockout,Out in the Open,31,19,50
5001,2023-01-20,PAM,hotZone,Split,26,18,44
5002,2023-01-20,PAM,heist,Tornado Ring,20,5,25
5003,2023-01-20,PAM,gemGrab,Undermine,52,110,162
5004,2023-01-20,PAM,gemGrab,Deep Diner,76,81,157
5005,2023-01-20,PAM,brawlBall,Sneaky Fields,97,114,211
5006,2023-01-20,PAM,brawlBall,Pinhole Punt,11,22,33
5007,2023-01-20,PAM,bounty,Dry Season,10,8,18
5008,2023-01-19,PAM,knockout,Out in the Open,30,23,53
5009,2023-01-19,PAM,hotZone,Split,51,62,113
5010,2023-01-19,PAM,heist,Kaboom Canyon,29,18,47
5011,2023-01-19,PAM,gemGrab,Undermine,94,163,257
5012,2023-01-19,PAM,gemGrab,Gem Fort,15,11,26
5013,2023-01-19,PAM,brawlBall,Sunny Soccer,0,3,3
5014,2023-01-19,PAM,brawlBall,Pinhole Punt,226,323,549
5015,2023-01-19,PAM,bounty,Shooting Star,18,11,29
5016,2023-01-18,PAM,knockout,Goldarm Gulch,2,2,4
5017,2023-01-18,PAM,hotZone,Parallel Plays,11,6,17
5018,2023-01-18,PAM,heist,Kaboom Canyon,7,17,24
5019,2023-01-18,PAM,gemGrab,Gem Fort,28,39,67
5020,2023-01-18,PAM,gemGrab,Crystal Arcade,2,1,3
5021,2023-01-18,PAM,brawlBall,Sunny Soccer,30,33,63
5022,2023-01-18,PAM,brawlBall,Beach Ball,4,3,7
5023,2023-01-18,PAM,bounty,Shooting Star,6,3,9
5024,2023-01-17,PAM,knockout,Goldarm Gulch,3,1,4
5025,2023-01-17,PAM,hotZone,Parallel Plays,17,12,29
5026,2023-01-17,PAM,heist,Pit Stop,0,1,1
5027,2023-01-17,PAM,gemGrab,Crystal Arcade,1,5,6
5028,2023-01-17,PAM,brawlBall,Beach Ball,16,12,28
5029,2023-01-16,PAM,hotZone,Quarter Pounder,3,4,7
5030,2023-01-16,PAM,heist,Pit Stop,1,0,1
5031,2023-01-16,PAM,gemGrab,Minecart Madness,8,5,13
5032,2023-01-16,PAM,gemGrab,Double Swoosh,6,18,24
5033,2023-01-16,PAM,brawlBall,Center Stage,8,27,35
5034,2023-01-16,PAM,brawlBall,Backyard Bowl,8,0,8
5035,2023-01-15,PAM,hotZone,Quarter Pounder,20,24,44
5036,2023-01-15,PAM,heist,Bridge Too Far,2,1,3
5037,2023-01-15,PAM,gemGrab,Hard Rock Mine,1,16,17
5038,2023-01-15,PAM,gemGrab,Double Swoosh,10,7,17
5039,2023-01-15,PAM,brawlBall,Super Beach,1,0,1
5040,2023-01-15,PAM,brawlBall,Backyard Bowl,38,59,97
5041,2023-01-14,PAM,knockout,Flaring Phoenix,1,0,1
5042,2023-01-14,PAM,hotZone,Controller Chaos,18,43,61
5043,2023-01-14,PAM,heist,Bridge Too Far,4,2,6
5044,2023-01-14,PAM,gemGrab,Hard Rock Mine,1,11,12
5045,2023-01-14,PAM,gemGrab,Deep Diner,2,1,3
5046,2023-01-14,PAM,brawlBall,Super Beach,4,8,12
5047,2023-01-14,PAM,bounty,Canal Grande,1,0,1
5048,2023-01-13,PAM,hotZone,Controller Chaos,9,9,18
5049,2023-01-13,PAM,gemGrab,Deep Diner,3,5,8
5050,2023-01-13,PAM,brawlBall,Sneaky Fields,12,7,19
5051,2023-01-13,PAM,brawlBall,Pinhole Punt,0,1,1
5052,2023-01-13,PAM,bounty,Temple Ruins,1,1,2
5053,2023-01-12,PAM,knockout,Riverside,7,7,14
5054,2023-01-12,PAM,hotZone,Open Zone,17,14,31
5055,2023-01-12,PAM,gemGrab,Undermine,10,14,24
5056,2023-01-12,PAM,gemGrab,Gem Fort,2,1,3
5057,2023-01-12,PAM,brawlBall,Pinhole Punt,7,13,20
5058,2023-01-11,PAM,hotZone,Open Zone,7,4,11
5059,2023-01-11,PAM,gemGrab,Gem Fort,1,1,2
5060,2023-01-10,PAM,knockout,New Perspective,1,0,1
5061,2023-01-10,PAM,hotZone,Dueling Beetles,9,14,23
5062,2023-01-10,PAM,heist,Safe Zone,10,14,24
5063,2023-01-10,PAM,gemGrab,Minecart Madness,2,5,7
5064,2023-01-10,PAM,gemGrab,Crystal Arcade,6,3,9
5065,2023-01-10,PAM,brawlBall,Beach Ball,1,1,2
5066,2023-01-10,PAM,bounty,Excel,1,0,1
5067,2023-01-09,PAM,hotZone,Dueling Beetles,4,1,5
5068,2023-01-09,PAM,heist,Snaked Assault,2,0,2
5069,2023-01-09,PAM,gemGrab,Minecart Madness,6,10,16
5070,2023-01-09,PAM,gemGrab,Double Swoosh,5,10,15
5071,2023-01-09,PAM,brawlBall,Center Stage,7,2,9
5072,2023-01-09,PAM,brawlBall,Backyard Bowl,0,11,11
5073,2023-01-09,PAM,bounty,Layer Cake,1,0,1
5074,2023-01-08,PAM,hotZone,Ring of Fire,19,23,42
5075,2023-01-08,PAM,heist,Snaked Assault,2,0,2
5076,2023-01-08,PAM,gemGrab,Hard Rock Mine,1,0,1
5077,2023-01-08,PAM,gemGrab,Double Swoosh,2,1,3
5078,2023-01-08,PAM,brawlBall,Super Beach,0,2,2
5079,2023-01-08,PAM,brawlBall,Backyard Bowl,11,41,52
5080,2023-01-07,PAM,hotZone,Ring of Fire,7,22,29
5081,2023-01-07,PAM,heist,Tornado Ring,1,3,4
5082,2023-01-07,PAM,gemGrab,Hard Rock Mine,2,2,4
5083,2023-01-07,PAM,gemGrab,Deep Diner,1,0,1
5084,2023-01-07,PAM,brawlBall,Super Beach,1,7,8
5085,2023-01-07,PAM,brawlBall,Sneaky Fields,1,0,1
5086,2023-01-06,PAM,heist,Tornado Ring,3,1,4
5087,2023-01-06,PAM,gemGrab,Undermine,1,0,1
5088,2023-01-06,PAM,gemGrab,Deep Diner,1,2,3
5089,2023-01-06,PAM,brawlBall,Sneaky Fields,2,6,8
5090,2023-01-06,PAM,bounty,Dry Season,1,0,1
5091,2023-01-05,PAM,knockout,Out in the Open,1,0,1
5092,2023-01-05,PAM,hotZone,Split,3,0,3
5093,2023-01-05,PAM,heist,Kaboom Canyon,2,0,2
5094,2023-01-05,PAM,gemGrab,Undermine,10,5,15
5095,2023-01-05,PAM,gemGrab,Gem Fort,3,9,12
5096,2023-01-05,PAM,brawlBall,Pinhole Punt,23,42,65
5097,2023-01-04,PAM,knockout,Goldarm Gulch,1,0,1
5098,2023-01-04,PAM,hotZone,Parallel Plays,3,5,8
5099,2023-01-04,PAM,heist,Kaboom Canyon,1,0,1
5100,2023-01-04,PAM,gemGrab,Gem Fort,2,9,11
5101,2023-01-04,PAM,gemGrab,Crystal Arcade,2,0,2
5102,2023-01-04,PAM,brawlBall,Sunny Soccer,10,12,22
5103,2023-01-04,PAM,bounty,Shooting Star,4,1,5
5104,2023-01-03,PAM,knockout,Goldarm Gulch,1,0,1
5105,2023-01-03,PAM,hotZone,Parallel Plays,5,8,13
5106,2023-01-03,PAM,heist,Pit Stop,1,0,1
5107,2023-01-03,PAM,gemGrab,Minecart Madness,1,2,3
5108,2023-01-03,PAM,gemGrab,Crystal Arcade,6,0,6
5109,2023-01-03,PAM,brawlBall,Center Stage,2,0,2
5110,2023-01-03,PAM,brawlBall,Beach Ball,6,4,10
5111,2023-01-03,PAM,bounty,Hideout,1,0,1
5112,2023-01-02,PAM,knockout,Belle's Rock,1,0,1
5113,2023-01-02,PAM,hotZone,Quarter Pounder,11,7,18
5114,2023-01-02,PAM,gemGrab,Minecart Madness,9,10,19
5115,2023-01-02,PAM,gemGrab,Double Swoosh,8,7,15
5116,2023-01-02,PAM,brawlBall,Center Stage,12,8,20
5117,2023-01-02,PAM,brawlBall,Backyard Bowl,2,2,4
5118,2023-01-02,PAM,bounty,Hideout,1,2,3
5119,2023-01-01,PAM,hotZone,Quarter Pounder,4,3,7
5120,2023-01-01,PAM,heist,Bridge Too Far,1,0,1
5121,2023-01-01,PAM,gemGrab,Double Swoosh,5,2,7
5122,2023-01-01,PAM,brawlBall,Backyard Bowl,12,9,21
5123,2022-12-31,PAM,hotZone,Controller Chaos,2,3,5
5124,2022-12-31,PAM,gemGrab,Deep Diner,2,0,2
5125,2022-12-31,PAM,brawlBall,Super Beach,0,1,1
5126,2022-12-31,PAM,bounty,Canal Grande,2,2,4
5127,2022-12-30,PAM,hotZone,Controller Chaos,1,3,4
5128,2022-12-30,PAM,gemGrab,Deep Diner,1,1,2
5129,2022-12-30,PAM,brawlBall,Sneaky Fields,1,2,3
5130,2022-12-29,PAM,hotZone,Controller Chaos,1,0,1
5131,2022-12-29,PAM,heist,Kaboom Canyon,0,1,1
5132,2022-12-29,PAM,gemGrab,Undermine,0,8,8
5133,2022-12-29,PAM,brawlBall,Pinhole Punt,1,0,1
5134,2022-12-28,PAM,hotZone,Open Zone,0,1,1
5135,2022-12-27,PAM,hotZone,Controller Chaos,0,1,1
5136,2022-12-27,PAM,brawlBall,Beach Ball,2,0,2
5137,2022-12-26,PAM,hotZone,Controller Chaos,1,0,1
5138,2022-12-26,PAM,heist,Kaboom Canyon,0,1,1
5139,2022-12-26,PAM,gemGrab,Minecart Madness,1,0,1
5140,2022-12-25,PAM,brawlBall,Backyard Bowl,1,1,2
5141,2022-12-22,PAM,brawlBall,Pinhole Punt,0,5,5
5142,2022-12-20,PAM,brawlBall,Beach Ball,0,1,1
5143,2022-12-16,PAM,brawlBall,Sneaky Fields,1,0,1
5144,2022-12-13,PAM,hotZone,Dueling Beetles,0,1,1
5145,2022-12-13,PAM,gemGrab,Crystal Arcade,1,0,1
5146,2022-11-07,PAM,hotZone,Quarter Pounder,1,0,1
5147,2022-10-30,PAM,brawlBall,Beach Ball,1,0,1
5148,2022-10-15,PAM,hotZone,Ring of Fire,0,2,2
5149,2022-10-15,PAM,gemGrab,Hard Rock Mine,0,1,1
5150,2023-02-05,OTIS,knockout,X Marks the Spot,28,26,54
5151,2023-02-05,OTIS,knockout,Goldarm Gulch,21,12,33
5152,2023-02-05,OTIS,hotZone,Ring of Fire,35,20,55
5153,2023-02-05,OTIS,heist,Snaked Assault,35,69,104
5154,2023-02-05,OTIS,heist,Pit Stop,7,6,13
5155,2023-02-05,OTIS,gemGrab,Hard Rock Mine,24,27,51
5156,2023-02-05,OTIS,gemGrab,Double Swoosh,123,264,387
5157,2023-02-05,OTIS,brawlBall,Super Beach,9,7,16
5158,2023-02-05,OTIS,brawlBall,Sneaky Fields,50,92,142
5159,2023-02-05,OTIS,brawlBall,Backyard Bowl,270,479,749
5160,2023-02-05,OTIS,bounty,Layer Cake,11,31,42
5161,2023-02-04,OTIS,knockout,X Marks the Spot,7,8,15
5162,2023-02-04,OTIS,knockout,Goldarm Gulch,13,16,29
5163,2023-02-04,OTIS,hotZone,Ring of Fire,11,16,27
5164,2023-02-04,OTIS,heist,Tornado Ring,1,4,5
5165,2023-02-04,OTIS,heist,Pit Stop,7,4,11
5166,2023-02-04,OTIS,gemGrab,Hard Rock Mine,31,25,56
5167,2023-02-04,OTIS,gemGrab,Double Swoosh,27,67,94
5168,2023-02-04,OTIS,gemGrab,Deep Diner,5,4,9
5169,2023-02-04,OTIS,brawlBall,Super Beach,60,109,169
5170,2023-02-04,OTIS,brawlBall,Sneaky Fields,36,90,126
5171,2023-02-04,OTIS,bounty,Dry Season,6,9,15
5172,2023-02-03,OTIS,knockout,Out in the Open,38,38,76
5173,2023-02-03,OTIS,knockout,Goldarm Gulch,69,67,136
5174,2023-02-03,OTIS,hotZone,Split,16,34,50
5175,2023-02-03,OTIS,heist,Tornado Ring,29,49,78
5176,2023-02-03,OTIS,heist,Pit Stop,52,73,125
5177,2023-02-03,OTIS,gemGrab,Undermine,15,22,37
5178,2023-02-03,OTIS,gemGrab,Double Swoosh,129,300,429
5179,2023-02-03,OTIS,gemGrab,Deep Diner,71,72,143
5180,2023-02-03,OTIS,brawlBall,Sneaky Fields,575,893,1468
5181,2023-02-03,OTIS,brawlBall,Pinhole Punt,15,13,28
5182,2023-02-03,OTIS,bounty,Dry Season,36,29,65
5183,2023-02-02,OTIS,knockout,Out in the Open,30,51,81
5184,2023-02-02,OTIS,hotZone,Split,3,1,4
5185,2023-02-02,OTIS,heist,Kaboom Canyon,7,3,10
5186,2023-02-02,OTIS,gemGrab,Undermine,15,10,25
5187,2023-02-02,OTIS,gemGrab,Gem Fort,7,7,14
5188,2023-02-02,OTIS,brawlBall,Sunny Soccer,2,0,2
5189,2023-02-02,OTIS,brawlBall,Pinhole Punt,137,206,343
5190,2023-02-02,OTIS,bounty,Shooting Star,1,2,3
5191,2023-02-01,OTIS,knockout,Goldarm Gulch,63,100,163
5192,2023-02-01,OTIS,hotZone,Parallel Plays,58,79,137
5193,2023-02-01,OTIS,heist,Kaboom Canyon,26,30,56
5194,2023-02-01,OTIS,gemGrab,Gem Fort,59,120,179
5195,2023-02-01,OTIS,gemGrab,Crystal Arcade,70,73,143
5196,2023-02-01,OTIS,brawlBall,Sunny Soccer,245,399,644
5197,2023-02-01,OTIS,brawlBall,Beach Ball,19,24,43
5198,2023-02-01,OTIS,bounty,Shooting Star,19,21,40
5199,2023-01-31,OTIS,knockout,Goldarm Gulch,41,42,83
5200,2023-01-31,OTIS,hotZone,Parallel Plays,27,48,75
5201,2023-01-31,OTIS,heist,Pit Stop,3,5,8
5202,2023-01-31,OTIS,gemGrab,Minecart Madness,3,9,12
5203,2023-01-31,OTIS,gemGrab,Crystal Arcade,43,66,109
5204,2023-01-31,OTIS,brawlBall,Center Stage,7,7,14
5205,2023-01-31,OTIS,brawlBall,Beach Ball,149,223,372
5206,2023-01-31,OTIS,bounty,Hideout,4,5,9
5207,2023-01-30,OTIS,knockout,Belle's Rock,43,51,94
5208,2023-01-30,OTIS,hotZone,Quarter Pounder,63,160,223
5209,2023-01-30,OTIS,heist,Pit Stop,14,11,25
5210,2023-01-30,OTIS,gemGrab,Minecart Madness,45,56,101
5211,2023-01-30,OTIS,gemGrab,Double Swoosh,42,66,108
5212,2023-01-30,OTIS,brawlBall,Center Stage,321,517,838
5213,2023-01-30,OTIS,brawlBall,Backyard Bowl,40,46,86
5214,2023-01-30,OTIS,bounty,Hideout,5,1,6
5215,2023-01-29,OTIS,knockout,Belle's Rock,51,51,102
5216,2023-01-29,OTIS,hotZone,Quarter Pounder,42,65,107
5217,2023-01-29,OTIS,heist,Bridge Too Far,40,51,91
5218,2023-01-29,OTIS,gemGrab,Hard Rock Mine,13,24,37
5219,2023-01-29,OTIS,gemGrab,Double Swoosh,93,99,192
5220,2023-01-29,OTIS,brawlBall,Super Beach,9,13,22
5221,2023-01-29,OTIS,brawlBall,Backyard Bowl,359,410,769
5222,2023-01-29,OTIS,bounty,Canal Grande,16,21,37
5223,2023-01-28,OTIS,knockout,Flaring Phoenix,19,12,31
5224,2023-01-28,OTIS,hotZone,Controller Chaos,89,138,227
5225,2023-01-28,OTIS,heist,Bridge Too Far,89,83,172
5226,2023-01-28,OTIS,gemGrab,Hard Rock Mine,95,134,229
5227,2023-01-28,OTIS,gemGrab,Deep Diner,19,22,41
5228,2023-01-28,OTIS,brawlBall,Super Beach,281,410,691
5229,2023-01-28,OTIS,brawlBall,Sneaky Fields,18,15,33
5230,2023-01-28,OTIS,bounty,Canal Grande,37,27,64
5231,2023-01-27,OTIS,knockout,Flaring Phoenix,17,21,38
5232,2023-01-27,OTIS,hotZone,Controller Chaos,19,35,54
5233,2023-01-27,OTIS,heist,Hot Potato,5,12,17
5234,2023-01-27,OTIS,gemGrab,Undermine,5,6,11
5235,2023-01-27,OTIS,gemGrab,Deep Diner,24,27,51
5236,2023-01-27,OTIS,brawlBall,Sneaky Fields,132,163,295
5237,2023-01-27,OTIS,brawlBall,Pinhole Punt,14,9,23
5238,2023-01-27,OTIS,bounty,Temple Ruins,14,43,57
5239,2023-01-26,OTIS,knockout,Riverside,34,15,49
5240,2023-01-26,OTIS,hotZone,Open Zone,50,67,117
5241,2023-01-26,OTIS,heist,Hot Potato,19,17,36
5242,2023-01-26,OTIS,gemGrab,Undermine,46,67,113
5243,2023-01-26,OTIS,gemGrab,Gem Fort,29,32,61
5244,2023-01-26,OTIS,brawlBall,Sunny Soccer,11,31,42
5245,2023-01-26,OTIS,brawlBall,Pinhole Punt,381,597,978
5246,2023-01-26,OTIS,bounty,Temple Ruins,22,37,59
5247,2023-01-25,OTIS,knockout,Riverside,5,11,16
5248,2023-01-25,OTIS,hotZone,Open Zone,13,22,35
5249,2023-01-25,OTIS,heist,Safe Zone,18,27,45
5250,2023-01-25,OTIS,gemGrab,Gem Fort,23,60,83
5251,2023-01-25,OTIS,gemGrab,Crystal Arcade,51,90,141
5252,2023-01-25,OTIS,brawlBall,Sunny Soccer,210,323,533
5253,2023-01-25,OTIS,brawlBall,Beach Ball,47,70,117
5254,2023-01-25,OTIS,bounty,Excel,16,12,28
5255,2023-01-24,OTIS,knockout,New Perspective,36,34,70
5256,2023-01-24,OTIS,hotZone,Dueling Beetles,26,31,57
5257,2023-01-24,OTIS,heist,Safe Zone,25,18,43
5258,2023-01-24,OTIS,gemGrab,Minecart Madness,16,22,38
5259,2023-01-24,OTIS,gemGrab,Crystal Arcade,57,98,155
5260,2023-01-24,OTIS,brawlBall,Center Stage,39,45,84
5261,2023-01-24,OTIS,brawlBall,Beach Ball,372,477,849
5262,2023-01-24,OTIS,bounty,Excel,31,19,50
5263,2023-01-23,OTIS,knockout,New Perspective,52,65,117
5264,2023-01-23,OTIS,hotZone,Dueling Beetles,91,83,174
5265,2023-01-23,OTIS,heist,Snaked Assault,36,44,80
5266,2023-01-23,OTIS,gemGrab,Minecart Madness,78,143,221
5267,2023-01-23,OTIS,gemGrab,Double Swoosh,36,39,75
5268,2023-01-23,OTIS,brawlBall,Center Stage,524,789,1313
5269,2023-01-23,OTIS,brawlBall,Backyard Bowl,25,32,57
5270,2023-01-23,OTIS,bounty,Layer Cake,24,41,65
5271,2023-01-22,OTIS,knockout,X Marks the Spot,12,14,26
5272,2023-01-22,OTIS,hotZone,Ring of Fire,17,23,40
5273,2023-01-22,OTIS,heist,Snaked Assault,21,26,47
5274,2023-01-22,OTIS,gemGrab,Hard Rock Mine,30,52,82
5275,2023-01-22,OTIS,gemGrab,Double Swoosh,42,78,120
5276,2023-01-22,OTIS,brawlBall,Super Beach,35,63,98
5277,2023-01-22,OTIS,brawlBall,Backyard Bowl,179,267,446
5278,2023-01-22,OTIS,bounty,Layer Cake,13,8,21
5279,2023-01-21,OTIS,knockout,X Marks the Spot,55,76,131
5280,2023-01-21,OTIS,hotZone,Ring of Fire,74,93,167
5281,2023-01-21,OTIS,heist,Tornado Ring,19,23,42
5282,2023-01-21,OTIS,gemGrab,Hard Rock Mine,87,91,178
5283,2023-01-21,OTIS,gemGrab,Deep Diner,17,32,49
5284,2023-01-21,OTIS,brawlBall,Super Beach,529,791,1320
5285,2023-01-21,OTIS,brawlBall,Sneaky Fields,9,14,23
5286,2023-01-21,OTIS,bounty,Dry Season,33,47,80
5287,2023-01-20,OTIS,knockout,Out in the Open,73,90,163
5288,2023-01-20,OTIS,hotZone,Split,10,17,27
5289,2023-01-20,OTIS,heist,Tornado Ring,20,22,42
5290,2023-01-20,OTIS,gemGrab,Undermine,20,30,50
5291,2023-01-20,OTIS,gemGrab,Deep Diner,85,113,198
5292,2023-01-20,OTIS,brawlBall,Sneaky Fields,377,557,934
5293,2023-01-20,OTIS,brawlBall,Pinhole Punt,22,46,68
5294,2023-01-20,OTIS,bounty,Dry Season,30,35,65
5295,2023-01-19,OTIS,knockout,Out in the Open,83,91,174
5296,2023-01-19,OTIS,hotZone,Split,14,11,25
5297,2023-01-19,OTIS,heist,Kaboom Canyon,17,13,30
5298,2023-01-19,OTIS,gemGrab,Undermine,60,69,129
5299,2023-01-19,OTIS,gemGrab,Gem Fort,15,4,19
5300,2023-01-19,OTIS,brawlBall,Sunny Soccer,3,6,9
5301,2023-01-19,OTIS,brawlBall,Pinhole Punt,433,624,1057
5302,2023-01-19,OTIS,bounty,Shooting Star,16,17,33
5303,2023-01-18,OTIS,knockout,Goldarm Gulch,6,6,12
5304,2023-01-18,OTIS,hotZone,Parallel Plays,3,10,13
5305,2023-01-18,OTIS,heist,Kaboom Canyon,8,14,22
5306,2023-01-18,OTIS,gemGrab,Gem Fort,23,36,59
5307,2023-01-18,OTIS,gemGrab,Crystal Arcade,5,5,10
5308,2023-01-18,OTIS,brawlBall,Sunny Soccer,112,167,279
5309,2023-01-18,OTIS,brawlBall,Beach Ball,0,2,2
5310,2023-01-18,OTIS,bounty,Shooting Star,10,4,14
5311,2023-01-17,OTIS,knockout,Goldarm Gulch,14,13,27
5312,2023-01-17,OTIS,hotZone,Parallel Plays,10,4,14
5313,2023-01-17,OTIS,heist,Pit Stop,5,2,7
5314,2023-01-17,OTIS,gemGrab,Minecart Madness,1,1,2
5315,2023-01-17,OTIS,gemGrab,Crystal Arcade,13,19,32
5316,2023-01-17,OTIS,brawlBall,Center Stage,1,1,2
5317,2023-01-17,OTIS,brawlBall,Beach Ball,27,51,78
5318,2023-01-17,OTIS,bounty,Hideout,0,1,1
5319,2023-01-16,OTIS,knockout,Belle's Rock,4,2,6
5320,2023-01-16,OTIS,hotZone,Quarter Pounder,6,22,28
5321,2023-01-16,OTIS,heist,Pit Stop,8,3,11
5322,2023-01-16,OTIS,gemGrab,Minecart Madness,6,9,15
5323,2023-01-16,OTIS,gemGrab,Double Swoosh,1,6,7
5324,2023-01-16,OTIS,brawlBall,Center Stage,33,65,98
5325,2023-01-16,OTIS,brawlBall,Backyard Bowl,3,6,9
5326,2023-01-15,OTIS,knockout,Belle's Rock,4,5,9
5327,2023-01-15,OTIS,hotZone,Quarter Pounder,18,4,22
5328,2023-01-15,OTIS,heist,Bridge Too Far,6,9,15
5329,2023-01-15,OTIS,gemGrab,Hard Rock Mine,2,11,13
5330,2023-01-15,OTIS,gemGrab,Double Swoosh,16,47,63
5331,2023-01-15,OTIS,brawlBall,Super Beach,4,9,13
5332,2023-01-15,OTIS,brawlBall,Backyard Bowl,42,74,116
5333,2023-01-15,OTIS,bounty,Canal Grande,3,4,7
5334,2023-01-14,OTIS,knockout,Flaring Phoenix,3,4,7
5335,2023-01-14,OTIS,hotZone,Controller Chaos,29,64,93
5336,2023-01-14,OTIS,heist,Bridge Too Far,15,24,39
5337,2023-01-14,OTIS,gemGrab,Hard Rock Mine,5,4,9
5338,2023-01-14,OTIS,gemGrab,Deep Diner,5,20,25
5339,2023-01-14,OTIS,brawlBall,Super Beach,27,43,70
5340,2023-01-14,OTIS,brawlBall,Sneaky Fields,9,35,44
5341,2023-01-14,OTIS,bounty,Canal Grande,2,1,3
5342,2023-01-13,OTIS,knockout,Flaring Phoenix,2,0,2
5343,2023-01-13,OTIS,hotZone,Controller Chaos,14,27,41
5344,2023-01-13,OTIS,heist,Hot Potato,3,8,11
5345,2023-01-13,OTIS,gemGrab,Deep Diner,6,23,29
5346,2023-01-13,OTIS,brawlBall,Sneaky Fields,47,40,87
5347,2023-01-13,OTIS,brawlBall,Pinhole Punt,2,1,3
5348,2023-01-13,OTIS,bounty,Temple Ruins,1,2,3
5349,2023-01-12,OTIS,knockout,Riverside,1,4,5
5350,2023-01-12,OTIS,hotZone,Open Zone,9,7,16
5351,2023-01-12,OTIS,heist,Hot Potato,2,0,2
5352,2023-01-12,OTIS,gemGrab,Undermine,4,6,10
5353,2023-01-12,OTIS,brawlBall,Sunny Soccer,3,6,9
5354,2023-01-12,OTIS,brawlBall,Pinhole Punt,16,9,25
5355,2023-01-11,OTIS,hotZone,Open Zone,1,0,1
5356,2023-01-11,OTIS,gemGrab,Gem Fort,1,1,2
5357,2023-01-11,OTIS,brawlBall,Sunny Soccer,5,22,27
5358,2023-01-10,OTIS,hotZone,Dueling Beetles,10,49,59
5359,2023-01-10,OTIS,heist,Safe Zone,3,7,10
5360,2023-01-10,OTIS,gemGrab,Minecart Madness,5,5,10
5361,2023-01-10,OTIS,gemGrab,Crystal Arcade,10,13,23
5362,2023-01-10,OTIS,brawlBall,Center Stage,6,3,9
5363,2023-01-10,OTIS,brawlBall,Beach Ball,29,42,71
5364,2023-01-09,OTIS,knockout,New Perspective,1,2,3
5365,2023-01-09,OTIS,hotZone,Dueling Beetles,4,1,5
5366,2023-01-09,OTIS,heist,Snaked Assault,3,2,5
5367,2023-01-09,OTIS,gemGrab,Minecart Madness,10,25,35
5368,2023-01-09,OTIS,gemGrab,Double Swoosh,9,17,26
5369,2023-01-09,OTIS,brawlBall,Center Stage,32,36,68
5370,2023-01-09,OTIS,bounty,Layer Cake,6,23,29
5371,2023-01-08,OTIS,knockout,X Marks the Spot,5,17,22
5372,2023-01-08,OTIS,hotZone,Ring of Fire,12,18,30
5373,2023-01-08,OTIS,heist,Snaked Assault,2,5,7
5374,2023-01-08,OTIS,gemGrab,Hard Rock Mine,1,0,1
5375,2023-01-08,OTIS,gemGrab,Double Swoosh,5,11,16
5376,2023-01-08,OTIS,brawlBall,Super Beach,7,19,26
5377,2023-01-08,OTIS,brawlBall,Backyard Bowl,25,40,65
5378,2023-01-07,OTIS,hotZone,Ring of Fire,8,9,17
5379,2023-01-07,OTIS,heist,Tornado Ring,2,0,2
5380,2023-01-07,OTIS,gemGrab,Hard Rock Mine,7,22,29
5381,2023-01-07,OTIS,gemGrab,Deep Diner,2,0,2
5382,2023-01-07,OTIS,brawlBall,Super Beach,11,8,19
5383,2023-01-07,OTIS,brawlBall,Sneaky Fields,1,9,10
5384,2023-01-07,OTIS,bounty,Dry Season,7,20,27
5385,2023-01-06,OTIS,knockout,Out in the Open,4,0,4
5386,2023-01-06,OTIS,hotZone,Split,1,2,3
5387,2023-01-06,OTIS,heist,Tornado Ring,6,0,6
5388,2023-01-06,OTIS,gemGrab,Undermine,2,1,3
5389,2023-01-06,OTIS,gemGrab,Deep Diner,6,2,8
5390,2023-01-06,OTIS,brawlBall,Sneaky Fields,40,104,144
5391,2023-01-06,OTIS,brawlBall,Pinhole Punt,2,1,3
5392,2023-01-06,OTIS,bounty,Dry Season,4,7,11
5393,2023-01-05,OTIS,knockout,Out in the Open,11,16,27
5394,2023-01-05,OTIS,hotZone,Split,5,16,21
5395,2023-01-05,OTIS,heist,Kaboom Canyon,1,6,7
5396,2023-01-05,OTIS,gemGrab,Undermine,6,0,6
5397,2023-01-05,OTIS,brawlBall,Pinhole Punt,47,119,166
5398,2023-01-04,OTIS,knockout,Goldarm Gulch,4,5,9
5399,2023-01-04,OTIS,hotZone,Parallel Plays,7,7,14
5400,2023-01-04,OTIS,heist,Kaboom Canyon,8,4,12
5401,2023-01-04,OTIS,gemGrab,Gem Fort,6,7,13
5402,2023-01-04,OTIS,gemGrab,Crystal Arcade,5,5,10
5403,2023-01-04,OTIS,brawlBall,Sunny Soccer,43,75,118
5404,2023-01-04,OTIS,bounty,Shooting Star,3,0,3
5405,2023-01-03,OTIS,knockout,Goldarm Gulch,7,14,21
5406,2023-01-03,OTIS,hotZone,Parallel Plays,4,7,11
5407,2023-01-03,OTIS,heist,Pit Stop,3,0,3
5408,2023-01-03,OTIS,gemGrab,Minecart Madness,1,0,1
5409,2023-01-03,OTIS,gemGrab,Crystal Arcade,3,5,8
5410,2023-01-03,OTIS,brawlBall,Center Stage,1,4,5
5411,2023-01-03,OTIS,brawlBall,Beach Ball,44,109,153
5412,2023-01-03,OTIS,bounty,Hideout,3,0,3
5413,2023-01-02,OTIS,knockout,Belle's Rock,7,3,10
5414,2023-01-02,OTIS,hotZone,Quarter Pounder,10,31,41
5415,2023-01-02,OTIS,heist,Pit Stop,0,2,2
5416,2023-01-02,OTIS,gemGrab,Minecart Madness,7,62,69
5417,2023-01-02,OTIS,gemGrab,Double Swoosh,8,4,12
5418,2023-01-02,OTIS,brawlBall,Center Stage,45,63,108
5419,2023-01-02,OTIS,brawlBall,Backyard Bowl,4,8,12
5420,2023-01-02,OTIS,bounty,Hideout,3,4,7
5421,2023-01-01,OTIS,knockout,Belle's Rock,3,2,5
5422,2023-01-01,OTIS,hotZone,Quarter Pounder,6,9,15
5423,2023-01-01,OTIS,heist,Bridge Too Far,6,2,8
5424,2023-01-01,OTIS,gemGrab,Double Swoosh,6,6,12
5425,2023-01-01,OTIS,brawlBall,Backyard Bowl,14,38,52
5426,2023-01-01,OTIS,bounty,Canal Grande,0,2,2
5427,2022-12-31,OTIS,hotZone,Controller Chaos,2,14,16
5428,2022-12-31,OTIS,heist,Bridge Too Far,2,0,2
5429,2022-12-31,OTIS,gemGrab,Minecart Madness,0,1,1
5430,2022-12-31,OTIS,brawlBall,Super Beach,5,0,5
5431,2022-12-31,OTIS,brawlBall,Sneaky Fields,0,1,1
5432,2022-12-31,OTIS,bounty,Canal Grande,1,0,1
5433,2022-12-30,OTIS,heist,Kaboom Canyon,0,1,1
5434,2022-12-30,OTIS,gemGrab,Deep Diner,1,3,4
5435,2022-12-30,OTIS,brawlBall,Sneaky Fields,4,5,9
5436,2022-12-29,OTIS,hotZone,Open Zone,5,3,8
5437,2022-12-29,OTIS,heist,Hot Potato,1,5,6
5438,2022-12-29,OTIS,gemGrab,Minecart Madness,0,1,1
5439,2022-12-29,OTIS,brawlBall,Pinhole Punt,1,1,2
5440,2022-12-28,OTIS,hotZone,Open Zone,7,13,20
5441,2022-12-27,OTIS,hotZone,Dueling Beetles,1,0,1
5442,2022-12-27,OTIS,brawlBall,Beach Ball,0,2,2
5443,2022-12-26,OTIS,gemGrab,Minecart Madness,0,1,1
5444,2022-12-25,OTIS,brawlBall,Backyard Bowl,1,0,1
5445,2022-12-22,OTIS,gemGrab,Gem Fort,1,12,13
5446,2022-12-22,OTIS,brawlBall,Pinhole Punt,1,8,9
5447,2022-12-21,OTIS,brawlBall,Sunny Soccer,0,1,1
5448,2022-12-19,OTIS,brawlBall,Center Stage,2,1,3
5449,2022-12-16,OTIS,brawlBall,Sneaky Fields,3,2,5
5450,2022-12-13,OTIS,gemGrab,Crystal Arcade,0,1,1
5451,2022-12-11,OTIS,brawlBall,Backyard Bowl,1,0,1
5452,2022-11-07,OTIS,hotZone,Quarter Pounder,3,1,4
5453,2022-10-26,OTIS,brawlBall,Sunny Soccer,1,2,3
5454,2022-10-15,OTIS,gemGrab,Hard Rock Mine,0,1,1
5455,2022-10-15,OTIS,bounty,Dry Season,0,1,1
5456,2022-10-10,OTIS,knockout,Belle's Rock,1,0,1
5457,2023-02-05,NITA,knockout,X Marks the Spot,17,4,21
5458,2023-02-05,NITA,hotZone,Ring of Fire,71,69,140
5459,2023-02-05,NITA,heist,Snaked Assault,802,768,1570
5460,2023-02-05,NITA,heist,Pit Stop,348,377,725
5461,2023-02-05,NITA,gemGrab,Hard Rock Mine,59,30,89
5462,2023-02-05,NITA,gemGrab,Double Swoosh,351,307,658
5463,2023-02-05,NITA,brawlBall,Super Beach,21,47,68
5464,2023-02-05,NITA,brawlBall,Sneaky Fields,114,107,221
5465,2023-02-05,NITA,brawlBall,Backyard Bowl,168,139,307
5466,2023-02-05,NITA,bounty,Layer Cake,18,4,22
5467,2023-02-04,NITA,knockout,X Marks the Spot,6,1,7
5468,2023-02-04,NITA,hotZone,Ring of Fire,16,19,35
5469,2023-02-04,NITA,heist,Tornado Ring,107,166,273
5470,2023-02-04,NITA,heist,Pit Stop,306,316,622
5471,2023-02-04,NITA,gemGrab,Hard Rock Mine,81,78,159
5472,2023-02-04,NITA,gemGrab,Double Swoosh,35,17,52
5473,2023-02-04,NITA,gemGrab,Deep Diner,7,0,7
5474,2023-02-04,NITA,brawlBall,Super Beach,262,311,573
5475,2023-02-04,NITA,brawlBall,Sneaky Fields,116,126,242
5476,2023-02-04,NITA,bounty,Dry Season,1,0,1
5477,2023-02-03,NITA,knockout,Out in the Open,14,4,18
5478,2023-02-03,NITA,knockout,Goldarm Gulch,3,1,4
5479,2023-02-03,NITA,hotZone,Split,117,119,236
5480,2023-02-03,NITA,heist,Tornado Ring,1243,1366,2609
5481,2023-02-03,NITA,heist,Pit Stop,1805,1680,3485
5482,2023-02-03,NITA,gemGrab,Undermine,34,42,76
5483,2023-02-03,NITA,gemGrab,Double Swoosh,212,132,344
5484,2023-02-03,NITA,gemGrab,Deep Diner,220,226,446
5485,2023-02-03,NITA,brawlBall,Sneaky Fields,2076,2593,4669
5486,2023-02-03,NITA,brawlBall,Pinhole Punt,13,32,45
5487,2023-02-03,NITA,bounty,Dry Season,12,2,14
5488,2023-02-02,NITA,knockout,Out in the Open,3,2,5
5489,2023-02-02,NITA,hotZone,Split,50,29,79
5490,2023-02-02,NITA,heist,Kaboom Canyon,37,19,56
5491,2023-02-02,NITA,gemGrab,Undermine,51,61,112
5492,2023-02-02,NITA,gemGrab,Gem Fort,7,8,15
5493,2023-02-02,NITA,brawlBall,Sunny Soccer,4,3,7
5494,2023-02-02,NITA,brawlBall,Pinhole Punt,145,187,332
5495,2023-02-02,NITA,bounty,Shooting Star,1,0,1
5496,2023-02-01,NITA,knockout,Goldarm Gulch,26,14,40
5497,2023-02-01,NITA,hotZone,Parallel Plays,251,301,552
5498,2023-02-01,NITA,heist,Kaboom Canyon,82,62,144
5499,2023-02-01,NITA,gemGrab,Gem Fort,121,160,281
5500,2023-02-01,NITA,gemGrab,Crystal Arcade,69,67,136
5501,2023-02-01,NITA,brawlBall,Sunny Soccer,732,933,1665
5502,2023-02-01,NITA,brawlBall,Beach Ball,23,40,63
5503,2023-02-01,NITA,bounty,Shooting Star,6,1,7
5504,2023-01-31,NITA,knockout,Goldarm Gulch,10,14,24
5505,2023-01-31,NITA,hotZone,Parallel Plays,126,150,276
5506,2023-01-31,NITA,heist,Pit Stop,185,180,365
5507,2023-01-31,NITA,gemGrab,Minecart Madness,3,4,7
5508,2023-01-31,NITA,gemGrab,Crystal Arcade,128,153,281
5509,2023-01-31,NITA,brawlBall,Center Stage,5,12,17
5510,2023-01-31,NITA,brawlBall,Beach Ball,272,300,572
5511,2023-01-31,NITA,bounty,Hideout,3,0,3
5512,2023-01-30,NITA,knockout,Belle's Rock,15,4,19
5513,2023-01-30,NITA,hotZone,Quarter Pounder,179,69,248
5514,2023-01-30,NITA,heist,Pit Stop,569,428,997
5515,2023-01-30,NITA,gemGrab,Minecart Madness,39,16,55
5516,2023-01-30,NITA,gemGrab,Double Swoosh,140,110,250
5517,2023-01-30,NITA,brawlBall,Center Stage,653,739,1392
5518,2023-01-30,NITA,brawlBall,Backyard Bowl,22,14,36
5519,2023-01-30,NITA,bounty,Hideout,3,3,6
5520,2023-01-29,NITA,knockout,Belle's Rock,17,9,26
5521,2023-01-29,NITA,hotZone,Quarter Pounder,171,135,306
5522,2023-01-29,NITA,heist,Bridge Too Far,62,18,80
5523,2023-01-29,NITA,gemGrab,Hard Rock Mine,40,52,92
5524,2023-01-29,NITA,gemGrab,Double Swoosh,279,306,585
5525,2023-01-29,NITA,brawlBall,Super Beach,12,13,25
5526,2023-01-29,NITA,brawlBall,Backyard Bowl,224,146,370
5527,2023-01-29,NITA,bounty,Canal Grande,27,17,44
5528,2023-01-28,NITA,knockout,Flaring Phoenix,23,10,33
5529,2023-01-28,NITA,hotZone,Controller Chaos,249,267,516
5530,2023-01-28,NITA,heist,Bridge Too Far,129,53,182
5531,2023-01-28,NITA,gemGrab,Hard Rock Mine,176,156,332
5532,2023-01-28,NITA,gemGrab,Deep Diner,44,43,87
5533,2023-01-28,NITA,brawlBall,Super Beach,1115,1194,2309
5534,2023-01-28,NITA,brawlBall,Sneaky Fields,82,114,196
5535,2023-01-28,NITA,bounty,Canal Grande,90,105,195
5536,2023-01-27,NITA,knockout,Flaring Phoenix,2,4,6
5537,2023-01-27,NITA,hotZone,Controller Chaos,57,70,127
5538,2023-01-27,NITA,heist,Hot Potato,151,185,336
5539,2023-01-27,NITA,gemGrab,Undermine,10,5,15
5540,2023-01-27,NITA,gemGrab,Deep Diner,53,38,91
5541,2023-01-27,NITA,brawlBall,Sneaky Fields,414,490,904
5542,2023-01-27,NITA,brawlBall,Pinhole Punt,5,3,8
5543,2023-01-27,NITA,bounty,Temple Ruins,7,1,8
5544,2023-01-26,NITA,knockout,Riverside,18,6,24
5545,2023-01-26,NITA,hotZone,Open Zone,39,16,55
5546,2023-01-26,NITA,heist,Hot Potato,637,639,1276
5547,2023-01-26,NITA,gemGrab,Undermine,128,179,307
5548,2023-01-26,NITA,gemGrab,Gem Fort,49,41,90
5549,2023-01-26,NITA,brawlBall,Sunny Soccer,63,77,140
5550,2023-01-26,NITA,brawlBall,Pinhole Punt,428,542,970
5551,2023-01-26,NITA,bounty,Temple Ruins,16,7,23
5552,2023-01-25,NITA,knockout,Riverside,2,0,2
5553,2023-01-25,NITA,hotZone,Open Zone,18,8,26
5554,2023-01-25,NITA,heist,Safe Zone,88,39,127
5555,2023-01-25,NITA,gemGrab,Gem Fort,74,89,163
5556,2023-01-25,NITA,gemGrab,Crystal Arcade,113,143,256
5557,2023-01-25,NITA,brawlBall,Sunny Soccer,488,503,991
5558,2023-01-25,NITA,brawlBall,Beach Ball,57,49,106
5559,2023-01-25,NITA,bounty,Excel,12,13,25
5560,2023-01-24,NITA,knockout,New Perspective,9,6,15
5561,2023-01-24,NITA,hotZone,Dueling Beetles,83,41,124
5562,2023-01-24,NITA,heist,Safe Zone,112,68,180
5563,2023-01-24,NITA,gemGrab,Minecart Madness,7,5,12
5564,2023-01-24,NITA,gemGrab,Crystal Arcade,339,404,743
5565,2023-01-24,NITA,brawlBall,Center Stage,81,78,159
5566,2023-01-24,NITA,brawlBall,Beach Ball,604,639,1243
5567,2023-01-24,NITA,bounty,Excel,11,6,17
5568,2023-01-23,NITA,knockout,New Perspective,30,15,45
5569,2023-01-23,NITA,hotZone,Dueling Beetles,140,90,230
5570,2023-01-23,NITA,heist,Snaked Assault,1010,1151,2161
5571,2023-01-23,NITA,gemGrab,Minecart Madness,61,47,108
5572,2023-01-23,NITA,gemGrab,Double Swoosh,92,98,190
5573,2023-01-23,NITA,brawlBall,Center Stage,1041,1060,2101
5574,2023-01-23,NITA,brawlBall,Backyard Bowl,6,6,12
5575,2023-01-23,NITA,bounty,Layer Cake,16,6,22
5576,2023-01-22,NITA,knockout,X Marks the Spot,10,3,13
5577,2023-01-22,NITA,hotZone,Ring of Fire,43,40,83
5578,2023-01-22,NITA,heist,Snaked Assault,531,584,1115
5579,2023-01-22,NITA,gemGrab,Hard Rock Mine,67,95,162
5580,2023-01-22,NITA,gemGrab,Double Swoosh,145,134,279
5581,2023-01-22,NITA,brawlBall,Super Beach,107,112,219
5582,2023-01-22,NITA,brawlBall,Backyard Bowl,96,90,186
5583,2023-01-22,NITA,bounty,Layer Cake,13,5,18
5584,2023-01-21,NITA,knockout,X Marks the Spot,28,6,34
5585,2023-01-21,NITA,hotZone,Ring of Fire,91,59,150
5586,2023-01-21,NITA,heist,Tornado Ring,750,932,1682
5587,2023-01-21,NITA,gemGrab,Hard Rock Mine,277,266,543
5588,2023-01-21,NITA,gemGrab,Deep Diner,31,54,85
5589,2023-01-21,NITA,brawlBall,Super Beach,1367,1599,2966
5590,2023-01-21,NITA,brawlBall,Sneaky Fields,70,98,168
5591,2023-01-21,NITA,bounty,Dry Season,5,12,17
5592,2023-01-20,NITA,knockout,Out in the Open,20,9,29
5593,2023-01-20,NITA,hotZone,Split,109,52,161
5594,2023-01-20,NITA,heist,Tornado Ring,841,883,1724
5595,2023-01-20,NITA,gemGrab,Undermine,51,57,108
5596,2023-01-20,NITA,gemGrab,Deep Diner,190,222,412
5597,2023-01-20,NITA,brawlBall,Sneaky Fields,1190,1412,2602
5598,2023-01-20,NITA,brawlBall,Pinhole Punt,16,13,29
5599,2023-01-20,NITA,bounty,Dry Season,7,4,11
5600,2023-01-19,NITA,knockout,Out in the Open,25,6,31
5601,2023-01-19,NITA,hotZone,Split,148,116,264
5602,2023-01-19,NITA,heist,Kaboom Canyon,126,93,219
5603,2023-01-19,NITA,gemGrab,Undermine,177,216,393
5604,2023-01-19,NITA,gemGrab,Gem Fort,32,36,68
5605,2023-01-19,NITA,brawlBall,Sunny Soccer,18,15,33
5606,2023-01-19,NITA,brawlBall,Pinhole Punt,538,526,1064
5607,2023-01-19,NITA,bounty,Shooting Star,5,1,6
5608,2023-01-18,NITA,knockout,Goldarm Gulch,4,3,7
5609,2023-01-18,NITA,hotZone,Parallel Plays,29,21,50
5610,2023-01-18,NITA,heist,Kaboom Canyon,41,21,62
5611,2023-01-18,NITA,gemGrab,Gem Fort,33,33,66
5612,2023-01-18,NITA,gemGrab,Crystal Arcade,7,15,22
5613,2023-01-18,NITA,brawlBall,Sunny Soccer,217,224,441
5614,2023-01-18,NITA,brawlBall,Beach Ball,6,6,12
5615,2023-01-18,NITA,bounty,Shooting Star,1,1,2
5616,2023-01-17,NITA,knockout,Goldarm Gulch,7,3,10
5617,2023-01-17,NITA,hotZone,Parallel Plays,25,22,47
5618,2023-01-17,NITA,heist,Pit Stop,56,62,118
5619,2023-01-17,NITA,gemGrab,Crystal Arcade,19,22,41
5620,2023-01-17,NITA,brawlBall,Center Stage,2,2,4
5621,2023-01-17,NITA,brawlBall,Beach Ball,56,70,126
5622,2023-01-16,NITA,knockout,Belle's Rock,1,0,1
5623,2023-01-16,NITA,hotZone,Quarter Pounder,15,8,23
5624,2023-01-16,NITA,heist,Pit Stop,173,190,363
5625,2023-01-16,NITA,gemGrab,Minecart Madness,4,3,7
5626,2023-01-16,NITA,gemGrab,Double Swoosh,5,5,10
5627,2023-01-16,NITA,brawlBall,Center Stage,88,117,205
5628,2023-01-16,NITA,brawlBall,Backyard Bowl,2,0,2
5629,2023-01-15,NITA,knockout,Belle's Rock,1,0,1
5630,2023-01-15,NITA,hotZone,Quarter Pounder,68,36,104
5631,2023-01-15,NITA,heist,Bridge Too Far,10,2,12
5632,2023-01-15,NITA,gemGrab,Hard Rock Mine,15,5,20
5633,2023-01-15,NITA,gemGrab,Double Swoosh,44,40,84
5634,2023-01-15,NITA,brawlBall,Super Beach,14,9,23
5635,2023-01-15,NITA,brawlBall,Backyard Bowl,33,18,51
5636,2023-01-15,NITA,bounty,Canal Grande,8,1,9
5637,2023-01-14,NITA,knockout,Flaring Phoenix,1,0,1
5638,2023-01-14,NITA,hotZone,Controller Chaos,76,36,112
5639,2023-01-14,NITA,heist,Bridge Too Far,21,4,25
5640,2023-01-14,NITA,gemGrab,Hard Rock Mine,9,4,13
5641,2023-01-14,NITA,gemGrab,Deep Diner,13,16,29
5642,2023-01-14,NITA,brawlBall,Super Beach,98,105,203
5643,2023-01-14,NITA,brawlBall,Sneaky Fields,21,27,48
5644,2023-01-14,NITA,bounty,Canal Grande,6,2,8
5645,2023-01-13,NITA,knockout,Flaring Phoenix,4,0,4
5646,2023-01-13,NITA,hotZone,Controller Chaos,138,102,240
5647,2023-01-13,NITA,heist,Hot Potato,33,50,83
5648,2023-01-13,NITA,gemGrab,Deep Diner,9,7,16
5649,2023-01-13,NITA,brawlBall,Sneaky Fields,124,157,281
5650,2023-01-13,NITA,bounty,Temple Ruins,3,0,3
5651,2023-01-12,NITA,hotZone,Open Zone,3,1,4
5652,2023-01-12,NITA,heist,Hot Potato,23,17,40
5653,2023-01-12,NITA,gemGrab,Undermine,10,11,21
5654,2023-01-12,NITA,gemGrab,Gem Fort,2,0,2
5655,2023-01-12,NITA,brawlBall,Sunny Soccer,2,2,4
5656,2023-01-12,NITA,brawlBall,Pinhole Punt,19,6,25
5657,2023-01-11,NITA,knockout,Riverside,1,0,1
5658,2023-01-11,NITA,hotZone,Open Zone,2,0,2
5659,2023-01-11,NITA,heist,Safe Zone,0,1,1
5660,2023-01-11,NITA,gemGrab,Gem Fort,8,3,11
5661,2023-01-11,NITA,brawlBall,Sunny Soccer,23,16,39
5662,2023-01-11,NITA,brawlBall,Beach Ball,0,1,1
5663,2023-01-11,NITA,bounty,Excel,3,2,5
5664,2023-01-10,NITA,hotZone,Dueling Beetles,21,3,24
5665,2023-01-10,NITA,heist,Safe Zone,9,1,10
5666,2023-01-10,NITA,gemGrab,Minecart Madness,2,0,2
5667,2023-01-10,NITA,gemGrab,Crystal Arcade,48,46,94
5668,2023-01-10,NITA,brawlBall,Center Stage,6,14,20
5669,2023-01-10,NITA,brawlBall,Beach Ball,44,85,129
5670,2023-01-09,NITA,knockout,New Perspective,1,0,1
5671,2023-01-09,NITA,hotZone,Dueling Beetles,11,2,13
5672,2023-01-09,NITA,heist,Snaked Assault,148,130,278
5673,2023-01-09,NITA,gemGrab,Minecart Madness,7,0,7
5674,2023-01-09,NITA,gemGrab,Double Swoosh,16,14,30
5675,2023-01-09,NITA,brawlBall,Center Stage,55,52,107
5676,2023-01-09,NITA,brawlBall,Backyard Bowl,3,0,3
5677,2023-01-09,NITA,bounty,Layer Cake,3,0,3
5678,2023-01-08,NITA,hotZone,Ring of Fire,11,1,12
5679,2023-01-08,NITA,heist,Snaked Assault,110,88,198
5680,2023-01-08,NITA,gemGrab,Hard Rock Mine,14,13,27
5681,2023-01-08,NITA,gemGrab,Double Swoosh,13,7,20
5682,2023-01-08,NITA,brawlBall,Super Beach,18,9,27
5683,2023-01-08,NITA,brawlBall,Backyard Bowl,16,5,21
5684,2023-01-08,NITA,bounty,Layer Cake,1,0,1
5685,2023-01-07,NITA,hotZone,Ring of Fire,4,0,4
5686,2023-01-07,NITA,heist,Tornado Ring,115,124,239
5687,2023-01-07,NITA,gemGrab,Hard Rock Mine,14,6,20
5688,2023-01-07,NITA,gemGrab,Deep Diner,21,27,48
5689,2023-01-07,NITA,brawlBall,Super Beach,52,45,97
5690,2023-01-07,NITA,brawlBall,Sneaky Fields,6,3,9
5691,2023-01-07,NITA,bounty,Dry Season,2,0,2
5692,2023-01-06,NITA,knockout,Out in the Open,1,0,1
5693,2023-01-06,NITA,hotZone,Split,19,4,23
5694,2023-01-06,NITA,heist,Tornado Ring,202,211,413
5695,2023-01-06,NITA,gemGrab,Undermine,5,0,5
5696,2023-01-06,NITA,gemGrab,Deep Diner,29,24,53
5697,2023-01-06,NITA,brawlBall,Sneaky Fields,121,136,257
5698,2023-01-06,NITA,brawlBall,Pinhole Punt,4,1,5
5699,2023-01-05,NITA,knockout,Out in the Open,2,0,2
5700,2023-01-05,NITA,hotZone,Split,32,11,43
5701,2023-01-05,NITA,heist,Kaboom Canyon,25,8,33
5702,2023-01-05,NITA,gemGrab,Undermine,15,20,35
5703,2023-01-05,NITA,gemGrab,Gem Fort,4,4,8
5704,2023-01-05,NITA,brawlBall,Sunny Soccer,0,1,1
5705,2023-01-05,NITA,brawlBall,Pinhole Punt,47,32,79
5706,2023-01-04,NITA,knockout,Goldarm Gulch,2,0,2
5707,2023-01-04,NITA,hotZone,Parallel Plays,15,8,23
5708,2023-01-04,NITA,heist,Kaboom Canyon,36,6,42
5709,2023-01-04,NITA,gemGrab,Gem Fort,26,37,63
5710,2023-01-04,NITA,gemGrab,Crystal Arcade,7,12,19
5711,2023-01-04,NITA,brawlBall,Sunny Soccer,96,61,157
5712,2023-01-04,NITA,bounty,Shooting Star,1,0,1
5713,2023-01-03,NITA,knockout,Goldarm Gulch,1,1,2
5714,2023-01-03,NITA,hotZone,Parallel Plays,50,39,89
5715,2023-01-03,NITA,hotZone,Controller Chaos,0,1,1
5716,2023-01-03,NITA,heist,Pit Stop,147,103,250
5717,2023-01-03,NITA,gemGrab,Crystal Arcade,70,58,128
5718,2023-01-03,NITA,brawlBall,Center Stage,2,8,10
5719,2023-01-03,NITA,brawlBall,Beach Ball,67,64,131
5720,2023-01-03,NITA,bounty,Hideout,1,0,1
5721,2023-01-02,NITA,knockout,Belle's Rock,3,0,3
5722,2023-01-02,NITA,hotZone,Quarter Pounder,26,27,53
5723,2023-01-02,NITA,heist,Pit Stop,264,180,444
5724,2023-01-02,NITA,heist,Kaboom Canyon,3,1,4
5725,2023-01-02,NITA,gemGrab,Minecart Madness,10,2,12
5726,2023-01-02,NITA,gemGrab,Double Swoosh,26,21,47
5727,2023-01-02,NITA,brawlBall,Center Stage,95,79,174
5728,2023-01-02,NITA,brawlBall,Backyard Bowl,1,0,1
5729,2023-01-02,NITA,bounty,Hideout,0,1,1
5730,2023-01-01,NITA,hotZone,Quarter Pounder,20,5,25
5731,2023-01-01,NITA,heist,Bridge Too Far,2,0,2
5732,2023-01-01,NITA,gemGrab,Double Swoosh,14,3,17
5733,2023-01-01,NITA,brawlBall,Backyard Bowl,5,0,5
5734,2022-12-31,NITA,hotZone,Controller Chaos,3,1,4
5735,2022-12-31,NITA,heist,Kaboom Canyon,1,0,1
5736,2022-12-31,NITA,gemGrab,Minecart Madness,1,0,1
5737,2022-12-31,NITA,gemGrab,Hard Rock Mine,1,2,3
5738,2022-12-31,NITA,gemGrab,Deep Diner,2,0,2
5739,2022-12-31,NITA,brawlBall,Super Beach,6,2,8
5740,2022-12-31,NITA,brawlBall,Sneaky Fields,5,6,11
5741,2022-12-30,NITA,hotZone,Controller Chaos,5,1,6
5742,2022-12-30,NITA,heist,Hot Potato,1,3,4
5743,2022-12-30,NITA,gemGrab,Undermine,3,14,17
5744,2022-12-30,NITA,gemGrab,Minecart Madness,0,1,1
5745,2022-12-30,NITA,gemGrab,Deep Diner,5,9,14
5746,2022-12-30,NITA,brawlBall,Sneaky Fields,17,19,36
5747,2022-12-29,NITA,heist,Kaboom Canyon,1,0,1
5748,2022-12-29,NITA,heist,Hot Potato,1,3,4
5749,2022-12-29,NITA,gemGrab,Undermine,1,1,2
5750,2022-12-29,NITA,brawlBall,Pinhole Punt,4,0,4
5751,2022-12-27,NITA,hotZone,Controller Chaos,1,0,1
5752,2022-12-27,NITA,heist,Kaboom Canyon,0,1,1
5753,2022-12-27,NITA,brawlBall,Center Stage,2,1,3
5754,2022-12-27,NITA,brawlBall,Beach Ball,1,0,1
5755,2022-12-26,NITA,heist,Kaboom Canyon,2,0,2
5756,2022-12-26,NITA,gemGrab,Minecart Madness,1,0,1
5757,2022-12-26,NITA,brawlBall,Center Stage,1,2,3
5758,2022-12-24,NITA,brawlBall,Super Beach,1,1,2
5759,2022-12-23,NITA,brawlBall,Sneaky Fields,1,1,2
5760,2022-12-22,NITA,gemGrab,Gem Fort,1,0,1
5761,2022-12-22,NITA,brawlBall,Pinhole Punt,2,0,2
5762,2022-12-21,NITA,brawlBall,Sunny Soccer,2,0,2
5763,2022-12-20,NITA,brawlBall,Beach Ball,1,1,2
5764,2022-12-19,NITA,brawlBall,Center Stage,1,2,3
5765,2022-12-16,NITA,brawlBall,Sneaky Fields,1,0,1
5766,2022-12-13,NITA,heist,Safe Zone,1,0,1
5767,2022-12-13,NITA,gemGrab,Crystal Arcade,1,1,2
5768,2022-12-13,NITA,brawlBall,Beach Ball,2,0,2
5769,2022-12-10,NITA,gemGrab,Hard Rock Mine,1,1,2
5770,2022-11-11,NITA,brawlBall,Sneaky Fields,1,2,3
5771,2022-11-03,NITA,brawlBall,Pinhole Punt,1,0,1
5772,2022-10-28,NITA,bounty,Canal Grande,1,0,1
5773,2022-10-15,NITA,gemGrab,Hard Rock Mine,0,1,1
5774,2023-02-05,NANI,knockout,X Marks the Spot,146,183,329
5775,2023-02-05,NANI,knockout,Goldarm Gulch,3,1,4
5776,2023-02-05,NANI,hotZone,Ring of Fire,7,5,12
5777,2023-02-05,NANI,heist,Snaked Assault,2,1,3
5778,2023-02-05,NANI,heist,Pit Stop,1,1,2
5779,2023-02-05,NANI,gemGrab,Hard Rock Mine,3,4,7
5780,2023-02-05,NANI,gemGrab,Double Swoosh,14,8,22
5781,2023-02-05,NANI,brawlBall,Super Beach,0,1,1
5782,2023-02-05,NANI,brawlBall,Sneaky Fields,2,0,2
5783,2023-02-05,NANI,brawlBall,Backyard Bowl,229,241,470
5784,2023-02-05,NANI,bounty,Layer Cake,15,9,24
5785,2023-02-04,NANI,knockout,X Marks the Spot,47,53,100
5786,2023-02-04,NANI,knockout,Goldarm Gulch,3,0,3
5787,2023-02-04,NANI,hotZone,Ring of Fire,1,0,1
5788,2023-02-04,NANI,heist,Tornado Ring,2,0,2
5789,2023-02-04,NANI,gemGrab,Hard Rock Mine,3,0,3
5790,2023-02-04,NANI,gemGrab,Double Swoosh,2,0,2
5791,2023-02-04,NANI,gemGrab,Deep Diner,1,2,3
5792,2023-02-04,NANI,brawlBall,Super Beach,6,2,8
5793,2023-02-04,NANI,brawlBall,Sneaky Fields,1,0,1
5794,2023-02-04,NANI,bounty,Dry Season,9,13,22
5795,2023-02-03,NANI,knockout,Out in the Open,108,113,221
5796,2023-02-03,NANI,knockout,Goldarm Gulch,18,13,31
5797,2023-02-03,NANI,hotZone,Split,6,1,7
5798,2023-02-03,NANI,heist,Tornado Ring,7,1,8
5799,2023-02-03,NANI,heist,Pit Stop,2,1,3
5800,2023-02-03,NANI,gemGrab,Undermine,15,4,19
5801,2023-02-03,NANI,gemGrab,Double Swoosh,24,6,30
5802,2023-02-03,NANI,gemGrab,Deep Diner,15,8,23
5803,2023-02-03,NANI,brawlBall,Sneaky Fields,38,23,61
5804,2023-02-03,NANI,brawlBall,Pinhole Punt,2,5,7
5805,2023-02-03,NANI,bounty,Dry Season,185,185,370
5806,2023-02-02,NANI,knockout,Out in the Open,68,82,150
5807,2023-02-02,NANI,hotZone,Split,2,1,3
5808,2023-02-02,NANI,heist,Kaboom Canyon,1,8,9
5809,2023-02-02,NANI,gemGrab,Undermine,2,0,2
5810,2023-02-02,NANI,gemGrab,Gem Fort,1,0,1
5811,2023-02-02,NANI,brawlBall,Sunny Soccer,1,1,2
5812,2023-02-02,NANI,brawlBall,Pinhole Punt,27,15,42
5813,2023-02-02,NANI,bounty,Shooting Star,97,190,287
5814,2023-02-01,NANI,knockout,Goldarm Gulch,39,45,84
5815,2023-02-01,NANI,hotZone,Parallel Plays,11,4,15
5816,2023-02-01,NANI,heist,Kaboom Canyon,33,39,72
5817,2023-02-01,NANI,gemGrab,Gem Fort,10,5,15
5818,2023-02-01,NANI,gemGrab,Crystal Arcade,3,1,4
5819,2023-02-01,NANI,brawlBall,Sunny Soccer,21,13,34
5820,2023-02-01,NANI,bounty,Shooting Star,340,445,785
5821,2023-01-31,NANI,knockout,Goldarm Gulch,29,22,51
5822,2023-01-31,NANI,hotZone,Parallel Plays,5,1,6
5823,2023-01-31,NANI,heist,Pit Stop,0,3,3
5824,2023-01-31,NANI,gemGrab,Minecart Madness,4,2,6
5825,2023-01-31,NANI,gemGrab,Crystal Arcade,6,2,8
5826,2023-01-31,NANI,brawlBall,Beach Ball,16,9,25
5827,2023-01-31,NANI,bounty,Hideout,79,95,174
5828,2023-01-30,NANI,knockout,Belle's Rock,56,55,111
5829,2023-01-30,NANI,hotZone,Quarter Pounder,6,1,7
5830,2023-01-30,NANI,heist,Pit Stop,2,0,2
5831,2023-01-30,NANI,gemGrab,Minecart Madness,23,16,39
5832,2023-01-30,NANI,gemGrab,Double Swoosh,6,2,8
5833,2023-01-30,NANI,brawlBall,Center Stage,23,25,48
5834,2023-01-30,NANI,brawlBall,Backyard Bowl,16,18,34
5835,2023-01-30,NANI,bounty,Hideout,131,200,331
5836,2023-01-29,NANI,knockout,Belle's Rock,61,67,128
5837,2023-01-29,NANI,hotZone,Quarter Pounder,9,11,20
5838,2023-01-29,NANI,heist,Bridge Too Far,112,91,203
5839,2023-01-29,NANI,gemGrab,Hard Rock Mine,0,3,3
5840,2023-01-29,NANI,gemGrab,Double Swoosh,13,3,16
5841,2023-01-29,NANI,brawlBall,Backyard Bowl,210,218,428
5842,2023-01-29,NANI,bounty,Canal Grande,8,25,33
5843,2023-01-28,NANI,knockout,Flaring Phoenix,39,20,59
5844,2023-01-28,NANI,hotZone,Controller Chaos,3,1,4
5845,2023-01-28,NANI,heist,Bridge Too Far,239,336,575
5846,2023-01-28,NANI,gemGrab,Hard Rock Mine,15,9,24
5847,2023-01-28,NANI,gemGrab,Deep Diner,4,3,7
5848,2023-01-28,NANI,brawlBall,Super Beach,38,25,63
5849,2023-01-28,NANI,brawlBall,Sneaky Fields,1,1,2
5850,2023-01-28,NANI,bounty,Canal Grande,7,4,11
5851,2023-01-27,NANI,knockout,Flaring Phoenix,15,10,25
5852,2023-01-27,NANI,hotZone,Controller Chaos,1,0,1
5853,2023-01-27,NANI,heist,Hot Potato,5,0,5
5854,2023-01-27,NANI,gemGrab,Undermine,1,2,3
5855,2023-01-27,NANI,gemGrab,Deep Diner,5,1,6
5856,2023-01-27,NANI,brawlBall,Sneaky Fields,3,12,15
5857,2023-01-27,NANI,bounty,Temple Ruins,5,4,9
5858,2023-01-26,NANI,knockout,Riverside,741,1129,1870
5859,2023-01-26,NANI,hotZone,Open Zone,24,10,34
5860,2023-01-26,NANI,heist,Hot Potato,6,4,10
5861,2023-01-26,NANI,gemGrab,Undermine,6,2,8
5862,2023-01-26,NANI,gemGrab,Gem Fort,2,3,5
5863,2023-01-26,NANI,brawlBall,Sunny Soccer,1,2,3
5864,2023-01-26,NANI,brawlBall,Pinhole Punt,61,45,106
5865,2023-01-26,NANI,bounty,Temple Ruins,16,11,27
5866,2023-01-25,NANI,knockout,Riverside,487,687,1174
5867,2023-01-25,NANI,hotZone,Open Zone,4,9,13
5868,2023-01-25,NANI,heist,Safe Zone,12,13,25
5869,2023-01-25,NANI,gemGrab,Gem Fort,4,1,5
5870,2023-01-25,NANI,gemGrab,Crystal Arcade,7,4,11
5871,2023-01-25,NANI,brawlBall,Sunny Soccer,22,5,27
5872,2023-01-25,NANI,brawlBall,Beach Ball,1,11,12
5873,2023-01-25,NANI,bounty,Excel,12,7,19
5874,2023-01-24,NANI,knockout,New Perspective,73,90,163
5875,2023-01-24,NANI,hotZone,Dueling Beetles,8,4,12
5876,2023-01-24,NANI,heist,Safe Zone,36,36,72
5877,2023-01-24,NANI,gemGrab,Minecart Madness,5,6,11
5878,2023-01-24,NANI,gemGrab,Crystal Arcade,12,4,16
5879,2023-01-24,NANI,brawlBall,Center Stage,5,0,5
5880,2023-01-24,NANI,brawlBall,Beach Ball,33,13,46
5881,2023-01-24,NANI,bounty,Excel,23,16,39
5882,2023-01-23,NANI,knockout,New Perspective,99,91,190
5883,2023-01-23,NANI,hotZone,Dueling Beetles,2,0,2
5884,2023-01-23,NANI,heist,Snaked Assault,8,1,9
5885,2023-01-23,NANI,gemGrab,Minecart Madness,28,41,69
5886,2023-01-23,NANI,gemGrab,Double Swoosh,5,1,6
5887,2023-01-23,NANI,brawlBall,Center Stage,44,32,76
5888,2023-01-23,NANI,brawlBall,Backyard Bowl,18,21,39
5889,2023-01-23,NANI,bounty,Layer Cake,26,26,52
5890,2023-01-22,NANI,knockout,X Marks the Spot,115,159,274
5891,2023-01-22,NANI,hotZone,Ring of Fire,8,1,9
5892,2023-01-22,NANI,heist,Snaked Assault,10,12,22
5893,2023-01-22,NANI,gemGrab,Hard Rock Mine,1,1,2
5894,2023-01-22,NANI,gemGrab,Double Swoosh,5,2,7
5895,2023-01-22,NANI,brawlBall,Super Beach,1,0,1
5896,2023-01-22,NANI,brawlBall,Backyard Bowl,118,120,238
5897,2023-01-22,NANI,bounty,Layer Cake,5,11,16
5898,2023-01-21,NANI,knockout,X Marks the Spot,369,498,867
5899,2023-01-21,NANI,hotZone,Ring of Fire,9,4,13
5900,2023-01-21,NANI,heist,Tornado Ring,2,2,4
5901,2023-01-21,NANI,gemGrab,Hard Rock Mine,17,12,29
5902,2023-01-21,NANI,gemGrab,Deep Diner,2,0,2
5903,2023-01-21,NANI,brawlBall,Super Beach,35,32,67
5904,2023-01-21,NANI,brawlBall,Sneaky Fields,2,0,2
5905,2023-01-21,NANI,bounty,Dry Season,118,134,252
5906,2023-01-20,NANI,knockout,Out in the Open,150,154,304
5907,2023-01-20,NANI,hotZone,Split,1,1,2
5908,2023-01-20,NANI,heist,Tornado Ring,7,2,9
5909,2023-01-20,NANI,gemGrab,Undermine,5,2,7
5910,2023-01-20,NANI,gemGrab,Deep Diner,29,18,47
5911,2023-01-20,NANI,brawlBall,Sneaky Fields,16,7,23
5912,2023-01-20,NANI,brawlBall,Pinhole Punt,1,8,9
5913,2023-01-20,NANI,bounty,Dry Season,87,93,180
5914,2023-01-19,NANI,knockout,Out in the Open,164,169,333
5915,2023-01-19,NANI,hotZone,Split,6,3,9
5916,2023-01-19,NANI,heist,Kaboom Canyon,42,61,103
5917,2023-01-19,NANI,gemGrab,Undermine,10,12,22
5918,2023-01-19,NANI,gemGrab,Gem Fort,1,1,2
5919,2023-01-19,NANI,brawlBall,Sunny Soccer,1,0,1
5920,2023-01-19,NANI,brawlBall,Pinhole Punt,53,45,98
5921,2023-01-19,NANI,bounty,Shooting Star,411,553,964
5922,2023-01-18,NANI,knockout,Goldarm Gulch,9,10,19
5923,2023-01-18,NANI,hotZone,Parallel Plays,2,1,3
5924,2023-01-18,NANI,heist,Kaboom Canyon,12,8,20
5925,2023-01-18,NANI,gemGrab,Gem Fort,3,0,3
5926,2023-01-18,NANI,brawlBall,Sunny Soccer,13,3,16
5927,2023-01-18,NANI,bounty,Shooting Star,212,226,438
5928,2023-01-17,NANI,knockout,Goldarm Gulch,2,3,5
5929,2023-01-17,NANI,heist,Pit Stop,1,0,1
5930,2023-01-17,NANI,gemGrab,Minecart Madness,0,1,1
5931,2023-01-17,NANI,brawlBall,Beach Ball,4,4,8
5932,2023-01-17,NANI,bounty,Hideout,25,22,47
5933,2023-01-16,NANI,knockout,Belle's Rock,3,2,5
5934,2023-01-16,NANI,hotZone,Quarter Pounder,2,0,2
5935,2023-01-16,NANI,gemGrab,Minecart Madness,3,5,8
5936,2023-01-16,NANI,brawlBall,Center Stage,5,1,6
5937,2023-01-16,NANI,brawlBall,Backyard Bowl,1,3,4
5938,2023-01-16,NANI,bounty,Hideout,27,56,83
5939,2023-01-15,NANI,knockout,Belle's Rock,5,2,7
5940,2023-01-15,NANI,hotZone,Quarter Pounder,1,1,2
5941,2023-01-15,NANI,heist,Bridge Too Far,21,37,58
5942,2023-01-15,NANI,gemGrab,Hard Rock Mine,0,1,1
5943,2023-01-15,NANI,gemGrab,Double Swoosh,1,0,1
5944,2023-01-15,NANI,brawlBall,Backyard Bowl,24,24,48
5945,2023-01-15,NANI,bounty,Canal Grande,1,0,1
5946,2023-01-14,NANI,knockout,Flaring Phoenix,3,1,4
5947,2023-01-14,NANI,hotZone,Controller Chaos,5,0,5
5948,2023-01-14,NANI,heist,Bridge Too Far,47,50,97
5949,2023-01-14,NANI,gemGrab,Deep Diner,3,8,11
5950,2023-01-14,NANI,brawlBall,Super Beach,2,0,2
5951,2023-01-14,NANI,brawlBall,Sneaky Fields,1,0,1
5952,2023-01-14,NANI,bounty,Canal Grande,1,0,1
5953,2023-01-13,NANI,knockout,Flaring Phoenix,7,3,10
5954,2023-01-13,NANI,hotZone,Controller Chaos,2,0,2
5955,2023-01-13,NANI,gemGrab,Deep Diner,1,1,2
5956,2023-01-13,NANI,brawlBall,Sneaky Fields,1,1,2
5957,2023-01-13,NANI,bounty,Temple Ruins,1,1,2
5958,2023-01-12,NANI,knockout,Riverside,131,158,289
5959,2023-01-12,NANI,brawlBall,Pinhole Punt,1,0,1
5960,2023-01-11,NANI,knockout,Riverside,37,49,86
5961,2023-01-11,NANI,hotZone,Open Zone,1,1,2
5962,2023-01-11,NANI,bounty,Excel,1,0,1
5963,2023-01-10,NANI,knockout,New Perspective,4,3,7
5964,2023-01-10,NANI,heist,Safe Zone,1,1,2
5965,2023-01-10,NANI,gemGrab,Minecart Madness,4,14,18
5966,2023-01-10,NANI,gemGrab,Crystal Arcade,3,2,5
5967,2023-01-10,NANI,brawlBall,Beach Ball,2,0,2
5968,2023-01-09,NANI,knockout,New Perspective,2,2,4
5969,2023-01-09,NANI,gemGrab,Minecart Madness,2,5,7
5970,2023-01-09,NANI,brawlBall,Backyard Bowl,2,2,4
5971,2023-01-09,NANI,bounty,Layer Cake,2,1,3
5972,2023-01-08,NANI,knockout,X Marks the Spot,23,12,35
5973,2023-01-08,NANI,hotZone,Ring of Fire,1,0,1
5974,2023-01-08,NANI,brawlBall,Super Beach,1,1,2
5975,2023-01-08,NANI,brawlBall,Backyard Bowl,5,16,21
5976,2023-01-08,NANI,bounty,Layer Cake,1,1,2
5977,2023-01-07,NANI,knockout,X Marks the Spot,11,2,13
5978,2023-01-07,NANI,gemGrab,Hard Rock Mine,2,0,2
5979,2023-01-07,NANI,gemGrab,Deep Diner,1,0,1
5980,2023-01-07,NANI,brawlBall,Super Beach,1,0,1
5981,2023-01-07,NANI,bounty,Dry Season,8,5,13
5982,2023-01-06,NANI,knockout,Out in the Open,5,1,6
5983,2023-01-06,NANI,bounty,Dry Season,10,15,25
5984,2023-01-05,NANI,knockout,Out in the Open,18,11,29
5985,2023-01-05,NANI,heist,Kaboom Canyon,2,1,3
5986,2023-01-05,NANI,gemGrab,Undermine,0,1,1
5987,2023-01-05,NANI,brawlBall,Pinhole Punt,1,0,1
5988,2023-01-05,NANI,bounty,Shooting Star,74,139,213
5989,2023-01-04,NANI,knockout,Goldarm Gulch,0,2,2
5990,2023-01-04,NANI,heist,Kaboom Canyon,5,10,15
5991,2023-01-04,NANI,brawlBall,Sunny Soccer,0,1,1
5992,2023-01-04,NANI,bounty,Shooting Star,235,329,564
5993,2023-01-03,NANI,knockout,Goldarm Gulch,1,4,5
5994,2023-01-03,NANI,gemGrab,Crystal Arcade,1,0,1
5995,2023-01-03,NANI,brawlBall,Beach Ball,2,0,2
5996,2023-01-03,NANI,bounty,Hideout,29,48,77
5997,2023-01-02,NANI,knockout,Belle's Rock,9,8,17
5998,2023-01-02,NANI,hotZone,Quarter Pounder,1,2,3
5999,2023-01-02,NANI,gemGrab,Minecart Madness,1,0,1
6000,2023-01-02,NANI,brawlBall,Center Stage,2,0,2
6001,2023-01-02,NANI,brawlBall,Backyard Bowl,0,1,1
6002,2023-01-02,NANI,bounty,Hideout,66,50,116
6003,2023-01-01,NANI,hotZone,Quarter Pounder,12,13,25
6004,2023-01-01,NANI,heist,Bridge Too Far,4,3,7
6005,2023-01-01,NANI,gemGrab,Double Swoosh,1,0,1
6006,2023-01-01,NANI,brawlBall,Backyard Bowl,8,3,11
6007,2022-12-31,NANI,heist,Bridge Too Far,2,1,3
6008,2022-12-30,NANI,knockout,Flaring Phoenix,0,1,1
6009,2022-12-29,NANI,heist,Kaboom Canyon,1,0,1
6010,2022-12-24,NANI,knockout,X Marks the Spot,0,1,1
6011,2022-12-22,NANI,brawlBall,Pinhole Punt,1,0,1
6012,2022-12-13,NANI,knockout,New Perspective,2,13,15
6013,2022-11-01,NANI,knockout,New Perspective,2,1,3
6014,2022-10-26,NANI,bounty,Shooting Star,4,4,8
6015,2022-10-15,NANI,gemGrab,Hard Rock Mine,0,1,1
6016,2023-02-05,MR. P,knockout,X Marks the Spot,48,55,103
6017,2023-02-05,MR. P,knockout,Goldarm Gulch,14,8,22
6018,2023-02-05,MR. P,hotZone,Ring of Fire,11,8,19
6019,2023-02-05,MR. P,heist,Snaked Assault,5,4,9
6020,2023-02-05,MR. P,heist,Pit Stop,4,0,4
6021,2023-02-05,MR. P,gemGrab,Hard Rock Mine,4,8,12
6022,2023-02-05,MR. P,gemGrab,Double Swoosh,43,65,108
6023,2023-02-05,MR. P,brawlBall,Super Beach,1,5,6
6024,2023-02-05,MR. P,brawlBall,Sneaky Fields,4,0,4
6025,2023-02-05,MR. P,brawlBall,Backyard Bowl,83,117,200
6026,2023-02-05,MR. P,bounty,Layer Cake,51,78,129
6027,2023-02-04,MR. P,knockout,X Marks the Spot,33,66,99
6028,2023-02-04,MR. P,knockout,Goldarm Gulch,9,7,16
6029,2023-02-04,MR. P,hotZone,Ring of Fire,1,2,3
6030,2023-02-04,MR. P,heist,Tornado Ring,2,2,4
6031,2023-02-04,MR. P,heist,Pit Stop,1,0,1
6032,2023-02-04,MR. P,gemGrab,Hard Rock Mine,9,7,16
6033,2023-02-04,MR. P,gemGrab,Double Swoosh,7,2,9
6034,2023-02-04,MR. P,gemGrab,Deep Diner,5,1,6
6035,2023-02-04,MR. P,brawlBall,Super Beach,15,21,36
6036,2023-02-04,MR. P,bounty,Dry Season,26,19,45
6037,2023-02-03,MR. P,knockout,Out in the Open,104,117,221
6038,2023-02-03,MR. P,knockout,Goldarm Gulch,47,34,81
6039,2023-02-03,MR. P,hotZone,Split,11,8,19
6040,2023-02-03,MR. P,heist,Tornado Ring,6,3,9
6041,2023-02-03,MR. P,heist,Pit Stop,8,0,8
6042,2023-02-03,MR. P,gemGrab,Undermine,14,6,20
6043,2023-02-03,MR. P,gemGrab,Double Swoosh,29,28,57
6044,2023-02-03,MR. P,gemGrab,Deep Diner,55,50,105
6045,2023-02-03,MR. P,brawlBall,Sneaky Fields,31,32,63
6046,2023-02-03,MR. P,brawlBall,Pinhole Punt,4,0,4
6047,2023-02-03,MR. P,bounty,Dry Season,140,223,363
6048,2023-02-02,MR. P,knockout,Out in the Open,34,46,80
6049,2023-02-02,MR. P,hotZone,Split,5,4,9
6050,2023-02-02,MR. P,heist,Kaboom Canyon,5,2,7
6051,2023-02-02,MR. P,gemGrab,Undermine,5,7,12
6052,2023-02-02,MR. P,gemGrab,Gem Fort,1,2,3
6053,2023-02-02,MR. P,brawlBall,Sunny Soccer,2,1,3
6054,2023-02-02,MR. P,brawlBall,Pinhole Punt,23,35,58
6055,2023-02-02,MR. P,bounty,Shooting Star,19,27,46
6056,2023-02-01,MR. P,knockout,Goldarm Gulch,112,145,257
6057,2023-02-01,MR. P,hotZone,Parallel Plays,20,13,33
6058,2023-02-01,MR. P,heist,Kaboom Canyon,9,8,17
6059,2023-02-01,MR. P,gemGrab,Gem Fort,36,34,70
6060,2023-02-01,MR. P,gemGrab,Crystal Arcade,26,23,49
6061,2023-02-01,MR. P,brawlBall,Sunny Soccer,47,56,103
6062,2023-02-01,MR. P,brawlBall,Beach Ball,3,5,8
6063,2023-02-01,MR. P,bounty,Shooting Star,30,39,69
6064,2023-01-31,MR. P,knockout,Goldarm Gulch,53,48,101
6065,2023-01-31,MR. P,hotZone,Parallel Plays,16,17,33
6066,2023-01-31,MR. P,heist,Pit Stop,7,2,9
6067,2023-01-31,MR. P,gemGrab,Minecart Madness,5,3,8
6068,2023-01-31,MR. P,gemGrab,Crystal Arcade,29,21,50
6069,2023-01-31,MR. P,brawlBall,Center Stage,2,1,3
6070,2023-01-31,MR. P,brawlBall,Beach Ball,28,32,60
6071,2023-01-31,MR. P,bounty,Hideout,20,11,31
6072,2023-01-30,MR. P,knockout,Belle's Rock,154,156,310
6073,2023-01-30,MR. P,hotZone,Quarter Pounder,40,14,54
6074,2023-01-30,MR. P,heist,Pit Stop,7,4,11
6075,2023-01-30,MR. P,gemGrab,Minecart Madness,46,47,93
6076,2023-01-30,MR. P,gemGrab,Double Swoosh,24,30,54
6077,2023-01-30,MR. P,brawlBall,Center Stage,50,54,104
6078,2023-01-30,MR. P,brawlBall,Backyard Bowl,15,11,26
6079,2023-01-30,MR. P,bounty,Hideout,21,13,34
6080,2023-01-29,MR. P,knockout,Belle's Rock,163,215,378
6081,2023-01-29,MR. P,hotZone,Quarter Pounder,20,14,34
6082,2023-01-29,MR. P,heist,Bridge Too Far,16,11,27
6083,2023-01-29,MR. P,gemGrab,Hard Rock Mine,11,7,18
6084,2023-01-29,MR. P,gemGrab,Double Swoosh,34,36,70
6085,2023-01-29,MR. P,brawlBall,Backyard Bowl,83,115,198
6086,2023-01-29,MR. P,bounty,Canal Grande,45,40,85
6087,2023-01-28,MR. P,knockout,Flaring Phoenix,70,75,145
6088,2023-01-28,MR. P,hotZone,Controller Chaos,16,9,25
6089,2023-01-28,MR. P,heist,Bridge Too Far,37,40,77
6090,2023-01-28,MR. P,gemGrab,Hard Rock Mine,44,56,100
6091,2023-01-28,MR. P,gemGrab,Deep Diner,21,30,51
6092,2023-01-28,MR. P,brawlBall,Super Beach,49,63,112
6093,2023-01-28,MR. P,brawlBall,Sneaky Fields,5,4,9
6094,2023-01-28,MR. P,bounty,Canal Grande,80,100,180
6095,2023-01-27,MR. P,knockout,Flaring Phoenix,24,15,39
6096,2023-01-27,MR. P,hotZone,Controller Chaos,8,4,12
6097,2023-01-27,MR. P,heist,Hot Potato,4,8,12
6098,2023-01-27,MR. P,gemGrab,Undermine,5,3,8
6099,2023-01-27,MR. P,gemGrab,Deep Diner,50,51,101
6100,2023-01-27,MR. P,brawlBall,Sneaky Fields,16,11,27
6101,2023-01-27,MR. P,brawlBall,Pinhole Punt,1,0,1
6102,2023-01-27,MR. P,bounty,Temple Ruins,8,7,15
6103,2023-01-26,MR. P,knockout,Riverside,98,125,223
6104,2023-01-26,MR. P,hotZone,Open Zone,27,11,38
6105,2023-01-26,MR. P,heist,Hot Potato,7,3,10
6106,2023-01-26,MR. P,gemGrab,Undermine,27,57,84
6107,2023-01-26,MR. P,gemGrab,Gem Fort,8,6,14
6108,2023-01-26,MR. P,brawlBall,Sunny Soccer,4,9,13
6109,2023-01-26,MR. P,brawlBall,Pinhole Punt,69,68,137
6110,2023-01-26,MR. P,bounty,Temple Ruins,21,30,51
6111,2023-01-25,MR. P,knockout,Riverside,40,45,85
6112,2023-01-25,MR. P,hotZone,Open Zone,6,3,9
6113,2023-01-25,MR. P,heist,Safe Zone,9,4,13
6114,2023-01-25,MR. P,gemGrab,Gem Fort,20,12,32
6115,2023-01-25,MR. P,gemGrab,Crystal Arcade,28,35,63
6116,2023-01-25,MR. P,brawlBall,Sunny Soccer,28,39,67
6117,2023-01-25,MR. P,brawlBall,Beach Ball,5,4,9
6118,2023-01-25,MR. P,bounty,Excel,43,54,97
6119,2023-01-24,MR. P,knockout,New Perspective,40,42,82
6120,2023-01-24,MR. P,hotZone,Dueling Beetles,21,21,42
6121,2023-01-24,MR. P,heist,Safe Zone,24,6,30
6122,2023-01-24,MR. P,gemGrab,Minecart Madness,21,26,47
6123,2023-01-24,MR. P,gemGrab,Crystal Arcade,30,32,62
6124,2023-01-24,MR. P,brawlBall,Center Stage,3,2,5
6125,2023-01-24,MR. P,brawlBall,Beach Ball,74,86,160
6126,2023-01-24,MR. P,bounty,Excel,86,107,193
6127,2023-01-23,MR. P,knockout,New Perspective,57,73,130
6128,2023-01-23,MR. P,hotZone,Dueling Beetles,24,17,41
6129,2023-01-23,MR. P,heist,Snaked Assault,14,13,27
6130,2023-01-23,MR. P,gemGrab,Minecart Madness,78,82,160
6131,2023-01-23,MR. P,gemGrab,Double Swoosh,14,22,36
6132,2023-01-23,MR. P,brawlBall,Center Stage,73,89,162
6133,2023-01-23,MR. P,brawlBall,Backyard Bowl,3,4,7
6134,2023-01-23,MR. P,bounty,Layer Cake,89,88,177
6135,2023-01-22,MR. P,knockout,X Marks the Spot,26,39,65
6136,2023-01-22,MR. P,hotZone,Ring of Fire,5,5,10
6137,2023-01-22,MR. P,heist,Snaked Assault,2,2,4
6138,2023-01-22,MR. P,gemGrab,Hard Rock Mine,12,11,23
6139,2023-01-22,MR. P,gemGrab,Double Swoosh,17,24,41
6140,2023-01-22,MR. P,brawlBall,Super Beach,6,11,17
6141,2023-01-22,MR. P,brawlBall,Backyard Bowl,58,67,125
6142,2023-01-22,MR. P,bounty,Layer Cake,48,36,84
6143,2023-01-21,MR. P,knockout,X Marks the Spot,143,174,317
6144,2023-01-21,MR. P,hotZone,Ring of Fire,13,10,23
6145,2023-01-21,MR. P,heist,Tornado Ring,5,2,7
6146,2023-01-21,MR. P,gemGrab,Hard Rock Mine,41,42,83
6147,2023-01-21,MR. P,gemGrab,Deep Diner,22,43,65
6148,2023-01-21,MR. P,brawlBall,Super Beach,86,87,173
6149,2023-01-21,MR. P,brawlBall,Sneaky Fields,2,1,3
6150,2023-01-21,MR. P,bounty,Dry Season,113,141,254
6151,2023-01-20,MR. P,knockout,Out in the Open,79,109,188
6152,2023-01-20,MR. P,hotZone,Split,13,9,22
6153,2023-01-20,MR. P,heist,Tornado Ring,8,9,17
6154,2023-01-20,MR. P,gemGrab,Undermine,14,21,35
6155,2023-01-20,MR. P,gemGrab,Deep Diner,68,91,159
6156,2023-01-20,MR. P,brawlBall,Sneaky Fields,31,35,66
6157,2023-01-20,MR. P,brawlBall,Pinhole Punt,1,0,1
6158,2023-01-20,MR. P,bounty,Dry Season,91,94,185
6159,2023-01-19,MR. P,knockout,Out in the Open,87,60,147
6160,2023-01-19,MR. P,hotZone,Split,12,7,19
6161,2023-01-19,MR. P,heist,Kaboom Canyon,10,15,25
6162,2023-01-19,MR. P,gemGrab,Undermine,50,81,131
6163,2023-01-19,MR. P,gemGrab,Gem Fort,12,16,28
6164,2023-01-19,MR. P,brawlBall,Sunny Soccer,2,2,4
6165,2023-01-19,MR. P,brawlBall,Pinhole Punt,59,77,136
6166,2023-01-19,MR. P,bounty,Shooting Star,40,81,121
6167,2023-01-18,MR. P,knockout,Goldarm Gulch,18,13,31
6168,2023-01-18,MR. P,hotZone,Parallel Plays,1,2,3
6169,2023-01-18,MR. P,heist,Kaboom Canyon,1,2,3
6170,2023-01-18,MR. P,gemGrab,Gem Fort,7,7,14
6171,2023-01-18,MR. P,gemGrab,Crystal Arcade,1,1,2
6172,2023-01-18,MR. P,brawlBall,Sunny Soccer,13,29,42
6173,2023-01-18,MR. P,bounty,Shooting Star,28,38,66
6174,2023-01-17,MR. P,knockout,Goldarm Gulch,8,10,18
6175,2023-01-17,MR. P,hotZone,Parallel Plays,4,3,7
6176,2023-01-17,MR. P,gemGrab,Minecart Madness,1,0,1
6177,2023-01-17,MR. P,gemGrab,Crystal Arcade,5,10,15
6178,2023-01-17,MR. P,brawlBall,Beach Ball,12,11,23
6179,2023-01-17,MR. P,bounty,Hideout,4,8,12
6180,2023-01-16,MR. P,knockout,Belle's Rock,14,8,22
6181,2023-01-16,MR. P,hotZone,Quarter Pounder,1,4,5
6182,2023-01-16,MR. P,heist,Pit Stop,2,2,4
6183,2023-01-16,MR. P,gemGrab,Minecart Madness,2,12,14
6184,2023-01-16,MR. P,gemGrab,Double Swoosh,2,8,10
6185,2023-01-16,MR. P,brawlBall,Center Stage,4,3,7
6186,2023-01-16,MR. P,bounty,Hideout,2,5,7
6187,2023-01-15,MR. P,knockout,Belle's Rock,13,18,31
6188,2023-01-15,MR. P,hotZone,Quarter Pounder,5,1,6
6189,2023-01-15,MR. P,heist,Bridge Too Far,5,6,11
6190,2023-01-15,MR. P,gemGrab,Hard Rock Mine,2,0,2
6191,2023-01-15,MR. P,gemGrab,Double Swoosh,2,3,5
6192,2023-01-15,MR. P,brawlBall,Backyard Bowl,7,36,43
6193,2023-01-15,MR. P,bounty,Canal Grande,5,22,27
6194,2023-01-14,MR. P,knockout,Flaring Phoenix,8,17,25
6195,2023-01-14,MR. P,hotZone,Controller Chaos,7,2,9
6196,2023-01-14,MR. P,heist,Bridge Too Far,8,0,8
6197,2023-01-14,MR. P,gemGrab,Hard Rock Mine,1,1,2
6198,2023-01-14,MR. P,gemGrab,Deep Diner,5,3,8
6199,2023-01-14,MR. P,brawlBall,Super Beach,7,3,10
6200,2023-01-14,MR. P,bounty,Canal Grande,4,2,6
6201,2023-01-13,MR. P,knockout,Flaring Phoenix,8,17,25
6202,2023-01-13,MR. P,gemGrab,Deep Diner,8,1,9
6203,2023-01-13,MR. P,brawlBall,Sneaky Fields,3,7,10
6204,2023-01-13,MR. P,brawlBall,Pinhole Punt,1,0,1
6205,2023-01-13,MR. P,bounty,Temple Ruins,0,3,3
6206,2023-01-12,MR. P,knockout,Riverside,11,1,12
6207,2023-01-12,MR. P,hotZone,Open Zone,2,1,3
6208,2023-01-12,MR. P,gemGrab,Undermine,1,1,2
6209,2023-01-12,MR. P,brawlBall,Pinhole Punt,0,2,2
6210,2023-01-11,MR. P,hotZone,Open Zone,1,0,1
6211,2023-01-11,MR. P,heist,Safe Zone,1,0,1
6212,2023-01-11,MR. P,gemGrab,Gem Fort,1,0,1
6213,2023-01-11,MR. P,brawlBall,Sunny Soccer,3,2,5
6214,2023-01-11,MR. P,bounty,Excel,1,8,9
6215,2023-01-10,MR. P,knockout,New Perspective,8,6,14
6216,2023-01-10,MR. P,hotZone,Dueling Beetles,3,1,4
6217,2023-01-10,MR. P,heist,Safe Zone,2,0,2
6218,2023-01-10,MR. P,gemGrab,Minecart Madness,4,14,18
6219,2023-01-10,MR. P,gemGrab,Crystal Arcade,2,0,2
6220,2023-01-10,MR. P,brawlBall,Beach Ball,6,12,18
6221,2023-01-10,MR. P,bounty,Excel,2,2,4
6222,2023-01-09,MR. P,knockout,New Perspective,1,0,1
6223,2023-01-09,MR. P,hotZone,Dueling Beetles,4,10,14
6224,2023-01-09,MR. P,gemGrab,Minecart Madness,9,12,21
6225,2023-01-09,MR. P,gemGrab,Double Swoosh,2,11,13
6226,2023-01-09,MR. P,brawlBall,Center Stage,1,2,3
6227,2023-01-09,MR. P,bounty,Layer Cake,11,4,15
6228,2023-01-08,MR. P,knockout,X Marks the Spot,4,2,6
6229,2023-01-08,MR. P,hotZone,Ring of Fire,1,0,1
6230,2023-01-08,MR. P,heist,Snaked Assault,3,0,3
6231,2023-01-08,MR. P,gemGrab,Double Swoosh,9,41,50
6232,2023-01-08,MR. P,brawlBall,Backyard Bowl,4,14,18
6233,2023-01-07,MR. P,knockout,X Marks the Spot,3,11,14
6234,2023-01-07,MR. P,hotZone,Ring of Fire,3,1,4
6235,2023-01-07,MR. P,gemGrab,Deep Diner,2,1,3
6236,2023-01-07,MR. P,bounty,Dry Season,9,2,11
6237,2023-01-06,MR. P,knockout,Out in the Open,3,1,4
6238,2023-01-06,MR. P,hotZone,Split,1,0,1
6239,2023-01-06,MR. P,gemGrab,Deep Diner,5,3,8
6240,2023-01-06,MR. P,brawlBall,Sneaky Fields,0,5,5
6241,2023-01-06,MR. P,bounty,Dry Season,19,15,34
6242,2023-01-05,MR. P,knockout,Out in the Open,8,24,32
6243,2023-01-05,MR. P,gemGrab,Undermine,3,1,4
6244,2023-01-05,MR. P,gemGrab,Gem Fort,0,1,1
6245,2023-01-05,MR. P,brawlBall,Pinhole Punt,4,8,12
6246,2023-01-05,MR. P,bounty,Shooting Star,6,1,7
6247,2023-01-04,MR. P,knockout,Goldarm Gulch,0,1,1
6248,2023-01-04,MR. P,hotZone,Parallel Plays,1,0,1
6249,2023-01-04,MR. P,heist,Kaboom Canyon,1,0,1
6250,2023-01-04,MR. P,gemGrab,Crystal Arcade,1,3,4
6251,2023-01-04,MR. P,brawlBall,Sunny Soccer,3,2,5
6252,2023-01-04,MR. P,bounty,Shooting Star,18,5,23
6253,2023-01-03,MR. P,knockout,Goldarm Gulch,1,1,2
6254,2023-01-03,MR. P,hotZone,Parallel Plays,1,2,3
6255,2023-01-03,MR. P,heist,Pit Stop,1,0,1
6256,2023-01-03,MR. P,gemGrab,Crystal Arcade,4,5,9
6257,2023-01-03,MR. P,brawlBall,Center Stage,1,0,1
6258,2023-01-03,MR. P,brawlBall,Beach Ball,5,16,21
6259,2023-01-03,MR. P,bounty,Hideout,7,4,11
6260,2023-01-02,MR. P,knockout,Belle's Rock,14,4,18
6261,2023-01-02,MR. P,hotZone,Quarter Pounder,5,9,14
6262,2023-01-02,MR. P,heist,Pit Stop,1,0,1
6263,2023-01-02,MR. P,gemGrab,Minecart Madness,10,18,28
6264,2023-01-02,MR. P,brawlBall,Center Stage,4,2,6
6265,2023-01-02,MR. P,brawlBall,Backyard Bowl,1,0,1
6266,2023-01-02,MR. P,bounty,Hideout,9,7,16
6267,2023-01-01,MR. P,knockout,Belle's Rock,1,2,3
6268,2023-01-01,MR. P,hotZone,Quarter Pounder,1,0,1
6269,2023-01-01,MR. P,gemGrab,Double Swoosh,7,25,32
6270,2023-01-01,MR. P,brawlBall,Backyard Bowl,9,16,25
6271,2023-01-01,MR. P,bounty,Canal Grande,1,2,3
6272,2022-12-31,MR. P,hotZone,Controller Chaos,1,1,2
6273,2022-12-24,MR. P,knockout,X Marks the Spot,1,1,2
6274,2022-12-23,MR. P,knockout,Out in the Open,1,0,1
6275,2022-12-22,MR. P,gemGrab,Gem Fort,1,0,1
6276,2022-11-07,MR. P,hotZone,Quarter Pounder,1,0,1
6277,2022-11-01,MR. P,knockout,New Perspective,2,2,4
6278,2022-10-30,MR. P,knockout,Out in the Open,0,2,2
6279,2022-10-26,MR. P,bounty,Shooting Star,0,1,1
6280,2023-02-05,MORTIS,knockout,X Marks the Spot,232,180,412
6281,2023-02-05,MORTIS,knockout,Goldarm Gulch,13,15,28
6282,2023-02-05,MORTIS,hotZone,Ring of Fire,67,54,121
6283,2023-02-05,MORTIS,heist,Snaked Assault,5,1,6
6284,2023-02-05,MORTIS,heist,Pit Stop,2,1,3
6285,2023-02-05,MORTIS,gemGrab,Hard Rock Mine,139,76,215
6286,2023-02-05,MORTIS,gemGrab,Double Swoosh,457,322,779
6287,2023-02-05,MORTIS,brawlBall,Super Beach,121,96,217
6288,2023-02-05,MORTIS,brawlBall,Sneaky Fields,37,21,58
6289,2023-02-05,MORTIS,brawlBall,Backyard Bowl,3647,2764,6411
6290,2023-02-05,MORTIS,bounty,Layer Cake,438,410,848
6291,2023-02-04,MORTIS,knockout,X Marks the Spot,105,120,225
6292,2023-02-04,MORTIS,knockout,Goldarm Gulch,13,13,26
6293,2023-02-04,MORTIS,hotZone,Ring of Fire,11,9,20
6294,2023-02-04,MORTIS,heist,Tornado Ring,1,0,1
6295,2023-02-04,MORTIS,heist,Pit Stop,3,1,4
6296,2023-02-04,MORTIS,gemGrab,Hard Rock Mine,150,118,268
6297,2023-02-04,MORTIS,gemGrab,Double Swoosh,26,40,66
6298,2023-02-04,MORTIS,gemGrab,Deep Diner,26,22,48
6299,2023-02-04,MORTIS,brawlBall,Super Beach,1143,875,2018
6300,2023-02-04,MORTIS,brawlBall,Sneaky Fields,35,41,76
6301,2023-02-04,MORTIS,bounty,Dry Season,72,75,147
6302,2023-02-03,MORTIS,knockout,Out in the Open,335,309,644
6303,2023-02-03,MORTIS,knockout,Goldarm Gulch,84,65,149
6304,2023-02-03,MORTIS,hotZone,Split,64,36,100
6305,2023-02-03,MORTIS,heist,Tornado Ring,18,14,32
6306,2023-02-03,MORTIS,heist,Pit Stop,8,10,18
6307,2023-02-03,MORTIS,gemGrab,Undermine,118,69,187
6308,2023-02-03,MORTIS,gemGrab,Double Swoosh,276,334,610
6309,2023-02-03,MORTIS,gemGrab,Deep Diner,637,564,1201
6310,2023-02-03,MORTIS,brawlBall,Sneaky Fields,3982,2794,6776
6311,2023-02-03,MORTIS,brawlBall,Pinhole Punt,158,120,278
6312,2023-02-03,MORTIS,bounty,Dry Season,762,813,1575
6313,2023-02-02,MORTIS,knockout,Out in the Open,146,137,283
6314,2023-02-02,MORTIS,hotZone,Split,19,27,46
6315,2023-02-02,MORTIS,gemGrab,Undermine,118,121,239
6316,2023-02-02,MORTIS,gemGrab,Gem Fort,27,17,44
6317,2023-02-02,MORTIS,brawlBall,Sunny Soccer,31,19,50
6318,2023-02-02,MORTIS,brawlBall,Pinhole Punt,1245,983,2228
6319,2023-02-02,MORTIS,bounty,Shooting Star,33,29,62
6320,2023-02-01,MORTIS,knockout,Goldarm Gulch,477,409,886
6321,2023-02-01,MORTIS,hotZone,Parallel Plays,197,165,362
6322,2023-02-01,MORTIS,heist,Kaboom Canyon,5,5,10
6323,2023-02-01,MORTIS,gemGrab,Gem Fort,403,297,700
6324,2023-02-01,MORTIS,gemGrab,Crystal Arcade,169,87,256
6325,2023-02-01,MORTIS,brawlBall,Sunny Soccer,3654,2732,6386
6326,2023-02-01,MORTIS,brawlBall,Beach Ball,126,82,208
6327,2023-02-01,MORTIS,bounty,Shooting Star,161,127,288
6328,2023-01-31,MORTIS,knockout,Goldarm Gulch,223,242,465
6329,2023-01-31,MORTIS,hotZone,Parallel Plays,65,50,115
6330,2023-01-31,MORTIS,heist,Pit Stop,2,2,4
6331,2023-01-31,MORTIS,gemGrab,Minecart Madness,23,17,40
6332,2023-01-31,MORTIS,gemGrab,Crystal Arcade,199,173,372
6333,2023-01-31,MORTIS,brawlBall,Center Stage,35,30,65
6334,2023-01-31,MORTIS,brawlBall,Beach Ball,1661,1212,2873
6335,2023-01-31,MORTIS,bounty,Hideout,81,92,173
6336,2023-01-30,MORTIS,knockout,Belle's Rock,588,542,1130
6337,2023-01-30,MORTIS,hotZone,Quarter Pounder,103,59,162
6338,2023-01-30,MORTIS,heist,Pit Stop,10,3,13
6339,2023-01-30,MORTIS,gemGrab,Minecart Madness,218,228,446
6340,2023-01-30,MORTIS,gemGrab,Double Swoosh,233,188,421
6341,2023-01-30,MORTIS,brawlBall,Center Stage,2709,2006,4715
6342,2023-01-30,MORTIS,brawlBall,Backyard Bowl,305,196,501
6343,2023-01-30,MORTIS,bounty,Hideout,170,184,354
6344,2023-01-29,MORTIS,knockout,Belle's Rock,570,575,1145
6345,2023-01-29,MORTIS,hotZone,Quarter Pounder,63,54,117
6346,2023-01-29,MORTIS,heist,Bridge Too Far,14,1,15
6347,2023-01-29,MORTIS,gemGrab,Hard Rock Mine,112,70,182
6348,2023-01-29,MORTIS,gemGrab,Double Swoosh,426,344,770
6349,2023-01-29,MORTIS,brawlBall,Super Beach,69,40,109
6350,2023-01-29,MORTIS,brawlBall,Backyard Bowl,3941,3253,7194
6351,2023-01-29,MORTIS,bounty,Canal Grande,102,53,155
6352,2023-01-28,MORTIS,knockout,Flaring Phoenix,543,501,1044
6353,2023-01-28,MORTIS,hotZone,Controller Chaos,77,40,117
6354,2023-01-28,MORTIS,heist,Bridge Too Far,25,6,31
6355,2023-01-28,MORTIS,gemGrab,Hard Rock Mine,463,369,832
6356,2023-01-28,MORTIS,gemGrab,Deep Diner,178,106,284
6357,2023-01-28,MORTIS,brawlBall,Super Beach,4425,3526,7951
6358,2023-01-28,MORTIS,brawlBall,Sneaky Fields,110,82,192
6359,2023-01-28,MORTIS,bounty,Canal Grande,193,113,306
6360,2023-01-27,MORTIS,knockout,Flaring Phoenix,289,299,588
6361,2023-01-27,MORTIS,hotZone,Controller Chaos,19,6,25
6362,2023-01-27,MORTIS,heist,Hot Potato,2,2,4
6363,2023-01-27,MORTIS,gemGrab,Undermine,19,15,34
6364,2023-01-27,MORTIS,gemGrab,Deep Diner,227,195,422
6365,2023-01-27,MORTIS,brawlBall,Sneaky Fields,915,734,1649
6366,2023-01-27,MORTIS,brawlBall,Pinhole Punt,25,26,51
6367,2023-01-27,MORTIS,bounty,Temple Ruins,61,36,97
6368,2023-01-26,MORTIS,knockout,Riverside,121,47,168
6369,2023-01-26,MORTIS,hotZone,Open Zone,70,24,94
6370,2023-01-26,MORTIS,heist,Hot Potato,19,5,24
6371,2023-01-26,MORTIS,gemGrab,Undermine,314,218,532
6372,2023-01-26,MORTIS,gemGrab,Gem Fort,162,118,280
6373,2023-01-26,MORTIS,brawlBall,Sunny Soccer,204,143,347
6374,2023-01-26,MORTIS,brawlBall,Pinhole Punt,3774,2903,6677
6375,2023-01-26,MORTIS,bounty,Temple Ruins,175,164,339
6376,2023-01-25,MORTIS,knockout,Riverside,51,28,79
6377,2023-01-25,MORTIS,hotZone,Open Zone,25,6,31
6378,2023-01-25,MORTIS,heist,Safe Zone,11,1,12
6379,2023-01-25,MORTIS,gemGrab,Gem Fort,182,127,309
6380,2023-01-25,MORTIS,gemGrab,Crystal Arcade,200,135,335
6381,2023-01-25,MORTIS,brawlBall,Sunny Soccer,2178,1643,3821
6382,2023-01-25,MORTIS,brawlBall,Beach Ball,327,245,572
6383,2023-01-25,MORTIS,bounty,Excel,305,328,633
6384,2023-01-24,MORTIS,knockout,New Perspective,288,297,585
6385,2023-01-24,MORTIS,hotZone,Dueling Beetles,113,100,213
6386,2023-01-24,MORTIS,heist,Safe Zone,15,6,21
6387,2023-01-24,MORTIS,gemGrab,Minecart Madness,91,91,182
6388,2023-01-24,MORTIS,gemGrab,Crystal Arcade,414,346,760
6389,2023-01-24,MORTIS,brawlBall,Center Stage,270,221,491
6390,2023-01-24,MORTIS,brawlBall,Beach Ball,3536,2801,6337
6391,2023-01-24,MORTIS,bounty,Excel,603,614,1217
6392,2023-01-23,MORTIS,knockout,New Perspective,741,829,1570
6393,2023-01-23,MORTIS,hotZone,Dueling Beetles,180,138,318
6394,2023-01-23,MORTIS,heist,Snaked Assault,14,7,21
6395,2023-01-23,MORTIS,gemGrab,Minecart Madness,467,413,880
6396,2023-01-23,MORTIS,gemGrab,Double Swoosh,180,138,318
6397,2023-01-23,MORTIS,brawlBall,Center Stage,4123,3107,7230
6398,2023-01-23,MORTIS,brawlBall,Backyard Bowl,183,133,316
6399,2023-01-23,MORTIS,bounty,Layer Cake,561,480,1041
6400,2023-01-22,MORTIS,knockout,X Marks the Spot,188,137,325
6401,2023-01-22,MORTIS,hotZone,Ring of Fire,43,18,61
6402,2023-01-22,MORTIS,heist,Snaked Assault,5,1,6
6403,2023-01-22,MORTIS,gemGrab,Hard Rock Mine,167,139,306
6404,2023-01-22,MORTIS,gemGrab,Double Swoosh,241,141,382
6405,2023-01-22,MORTIS,brawlBall,Super Beach,355,278,633
6406,2023-01-22,MORTIS,brawlBall,Backyard Bowl,1867,1524,3391
6407,2023-01-22,MORTIS,bounty,Layer Cake,355,357,712
6408,2023-01-21,MORTIS,knockout,X Marks the Spot,622,563,1185
6409,2023-01-21,MORTIS,hotZone,Ring of Fire,85,75,160
6410,2023-01-21,MORTIS,heist,Tornado Ring,17,3,20
6411,2023-01-21,MORTIS,gemGrab,Hard Rock Mine,764,606,1370
6412,2023-01-21,MORTIS,gemGrab,Deep Diner,133,87,220
6413,2023-01-21,MORTIS,brawlBall,Super Beach,5585,4101,9686
6414,2023-01-21,MORTIS,brawlBall,Sneaky Fields,161,103,264
6415,2023-01-21,MORTIS,bounty,Dry Season,444,380,824
6416,2023-01-20,MORTIS,knockout,Out in the Open,365,275,640
6417,2023-01-20,MORTIS,hotZone,Split,86,54,140
6418,2023-01-20,MORTIS,heist,Tornado Ring,23,2,25
6419,2023-01-20,MORTIS,gemGrab,Undermine,188,132,320
6420,2023-01-20,MORTIS,gemGrab,Deep Diner,633,469,1102
6421,2023-01-20,MORTIS,brawlBall,Sneaky Fields,3370,2371,5741
6422,2023-01-20,MORTIS,brawlBall,Pinhole Punt,161,133,294
6423,2023-01-20,MORTIS,bounty,Dry Season,408,460,868
6424,2023-01-19,MORTIS,knockout,Out in the Open,504,420,924
6425,2023-01-19,MORTIS,hotZone,Split,81,49,130
6426,2023-01-19,MORTIS,heist,Kaboom Canyon,13,2,15
6427,2023-01-19,MORTIS,gemGrab,Undermine,443,335,778
6428,2023-01-19,MORTIS,gemGrab,Gem Fort,75,46,121
6429,2023-01-19,MORTIS,brawlBall,Sunny Soccer,114,81,195
6430,2023-01-19,MORTIS,brawlBall,Pinhole Punt,4563,3469,8032
6431,2023-01-19,MORTIS,bounty,Shooting Star,178,156,334
6432,2023-01-18,MORTIS,knockout,Goldarm Gulch,47,40,87
6433,2023-01-18,MORTIS,hotZone,Parallel Plays,8,13,21
6434,2023-01-18,MORTIS,heist,Kaboom Canyon,3,0,3
6435,2023-01-18,MORTIS,gemGrab,Gem Fort,100,74,174
6436,2023-01-18,MORTIS,gemGrab,Crystal Arcade,21,9,30
6437,2023-01-18,MORTIS,brawlBall,Sunny Soccer,1115,867,1982
6438,2023-01-18,MORTIS,brawlBall,Beach Ball,43,40,83
6439,2023-01-18,MORTIS,bounty,Shooting Star,86,92,178
6440,2023-01-17,MORTIS,knockout,Goldarm Gulch,57,45,102
6441,2023-01-17,MORTIS,hotZone,Parallel Plays,7,2,9
6442,2023-01-17,MORTIS,gemGrab,Minecart Madness,3,6,9
6443,2023-01-17,MORTIS,gemGrab,Crystal Arcade,39,19,58
6444,2023-01-17,MORTIS,brawlBall,Center Stage,21,10,31
6445,2023-01-17,MORTIS,brawlBall,Beach Ball,368,283,651
6446,2023-01-17,MORTIS,bounty,Hideout,19,24,43
6447,2023-01-16,MORTIS,knockout,Belle's Rock,45,34,79
6448,2023-01-16,MORTIS,hotZone,Quarter Pounder,10,2,12
6449,2023-01-16,MORTIS,heist,Pit Stop,2,0,2
6450,2023-01-16,MORTIS,gemGrab,Minecart Madness,42,27,69
6451,2023-01-16,MORTIS,gemGrab,Double Swoosh,9,7,16
6452,2023-01-16,MORTIS,brawlBall,Center Stage,236,166,402
6453,2023-01-16,MORTIS,brawlBall,Backyard Bowl,40,10,50
6454,2023-01-16,MORTIS,bounty,Hideout,42,17,59
6455,2023-01-15,MORTIS,knockout,Belle's Rock,77,71,148
6456,2023-01-15,MORTIS,hotZone,Quarter Pounder,12,9,21
6457,2023-01-15,MORTIS,heist,Bridge Too Far,2,0,2
6458,2023-01-15,MORTIS,gemGrab,Hard Rock Mine,41,22,63
6459,2023-01-15,MORTIS,gemGrab,Double Swoosh,82,58,140
6460,2023-01-15,MORTIS,brawlBall,Super Beach,41,22,63
6461,2023-01-15,MORTIS,brawlBall,Backyard Bowl,437,257,694
6462,2023-01-15,MORTIS,bounty,Canal Grande,19,9,28
6463,2023-01-14,MORTIS,knockout,Flaring Phoenix,24,25,49
6464,2023-01-14,MORTIS,hotZone,Controller Chaos,17,7,24
6465,2023-01-14,MORTIS,heist,Bridge Too Far,3,0,3
6466,2023-01-14,MORTIS,gemGrab,Hard Rock Mine,44,36,80
6467,2023-01-14,MORTIS,gemGrab,Deep Diner,25,35,60
6468,2023-01-14,MORTIS,brawlBall,Super Beach,304,205,509
6469,2023-01-14,MORTIS,brawlBall,Sneaky Fields,12,5,17
6470,2023-01-14,MORTIS,bounty,Canal Grande,14,23,37
6471,2023-01-13,MORTIS,knockout,Flaring Phoenix,49,63,112
6472,2023-01-13,MORTIS,hotZone,Controller Chaos,24,45,69
6473,2023-01-13,MORTIS,gemGrab,Undermine,1,0,1
6474,2023-01-13,MORTIS,gemGrab,Deep Diner,73,32,105
6475,2023-01-13,MORTIS,brawlBall,Sneaky Fields,171,97,268
6476,2023-01-13,MORTIS,brawlBall,Pinhole Punt,2,3,5
6477,2023-01-13,MORTIS,bounty,Temple Ruins,10,20,30
6478,2023-01-12,MORTIS,knockout,Riverside,12,5,17
6479,2023-01-12,MORTIS,hotZone,Open Zone,9,2,11
6480,2023-01-12,MORTIS,gemGrab,Undermine,8,7,15
6481,2023-01-12,MORTIS,gemGrab,Gem Fort,3,2,5
6482,2023-01-12,MORTIS,brawlBall,Sunny Soccer,3,0,3
6483,2023-01-12,MORTIS,brawlBall,Pinhole Punt,67,55,122
6484,2023-01-11,MORTIS,knockout,Riverside,2,0,2
6485,2023-01-11,MORTIS,hotZone,Open Zone,1,1,2
6486,2023-01-11,MORTIS,gemGrab,Gem Fort,8,3,11
6487,2023-01-11,MORTIS,brawlBall,Sunny Soccer,47,46,93
6488,2023-01-11,MORTIS,brawlBall,Beach Ball,2,2,4
6489,2023-01-11,MORTIS,bounty,Excel,18,12,30
6490,2023-01-10,MORTIS,knockout,New Perspective,15,15,30
6491,2023-01-10,MORTIS,hotZone,Dueling Beetles,31,22,53
6492,2023-01-10,MORTIS,heist,Safe Zone,1,0,1
6493,2023-01-10,MORTIS,gemGrab,Minecart Madness,23,19,42
6494,2023-01-10,MORTIS,gemGrab,Crystal Arcade,52,30,82
6495,2023-01-10,MORTIS,brawlBall,Center Stage,26,34,60
6496,2023-01-10,MORTIS,brawlBall,Beach Ball,156,74,230
6497,2023-01-10,MORTIS,bounty,Excel,22,7,29
6498,2023-01-09,MORTIS,knockout,New Perspective,34,35,69
6499,2023-01-09,MORTIS,hotZone,Dueling Beetles,13,17,30
6500,2023-01-09,MORTIS,heist,Snaked Assault,1,1,2
6501,2023-01-09,MORTIS,gemGrab,Minecart Madness,44,14,58
6502,2023-01-09,MORTIS,gemGrab,Double Swoosh,24,15,39
6503,2023-01-09,MORTIS,brawlBall,Center Stage,142,120,262
6504,2023-01-09,MORTIS,brawlBall,Backyard Bowl,13,6,19
6505,2023-01-09,MORTIS,bounty,Layer Cake,77,110,187
6506,2023-01-08,MORTIS,knockout,X Marks the Spot,32,21,53
6507,2023-01-08,MORTIS,hotZone,Ring of Fire,8,1,9
6508,2023-01-08,MORTIS,heist,Snaked Assault,1,0,1
6509,2023-01-08,MORTIS,gemGrab,Hard Rock Mine,17,10,27
6510,2023-01-08,MORTIS,gemGrab,Double Swoosh,14,7,21
6511,2023-01-08,MORTIS,brawlBall,Super Beach,17,9,26
6512,2023-01-08,MORTIS,brawlBall,Backyard Bowl,169,71,240
6513,2023-01-08,MORTIS,bounty,Layer Cake,26,17,43
6514,2023-01-07,MORTIS,knockout,X Marks the Spot,15,11,26
6515,2023-01-07,MORTIS,hotZone,Ring of Fire,3,1,4
6516,2023-01-07,MORTIS,heist,Tornado Ring,2,0,2
6517,2023-01-07,MORTIS,gemGrab,Hard Rock Mine,36,15,51
6518,2023-01-07,MORTIS,gemGrab,Deep Diner,29,9,38
6519,2023-01-07,MORTIS,brawlBall,Super Beach,88,35,123
6520,2023-01-07,MORTIS,brawlBall,Sneaky Fields,12,2,14
6521,2023-01-07,MORTIS,bounty,Dry Season,56,38,94
6522,2023-01-06,MORTIS,knockout,Out in the Open,23,31,54
6523,2023-01-06,MORTIS,hotZone,Split,7,3,10
6524,2023-01-06,MORTIS,gemGrab,Undermine,9,17,26
6525,2023-01-06,MORTIS,gemGrab,Deep Diner,59,17,76
6526,2023-01-06,MORTIS,brawlBall,Sneaky Fields,88,36,124
6527,2023-01-06,MORTIS,brawlBall,Pinhole Punt,20,10,30
6528,2023-01-06,MORTIS,bounty,Dry Season,67,54,121
6529,2023-01-05,MORTIS,knockout,Out in the Open,50,20,70
6530,2023-01-05,MORTIS,hotZone,Split,9,2,11
6531,2023-01-05,MORTIS,heist,Kaboom Canyon,1,0,1
6532,2023-01-05,MORTIS,gemGrab,Undermine,38,28,66
6533,2023-01-05,MORTIS,gemGrab,Gem Fort,1,2,3
6534,2023-01-05,MORTIS,brawlBall,Sunny Soccer,4,1,5
6535,2023-01-05,MORTIS,brawlBall,Pinhole Punt,227,93,320
6536,2023-01-05,MORTIS,bounty,Shooting Star,20,29,49
6537,2023-01-04,MORTIS,knockout,Goldarm Gulch,15,13,28
6538,2023-01-04,MORTIS,hotZone,Parallel Plays,9,8,17
6539,2023-01-04,MORTIS,gemGrab,Gem Fort,49,18,67
6540,2023-01-04,MORTIS,gemGrab,Crystal Arcade,17,8,25
6541,2023-01-04,MORTIS,brawlBall,Sunny Soccer,171,77,248
6542,2023-01-04,MORTIS,brawlBall,Beach Ball,5,2,7
6543,2023-01-04,MORTIS,bounty,Shooting Star,59,51,110
6544,2023-01-03,MORTIS,knockout,Goldarm Gulch,17,7,24
6545,2023-01-03,MORTIS,hotZone,Parallel Plays,9,2,11
6546,2023-01-03,MORTIS,heist,Pit Stop,1,0,1
6547,2023-01-03,MORTIS,gemGrab,Minecart Madness,6,3,9
6548,2023-01-03,MORTIS,gemGrab,Crystal Arcade,57,26,83
6549,2023-01-03,MORTIS,brawlBall,Center Stage,15,5,20
6550,2023-01-03,MORTIS,brawlBall,Beach Ball,184,51,235
6551,2023-01-03,MORTIS,bounty,Hideout,50,65,115
6552,2023-01-02,MORTIS,knockout,Belle's Rock,45,34,79
6553,2023-01-02,MORTIS,hotZone,Quarter Pounder,15,11,26
6554,2023-01-02,MORTIS,gemGrab,Minecart Madness,55,11,66
6555,2023-01-02,MORTIS,gemGrab,Double Swoosh,21,4,25
6556,2023-01-02,MORTIS,brawlBall,Center Stage,165,53,218
6557,2023-01-02,MORTIS,brawlBall,Backyard Bowl,25,19,44
6558,2023-01-02,MORTIS,bounty,Hideout,93,68,161
6559,2023-01-01,MORTIS,knockout,Belle's Rock,17,9,26
6560,2023-01-01,MORTIS,hotZone,Quarter Pounder,7,12,19
6561,2023-01-01,MORTIS,hotZone,Controller Chaos,0,1,1
6562,2023-01-01,MORTIS,gemGrab,Minecart Madness,0,1,1
6563,2023-01-01,MORTIS,gemGrab,Hard Rock Mine,1,0,1
6564,2023-01-01,MORTIS,gemGrab,Double Swoosh,14,6,20
6565,2023-01-01,MORTIS,brawlBall,Backyard Bowl,106,32,138
6566,2023-01-01,MORTIS,bounty,Canal Grande,0,2,2
6567,2022-12-31,MORTIS,knockout,Flaring Phoenix,0,1,1
6568,2022-12-31,MORTIS,hotZone,Controller Chaos,1,0,1
6569,2022-12-31,MORTIS,gemGrab,Hard Rock Mine,13,4,17
6570,2022-12-31,MORTIS,gemGrab,Deep Diner,4,4,8
6571,2022-12-31,MORTIS,brawlBall,Super Beach,26,10,36
6572,2022-12-31,MORTIS,bounty,Canal Grande,1,0,1
6573,2022-12-30,MORTIS,knockout,Flaring Phoenix,3,2,5
6574,2022-12-30,MORTIS,hotZone,Controller Chaos,3,6,9
6575,2022-12-30,MORTIS,heist,Kaboom Canyon,1,0,1
6576,2022-12-30,MORTIS,gemGrab,Deep Diner,11,4,15
6577,2022-12-30,MORTIS,brawlBall,Sneaky Fields,19,10,29
6578,2022-12-29,MORTIS,hotZone,Open Zone,1,0,1
6579,2022-12-29,MORTIS,gemGrab,Undermine,1,1,2
6580,2022-12-29,MORTIS,gemGrab,Minecart Madness,1,1,2
6581,2022-12-29,MORTIS,brawlBall,Pinhole Punt,8,14,22
6582,2022-12-28,MORTIS,brawlBall,Sunny Soccer,4,4,8
6583,2022-12-27,MORTIS,gemGrab,Minecart Madness,0,2,2
6584,2022-12-27,MORTIS,brawlBall,Beach Ball,9,5,14
6585,2022-12-26,MORTIS,heist,Kaboom Canyon,0,2,2
6586,2022-12-26,MORTIS,gemGrab,Minecart Madness,1,5,6
6587,2022-12-26,MORTIS,brawlBall,Center Stage,5,2,7
6588,2022-12-25,MORTIS,brawlBall,Backyard Bowl,1,0,1
6589,2022-12-25,MORTIS,bounty,Layer Cake,1,1,2
6590,2022-12-24,MORTIS,brawlBall,Super Beach,2,2,4
6591,2022-12-24,MORTIS,bounty,Dry Season,1,0,1
6592,2022-12-23,MORTIS,knockout,Out in the Open,0,1,1
6593,2022-12-23,MORTIS,brawlBall,Sneaky Fields,0,1,1
6594,2022-12-22,MORTIS,gemGrab,Gem Fort,1,2,3
6595,2022-12-22,MORTIS,brawlBall,Pinhole Punt,5,0,5
6596,2022-12-21,MORTIS,brawlBall,Sunny Soccer,3,3,6
6597,2022-12-20,MORTIS,brawlBall,Beach Ball,5,6,11
6598,2022-12-19,MORTIS,brawlBall,Center Stage,7,5,12
6599,2022-12-17,MORTIS,knockout,Flaring Phoenix,4,4,8
6600,2022-12-16,MORTIS,brawlBall,Sneaky Fields,4,2,6
6601,2022-12-16,MORTIS,bounty,Temple Ruins,1,4,5
6602,2022-12-13,MORTIS,knockout,New Perspective,2,1,3
6603,2022-12-13,MORTIS,gemGrab,Crystal Arcade,2,1,3
6604,2022-12-13,MORTIS,brawlBall,Beach Ball,4,1,5
6605,2022-12-11,MORTIS,gemGrab,Double Swoosh,2,0,2
6606,2022-12-10,MORTIS,knockout,X Marks the Spot,1,1,2
6607,2022-11-11,MORTIS,brawlBall,Sneaky Fields,1,0,1
6608,2022-11-03,MORTIS,bounty,Temple Ruins,0,1,1
6609,2022-10-28,MORTIS,brawlBall,Beach Ball,1,0,1
6610,2022-10-26,MORTIS,brawlBall,Sunny Soccer,2,0,2
6611,2022-10-26,MORTIS,bounty,Shooting Star,0,1,1
6612,2022-10-15,MORTIS,hotZone,Ring of Fire,1,0,1
6613,2022-10-15,MORTIS,gemGrab,Hard Rock Mine,2,2,4
6614,2022-10-15,MORTIS,brawlBall,Super Beach,1,1,2
6615,2022-10-10,MORTIS,knockout,Belle's Rock,1,0,1
6616,2023-02-05,MEG,knockout,X Marks the Spot,2,11,13
6617,2023-02-05,MEG,hotZone,Ring of Fire,261,504,765
6618,2023-02-05,MEG,heist,Snaked Assault,12,11,23
6619,2023-02-05,MEG,gemGrab,Hard Rock Mine,7,4,11
6620,2023-02-05,MEG,gemGrab,Double Swoosh,29,30,59
6621,2023-02-05,MEG,brawlBall,Super Beach,4,5,9
6622,2023-02-05,MEG,brawlBall,Sneaky Fields,1,0,1
6623,2023-02-05,MEG,brawlBall,Backyard Bowl,293,480,773
6624,2023-02-05,MEG,bounty,Layer Cake,6,11,17
6625,2023-02-04,MEG,knockout,X Marks the Spot,2,2,4
6626,2023-02-04,MEG,knockout,Goldarm Gulch,2,0,2
6627,2023-02-04,MEG,hotZone,Ring of Fire,65,75,140
6628,2023-02-04,MEG,heist,Tornado Ring,1,0,1
6629,2023-02-04,MEG,gemGrab,Hard Rock Mine,3,6,9
6630,2023-02-04,MEG,gemGrab,Double Swoosh,1,5,6
6631,2023-02-04,MEG,gemGrab,Deep Diner,2,2,4
6632,2023-02-04,MEG,brawlBall,Super Beach,31,32,63
6633,2023-02-04,MEG,brawlBall,Sneaky Fields,1,0,1
6634,2023-02-04,MEG,bounty,Dry Season,2,3,5
6635,2023-02-03,MEG,knockout,Out in the Open,21,12,33
6636,2023-02-03,MEG,knockout,Goldarm Gulch,3,3,6
6637,2023-02-03,MEG,hotZone,Split,12,12,24
6638,2023-02-03,MEG,heist,Tornado Ring,8,3,11
6639,2023-02-03,MEG,heist,Pit Stop,1,1,2
6640,2023-02-03,MEG,gemGrab,Undermine,9,9,18
6641,2023-02-03,MEG,gemGrab,Double Swoosh,13,2,15
6642,2023-02-03,MEG,gemGrab,Deep Diner,40,75,115
6643,2023-02-03,MEG,brawlBall,Sneaky Fields,71,67,138
6644,2023-02-03,MEG,brawlBall,Pinhole Punt,3,2,5
6645,2023-02-03,MEG,bounty,Dry Season,12,16,28
6646,2023-02-02,MEG,knockout,Out in the Open,9,10,19
6647,2023-02-02,MEG,hotZone,Split,4,1,5
6648,2023-02-02,MEG,heist,Kaboom Canyon,8,27,35
6649,2023-02-02,MEG,gemGrab,Undermine,11,16,27
6650,2023-02-02,MEG,gemGrab,Gem Fort,1,5,6
6651,2023-02-02,MEG,brawlBall,Pinhole Punt,60,87,147
6652,2023-02-02,MEG,bounty,Shooting Star,2,5,7
6653,2023-02-01,MEG,knockout,Goldarm Gulch,12,5,17
6654,2023-02-01,MEG,hotZone,Parallel Plays,44,49,93
6655,2023-02-01,MEG,heist,Kaboom Canyon,29,80,109
6656,2023-02-01,MEG,gemGrab,Gem Fort,39,47,86
6657,2023-02-01,MEG,gemGrab,Crystal Arcade,13,16,29
6658,2023-02-01,MEG,brawlBall,Sunny Soccer,89,89,178
6659,2023-02-01,MEG,brawlBall,Beach Ball,1,0,1
6660,2023-02-01,MEG,bounty,Shooting Star,13,10,23
6661,2023-01-31,MEG,knockout,Goldarm Gulch,6,9,15
6662,2023-01-31,MEG,hotZone,Parallel Plays,17,18,35
6663,2023-01-31,MEG,heist,Pit Stop,2,4,6
6664,2023-01-31,MEG,gemGrab,Minecart Madness,2,7,9
6665,2023-01-31,MEG,gemGrab,Crystal Arcade,9,12,21
6666,2023-01-31,MEG,brawlBall,Center Stage,0,2,2
6667,2023-01-31,MEG,brawlBall,Beach Ball,56,61,117
6668,2023-01-31,MEG,bounty,Hideout,2,3,5
6669,2023-01-30,MEG,knockout,Belle's Rock,13,10,23
6670,2023-01-30,MEG,hotZone,Quarter Pounder,134,307,441
6671,2023-01-30,MEG,gemGrab,Minecart Madness,46,118,164
6672,2023-01-30,MEG,gemGrab,Double Swoosh,16,29,45
6673,2023-01-30,MEG,brawlBall,Center Stage,51,45,96
6674,2023-01-30,MEG,brawlBall,Backyard Bowl,33,54,87
6675,2023-01-30,MEG,bounty,Hideout,6,3,9
6676,2023-01-29,MEG,knockout,Belle's Rock,10,19,29
6677,2023-01-29,MEG,hotZone,Quarter Pounder,147,356,503
6678,2023-01-29,MEG,heist,Bridge Too Far,50,113,163
6679,2023-01-29,MEG,gemGrab,Hard Rock Mine,7,7,14
6680,2023-01-29,MEG,gemGrab,Double Swoosh,17,31,48
6681,2023-01-29,MEG,brawlBall,Super Beach,0,1,1
6682,2023-01-29,MEG,brawlBall,Backyard Bowl,344,505,849
6683,2023-01-29,MEG,bounty,Canal Grande,3,1,4
6684,2023-01-28,MEG,knockout,Flaring Phoenix,7,6,13
6685,2023-01-28,MEG,hotZone,Controller Chaos,71,62,133
6686,2023-01-28,MEG,heist,Bridge Too Far,179,218,397
6687,2023-01-28,MEG,gemGrab,Hard Rock Mine,56,52,108
6688,2023-01-28,MEG,gemGrab,Deep Diner,9,19,28
6689,2023-01-28,MEG,brawlBall,Super Beach,110,141,251
6690,2023-01-28,MEG,brawlBall,Sneaky Fields,1,1,2
6691,2023-01-28,MEG,bounty,Canal Grande,2,1,3
6692,2023-01-27,MEG,knockout,Flaring Phoenix,1,2,3
6693,2023-01-27,MEG,hotZone,Controller Chaos,16,16,32
6694,2023-01-27,MEG,heist,Hot Potato,8,5,13
6695,2023-01-27,MEG,gemGrab,Undermine,3,2,5
6696,2023-01-27,MEG,gemGrab,Deep Diner,14,12,26
6697,2023-01-27,MEG,brawlBall,Sneaky Fields,14,29,43
6698,2023-01-27,MEG,brawlBall,Pinhole Punt,1,0,1
6699,2023-01-27,MEG,bounty,Temple Ruins,4,3,7
6700,2023-01-26,MEG,knockout,Riverside,26,26,52
6701,2023-01-26,MEG,hotZone,Open Zone,213,473,686
6702,2023-01-26,MEG,heist,Hot Potato,6,5,11
6703,2023-01-26,MEG,gemGrab,Undermine,14,23,37
6704,2023-01-26,MEG,gemGrab,Gem Fort,8,6,14
6705,2023-01-26,MEG,brawlBall,Sunny Soccer,3,3,6
6706,2023-01-26,MEG,brawlBall,Pinhole Punt,213,250,463
6707,2023-01-26,MEG,bounty,Temple Ruins,9,8,17
6708,2023-01-25,MEG,knockout,Riverside,21,23,44
6709,2023-01-25,MEG,hotZone,Open Zone,150,249,399
6710,2023-01-25,MEG,heist,Safe Zone,22,25,47
6711,2023-01-25,MEG,gemGrab,Gem Fort,21,19,40
6712,2023-01-25,MEG,gemGrab,Crystal Arcade,19,10,29
6713,2023-01-25,MEG,brawlBall,Sunny Soccer,48,68,116
6714,2023-01-25,MEG,brawlBall,Beach Ball,11,13,24
6715,2023-01-25,MEG,bounty,Excel,0,1,1
6716,2023-01-24,MEG,knockout,New Perspective,13,22,35
6717,2023-01-24,MEG,hotZone,Dueling Beetles,130,381,511
6718,2023-01-24,MEG,heist,Safe Zone,33,46,79
6719,2023-01-24,MEG,gemGrab,Minecart Madness,37,47,84
6720,2023-01-24,MEG,gemGrab,Crystal Arcade,36,46,82
6721,2023-01-24,MEG,brawlBall,Center Stage,20,12,32
6722,2023-01-24,MEG,brawlBall,Beach Ball,108,148,256
6723,2023-01-24,MEG,bounty,Excel,3,8,11
6724,2023-01-23,MEG,knockout,New Perspective,14,9,23
6725,2023-01-23,MEG,hotZone,Dueling Beetles,305,536,841
6726,2023-01-23,MEG,heist,Snaked Assault,13,15,28
6727,2023-01-23,MEG,gemGrab,Minecart Madness,65,111,176
6728,2023-01-23,MEG,gemGrab,Double Swoosh,16,10,26
6729,2023-01-23,MEG,brawlBall,Center Stage,108,130,238
6730,2023-01-23,MEG,brawlBall,Backyard Bowl,29,37,66
6731,2023-01-23,MEG,bounty,Layer Cake,8,10,18
6732,2023-01-22,MEG,knockout,X Marks the Spot,4,5,9
6733,2023-01-22,MEG,hotZone,Ring of Fire,70,137,207
6734,2023-01-22,MEG,heist,Snaked Assault,4,1,5
6735,2023-01-22,MEG,gemGrab,Hard Rock Mine,0,6,6
6736,2023-01-22,MEG,gemGrab,Double Swoosh,25,22,47
6737,2023-01-22,MEG,brawlBall,Super Beach,11,13,24
6738,2023-01-22,MEG,brawlBall,Backyard Bowl,152,215,367
6739,2023-01-22,MEG,bounty,Layer Cake,1,2,3
6740,2023-01-21,MEG,knockout,X Marks the Spot,27,50,77
6741,2023-01-21,MEG,hotZone,Ring of Fire,260,448,708
6742,2023-01-21,MEG,heist,Tornado Ring,14,14,28
6743,2023-01-21,MEG,gemGrab,Hard Rock Mine,31,32,63
6744,2023-01-21,MEG,gemGrab,Deep Diner,5,12,17
6745,2023-01-21,MEG,brawlBall,Super Beach,100,119,219
6746,2023-01-21,MEG,brawlBall,Sneaky Fields,2,3,5
6747,2023-01-21,MEG,bounty,Dry Season,10,5,15
6748,2023-01-20,MEG,knockout,Out in the Open,17,32,49
6749,2023-01-20,MEG,hotZone,Split,7,6,13
6750,2023-01-20,MEG,heist,Tornado Ring,11,7,18
6751,2023-01-20,MEG,gemGrab,Undermine,12,18,30
6752,2023-01-20,MEG,gemGrab,Deep Diner,39,67,106
6753,2023-01-20,MEG,brawlBall,Sneaky Fields,57,66,123
6754,2023-01-20,MEG,brawlBall,Pinhole Punt,12,11,23
6755,2023-01-20,MEG,bounty,Dry Season,15,11,26
6756,2023-01-19,MEG,knockout,Out in the Open,39,31,70
6757,2023-01-19,MEG,hotZone,Split,11,9,20
6758,2023-01-19,MEG,heist,Kaboom Canyon,20,49,69
6759,2023-01-19,MEG,gemGrab,Undermine,27,32,59
6760,2023-01-19,MEG,gemGrab,Gem Fort,6,5,11
6761,2023-01-19,MEG,brawlBall,Sunny Soccer,3,0,3
6762,2023-01-19,MEG,brawlBall,Pinhole Punt,196,269,465
6763,2023-01-19,MEG,bounty,Shooting Star,12,14,26
6764,2023-01-18,MEG,knockout,Goldarm Gulch,3,1,4
6765,2023-01-18,MEG,hotZone,Parallel Plays,4,0,4
6766,2023-01-18,MEG,heist,Kaboom Canyon,9,28,37
6767,2023-01-18,MEG,gemGrab,Gem Fort,6,6,12
6768,2023-01-18,MEG,gemGrab,Crystal Arcade,2,5,7
6769,2023-01-18,MEG,brawlBall,Sunny Soccer,18,28,46
6770,2023-01-18,MEG,brawlBall,Beach Ball,4,0,4
6771,2023-01-18,MEG,bounty,Shooting Star,7,15,22
6772,2023-01-17,MEG,knockout,Goldarm Gulch,0,1,1
6773,2023-01-17,MEG,hotZone,Parallel Plays,2,1,3
6774,2023-01-17,MEG,gemGrab,Minecart Madness,2,2,4
6775,2023-01-17,MEG,gemGrab,Crystal Arcade,2,3,5
6776,2023-01-17,MEG,brawlBall,Beach Ball,17,16,33
6777,2023-01-17,MEG,bounty,Hideout,0,2,2
6778,2023-01-16,MEG,knockout,Belle's Rock,1,0,1
6779,2023-01-16,MEG,hotZone,Quarter Pounder,9,57,66
6780,2023-01-16,MEG,gemGrab,Minecart Madness,5,12,17
6781,2023-01-16,MEG,gemGrab,Double Swoosh,1,0,1
6782,2023-01-16,MEG,brawlBall,Center Stage,3,2,5
6783,2023-01-16,MEG,brawlBall,Backyard Bowl,3,13,16
6784,2023-01-16,MEG,bounty,Hideout,2,0,2
6785,2023-01-15,MEG,knockout,Belle's Rock,1,1,2
6786,2023-01-15,MEG,hotZone,Quarter Pounder,36,120,156
6787,2023-01-15,MEG,heist,Bridge Too Far,26,42,68
6788,2023-01-15,MEG,gemGrab,Double Swoosh,3,7,10
6789,2023-01-15,MEG,brawlBall,Backyard Bowl,48,54,102
6790,2023-01-14,MEG,knockout,Flaring Phoenix,1,2,3
6791,2023-01-14,MEG,hotZone,Controller Chaos,6,34,40
6792,2023-01-14,MEG,heist,Bridge Too Far,15,51,66
6793,2023-01-14,MEG,gemGrab,Hard Rock Mine,1,0,1
6794,2023-01-14,MEG,gemGrab,Deep Diner,3,0,3
6795,2023-01-14,MEG,brawlBall,Super Beach,7,9,16
6796,2023-01-14,MEG,brawlBall,Sneaky Fields,3,0,3
6797,2023-01-13,MEG,knockout,Flaring Phoenix,0,1,1
6798,2023-01-13,MEG,hotZone,Controller Chaos,12,26,38
6799,2023-01-13,MEG,gemGrab,Deep Diner,1,1,2
6800,2023-01-13,MEG,brawlBall,Sneaky Fields,2,0,2
6801,2023-01-13,MEG,brawlBall,Pinhole Punt,0,1,1
6802,2023-01-13,MEG,bounty,Temple Ruins,0,1,1
6803,2023-01-12,MEG,knockout,Riverside,1,0,1
6804,2023-01-12,MEG,hotZone,Open Zone,13,69,82
6805,2023-01-12,MEG,brawlBall,Pinhole Punt,5,10,15
6806,2023-01-11,MEG,knockout,Riverside,4,3,7
6807,2023-01-11,MEG,hotZone,Open Zone,16,27,43
6808,2023-01-11,MEG,brawlBall,Sunny Soccer,2,1,3
6809,2023-01-10,MEG,hotZone,Dueling Beetles,20,54,74
6810,2023-01-10,MEG,heist,Safe Zone,2,4,6
6811,2023-01-10,MEG,gemGrab,Minecart Madness,2,18,20
6812,2023-01-10,MEG,gemGrab,Crystal Arcade,1,0,1
6813,2023-01-10,MEG,brawlBall,Beach Ball,17,41,58
6814,2023-01-09,MEG,knockout,New Perspective,0,1,1
6815,2023-01-09,MEG,hotZone,Dueling Beetles,9,31,40
6816,2023-01-09,MEG,heist,Snaked Assault,3,0,3
6817,2023-01-09,MEG,gemGrab,Minecart Madness,7,29,36
6818,2023-01-09,MEG,gemGrab,Double Swoosh,1,1,2
6819,2023-01-09,MEG,brawlBall,Center Stage,1,0,1
6820,2023-01-09,MEG,brawlBall,Backyard Bowl,4,10,14
6821,2023-01-09,MEG,bounty,Layer Cake,1,2,3
6822,2023-01-08,MEG,knockout,X Marks the Spot,4,3,7
6823,2023-01-08,MEG,hotZone,Ring of Fire,23,42,65
6824,2023-01-08,MEG,heist,Snaked Assault,1,0,1
6825,2023-01-08,MEG,gemGrab,Hard Rock Mine,1,1,2
6826,2023-01-08,MEG,gemGrab,Double Swoosh,1,0,1
6827,2023-01-08,MEG,brawlBall,Super Beach,0,4,4
6828,2023-01-08,MEG,brawlBall,Backyard Bowl,25,29,54
6829,2023-01-08,MEG,bounty,Layer Cake,1,0,1
6830,2023-01-07,MEG,hotZone,Ring of Fire,19,39,58
6831,2023-01-07,MEG,brawlBall,Sneaky Fields,0,3,3
6832,2023-01-07,MEG,bounty,Dry Season,0,3,3
6833,2023-01-06,MEG,gemGrab,Undermine,2,1,3
6834,2023-01-06,MEG,brawlBall,Sneaky Fields,5,2,7
6835,2023-01-06,MEG,brawlBall,Pinhole Punt,0,2,2
6836,2023-01-06,MEG,bounty,Dry Season,0,1,1
6837,2023-01-05,MEG,knockout,Out in the Open,5,2,7
6838,2023-01-05,MEG,hotZone,Split,1,0,1
6839,2023-01-05,MEG,heist,Kaboom Canyon,5,12,17
6840,2023-01-05,MEG,gemGrab,Undermine,3,5,8
6841,2023-01-05,MEG,gemGrab,Gem Fort,0,1,1
6842,2023-01-05,MEG,brawlBall,Pinhole Punt,9,25,34
6843,2023-01-05,MEG,bounty,Shooting Star,0,1,1
6844,2023-01-04,MEG,hotZone,Parallel Plays,0,3,3
6845,2023-01-04,MEG,heist,Kaboom Canyon,3,8,11
6846,2023-01-04,MEG,gemGrab,Gem Fort,1,0,1
6847,2023-01-04,MEG,gemGrab,Crystal Arcade,1,0,1
6848,2023-01-04,MEG,brawlBall,Sunny Soccer,1,0,1
6849,2023-01-04,MEG,bounty,Shooting Star,1,1,2
6850,2023-01-03,MEG,knockout,Goldarm Gulch,1,0,1
6851,2023-01-03,MEG,hotZone,Parallel Plays,1,0,1
6852,2023-01-03,MEG,gemGrab,Minecart Madness,2,17,19
6853,2023-01-03,MEG,gemGrab,Crystal Arcade,3,0,3
6854,2023-01-03,MEG,brawlBall,Beach Ball,4,1,5
6855,2023-01-03,MEG,bounty,Hideout,1,0,1
6856,2023-01-02,MEG,knockout,Belle's Rock,1,0,1
6857,2023-01-02,MEG,hotZone,Quarter Pounder,24,33,57
6858,2023-01-02,MEG,gemGrab,Minecart Madness,9,15,24
6859,2023-01-02,MEG,gemGrab,Double Swoosh,1,0,1
6860,2023-01-02,MEG,brawlBall,Center Stage,3,0,3
6861,2023-01-02,MEG,brawlBall,Backyard Bowl,1,0,1
6862,2023-01-02,MEG,bounty,Hideout,2,1,3
6863,2023-01-01,MEG,knockout,Belle's Rock,1,6,7
6864,2023-01-01,MEG,hotZone,Quarter Pounder,12,19,31
6865,2023-01-01,MEG,heist,Bridge Too Far,1,1,2
6866,2023-01-01,MEG,brawlBall,Backyard Bowl,13,5,18
6867,2022-12-31,MEG,gemGrab,Hard Rock Mine,0,3,3
6868,2022-12-31,MEG,brawlBall,Super Beach,0,8,8
6869,2022-12-30,MEG,hotZone,Controller Chaos,6,15,21
6870,2022-12-30,MEG,heist,Kaboom Canyon,1,1,2
6871,2022-12-30,MEG,gemGrab,Minecart Madness,0,1,1
6872,2022-12-30,MEG,gemGrab,Deep Diner,2,0,2
6873,2022-12-30,MEG,brawlBall,Sneaky Fields,0,1,1
6874,2022-12-29,MEG,hotZone,Open Zone,1,1,2
6875,2022-12-29,MEG,brawlBall,Pinhole Punt,0,1,1
6876,2022-12-27,MEG,heist,Kaboom Canyon,0,1,1
6877,2022-12-27,MEG,gemGrab,Minecart Madness,0,1,1
6878,2022-12-27,MEG,brawlBall,Beach Ball,2,1,3
6879,2022-12-26,MEG,gemGrab,Minecart Madness,0,1,1
6880,2022-12-22,MEG,brawlBall,Pinhole Punt,0,1,1
6881,2022-12-11,MEG,brawlBall,Backyard Bowl,0,1,1
6882,2022-12-10,MEG,gemGrab,Hard Rock Mine,1,0,1
6883,2023-02-05,MAX,knockout,X Marks the Spot,79,77,156
6884,2023-02-05,MAX,knockout,Goldarm Gulch,15,14,29
6885,2023-02-05,MAX,hotZone,Ring of Fire,72,75,147
6886,2023-02-05,MAX,heist,Snaked Assault,56,72,128
6887,2023-02-05,MAX,heist,Pit Stop,6,6,12
6888,2023-02-05,MAX,gemGrab,Hard Rock Mine,47,63,110
6889,2023-02-05,MAX,gemGrab,Double Swoosh,142,160,302
6890,2023-02-05,MAX,brawlBall,Super Beach,33,35,68
6891,2023-02-05,MAX,brawlBall,Sneaky Fields,36,71,107
6892,2023-02-05,MAX,brawlBall,Backyard Bowl,1453,1683,3136
6893,2023-02-05,MAX,bounty,Layer Cake,67,49,116
6894,2023-02-04,MAX,knockout,X Marks the Spot,27,19,46
6895,2023-02-04,MAX,knockout,Goldarm Gulch,10,15,25
6896,2023-02-04,MAX,hotZone,Ring of Fire,19,16,35
6897,2023-02-04,MAX,heist,Tornado Ring,3,3,6
6898,2023-02-04,MAX,heist,Pit Stop,7,11,18
6899,2023-02-04,MAX,gemGrab,Hard Rock Mine,53,44,97
6900,2023-02-04,MAX,gemGrab,Double Swoosh,11,40,51
6901,2023-02-04,MAX,gemGrab,Deep Diner,14,5,19
6902,2023-02-04,MAX,brawlBall,Super Beach,272,333,605
6903,2023-02-04,MAX,brawlBall,Sneaky Fields,25,79,104
6904,2023-02-04,MAX,bounty,Dry Season,13,13,26
6905,2023-02-03,MAX,knockout,Out in the Open,152,125,277
6906,2023-02-03,MAX,knockout,Goldarm Gulch,107,95,202
6907,2023-02-03,MAX,hotZone,Split,24,12,36
6908,2023-02-03,MAX,heist,Tornado Ring,49,25,74
6909,2023-02-03,MAX,heist,Pit Stop,27,22,49
6910,2023-02-03,MAX,gemGrab,Undermine,32,36,68
6911,2023-02-03,MAX,gemGrab,Double Swoosh,86,222,308
6912,2023-02-03,MAX,gemGrab,Deep Diner,171,189,360
6913,2023-02-03,MAX,brawlBall,Sneaky Fields,1134,1459,2593
6914,2023-02-03,MAX,brawlBall,Pinhole Punt,51,26,77
6915,2023-02-03,MAX,bounty,Dry Season,312,306,618
6916,2023-02-02,MAX,knockout,Out in the Open,53,21,74
6917,2023-02-02,MAX,hotZone,Split,8,4,12
6918,2023-02-02,MAX,heist,Kaboom Canyon,14,14,28
6919,2023-02-02,MAX,gemGrab,Undermine,34,40,74
6920,2023-02-02,MAX,gemGrab,Gem Fort,4,6,10
6921,2023-02-02,MAX,brawlBall,Sunny Soccer,8,11,19
6922,2023-02-02,MAX,brawlBall,Pinhole Punt,369,366,735
6923,2023-02-02,MAX,bounty,Shooting Star,44,34,78
6924,2023-02-01,MAX,knockout,Goldarm Gulch,119,111,230
6925,2023-02-01,MAX,hotZone,Parallel Plays,72,102,174
6926,2023-02-01,MAX,heist,Kaboom Canyon,84,87,171
6927,2023-02-01,MAX,gemGrab,Gem Fort,105,116,221
6928,2023-02-01,MAX,gemGrab,Crystal Arcade,69,45,114
6929,2023-02-01,MAX,brawlBall,Sunny Soccer,779,841,1620
6930,2023-02-01,MAX,brawlBall,Beach Ball,33,29,62
6931,2023-02-01,MAX,bounty,Shooting Star,191,213,404
6932,2023-01-31,MAX,knockout,Goldarm Gulch,42,30,72
6933,2023-01-31,MAX,hotZone,Parallel Plays,26,30,56
6934,2023-01-31,MAX,heist,Pit Stop,5,4,9
6935,2023-01-31,MAX,gemGrab,Minecart Madness,16,4,20
6936,2023-01-31,MAX,gemGrab,Crystal Arcade,81,64,145
6937,2023-01-31,MAX,brawlBall,Center Stage,5,6,11
6938,2023-01-31,MAX,brawlBall,Beach Ball,394,454,848
6939,2023-01-31,MAX,bounty,Hideout,33,47,80
6940,2023-01-30,MAX,knockout,Belle's Rock,134,179,313
6941,2023-01-30,MAX,hotZone,Quarter Pounder,101,75,176
6942,2023-01-30,MAX,heist,Pit Stop,36,35,71
6943,2023-01-30,MAX,gemGrab,Minecart Madness,145,164,309
6944,2023-01-30,MAX,gemGrab,Double Swoosh,80,68,148
6945,2023-01-30,MAX,brawlBall,Center Stage,496,550,1046
6946,2023-01-30,MAX,brawlBall,Backyard Bowl,135,155,290
6947,2023-01-30,MAX,bounty,Hideout,95,104,199
6948,2023-01-29,MAX,knockout,Belle's Rock,142,103,245
6949,2023-01-29,MAX,hotZone,Quarter Pounder,72,99,171
6950,2023-01-29,MAX,heist,Bridge Too Far,207,220,427
6951,2023-01-29,MAX,gemGrab,Hard Rock Mine,41,17,58
6952,2023-01-29,MAX,gemGrab,Double Swoosh,115,104,219
6953,2023-01-29,MAX,brawlBall,Super Beach,17,8,25
6954,2023-01-29,MAX,brawlBall,Backyard Bowl,1451,1474,2925
6955,2023-01-29,MAX,bounty,Canal Grande,17,24,41
6956,2023-01-28,MAX,knockout,Flaring Phoenix,28,49,77
6957,2023-01-28,MAX,hotZone,Controller Chaos,44,66,110
6958,2023-01-28,MAX,heist,Bridge Too Far,544,582,1126
6959,2023-01-28,MAX,gemGrab,Hard Rock Mine,200,232,432
6960,2023-01-28,MAX,gemGrab,Deep Diner,61,61,122
6961,2023-01-28,MAX,brawlBall,Super Beach,1048,1123,2171
6962,2023-01-28,MAX,brawlBall,Sneaky Fields,35,45,80
6963,2023-01-28,MAX,bounty,Canal Grande,41,42,83
6964,2023-01-27,MAX,knockout,Flaring Phoenix,23,6,29
6965,2023-01-27,MAX,hotZone,Controller Chaos,13,7,20
6966,2023-01-27,MAX,heist,Hot Potato,13,12,25
6967,2023-01-27,MAX,gemGrab,Undermine,11,17,28
6968,2023-01-27,MAX,gemGrab,Deep Diner,70,66,136
6969,2023-01-27,MAX,brawlBall,Sneaky Fields,244,321,565
6970,2023-01-27,MAX,brawlBall,Pinhole Punt,12,12,24
6971,2023-01-27,MAX,bounty,Temple Ruins,26,21,47
6972,2023-01-26,MAX,knockout,Riverside,121,101,222
6973,2023-01-26,MAX,hotZone,Open Zone,151,159,310
6974,2023-01-26,MAX,heist,Hot Potato,41,32,73
6975,2023-01-26,MAX,gemGrab,Undermine,98,123,221
6976,2023-01-26,MAX,gemGrab,Gem Fort,43,46,89
6977,2023-01-26,MAX,brawlBall,Sunny Soccer,49,53,102
6978,2023-01-26,MAX,brawlBall,Pinhole Punt,1131,1177,2308
6979,2023-01-26,MAX,bounty,Temple Ruins,48,52,100
6980,2023-01-25,MAX,knockout,Riverside,66,66,132
6981,2023-01-25,MAX,hotZone,Open Zone,87,63,150
6982,2023-01-25,MAX,heist,Safe Zone,88,105,193
6983,2023-01-25,MAX,gemGrab,Gem Fort,42,47,89
6984,2023-01-25,MAX,gemGrab,Crystal Arcade,104,123,227
6985,2023-01-25,MAX,brawlBall,Sunny Soccer,495,551,1046
6986,2023-01-25,MAX,brawlBall,Beach Ball,81,128,209
6987,2023-01-25,MAX,bounty,Excel,22,39,61
6988,2023-01-24,MAX,knockout,New Perspective,84,41,125
6989,2023-01-24,MAX,hotZone,Dueling Beetles,46,34,80
6990,2023-01-24,MAX,heist,Safe Zone,216,245,461
6991,2023-01-24,MAX,gemGrab,Minecart Madness,26,35,61
6992,2023-01-24,MAX,gemGrab,Crystal Arcade,154,231,385
6993,2023-01-24,MAX,brawlBall,Center Stage,74,91,165
6994,2023-01-24,MAX,brawlBall,Beach Ball,882,998,1880
6995,2023-01-24,MAX,bounty,Excel,67,68,135
6996,2023-01-23,MAX,knockout,New Perspective,113,85,198
6997,2023-01-23,MAX,hotZone,Dueling Beetles,94,103,197
6998,2023-01-23,MAX,heist,Snaked Assault,91,157,248
6999,2023-01-23,MAX,gemGrab,Minecart Madness,184,242,426
7000,2023-01-23,MAX,gemGrab,Double Swoosh,51,59,110
7001,2023-01-23,MAX,brawlBall,Center Stage,860,957,1817
7002,2023-01-23,MAX,brawlBall,Backyard Bowl,98,95,193
7003,2023-01-23,MAX,bounty,Layer Cake,63,94,157
7004,2023-01-22,MAX,knockout,X Marks the Spot,75,68,143
7005,2023-01-22,MAX,hotZone,Ring of Fire,44,25,69
7006,2023-01-22,MAX,heist,Snaked Assault,49,43,92
7007,2023-01-22,MAX,gemGrab,Hard Rock Mine,44,59,103
7008,2023-01-22,MAX,gemGrab,Double Swoosh,54,66,120
7009,2023-01-22,MAX,brawlBall,Super Beach,126,168,294
7010,2023-01-22,MAX,brawlBall,Backyard Bowl,671,695,1366
7011,2023-01-22,MAX,bounty,Layer Cake,29,41,70
7012,2023-01-21,MAX,knockout,X Marks the Spot,215,177,392
7013,2023-01-21,MAX,hotZone,Ring of Fire,103,65,168
7014,2023-01-21,MAX,heist,Tornado Ring,31,33,64
7015,2023-01-21,MAX,gemGrab,Hard Rock Mine,240,254,494
7016,2023-01-21,MAX,gemGrab,Deep Diner,31,49,80
7017,2023-01-21,MAX,brawlBall,Super Beach,1255,1285,2540
7018,2023-01-21,MAX,brawlBall,Sneaky Fields,41,52,93
7019,2023-01-21,MAX,bounty,Dry Season,136,120,256
7020,2023-01-20,MAX,knockout,Out in the Open,169,153,322
7021,2023-01-20,MAX,hotZone,Split,21,10,31
7022,2023-01-20,MAX,heist,Tornado Ring,45,30,75
7023,2023-01-20,MAX,gemGrab,Undermine,51,51,102
7024,2023-01-20,MAX,gemGrab,Deep Diner,180,136,316
7025,2023-01-20,MAX,brawlBall,Sneaky Fields,651,754,1405
7026,2023-01-20,MAX,brawlBall,Pinhole Punt,27,41,68
7027,2023-01-20,MAX,bounty,Dry Season,113,106,219
7028,2023-01-19,MAX,knockout,Out in the Open,192,111,303
7029,2023-01-19,MAX,hotZone,Split,17,18,35
7030,2023-01-19,MAX,heist,Kaboom Canyon,76,99,175
7031,2023-01-19,MAX,gemGrab,Undermine,91,108,199
7032,2023-01-19,MAX,gemGrab,Gem Fort,25,47,72
7033,2023-01-19,MAX,brawlBall,Sunny Soccer,15,47,62
7034,2023-01-19,MAX,brawlBall,Pinhole Punt,1128,1206,2334
7035,2023-01-19,MAX,bounty,Shooting Star,157,186,343
7036,2023-01-18,MAX,knockout,Goldarm Gulch,10,23,33
7037,2023-01-18,MAX,hotZone,Parallel Plays,4,6,10
7038,2023-01-18,MAX,heist,Kaboom Canyon,37,52,89
7039,2023-01-18,MAX,gemGrab,Gem Fort,9,13,22
7040,2023-01-18,MAX,gemGrab,Crystal Arcade,6,1,7
7041,2023-01-18,MAX,brawlBall,Sunny Soccer,193,218,411
7042,2023-01-18,MAX,brawlBall,Beach Ball,11,18,29
7043,2023-01-18,MAX,bounty,Shooting Star,72,62,134
7044,2023-01-17,MAX,knockout,Goldarm Gulch,9,5,14
7045,2023-01-17,MAX,hotZone,Parallel Plays,1,2,3
7046,2023-01-17,MAX,gemGrab,Minecart Madness,2,3,5
7047,2023-01-17,MAX,gemGrab,Crystal Arcade,13,8,21
7048,2023-01-17,MAX,brawlBall,Center Stage,2,5,7
7049,2023-01-17,MAX,brawlBall,Beach Ball,42,64,106
7050,2023-01-17,MAX,bounty,Hideout,12,12,24
7051,2023-01-16,MAX,knockout,Belle's Rock,15,8,23
7052,2023-01-16,MAX,hotZone,Quarter Pounder,8,7,15
7053,2023-01-16,MAX,heist,Pit Stop,14,7,21
7054,2023-01-16,MAX,gemGrab,Minecart Madness,19,14,33
7055,2023-01-16,MAX,gemGrab,Double Swoosh,8,3,11
7056,2023-01-16,MAX,brawlBall,Center Stage,41,66,107
7057,2023-01-16,MAX,brawlBall,Backyard Bowl,21,8,29
7058,2023-01-16,MAX,bounty,Hideout,27,21,48
7059,2023-01-15,MAX,knockout,Belle's Rock,29,21,50
7060,2023-01-15,MAX,hotZone,Quarter Pounder,16,33,49
7061,2023-01-15,MAX,heist,Bridge Too Far,50,52,102
7062,2023-01-15,MAX,gemGrab,Hard Rock Mine,14,20,34
7063,2023-01-15,MAX,gemGrab,Double Swoosh,16,29,45
7064,2023-01-15,MAX,brawlBall,Super Beach,16,12,28
7065,2023-01-15,MAX,brawlBall,Backyard Bowl,189,246,435
7066,2023-01-15,MAX,bounty,Canal Grande,2,3,5
7067,2023-01-14,MAX,knockout,Flaring Phoenix,5,2,7
7068,2023-01-14,MAX,hotZone,Controller Chaos,9,1,10
7069,2023-01-14,MAX,heist,Bridge Too Far,91,52,143
7070,2023-01-14,MAX,gemGrab,Hard Rock Mine,21,15,36
7071,2023-01-14,MAX,gemGrab,Deep Diner,9,23,32
7072,2023-01-14,MAX,brawlBall,Super Beach,98,157,255
7073,2023-01-14,MAX,brawlBall,Sneaky Fields,17,17,34
7074,2023-01-14,MAX,bounty,Canal Grande,0,2,2
7075,2023-01-13,MAX,knockout,Flaring Phoenix,7,4,11
7076,2023-01-13,MAX,hotZone,Controller Chaos,4,1,5
7077,2023-01-13,MAX,heist,Hot Potato,1,2,3
7078,2023-01-13,MAX,gemGrab,Deep Diner,19,21,40
7079,2023-01-13,MAX,brawlBall,Sneaky Fields,88,74,162
7080,2023-01-13,MAX,brawlBall,Pinhole Punt,1,2,3
7081,2023-01-13,MAX,bounty,Temple Ruins,6,4,10
7082,2023-01-12,MAX,knockout,Riverside,18,17,35
7083,2023-01-12,MAX,hotZone,Open Zone,24,13,37
7084,2023-01-12,MAX,heist,Hot Potato,0,1,1
7085,2023-01-12,MAX,gemGrab,Undermine,4,2,6
7086,2023-01-12,MAX,gemGrab,Gem Fort,1,0,1
7087,2023-01-12,MAX,brawlBall,Sunny Soccer,1,1,2
7088,2023-01-12,MAX,brawlBall,Pinhole Punt,54,75,129
7089,2023-01-12,MAX,bounty,Temple Ruins,1,0,1
7090,2023-01-11,MAX,knockout,Riverside,2,1,3
7091,2023-01-11,MAX,hotZone,Open Zone,8,1,9
7092,2023-01-11,MAX,gemGrab,Gem Fort,3,1,4
7093,2023-01-11,MAX,brawlBall,Sunny Soccer,27,31,58
7094,2023-01-11,MAX,bounty,Excel,1,0,1
7095,2023-01-10,MAX,knockout,New Perspective,4,1,5
7096,2023-01-10,MAX,hotZone,Dueling Beetles,13,30,43
7097,2023-01-10,MAX,heist,Safe Zone,9,11,20
7098,2023-01-10,MAX,gemGrab,Minecart Madness,8,1,9
7099,2023-01-10,MAX,gemGrab,Crystal Arcade,23,27,50
7100,2023-01-10,MAX,brawlBall,Center Stage,3,0,3
7101,2023-01-10,MAX,brawlBall,Beach Ball,51,60,111
7102,2023-01-10,MAX,bounty,Excel,3,0,3
7103,2023-01-09,MAX,knockout,New Perspective,2,4,6
7104,2023-01-09,MAX,hotZone,Dueling Beetles,7,4,11
7105,2023-01-09,MAX,heist,Snaked Assault,25,18,43
7106,2023-01-09,MAX,gemGrab,Minecart Madness,21,14,35
7107,2023-01-09,MAX,gemGrab,Double Swoosh,10,12,22
7108,2023-01-09,MAX,brawlBall,Center Stage,55,63,118
7109,2023-01-09,MAX,brawlBall,Backyard Bowl,11,12,23
7110,2023-01-09,MAX,bounty,Layer Cake,19,30,49
7111,2023-01-08,MAX,knockout,X Marks the Spot,14,6,20
7112,2023-01-08,MAX,hotZone,Ring of Fire,19,7,26
7113,2023-01-08,MAX,heist,Snaked Assault,6,7,13
7114,2023-01-08,MAX,gemGrab,Hard Rock Mine,8,7,15
7115,2023-01-08,MAX,gemGrab,Double Swoosh,8,9,17
7116,2023-01-08,MAX,brawlBall,Super Beach,14,26,40
7117,2023-01-08,MAX,brawlBall,Backyard Bowl,168,191,359
7118,2023-01-08,MAX,bounty,Layer Cake,2,0,2
7119,2023-01-07,MAX,knockout,X Marks the Spot,9,8,17
7120,2023-01-07,MAX,hotZone,Ring of Fire,3,3,6
7121,2023-01-07,MAX,heist,Tornado Ring,7,0,7
7122,2023-01-07,MAX,gemGrab,Hard Rock Mine,14,11,25
7123,2023-01-07,MAX,gemGrab,Deep Diner,13,14,27
7124,2023-01-07,MAX,brawlBall,Super Beach,52,93,145
7125,2023-01-07,MAX,brawlBall,Sneaky Fields,4,4,8
7126,2023-01-07,MAX,bounty,Dry Season,17,18,35
7127,2023-01-06,MAX,knockout,Out in the Open,13,7,20
7128,2023-01-06,MAX,hotZone,Split,3,0,3
7129,2023-01-06,MAX,heist,Tornado Ring,8,10,18
7130,2023-01-06,MAX,gemGrab,Undermine,8,20,28
7131,2023-01-06,MAX,gemGrab,Deep Diner,16,32,48
7132,2023-01-06,MAX,brawlBall,Sneaky Fields,54,101,155
7133,2023-01-06,MAX,brawlBall,Pinhole Punt,9,14,23
7134,2023-01-06,MAX,bounty,Dry Season,43,42,85
7135,2023-01-05,MAX,knockout,Out in the Open,34,38,72
7136,2023-01-05,MAX,hotZone,Split,3,0,3
7137,2023-01-05,MAX,heist,Kaboom Canyon,11,32,43
7138,2023-01-05,MAX,gemGrab,Undermine,19,34,53
7139,2023-01-05,MAX,gemGrab,Gem Fort,4,0,4
7140,2023-01-05,MAX,brawlBall,Sunny Soccer,2,0,2
7141,2023-01-05,MAX,brawlBall,Pinhole Punt,151,129,280
7142,2023-01-05,MAX,bounty,Shooting Star,27,22,49
7143,2023-01-04,MAX,knockout,Goldarm Gulch,6,8,14
7144,2023-01-04,MAX,hotZone,Parallel Plays,7,1,8
7145,2023-01-04,MAX,heist,Kaboom Canyon,17,12,29
7146,2023-01-04,MAX,gemGrab,Gem Fort,12,14,26
7147,2023-01-04,MAX,gemGrab,Crystal Arcade,5,1,6
7148,2023-01-04,MAX,brawlBall,Sunny Soccer,91,67,158
7149,2023-01-04,MAX,brawlBall,Beach Ball,1,3,4
7150,2023-01-04,MAX,bounty,Shooting Star,82,41,123
7151,2023-01-03,MAX,knockout,Goldarm Gulch,3,2,5
7152,2023-01-03,MAX,hotZone,Parallel Plays,4,0,4
7153,2023-01-03,MAX,heist,Pit Stop,1,1,2
7154,2023-01-03,MAX,gemGrab,Minecart Madness,6,2,8
7155,2023-01-03,MAX,gemGrab,Crystal Arcade,17,22,39
7156,2023-01-03,MAX,brawlBall,Center Stage,5,0,5
7157,2023-01-03,MAX,brawlBall,Beach Ball,76,89,165
7158,2023-01-03,MAX,bounty,Hideout,37,59,96
7159,2023-01-02,MAX,knockout,Belle's Rock,20,28,48
7160,2023-01-02,MAX,hotZone,Quarter Pounder,29,58,87
7161,2023-01-02,MAX,heist,Pit Stop,5,0,5
7162,2023-01-02,MAX,heist,Kaboom Canyon,1,0,1
7163,2023-01-02,MAX,gemGrab,Minecart Madness,31,35,66
7164,2023-01-02,MAX,gemGrab,Double Swoosh,10,14,24
7165,2023-01-02,MAX,brawlBall,Center Stage,59,60,119
7166,2023-01-02,MAX,brawlBall,Backyard Bowl,10,9,19
7167,2023-01-02,MAX,bounty,Hideout,62,52,114
7168,2023-01-01,MAX,knockout,Belle's Rock,5,5,10
7169,2023-01-01,MAX,hotZone,Quarter Pounder,5,5,10
7170,2023-01-01,MAX,heist,Bridge Too Far,7,10,17
7171,2023-01-01,MAX,gemGrab,Hard Rock Mine,4,3,7
7172,2023-01-01,MAX,gemGrab,Double Swoosh,18,3,21
7173,2023-01-01,MAX,brawlBall,Backyard Bowl,86,88,174
7174,2023-01-01,MAX,bounty,Canal Grande,1,3,4
7175,2022-12-31,MAX,heist,Kaboom Canyon,1,0,1
7176,2022-12-31,MAX,heist,Bridge Too Far,4,3,7
7177,2022-12-31,MAX,gemGrab,Hard Rock Mine,7,4,11
7178,2022-12-31,MAX,gemGrab,Deep Diner,1,0,1
7179,2022-12-31,MAX,brawlBall,Super Beach,10,22,32
7180,2022-12-31,MAX,brawlBall,Sneaky Fields,4,7,11
7181,2022-12-30,MAX,knockout,Flaring Phoenix,1,0,1
7182,2022-12-30,MAX,hotZone,Controller Chaos,6,4,10
7183,2022-12-30,MAX,gemGrab,Minecart Madness,1,0,1
7184,2022-12-30,MAX,gemGrab,Deep Diner,7,6,13
7185,2022-12-30,MAX,brawlBall,Sneaky Fields,5,4,9
7186,2022-12-29,MAX,heist,Kaboom Canyon,0,1,1
7187,2022-12-29,MAX,gemGrab,Undermine,2,0,2
7188,2022-12-29,MAX,gemGrab,Minecart Madness,1,0,1
7189,2022-12-29,MAX,brawlBall,Pinhole Punt,5,4,9
7190,2022-12-28,MAX,hotZone,Open Zone,1,1,2
7191,2022-12-28,MAX,brawlBall,Sunny Soccer,1,1,2
7192,2022-12-27,MAX,brawlBall,Center Stage,1,0,1
7193,2022-12-27,MAX,brawlBall,Beach Ball,4,1,5
7194,2022-12-26,MAX,hotZone,Controller Chaos,1,0,1
7195,2022-12-26,MAX,gemGrab,Minecart Madness,0,1,1
7196,2022-12-26,MAX,brawlBall,Center Stage,0,2,2
7197,2022-12-25,MAX,brawlBall,Backyard Bowl,1,1,2
7198,2022-12-24,MAX,brawlBall,Super Beach,2,0,2
7199,2022-12-23,MAX,knockout,Out in the Open,1,0,1
7200,2022-12-23,MAX,brawlBall,Sneaky Fields,1,0,1
7201,2022-12-22,MAX,gemGrab,Gem Fort,2,0,2
7202,2022-12-22,MAX,brawlBall,Pinhole Punt,2,1,3
7203,2022-12-20,MAX,brawlBall,Beach Ball,2,0,2
7204,2022-12-19,MAX,brawlBall,Center Stage,1,0,1
7205,2022-12-13,MAX,knockout,New Perspective,2,0,2
7206,2022-12-13,MAX,gemGrab,Crystal Arcade,1,0,1
7207,2022-12-13,MAX,brawlBall,Beach Ball,0,2,2
7208,2022-11-11,MAX,brawlBall,Sneaky Fields,0,1,1
7209,2022-11-03,MAX,brawlBall,Pinhole Punt,0,1,1
7210,2022-11-01,MAX,knockout,New Perspective,0,1,1
7211,2022-10-30,MAX,hotZone,Dueling Beetles,1,0,1
7212,2022-10-15,MAX,gemGrab,Hard Rock Mine,1,0,1
7213,2022-10-15,MAX,bounty,Dry Season,1,0,1
7214,2023-02-05,MANDY,knockout,X Marks the Spot,392,594,986
7215,2023-02-05,MANDY,knockout,Goldarm Gulch,58,45,103
7216,2023-02-05,MANDY,hotZone,Ring of Fire,89,113,202
7217,2023-02-05,MANDY,heist,Snaked Assault,26,36,62
7218,2023-02-05,MANDY,heist,Pit Stop,3,0,3
7219,2023-02-05,MANDY,gemGrab,Hard Rock Mine,33,40,73
7220,2023-02-05,MANDY,gemGrab,Double Swoosh,130,152,282
7221,2023-02-05,MANDY,brawlBall,Super Beach,19,18,37
7222,2023-02-05,MANDY,brawlBall,Sneaky Fields,2,3,5
7223,2023-02-05,MANDY,brawlBall,Backyard Bowl,1120,1479,2599
7224,2023-02-05,MANDY,bounty,Layer Cake,126,180,306
7225,2023-02-04,MANDY,knockout,X Marks the Spot,159,228,387
7226,2023-02-04,MANDY,knockout,Goldarm Gulch,48,42,90
7227,2023-02-04,MANDY,hotZone,Ring of Fire,22,21,43
7228,2023-02-04,MANDY,heist,Tornado Ring,1,1,2
7229,2023-02-04,MANDY,heist,Pit Stop,1,2,3
7230,2023-02-04,MANDY,gemGrab,Hard Rock Mine,26,40,66
7231,2023-02-04,MANDY,gemGrab,Double Swoosh,5,6,11
7232,2023-02-04,MANDY,gemGrab,Deep Diner,4,2,6
7233,2023-02-04,MANDY,brawlBall,Super Beach,131,227,358
7234,2023-02-04,MANDY,brawlBall,Sneaky Fields,1,4,5
7235,2023-02-04,MANDY,bounty,Dry Season,67,121,188
7236,2023-02-03,MANDY,knockout,Out in the Open,695,934,1629
7237,2023-02-03,MANDY,knockout,Goldarm Gulch,263,291,554
7238,2023-02-03,MANDY,hotZone,Split,29,47,76
7239,2023-02-03,MANDY,heist,Tornado Ring,37,25,62
7240,2023-02-03,MANDY,heist,Pit Stop,11,13,24
7241,2023-02-03,MANDY,gemGrab,Undermine,29,37,66
7242,2023-02-03,MANDY,gemGrab,Double Swoosh,34,51,85
7243,2023-02-03,MANDY,gemGrab,Deep Diner,149,192,341
7244,2023-02-03,MANDY,brawlBall,Sneaky Fields,445,634,1079
7245,2023-02-03,MANDY,brawlBall,Pinhole Punt,27,34,61
7246,2023-02-03,MANDY,bounty,Dry Season,788,1124,1912
7247,2023-02-02,MANDY,knockout,Out in the Open,310,423,733
7248,2023-02-02,MANDY,hotZone,Split,18,19,37
7249,2023-02-02,MANDY,heist,Kaboom Canyon,32,23,55
7250,2023-02-02,MANDY,gemGrab,Undermine,20,29,49
7251,2023-02-02,MANDY,gemGrab,Gem Fort,18,15,33
7252,2023-02-02,MANDY,brawlBall,Sunny Soccer,1,1,2
7253,2023-02-02,MANDY,brawlBall,Pinhole Punt,234,298,532
7254,2023-02-02,MANDY,bounty,Shooting Star,130,183,313
7255,2023-02-01,MANDY,knockout,Goldarm Gulch,678,866,1544
7256,2023-02-01,MANDY,hotZone,Parallel Plays,65,96,161
7257,2023-02-01,MANDY,heist,Kaboom Canyon,71,73,144
7258,2023-02-01,MANDY,gemGrab,Gem Fort,112,140,252
7259,2023-02-01,MANDY,gemGrab,Crystal Arcade,85,108,193
7260,2023-02-01,MANDY,brawlBall,Sunny Soccer,463,627,1090
7261,2023-02-01,MANDY,brawlBall,Beach Ball,10,19,29
7262,2023-02-01,MANDY,bounty,Shooting Star,335,492,827
7263,2023-01-31,MANDY,knockout,Goldarm Gulch,386,466,852
7264,2023-01-31,MANDY,hotZone,Parallel Plays,29,40,69
7265,2023-01-31,MANDY,heist,Pit Stop,12,14,26
7266,2023-01-31,MANDY,gemGrab,Minecart Madness,14,29,43
7267,2023-01-31,MANDY,gemGrab,Crystal Arcade,67,94,161
7268,2023-01-31,MANDY,brawlBall,Center Stage,22,19,41
7269,2023-01-31,MANDY,brawlBall,Beach Ball,312,420,732
7270,2023-01-31,MANDY,bounty,Hideout,92,130,222
7271,2023-01-30,MANDY,knockout,Belle's Rock,570,852,1422
7272,2023-01-30,MANDY,hotZone,Quarter Pounder,56,65,121
7273,2023-01-30,MANDY,heist,Pit Stop,7,13,20
7274,2023-01-30,MANDY,gemGrab,Minecart Madness,205,349,554
7275,2023-01-30,MANDY,gemGrab,Double Swoosh,66,64,130
7276,2023-01-30,MANDY,brawlBall,Center Stage,403,482,885
7277,2023-01-30,MANDY,brawlBall,Backyard Bowl,80,156,236
7278,2023-01-30,MANDY,bounty,Hideout,174,282,456
7279,2023-01-29,MANDY,knockout,Belle's Rock,663,957,1620
7280,2023-01-29,MANDY,hotZone,Quarter Pounder,59,56,115
7281,2023-01-29,MANDY,heist,Bridge Too Far,285,370,655
7282,2023-01-29,MANDY,gemGrab,Hard Rock Mine,19,35,54
7283,2023-01-29,MANDY,gemGrab,Double Swoosh,152,179,331
7284,2023-01-29,MANDY,brawlBall,Super Beach,10,11,21
7285,2023-01-29,MANDY,brawlBall,Backyard Bowl,1193,1705,2898
7286,2023-01-29,MANDY,bounty,Canal Grande,79,101,180
7287,2023-01-28,MANDY,knockout,Flaring Phoenix,369,510,879
7288,2023-01-28,MANDY,hotZone,Controller Chaos,38,48,86
7289,2023-01-28,MANDY,heist,Bridge Too Far,646,678,1324
7290,2023-01-28,MANDY,gemGrab,Hard Rock Mine,140,148,288
7291,2023-01-28,MANDY,gemGrab,Deep Diner,42,56,98
7292,2023-01-28,MANDY,brawlBall,Super Beach,581,847,1428
7293,2023-01-28,MANDY,brawlBall,Sneaky Fields,24,35,59
7294,2023-01-28,MANDY,bounty,Canal Grande,144,223,367
7295,2023-01-27,MANDY,knockout,Flaring Phoenix,171,231,402
7296,2023-01-27,MANDY,hotZone,Controller Chaos,18,10,28
7297,2023-01-27,MANDY,heist,Hot Potato,16,21,37
7298,2023-01-27,MANDY,gemGrab,Undermine,7,7,14
7299,2023-01-27,MANDY,gemGrab,Deep Diner,69,123,192
7300,2023-01-27,MANDY,brawlBall,Sneaky Fields,119,187,306
7301,2023-01-27,MANDY,brawlBall,Pinhole Punt,4,3,7
7302,2023-01-27,MANDY,bounty,Temple Ruins,29,52,81
7303,2023-01-26,MANDY,knockout,Riverside,670,1034,1704
7304,2023-01-26,MANDY,hotZone,Open Zone,99,155,254
7305,2023-01-26,MANDY,heist,Hot Potato,54,67,121
7306,2023-01-26,MANDY,gemGrab,Undermine,76,142,218
7307,2023-01-26,MANDY,gemGrab,Gem Fort,33,37,70
7308,2023-01-26,MANDY,brawlBall,Sunny Soccer,4,12,16
7309,2023-01-26,MANDY,brawlBall,Pinhole Punt,644,1081,1725
7310,2023-01-26,MANDY,bounty,Temple Ruins,75,125,200
7311,2023-01-25,MANDY,knockout,Riverside,414,607,1021
7312,2023-01-25,MANDY,hotZone,Open Zone,42,60,102
7313,2023-01-25,MANDY,heist,Safe Zone,119,133,252
7314,2023-01-25,MANDY,gemGrab,Gem Fort,63,65,128
7315,2023-01-25,MANDY,gemGrab,Crystal Arcade,59,94,153
7316,2023-01-25,MANDY,brawlBall,Sunny Soccer,341,521,862
7317,2023-01-25,MANDY,brawlBall,Beach Ball,34,43,77
7318,2023-01-25,MANDY,bounty,Excel,82,116,198
7319,2023-01-24,MANDY,knockout,New Perspective,271,457,728
7320,2023-01-24,MANDY,hotZone,Dueling Beetles,43,46,89
7321,2023-01-24,MANDY,heist,Safe Zone,250,238,488
7322,2023-01-24,MANDY,gemGrab,Minecart Madness,87,109,196
7323,2023-01-24,MANDY,gemGrab,Crystal Arcade,184,260,444
7324,2023-01-24,MANDY,brawlBall,Center Stage,28,72,100
7325,2023-01-24,MANDY,brawlBall,Beach Ball,482,796,1278
7326,2023-01-24,MANDY,bounty,Excel,141,234,375
7327,2023-01-23,MANDY,knockout,New Perspective,527,720,1247
7328,2023-01-23,MANDY,hotZone,Dueling Beetles,79,111,190
7329,2023-01-23,MANDY,heist,Snaked Assault,43,50,93
7330,2023-01-23,MANDY,gemGrab,Minecart Madness,318,452,770
7331,2023-01-23,MANDY,gemGrab,Double Swoosh,49,90,139
7332,2023-01-23,MANDY,brawlBall,Center Stage,678,987,1665
7333,2023-01-23,MANDY,brawlBall,Backyard Bowl,66,86,152
7334,2023-01-23,MANDY,bounty,Layer Cake,151,213,364
7335,2023-01-22,MANDY,knockout,X Marks the Spot,294,397,691
7336,2023-01-22,MANDY,hotZone,Ring of Fire,28,40,68
7337,2023-01-22,MANDY,heist,Snaked Assault,22,32,54
7338,2023-01-22,MANDY,gemGrab,Hard Rock Mine,64,106,170
7339,2023-01-22,MANDY,gemGrab,Double Swoosh,86,122,208
7340,2023-01-22,MANDY,brawlBall,Super Beach,50,64,114
7341,2023-01-22,MANDY,brawlBall,Backyard Bowl,598,890,1488
7342,2023-01-22,MANDY,bounty,Layer Cake,84,136,220
7343,2023-01-21,MANDY,knockout,X Marks the Spot,903,1276,2179
7344,2023-01-21,MANDY,hotZone,Ring of Fire,103,97,200
7345,2023-01-21,MANDY,heist,Tornado Ring,34,38,72
7346,2023-01-21,MANDY,gemGrab,Hard Rock Mine,205,310,515
7347,2023-01-21,MANDY,gemGrab,Deep Diner,68,80,148
7348,2023-01-21,MANDY,brawlBall,Super Beach,713,1272,1985
7349,2023-01-21,MANDY,brawlBall,Sneaky Fields,15,29,44
7350,2023-01-21,MANDY,bounty,Dry Season,385,605,990
7351,2023-01-20,MANDY,knockout,Out in the Open,669,919,1588
7352,2023-01-20,MANDY,hotZone,Split,26,39,65
7353,2023-01-20,MANDY,heist,Tornado Ring,53,51,104
7354,2023-01-20,MANDY,gemGrab,Undermine,62,103,165
7355,2023-01-20,MANDY,gemGrab,Deep Diner,225,372,597
7356,2023-01-20,MANDY,brawlBall,Sneaky Fields,469,693,1162
7357,2023-01-20,MANDY,brawlBall,Pinhole Punt,29,26,55
7358,2023-01-20,MANDY,bounty,Dry Season,436,677,1113
7359,2023-01-19,MANDY,knockout,Out in the Open,686,1017,1703
7360,2023-01-19,MANDY,hotZone,Split,37,57,94
7361,2023-01-19,MANDY,heist,Kaboom Canyon,71,128,199
7362,2023-01-19,MANDY,gemGrab,Undermine,133,200,333
7363,2023-01-19,MANDY,gemGrab,Gem Fort,13,30,43
7364,2023-01-19,MANDY,brawlBall,Sunny Soccer,16,41,57
7365,2023-01-19,MANDY,brawlBall,Pinhole Punt,758,1082,1840
7366,2023-01-19,MANDY,bounty,Shooting Star,305,528,833
7367,2023-01-18,MANDY,knockout,Goldarm Gulch,71,136,207
7368,2023-01-18,MANDY,hotZone,Parallel Plays,6,5,11
7369,2023-01-18,MANDY,heist,Kaboom Canyon,35,67,102
7370,2023-01-18,MANDY,gemGrab,Gem Fort,44,48,92
7371,2023-01-18,MANDY,gemGrab,Crystal Arcade,7,3,10
7372,2023-01-18,MANDY,brawlBall,Sunny Soccer,221,338,559
7373,2023-01-18,MANDY,brawlBall,Beach Ball,12,10,22
7374,2023-01-18,MANDY,bounty,Shooting Star,223,320,543
7375,2023-01-17,MANDY,knockout,Goldarm Gulch,60,84,144
7376,2023-01-17,MANDY,hotZone,Parallel Plays,12,6,18
7377,2023-01-17,MANDY,heist,Pit Stop,2,4,6
7378,2023-01-17,MANDY,gemGrab,Minecart Madness,6,6,12
7379,2023-01-17,MANDY,gemGrab,Crystal Arcade,10,16,26
7380,2023-01-17,MANDY,brawlBall,Center Stage,1,0,1
7381,2023-01-17,MANDY,brawlBall,Beach Ball,41,104,145
7382,2023-01-17,MANDY,bounty,Hideout,17,14,31
7383,2023-01-16,MANDY,knockout,Belle's Rock,38,65,103
7384,2023-01-16,MANDY,hotZone,Quarter Pounder,9,8,17
7385,2023-01-16,MANDY,heist,Pit Stop,2,0,2
7386,2023-01-16,MANDY,gemGrab,Minecart Madness,20,39,59
7387,2023-01-16,MANDY,gemGrab,Double Swoosh,1,0,1
7388,2023-01-16,MANDY,brawlBall,Center Stage,52,55,107
7389,2023-01-16,MANDY,brawlBall,Backyard Bowl,9,50,59
7390,2023-01-16,MANDY,bounty,Hideout,38,112,150
7391,2023-01-15,MANDY,knockout,Belle's Rock,71,127,198
7392,2023-01-15,MANDY,hotZone,Quarter Pounder,18,21,39
7393,2023-01-15,MANDY,heist,Bridge Too Far,54,68,122
7394,2023-01-15,MANDY,gemGrab,Hard Rock Mine,7,26,33
7395,2023-01-15,MANDY,gemGrab,Double Swoosh,11,13,24
7396,2023-01-15,MANDY,brawlBall,Super Beach,5,4,9
7397,2023-01-15,MANDY,brawlBall,Backyard Bowl,104,224,328
7398,2023-01-15,MANDY,bounty,Canal Grande,5,31,36
7399,2023-01-14,MANDY,knockout,Flaring Phoenix,20,39,59
7400,2023-01-14,MANDY,hotZone,Controller Chaos,16,18,34
7401,2023-01-14,MANDY,heist,Bridge Too Far,76,150,226
7402,2023-01-14,MANDY,gemGrab,Hard Rock Mine,5,12,17
7403,2023-01-14,MANDY,gemGrab,Deep Diner,13,24,37
7404,2023-01-14,MANDY,brawlBall,Super Beach,63,201,264
7405,2023-01-14,MANDY,brawlBall,Sneaky Fields,3,1,4
7406,2023-01-14,MANDY,bounty,Canal Grande,3,6,9
7407,2023-01-13,MANDY,knockout,Flaring Phoenix,31,87,118
7408,2023-01-13,MANDY,hotZone,Controller Chaos,1,1,2
7409,2023-01-13,MANDY,gemGrab,Undermine,1,1,2
7410,2023-01-13,MANDY,gemGrab,Deep Diner,12,15,27
7411,2023-01-13,MANDY,brawlBall,Sneaky Fields,39,95,134
7412,2023-01-13,MANDY,bounty,Temple Ruins,1,2,3
7413,2023-01-12,MANDY,knockout,Riverside,44,103,147
7414,2023-01-12,MANDY,hotZone,Open Zone,11,25,36
7415,2023-01-12,MANDY,gemGrab,Undermine,8,2,10
7416,2023-01-12,MANDY,brawlBall,Sunny Soccer,3,11,14
7417,2023-01-12,MANDY,brawlBall,Pinhole Punt,7,4,11
7418,2023-01-11,MANDY,knockout,Riverside,8,7,15
7419,2023-01-11,MANDY,hotZone,Open Zone,0,1,1
7420,2023-01-11,MANDY,gemGrab,Gem Fort,2,7,9
7421,2023-01-11,MANDY,brawlBall,Sunny Soccer,4,10,14
7422,2023-01-10,MANDY,knockout,New Perspective,3,9,12
7423,2023-01-10,MANDY,hotZone,Dueling Beetles,8,17,25
7424,2023-01-10,MANDY,heist,Safe Zone,1,0,1
7425,2023-01-10,MANDY,gemGrab,Minecart Madness,5,30,35
7426,2023-01-10,MANDY,gemGrab,Crystal Arcade,12,28,40
7427,2023-01-10,MANDY,brawlBall,Beach Ball,26,48,74
7428,2023-01-09,MANDY,knockout,New Perspective,4,9,13
7429,2023-01-09,MANDY,hotZone,Dueling Beetles,9,20,29
7430,2023-01-09,MANDY,gemGrab,Minecart Madness,8,25,33
7431,2023-01-09,MANDY,gemGrab,Double Swoosh,3,7,10
7432,2023-01-09,MANDY,brawlBall,Center Stage,9,24,33
7433,2023-01-09,MANDY,brawlBall,Backyard Bowl,2,1,3
7434,2023-01-09,MANDY,bounty,Layer Cake,4,6,10
7435,2023-01-08,MANDY,knockout,X Marks the Spot,8,3,11
7436,2023-01-08,MANDY,hotZone,Ring of Fire,0,9,9
7437,2023-01-08,MANDY,heist,Snaked Assault,5,17,22
7438,2023-01-08,MANDY,gemGrab,Hard Rock Mine,0,2,2
7439,2023-01-08,MANDY,brawlBall,Super Beach,3,0,3
7440,2023-01-08,MANDY,brawlBall,Backyard Bowl,7,10,17
7441,2023-01-08,MANDY,bounty,Layer Cake,0,1,1
7442,2023-01-07,MANDY,knockout,X Marks the Spot,4,10,14
7443,2023-01-07,MANDY,heist,Tornado Ring,1,0,1
7444,2023-01-07,MANDY,brawlBall,Super Beach,3,8,11
7445,2023-01-07,MANDY,bounty,Dry Season,8,26,34
7446,2023-01-06,MANDY,knockout,Out in the Open,3,16,19
7447,2023-01-06,MANDY,heist,Tornado Ring,4,11,15
7448,2023-01-06,MANDY,gemGrab,Deep Diner,1,2,3
7449,2023-01-06,MANDY,brawlBall,Sneaky Fields,28,52,80
7450,2023-01-06,MANDY,brawlBall,Pinhole Punt,2,5,7
7451,2023-01-06,MANDY,bounty,Dry Season,24,51,75
7452,2023-01-05,MANDY,knockout,Out in the Open,47,88,135
7453,2023-01-05,MANDY,heist,Kaboom Canyon,2,2,4
7454,2023-01-05,MANDY,brawlBall,Pinhole Punt,51,129,180
7455,2023-01-05,MANDY,bounty,Shooting Star,13,14,27
7456,2023-01-04,MANDY,knockout,Goldarm Gulch,6,31,37
7457,2023-01-04,MANDY,hotZone,Parallel Plays,2,20,22
7458,2023-01-04,MANDY,heist,Kaboom Canyon,1,17,18
7459,2023-01-04,MANDY,gemGrab,Gem Fort,2,1,3
7460,2023-01-04,MANDY,gemGrab,Crystal Arcade,0,2,2
7461,2023-01-04,MANDY,brawlBall,Sunny Soccer,36,99,135
7462,2023-01-04,MANDY,bounty,Shooting Star,29,91,120
7463,2023-01-03,MANDY,knockout,Goldarm Gulch,11,22,33
7464,2023-01-03,MANDY,hotZone,Parallel Plays,3,14,17
7465,2023-01-03,MANDY,heist,Pit Stop,2,0,2
7466,2023-01-03,MANDY,gemGrab,Minecart Madness,11,34,45
7467,2023-01-03,MANDY,gemGrab,Crystal Arcade,11,45,56
7468,2023-01-03,MANDY,brawlBall,Center Stage,4,21,25
7469,2023-01-03,MANDY,brawlBall,Beach Ball,48,153,201
7470,2023-01-03,MANDY,bounty,Hideout,17,70,87
7471,2023-01-02,MANDY,knockout,Belle's Rock,2,29,31
7472,2023-01-02,MANDY,hotZone,Quarter Pounder,0,1,1
7473,2023-01-02,MANDY,heist,Pit Stop,1,0,1
7474,2023-01-02,MANDY,gemGrab,Minecart Madness,41,137,178
7475,2023-01-02,MANDY,brawlBall,Center Stage,90,290,380
7476,2023-01-02,MANDY,bounty,Hideout,49,152,201
7477,2023-02-05,LOU,knockout,X Marks the Spot,7,8,15
7478,2023-02-05,LOU,knockout,Goldarm Gulch,1,0,1
7479,2023-02-05,LOU,hotZone,Ring of Fire,224,352,576
7480,2023-02-05,LOU,heist,Snaked Assault,17,10,27
7481,2023-02-05,LOU,heist,Pit Stop,1,1,2
7482,2023-02-05,LOU,gemGrab,Hard Rock Mine,4,4,8
7483,2023-02-05,LOU,gemGrab,Double Swoosh,33,26,59
7484,2023-02-05,LOU,brawlBall,Super Beach,6,3,9
7485,2023-02-05,LOU,brawlBall,Sneaky Fields,6,12,18
7486,2023-02-05,LOU,brawlBall,Backyard Bowl,174,233,407
7487,2023-02-05,LOU,bounty,Layer Cake,3,1,4
7488,2023-02-04,LOU,knockout,X Marks the Spot,5,4,9
7489,2023-02-04,LOU,knockout,Goldarm Gulch,1,0,1
7490,2023-02-04,LOU,hotZone,Ring of Fire,79,80,159
7491,2023-02-04,LOU,heist,Tornado Ring,1,0,1
7492,2023-02-04,LOU,heist,Pit Stop,1,0,1
7493,2023-02-04,LOU,gemGrab,Hard Rock Mine,5,5,10
7494,2023-02-04,LOU,gemGrab,Double Swoosh,8,0,8
7495,2023-02-04,LOU,gemGrab,Deep Diner,3,2,5
7496,2023-02-04,LOU,brawlBall,Super Beach,72,89,161
7497,2023-02-04,LOU,brawlBall,Sneaky Fields,10,9,19
7498,2023-02-04,LOU,bounty,Dry Season,1,1,2
7499,2023-02-03,LOU,knockout,Out in the Open,21,17,38
7500,2023-02-03,LOU,knockout,Goldarm Gulch,2,5,7
7501,2023-02-03,LOU,hotZone,Split,25,23,48
7502,2023-02-03,LOU,heist,Tornado Ring,8,4,12
7503,2023-02-03,LOU,heist,Pit Stop,5,8,13
7504,2023-02-03,LOU,gemGrab,Undermine,8,7,15
7505,2023-02-03,LOU,gemGrab,Double Swoosh,52,23,75
7506,2023-02-03,LOU,gemGrab,Deep Diner,43,34,77
7507,2023-02-03,LOU,brawlBall,Sneaky Fields,360,591,951
7508,2023-02-03,LOU,brawlBall,Pinhole Punt,14,17,31
7509,2023-02-03,LOU,bounty,Dry Season,17,6,23
7510,2023-02-02,LOU,knockout,Out in the Open,5,4,9
7511,2023-02-02,LOU,hotZone,Split,6,7,13
7512,2023-02-02,LOU,heist,Kaboom Canyon,2,0,2
7513,2023-02-02,LOU,gemGrab,Undermine,7,4,11
7514,2023-02-02,LOU,gemGrab,Gem Fort,4,0,4
7515,2023-02-02,LOU,brawlBall,Sunny Soccer,3,0,3
7516,2023-02-02,LOU,brawlBall,Pinhole Punt,101,144,245
7517,2023-02-02,LOU,bounty,Shooting Star,2,2,4
7518,2023-02-01,LOU,knockout,Goldarm Gulch,22,13,35
7519,2023-02-01,LOU,hotZone,Parallel Plays,71,93,164
7520,2023-02-01,LOU,heist,Kaboom Canyon,14,26,40
7521,2023-02-01,LOU,gemGrab,Gem Fort,32,42,74
7522,2023-02-01,LOU,gemGrab,Crystal Arcade,16,17,33
7523,2023-02-01,LOU,brawlBall,Sunny Soccer,178,294,472
7524,2023-02-01,LOU,brawlBall,Beach Ball,5,1,6
7525,2023-02-01,LOU,bounty,Shooting Star,3,0,3
7526,2023-01-31,LOU,knockout,Goldarm Gulch,6,4,10
7527,2023-01-31,LOU,hotZone,Parallel Plays,57,87,144
7528,2023-01-31,LOU,heist,Pit Stop,3,2,5
7529,2023-01-31,LOU,gemGrab,Minecart Madness,5,0,5
7530,2023-01-31,LOU,gemGrab,Crystal Arcade,12,25,37
7531,2023-01-31,LOU,brawlBall,Center Stage,3,2,5
7532,2023-01-31,LOU,brawlBall,Beach Ball,113,175,288
7533,2023-01-31,LOU,bounty,Hideout,7,7,14
7534,2023-01-30,LOU,knockout,Belle's Rock,12,12,24
7535,2023-01-30,LOU,hotZone,Quarter Pounder,125,254,379
7536,2023-01-30,LOU,heist,Pit Stop,5,0,5
7537,2023-01-30,LOU,gemGrab,Minecart Madness,32,33,65
7538,2023-01-30,LOU,gemGrab,Double Swoosh,30,20,50
7539,2023-01-30,LOU,brawlBall,Center Stage,167,236,403
7540,2023-01-30,LOU,brawlBall,Backyard Bowl,19,24,43
7541,2023-01-30,LOU,bounty,Hideout,7,0,7
7542,2023-01-29,LOU,knockout,Belle's Rock,18,10,28
7543,2023-01-29,LOU,hotZone,Quarter Pounder,85,123,208
7544,2023-01-29,LOU,heist,Bridge Too Far,18,11,29
7545,2023-01-29,LOU,gemGrab,Hard Rock Mine,5,3,8
7546,2023-01-29,LOU,gemGrab,Double Swoosh,31,16,47
7547,2023-01-29,LOU,brawlBall,Super Beach,4,3,7
7548,2023-01-29,LOU,brawlBall,Backyard Bowl,182,219,401
7549,2023-01-29,LOU,bounty,Canal Grande,9,8,17
7550,2023-01-28,LOU,knockout,Flaring Phoenix,14,6,20
7551,2023-01-28,LOU,hotZone,Controller Chaos,115,160,275
7552,2023-01-28,LOU,heist,Bridge Too Far,23,34,57
7553,2023-01-28,LOU,gemGrab,Hard Rock Mine,46,34,80
7554,2023-01-28,LOU,gemGrab,Deep Diner,16,19,35
7555,2023-01-28,LOU,brawlBall,Super Beach,262,326,588
7556,2023-01-28,LOU,brawlBall,Sneaky Fields,12,28,40
7557,2023-01-28,LOU,bounty,Canal Grande,14,13,27
7558,2023-01-27,LOU,knockout,Flaring Phoenix,4,3,7
7559,2023-01-27,LOU,hotZone,Controller Chaos,24,22,46
7560,2023-01-27,LOU,heist,Hot Potato,3,1,4
7561,2023-01-27,LOU,gemGrab,Undermine,4,4,8
7562,2023-01-27,LOU,gemGrab,Deep Diner,24,28,52
7563,2023-01-27,LOU,brawlBall,Sneaky Fields,80,116,196
7564,2023-01-27,LOU,brawlBall,Pinhole Punt,3,0,3
7565,2023-01-27,LOU,bounty,Temple Ruins,6,9,15
7566,2023-01-26,LOU,knockout,Riverside,22,10,32
7567,2023-01-26,LOU,hotZone,Open Zone,99,114,213
7568,2023-01-26,LOU,heist,Hot Potato,6,3,9
7569,2023-01-26,LOU,gemGrab,Undermine,18,26,44
7570,2023-01-26,LOU,gemGrab,Gem Fort,8,10,18
7571,2023-01-26,LOU,brawlBall,Sunny Soccer,13,11,24
7572,2023-01-26,LOU,brawlBall,Pinhole Punt,266,357,623
7573,2023-01-26,LOU,bounty,Temple Ruins,10,2,12
7574,2023-01-25,LOU,knockout,Riverside,7,3,10
7575,2023-01-25,LOU,hotZone,Open Zone,55,80,135
7576,2023-01-25,LOU,heist,Safe Zone,7,1,8
7577,2023-01-25,LOU,gemGrab,Gem Fort,11,11,22
7578,2023-01-25,LOU,gemGrab,Crystal Arcade,13,10,23
7579,2023-01-25,LOU,brawlBall,Sunny Soccer,153,206,359
7580,2023-01-25,LOU,brawlBall,Beach Ball,24,37,61
7581,2023-01-25,LOU,bounty,Excel,6,11,17
7582,2023-01-24,LOU,knockout,New Perspective,8,4,12
7583,2023-01-24,LOU,hotZone,Dueling Beetles,263,536,799
7584,2023-01-24,LOU,heist,Safe Zone,17,5,22
7585,2023-01-24,LOU,gemGrab,Minecart Madness,16,6,22
7586,2023-01-24,LOU,gemGrab,Crystal Arcade,35,35,70
7587,2023-01-24,LOU,brawlBall,Center Stage,11,13,24
7588,2023-01-24,LOU,brawlBall,Beach Ball,221,275,496
7589,2023-01-24,LOU,bounty,Excel,8,2,10
7590,2023-01-23,LOU,knockout,New Perspective,20,18,38
7591,2023-01-23,LOU,hotZone,Dueling Beetles,557,923,1480
7592,2023-01-23,LOU,heist,Snaked Assault,4,4,8
7593,2023-01-23,LOU,gemGrab,Minecart Madness,66,100,166
7594,2023-01-23,LOU,gemGrab,Double Swoosh,15,4,19
7595,2023-01-23,LOU,brawlBall,Center Stage,243,417,660
7596,2023-01-23,LOU,brawlBall,Backyard Bowl,4,19,23
7597,2023-01-23,LOU,bounty,Layer Cake,4,4,8
7598,2023-01-22,LOU,knockout,X Marks the Spot,6,2,8
7599,2023-01-22,LOU,hotZone,Ring of Fire,132,247,379
7600,2023-01-22,LOU,heist,Snaked Assault,4,1,5
7601,2023-01-22,LOU,gemGrab,Hard Rock Mine,2,5,7
7602,2023-01-22,LOU,gemGrab,Double Swoosh,13,17,30
7603,2023-01-22,LOU,brawlBall,Super Beach,25,62,87
7604,2023-01-22,LOU,brawlBall,Backyard Bowl,87,105,192
7605,2023-01-22,LOU,bounty,Layer Cake,3,8,11
7606,2023-01-21,LOU,knockout,X Marks the Spot,25,25,50
7607,2023-01-21,LOU,hotZone,Ring of Fire,469,645,1114
7608,2023-01-21,LOU,heist,Tornado Ring,4,2,6
7609,2023-01-21,LOU,gemGrab,Hard Rock Mine,21,23,44
7610,2023-01-21,LOU,gemGrab,Deep Diner,14,5,19
7611,2023-01-21,LOU,brawlBall,Super Beach,339,578,917
7612,2023-01-21,LOU,brawlBall,Sneaky Fields,8,9,17
7613,2023-01-21,LOU,bounty,Dry Season,10,7,17
7614,2023-01-20,LOU,knockout,Out in the Open,23,10,33
7615,2023-01-20,LOU,hotZone,Split,25,19,44
7616,2023-01-20,LOU,heist,Tornado Ring,10,9,19
7617,2023-01-20,LOU,gemGrab,Undermine,8,11,19
7618,2023-01-20,LOU,gemGrab,Deep Diner,56,47,103
7619,2023-01-20,LOU,brawlBall,Sneaky Fields,243,272,515
7620,2023-01-20,LOU,brawlBall,Pinhole Punt,9,19,28
7621,2023-01-20,LOU,bounty,Dry Season,5,7,12
7622,2023-01-19,LOU,knockout,Out in the Open,24,19,43
7623,2023-01-19,LOU,hotZone,Split,35,34,69
7624,2023-01-19,LOU,heist,Kaboom Canyon,9,5,14
7625,2023-01-19,LOU,gemGrab,Undermine,22,25,47
7626,2023-01-19,LOU,gemGrab,Gem Fort,5,2,7
7627,2023-01-19,LOU,brawlBall,Sunny Soccer,7,4,11
7628,2023-01-19,LOU,brawlBall,Pinhole Punt,209,248,457
7629,2023-01-19,LOU,bounty,Shooting Star,6,9,15
7630,2023-01-18,LOU,knockout,Goldarm Gulch,2,1,3
7631,2023-01-18,LOU,hotZone,Parallel Plays,6,10,16
7632,2023-01-18,LOU,heist,Kaboom Canyon,3,7,10
7633,2023-01-18,LOU,gemGrab,Gem Fort,9,3,12
7634,2023-01-18,LOU,gemGrab,Crystal Arcade,0,4,4
7635,2023-01-18,LOU,brawlBall,Sunny Soccer,56,49,105
7636,2023-01-18,LOU,bounty,Shooting Star,2,2,4
7637,2023-01-17,LOU,knockout,Goldarm Gulch,3,2,5
7638,2023-01-17,LOU,hotZone,Parallel Plays,4,4,8
7639,2023-01-17,LOU,gemGrab,Minecart Madness,1,2,3
7640,2023-01-17,LOU,gemGrab,Crystal Arcade,3,0,3
7641,2023-01-17,LOU,brawlBall,Beach Ball,11,20,31
7642,2023-01-17,LOU,bounty,Hideout,0,2,2
7643,2023-01-16,LOU,knockout,Belle's Rock,1,0,1
7644,2023-01-16,LOU,hotZone,Quarter Pounder,4,2,6
7645,2023-01-16,LOU,heist,Pit Stop,4,1,5
7646,2023-01-16,LOU,gemGrab,Minecart Madness,6,9,15
7647,2023-01-16,LOU,brawlBall,Center Stage,8,17,25
7648,2023-01-16,LOU,brawlBall,Backyard Bowl,3,0,3
7649,2023-01-15,LOU,knockout,Belle's Rock,0,1,1
7650,2023-01-15,LOU,hotZone,Quarter Pounder,13,17,30
7651,2023-01-15,LOU,heist,Bridge Too Far,1,5,6
7652,2023-01-15,LOU,gemGrab,Double Swoosh,5,6,11
7653,2023-01-15,LOU,brawlBall,Super Beach,9,9,18
7654,2023-01-15,LOU,brawlBall,Backyard Bowl,17,34,51
7655,2023-01-15,LOU,bounty,Canal Grande,1,1,2
7656,2023-01-14,LOU,knockout,Flaring Phoenix,1,0,1
7657,2023-01-14,LOU,hotZone,Controller Chaos,19,77,96
7658,2023-01-14,LOU,heist,Bridge Too Far,3,0,3
7659,2023-01-14,LOU,gemGrab,Hard Rock Mine,1,1,2
7660,2023-01-14,LOU,gemGrab,Deep Diner,1,0,1
7661,2023-01-14,LOU,brawlBall,Super Beach,31,23,54
7662,2023-01-14,LOU,brawlBall,Sneaky Fields,5,4,9
7663,2023-01-13,LOU,knockout,Flaring Phoenix,1,2,3
7664,2023-01-13,LOU,hotZone,Controller Chaos,47,70,117
7665,2023-01-13,LOU,gemGrab,Deep Diner,4,10,14
7666,2023-01-13,LOU,brawlBall,Sneaky Fields,15,40,55
7667,2023-01-13,LOU,brawlBall,Pinhole Punt,2,1,3
7668,2023-01-12,LOU,knockout,Riverside,1,0,1
7669,2023-01-12,LOU,hotZone,Open Zone,7,15,22
7670,2023-01-12,LOU,heist,Hot Potato,1,0,1
7671,2023-01-12,LOU,gemGrab,Undermine,1,0,1
7672,2023-01-12,LOU,brawlBall,Sunny Soccer,2,2,4
7673,2023-01-12,LOU,brawlBall,Pinhole Punt,5,2,7
7674,2023-01-11,LOU,knockout,Riverside,1,0,1
7675,2023-01-11,LOU,hotZone,Open Zone,4,3,7
7676,2023-01-11,LOU,gemGrab,Gem Fort,1,0,1
7677,2023-01-11,LOU,brawlBall,Sunny Soccer,7,20,27
7678,2023-01-11,LOU,bounty,Excel,1,0,1
7679,2023-01-10,LOU,knockout,New Perspective,0,1,1
7680,2023-01-10,LOU,hotZone,Dueling Beetles,55,80,135
7681,2023-01-10,LOU,heist,Safe Zone,1,0,1
7682,2023-01-10,LOU,gemGrab,Minecart Madness,2,0,2
7683,2023-01-10,LOU,gemGrab,Crystal Arcade,2,0,2
7684,2023-01-10,LOU,brawlBall,Center Stage,1,0,1
7685,2023-01-10,LOU,brawlBall,Beach Ball,7,9,16
7686,2023-01-09,LOU,hotZone,Dueling Beetles,38,73,111
7687,2023-01-09,LOU,gemGrab,Minecart Madness,4,1,5
7688,2023-01-09,LOU,gemGrab,Double Swoosh,2,2,4
7689,2023-01-09,LOU,brawlBall,Center Stage,10,19,29
7690,2023-01-09,LOU,bounty,Layer Cake,1,0,1
7691,2023-01-08,LOU,knockout,X Marks the Spot,1,0,1
7692,2023-01-08,LOU,hotZone,Ring of Fire,26,24,50
7693,2023-01-08,LOU,heist,Snaked Assault,2,0,2
7694,2023-01-08,LOU,gemGrab,Double Swoosh,1,0,1
7695,2023-01-08,LOU,brawlBall,Backyard Bowl,10,10,20
7696,2023-01-07,LOU,knockout,X Marks the Spot,1,0,1
7697,2023-01-07,LOU,hotZone,Ring of Fire,14,14,28
7698,2023-01-07,LOU,heist,Tornado Ring,1,3,4
7699,2023-01-07,LOU,gemGrab,Deep Diner,0,1,1
7700,2023-01-07,LOU,brawlBall,Super Beach,7,13,20
7701,2023-01-06,LOU,gemGrab,Undermine,1,0,1
7702,2023-01-06,LOU,gemGrab,Deep Diner,2,0,2
7703,2023-01-06,LOU,brawlBall,Sneaky Fields,21,16,37
7704,2023-01-06,LOU,brawlBall,Pinhole Punt,1,0,1
7705,2023-01-05,LOU,knockout,Out in the Open,3,1,4
7706,2023-01-05,LOU,hotZone,Split,7,8,15
7707,2023-01-05,LOU,brawlBall,Pinhole Punt,31,73,104
7708,2023-01-04,LOU,hotZone,Parallel Plays,3,2,5
7709,2023-01-04,LOU,heist,Kaboom Canyon,0,2,2
7710,2023-01-04,LOU,gemGrab,Gem Fort,4,3,7
7711,2023-01-04,LOU,gemGrab,Crystal Arcade,0,1,1
7712,2023-01-04,LOU,brawlBall,Sunny Soccer,27,24,51
7713,2023-01-03,LOU,hotZone,Parallel Plays,3,0,3
7714,2023-01-03,LOU,hotZone,Controller Chaos,1,0,1
7715,2023-01-03,LOU,gemGrab,Minecart Madness,4,6,10
7716,2023-01-03,LOU,gemGrab,Crystal Arcade,0,2,2
7717,2023-01-03,LOU,brawlBall,Beach Ball,16,25,41
7718,2023-01-02,LOU,knockout,Belle's Rock,3,0,3
7719,2023-01-02,LOU,hotZone,Quarter Pounder,24,20,44
7720,2023-01-02,LOU,heist,Pit Stop,0,1,1
7721,2023-01-02,LOU,gemGrab,Minecart Madness,1,3,4
7722,2023-01-02,LOU,gemGrab,Double Swoosh,1,3,4
7723,2023-01-02,LOU,brawlBall,Center Stage,16,26,42
7724,2023-01-02,LOU,brawlBall,Backyard Bowl,1,1,2
7725,2023-01-01,LOU,hotZone,Quarter Pounder,4,3,7
7726,2023-01-01,LOU,gemGrab,Double Swoosh,3,0,3
7727,2023-01-01,LOU,brawlBall,Backyard Bowl,7,9,16
7728,2022-12-31,LOU,hotZone,Controller Chaos,7,15,22
7729,2022-12-31,LOU,gemGrab,Minecart Madness,1,1,2
7730,2022-12-31,LOU,gemGrab,Deep Diner,1,0,1
7731,2022-12-31,LOU,brawlBall,Super Beach,0,1,1
7732,2022-12-31,LOU,brawlBall,Sneaky Fields,1,0,1
7733,2022-12-30,LOU,hotZone,Controller Chaos,7,16,23
7734,2022-12-30,LOU,brawlBall,Sneaky Fields,3,2,5
7735,2022-12-29,LOU,hotZone,Open Zone,0,2,2
7736,2022-12-29,LOU,heist,Hot Potato,1,0,1
7737,2022-12-28,LOU,hotZone,Open Zone,3,2,5
7738,2022-12-28,LOU,brawlBall,Sunny Soccer,1,1,2
7739,2022-12-27,LOU,hotZone,Controller Chaos,0,1,1
7740,2022-12-26,LOU,hotZone,Controller Chaos,1,0,1
7741,2022-12-26,LOU,gemGrab,Minecart Madness,1,0,1
7742,2022-12-22,LOU,brawlBall,Pinhole Punt,3,2,5
7743,2022-12-20,LOU,brawlBall,Beach Ball,2,1,3
7744,2022-12-17,LOU,brawlBall,Super Beach,1,1,2
7745,2022-12-16,LOU,gemGrab,Undermine,1,0,1
7746,2022-12-16,LOU,brawlBall,Sneaky Fields,2,0,2
7747,2022-12-10,LOU,hotZone,Ring of Fire,0,1,1
7748,2022-11-07,LOU,hotZone,Quarter Pounder,3,1,4
7749,2022-10-30,LOU,hotZone,Dueling Beetles,0,2,2
7750,2022-10-30,LOU,heist,Safe Zone,0,1,1
7751,2022-10-28,LOU,hotZone,Dueling Beetles,1,0,1
7752,2023-02-05,LOLA,knockout,X Marks the Spot,20,20,40
7753,2023-02-05,LOLA,knockout,Goldarm Gulch,0,1,1
7754,2023-02-05,LOLA,hotZone,Ring of Fire,39,90,129
7755,2023-02-05,LOLA,heist,Snaked Assault,41,46,87
7756,2023-02-05,LOLA,heist,Pit Stop,1,0,1
7757,2023-02-05,LOLA,gemGrab,Hard Rock Mine,7,17,24
7758,2023-02-05,LOLA,gemGrab,Double Swoosh,36,44,80
7759,2023-02-05,LOLA,brawlBall,Super Beach,2,2,4
7760,2023-02-05,LOLA,brawlBall,Sneaky Fields,1,0,1
7761,2023-02-05,LOLA,brawlBall,Backyard Bowl,315,474,789
7762,2023-02-05,LOLA,bounty,Layer Cake,12,18,30
7763,2023-02-04,LOLA,knockout,X Marks the Spot,1,10,11
7764,2023-02-04,LOLA,knockout,Goldarm Gulch,1,0,1
7765,2023-02-04,LOLA,hotZone,Ring of Fire,27,40,67
7766,2023-02-04,LOLA,heist,Tornado Ring,1,1,2
7767,2023-02-04,LOLA,heist,Pit Stop,6,1,7
7768,2023-02-04,LOLA,gemGrab,Hard Rock Mine,12,8,20
7769,2023-02-04,LOLA,gemGrab,Double Swoosh,1,6,7
7770,2023-02-04,LOLA,gemGrab,Deep Diner,0,1,1
7771,2023-02-04,LOLA,brawlBall,Super Beach,28,43,71
7772,2023-02-04,LOLA,brawlBall,Sneaky Fields,1,0,1
7773,2023-02-04,LOLA,bounty,Dry Season,2,2,4
7774,2023-02-03,LOLA,knockout,Out in the Open,32,40,72
7775,2023-02-03,LOLA,knockout,Goldarm Gulch,4,0,4
7776,2023-02-03,LOLA,hotZone,Split,4,3,7
7777,2023-02-03,LOLA,heist,Tornado Ring,23,14,37
7778,2023-02-03,LOLA,heist,Pit Stop,7,12,19
7779,2023-02-03,LOLA,gemGrab,Undermine,10,31,41
7780,2023-02-03,LOLA,gemGrab,Double Swoosh,19,22,41
7781,2023-02-03,LOLA,gemGrab,Deep Diner,34,26,60
7782,2023-02-03,LOLA,brawlBall,Sneaky Fields,87,122,209
7783,2023-02-03,LOLA,brawlBall,Pinhole Punt,7,30,37
7784,2023-02-03,LOLA,bounty,Dry Season,24,32,56
7785,2023-02-02,LOLA,knockout,Out in the Open,16,17,33
7786,2023-02-02,LOLA,hotZone,Split,3,1,4
7787,2023-02-02,LOLA,heist,Kaboom Canyon,22,50,72
7788,2023-02-02,LOLA,gemGrab,Undermine,12,11,23
7789,2023-02-02,LOLA,gemGrab,Gem Fort,7,13,20
7790,2023-02-02,LOLA,brawlBall,Pinhole Punt,70,85,155
7791,2023-02-02,LOLA,bounty,Shooting Star,4,4,8
7792,2023-02-01,LOLA,knockout,Goldarm Gulch,21,26,47
7793,2023-02-01,LOLA,hotZone,Parallel Plays,21,56,77
7794,2023-02-01,LOLA,heist,Kaboom Canyon,66,71,137
7795,2023-02-01,LOLA,gemGrab,Gem Fort,21,36,57
7796,2023-02-01,LOLA,gemGrab,Crystal Arcade,10,22,32
7797,2023-02-01,LOLA,brawlBall,Sunny Soccer,63,77,140
7798,2023-02-01,LOLA,brawlBall,Beach Ball,2,4,6
7799,2023-02-01,LOLA,bounty,Shooting Star,11,22,33
7800,2023-01-31,LOLA,knockout,Goldarm Gulch,24,15,39
7801,2023-01-31,LOLA,hotZone,Parallel Plays,10,5,15
7802,2023-01-31,LOLA,heist,Pit Stop,7,4,11
7803,2023-01-31,LOLA,gemGrab,Minecart Madness,4,3,7
7804,2023-01-31,LOLA,gemGrab,Crystal Arcade,18,15,33
7805,2023-01-31,LOLA,brawlBall,Center Stage,2,1,3
7806,2023-01-31,LOLA,brawlBall,Beach Ball,41,56,97
7807,2023-01-31,LOLA,bounty,Hideout,4,4,8
7808,2023-01-30,LOLA,knockout,Belle's Rock,11,18,29
7809,2023-01-30,LOLA,hotZone,Quarter Pounder,35,98,133
7810,2023-01-30,LOLA,heist,Pit Stop,8,1,9
7811,2023-01-30,LOLA,gemGrab,Minecart Madness,42,42,84
7812,2023-01-30,LOLA,gemGrab,Double Swoosh,12,23,35
7813,2023-01-30,LOLA,brawlBall,Center Stage,69,55,124
7814,2023-01-30,LOLA,brawlBall,Backyard Bowl,34,50,84
7815,2023-01-30,LOLA,bounty,Hideout,18,32,50
7816,2023-01-29,LOLA,knockout,Belle's Rock,17,8,25
7817,2023-01-29,LOLA,hotZone,Quarter Pounder,52,111,163
7818,2023-01-29,LOLA,heist,Bridge Too Far,170,224,394
7819,2023-01-29,LOLA,gemGrab,Hard Rock Mine,15,34,49
7820,2023-01-29,LOLA,gemGrab,Double Swoosh,33,45,78
7821,2023-01-29,LOLA,brawlBall,Super Beach,7,5,12
7822,2023-01-29,LOLA,brawlBall,Backyard Bowl,343,433,776
7823,2023-01-29,LOLA,bounty,Canal Grande,4,3,7
7824,2023-01-28,LOLA,knockout,Flaring Phoenix,9,6,15
7825,2023-01-28,LOLA,hotZone,Controller Chaos,28,38,66
7826,2023-01-28,LOLA,heist,Bridge Too Far,462,567,1029
7827,2023-01-28,LOLA,gemGrab,Hard Rock Mine,45,78,123
7828,2023-01-28,LOLA,gemGrab,Deep Diner,8,20,28
7829,2023-01-28,LOLA,brawlBall,Super Beach,115,121,236
7830,2023-01-28,LOLA,brawlBall,Sneaky Fields,6,0,6
7831,2023-01-28,LOLA,bounty,Canal Grande,2,4,6
7832,2023-01-27,LOLA,knockout,Flaring Phoenix,11,17,28
7833,2023-01-27,LOLA,hotZone,Controller Chaos,4,4,8
7834,2023-01-27,LOLA,heist,Hot Potato,22,39,61
7835,2023-01-27,LOLA,gemGrab,Undermine,4,1,5
7836,2023-01-27,LOLA,gemGrab,Deep Diner,8,8,16
7837,2023-01-27,LOLA,brawlBall,Sneaky Fields,28,15,43
7838,2023-01-27,LOLA,brawlBall,Pinhole Punt,0,1,1
7839,2023-01-27,LOLA,bounty,Temple Ruins,5,5,10
7840,2023-01-26,LOLA,knockout,Riverside,44,56,100
7841,2023-01-26,LOLA,hotZone,Open Zone,91,141,232
7842,2023-01-26,LOLA,heist,Hot Potato,40,32,72
7843,2023-01-26,LOLA,gemGrab,Undermine,22,27,49
7844,2023-01-26,LOLA,gemGrab,Gem Fort,17,17,34
7845,2023-01-26,LOLA,brawlBall,Sunny Soccer,2,2,4
7846,2023-01-26,LOLA,brawlBall,Pinhole Punt,223,344,567
7847,2023-01-26,LOLA,bounty,Temple Ruins,17,13,30
7848,2023-01-25,LOLA,knockout,Riverside,23,24,47
7849,2023-01-25,LOLA,hotZone,Open Zone,70,94,164
7850,2023-01-25,LOLA,heist,Safe Zone,66,131,197
7851,2023-01-25,LOLA,gemGrab,Gem Fort,8,10,18
7852,2023-01-25,LOLA,gemGrab,Crystal Arcade,20,24,44
7853,2023-01-25,LOLA,brawlBall,Sunny Soccer,41,56,97
7854,2023-01-25,LOLA,brawlBall,Beach Ball,11,6,17
7855,2023-01-25,LOLA,bounty,Excel,2,1,3
7856,2023-01-24,LOLA,knockout,New Perspective,9,11,20
7857,2023-01-24,LOLA,hotZone,Dueling Beetles,34,30,64
7858,2023-01-24,LOLA,heist,Safe Zone,117,121,238
7859,2023-01-24,LOLA,gemGrab,Minecart Madness,11,39,50
7860,2023-01-24,LOLA,gemGrab,Crystal Arcade,35,27,62
7861,2023-01-24,LOLA,brawlBall,Center Stage,6,5,11
7862,2023-01-24,LOLA,brawlBall,Beach Ball,80,103,183
7863,2023-01-24,LOLA,bounty,Excel,8,2,10
7864,2023-01-23,LOLA,knockout,New Perspective,22,15,37
7865,2023-01-23,LOLA,hotZone,Dueling Beetles,46,85,131
7866,2023-01-23,LOLA,heist,Snaked Assault,96,147,243
7867,2023-01-23,LOLA,gemGrab,Minecart Madness,72,124,196
7868,2023-01-23,LOLA,gemGrab,Double Swoosh,6,17,23
7869,2023-01-23,LOLA,brawlBall,Center Stage,89,124,213
7870,2023-01-23,LOLA,brawlBall,Backyard Bowl,26,44,70
7871,2023-01-23,LOLA,bounty,Layer Cake,12,15,27
7872,2023-01-22,LOLA,knockout,X Marks the Spot,4,5,9
7873,2023-01-22,LOLA,hotZone,Ring of Fire,21,61,82
7874,2023-01-22,LOLA,heist,Snaked Assault,40,60,100
7875,2023-01-22,LOLA,gemGrab,Hard Rock Mine,15,11,26
7876,2023-01-22,LOLA,gemGrab,Double Swoosh,24,23,47
7877,2023-01-22,LOLA,brawlBall,Super Beach,9,30,39
7878,2023-01-22,LOLA,brawlBall,Backyard Bowl,157,214,371
7879,2023-01-22,LOLA,bounty,Layer Cake,3,1,4
7880,2023-01-21,LOLA,knockout,X Marks the Spot,48,51,99
7881,2023-01-21,LOLA,hotZone,Ring of Fire,89,98,187
7882,2023-01-21,LOLA,heist,Tornado Ring,26,29,55
7883,2023-01-21,LOLA,gemGrab,Hard Rock Mine,43,36,79
7884,2023-01-21,LOLA,gemGrab,Deep Diner,15,16,31
7885,2023-01-21,LOLA,brawlBall,Super Beach,129,173,302
7886,2023-01-21,LOLA,brawlBall,Sneaky Fields,1,1,2
7887,2023-01-21,LOLA,bounty,Dry Season,21,13,34
7888,2023-01-20,LOLA,knockout,Out in the Open,33,26,59
7889,2023-01-20,LOLA,hotZone,Split,9,10,19
7890,2023-01-20,LOLA,heist,Tornado Ring,30,15,45
7891,2023-01-20,LOLA,gemGrab,Undermine,7,17,24
7892,2023-01-20,LOLA,gemGrab,Deep Diner,35,76,111
7893,2023-01-20,LOLA,brawlBall,Sneaky Fields,60,54,114
7894,2023-01-20,LOLA,brawlBall,Pinhole Punt,6,5,11
7895,2023-01-20,LOLA,bounty,Dry Season,7,28,35
7896,2023-01-19,LOLA,knockout,Out in the Open,53,46,99
7897,2023-01-19,LOLA,hotZone,Split,7,10,17
7898,2023-01-19,LOLA,heist,Kaboom Canyon,71,125,196
7899,2023-01-19,LOLA,gemGrab,Undermine,33,50,83
7900,2023-01-19,LOLA,gemGrab,Gem Fort,15,20,35
7901,2023-01-19,LOLA,brawlBall,Sunny Soccer,5,10,15
7902,2023-01-19,LOLA,brawlBall,Pinhole Punt,232,319,551
7903,2023-01-19,LOLA,bounty,Shooting Star,14,17,31
7904,2023-01-18,LOLA,knockout,Goldarm Gulch,5,4,9
7905,2023-01-18,LOLA,hotZone,Parallel Plays,2,2,4
7906,2023-01-18,LOLA,heist,Kaboom Canyon,21,40,61
7907,2023-01-18,LOLA,gemGrab,Gem Fort,4,5,9
7908,2023-01-18,LOLA,gemGrab,Crystal Arcade,3,0,3
7909,2023-01-18,LOLA,brawlBall,Sunny Soccer,24,23,47
7910,2023-01-18,LOLA,brawlBall,Beach Ball,4,1,5
7911,2023-01-18,LOLA,bounty,Shooting Star,9,10,19
7912,2023-01-17,LOLA,knockout,Goldarm Gulch,5,6,11
7913,2023-01-17,LOLA,hotZone,Parallel Plays,2,3,5
7914,2023-01-17,LOLA,heist,Pit Stop,0,1,1
7915,2023-01-17,LOLA,gemGrab,Minecart Madness,1,5,6
7916,2023-01-17,LOLA,gemGrab,Crystal Arcade,2,4,6
7917,2023-01-17,LOLA,brawlBall,Beach Ball,6,8,14
7918,2023-01-17,LOLA,bounty,Hideout,2,2,4
7919,2023-01-16,LOLA,knockout,Belle's Rock,1,5,6
7920,2023-01-16,LOLA,hotZone,Quarter Pounder,11,21,32
7921,2023-01-16,LOLA,heist,Pit Stop,2,0,2
7922,2023-01-16,LOLA,gemGrab,Minecart Madness,17,14,31
7923,2023-01-16,LOLA,gemGrab,Double Swoosh,1,14,15
7924,2023-01-16,LOLA,brawlBall,Center Stage,2,6,8
7925,2023-01-16,LOLA,brawlBall,Backyard Bowl,3,9,12
7926,2023-01-16,LOLA,bounty,Hideout,3,3,6
7927,2023-01-15,LOLA,hotZone,Quarter Pounder,8,15,23
7928,2023-01-15,LOLA,heist,Bridge Too Far,51,54,105
7929,2023-01-15,LOLA,gemGrab,Hard Rock Mine,1,0,1
7930,2023-01-15,LOLA,gemGrab,Double Swoosh,2,3,5
7931,2023-01-15,LOLA,brawlBall,Super Beach,1,0,1
7932,2023-01-15,LOLA,brawlBall,Backyard Bowl,52,63,115
7933,2023-01-15,LOLA,bounty,Canal Grande,1,0,1
7934,2023-01-14,LOLA,knockout,Flaring Phoenix,1,10,11
7935,2023-01-14,LOLA,hotZone,Controller Chaos,4,3,7
7936,2023-01-14,LOLA,heist,Bridge Too Far,99,137,236
7937,2023-01-14,LOLA,gemGrab,Hard Rock Mine,1,0,1
7938,2023-01-14,LOLA,gemGrab,Deep Diner,2,0,2
7939,2023-01-14,LOLA,brawlBall,Super Beach,15,13,28
7940,2023-01-13,LOLA,knockout,Flaring Phoenix,2,0,2
7941,2023-01-13,LOLA,hotZone,Controller Chaos,4,1,5
7942,2023-01-13,LOLA,heist,Hot Potato,0,1,1
7943,2023-01-13,LOLA,gemGrab,Deep Diner,5,1,6
7944,2023-01-13,LOLA,brawlBall,Sneaky Fields,8,8,16
7945,2023-01-13,LOLA,brawlBall,Pinhole Punt,1,1,2
7946,2023-01-12,LOLA,knockout,Riverside,3,0,3
7947,2023-01-12,LOLA,hotZone,Open Zone,9,7,16
7948,2023-01-12,LOLA,gemGrab,Undermine,4,7,11
7949,2023-01-12,LOLA,brawlBall,Pinhole Punt,1,1,2
7950,2023-01-11,LOLA,hotZone,Open Zone,4,6,10
7951,2023-01-11,LOLA,gemGrab,Gem Fort,0,1,1
7952,2023-01-11,LOLA,brawlBall,Sunny Soccer,1,4,5
7953,2023-01-10,LOLA,knockout,New Perspective,1,0,1
7954,2023-01-10,LOLA,hotZone,Dueling Beetles,4,12,16
7955,2023-01-10,LOLA,heist,Safe Zone,7,8,15
7956,2023-01-10,LOLA,gemGrab,Minecart Madness,1,3,4
7957,2023-01-10,LOLA,gemGrab,Crystal Arcade,0,2,2
7958,2023-01-10,LOLA,brawlBall,Beach Ball,2,2,4
7959,2023-01-09,LOLA,knockout,New Perspective,1,0,1
7960,2023-01-09,LOLA,hotZone,Dueling Beetles,3,2,5
7961,2023-01-09,LOLA,heist,Snaked Assault,5,3,8
7962,2023-01-09,LOLA,gemGrab,Minecart Madness,13,23,36
7963,2023-01-09,LOLA,gemGrab,Double Swoosh,2,2,4
7964,2023-01-09,LOLA,brawlBall,Center Stage,1,6,7
7965,2023-01-09,LOLA,brawlBall,Backyard Bowl,2,3,5
7966,2023-01-08,LOLA,knockout,X Marks the Spot,2,0,2
7967,2023-01-08,LOLA,hotZone,Ring of Fire,8,4,12
7968,2023-01-08,LOLA,heist,Snaked Assault,8,2,10
7969,2023-01-08,LOLA,gemGrab,Hard Rock Mine,4,5,9
7970,2023-01-08,LOLA,gemGrab,Double Swoosh,3,1,4
7971,2023-01-08,LOLA,brawlBall,Backyard Bowl,17,37,54
7972,2023-01-08,LOLA,bounty,Layer Cake,1,0,1
7973,2023-01-07,LOLA,knockout,X Marks the Spot,2,0,2
7974,2023-01-07,LOLA,hotZone,Ring of Fire,4,0,4
7975,2023-01-07,LOLA,heist,Tornado Ring,3,1,4
7976,2023-01-07,LOLA,gemGrab,Hard Rock Mine,1,0,1
7977,2023-01-07,LOLA,gemGrab,Deep Diner,1,1,2
7978,2023-01-07,LOLA,brawlBall,Super Beach,1,8,9
7979,2023-01-07,LOLA,brawlBall,Sneaky Fields,1,0,1
7980,2023-01-07,LOLA,bounty,Dry Season,2,0,2
7981,2023-01-06,LOLA,knockout,Out in the Open,0,4,4
7982,2023-01-06,LOLA,hotZone,Split,2,0,2
7983,2023-01-06,LOLA,heist,Tornado Ring,4,1,5
7984,2023-01-06,LOLA,gemGrab,Undermine,2,0,2
7985,2023-01-06,LOLA,gemGrab,Deep Diner,0,17,17
7986,2023-01-06,LOLA,brawlBall,Sneaky Fields,4,8,12
7987,2023-01-06,LOLA,brawlBall,Pinhole Punt,1,2,3
7988,2023-01-06,LOLA,bounty,Dry Season,8,15,23
7989,2023-01-05,LOLA,heist,Kaboom Canyon,17,57,74
7990,2023-01-05,LOLA,brawlBall,Pinhole Punt,21,62,83
7991,2023-01-05,LOLA,bounty,Shooting Star,4,16,20
7992,2023-01-04,LOLA,knockout,Goldarm Gulch,1,0,1
7993,2023-01-04,LOLA,hotZone,Parallel Plays,1,0,1
7994,2023-01-04,LOLA,heist,Kaboom Canyon,39,82,121
7995,2023-01-04,LOLA,gemGrab,Gem Fort,3,1,4
7996,2023-01-04,LOLA,brawlBall,Sunny Soccer,1,1,2
7997,2023-01-04,LOLA,bounty,Shooting Star,6,0,6
7998,2023-01-03,LOLA,knockout,Goldarm Gulch,2,3,5
7999,2023-01-03,LOLA,hotZone,Parallel Plays,3,0,3
8000,2023-01-03,LOLA,heist,Pit Stop,1,0,1
8001,2023-01-03,LOLA,gemGrab,Minecart Madness,1,24,25
8002,2023-01-03,LOLA,brawlBall,Center Stage,2,0,2
8003,2023-01-03,LOLA,brawlBall,Beach Ball,3,1,4
8004,2023-01-02,LOLA,knockout,Belle's Rock,1,1,2
8005,2023-01-02,LOLA,hotZone,Quarter Pounder,6,6,12
8006,2023-01-02,LOLA,heist,Pit Stop,3,0,3
8007,2023-01-02,LOLA,gemGrab,Minecart Madness,9,15,24
8008,2023-01-02,LOLA,gemGrab,Double Swoosh,2,0,2
8009,2023-01-02,LOLA,brawlBall,Center Stage,8,4,12
8010,2023-01-02,LOLA,brawlBall,Backyard Bowl,2,4,6
8011,2023-01-02,LOLA,bounty,Hideout,3,1,4
8012,2023-01-01,LOLA,knockout,Belle's Rock,2,0,2
8013,2023-01-01,LOLA,hotZone,Quarter Pounder,2,1,3
8014,2023-01-01,LOLA,heist,Bridge Too Far,12,22,34
8015,2023-01-01,LOLA,gemGrab,Double Swoosh,2,4,6
8016,2023-01-01,LOLA,brawlBall,Backyard Bowl,21,47,68
8017,2022-12-31,LOLA,heist,Bridge Too Far,6,10,16
8018,2022-12-31,LOLA,gemGrab,Minecart Madness,1,0,1
8019,2022-12-31,LOLA,gemGrab,Hard Rock Mine,2,0,2
8020,2022-12-31,LOLA,gemGrab,Deep Diner,0,1,1
8021,2022-12-31,LOLA,brawlBall,Super Beach,1,3,4
8022,2022-12-30,LOLA,hotZone,Controller Chaos,1,0,1
8023,2022-12-30,LOLA,heist,Hot Potato,1,0,1
8024,2022-12-30,LOLA,gemGrab,Undermine,2,0,2
8025,2022-12-30,LOLA,brawlBall,Sneaky Fields,2,1,3
8026,2022-12-29,LOLA,hotZone,Open Zone,0,1,1
8027,2022-12-29,LOLA,heist,Hot Potato,1,0,1
8028,2022-12-29,LOLA,gemGrab,Undermine,1,0,1
8029,2022-12-28,LOLA,hotZone,Open Zone,2,8,10
8030,2022-12-27,LOLA,knockout,New Perspective,1,0,1
8031,2022-12-26,LOLA,heist,Kaboom Canyon,0,1,1
8032,2022-12-26,LOLA,brawlBall,Center Stage,1,0,1
8033,2022-12-22,LOLA,brawlBall,Pinhole Punt,1,0,1
8034,2022-12-21,LOLA,brawlBall,Sunny Soccer,0,1,1
8035,2022-12-16,LOLA,gemGrab,Undermine,1,0,1
8036,2022-12-13,LOLA,heist,Safe Zone,0,2,2
8037,2022-12-13,LOLA,gemGrab,Crystal Arcade,1,0,1
8038,2022-12-11,LOLA,gemGrab,Double Swoosh,0,1,1
8039,2022-11-01,LOLA,knockout,New Perspective,0,1,1
8040,2022-10-10,LOLA,knockout,Belle's Rock,2,0,2
8041,2023-02-05,LEON,knockout,X Marks the Spot,134,74,208
8042,2023-02-05,LEON,knockout,Goldarm Gulch,14,14,28
8043,2023-02-05,LEON,hotZone,Ring of Fire,69,94,163
8044,2023-02-05,LEON,heist,Snaked Assault,12,9,21
8045,2023-02-05,LEON,heist,Pit Stop,2,0,2
8046,2023-02-05,LEON,gemGrab,Hard Rock Mine,60,21,81
8047,2023-02-05,LEON,gemGrab,Double Swoosh,159,99,258
8048,2023-02-05,LEON,brawlBall,Super Beach,12,8,20
8049,2023-02-05,LEON,brawlBall,Sneaky Fields,8,4,12
8050,2023-02-05,LEON,brawlBall,Backyard Bowl,772,907,1679
8051,2023-02-05,LEON,bounty,Layer Cake,99,97,196
8052,2023-02-04,LEON,knockout,X Marks the Spot,32,23,55
8053,2023-02-04,LEON,knockout,Goldarm Gulch,18,8,26
8054,2023-02-04,LEON,hotZone,Ring of Fire,4,5,9
8055,2023-02-04,LEON,heist,Tornado Ring,3,0,3
8056,2023-02-04,LEON,gemGrab,Hard Rock Mine,52,49,101
8057,2023-02-04,LEON,gemGrab,Double Swoosh,32,4,36
8058,2023-02-04,LEON,gemGrab,Deep Diner,13,14,27
8059,2023-02-04,LEON,brawlBall,Super Beach,78,55,133
8060,2023-02-04,LEON,brawlBall,Sneaky Fields,7,1,8
8061,2023-02-04,LEON,bounty,Dry Season,34,28,62
8062,2023-02-03,LEON,knockout,Out in the Open,211,135,346
8063,2023-02-03,LEON,knockout,Goldarm Gulch,105,73,178
8064,2023-02-03,LEON,hotZone,Split,32,14,46
8065,2023-02-03,LEON,heist,Tornado Ring,26,17,43
8066,2023-02-03,LEON,heist,Pit Stop,8,0,8
8067,2023-02-03,LEON,gemGrab,Undermine,51,30,81
8068,2023-02-03,LEON,gemGrab,Double Swoosh,156,68,224
8069,2023-02-03,LEON,gemGrab,Deep Diner,164,119,283
8070,2023-02-03,LEON,brawlBall,Sneaky Fields,341,232,573
8071,2023-02-03,LEON,brawlBall,Pinhole Punt,27,20,47
8072,2023-02-03,LEON,bounty,Dry Season,237,276,513
8073,2023-02-02,LEON,knockout,Out in the Open,64,65,129
8074,2023-02-02,LEON,hotZone,Split,12,3,15
8075,2023-02-02,LEON,heist,Kaboom Canyon,4,1,5
8076,2023-02-02,LEON,gemGrab,Undermine,30,14,44
8077,2023-02-02,LEON,gemGrab,Gem Fort,7,10,17
8078,2023-02-02,LEON,brawlBall,Sunny Soccer,4,1,5
8079,2023-02-02,LEON,brawlBall,Pinhole Punt,162,155,317
8080,2023-02-02,LEON,bounty,Shooting Star,37,31,68
8081,2023-02-01,LEON,knockout,Goldarm Gulch,305,224,529
8082,2023-02-01,LEON,hotZone,Parallel Plays,90,95,185
8083,2023-02-01,LEON,heist,Kaboom Canyon,14,5,19
8084,2023-02-01,LEON,gemGrab,Gem Fort,132,111,243
8085,2023-02-01,LEON,gemGrab,Crystal Arcade,88,53,141
8086,2023-02-01,LEON,brawlBall,Sunny Soccer,294,237,531
8087,2023-02-01,LEON,brawlBall,Beach Ball,26,27,53
8088,2023-02-01,LEON,bounty,Shooting Star,87,93,180
8089,2023-01-31,LEON,knockout,Goldarm Gulch,132,107,239
8090,2023-01-31,LEON,hotZone,Parallel Plays,73,88,161
8091,2023-01-31,LEON,heist,Pit Stop,6,2,8
8092,2023-01-31,LEON,gemGrab,Minecart Madness,9,12,21
8093,2023-01-31,LEON,gemGrab,Crystal Arcade,90,60,150
8094,2023-01-31,LEON,brawlBall,Center Stage,3,1,4
8095,2023-01-31,LEON,brawlBall,Beach Ball,199,138,337
8096,2023-01-31,LEON,bounty,Hideout,42,42,84
8097,2023-01-30,LEON,knockout,Belle's Rock,218,178,396
8098,2023-01-30,LEON,hotZone,Quarter Pounder,66,36,102
8099,2023-01-30,LEON,heist,Pit Stop,14,2,16
8100,2023-01-30,LEON,gemGrab,Minecart Madness,78,81,159
8101,2023-01-30,LEON,gemGrab,Double Swoosh,86,55,141
8102,2023-01-30,LEON,brawlBall,Center Stage,251,175,426
8103,2023-01-30,LEON,brawlBall,Backyard Bowl,60,87,147
8104,2023-01-30,LEON,bounty,Hideout,94,82,176
8105,2023-01-29,LEON,knockout,Belle's Rock,243,206,449
8106,2023-01-29,LEON,hotZone,Quarter Pounder,37,13,50
8107,2023-01-29,LEON,heist,Bridge Too Far,17,5,22
8108,2023-01-29,LEON,gemGrab,Hard Rock Mine,24,18,42
8109,2023-01-29,LEON,gemGrab,Double Swoosh,124,100,224
8110,2023-01-29,LEON,brawlBall,Super Beach,3,3,6
8111,2023-01-29,LEON,brawlBall,Backyard Bowl,818,875,1693
8112,2023-01-29,LEON,bounty,Canal Grande,58,26,84
8113,2023-01-28,LEON,knockout,Flaring Phoenix,154,101,255
8114,2023-01-28,LEON,hotZone,Controller Chaos,45,11,56
8115,2023-01-28,LEON,heist,Bridge Too Far,31,15,46
8116,2023-01-28,LEON,gemGrab,Hard Rock Mine,203,176,379
8117,2023-01-28,LEON,gemGrab,Deep Diner,77,71,148
8118,2023-01-28,LEON,brawlBall,Super Beach,354,282,636
8119,2023-01-28,LEON,brawlBall,Sneaky Fields,6,8,14
8120,2023-01-28,LEON,bounty,Canal Grande,134,108,242
8121,2023-01-27,LEON,knockout,Flaring Phoenix,73,57,130
8122,2023-01-27,LEON,hotZone,Controller Chaos,15,4,19
8123,2023-01-27,LEON,heist,Hot Potato,7,1,8
8124,2023-01-27,LEON,gemGrab,Undermine,11,12,23
8125,2023-01-27,LEON,gemGrab,Deep Diner,87,77,164
8126,2023-01-27,LEON,brawlBall,Sneaky Fields,84,71,155
8127,2023-01-27,LEON,brawlBall,Pinhole Punt,5,5,10
8128,2023-01-27,LEON,bounty,Temple Ruins,36,20,56
8129,2023-01-26,LEON,knockout,Riverside,184,87,271
8130,2023-01-26,LEON,hotZone,Open Zone,66,37,103
8131,2023-01-26,LEON,heist,Hot Potato,14,3,17
8132,2023-01-26,LEON,gemGrab,Undermine,92,44,136
8133,2023-01-26,LEON,gemGrab,Gem Fort,47,40,87
8134,2023-01-26,LEON,brawlBall,Sunny Soccer,27,5,32
8135,2023-01-26,LEON,brawlBall,Pinhole Punt,509,530,1039
8136,2023-01-26,LEON,bounty,Temple Ruins,87,53,140
8137,2023-01-25,LEON,knockout,Riverside,100,70,170
8138,2023-01-25,LEON,hotZone,Open Zone,31,28,59
8139,2023-01-25,LEON,heist,Safe Zone,20,6,26
8140,2023-01-25,LEON,gemGrab,Gem Fort,50,52,102
8141,2023-01-25,LEON,gemGrab,Crystal Arcade,92,44,136
8142,2023-01-25,LEON,brawlBall,Sunny Soccer,228,190,418
8143,2023-01-25,LEON,brawlBall,Beach Ball,51,24,75
8144,2023-01-25,LEON,bounty,Excel,68,52,120
8145,2023-01-24,LEON,knockout,New Perspective,196,114,310
8146,2023-01-24,LEON,hotZone,Dueling Beetles,39,41,80
8147,2023-01-24,LEON,heist,Safe Zone,25,7,32
8148,2023-01-24,LEON,gemGrab,Minecart Madness,31,23,54
8149,2023-01-24,LEON,gemGrab,Crystal Arcade,156,108,264
8150,2023-01-24,LEON,brawlBall,Center Stage,40,21,61
8151,2023-01-24,LEON,brawlBall,Beach Ball,451,402,853
8152,2023-01-24,LEON,bounty,Excel,106,76,182
8153,2023-01-23,LEON,knockout,New Perspective,264,192,456
8154,2023-01-23,LEON,hotZone,Dueling Beetles,61,49,110
8155,2023-01-23,LEON,heist,Snaked Assault,30,12,42
8156,2023-01-23,LEON,gemGrab,Minecart Madness,133,90,223
8157,2023-01-23,LEON,gemGrab,Double Swoosh,53,22,75
8158,2023-01-23,LEON,brawlBall,Center Stage,410,299,709
8159,2023-01-23,LEON,brawlBall,Backyard Bowl,44,76,120
8160,2023-01-23,LEON,bounty,Layer Cake,161,186,347
8161,2023-01-22,LEON,knockout,X Marks the Spot,84,77,161
8162,2023-01-22,LEON,hotZone,Ring of Fire,45,32,77
8163,2023-01-22,LEON,heist,Snaked Assault,13,4,17
8164,2023-01-22,LEON,gemGrab,Hard Rock Mine,54,37,91
8165,2023-01-22,LEON,gemGrab,Double Swoosh,71,57,128
8166,2023-01-22,LEON,brawlBall,Super Beach,32,20,52
8167,2023-01-22,LEON,brawlBall,Backyard Bowl,376,412,788
8168,2023-01-22,LEON,bounty,Layer Cake,119,91,210
8169,2023-01-21,LEON,knockout,X Marks the Spot,313,254,567
8170,2023-01-21,LEON,hotZone,Ring of Fire,102,139,241
8171,2023-01-21,LEON,heist,Tornado Ring,23,19,42
8172,2023-01-21,LEON,gemGrab,Hard Rock Mine,253,203,456
8173,2023-01-21,LEON,gemGrab,Deep Diner,68,70,138
8174,2023-01-21,LEON,brawlBall,Super Beach,464,308,772
8175,2023-01-21,LEON,brawlBall,Sneaky Fields,16,15,31
8176,2023-01-21,LEON,bounty,Dry Season,177,238,415
8177,2023-01-20,LEON,knockout,Out in the Open,251,183,434
8178,2023-01-20,LEON,hotZone,Split,26,14,40
8179,2023-01-20,LEON,heist,Tornado Ring,15,8,23
8180,2023-01-20,LEON,gemGrab,Undermine,63,40,103
8181,2023-01-20,LEON,gemGrab,Deep Diner,208,198,406
8182,2023-01-20,LEON,brawlBall,Sneaky Fields,302,186,488
8183,2023-01-20,LEON,brawlBall,Pinhole Punt,35,38,73
8184,2023-01-20,LEON,bounty,Dry Season,189,174,363
8185,2023-01-19,LEON,knockout,Out in the Open,262,153,415
8186,2023-01-19,LEON,hotZone,Split,37,19,56
8187,2023-01-19,LEON,heist,Kaboom Canyon,14,12,26
8188,2023-01-19,LEON,gemGrab,Undermine,141,114,255
8189,2023-01-19,LEON,gemGrab,Gem Fort,30,29,59
8190,2023-01-19,LEON,brawlBall,Sunny Soccer,18,5,23
8191,2023-01-19,LEON,brawlBall,Pinhole Punt,554,516,1070
8192,2023-01-19,LEON,bounty,Shooting Star,103,64,167
8193,2023-01-18,LEON,knockout,Goldarm Gulch,41,31,72
8194,2023-01-18,LEON,hotZone,Parallel Plays,7,2,9
8195,2023-01-18,LEON,heist,Kaboom Canyon,4,2,6
8196,2023-01-18,LEON,gemGrab,Gem Fort,38,29,67
8197,2023-01-18,LEON,gemGrab,Crystal Arcade,10,7,17
8198,2023-01-18,LEON,brawlBall,Sunny Soccer,118,81,199
8199,2023-01-18,LEON,brawlBall,Beach Ball,6,0,6
8200,2023-01-18,LEON,bounty,Shooting Star,52,49,101
8201,2023-01-17,LEON,knockout,Goldarm Gulch,36,21,57
8202,2023-01-17,LEON,hotZone,Parallel Plays,12,7,19
8203,2023-01-17,LEON,heist,Pit Stop,1,1,2
8204,2023-01-17,LEON,gemGrab,Minecart Madness,1,1,2
8205,2023-01-17,LEON,gemGrab,Crystal Arcade,5,4,9
8206,2023-01-17,LEON,brawlBall,Center Stage,3,1,4
8207,2023-01-17,LEON,brawlBall,Beach Ball,51,30,81
8208,2023-01-17,LEON,bounty,Hideout,9,10,19
8209,2023-01-16,LEON,knockout,Belle's Rock,9,7,16
8210,2023-01-16,LEON,hotZone,Quarter Pounder,7,14,21
8211,2023-01-16,LEON,heist,Pit Stop,2,0,2
8212,2023-01-16,LEON,gemGrab,Minecart Madness,15,15,30
8213,2023-01-16,LEON,gemGrab,Double Swoosh,6,0,6
8214,2023-01-16,LEON,brawlBall,Center Stage,19,12,31
8215,2023-01-16,LEON,brawlBall,Backyard Bowl,14,0,14
8216,2023-01-16,LEON,bounty,Hideout,20,25,45
8217,2023-01-15,LEON,knockout,Belle's Rock,31,15,46
8218,2023-01-15,LEON,hotZone,Quarter Pounder,11,1,12
8219,2023-01-15,LEON,heist,Bridge Too Far,1,1,2
8220,2023-01-15,LEON,gemGrab,Hard Rock Mine,16,26,42
8221,2023-01-15,LEON,gemGrab,Double Swoosh,14,4,18
8222,2023-01-15,LEON,brawlBall,Super Beach,2,4,6
8223,2023-01-15,LEON,brawlBall,Backyard Bowl,117,113,230
8224,2023-01-15,LEON,bounty,Canal Grande,8,4,12
8225,2023-01-14,LEON,knockout,Flaring Phoenix,11,5,16
8226,2023-01-14,LEON,hotZone,Controller Chaos,9,4,13
8227,2023-01-14,LEON,heist,Bridge Too Far,6,0,6
8228,2023-01-14,LEON,gemGrab,Hard Rock Mine,17,11,28
8229,2023-01-14,LEON,gemGrab,Deep Diner,6,4,10
8230,2023-01-14,LEON,brawlBall,Super Beach,22,11,33
8231,2023-01-14,LEON,brawlBall,Sneaky Fields,2,0,2
8232,2023-01-14,LEON,bounty,Canal Grande,9,8,17
8233,2023-01-13,LEON,knockout,Flaring Phoenix,11,8,19
8234,2023-01-13,LEON,hotZone,Controller Chaos,11,0,11
8235,2023-01-13,LEON,gemGrab,Deep Diner,25,3,28
8236,2023-01-13,LEON,brawlBall,Sneaky Fields,11,2,13
8237,2023-01-13,LEON,brawlBall,Pinhole Punt,0,1,1
8238,2023-01-13,LEON,bounty,Temple Ruins,4,2,6
8239,2023-01-12,LEON,knockout,Riverside,22,9,31
8240,2023-01-12,LEON,hotZone,Open Zone,10,2,12
8241,2023-01-12,LEON,gemGrab,Undermine,5,3,8
8242,2023-01-12,LEON,gemGrab,Gem Fort,1,1,2
8243,2023-01-12,LEON,brawlBall,Sunny Soccer,3,0,3
8244,2023-01-12,LEON,brawlBall,Pinhole Punt,22,10,32
8245,2023-01-11,LEON,knockout,Riverside,1,4,5
8246,2023-01-11,LEON,hotZone,Open Zone,11,31,42
8247,2023-01-11,LEON,gemGrab,Gem Fort,5,2,7
8248,2023-01-11,LEON,brawlBall,Sunny Soccer,13,21,34
8249,2023-01-11,LEON,bounty,Excel,3,2,5
8250,2023-01-10,LEON,knockout,New Perspective,11,10,21
8251,2023-01-10,LEON,hotZone,Dueling Beetles,9,2,11
8252,2023-01-10,LEON,gemGrab,Minecart Madness,7,4,11
8253,2023-01-10,LEON,gemGrab,Crystal Arcade,20,4,24
8254,2023-01-10,LEON,brawlBall,Center Stage,1,0,1
8255,2023-01-10,LEON,brawlBall,Beach Ball,16,12,28
8256,2023-01-10,LEON,bounty,Excel,5,0,5
8257,2023-01-09,LEON,knockout,New Perspective,11,4,15
8258,2023-01-09,LEON,hotZone,Dueling Beetles,9,6,15
8259,2023-01-09,LEON,heist,Snaked Assault,3,1,4
8260,2023-01-09,LEON,gemGrab,Minecart Madness,22,10,32
8261,2023-01-09,LEON,gemGrab,Double Swoosh,8,0,8
8262,2023-01-09,LEON,brawlBall,Center Stage,20,12,32
8263,2023-01-09,LEON,brawlBall,Backyard Bowl,4,0,4
8264,2023-01-09,LEON,bounty,Layer Cake,24,16,40
8265,2023-01-08,LEON,knockout,X Marks the Spot,29,31,60
8266,2023-01-08,LEON,hotZone,Ring of Fire,9,5,14
8267,2023-01-08,LEON,heist,Snaked Assault,3,1,4
8268,2023-01-08,LEON,gemGrab,Hard Rock Mine,4,4,8
8269,2023-01-08,LEON,gemGrab,Double Swoosh,4,0,4
8270,2023-01-08,LEON,brawlBall,Super Beach,4,2,6
8271,2023-01-08,LEON,brawlBall,Backyard Bowl,66,60,126
8272,2023-01-08,LEON,bounty,Layer Cake,0,2,2
8273,2023-01-07,LEON,knockout,X Marks the Spot,5,2,7
8274,2023-01-07,LEON,hotZone,Ring of Fire,1,0,1
8275,2023-01-07,LEON,heist,Tornado Ring,4,0,4
8276,2023-01-07,LEON,gemGrab,Hard Rock Mine,16,16,32
8277,2023-01-07,LEON,gemGrab,Deep Diner,6,2,8
8278,2023-01-07,LEON,brawlBall,Super Beach,8,3,11
8279,2023-01-07,LEON,brawlBall,Sneaky Fields,3,2,5
8280,2023-01-07,LEON,bounty,Dry Season,22,12,34
8281,2023-01-06,LEON,knockout,Out in the Open,11,6,17
8282,2023-01-06,LEON,hotZone,Split,5,0,5
8283,2023-01-06,LEON,heist,Tornado Ring,4,1,5
8284,2023-01-06,LEON,gemGrab,Undermine,5,0,5
8285,2023-01-06,LEON,gemGrab,Deep Diner,20,5,25
8286,2023-01-06,LEON,brawlBall,Sneaky Fields,13,9,22
8287,2023-01-06,LEON,brawlBall,Pinhole Punt,0,2,2
8288,2023-01-06,LEON,bounty,Dry Season,31,49,80
8289,2023-01-05,LEON,knockout,Out in the Open,28,19,47
8290,2023-01-05,LEON,hotZone,Split,5,2,7
8291,2023-01-05,LEON,heist,Kaboom Canyon,1,0,1
8292,2023-01-05,LEON,gemGrab,Undermine,14,6,20
8293,2023-01-05,LEON,gemGrab,Gem Fort,4,1,5
8294,2023-01-05,LEON,brawlBall,Pinhole Punt,58,123,181
8295,2023-01-05,LEON,bounty,Shooting Star,24,9,33
8296,2023-01-04,LEON,knockout,Goldarm Gulch,15,1,16
8297,2023-01-04,LEON,hotZone,Parallel Plays,10,4,14
8298,2023-01-04,LEON,heist,Kaboom Canyon,3,0,3
8299,2023-01-04,LEON,gemGrab,Gem Fort,10,4,14
8300,2023-01-04,LEON,gemGrab,Crystal Arcade,5,1,6
8301,2023-01-04,LEON,brawlBall,Sunny Soccer,15,12,27
8302,2023-01-04,LEON,bounty,Shooting Star,46,10,56
8303,2023-01-03,LEON,knockout,Goldarm Gulch,12,2,14
8304,2023-01-03,LEON,hotZone,Parallel Plays,29,92,121
8305,2023-01-03,LEON,heist,Pit Stop,0,1,1
8306,2023-01-03,LEON,gemGrab,Minecart Madness,4,0,4
8307,2023-01-03,LEON,gemGrab,Crystal Arcade,24,1,25
8308,2023-01-03,LEON,brawlBall,Center Stage,3,0,3
8309,2023-01-03,LEON,brawlBall,Beach Ball,21,15,36
8310,2023-01-03,LEON,bounty,Hideout,26,20,46
8311,2023-01-02,LEON,knockout,Belle's Rock,18,3,21
8312,2023-01-02,LEON,hotZone,Quarter Pounder,12,10,22
8313,2023-01-02,LEON,heist,Pit Stop,2,0,2
8314,2023-01-02,LEON,gemGrab,Minecart Madness,25,5,30
8315,2023-01-02,LEON,gemGrab,Double Swoosh,9,1,10
8316,2023-01-02,LEON,brawlBall,Center Stage,19,10,29
8317,2023-01-02,LEON,brawlBall,Backyard Bowl,6,1,7
8318,2023-01-02,LEON,bounty,Hideout,63,59,122
8319,2023-01-01,LEON,knockout,Belle's Rock,8,5,13
8320,2023-01-01,LEON,hotZone,Quarter Pounder,2,11,13
8321,2023-01-01,LEON,gemGrab,Double Swoosh,8,3,11
8322,2023-01-01,LEON,brawlBall,Backyard Bowl,22,21,43
8323,2023-01-01,LEON,bounty,Canal Grande,1,0,1
8324,2022-12-31,LEON,gemGrab,Hard Rock Mine,2,11,13
8325,2022-12-31,LEON,gemGrab,Deep Diner,5,8,13
8326,2022-12-31,LEON,brawlBall,Super Beach,3,4,7
8327,2022-12-31,LEON,bounty,Canal Grande,1,0,1
8328,2022-12-30,LEON,knockout,Flaring Phoenix,1,0,1
8329,2022-12-30,LEON,hotZone,Controller Chaos,1,0,1
8330,2022-12-30,LEON,gemGrab,Deep Diner,14,7,21
8331,2022-12-30,LEON,brawlBall,Sneaky Fields,5,3,8
8332,2022-12-29,LEON,hotZone,Open Zone,1,0,1
8333,2022-12-29,LEON,gemGrab,Gem Fort,2,1,3
8334,2022-12-29,LEON,brawlBall,Pinhole Punt,3,0,3
8335,2022-12-28,LEON,hotZone,Open Zone,0,1,1
8336,2022-12-27,LEON,knockout,New Perspective,0,1,1
8337,2022-12-27,LEON,hotZone,Controller Chaos,1,0,1
8338,2022-12-27,LEON,heist,Safe Zone,1,1,2
8339,2022-12-27,LEON,gemGrab,Minecart Madness,1,0,1
8340,2022-12-27,LEON,brawlBall,Beach Ball,8,5,13
8341,2022-12-27,LEON,bounty,Excel,2,1,3
8342,2022-12-25,LEON,brawlBall,Backyard Bowl,1,0,1
8343,2022-12-23,LEON,knockout,Out in the Open,1,1,2
8344,2022-12-22,LEON,brawlBall,Pinhole Punt,4,0,4
8345,2022-12-21,LEON,brawlBall,Sunny Soccer,1,0,1
8346,2022-12-20,LEON,brawlBall,Beach Ball,1,2,3
8347,2022-12-16,LEON,bounty,Temple Ruins,1,0,1
8348,2022-12-13,LEON,knockout,New Perspective,3,0,3
8349,2022-12-13,LEON,gemGrab,Crystal Arcade,4,0,4
8350,2022-11-07,LEON,hotZone,Quarter Pounder,1,0,1
8351,2022-11-01,LEON,knockout,New Perspective,0,1,1
8352,2022-10-26,LEON,bounty,Shooting Star,1,4,5
8353,2022-10-15,LEON,gemGrab,Hard Rock Mine,2,2,4
8354,2023-02-05,JESSIE,knockout,X Marks the Spot,22,11,33
8355,2023-02-05,JESSIE,hotZone,Ring of Fire,107,72,179
8356,2023-02-05,JESSIE,heist,Snaked Assault,381,255,636
8357,2023-02-05,JESSIE,heist,Pit Stop,68,26,94
8358,2023-02-05,JESSIE,gemGrab,Hard Rock Mine,26,14,40
8359,2023-02-05,JESSIE,gemGrab,Double Swoosh,211,211,422
8360,2023-02-05,JESSIE,brawlBall,Super Beach,7,15,22
8361,2023-02-05,JESSIE,brawlBall,Sneaky Fields,34,12,46
8362,2023-02-05,JESSIE,brawlBall,Backyard Bowl,228,213,441
8363,2023-02-05,JESSIE,bounty,Layer Cake,13,3,16
8364,2023-02-04,JESSIE,knockout,X Marks the Spot,8,6,14
8365,2023-02-04,JESSIE,knockout,Goldarm Gulch,2,2,4
8366,2023-02-04,JESSIE,hotZone,Ring of Fire,16,18,34
8367,2023-02-04,JESSIE,heist,Tornado Ring,45,43,88
8368,2023-02-04,JESSIE,heist,Pit Stop,57,14,71
8369,2023-02-04,JESSIE,gemGrab,Hard Rock Mine,29,9,38
8370,2023-02-04,JESSIE,gemGrab,Double Swoosh,48,20,68
8371,2023-02-04,JESSIE,gemGrab,Deep Diner,9,8,17
8372,2023-02-04,JESSIE,brawlBall,Super Beach,95,104,199
8373,2023-02-04,JESSIE,brawlBall,Sneaky Fields,17,8,25
8374,2023-02-04,JESSIE,bounty,Dry Season,4,1,5
8375,2023-02-03,JESSIE,knockout,Out in the Open,37,13,50
8376,2023-02-03,JESSIE,knockout,Goldarm Gulch,4,3,7
8377,2023-02-03,JESSIE,hotZone,Split,34,11,45
8378,2023-02-03,JESSIE,heist,Tornado Ring,387,274,661
8379,2023-02-03,JESSIE,heist,Pit Stop,386,111,497
8380,2023-02-03,JESSIE,gemGrab,Undermine,31,34,65
8381,2023-02-03,JESSIE,gemGrab,Double Swoosh,253,48,301
8382,2023-02-03,JESSIE,gemGrab,Deep Diner,174,164,338
8383,2023-02-03,JESSIE,brawlBall,Sneaky Fields,404,377,781
8384,2023-02-03,JESSIE,brawlBall,Pinhole Punt,9,17,26
8385,2023-02-03,JESSIE,bounty,Dry Season,37,14,51
8386,2023-02-02,JESSIE,knockout,Out in the Open,19,9,28
8387,2023-02-02,JESSIE,hotZone,Split,21,13,34
8388,2023-02-02,JESSIE,heist,Kaboom Canyon,61,36,97
8389,2023-02-02,JESSIE,gemGrab,Undermine,31,21,52
8390,2023-02-02,JESSIE,gemGrab,Gem Fort,9,8,17
8391,2023-02-02,JESSIE,brawlBall,Sunny Soccer,1,1,2
8392,2023-02-02,JESSIE,brawlBall,Pinhole Punt,100,90,190
8393,2023-02-02,JESSIE,bounty,Shooting Star,6,1,7
8394,2023-02-01,JESSIE,knockout,Goldarm Gulch,30,25,55
8395,2023-02-01,JESSIE,hotZone,Parallel Plays,122,129,251
8396,2023-02-01,JESSIE,heist,Kaboom Canyon,170,146,316
8397,2023-02-01,JESSIE,gemGrab,Gem Fort,126,128,254
8398,2023-02-01,JESSIE,gemGrab,Crystal Arcade,74,57,131
8399,2023-02-01,JESSIE,brawlBall,Sunny Soccer,248,217,465
8400,2023-02-01,JESSIE,brawlBall,Beach Ball,4,7,11
8401,2023-02-01,JESSIE,bounty,Shooting Star,8,8,16
8402,2023-01-31,JESSIE,knockout,Goldarm Gulch,15,13,28
8403,2023-01-31,JESSIE,hotZone,Parallel Plays,74,68,142
8404,2023-01-31,JESSIE,heist,Pit Stop,65,47,112
8405,2023-01-31,JESSIE,gemGrab,Minecart Madness,12,9,21
8406,2023-01-31,JESSIE,gemGrab,Crystal Arcade,53,30,83
8407,2023-01-31,JESSIE,brawlBall,Center Stage,4,2,6
8408,2023-01-31,JESSIE,brawlBall,Beach Ball,144,151,295
8409,2023-01-31,JESSIE,bounty,Hideout,5,4,9
8410,2023-01-30,JESSIE,knockout,Belle's Rock,34,18,52
8411,2023-01-30,JESSIE,hotZone,Quarter Pounder,241,123,364
8412,2023-01-30,JESSIE,heist,Pit Stop,120,74,194
8413,2023-01-30,JESSIE,gemGrab,Minecart Madness,96,75,171
8414,2023-01-30,JESSIE,gemGrab,Double Swoosh,89,59,148
8415,2023-01-30,JESSIE,brawlBall,Center Stage,164,213,377
8416,2023-01-30,JESSIE,brawlBall,Backyard Bowl,32,19,51
8417,2023-01-30,JESSIE,bounty,Hideout,11,8,19
8418,2023-01-29,JESSIE,knockout,Belle's Rock,33,11,44
8419,2023-01-29,JESSIE,hotZone,Quarter Pounder,125,50,175
8420,2023-01-29,JESSIE,heist,Bridge Too Far,178,104,282
8421,2023-01-29,JESSIE,gemGrab,Hard Rock Mine,19,8,27
8422,2023-01-29,JESSIE,gemGrab,Double Swoosh,121,140,261
8423,2023-01-29,JESSIE,brawlBall,Super Beach,12,13,25
8424,2023-01-29,JESSIE,brawlBall,Backyard Bowl,305,275,580
8425,2023-01-29,JESSIE,bounty,Canal Grande,12,9,21
8426,2023-01-28,JESSIE,knockout,Flaring Phoenix,15,11,26
8427,2023-01-28,JESSIE,hotZone,Controller Chaos,136,118,254
8428,2023-01-28,JESSIE,heist,Bridge Too Far,327,251,578
8429,2023-01-28,JESSIE,gemGrab,Hard Rock Mine,100,69,169
8430,2023-01-28,JESSIE,gemGrab,Deep Diner,63,45,108
8431,2023-01-28,JESSIE,brawlBall,Super Beach,424,493,917
8432,2023-01-28,JESSIE,brawlBall,Sneaky Fields,5,6,11
8433,2023-01-28,JESSIE,bounty,Canal Grande,36,9,45
8434,2023-01-27,JESSIE,knockout,Flaring Phoenix,9,6,15
8435,2023-01-27,JESSIE,hotZone,Controller Chaos,19,30,49
8436,2023-01-27,JESSIE,heist,Hot Potato,115,82,197
8437,2023-01-27,JESSIE,gemGrab,Undermine,5,4,9
8438,2023-01-27,JESSIE,gemGrab,Deep Diner,57,40,97
8439,2023-01-27,JESSIE,brawlBall,Sneaky Fields,74,79,153
8440,2023-01-27,JESSIE,brawlBall,Pinhole Punt,2,0,2
8441,2023-01-27,JESSIE,bounty,Temple Ruins,3,1,4
8442,2023-01-26,JESSIE,knockout,Riverside,29,18,47
8443,2023-01-26,JESSIE,hotZone,Open Zone,97,58,155
8444,2023-01-26,JESSIE,heist,Hot Potato,300,222,522
8445,2023-01-26,JESSIE,gemGrab,Undermine,72,78,150
8446,2023-01-26,JESSIE,gemGrab,Gem Fort,57,33,90
8447,2023-01-26,JESSIE,brawlBall,Sunny Soccer,22,18,40
8448,2023-01-26,JESSIE,brawlBall,Pinhole Punt,286,312,598
8449,2023-01-26,JESSIE,bounty,Temple Ruins,18,11,29
8450,2023-01-25,JESSIE,knockout,Riverside,12,6,18
8451,2023-01-25,JESSIE,hotZone,Open Zone,50,40,90
8452,2023-01-25,JESSIE,heist,Safe Zone,272,161,433
8453,2023-01-25,JESSIE,gemGrab,Gem Fort,51,42,93
8454,2023-01-25,JESSIE,gemGrab,Crystal Arcade,71,93,164
8455,2023-01-25,JESSIE,brawlBall,Sunny Soccer,199,218,417
8456,2023-01-25,JESSIE,brawlBall,Beach Ball,26,26,52
8457,2023-01-25,JESSIE,bounty,Excel,17,6,23
8458,2023-01-24,JESSIE,knockout,New Perspective,32,40,72
8459,2023-01-24,JESSIE,hotZone,Dueling Beetles,140,120,260
8460,2023-01-24,JESSIE,heist,Safe Zone,443,300,743
8461,2023-01-24,JESSIE,gemGrab,Minecart Madness,23,12,35
8462,2023-01-24,JESSIE,gemGrab,Crystal Arcade,99,65,164
8463,2023-01-24,JESSIE,brawlBall,Center Stage,27,20,47
8464,2023-01-24,JESSIE,brawlBall,Beach Ball,285,277,562
8465,2023-01-24,JESSIE,bounty,Excel,15,5,20
8466,2023-01-23,JESSIE,knockout,New Perspective,35,19,54
8467,2023-01-23,JESSIE,hotZone,Dueling Beetles,219,139,358
8468,2023-01-23,JESSIE,heist,Snaked Assault,631,343,974
8469,2023-01-23,JESSIE,gemGrab,Minecart Madness,118,79,197
8470,2023-01-23,JESSIE,gemGrab,Double Swoosh,65,64,129
8471,2023-01-23,JESSIE,brawlBall,Center Stage,274,236,510
8472,2023-01-23,JESSIE,brawlBall,Backyard Bowl,24,11,35
8473,2023-01-23,JESSIE,bounty,Layer Cake,26,9,35
8474,2023-01-22,JESSIE,knockout,X Marks the Spot,16,5,21
8475,2023-01-22,JESSIE,hotZone,Ring of Fire,65,38,103
8476,2023-01-22,JESSIE,heist,Snaked Assault,239,151,390
8477,2023-01-22,JESSIE,gemGrab,Hard Rock Mine,24,15,39
8478,2023-01-22,JESSIE,gemGrab,Double Swoosh,74,66,140
8479,2023-01-22,JESSIE,brawlBall,Super Beach,42,47,89
8480,2023-01-22,JESSIE,brawlBall,Backyard Bowl,143,108,251
8481,2023-01-22,JESSIE,bounty,Layer Cake,12,3,15
8482,2023-01-21,JESSIE,knockout,X Marks the Spot,45,18,63
8483,2023-01-21,JESSIE,hotZone,Ring of Fire,174,130,304
8484,2023-01-21,JESSIE,heist,Tornado Ring,367,213,580
8485,2023-01-21,JESSIE,gemGrab,Hard Rock Mine,176,104,280
8486,2023-01-21,JESSIE,gemGrab,Deep Diner,49,62,111
8487,2023-01-21,JESSIE,brawlBall,Super Beach,500,691,1191
8488,2023-01-21,JESSIE,brawlBall,Sneaky Fields,13,10,23
8489,2023-01-21,JESSIE,bounty,Dry Season,31,11,42
8490,2023-01-20,JESSIE,knockout,Out in the Open,44,35,79
8491,2023-01-20,JESSIE,hotZone,Split,40,15,55
8492,2023-01-20,JESSIE,heist,Tornado Ring,315,238,553
8493,2023-01-20,JESSIE,gemGrab,Undermine,40,40,80
8494,2023-01-20,JESSIE,gemGrab,Deep Diner,190,170,360
8495,2023-01-20,JESSIE,brawlBall,Sneaky Fields,236,263,499
8496,2023-01-20,JESSIE,brawlBall,Pinhole Punt,23,30,53
8497,2023-01-20,JESSIE,bounty,Dry Season,16,16,32
8498,2023-01-19,JESSIE,knockout,Out in the Open,57,25,82
8499,2023-01-19,JESSIE,hotZone,Split,62,23,85
8500,2023-01-19,JESSIE,heist,Kaboom Canyon,215,164,379
8501,2023-01-19,JESSIE,gemGrab,Undermine,116,75,191
8502,2023-01-19,JESSIE,gemGrab,Gem Fort,27,16,43
8503,2023-01-19,JESSIE,brawlBall,Sunny Soccer,8,10,18
8504,2023-01-19,JESSIE,brawlBall,Pinhole Punt,336,336,672
8505,2023-01-19,JESSIE,bounty,Shooting Star,16,4,20
8506,2023-01-18,JESSIE,knockout,Goldarm Gulch,4,7,11
8507,2023-01-18,JESSIE,hotZone,Parallel Plays,13,14,27
8508,2023-01-18,JESSIE,heist,Kaboom Canyon,71,45,116
8509,2023-01-18,JESSIE,gemGrab,Gem Fort,36,31,67
8510,2023-01-18,JESSIE,gemGrab,Crystal Arcade,13,1,14
8511,2023-01-18,JESSIE,brawlBall,Sunny Soccer,86,90,176
8512,2023-01-18,JESSIE,brawlBall,Beach Ball,2,2,4
8513,2023-01-18,JESSIE,bounty,Shooting Star,7,5,12
8514,2023-01-17,JESSIE,knockout,Goldarm Gulch,3,0,3
8515,2023-01-17,JESSIE,hotZone,Parallel Plays,16,13,29
8516,2023-01-17,JESSIE,heist,Pit Stop,22,8,30
8517,2023-01-17,JESSIE,gemGrab,Minecart Madness,1,3,4
8518,2023-01-17,JESSIE,gemGrab,Crystal Arcade,7,4,11
8519,2023-01-17,JESSIE,brawlBall,Beach Ball,28,29,57
8520,2023-01-17,JESSIE,bounty,Hideout,2,0,2
8521,2023-01-16,JESSIE,knockout,Belle's Rock,6,1,7
8522,2023-01-16,JESSIE,hotZone,Quarter Pounder,21,4,25
8523,2023-01-16,JESSIE,heist,Pit Stop,30,16,46
8524,2023-01-16,JESSIE,gemGrab,Minecart Madness,16,12,28
8525,2023-01-16,JESSIE,gemGrab,Double Swoosh,6,3,9
8526,2023-01-16,JESSIE,brawlBall,Center Stage,14,12,26
8527,2023-01-16,JESSIE,brawlBall,Backyard Bowl,2,0,2
8528,2023-01-16,JESSIE,bounty,Hideout,0,1,1
8529,2023-01-15,JESSIE,knockout,Belle's Rock,4,4,8
8530,2023-01-15,JESSIE,hotZone,Quarter Pounder,38,12,50
8531,2023-01-15,JESSIE,heist,Bridge Too Far,57,30,87
8532,2023-01-15,JESSIE,gemGrab,Hard Rock Mine,5,1,6
8533,2023-01-15,JESSIE,gemGrab,Double Swoosh,14,16,30
8534,2023-01-15,JESSIE,brawlBall,Super Beach,5,2,7
8535,2023-01-15,JESSIE,brawlBall,Backyard Bowl,31,38,69
8536,2023-01-15,JESSIE,bounty,Canal Grande,3,1,4
8537,2023-01-14,JESSIE,knockout,Flaring Phoenix,2,0,2
8538,2023-01-14,JESSIE,hotZone,Controller Chaos,27,15,42
8539,2023-01-14,JESSIE,heist,Bridge Too Far,44,19,63
8540,2023-01-14,JESSIE,gemGrab,Hard Rock Mine,8,3,11
8541,2023-01-14,JESSIE,gemGrab,Deep Diner,8,6,14
8542,2023-01-14,JESSIE,brawlBall,Super Beach,44,57,101
8543,2023-01-14,JESSIE,brawlBall,Sneaky Fields,3,1,4
8544,2023-01-14,JESSIE,bounty,Canal Grande,1,1,2
8545,2023-01-13,JESSIE,knockout,Flaring Phoenix,3,1,4
8546,2023-01-13,JESSIE,hotZone,Controller Chaos,26,6,32
8547,2023-01-13,JESSIE,heist,Hot Potato,17,20,37
8548,2023-01-13,JESSIE,gemGrab,Undermine,1,0,1
8549,2023-01-13,JESSIE,gemGrab,Deep Diner,13,6,19
8550,2023-01-13,JESSIE,brawlBall,Sneaky Fields,15,35,50
8551,2023-01-13,JESSIE,brawlBall,Pinhole Punt,1,0,1
8552,2023-01-13,JESSIE,bounty,Temple Ruins,1,0,1
8553,2023-01-12,JESSIE,knockout,Riverside,3,0,3
8554,2023-01-12,JESSIE,hotZone,Open Zone,21,1,22
8555,2023-01-12,JESSIE,heist,Hot Potato,8,3,11
8556,2023-01-12,JESSIE,gemGrab,Undermine,2,1,3
8557,2023-01-12,JESSIE,brawlBall,Sunny Soccer,0,1,1
8558,2023-01-12,JESSIE,brawlBall,Pinhole Punt,12,26,38
8559,2023-01-11,JESSIE,knockout,Riverside,1,0,1
8560,2023-01-11,JESSIE,hotZone,Open Zone,1,2,3
8561,2023-01-11,JESSIE,heist,Safe Zone,2,1,3
8562,2023-01-11,JESSIE,gemGrab,Gem Fort,4,1,5
8563,2023-01-11,JESSIE,brawlBall,Sunny Soccer,4,7,11
8564,2023-01-10,JESSIE,hotZone,Dueling Beetles,36,30,66
8565,2023-01-10,JESSIE,heist,Safe Zone,33,9,42
8566,2023-01-10,JESSIE,gemGrab,Minecart Madness,8,5,13
8567,2023-01-10,JESSIE,gemGrab,Crystal Arcade,8,1,9
8568,2023-01-10,JESSIE,brawlBall,Center Stage,3,1,4
8569,2023-01-10,JESSIE,brawlBall,Beach Ball,13,17,30
8570,2023-01-09,JESSIE,knockout,New Perspective,1,0,1
8571,2023-01-09,JESSIE,hotZone,Dueling Beetles,11,14,25
8572,2023-01-09,JESSIE,heist,Snaked Assault,78,49,127
8573,2023-01-09,JESSIE,gemGrab,Minecart Madness,16,10,26
8574,2023-01-09,JESSIE,gemGrab,Double Swoosh,7,2,9
8575,2023-01-09,JESSIE,brawlBall,Center Stage,9,1,10
8576,2023-01-09,JESSIE,brawlBall,Backyard Bowl,1,1,2
8577,2023-01-09,JESSIE,bounty,Layer Cake,2,2,4
8578,2023-01-08,JESSIE,knockout,X Marks the Spot,2,0,2
8579,2023-01-08,JESSIE,hotZone,Ring of Fire,24,2,26
8580,2023-01-08,JESSIE,heist,Snaked Assault,38,19,57
8581,2023-01-08,JESSIE,gemGrab,Hard Rock Mine,6,1,7
8582,2023-01-08,JESSIE,gemGrab,Double Swoosh,8,11,19
8583,2023-01-08,JESSIE,brawlBall,Super Beach,4,10,14
8584,2023-01-08,JESSIE,brawlBall,Backyard Bowl,19,11,30
8585,2023-01-08,JESSIE,bounty,Layer Cake,1,1,2
8586,2023-01-07,JESSIE,hotZone,Ring of Fire,9,2,11
8587,2023-01-07,JESSIE,heist,Tornado Ring,27,10,37
8588,2023-01-07,JESSIE,gemGrab,Hard Rock Mine,6,3,9
8589,2023-01-07,JESSIE,gemGrab,Deep Diner,13,7,20
8590,2023-01-07,JESSIE,brawlBall,Super Beach,15,23,38
8591,2023-01-07,JESSIE,brawlBall,Sneaky Fields,1,0,1
8592,2023-01-07,JESSIE,bounty,Dry Season,2,0,2
8593,2023-01-06,JESSIE,knockout,Out in the Open,3,1,4
8594,2023-01-06,JESSIE,hotZone,Split,4,0,4
8595,2023-01-06,JESSIE,heist,Tornado Ring,43,32,75
8596,2023-01-06,JESSIE,gemGrab,Undermine,1,2,3
8597,2023-01-06,JESSIE,gemGrab,Deep Diner,20,3,23
8598,2023-01-06,JESSIE,brawlBall,Sneaky Fields,5,6,11
8599,2023-01-06,JESSIE,brawlBall,Pinhole Punt,1,1,2
8600,2023-01-06,JESSIE,bounty,Dry Season,2,0,2
8601,2023-01-05,JESSIE,knockout,Out in the Open,2,1,3
8602,2023-01-05,JESSIE,hotZone,Split,3,1,4
8603,2023-01-05,JESSIE,heist,Kaboom Canyon,36,7,43
8604,2023-01-05,JESSIE,gemGrab,Undermine,20,5,25
8605,2023-01-05,JESSIE,gemGrab,Gem Fort,1,3,4
8606,2023-01-05,JESSIE,brawlBall,Pinhole Punt,17,18,35
8607,2023-01-05,JESSIE,bounty,Shooting Star,1,0,1
8608,2023-01-04,JESSIE,knockout,Goldarm Gulch,2,0,2
8609,2023-01-04,JESSIE,hotZone,Parallel Plays,11,21,32
8610,2023-01-04,JESSIE,heist,Kaboom Canyon,59,38,97
8611,2023-01-04,JESSIE,gemGrab,Gem Fort,12,8,20
8612,2023-01-04,JESSIE,gemGrab,Crystal Arcade,7,4,11
8613,2023-01-04,JESSIE,brawlBall,Sunny Soccer,28,12,40
8614,2023-01-04,JESSIE,brawlBall,Beach Ball,1,0,1
8615,2023-01-04,JESSIE,bounty,Shooting Star,3,1,4
8616,2023-01-03,JESSIE,hotZone,Parallel Plays,17,7,24
8617,2023-01-03,JESSIE,heist,Pit Stop,15,8,23
8618,2023-01-03,JESSIE,gemGrab,Minecart Madness,3,0,3
8619,2023-01-03,JESSIE,gemGrab,Crystal Arcade,17,10,27
8620,2023-01-03,JESSIE,brawlBall,Center Stage,2,0,2
8621,2023-01-03,JESSIE,brawlBall,Beach Ball,21,32,53
8622,2023-01-03,JESSIE,bounty,Hideout,2,0,2
8623,2023-01-02,JESSIE,knockout,Belle's Rock,3,0,3
8624,2023-01-02,JESSIE,hotZone,Quarter Pounder,26,5,31
8625,2023-01-02,JESSIE,hotZone,Controller Chaos,1,0,1
8626,2023-01-02,JESSIE,heist,Pit Stop,37,2,39
8627,2023-01-02,JESSIE,heist,Kaboom Canyon,0,1,1
8628,2023-01-02,JESSIE,gemGrab,Minecart Madness,16,2,18
8629,2023-01-02,JESSIE,gemGrab,Double Swoosh,7,4,11
8630,2023-01-02,JESSIE,brawlBall,Center Stage,12,3,15
8631,2023-01-02,JESSIE,brawlBall,Backyard Bowl,1,0,1
8632,2023-01-02,JESSIE,bounty,Hideout,3,1,4
8633,2023-01-01,JESSIE,knockout,Belle's Rock,1,0,1
8634,2023-01-01,JESSIE,hotZone,Quarter Pounder,10,2,12
8635,2023-01-01,JESSIE,heist,Kaboom Canyon,0,1,1
8636,2023-01-01,JESSIE,heist,Bridge Too Far,4,3,7
8637,2023-01-01,JESSIE,gemGrab,Double Swoosh,6,13,19
8638,2023-01-01,JESSIE,brawlBall,Backyard Bowl,7,10,17
8639,2023-01-01,JESSIE,bounty,Canal Grande,0,1,1
8640,2022-12-31,JESSIE,hotZone,Controller Chaos,3,0,3
8641,2022-12-31,JESSIE,heist,Bridge Too Far,2,0,2
8642,2022-12-31,JESSIE,gemGrab,Hard Rock Mine,1,0,1
8643,2022-12-31,JESSIE,gemGrab,Deep Diner,1,0,1
8644,2022-12-31,JESSIE,brawlBall,Super Beach,3,11,14
8645,2022-12-30,JESSIE,hotZone,Controller Chaos,3,2,5
8646,2022-12-30,JESSIE,gemGrab,Undermine,2,0,2
8647,2022-12-30,JESSIE,gemGrab,Deep Diner,9,1,10
8648,2022-12-30,JESSIE,brawlBall,Sneaky Fields,1,0,1
8649,2022-12-29,JESSIE,brawlBall,Pinhole Punt,2,3,5
8650,2022-12-27,JESSIE,heist,Safe Zone,1,0,1
8651,2022-12-27,JESSIE,heist,Kaboom Canyon,2,0,2
8652,2022-12-27,JESSIE,brawlBall,Beach Ball,1,1,2
8653,2022-12-26,JESSIE,heist,Kaboom Canyon,2,0,2
8654,2022-12-26,JESSIE,gemGrab,Minecart Madness,1,0,1
8655,2022-12-26,JESSIE,brawlBall,Center Stage,1,0,1
8656,2022-12-24,JESSIE,brawlBall,Super Beach,1,0,1
8657,2022-12-23,JESSIE,knockout,Out in the Open,0,1,1
8658,2022-12-22,JESSIE,brawlBall,Pinhole Punt,1,0,1
8659,2022-12-13,JESSIE,heist,Safe Zone,2,3,5
8660,2022-12-10,JESSIE,knockout,X Marks the Spot,2,0,2
8661,2022-12-10,JESSIE,hotZone,Ring of Fire,0,1,1
8662,2022-11-11,JESSIE,brawlBall,Sneaky Fields,1,0,1
8663,2022-11-01,JESSIE,knockout,New Perspective,1,0,1
8664,2022-10-30,JESSIE,heist,Safe Zone,1,0,1
8665,2022-10-30,JESSIE,brawlBall,Beach Ball,1,0,1
8666,2022-10-30,JESSIE,bounty,Canal Grande,1,0,1
8667,2022-10-15,JESSIE,gemGrab,Hard Rock Mine,0,2,2
8668,2023-02-05,JANET,knockout,X Marks the Spot,44,41,85
8669,2023-02-05,JANET,knockout,Goldarm Gulch,16,8,24
8670,2023-02-05,JANET,hotZone,Ring of Fire,47,83,130
8671,2023-02-05,JANET,heist,Snaked Assault,3,1,4
8672,2023-02-05,JANET,heist,Pit Stop,1,0,1
8673,2023-02-05,JANET,gemGrab,Hard Rock Mine,18,20,38
8674,2023-02-05,JANET,gemGrab,Double Swoosh,148,254,402
8675,2023-02-05,JANET,brawlBall,Super Beach,5,5,10
8676,2023-02-05,JANET,brawlBall,Sneaky Fields,6,12,18
8677,2023-02-05,JANET,brawlBall,Backyard Bowl,207,284,491
8678,2023-02-05,JANET,bounty,Layer Cake,24,21,45
8679,2023-02-04,JANET,knockout,X Marks the Spot,12,6,18
8680,2023-02-04,JANET,knockout,Goldarm Gulch,14,11,25
8681,2023-02-04,JANET,hotZone,Ring of Fire,10,20,30
8682,2023-02-04,JANET,heist,Tornado Ring,1,1,2
8683,2023-02-04,JANET,gemGrab,Hard Rock Mine,29,48,77
8684,2023-02-04,JANET,gemGrab,Double Swoosh,12,52,64
8685,2023-02-04,JANET,gemGrab,Deep Diner,11,17,28
8686,2023-02-04,JANET,brawlBall,Super Beach,39,44,83
8687,2023-02-04,JANET,brawlBall,Sneaky Fields,5,12,17
8688,2023-02-04,JANET,bounty,Dry Season,6,4,10
8689,2023-02-03,JANET,knockout,Out in the Open,64,57,121
8690,2023-02-03,JANET,knockout,Goldarm Gulch,77,73,150
8691,2023-02-03,JANET,hotZone,Split,7,20,27
8692,2023-02-03,JANET,heist,Tornado Ring,12,10,22
8693,2023-02-03,JANET,heist,Pit Stop,2,6,8
8694,2023-02-03,JANET,gemGrab,Undermine,21,26,47
8695,2023-02-03,JANET,gemGrab,Double Swoosh,112,341,453
8696,2023-02-03,JANET,gemGrab,Deep Diner,61,102,163
8697,2023-02-03,JANET,brawlBall,Sneaky Fields,221,319,540
8698,2023-02-03,JANET,brawlBall,Pinhole Punt,11,4,15
8699,2023-02-03,JANET,bounty,Dry Season,39,75,114
8700,2023-02-02,JANET,knockout,Out in the Open,26,18,44
8701,2023-02-02,JANET,hotZone,Split,7,14,21
8702,2023-02-02,JANET,heist,Kaboom Canyon,1,0,1
8703,2023-02-02,JANET,gemGrab,Undermine,18,15,33
8704,2023-02-02,JANET,gemGrab,Gem Fort,5,10,15
8705,2023-02-02,JANET,brawlBall,Sunny Soccer,2,0,2
8706,2023-02-02,JANET,brawlBall,Pinhole Punt,71,78,149
8707,2023-02-02,JANET,bounty,Shooting Star,5,5,10
8708,2023-02-01,JANET,knockout,Goldarm Gulch,62,91,153
8709,2023-02-01,JANET,hotZone,Parallel Plays,40,30,70
8710,2023-02-01,JANET,heist,Kaboom Canyon,9,8,17
8711,2023-02-01,JANET,gemGrab,Gem Fort,48,64,112
8712,2023-02-01,JANET,gemGrab,Crystal Arcade,28,33,61
8713,2023-02-01,JANET,brawlBall,Sunny Soccer,104,145,249
8714,2023-02-01,JANET,brawlBall,Beach Ball,8,20,28
8715,2023-02-01,JANET,bounty,Shooting Star,12,21,33
8716,2023-01-31,JANET,knockout,Goldarm Gulch,34,30,64
8717,2023-01-31,JANET,hotZone,Parallel Plays,28,34,62
8718,2023-01-31,JANET,heist,Pit Stop,2,2,4
8719,2023-01-31,JANET,gemGrab,Minecart Madness,0,1,1
8720,2023-01-31,JANET,gemGrab,Crystal Arcade,14,32,46
8721,2023-01-31,JANET,brawlBall,Center Stage,2,2,4
8722,2023-01-31,JANET,brawlBall,Beach Ball,70,93,163
8723,2023-01-31,JANET,bounty,Hideout,4,3,7
8724,2023-01-30,JANET,knockout,Belle's Rock,101,121,222
8725,2023-01-30,JANET,hotZone,Quarter Pounder,26,70,96
8726,2023-01-30,JANET,heist,Pit Stop,3,0,3
8727,2023-01-30,JANET,gemGrab,Minecart Madness,50,74,124
8728,2023-01-30,JANET,gemGrab,Double Swoosh,69,129,198
8729,2023-01-30,JANET,brawlBall,Center Stage,175,190,365
8730,2023-01-30,JANET,brawlBall,Backyard Bowl,10,10,20
8731,2023-01-30,JANET,bounty,Hideout,17,35,52
8732,2023-01-29,JANET,knockout,Belle's Rock,92,101,193
8733,2023-01-29,JANET,hotZone,Quarter Pounder,36,72,108
8734,2023-01-29,JANET,heist,Bridge Too Far,4,3,7
8735,2023-01-29,JANET,gemGrab,Hard Rock Mine,19,22,41
8736,2023-01-29,JANET,gemGrab,Double Swoosh,143,223,366
8737,2023-01-29,JANET,brawlBall,Super Beach,2,5,7
8738,2023-01-29,JANET,brawlBall,Backyard Bowl,196,246,442
8739,2023-01-29,JANET,bounty,Canal Grande,24,93,117
8740,2023-01-28,JANET,knockout,Flaring Phoenix,34,47,81
8741,2023-01-28,JANET,hotZone,Controller Chaos,23,53,76
8742,2023-01-28,JANET,heist,Bridge Too Far,21,10,31
8743,2023-01-28,JANET,gemGrab,Hard Rock Mine,86,134,220
8744,2023-01-28,JANET,gemGrab,Deep Diner,33,44,77
8745,2023-01-28,JANET,brawlBall,Super Beach,148,183,331
8746,2023-01-28,JANET,brawlBall,Sneaky Fields,15,23,38
8747,2023-01-28,JANET,bounty,Canal Grande,83,92,175
8748,2023-01-27,JANET,knockout,Flaring Phoenix,10,10,20
8749,2023-01-27,JANET,hotZone,Controller Chaos,12,13,25
8750,2023-01-27,JANET,heist,Hot Potato,1,1,2
8751,2023-01-27,JANET,gemGrab,Undermine,5,7,12
8752,2023-01-27,JANET,gemGrab,Deep Diner,38,41,79
8753,2023-01-27,JANET,brawlBall,Sneaky Fields,45,65,110
8754,2023-01-27,JANET,brawlBall,Pinhole Punt,0,1,1
8755,2023-01-27,JANET,bounty,Temple Ruins,10,6,16
8756,2023-01-26,JANET,knockout,Riverside,54,25,79
8757,2023-01-26,JANET,hotZone,Open Zone,51,75,126
8758,2023-01-26,JANET,heist,Hot Potato,1,5,6
8759,2023-01-26,JANET,gemGrab,Undermine,58,106,164
8760,2023-01-26,JANET,gemGrab,Gem Fort,17,15,32
8761,2023-01-26,JANET,brawlBall,Sunny Soccer,4,9,13
8762,2023-01-26,JANET,brawlBall,Pinhole Punt,204,279,483
8763,2023-01-26,JANET,bounty,Temple Ruins,45,59,104
8764,2023-01-25,JANET,knockout,Riverside,20,17,37
8765,2023-01-25,JANET,hotZone,Open Zone,29,33,62
8766,2023-01-25,JANET,heist,Safe Zone,4,3,7
8767,2023-01-25,JANET,gemGrab,Gem Fort,28,19,47
8768,2023-01-25,JANET,gemGrab,Crystal Arcade,32,45,77
8769,2023-01-25,JANET,brawlBall,Sunny Soccer,73,87,160
8770,2023-01-25,JANET,brawlBall,Beach Ball,16,27,43
8771,2023-01-25,JANET,bounty,Excel,13,14,27
8772,2023-01-24,JANET,knockout,New Perspective,30,25,55
8773,2023-01-24,JANET,hotZone,Dueling Beetles,62,84,146
8774,2023-01-24,JANET,heist,Safe Zone,7,2,9
8775,2023-01-24,JANET,gemGrab,Minecart Madness,19,40,59
8776,2023-01-24,JANET,gemGrab,Crystal Arcade,60,67,127
8777,2023-01-24,JANET,brawlBall,Center Stage,23,28,51
8778,2023-01-24,JANET,brawlBall,Beach Ball,206,280,486
8779,2023-01-24,JANET,bounty,Excel,37,36,73
8780,2023-01-23,JANET,knockout,New Perspective,75,68,143
8781,2023-01-23,JANET,hotZone,Dueling Beetles,103,155,258
8782,2023-01-23,JANET,heist,Snaked Assault,6,3,9
8783,2023-01-23,JANET,gemGrab,Minecart Madness,119,181,300
8784,2023-01-23,JANET,gemGrab,Double Swoosh,56,73,129
8785,2023-01-23,JANET,brawlBall,Center Stage,301,369,670
8786,2023-01-23,JANET,brawlBall,Backyard Bowl,17,39,56
8787,2023-01-23,JANET,bounty,Layer Cake,62,134,196
8788,2023-01-22,JANET,knockout,X Marks the Spot,32,16,48
8789,2023-01-22,JANET,hotZone,Ring of Fire,19,26,45
8790,2023-01-22,JANET,heist,Snaked Assault,1,3,4
8791,2023-01-22,JANET,gemGrab,Hard Rock Mine,14,9,23
8792,2023-01-22,JANET,gemGrab,Double Swoosh,66,105,171
8793,2023-01-22,JANET,brawlBall,Super Beach,23,26,49
8794,2023-01-22,JANET,brawlBall,Backyard Bowl,103,128,231
8795,2023-01-22,JANET,bounty,Layer Cake,24,18,42
8796,2023-01-21,JANET,knockout,X Marks the Spot,135,106,241
8797,2023-01-21,JANET,hotZone,Ring of Fire,63,68,131
8798,2023-01-21,JANET,heist,Tornado Ring,6,3,9
8799,2023-01-21,JANET,gemGrab,Hard Rock Mine,136,156,292
8800,2023-01-21,JANET,gemGrab,Deep Diner,23,38,61
8801,2023-01-21,JANET,brawlBall,Super Beach,169,166,335
8802,2023-01-21,JANET,brawlBall,Sneaky Fields,7,3,10
8803,2023-01-21,JANET,bounty,Dry Season,41,80,121
8804,2023-01-20,JANET,knockout,Out in the Open,84,79,163
8805,2023-01-20,JANET,hotZone,Split,27,26,53
8806,2023-01-20,JANET,heist,Tornado Ring,4,2,6
8807,2023-01-20,JANET,gemGrab,Undermine,29,24,53
8808,2023-01-20,JANET,gemGrab,Deep Diner,101,128,229
8809,2023-01-20,JANET,brawlBall,Sneaky Fields,174,192,366
8810,2023-01-20,JANET,brawlBall,Pinhole Punt,5,4,9
8811,2023-01-20,JANET,bounty,Dry Season,29,21,50
8812,2023-01-19,JANET,knockout,Out in the Open,91,122,213
8813,2023-01-19,JANET,hotZone,Split,14,7,21
8814,2023-01-19,JANET,heist,Kaboom Canyon,8,3,11
8815,2023-01-19,JANET,gemGrab,Undermine,67,88,155
8816,2023-01-19,JANET,gemGrab,Gem Fort,7,22,29
8817,2023-01-19,JANET,brawlBall,Sunny Soccer,4,2,6
8818,2023-01-19,JANET,brawlBall,Pinhole Punt,251,329,580
8819,2023-01-19,JANET,bounty,Shooting Star,23,34,57
8820,2023-01-18,JANET,knockout,Goldarm Gulch,18,31,49
8821,2023-01-18,JANET,hotZone,Parallel Plays,3,16,19
8822,2023-01-18,JANET,heist,Kaboom Canyon,1,1,2
8823,2023-01-18,JANET,gemGrab,Gem Fort,11,15,26
8824,2023-01-18,JANET,gemGrab,Crystal Arcade,6,7,13
8825,2023-01-18,JANET,brawlBall,Sunny Soccer,58,77,135
8826,2023-01-18,JANET,brawlBall,Beach Ball,3,0,3
8827,2023-01-18,JANET,bounty,Shooting Star,17,22,39
8828,2023-01-17,JANET,knockout,Goldarm Gulch,8,6,14
8829,2023-01-17,JANET,hotZone,Parallel Plays,3,4,7
8830,2023-01-17,JANET,heist,Pit Stop,0,1,1
8831,2023-01-17,JANET,gemGrab,Minecart Madness,1,2,3
8832,2023-01-17,JANET,gemGrab,Crystal Arcade,15,12,27
8833,2023-01-17,JANET,brawlBall,Center Stage,1,0,1
8834,2023-01-17,JANET,brawlBall,Beach Ball,10,13,23
8835,2023-01-17,JANET,bounty,Hideout,3,1,4
8836,2023-01-16,JANET,knockout,Belle's Rock,10,16,26
8837,2023-01-16,JANET,hotZone,Quarter Pounder,4,0,4
8838,2023-01-16,JANET,heist,Pit Stop,0,1,1
8839,2023-01-16,JANET,gemGrab,Minecart Madness,8,7,15
8840,2023-01-16,JANET,gemGrab,Double Swoosh,8,1,9
8841,2023-01-16,JANET,brawlBall,Center Stage,16,36,52
8842,2023-01-16,JANET,brawlBall,Backyard Bowl,3,6,9
8843,2023-01-16,JANET,bounty,Hideout,11,18,29
8844,2023-01-15,JANET,knockout,Belle's Rock,9,24,33
8845,2023-01-15,JANET,hotZone,Quarter Pounder,12,9,21
8846,2023-01-15,JANET,heist,Bridge Too Far,1,0,1
8847,2023-01-15,JANET,gemGrab,Hard Rock Mine,3,0,3
8848,2023-01-15,JANET,gemGrab,Double Swoosh,12,57,69
8849,2023-01-15,JANET,brawlBall,Super Beach,1,0,1
8850,2023-01-15,JANET,brawlBall,Backyard Bowl,27,32,59
8851,2023-01-15,JANET,bounty,Canal Grande,5,4,9
8852,2023-01-14,JANET,knockout,Flaring Phoenix,2,1,3
8853,2023-01-14,JANET,hotZone,Controller Chaos,9,6,15
8854,2023-01-14,JANET,heist,Bridge Too Far,1,0,1
8855,2023-01-14,JANET,gemGrab,Hard Rock Mine,3,6,9
8856,2023-01-14,JANET,gemGrab,Deep Diner,6,1,7
8857,2023-01-14,JANET,brawlBall,Super Beach,10,3,13
8858,2023-01-14,JANET,brawlBall,Sneaky Fields,1,0,1
8859,2023-01-14,JANET,bounty,Canal Grande,2,7,9
8860,2023-01-13,JANET,knockout,Flaring Phoenix,2,3,5
8861,2023-01-13,JANET,hotZone,Controller Chaos,7,5,12
8862,2023-01-13,JANET,heist,Hot Potato,1,0,1
8863,2023-01-13,JANET,gemGrab,Deep Diner,6,6,12
8864,2023-01-13,JANET,brawlBall,Sneaky Fields,12,5,17
8865,2023-01-13,JANET,bounty,Temple Ruins,1,0,1
8866,2023-01-12,JANET,knockout,Riverside,3,0,3
8867,2023-01-12,JANET,hotZone,Open Zone,5,13,18
8868,2023-01-12,JANET,gemGrab,Undermine,7,20,27
8869,2023-01-12,JANET,brawlBall,Sunny Soccer,1,0,1
8870,2023-01-12,JANET,brawlBall,Pinhole Punt,12,30,42
8871,2023-01-12,JANET,bounty,Temple Ruins,1,0,1
8872,2023-01-11,JANET,hotZone,Open Zone,2,7,9
8873,2023-01-11,JANET,gemGrab,Gem Fort,3,1,4
8874,2023-01-11,JANET,brawlBall,Sunny Soccer,1,4,5
8875,2023-01-10,JANET,knockout,New Perspective,4,2,6
8876,2023-01-10,JANET,hotZone,Dueling Beetles,6,4,10
8877,2023-01-10,JANET,heist,Safe Zone,0,1,1
8878,2023-01-10,JANET,gemGrab,Minecart Madness,6,23,29
8879,2023-01-10,JANET,gemGrab,Crystal Arcade,3,20,23
8880,2023-01-10,JANET,brawlBall,Center Stage,3,0,3
8881,2023-01-10,JANET,brawlBall,Beach Ball,9,54,63
8882,2023-01-09,JANET,knockout,New Perspective,3,3,6
8883,2023-01-09,JANET,hotZone,Dueling Beetles,6,0,6
8884,2023-01-09,JANET,gemGrab,Minecart Madness,2,11,13
8885,2023-01-09,JANET,gemGrab,Double Swoosh,8,26,34
8886,2023-01-09,JANET,brawlBall,Center Stage,10,21,31
8887,2023-01-09,JANET,bounty,Layer Cake,4,14,18
8888,2023-01-08,JANET,knockout,X Marks the Spot,17,12,29
8889,2023-01-08,JANET,hotZone,Ring of Fire,1,3,4
8890,2023-01-08,JANET,gemGrab,Hard Rock Mine,4,2,6
8891,2023-01-08,JANET,gemGrab,Double Swoosh,4,8,12
8892,2023-01-08,JANET,brawlBall,Backyard Bowl,14,8,22
8893,2023-01-08,JANET,bounty,Layer Cake,7,27,34
8894,2023-01-07,JANET,knockout,X Marks the Spot,2,0,2
8895,2023-01-07,JANET,hotZone,Ring of Fire,5,3,8
8896,2023-01-07,JANET,heist,Tornado Ring,1,0,1
8897,2023-01-07,JANET,gemGrab,Hard Rock Mine,3,1,4
8898,2023-01-07,JANET,gemGrab,Deep Diner,5,4,9
8899,2023-01-07,JANET,brawlBall,Super Beach,2,5,7
8900,2023-01-07,JANET,bounty,Dry Season,8,14,22
8901,2023-01-06,JANET,knockout,Out in the Open,4,2,6
8902,2023-01-06,JANET,hotZone,Split,1,1,2
8903,2023-01-06,JANET,heist,Tornado Ring,1,0,1
8904,2023-01-06,JANET,gemGrab,Undermine,2,2,4
8905,2023-01-06,JANET,gemGrab,Deep Diner,14,2,16
8906,2023-01-06,JANET,brawlBall,Sneaky Fields,5,3,8
8907,2023-01-06,JANET,brawlBall,Pinhole Punt,1,5,6
8908,2023-01-06,JANET,bounty,Dry Season,7,3,10
8909,2023-01-05,JANET,knockout,Out in the Open,7,28,35
8910,2023-01-05,JANET,hotZone,Split,10,11,21
8911,2023-01-05,JANET,heist,Kaboom Canyon,1,0,1
8912,2023-01-05,JANET,gemGrab,Undermine,13,27,40
8913,2023-01-05,JANET,gemGrab,Gem Fort,1,0,1
8914,2023-01-05,JANET,brawlBall,Sunny Soccer,1,0,1
8915,2023-01-05,JANET,brawlBall,Pinhole Punt,24,40,64
8916,2023-01-05,JANET,bounty,Shooting Star,2,2,4
8917,2023-01-04,JANET,knockout,Goldarm Gulch,2,1,3
8918,2023-01-04,JANET,hotZone,Parallel Plays,5,22,27
8919,2023-01-04,JANET,heist,Kaboom Canyon,4,0,4
8920,2023-01-04,JANET,gemGrab,Gem Fort,5,0,5
8921,2023-01-04,JANET,gemGrab,Crystal Arcade,4,17,21
8922,2023-01-04,JANET,brawlBall,Sunny Soccer,8,5,13
8923,2023-01-04,JANET,bounty,Shooting Star,3,1,4
8924,2023-01-03,JANET,knockout,Goldarm Gulch,3,3,6
8925,2023-01-03,JANET,hotZone,Parallel Plays,14,36,50
8926,2023-01-03,JANET,gemGrab,Minecart Madness,1,2,3
8927,2023-01-03,JANET,gemGrab,Crystal Arcade,14,6,20
8928,2023-01-03,JANET,brawlBall,Center Stage,2,11,13
8929,2023-01-03,JANET,brawlBall,Beach Ball,16,62,78
8930,2023-01-03,JANET,bounty,Hideout,6,20,26
8931,2023-01-02,JANET,knockout,Belle's Rock,6,2,8
8932,2023-01-02,JANET,hotZone,Quarter Pounder,10,18,28
8933,2023-01-02,JANET,heist,Pit Stop,1,0,1
8934,2023-01-02,JANET,heist,Kaboom Canyon,0,1,1
8935,2023-01-02,JANET,gemGrab,Minecart Madness,12,17,29
8936,2023-01-02,JANET,gemGrab,Double Swoosh,11,19,30
8937,2023-01-02,JANET,brawlBall,Center Stage,12,36,48
8938,2023-01-02,JANET,brawlBall,Backyard Bowl,1,1,2
8939,2023-01-02,JANET,bounty,Hideout,10,23,33
8940,2023-01-01,JANET,knockout,Belle's Rock,11,13,24
8941,2023-01-01,JANET,hotZone,Quarter Pounder,7,10,17
8942,2023-01-01,JANET,gemGrab,Double Swoosh,8,7,15
8943,2023-01-01,JANET,brawlBall,Backyard Bowl,11,3,14
8944,2023-01-01,JANET,bounty,Canal Grande,6,8,14
8945,2022-12-31,JANET,hotZone,Controller Chaos,1,0,1
8946,2022-12-31,JANET,gemGrab,Minecart Madness,0,1,1
8947,2022-12-31,JANET,gemGrab,Hard Rock Mine,1,0,1
8948,2022-12-31,JANET,gemGrab,Deep Diner,2,0,2
8949,2022-12-31,JANET,brawlBall,Super Beach,0,1,1
8950,2022-12-31,JANET,bounty,Canal Grande,3,3,6
8951,2022-12-30,JANET,knockout,Flaring Phoenix,0,1,1
8952,2022-12-30,JANET,brawlBall,Sneaky Fields,0,2,2
8953,2022-12-29,JANET,gemGrab,Undermine,1,0,1
8954,2022-12-29,JANET,gemGrab,Minecart Madness,1,0,1
8955,2022-12-29,JANET,gemGrab,Gem Fort,1,1,2
8956,2022-12-28,JANET,hotZone,Open Zone,0,1,1
8957,2022-12-27,JANET,brawlBall,Center Stage,0,1,1
8958,2022-12-25,JANET,gemGrab,Double Swoosh,2,3,5
8959,2022-12-23,JANET,knockout,Out in the Open,1,1,2
8960,2022-12-22,JANET,brawlBall,Pinhole Punt,0,1,1
8961,2022-12-16,JANET,gemGrab,Undermine,0,1,1
8962,2022-12-13,JANET,gemGrab,Crystal Arcade,1,0,1
8963,2022-10-28,JANET,knockout,Out in the Open,1,1,2
8964,2022-10-28,JANET,hotZone,Dueling Beetles,0,2,2
8965,2022-10-28,JANET,bounty,Canal Grande,0,2,2
8966,2022-10-15,JANET,hotZone,Ring of Fire,0,1,1
8967,2023-02-05,JACKY,knockout,X Marks the Spot,289,383,672
8968,2023-02-05,JACKY,knockout,Goldarm Gulch,122,154,276
8969,2023-02-05,JACKY,hotZone,Ring of Fire,21,17,38
8970,2023-02-05,JACKY,heist,Snaked Assault,8,9,17
8971,2023-02-05,JACKY,heist,Pit Stop,0,1,1
8972,2023-02-05,JACKY,gemGrab,Hard Rock Mine,17,28,45
8973,2023-02-05,JACKY,gemGrab,Double Swoosh,125,88,213
8974,2023-02-05,JACKY,brawlBall,Super Beach,20,23,43
8975,2023-02-05,JACKY,brawlBall,Sneaky Fields,228,238,466
8976,2023-02-05,JACKY,brawlBall,Backyard Bowl,140,110,250
8977,2023-02-05,JACKY,bounty,Layer Cake,11,4,15
8978,2023-02-04,JACKY,knockout,X Marks the Spot,81,91,172
8979,2023-02-04,JACKY,knockout,Goldarm Gulch,130,174,304
8980,2023-02-04,JACKY,heist,Tornado Ring,2,2,4
8981,2023-02-04,JACKY,heist,Pit Stop,3,2,5
8982,2023-02-04,JACKY,gemGrab,Hard Rock Mine,8,7,15
8983,2023-02-04,JACKY,gemGrab,Double Swoosh,24,14,38
8984,2023-02-04,JACKY,gemGrab,Deep Diner,2,2,4
8985,2023-02-04,JACKY,brawlBall,Super Beach,204,214,418
8986,2023-02-04,JACKY,brawlBall,Sneaky Fields,154,153,307
8987,2023-02-04,JACKY,bounty,Dry Season,1,1,2
8988,2023-02-03,JACKY,knockout,Out in the Open,205,337,542
8989,2023-02-03,JACKY,knockout,Goldarm Gulch,569,770,1339
8990,2023-02-03,JACKY,hotZone,Split,42,48,90
8991,2023-02-03,JACKY,heist,Tornado Ring,12,3,15
8992,2023-02-03,JACKY,heist,Pit Stop,13,7,20
8993,2023-02-03,JACKY,gemGrab,Undermine,10,6,16
8994,2023-02-03,JACKY,gemGrab,Double Swoosh,127,44,171
8995,2023-02-03,JACKY,gemGrab,Deep Diner,21,21,42
8996,2023-02-03,JACKY,brawlBall,Sneaky Fields,3098,3229,6327
8997,2023-02-03,JACKY,brawlBall,Pinhole Punt,24,21,45
8998,2023-02-03,JACKY,bounty,Dry Season,20,26,46
8999,2023-02-02,JACKY,knockout,Out in the Open,142,217,359
9000,2023-02-02,JACKY,hotZone,Split,20,29,49
9001,2023-02-02,JACKY,heist,Kaboom Canyon,0,1,1
9002,2023-02-02,JACKY,gemGrab,Undermine,14,8,22
9003,2023-02-02,JACKY,gemGrab,Gem Fort,4,10,14
9004,2023-02-02,JACKY,brawlBall,Sunny Soccer,8,15,23
9005,2023-02-02,JACKY,brawlBall,Pinhole Punt,123,136,259
9006,2023-02-02,JACKY,bounty,Shooting Star,0,1,1
9007,2023-02-01,JACKY,knockout,Goldarm Gulch,344,459,803
9008,2023-02-01,JACKY,hotZone,Parallel Plays,73,62,135
9009,2023-02-01,JACKY,heist,Kaboom Canyon,2,0,2
9010,2023-02-01,JACKY,gemGrab,Gem Fort,56,40,96
9011,2023-02-01,JACKY,gemGrab,Crystal Arcade,13,24,37
9012,2023-02-01,JACKY,brawlBall,Sunny Soccer,627,667,1294
9013,2023-02-01,JACKY,brawlBall,Beach Ball,17,25,42
9014,2023-02-01,JACKY,bounty,Shooting Star,2,1,3
9015,2023-01-31,JACKY,knockout,Goldarm Gulch,251,332,583
9016,2023-01-31,JACKY,hotZone,Parallel Plays,30,33,63
9017,2023-01-31,JACKY,heist,Pit Stop,3,4,7
9018,2023-01-31,JACKY,gemGrab,Crystal Arcade,31,48,79
9019,2023-01-31,JACKY,brawlBall,Center Stage,10,23,33
9020,2023-01-31,JACKY,brawlBall,Beach Ball,274,265,539
9021,2023-01-31,JACKY,bounty,Hideout,2,0,2
9022,2023-01-30,JACKY,knockout,Belle's Rock,129,194,323
9023,2023-01-30,JACKY,hotZone,Quarter Pounder,21,11,32
9024,2023-01-30,JACKY,heist,Pit Stop,7,5,12
9025,2023-01-30,JACKY,gemGrab,Minecart Madness,6,7,13
9026,2023-01-30,JACKY,gemGrab,Double Swoosh,46,35,81
9027,2023-01-30,JACKY,brawlBall,Center Stage,908,1165,2073
9028,2023-01-30,JACKY,brawlBall,Backyard Bowl,19,4,23
9029,2023-01-30,JACKY,bounty,Hideout,7,2,9
9030,2023-01-29,JACKY,knockout,Belle's Rock,305,394,699
9031,2023-01-29,JACKY,hotZone,Quarter Pounder,18,10,28
9032,2023-01-29,JACKY,gemGrab,Hard Rock Mine,17,11,28
9033,2023-01-29,JACKY,gemGrab,Double Swoosh,66,46,112
9034,2023-01-29,JACKY,brawlBall,Super Beach,10,19,29
9035,2023-01-29,JACKY,brawlBall,Backyard Bowl,159,106,265
9036,2023-01-29,JACKY,bounty,Canal Grande,48,83,131
9037,2023-01-28,JACKY,knockout,Flaring Phoenix,172,274,446
9038,2023-01-28,JACKY,hotZone,Controller Chaos,27,7,34
9039,2023-01-28,JACKY,heist,Bridge Too Far,13,4,17
9040,2023-01-28,JACKY,gemGrab,Hard Rock Mine,48,45,93
9041,2023-01-28,JACKY,gemGrab,Deep Diner,7,0,7
9042,2023-01-28,JACKY,brawlBall,Super Beach,975,1150,2125
9043,2023-01-28,JACKY,brawlBall,Sneaky Fields,88,73,161
9044,2023-01-28,JACKY,bounty,Canal Grande,101,135,236
9045,2023-01-27,JACKY,knockout,Flaring Phoenix,101,151,252
9046,2023-01-27,JACKY,hotZone,Controller Chaos,10,6,16
9047,2023-01-27,JACKY,heist,Hot Potato,3,1,4
9048,2023-01-27,JACKY,gemGrab,Undermine,2,1,3
9049,2023-01-27,JACKY,gemGrab,Deep Diner,11,9,20
9050,2023-01-27,JACKY,brawlBall,Sneaky Fields,541,580,1121
9051,2023-01-27,JACKY,brawlBall,Pinhole Punt,3,12,15
9052,2023-01-27,JACKY,bounty,Temple Ruins,2,0,2
9053,2023-01-26,JACKY,knockout,Riverside,6,2,8
9054,2023-01-26,JACKY,hotZone,Open Zone,3,2,5
9055,2023-01-26,JACKY,heist,Hot Potato,19,9,28
9056,2023-01-26,JACKY,gemGrab,Undermine,29,13,42
9057,2023-01-26,JACKY,gemGrab,Gem Fort,19,28,47
9058,2023-01-26,JACKY,brawlBall,Sunny Soccer,39,40,79
9059,2023-01-26,JACKY,brawlBall,Pinhole Punt,403,386,789
9060,2023-01-26,JACKY,bounty,Temple Ruins,26,21,47
9061,2023-01-25,JACKY,knockout,Riverside,7,0,7
9062,2023-01-25,JACKY,hotZone,Open Zone,3,0,3
9063,2023-01-25,JACKY,heist,Safe Zone,4,0,4
9064,2023-01-25,JACKY,gemGrab,Gem Fort,40,21,61
9065,2023-01-25,JACKY,gemGrab,Crystal Arcade,17,14,31
9066,2023-01-25,JACKY,brawlBall,Sunny Soccer,416,546,962
9067,2023-01-25,JACKY,brawlBall,Beach Ball,67,47,114
9068,2023-01-25,JACKY,bounty,Excel,6,6,12
9069,2023-01-24,JACKY,knockout,New Perspective,140,228,368
9070,2023-01-24,JACKY,hotZone,Dueling Beetles,33,18,51
9071,2023-01-24,JACKY,heist,Safe Zone,7,4,11
9072,2023-01-24,JACKY,gemGrab,Minecart Madness,3,2,5
9073,2023-01-24,JACKY,gemGrab,Crystal Arcade,20,34,54
9074,2023-01-24,JACKY,brawlBall,Center Stage,81,95,176
9075,2023-01-24,JACKY,brawlBall,Beach Ball,601,594,1195
9076,2023-01-24,JACKY,bounty,Excel,36,39,75
9077,2023-01-23,JACKY,knockout,New Perspective,459,605,1064
9078,2023-01-23,JACKY,hotZone,Dueling Beetles,50,16,66
9079,2023-01-23,JACKY,heist,Snaked Assault,14,2,16
9080,2023-01-23,JACKY,gemGrab,Minecart Madness,10,8,18
9081,2023-01-23,JACKY,gemGrab,Double Swoosh,45,18,63
9082,2023-01-23,JACKY,brawlBall,Center Stage,1388,1420,2808
9083,2023-01-23,JACKY,brawlBall,Backyard Bowl,6,3,9
9084,2023-01-23,JACKY,bounty,Layer Cake,28,26,54
9085,2023-01-22,JACKY,knockout,X Marks the Spot,186,244,430
9086,2023-01-22,JACKY,hotZone,Ring of Fire,8,7,15
9087,2023-01-22,JACKY,heist,Snaked Assault,6,6,12
9088,2023-01-22,JACKY,gemGrab,Hard Rock Mine,17,18,35
9089,2023-01-22,JACKY,gemGrab,Double Swoosh,51,32,83
9090,2023-01-22,JACKY,brawlBall,Super Beach,103,106,209
9091,2023-01-22,JACKY,brawlBall,Backyard Bowl,67,40,107
9092,2023-01-22,JACKY,bounty,Layer Cake,25,32,57
9093,2023-01-21,JACKY,knockout,X Marks the Spot,750,898,1648
9094,2023-01-21,JACKY,hotZone,Ring of Fire,25,54,79
9095,2023-01-21,JACKY,heist,Tornado Ring,16,11,27
9096,2023-01-21,JACKY,gemGrab,Hard Rock Mine,80,61,141
9097,2023-01-21,JACKY,gemGrab,Deep Diner,20,9,29
9098,2023-01-21,JACKY,brawlBall,Super Beach,1196,1347,2543
9099,2023-01-21,JACKY,brawlBall,Sneaky Fields,94,105,199
9100,2023-01-21,JACKY,bounty,Dry Season,14,7,21
9101,2023-01-20,JACKY,knockout,Out in the Open,297,509,806
9102,2023-01-20,JACKY,hotZone,Split,41,74,115
9103,2023-01-20,JACKY,heist,Tornado Ring,10,8,18
9104,2023-01-20,JACKY,gemGrab,Undermine,12,3,15
9105,2023-01-20,JACKY,gemGrab,Deep Diner,22,15,37
9106,2023-01-20,JACKY,brawlBall,Sneaky Fields,1860,2216,4076
9107,2023-01-20,JACKY,brawlBall,Pinhole Punt,22,19,41
9108,2023-01-20,JACKY,bounty,Dry Season,1,14,15
9109,2023-01-19,JACKY,knockout,Out in the Open,696,1005,1701
9110,2023-01-19,JACKY,hotZone,Split,62,46,108
9111,2023-01-19,JACKY,heist,Kaboom Canyon,10,3,13
9112,2023-01-19,JACKY,gemGrab,Undermine,46,24,70
9113,2023-01-19,JACKY,gemGrab,Gem Fort,14,13,27
9114,2023-01-19,JACKY,brawlBall,Sunny Soccer,20,23,43
9115,2023-01-19,JACKY,brawlBall,Pinhole Punt,427,454,881
9116,2023-01-19,JACKY,bounty,Shooting Star,6,0,6
9117,2023-01-18,JACKY,knockout,Goldarm Gulch,49,46,95
9118,2023-01-18,JACKY,hotZone,Parallel Plays,5,7,12
9119,2023-01-18,JACKY,heist,Kaboom Canyon,3,0,3
9120,2023-01-18,JACKY,gemGrab,Gem Fort,14,16,30
9121,2023-01-18,JACKY,gemGrab,Crystal Arcade,2,0,2
9122,2023-01-18,JACKY,brawlBall,Sunny Soccer,183,194,377
9123,2023-01-18,JACKY,brawlBall,Beach Ball,4,8,12
9124,2023-01-18,JACKY,bounty,Shooting Star,1,0,1
9125,2023-01-17,JACKY,knockout,Goldarm Gulch,35,73,108
9126,2023-01-17,JACKY,hotZone,Parallel Plays,6,3,9
9127,2023-01-17,JACKY,heist,Pit Stop,0,1,1
9128,2023-01-17,JACKY,gemGrab,Crystal Arcade,4,5,9
9129,2023-01-17,JACKY,brawlBall,Center Stage,5,9,14
9130,2023-01-17,JACKY,brawlBall,Beach Ball,41,50,91
9131,2023-01-16,JACKY,knockout,Belle's Rock,18,32,50
9132,2023-01-16,JACKY,hotZone,Quarter Pounder,2,0,2
9133,2023-01-16,JACKY,heist,Pit Stop,2,0,2
9134,2023-01-16,JACKY,gemGrab,Minecart Madness,1,1,2
9135,2023-01-16,JACKY,gemGrab,Double Swoosh,5,1,6
9136,2023-01-16,JACKY,brawlBall,Center Stage,103,95,198
9137,2023-01-16,JACKY,brawlBall,Backyard Bowl,1,1,2
9138,2023-01-16,JACKY,bounty,Hideout,3,2,5
9139,2023-01-15,JACKY,knockout,Belle's Rock,31,28,59
9140,2023-01-15,JACKY,hotZone,Quarter Pounder,12,1,13
9141,2023-01-15,JACKY,gemGrab,Hard Rock Mine,5,13,18
9142,2023-01-15,JACKY,gemGrab,Double Swoosh,16,6,22
9143,2023-01-15,JACKY,brawlBall,Super Beach,18,11,29
9144,2023-01-15,JACKY,brawlBall,Backyard Bowl,17,8,25
9145,2023-01-15,JACKY,bounty,Canal Grande,10,9,19
9146,2023-01-14,JACKY,knockout,Flaring Phoenix,20,41,61
9147,2023-01-14,JACKY,hotZone,Controller Chaos,5,2,7
9148,2023-01-14,JACKY,heist,Bridge Too Far,1,0,1
9149,2023-01-14,JACKY,gemGrab,Hard Rock Mine,5,2,7
9150,2023-01-14,JACKY,brawlBall,Super Beach,97,112,209
9151,2023-01-14,JACKY,brawlBall,Sneaky Fields,40,29,69
9152,2023-01-14,JACKY,bounty,Canal Grande,11,18,29
9153,2023-01-13,JACKY,knockout,Flaring Phoenix,13,19,32
9154,2023-01-13,JACKY,hotZone,Controller Chaos,5,0,5
9155,2023-01-13,JACKY,gemGrab,Deep Diner,2,0,2
9156,2023-01-13,JACKY,brawlBall,Sneaky Fields,171,173,344
9157,2023-01-13,JACKY,brawlBall,Pinhole Punt,1,1,2
9158,2023-01-13,JACKY,bounty,Temple Ruins,0,3,3
9159,2023-01-12,JACKY,hotZone,Open Zone,3,0,3
9160,2023-01-12,JACKY,gemGrab,Undermine,4,1,5
9161,2023-01-12,JACKY,gemGrab,Gem Fort,1,0,1
9162,2023-01-12,JACKY,brawlBall,Sunny Soccer,1,0,1
9163,2023-01-12,JACKY,brawlBall,Pinhole Punt,21,11,32
9164,2023-01-11,JACKY,gemGrab,Gem Fort,3,12,15
9165,2023-01-11,JACKY,brawlBall,Sunny Soccer,19,18,37
9166,2023-01-11,JACKY,brawlBall,Beach Ball,1,0,1
9167,2023-01-10,JACKY,knockout,New Perspective,12,13,25
9168,2023-01-10,JACKY,hotZone,Dueling Beetles,9,0,9
9169,2023-01-10,JACKY,gemGrab,Crystal Arcade,6,4,10
9170,2023-01-10,JACKY,brawlBall,Center Stage,17,5,22
9171,2023-01-10,JACKY,brawlBall,Beach Ball,54,15,69
9172,2023-01-10,JACKY,bounty,Excel,2,2,4
9173,2023-01-09,JACKY,knockout,New Perspective,27,28,55
9174,2023-01-09,JACKY,hotZone,Dueling Beetles,12,1,13
9175,2023-01-09,JACKY,heist,Snaked Assault,3,0,3
9176,2023-01-09,JACKY,gemGrab,Minecart Madness,1,0,1
9177,2023-01-09,JACKY,gemGrab,Double Swoosh,3,2,5
9178,2023-01-09,JACKY,brawlBall,Center Stage,113,108,221
9179,2023-01-09,JACKY,brawlBall,Backyard Bowl,1,0,1
9180,2023-01-09,JACKY,bounty,Layer Cake,3,1,4
9181,2023-01-08,JACKY,knockout,X Marks the Spot,41,90,131
9182,2023-01-08,JACKY,hotZone,Ring of Fire,2,0,2
9183,2023-01-08,JACKY,gemGrab,Hard Rock Mine,4,0,4
9184,2023-01-08,JACKY,gemGrab,Double Swoosh,4,0,4
9185,2023-01-08,JACKY,brawlBall,Super Beach,5,8,13
9186,2023-01-08,JACKY,brawlBall,Backyard Bowl,13,3,16
9187,2023-01-08,JACKY,bounty,Layer Cake,0,1,1
9188,2023-01-07,JACKY,knockout,X Marks the Spot,27,36,63
9189,2023-01-07,JACKY,hotZone,Ring of Fire,1,0,1
9190,2023-01-07,JACKY,heist,Tornado Ring,3,0,3
9191,2023-01-07,JACKY,gemGrab,Hard Rock Mine,0,1,1
9192,2023-01-07,JACKY,gemGrab,Deep Diner,2,0,2
9193,2023-01-07,JACKY,brawlBall,Super Beach,44,6,50
9194,2023-01-07,JACKY,brawlBall,Sneaky Fields,13,3,16
9195,2023-01-07,JACKY,bounty,Dry Season,1,2,3
9196,2023-01-06,JACKY,knockout,Out in the Open,44,62,106
9197,2023-01-06,JACKY,hotZone,Split,6,0,6
9198,2023-01-06,JACKY,heist,Tornado Ring,1,2,3
9199,2023-01-06,JACKY,gemGrab,Undermine,0,1,1
9200,2023-01-06,JACKY,gemGrab,Deep Diner,1,2,3
9201,2023-01-06,JACKY,brawlBall,Sneaky Fields,143,88,231
9202,2023-01-06,JACKY,brawlBall,Pinhole Punt,4,1,5
9203,2023-01-06,JACKY,bounty,Dry Season,4,3,7
9204,2023-01-05,JACKY,knockout,Out in the Open,68,115,183
9205,2023-01-05,JACKY,hotZone,Split,22,19,41
9206,2023-01-05,JACKY,heist,Kaboom Canyon,1,0,1
9207,2023-01-05,JACKY,gemGrab,Undermine,2,1,3
9208,2023-01-05,JACKY,gemGrab,Gem Fort,2,0,2
9209,2023-01-05,JACKY,brawlBall,Pinhole Punt,53,6,59
9210,2023-01-05,JACKY,bounty,Shooting Star,1,0,1
9211,2023-01-04,JACKY,knockout,Goldarm Gulch,7,2,9
9212,2023-01-04,JACKY,hotZone,Parallel Plays,3,0,3
9213,2023-01-04,JACKY,heist,Kaboom Canyon,0,1,1
9214,2023-01-04,JACKY,gemGrab,Gem Fort,5,6,11
9215,2023-01-04,JACKY,gemGrab,Crystal Arcade,1,0,1
9216,2023-01-04,JACKY,brawlBall,Sunny Soccer,59,38,97
9217,2023-01-04,JACKY,brawlBall,Beach Ball,0,1,1
9218,2023-01-03,JACKY,knockout,Goldarm Gulch,9,9,18
9219,2023-01-03,JACKY,hotZone,Parallel Plays,5,0,5
9220,2023-01-03,JACKY,heist,Pit Stop,1,0,1
9221,2023-01-03,JACKY,gemGrab,Crystal Arcade,8,14,22
9222,2023-01-03,JACKY,brawlBall,Beach Ball,56,14,70
9223,2023-01-03,JACKY,bounty,Hideout,1,0,1
9224,2023-01-02,JACKY,knockout,Belle's Rock,10,23,33
9225,2023-01-02,JACKY,hotZone,Quarter Pounder,11,9,20
9226,2023-01-02,JACKY,heist,Pit Stop,3,0,3
9227,2023-01-02,JACKY,gemGrab,Minecart Madness,1,1,2
9228,2023-01-02,JACKY,gemGrab,Double Swoosh,2,2,4
9229,2023-01-02,JACKY,brawlBall,Center Stage,112,77,189
9230,2023-01-02,JACKY,bounty,Hideout,2,1,3
9231,2023-01-01,JACKY,knockout,Belle's Rock,3,12,15
9232,2023-01-01,JACKY,hotZone,Quarter Pounder,1,0,1
9233,2023-01-01,JACKY,gemGrab,Minecart Madness,0,1,1
9234,2023-01-01,JACKY,gemGrab,Double Swoosh,3,4,7
9235,2023-01-01,JACKY,brawlBall,Backyard Bowl,10,4,14
9236,2023-01-01,JACKY,bounty,Canal Grande,0,1,1
9237,2022-12-31,JACKY,hotZone,Controller Chaos,1,0,1
9238,2022-12-31,JACKY,gemGrab,Hard Rock Mine,1,0,1
9239,2022-12-31,JACKY,gemGrab,Deep Diner,0,1,1
9240,2022-12-31,JACKY,brawlBall,Super Beach,10,7,17
9241,2022-12-31,JACKY,brawlBall,Sneaky Fields,0,1,1
9242,2022-12-31,JACKY,bounty,Canal Grande,1,0,1
9243,2022-12-30,JACKY,hotZone,Controller Chaos,3,0,3
9244,2022-12-30,JACKY,heist,Kaboom Canyon,1,1,2
9245,2022-12-30,JACKY,gemGrab,Minecart Madness,1,0,1
9246,2022-12-30,JACKY,brawlBall,Sneaky Fields,7,7,14
9247,2022-12-29,JACKY,brawlBall,Pinhole Punt,1,1,2
9248,2022-12-28,JACKY,brawlBall,Sunny Soccer,1,1,2
9249,2022-12-27,JACKY,brawlBall,Beach Ball,0,2,2
9250,2022-12-26,JACKY,gemGrab,Minecart Madness,1,0,1
9251,2022-12-26,JACKY,brawlBall,Center Stage,0,1,1
9252,2022-12-24,JACKY,brawlBall,Super Beach,1,1,2
9253,2022-12-23,JACKY,brawlBall,Sneaky Fields,1,0,1
9254,2022-12-22,JACKY,brawlBall,Pinhole Punt,1,0,1
9255,2022-12-21,JACKY,brawlBall,Sunny Soccer,1,0,1
9256,2022-12-19,JACKY,brawlBall,Center Stage,1,0,1
9257,2022-12-16,JACKY,gemGrab,Undermine,1,0,1
9258,2022-12-16,JACKY,brawlBall,Sneaky Fields,1,0,1
9259,2022-11-11,JACKY,brawlBall,Sneaky Fields,3,1,4
9260,2022-10-30,JACKY,bounty,Canal Grande,0,2,2
9261,2022-10-28,JACKY,hotZone,Dueling Beetles,1,0,1
9262,2023-02-05,GUS,knockout,X Marks the Spot,86,138,224
9263,2023-02-05,GUS,knockout,Goldarm Gulch,6,4,10
9264,2023-02-05,GUS,hotZone,Ring of Fire,49,67,116
9265,2023-02-05,GUS,heist,Snaked Assault,8,0,8
9266,2023-02-05,GUS,gemGrab,Hard Rock Mine,30,53,83
9267,2023-02-05,GUS,gemGrab,Double Swoosh,68,79,147
9268,2023-02-05,GUS,brawlBall,Super Beach,7,9,16
9269,2023-02-05,GUS,brawlBall,Sneaky Fields,0,1,1
9270,2023-02-05,GUS,brawlBall,Backyard Bowl,466,677,1143
9271,2023-02-05,GUS,bounty,Layer Cake,53,98,151
9272,2023-02-04,GUS,knockout,X Marks the Spot,29,27,56
9273,2023-02-04,GUS,knockout,Goldarm Gulch,14,9,23
9274,2023-02-04,GUS,hotZone,Ring of Fire,16,8,24
9275,2023-02-04,GUS,gemGrab,Hard Rock Mine,30,38,68
9276,2023-02-04,GUS,gemGrab,Double Swoosh,2,8,10
9277,2023-02-04,GUS,gemGrab,Deep Diner,17,14,31
9278,2023-02-04,GUS,brawlBall,Super Beach,53,72,125
9279,2023-02-04,GUS,brawlBall,Sneaky Fields,4,1,5
9280,2023-02-04,GUS,bounty,Dry Season,18,19,37
9281,2023-02-03,GUS,knockout,Out in the Open,210,322,532
9282,2023-02-03,GUS,knockout,Goldarm Gulch,80,81,161
9283,2023-02-03,GUS,hotZone,Split,16,6,22
9284,2023-02-03,GUS,heist,Tornado Ring,2,0,2
9285,2023-02-03,GUS,gemGrab,Undermine,28,58,86
9286,2023-02-03,GUS,gemGrab,Double Swoosh,34,34,68
9287,2023-02-03,GUS,gemGrab,Deep Diner,115,156,271
9288,2023-02-03,GUS,brawlBall,Sneaky Fields,150,255,405
9289,2023-02-03,GUS,brawlBall,Pinhole Punt,9,8,17
9290,2023-02-03,GUS,bounty,Dry Season,246,366,612
9291,2023-02-02,GUS,knockout,Out in the Open,64,87,151
9292,2023-02-02,GUS,hotZone,Split,1,2,3
9293,2023-02-02,GUS,heist,Kaboom Canyon,7,1,8
9294,2023-02-02,GUS,gemGrab,Undermine,22,35,57
9295,2023-02-02,GUS,gemGrab,Gem Fort,9,7,16
9296,2023-02-02,GUS,brawlBall,Sunny Soccer,2,0,2
9297,2023-02-02,GUS,brawlBall,Pinhole Punt,99,132,231
9298,2023-02-02,GUS,bounty,Shooting Star,41,40,81
9299,2023-02-01,GUS,knockout,Goldarm Gulch,126,174,300
9300,2023-02-01,GUS,hotZone,Parallel Plays,36,55,91
9301,2023-02-01,GUS,heist,Kaboom Canyon,17,40,57
9302,2023-02-01,GUS,gemGrab,Gem Fort,59,63,122
9303,2023-02-01,GUS,gemGrab,Crystal Arcade,54,116,170
9304,2023-02-01,GUS,brawlBall,Sunny Soccer,132,172,304
9305,2023-02-01,GUS,brawlBall,Beach Ball,7,6,13
9306,2023-02-01,GUS,bounty,Shooting Star,105,170,275
9307,2023-01-31,GUS,knockout,Goldarm Gulch,60,79,139
9308,2023-01-31,GUS,hotZone,Parallel Plays,10,14,24
9309,2023-01-31,GUS,heist,Pit Stop,2,0,2
9310,2023-01-31,GUS,gemGrab,Minecart Madness,11,19,30
9311,2023-01-31,GUS,gemGrab,Crystal Arcade,46,59,105
9312,2023-01-31,GUS,brawlBall,Center Stage,1,0,1
9313,2023-01-31,GUS,brawlBall,Beach Ball,77,135,212
9314,2023-01-31,GUS,bounty,Hideout,29,36,65
9315,2023-01-30,GUS,knockout,Belle's Rock,194,307,501
9316,2023-01-30,GUS,hotZone,Quarter Pounder,41,132,173
9317,2023-01-30,GUS,heist,Pit Stop,3,4,7
9318,2023-01-30,GUS,gemGrab,Minecart Madness,114,178,292
9319,2023-01-30,GUS,gemGrab,Double Swoosh,33,27,60
9320,2023-01-30,GUS,brawlBall,Center Stage,87,100,187
9321,2023-01-30,GUS,brawlBall,Backyard Bowl,28,52,80
9322,2023-01-30,GUS,bounty,Hideout,65,105,170
9323,2023-01-29,GUS,knockout,Belle's Rock,175,291,466
9324,2023-01-29,GUS,hotZone,Quarter Pounder,49,55,104
9325,2023-01-29,GUS,heist,Bridge Too Far,20,39,59
9326,2023-01-29,GUS,gemGrab,Hard Rock Mine,23,31,54
9327,2023-01-29,GUS,gemGrab,Double Swoosh,55,51,106
9328,2023-01-29,GUS,brawlBall,Super Beach,4,1,5
9329,2023-01-29,GUS,brawlBall,Backyard Bowl,430,610,1040
9330,2023-01-29,GUS,bounty,Canal Grande,14,14,28
9331,2023-01-28,GUS,knockout,Flaring Phoenix,40,51,91
9332,2023-01-28,GUS,hotZone,Controller Chaos,24,29,53
9333,2023-01-28,GUS,heist,Bridge Too Far,68,85,153
9334,2023-01-28,GUS,gemGrab,Hard Rock Mine,123,139,262
9335,2023-01-28,GUS,gemGrab,Deep Diner,33,42,75
9336,2023-01-28,GUS,brawlBall,Super Beach,240,250,490
9337,2023-01-28,GUS,brawlBall,Sneaky Fields,8,11,19
9338,2023-01-28,GUS,bounty,Canal Grande,22,29,51
9339,2023-01-27,GUS,knockout,Flaring Phoenix,26,23,49
9340,2023-01-27,GUS,hotZone,Controller Chaos,13,14,27
9341,2023-01-27,GUS,heist,Hot Potato,1,1,2
9342,2023-01-27,GUS,gemGrab,Undermine,8,11,19
9343,2023-01-27,GUS,gemGrab,Deep Diner,55,89,144
9344,2023-01-27,GUS,brawlBall,Sneaky Fields,59,53,112
9345,2023-01-27,GUS,brawlBall,Pinhole Punt,1,4,5
9346,2023-01-27,GUS,bounty,Temple Ruins,15,29,44
9347,2023-01-26,GUS,knockout,Riverside,232,381,613
9348,2023-01-26,GUS,hotZone,Open Zone,61,111,172
9349,2023-01-26,GUS,heist,Hot Potato,1,1,2
9350,2023-01-26,GUS,gemGrab,Undermine,50,94,144
9351,2023-01-26,GUS,gemGrab,Gem Fort,10,7,17
9352,2023-01-26,GUS,brawlBall,Sunny Soccer,6,5,11
9353,2023-01-26,GUS,brawlBall,Pinhole Punt,252,300,552
9354,2023-01-26,GUS,bounty,Temple Ruins,26,37,63
9355,2023-01-25,GUS,knockout,Riverside,88,132,220
9356,2023-01-25,GUS,hotZone,Open Zone,45,52,97
9357,2023-01-25,GUS,heist,Safe Zone,15,18,33
9358,2023-01-25,GUS,gemGrab,Gem Fort,15,38,53
9359,2023-01-25,GUS,gemGrab,Crystal Arcade,51,94,145
9360,2023-01-25,GUS,brawlBall,Sunny Soccer,96,119,215
9361,2023-01-25,GUS,brawlBall,Beach Ball,14,5,19
9362,2023-01-25,GUS,bounty,Excel,25,57,82
9363,2023-01-24,GUS,knockout,New Perspective,62,88,150
9364,2023-01-24,GUS,hotZone,Dueling Beetles,42,63,105
9365,2023-01-24,GUS,heist,Safe Zone,26,30,56
9366,2023-01-24,GUS,gemGrab,Minecart Madness,25,34,59
9367,2023-01-24,GUS,gemGrab,Crystal Arcade,118,132,250
9368,2023-01-24,GUS,brawlBall,Center Stage,12,10,22
9369,2023-01-24,GUS,brawlBall,Beach Ball,180,174,354
9370,2023-01-24,GUS,bounty,Excel,71,116,187
9371,2023-01-23,GUS,knockout,New Perspective,119,152,271
9372,2023-01-23,GUS,hotZone,Dueling Beetles,74,85,159
9373,2023-01-23,GUS,heist,Snaked Assault,5,5,10
9374,2023-01-23,GUS,gemGrab,Minecart Madness,130,188,318
9375,2023-01-23,GUS,gemGrab,Double Swoosh,31,42,73
9376,2023-01-23,GUS,brawlBall,Center Stage,168,186,354
9377,2023-01-23,GUS,brawlBall,Backyard Bowl,36,57,93
9378,2023-01-23,GUS,bounty,Layer Cake,48,66,114
9379,2023-01-22,GUS,knockout,X Marks the Spot,67,76,143
9380,2023-01-22,GUS,hotZone,Ring of Fire,26,30,56
9381,2023-01-22,GUS,heist,Snaked Assault,1,1,2
9382,2023-01-22,GUS,gemGrab,Hard Rock Mine,35,67,102
9383,2023-01-22,GUS,gemGrab,Double Swoosh,29,45,74
9384,2023-01-22,GUS,brawlBall,Super Beach,24,16,40
9385,2023-01-22,GUS,brawlBall,Backyard Bowl,256,370,626
9386,2023-01-22,GUS,bounty,Layer Cake,29,27,56
9387,2023-01-21,GUS,knockout,X Marks the Spot,278,336,614
9388,2023-01-21,GUS,hotZone,Ring of Fire,102,118,220
9389,2023-01-21,GUS,heist,Tornado Ring,11,3,14
9390,2023-01-21,GUS,gemGrab,Hard Rock Mine,116,138,254
9391,2023-01-21,GUS,gemGrab,Deep Diner,39,55,94
9392,2023-01-21,GUS,brawlBall,Super Beach,307,394,701
9393,2023-01-21,GUS,brawlBall,Sneaky Fields,8,3,11
9394,2023-01-21,GUS,bounty,Dry Season,181,261,442
9395,2023-01-20,GUS,knockout,Out in the Open,265,313,578
9396,2023-01-20,GUS,hotZone,Split,6,5,11
9397,2023-01-20,GUS,heist,Tornado Ring,1,1,2
9398,2023-01-20,GUS,gemGrab,Undermine,14,25,39
9399,2023-01-20,GUS,gemGrab,Deep Diner,127,210,337
9400,2023-01-20,GUS,brawlBall,Sneaky Fields,163,150,313
9401,2023-01-20,GUS,brawlBall,Pinhole Punt,7,13,20
9402,2023-01-20,GUS,bounty,Dry Season,129,194,323
9403,2023-01-19,GUS,knockout,Out in the Open,204,266,470
9404,2023-01-19,GUS,hotZone,Split,13,7,20
9405,2023-01-19,GUS,heist,Kaboom Canyon,11,18,29
9406,2023-01-19,GUS,gemGrab,Undermine,63,100,163
9407,2023-01-19,GUS,gemGrab,Gem Fort,9,10,19
9408,2023-01-19,GUS,brawlBall,Sunny Soccer,4,0,4
9409,2023-01-19,GUS,brawlBall,Pinhole Punt,300,401,701
9410,2023-01-19,GUS,bounty,Shooting Star,101,189,290
9411,2023-01-18,GUS,knockout,Goldarm Gulch,17,15,32
9412,2023-01-18,GUS,hotZone,Parallel Plays,2,3,5
9413,2023-01-18,GUS,heist,Kaboom Canyon,6,2,8
9414,2023-01-18,GUS,gemGrab,Gem Fort,13,13,26
9415,2023-01-18,GUS,gemGrab,Crystal Arcade,7,11,18
9416,2023-01-18,GUS,brawlBall,Sunny Soccer,40,43,83
9417,2023-01-18,GUS,brawlBall,Beach Ball,4,6,10
9418,2023-01-18,GUS,bounty,Shooting Star,63,72,135
9419,2023-01-17,GUS,knockout,Goldarm Gulch,21,18,39
9420,2023-01-17,GUS,hotZone,Parallel Plays,8,4,12
9421,2023-01-17,GUS,gemGrab,Minecart Madness,6,4,10
9422,2023-01-17,GUS,gemGrab,Crystal Arcade,6,4,10
9423,2023-01-17,GUS,brawlBall,Beach Ball,23,27,50
9424,2023-01-17,GUS,bounty,Hideout,8,8,16
9425,2023-01-16,GUS,knockout,Belle's Rock,35,32,67
9426,2023-01-16,GUS,hotZone,Quarter Pounder,3,3,6
9427,2023-01-16,GUS,gemGrab,Minecart Madness,8,13,21
9428,2023-01-16,GUS,gemGrab,Double Swoosh,2,4,6
9429,2023-01-16,GUS,brawlBall,Center Stage,10,14,24
9430,2023-01-16,GUS,brawlBall,Backyard Bowl,2,5,7
9431,2023-01-16,GUS,bounty,Hideout,17,47,64
9432,2023-01-15,GUS,knockout,Belle's Rock,32,47,79
9433,2023-01-15,GUS,hotZone,Quarter Pounder,10,18,28
9434,2023-01-15,GUS,heist,Bridge Too Far,3,2,5
9435,2023-01-15,GUS,gemGrab,Hard Rock Mine,2,1,3
9436,2023-01-15,GUS,gemGrab,Double Swoosh,5,23,28
9437,2023-01-15,GUS,brawlBall,Super Beach,1,0,1
9438,2023-01-15,GUS,brawlBall,Backyard Bowl,48,89,137
9439,2023-01-15,GUS,bounty,Canal Grande,1,1,2
9440,2023-01-14,GUS,knockout,Flaring Phoenix,15,8,23
9441,2023-01-14,GUS,hotZone,Controller Chaos,7,48,55
9442,2023-01-14,GUS,heist,Bridge Too Far,8,0,8
9443,2023-01-14,GUS,gemGrab,Hard Rock Mine,9,21,30
9444,2023-01-14,GUS,gemGrab,Deep Diner,3,3,6
9445,2023-01-14,GUS,brawlBall,Super Beach,11,11,22
9446,2023-01-14,GUS,brawlBall,Sneaky Fields,2,13,15
9447,2023-01-14,GUS,bounty,Canal Grande,0,2,2
9448,2023-01-13,GUS,knockout,Flaring Phoenix,5,27,32
9449,2023-01-13,GUS,hotZone,Controller Chaos,4,0,4
9450,2023-01-13,GUS,gemGrab,Undermine,1,0,1
9451,2023-01-13,GUS,gemGrab,Deep Diner,6,4,10
9452,2023-01-13,GUS,brawlBall,Sneaky Fields,18,29,47
9453,2023-01-13,GUS,bounty,Temple Ruins,3,1,4
9454,2023-01-12,GUS,knockout,Riverside,25,46,71
9455,2023-01-12,GUS,hotZone,Open Zone,9,27,36
9456,2023-01-12,GUS,gemGrab,Undermine,5,4,9
9457,2023-01-12,GUS,brawlBall,Sunny Soccer,0,1,1
9458,2023-01-12,GUS,brawlBall,Pinhole Punt,9,7,16
9459,2023-01-11,GUS,knockout,Riverside,4,5,9
9460,2023-01-11,GUS,hotZone,Open Zone,5,0,5
9461,2023-01-11,GUS,heist,Safe Zone,5,0,5
9462,2023-01-11,GUS,gemGrab,Gem Fort,1,0,1
9463,2023-01-11,GUS,brawlBall,Sunny Soccer,6,2,8
9464,2023-01-11,GUS,bounty,Excel,1,0,1
9465,2023-01-10,GUS,knockout,New Perspective,1,5,6
9466,2023-01-10,GUS,hotZone,Dueling Beetles,4,11,15
9467,2023-01-10,GUS,heist,Safe Zone,3,0,3
9468,2023-01-10,GUS,gemGrab,Minecart Madness,7,7,14
9469,2023-01-10,GUS,gemGrab,Crystal Arcade,2,7,9
9470,2023-01-10,GUS,brawlBall,Center Stage,3,3,6
9471,2023-01-10,GUS,brawlBall,Beach Ball,11,8,19
9472,2023-01-10,GUS,bounty,Excel,3,15,18
9473,2023-01-09,GUS,knockout,New Perspective,1,12,13
9474,2023-01-09,GUS,hotZone,Dueling Beetles,5,9,14
9475,2023-01-09,GUS,gemGrab,Minecart Madness,17,40,57
9476,2023-01-09,GUS,gemGrab,Double Swoosh,0,2,2
9477,2023-01-09,GUS,brawlBall,Center Stage,4,6,10
9478,2023-01-09,GUS,bounty,Layer Cake,8,50,58
9479,2023-01-08,GUS,knockout,X Marks the Spot,10,30,40
9480,2023-01-08,GUS,hotZone,Ring of Fire,4,9,13
9481,2023-01-08,GUS,heist,Snaked Assault,0,1,1
9482,2023-01-08,GUS,gemGrab,Hard Rock Mine,5,8,13
9483,2023-01-08,GUS,brawlBall,Backyard Bowl,30,61,91
9484,2023-01-08,GUS,bounty,Layer Cake,4,0,4
9485,2023-01-07,GUS,knockout,X Marks the Spot,7,5,12
9486,2023-01-07,GUS,hotZone,Ring of Fire,0,1,1
9487,2023-01-07,GUS,heist,Tornado Ring,0,1,1
9488,2023-01-07,GUS,gemGrab,Hard Rock Mine,4,10,14
9489,2023-01-07,GUS,gemGrab,Deep Diner,4,12,16
9490,2023-01-07,GUS,brawlBall,Super Beach,13,5,18
9491,2023-01-07,GUS,bounty,Dry Season,14,16,30
9492,2023-01-06,GUS,knockout,Out in the Open,20,32,52
9493,2023-01-06,GUS,gemGrab,Undermine,0,10,10
9494,2023-01-06,GUS,gemGrab,Deep Diner,11,47,58
9495,2023-01-06,GUS,brawlBall,Sneaky Fields,3,3,6
9496,2023-01-06,GUS,brawlBall,Pinhole Punt,2,4,6
9497,2023-01-06,GUS,bounty,Dry Season,32,38,70
9498,2023-01-05,GUS,knockout,Out in the Open,31,40,71
9499,2023-01-05,GUS,gemGrab,Undermine,8,15,23
9500,2023-01-05,GUS,brawlBall,Pinhole Punt,21,26,47
9501,2023-01-05,GUS,bounty,Shooting Star,24,50,74
9502,2023-01-04,GUS,knockout,Goldarm Gulch,5,2,7
9503,2023-01-04,GUS,hotZone,Parallel Plays,3,2,5
9504,2023-01-04,GUS,heist,Kaboom Canyon,0,5,5
9505,2023-01-04,GUS,gemGrab,Gem Fort,3,6,9
9506,2023-01-04,GUS,gemGrab,Crystal Arcade,5,22,27
9507,2023-01-04,GUS,brawlBall,Sunny Soccer,8,6,14
9508,2023-01-04,GUS,brawlBall,Beach Ball,0,1,1
9509,2023-01-04,GUS,bounty,Shooting Star,41,91,132
9510,2023-01-03,GUS,knockout,Goldarm Gulch,8,9,17
9511,2023-01-03,GUS,hotZone,Parallel Plays,1,3,4
9512,2023-01-03,GUS,gemGrab,Minecart Madness,0,7,7
9513,2023-01-03,GUS,gemGrab,Crystal Arcade,21,76,97
9514,2023-01-03,GUS,brawlBall,Center Stage,0,4,4
9515,2023-01-03,GUS,brawlBall,Beach Ball,11,6,17
9516,2023-01-03,GUS,bounty,Hideout,13,21,34
9517,2023-01-02,GUS,knockout,Belle's Rock,17,45,62
9518,2023-01-02,GUS,hotZone,Quarter Pounder,18,13,31
9519,2023-01-02,GUS,heist,Kaboom Canyon,1,0,1
9520,2023-01-02,GUS,gemGrab,Minecart Madness,8,76,84
9521,2023-01-02,GUS,gemGrab,Double Swoosh,5,5,10
9522,2023-01-02,GUS,brawlBall,Center Stage,9,5,14
9523,2023-01-02,GUS,brawlBall,Backyard Bowl,0,1,1
9524,2023-01-02,GUS,bounty,Hideout,40,91,131
9525,2023-01-01,GUS,knockout,Belle's Rock,18,33,51
9526,2023-01-01,GUS,hotZone,Quarter Pounder,4,5,9
9527,2023-01-01,GUS,heist,Bridge Too Far,1,0,1
9528,2023-01-01,GUS,gemGrab,Hard Rock Mine,1,0,1
9529,2023-01-01,GUS,gemGrab,Double Swoosh,4,7,11
9530,2023-01-01,GUS,brawlBall,Backyard Bowl,20,57,77
9531,2022-12-31,GUS,heist,Bridge Too Far,4,3,7
9532,2022-12-31,GUS,gemGrab,Hard Rock Mine,0,4,4
9533,2022-12-31,GUS,gemGrab,Deep Diner,3,19,22
9534,2022-12-31,GUS,brawlBall,Super Beach,8,2,10
9535,2022-12-31,GUS,bounty,Canal Grande,2,0,2
9536,2022-12-30,GUS,gemGrab,Deep Diner,2,0,2
9537,2022-12-29,GUS,gemGrab,Gem Fort,0,1,1
9538,2022-12-29,GUS,brawlBall,Pinhole Punt,2,3,5
9539,2022-12-28,GUS,brawlBall,Sunny Soccer,0,1,1
9540,2022-12-27,GUS,knockout,New Perspective,0,1,1
9541,2022-12-27,GUS,hotZone,Dueling Beetles,4,3,7
9542,2022-12-27,GUS,brawlBall,Beach Ball,2,0,2
9543,2022-12-26,GUS,hotZone,Controller Chaos,0,1,1
9544,2022-12-23,GUS,gemGrab,Deep Diner,0,1,1
9545,2022-12-22,GUS,brawlBall,Pinhole Punt,2,2,4
9546,2022-12-21,GUS,brawlBall,Sunny Soccer,0,2,2
9547,2022-12-17,GUS,knockout,Flaring Phoenix,1,0,1
9548,2022-12-16,GUS,brawlBall,Sneaky Fields,1,0,1
9549,2022-12-13,GUS,gemGrab,Crystal Arcade,1,0,1
9550,2022-12-11,GUS,brawlBall,Backyard Bowl,0,1,1
9551,2022-12-10,GUS,knockout,X Marks the Spot,1,0,1
9552,2022-11-07,GUS,hotZone,Quarter Pounder,0,1,1
9553,2022-11-03,GUS,brawlBall,Pinhole Punt,0,1,1
9554,2022-10-15,GUS,gemGrab,Hard Rock Mine,1,0,1
9555,2022-10-15,GUS,bounty,Dry Season,0,1,1
9556,2022-10-10,GUS,knockout,Belle's Rock,1,1,2
9557,2023-02-05,GROM,knockout,X Marks the Spot,380,352,732
9558,2023-02-05,GROM,knockout,Goldarm Gulch,157,191,348
9559,2023-02-05,GROM,hotZone,Ring of Fire,55,31,86
9560,2023-02-05,GROM,heist,Snaked Assault,38,20,58
9561,2023-02-05,GROM,heist,Pit Stop,36,16,52
9562,2023-02-05,GROM,gemGrab,Hard Rock Mine,15,12,27
9563,2023-02-05,GROM,gemGrab,Double Swoosh,98,75,173
9564,2023-02-05,GROM,brawlBall,Super Beach,6,4,10
9565,2023-02-05,GROM,brawlBall,Sneaky Fields,22,18,40
9566,2023-02-05,GROM,brawlBall,Backyard Bowl,122,98,220
9567,2023-02-05,GROM,bounty,Layer Cake,391,316,707
9568,2023-02-04,GROM,knockout,X Marks the Spot,128,110,238
9569,2023-02-04,GROM,knockout,Goldarm Gulch,132,108,240
9570,2023-02-04,GROM,hotZone,Ring of Fire,10,6,16
9571,2023-02-04,GROM,heist,Tornado Ring,5,1,6
9572,2023-02-04,GROM,heist,Pit Stop,25,16,41
9573,2023-02-04,GROM,gemGrab,Hard Rock Mine,13,36,49
9574,2023-02-04,GROM,gemGrab,Double Swoosh,23,4,27
9575,2023-02-04,GROM,gemGrab,Deep Diner,8,15,23
9576,2023-02-04,GROM,brawlBall,Super Beach,50,60,110
9577,2023-02-04,GROM,brawlBall,Sneaky Fields,22,10,32
9578,2023-02-04,GROM,bounty,Dry Season,54,94,148
9579,2023-02-03,GROM,knockout,Out in the Open,379,318,697
9580,2023-02-03,GROM,knockout,Goldarm Gulch,932,896,1828
9581,2023-02-03,GROM,hotZone,Split,152,119,271
9582,2023-02-03,GROM,heist,Tornado Ring,37,21,58
9583,2023-02-03,GROM,heist,Pit Stop,193,97,290
9584,2023-02-03,GROM,gemGrab,Undermine,12,11,23
9585,2023-02-03,GROM,gemGrab,Double Swoosh,204,115,319
9586,2023-02-03,GROM,gemGrab,Deep Diner,121,103,224
9587,2023-02-03,GROM,brawlBall,Sneaky Fields,335,311,646
9588,2023-02-03,GROM,brawlBall,Pinhole Punt,8,7,15
9589,2023-02-03,GROM,bounty,Dry Season,586,686,1272
9590,2023-02-02,GROM,knockout,Out in the Open,177,188,365
9591,2023-02-02,GROM,hotZone,Split,78,48,126
9592,2023-02-02,GROM,heist,Kaboom Canyon,18,14,32
9593,2023-02-02,GROM,gemGrab,Undermine,12,7,19
9594,2023-02-02,GROM,gemGrab,Gem Fort,3,3,6
9595,2023-02-02,GROM,brawlBall,Sunny Soccer,5,3,8
9596,2023-02-02,GROM,brawlBall,Pinhole Punt,57,45,102
9597,2023-02-02,GROM,bounty,Shooting Star,107,131,238
9598,2023-02-01,GROM,knockout,Goldarm Gulch,725,749,1474
9599,2023-02-01,GROM,hotZone,Parallel Plays,63,31,94
9600,2023-02-01,GROM,heist,Kaboom Canyon,78,71,149
9601,2023-02-01,GROM,gemGrab,Gem Fort,34,26,60
9602,2023-02-01,GROM,gemGrab,Crystal Arcade,29,14,43
9603,2023-02-01,GROM,brawlBall,Sunny Soccer,285,244,529
9604,2023-02-01,GROM,brawlBall,Beach Ball,8,9,17
9605,2023-02-01,GROM,bounty,Shooting Star,225,219,444
9606,2023-01-31,GROM,knockout,Goldarm Gulch,340,338,678
9607,2023-01-31,GROM,hotZone,Parallel Plays,37,18,55
9608,2023-01-31,GROM,heist,Pit Stop,18,25,43
9609,2023-01-31,GROM,gemGrab,Minecart Madness,14,9,23
9610,2023-01-31,GROM,gemGrab,Crystal Arcade,25,24,49
9611,2023-01-31,GROM,brawlBall,Center Stage,9,14,23
9612,2023-01-31,GROM,brawlBall,Beach Ball,160,148,308
9613,2023-01-31,GROM,bounty,Hideout,122,157,279
9614,2023-01-30,GROM,knockout,Belle's Rock,1392,1396,2788
9615,2023-01-30,GROM,hotZone,Quarter Pounder,101,75,176
9616,2023-01-30,GROM,heist,Pit Stop,58,64,122
9617,2023-01-30,GROM,gemGrab,Minecart Madness,126,132,258
9618,2023-01-30,GROM,gemGrab,Double Swoosh,22,25,47
9619,2023-01-30,GROM,brawlBall,Center Stage,993,1170,2163
9620,2023-01-30,GROM,brawlBall,Backyard Bowl,20,18,38
9621,2023-01-30,GROM,bounty,Hideout,284,334,618
9622,2023-01-29,GROM,knockout,Belle's Rock,1703,1672,3375
9623,2023-01-29,GROM,hotZone,Quarter Pounder,83,72,155
9624,2023-01-29,GROM,heist,Bridge Too Far,334,524,858
9625,2023-01-29,GROM,gemGrab,Hard Rock Mine,8,5,13
9626,2023-01-29,GROM,gemGrab,Double Swoosh,58,50,108
9627,2023-01-29,GROM,brawlBall,Super Beach,9,17,26
9628,2023-01-29,GROM,brawlBall,Backyard Bowl,126,128,254
9629,2023-01-29,GROM,bounty,Canal Grande,256,291,547
9630,2023-01-28,GROM,knockout,Flaring Phoenix,403,434,837
9631,2023-01-28,GROM,hotZone,Controller Chaos,50,40,90
9632,2023-01-28,GROM,heist,Bridge Too Far,612,874,1486
9633,2023-01-28,GROM,gemGrab,Hard Rock Mine,56,51,107
9634,2023-01-28,GROM,gemGrab,Deep Diner,44,55,99
9635,2023-01-28,GROM,brawlBall,Super Beach,211,187,398
9636,2023-01-28,GROM,brawlBall,Sneaky Fields,10,6,16
9637,2023-01-28,GROM,bounty,Canal Grande,554,647,1201
9638,2023-01-27,GROM,knockout,Flaring Phoenix,185,159,344
9639,2023-01-27,GROM,hotZone,Controller Chaos,25,15,40
9640,2023-01-27,GROM,heist,Hot Potato,30,32,62
9641,2023-01-27,GROM,gemGrab,Undermine,1,1,2
9642,2023-01-27,GROM,gemGrab,Deep Diner,64,66,130
9643,2023-01-27,GROM,brawlBall,Sneaky Fields,78,87,165
9644,2023-01-27,GROM,brawlBall,Pinhole Punt,16,11,27
9645,2023-01-27,GROM,bounty,Temple Ruins,35,18,53
9646,2023-01-26,GROM,knockout,Riverside,370,256,626
9647,2023-01-26,GROM,hotZone,Open Zone,46,14,60
9648,2023-01-26,GROM,heist,Hot Potato,54,48,102
9649,2023-01-26,GROM,gemGrab,Undermine,43,21,64
9650,2023-01-26,GROM,gemGrab,Gem Fort,8,13,21
9651,2023-01-26,GROM,brawlBall,Sunny Soccer,23,15,38
9652,2023-01-26,GROM,brawlBall,Pinhole Punt,192,164,356
9653,2023-01-26,GROM,bounty,Temple Ruins,114,133,247
9654,2023-01-25,GROM,knockout,Riverside,155,116,271
9655,2023-01-25,GROM,hotZone,Open Zone,18,11,29
9656,2023-01-25,GROM,heist,Safe Zone,231,233,464
9657,2023-01-25,GROM,gemGrab,Gem Fort,24,11,35
9658,2023-01-25,GROM,gemGrab,Crystal Arcade,31,30,61
9659,2023-01-25,GROM,brawlBall,Sunny Soccer,234,224,458
9660,2023-01-25,GROM,brawlBall,Beach Ball,29,58,87
9661,2023-01-25,GROM,bounty,Excel,310,330,640
9662,2023-01-24,GROM,knockout,New Perspective,292,315,607
9663,2023-01-24,GROM,hotZone,Dueling Beetles,116,71,187
9664,2023-01-24,GROM,heist,Safe Zone,306,367,673
9665,2023-01-24,GROM,gemGrab,Minecart Madness,33,32,65
9666,2023-01-24,GROM,gemGrab,Crystal Arcade,58,33,91
9667,2023-01-24,GROM,brawlBall,Center Stage,157,204,361
9668,2023-01-24,GROM,brawlBall,Beach Ball,418,432,850
9669,2023-01-24,GROM,bounty,Excel,580,522,1102
9670,2023-01-23,GROM,knockout,New Perspective,538,507,1045
9671,2023-01-23,GROM,hotZone,Dueling Beetles,191,125,316
9672,2023-01-23,GROM,heist,Snaked Assault,44,13,57
9673,2023-01-23,GROM,gemGrab,Minecart Madness,194,128,322
9674,2023-01-23,GROM,gemGrab,Double Swoosh,27,13,40
9675,2023-01-23,GROM,brawlBall,Center Stage,2078,2563,4641
9676,2023-01-23,GROM,brawlBall,Backyard Bowl,9,3,12
9677,2023-01-23,GROM,bounty,Layer Cake,420,509,929
9678,2023-01-22,GROM,knockout,X Marks the Spot,335,401,736
9679,2023-01-22,GROM,hotZone,Ring of Fire,28,20,48
9680,2023-01-22,GROM,heist,Snaked Assault,15,12,27
9681,2023-01-22,GROM,gemGrab,Hard Rock Mine,14,9,23
9682,2023-01-22,GROM,gemGrab,Double Swoosh,29,45,74
9683,2023-01-22,GROM,brawlBall,Super Beach,22,14,36
9684,2023-01-22,GROM,brawlBall,Backyard Bowl,89,63,152
9685,2023-01-22,GROM,bounty,Layer Cake,327,313,640
9686,2023-01-21,GROM,knockout,X Marks the Spot,1123,1055,2178
9687,2023-01-21,GROM,hotZone,Ring of Fire,98,59,157
9688,2023-01-21,GROM,heist,Tornado Ring,34,17,51
9689,2023-01-21,GROM,gemGrab,Hard Rock Mine,60,60,120
9690,2023-01-21,GROM,gemGrab,Deep Diner,41,35,76
9691,2023-01-21,GROM,brawlBall,Super Beach,312,242,554
9692,2023-01-21,GROM,brawlBall,Sneaky Fields,12,13,25
9693,2023-01-21,GROM,bounty,Dry Season,484,497,981
9694,2023-01-20,GROM,knockout,Out in the Open,457,421,878
9695,2023-01-20,GROM,hotZone,Split,173,92,265
9696,2023-01-20,GROM,heist,Tornado Ring,38,18,56
9697,2023-01-20,GROM,gemGrab,Undermine,18,16,34
9698,2023-01-20,GROM,gemGrab,Deep Diner,187,183,370
9699,2023-01-20,GROM,brawlBall,Sneaky Fields,224,236,460
9700,2023-01-20,GROM,brawlBall,Pinhole Punt,7,9,16
9701,2023-01-20,GROM,bounty,Dry Season,329,339,668
9702,2023-01-19,GROM,knockout,Out in the Open,613,554,1167
9703,2023-01-19,GROM,hotZone,Split,248,194,442
9704,2023-01-19,GROM,heist,Kaboom Canyon,63,62,125
9705,2023-01-19,GROM,gemGrab,Undermine,51,35,86
9706,2023-01-19,GROM,gemGrab,Gem Fort,3,1,4
9707,2023-01-19,GROM,brawlBall,Sunny Soccer,14,7,21
9708,2023-01-19,GROM,brawlBall,Pinhole Punt,200,160,360
9709,2023-01-19,GROM,bounty,Shooting Star,317,397,714
9710,2023-01-18,GROM,knockout,Goldarm Gulch,104,105,209
9711,2023-01-18,GROM,hotZone,Parallel Plays,4,1,5
9712,2023-01-18,GROM,heist,Kaboom Canyon,27,15,42
9713,2023-01-18,GROM,gemGrab,Gem Fort,12,4,16
9714,2023-01-18,GROM,gemGrab,Crystal Arcade,3,0,3
9715,2023-01-18,GROM,brawlBall,Sunny Soccer,98,87,185
9716,2023-01-18,GROM,brawlBall,Beach Ball,3,7,10
9717,2023-01-18,GROM,bounty,Shooting Star,127,144,271
9718,2023-01-17,GROM,knockout,Goldarm Gulch,92,111,203
9719,2023-01-17,GROM,hotZone,Parallel Plays,5,6,11
9720,2023-01-17,GROM,heist,Pit Stop,7,5,12
9721,2023-01-17,GROM,gemGrab,Minecart Madness,1,1,2
9722,2023-01-17,GROM,gemGrab,Crystal Arcade,3,2,5
9723,2023-01-17,GROM,brawlBall,Center Stage,1,2,3
9724,2023-01-17,GROM,brawlBall,Beach Ball,34,28,62
9725,2023-01-17,GROM,bounty,Hideout,41,37,78
9726,2023-01-16,GROM,knockout,Belle's Rock,104,119,223
9727,2023-01-16,GROM,hotZone,Quarter Pounder,13,14,27
9728,2023-01-16,GROM,heist,Pit Stop,17,19,36
9729,2023-01-16,GROM,gemGrab,Minecart Madness,12,12,24
9730,2023-01-16,GROM,gemGrab,Double Swoosh,4,3,7
9731,2023-01-16,GROM,brawlBall,Center Stage,177,204,381
9732,2023-01-16,GROM,brawlBall,Backyard Bowl,1,1,2
9733,2023-01-16,GROM,bounty,Hideout,74,54,128
9734,2023-01-15,GROM,knockout,Belle's Rock,210,212,422
9735,2023-01-15,GROM,hotZone,Quarter Pounder,30,33,63
9736,2023-01-15,GROM,heist,Bridge Too Far,46,43,89
9737,2023-01-15,GROM,gemGrab,Hard Rock Mine,1,1,2
9738,2023-01-15,GROM,gemGrab,Double Swoosh,7,2,9
9739,2023-01-15,GROM,brawlBall,Super Beach,6,0,6
9740,2023-01-15,GROM,brawlBall,Backyard Bowl,21,16,37
9741,2023-01-15,GROM,bounty,Canal Grande,54,61,115
9742,2023-01-14,GROM,knockout,Flaring Phoenix,60,34,94
9743,2023-01-14,GROM,hotZone,Controller Chaos,26,9,35
9744,2023-01-14,GROM,heist,Bridge Too Far,76,70,146
9745,2023-01-14,GROM,gemGrab,Hard Rock Mine,2,7,9
9746,2023-01-14,GROM,gemGrab,Deep Diner,10,8,18
9747,2023-01-14,GROM,brawlBall,Super Beach,24,12,36
9748,2023-01-14,GROM,bounty,Canal Grande,57,71,128
9749,2023-01-13,GROM,knockout,Flaring Phoenix,43,38,81
9750,2023-01-13,GROM,hotZone,Controller Chaos,19,10,29
9751,2023-01-13,GROM,heist,Hot Potato,4,3,7
9752,2023-01-13,GROM,gemGrab,Deep Diner,11,5,16
9753,2023-01-13,GROM,brawlBall,Sneaky Fields,22,14,36
9754,2023-01-13,GROM,brawlBall,Pinhole Punt,1,0,1
9755,2023-01-13,GROM,bounty,Temple Ruins,2,2,4
9756,2023-01-12,GROM,knockout,Riverside,63,30,93
9757,2023-01-12,GROM,hotZone,Open Zone,5,1,6
9758,2023-01-12,GROM,heist,Hot Potato,0,2,2
9759,2023-01-12,GROM,gemGrab,Undermine,3,2,5
9760,2023-01-12,GROM,brawlBall,Sunny Soccer,2,0,2
9761,2023-01-12,GROM,brawlBall,Pinhole Punt,4,3,7
9762,2023-01-12,GROM,bounty,Temple Ruins,0,4,4
9763,2023-01-11,GROM,knockout,Riverside,11,2,13
9764,2023-01-11,GROM,hotZone,Open Zone,2,0,2
9765,2023-01-11,GROM,heist,Safe Zone,1,1,2
9766,2023-01-11,GROM,gemGrab,Gem Fort,0,4,4
9767,2023-01-11,GROM,brawlBall,Sunny Soccer,18,18,36
9768,2023-01-11,GROM,bounty,Excel,13,14,27
9769,2023-01-10,GROM,knockout,New Perspective,35,52,87
9770,2023-01-10,GROM,hotZone,Dueling Beetles,25,31,56
9771,2023-01-10,GROM,heist,Safe Zone,24,9,33
9772,2023-01-10,GROM,gemGrab,Minecart Madness,9,19,28
9773,2023-01-10,GROM,gemGrab,Crystal Arcade,7,6,13
9774,2023-01-10,GROM,brawlBall,Center Stage,18,49,67
9775,2023-01-10,GROM,brawlBall,Beach Ball,31,35,66
9776,2023-01-10,GROM,bounty,Excel,18,12,30
9777,2023-01-09,GROM,knockout,New Perspective,28,28,56
9778,2023-01-09,GROM,hotZone,Dueling Beetles,33,15,48
9779,2023-01-09,GROM,heist,Snaked Assault,8,3,11
9780,2023-01-09,GROM,gemGrab,Minecart Madness,25,6,31
9781,2023-01-09,GROM,gemGrab,Double Swoosh,6,0,6
9782,2023-01-09,GROM,brawlBall,Center Stage,207,283,490
9783,2023-01-09,GROM,brawlBall,Backyard Bowl,1,2,3
9784,2023-01-09,GROM,bounty,Layer Cake,70,49,119
9785,2023-01-08,GROM,knockout,X Marks the Spot,81,75,156
9786,2023-01-08,GROM,hotZone,Ring of Fire,6,4,10
9787,2023-01-08,GROM,heist,Snaked Assault,7,10,17
9788,2023-01-08,GROM,gemGrab,Hard Rock Mine,1,0,1
9789,2023-01-08,GROM,gemGrab,Double Swoosh,5,5,10
9790,2023-01-08,GROM,brawlBall,Backyard Bowl,10,8,18
9791,2023-01-08,GROM,bounty,Layer Cake,24,27,51
9792,2023-01-07,GROM,knockout,X Marks the Spot,41,42,83
9793,2023-01-07,GROM,hotZone,Ring of Fire,8,9,17
9794,2023-01-07,GROM,heist,Tornado Ring,1,3,4
9795,2023-01-07,GROM,gemGrab,Hard Rock Mine,3,2,5
9796,2023-01-07,GROM,gemGrab,Deep Diner,8,13,21
9797,2023-01-07,GROM,brawlBall,Super Beach,14,11,25
9798,2023-01-07,GROM,brawlBall,Sneaky Fields,1,1,2
9799,2023-01-07,GROM,bounty,Dry Season,60,94,154
9800,2023-01-06,GROM,knockout,Out in the Open,52,40,92
9801,2023-01-06,GROM,hotZone,Split,25,24,49
9802,2023-01-06,GROM,heist,Tornado Ring,5,1,6
9803,2023-01-06,GROM,gemGrab,Undermine,0,1,1
9804,2023-01-06,GROM,gemGrab,Deep Diner,30,72,102
9805,2023-01-06,GROM,brawlBall,Sneaky Fields,13,20,33
9806,2023-01-06,GROM,bounty,Dry Season,95,118,213
9807,2023-01-05,GROM,knockout,Out in the Open,101,92,193
9808,2023-01-05,GROM,hotZone,Split,52,92,144
9809,2023-01-05,GROM,heist,Kaboom Canyon,7,5,12
9810,2023-01-05,GROM,gemGrab,Undermine,2,4,6
9811,2023-01-05,GROM,gemGrab,Gem Fort,0,2,2
9812,2023-01-05,GROM,brawlBall,Sunny Soccer,0,1,1
9813,2023-01-05,GROM,brawlBall,Pinhole Punt,25,20,45
9814,2023-01-05,GROM,bounty,Shooting Star,56,58,114
9815,2023-01-04,GROM,knockout,Goldarm Gulch,35,38,73
9816,2023-01-04,GROM,hotZone,Parallel Plays,4,1,5
9817,2023-01-04,GROM,heist,Kaboom Canyon,19,26,45
9818,2023-01-04,GROM,gemGrab,Gem Fort,1,0,1
9819,2023-01-04,GROM,gemGrab,Crystal Arcade,1,1,2
9820,2023-01-04,GROM,brawlBall,Sunny Soccer,46,59,105
9821,2023-01-04,GROM,bounty,Shooting Star,144,162,306
9822,2023-01-03,GROM,knockout,Goldarm Gulch,49,55,104
9823,2023-01-03,GROM,hotZone,Parallel Plays,10,9,19
9824,2023-01-03,GROM,heist,Pit Stop,10,2,12
9825,2023-01-03,GROM,gemGrab,Minecart Madness,6,2,8
9826,2023-01-03,GROM,gemGrab,Crystal Arcade,2,2,4
9827,2023-01-03,GROM,brawlBall,Center Stage,9,1,10
9828,2023-01-03,GROM,brawlBall,Beach Ball,36,31,67
9829,2023-01-03,GROM,bounty,Hideout,86,105,191
9830,2023-01-02,GROM,knockout,Belle's Rock,120,142,262
9831,2023-01-02,GROM,hotZone,Quarter Pounder,17,12,29
9832,2023-01-02,GROM,heist,Pit Stop,5,1,6
9833,2023-01-02,GROM,gemGrab,Minecart Madness,16,15,31
9834,2023-01-02,GROM,gemGrab,Double Swoosh,1,0,1
9835,2023-01-02,GROM,brawlBall,Center Stage,264,305,569
9836,2023-01-02,GROM,brawlBall,Backyard Bowl,2,2,4
9837,2023-01-02,GROM,bounty,Hideout,169,192,361
9838,2023-01-01,GROM,knockout,Belle's Rock,61,80,141
9839,2023-01-01,GROM,hotZone,Quarter Pounder,6,26,32
9840,2023-01-01,GROM,heist,Bridge Too Far,13,20,33
9841,2023-01-01,GROM,gemGrab,Hard Rock Mine,0,1,1
9842,2023-01-01,GROM,gemGrab,Double Swoosh,2,1,3
9843,2023-01-01,GROM,brawlBall,Backyard Bowl,4,0,4
9844,2023-01-01,GROM,bounty,Canal Grande,2,3,5
9845,2022-12-31,GROM,knockout,Flaring Phoenix,2,0,2
9846,2022-12-31,GROM,heist,Bridge Too Far,2,3,5
9847,2022-12-31,GROM,gemGrab,Minecart Madness,0,1,1
9848,2022-12-31,GROM,gemGrab,Hard Rock Mine,1,0,1
9849,2022-12-31,GROM,gemGrab,Deep Diner,1,4,5
9850,2022-12-31,GROM,brawlBall,Super Beach,3,0,3
9851,2022-12-31,GROM,bounty,Canal Grande,1,3,4
9852,2022-12-30,GROM,knockout,Flaring Phoenix,4,1,5
9853,2022-12-30,GROM,hotZone,Controller Chaos,4,0,4
9854,2022-12-30,GROM,gemGrab,Deep Diner,4,0,4
9855,2022-12-30,GROM,brawlBall,Sneaky Fields,4,0,4
9856,2022-12-29,GROM,gemGrab,Undermine,0,1,1
9857,2022-12-29,GROM,gemGrab,Minecart Madness,0,1,1
9858,2022-12-29,GROM,brawlBall,Pinhole Punt,2,0,2
9859,2022-12-28,GROM,brawlBall,Sunny Soccer,0,1,1
9860,2022-12-27,GROM,hotZone,Dueling Beetles,0,1,1
9861,2022-12-27,GROM,heist,Safe Zone,2,0,2
9862,2022-12-27,GROM,brawlBall,Center Stage,1,2,3
9863,2022-12-27,GROM,brawlBall,Beach Ball,2,0,2
9864,2022-12-27,GROM,bounty,Excel,0,1,1
9865,2022-12-26,GROM,heist,Kaboom Canyon,0,1,1
9866,2022-12-26,GROM,brawlBall,Center Stage,3,4,7
9867,2022-12-25,GROM,bounty,Layer Cake,2,1,3
9868,2022-12-24,GROM,brawlBall,Super Beach,0,1,1
9869,2022-12-23,GROM,knockout,Out in the Open,4,8,12
9870,2022-12-22,GROM,gemGrab,Gem Fort,1,0,1
9871,2022-12-19,GROM,brawlBall,Center Stage,2,0,2
9872,2022-12-18,GROM,knockout,Belle's Rock,1,0,1
9873,2022-12-17,GROM,knockout,Flaring Phoenix,3,1,4
9874,2022-12-13,GROM,knockout,New Perspective,4,13,17
9875,2022-12-13,GROM,heist,Safe Zone,0,1,1
9876,2022-12-11,GROM,brawlBall,Backyard Bowl,1,0,1
9877,2022-10-26,GROM,bounty,Shooting Star,1,0,1
9878,2022-10-15,GROM,gemGrab,Hard Rock Mine,1,0,1
9879,2022-10-10,GROM,knockout,Belle's Rock,1,1,2
9880,2023-02-05,GRIFF,knockout,X Marks the Spot,21,24,45
9881,2023-02-05,GRIFF,knockout,Goldarm Gulch,5,0,5
9882,2023-02-05,GRIFF,hotZone,Ring of Fire,90,66,156
9883,2023-02-05,GRIFF,heist,Snaked Assault,221,269,490
9884,2023-02-05,GRIFF,heist,Pit Stop,101,66,167
9885,2023-02-05,GRIFF,gemGrab,Hard Rock Mine,17,22,39
9886,2023-02-05,GRIFF,gemGrab,Double Swoosh,225,206,431
9887,2023-02-05,GRIFF,brawlBall,Super Beach,29,25,54
9888,2023-02-05,GRIFF,brawlBall,Sneaky Fields,144,143,287
9889,2023-02-05,GRIFF,brawlBall,Backyard Bowl,361,314,675
9890,2023-02-05,GRIFF,bounty,Layer Cake,5,5,10
9891,2023-02-04,GRIFF,knockout,X Marks the Spot,6,4,10
9892,2023-02-04,GRIFF,knockout,Goldarm Gulch,7,1,8
9893,2023-02-04,GRIFF,hotZone,Ring of Fire,23,16,39
9894,2023-02-04,GRIFF,heist,Tornado Ring,17,37,54
9895,2023-02-04,GRIFF,heist,Pit Stop,90,50,140
9896,2023-02-04,GRIFF,gemGrab,Hard Rock Mine,19,20,39
9897,2023-02-04,GRIFF,gemGrab,Double Swoosh,41,48,89
9898,2023-02-04,GRIFF,gemGrab,Deep Diner,13,7,20
9899,2023-02-04,GRIFF,brawlBall,Super Beach,125,149,274
9900,2023-02-04,GRIFF,brawlBall,Sneaky Fields,85,94,179
9901,2023-02-04,GRIFF,bounty,Dry Season,3,1,4
9902,2023-02-03,GRIFF,knockout,Out in the Open,39,27,66
9903,2023-02-03,GRIFF,knockout,Goldarm Gulch,21,8,29
9904,2023-02-03,GRIFF,hotZone,Split,87,158,245
9905,2023-02-03,GRIFF,heist,Tornado Ring,184,199,383
9906,2023-02-03,GRIFF,heist,Pit Stop,332,246,578
9907,2023-02-03,GRIFF,gemGrab,Undermine,39,64,103
9908,2023-02-03,GRIFF,gemGrab,Double Swoosh,256,253,509
9909,2023-02-03,GRIFF,gemGrab,Deep Diner,176,191,367
9910,2023-02-03,GRIFF,brawlBall,Sneaky Fields,1093,1085,2178
9911,2023-02-03,GRIFF,brawlBall,Pinhole Punt,27,40,67
9912,2023-02-03,GRIFF,bounty,Dry Season,24,7,31
9913,2023-02-02,GRIFF,knockout,Out in the Open,7,11,18
9914,2023-02-02,GRIFF,hotZone,Split,48,36,84
9915,2023-02-02,GRIFF,heist,Kaboom Canyon,10,4,14
9916,2023-02-02,GRIFF,gemGrab,Undermine,19,21,40
9917,2023-02-02,GRIFF,gemGrab,Gem Fort,14,10,24
9918,2023-02-02,GRIFF,brawlBall,Sunny Soccer,16,29,45
9919,2023-02-02,GRIFF,brawlBall,Pinhole Punt,149,152,301
9920,2023-02-02,GRIFF,bounty,Shooting Star,3,1,4
9921,2023-02-01,GRIFF,knockout,Goldarm Gulch,30,20,50
9922,2023-02-01,GRIFF,hotZone,Parallel Plays,139,167,306
9923,2023-02-01,GRIFF,heist,Kaboom Canyon,38,33,71
9924,2023-02-01,GRIFF,gemGrab,Gem Fort,95,89,184
9925,2023-02-01,GRIFF,gemGrab,Crystal Arcade,62,43,105
9926,2023-02-01,GRIFF,brawlBall,Sunny Soccer,439,439,878
9927,2023-02-01,GRIFF,brawlBall,Beach Ball,35,32,67
9928,2023-02-01,GRIFF,bounty,Shooting Star,4,1,5
9929,2023-01-31,GRIFF,knockout,Goldarm Gulch,22,25,47
9930,2023-01-31,GRIFF,hotZone,Parallel Plays,66,51,117
9931,2023-01-31,GRIFF,heist,Pit Stop,15,20,35
9932,2023-01-31,GRIFF,gemGrab,Minecart Madness,7,4,11
9933,2023-01-31,GRIFF,gemGrab,Crystal Arcade,42,38,80
9934,2023-01-31,GRIFF,brawlBall,Center Stage,7,6,13
9935,2023-01-31,GRIFF,brawlBall,Beach Ball,219,253,472
9936,2023-01-31,GRIFF,bounty,Hideout,6,1,7
9937,2023-01-30,GRIFF,knockout,Belle's Rock,24,12,36
9938,2023-01-30,GRIFF,hotZone,Quarter Pounder,256,407,663
9939,2023-01-30,GRIFF,heist,Pit Stop,88,85,173
9940,2023-01-30,GRIFF,gemGrab,Minecart Madness,51,41,92
9941,2023-01-30,GRIFF,gemGrab,Double Swoosh,95,94,189
9942,2023-01-30,GRIFF,brawlBall,Center Stage,452,417,869
9943,2023-01-30,GRIFF,brawlBall,Backyard Bowl,44,62,106
9944,2023-01-30,GRIFF,bounty,Hideout,4,3,7
9945,2023-01-29,GRIFF,knockout,Belle's Rock,23,9,32
9946,2023-01-29,GRIFF,hotZone,Quarter Pounder,313,403,716
9947,2023-01-29,GRIFF,heist,Bridge Too Far,33,25,58
9948,2023-01-29,GRIFF,gemGrab,Hard Rock Mine,12,10,22
9949,2023-01-29,GRIFF,gemGrab,Double Swoosh,132,117,249
9950,2023-01-29,GRIFF,brawlBall,Super Beach,7,6,13
9951,2023-01-29,GRIFF,brawlBall,Backyard Bowl,403,323,726
9952,2023-01-29,GRIFF,bounty,Canal Grande,31,28,59
9953,2023-01-28,GRIFF,knockout,Flaring Phoenix,20,11,31
9954,2023-01-28,GRIFF,hotZone,Controller Chaos,164,224,388
9955,2023-01-28,GRIFF,heist,Bridge Too Far,71,52,123
9956,2023-01-28,GRIFF,gemGrab,Hard Rock Mine,106,90,196
9957,2023-01-28,GRIFF,gemGrab,Deep Diner,60,58,118
9958,2023-01-28,GRIFF,brawlBall,Super Beach,718,746,1464
9959,2023-01-28,GRIFF,brawlBall,Sneaky Fields,20,21,41
9960,2023-01-28,GRIFF,bounty,Canal Grande,60,39,99
9961,2023-01-27,GRIFF,knockout,Flaring Phoenix,8,6,14
9962,2023-01-27,GRIFF,hotZone,Controller Chaos,40,28,68
9963,2023-01-27,GRIFF,heist,Hot Potato,32,25,57
9964,2023-01-27,GRIFF,gemGrab,Undermine,7,6,13
9965,2023-01-27,GRIFF,gemGrab,Deep Diner,86,90,176
9966,2023-01-27,GRIFF,brawlBall,Sneaky Fields,210,177,387
9967,2023-01-27,GRIFF,brawlBall,Pinhole Punt,5,8,13
9968,2023-01-27,GRIFF,bounty,Temple Ruins,9,1,10
9969,2023-01-26,GRIFF,knockout,Riverside,16,7,23
9970,2023-01-26,GRIFF,hotZone,Open Zone,77,54,131
9971,2023-01-26,GRIFF,heist,Hot Potato,140,160,300
9972,2023-01-26,GRIFF,gemGrab,Undermine,73,85,158
9973,2023-01-26,GRIFF,gemGrab,Gem Fort,44,41,85
9974,2023-01-26,GRIFF,brawlBall,Sunny Soccer,34,41,75
9975,2023-01-26,GRIFF,brawlBall,Pinhole Punt,654,653,1307
9976,2023-01-26,GRIFF,bounty,Temple Ruins,16,14,30
9977,2023-01-25,GRIFF,knockout,Riverside,6,4,10
9978,2023-01-25,GRIFF,hotZone,Open Zone,54,20,74
9979,2023-01-25,GRIFF,heist,Safe Zone,55,89,144
9980,2023-01-25,GRIFF,gemGrab,Gem Fort,39,50,89
9981,2023-01-25,GRIFF,gemGrab,Crystal Arcade,60,50,110
9982,2023-01-25,GRIFF,brawlBall,Sunny Soccer,311,320,631
9983,2023-01-25,GRIFF,brawlBall,Beach Ball,58,64,122
9984,2023-01-25,GRIFF,bounty,Excel,17,8,25
9985,2023-01-24,GRIFF,knockout,New Perspective,17,11,28
9986,2023-01-24,GRIFF,hotZone,Dueling Beetles,139,161,300
9987,2023-01-24,GRIFF,heist,Safe Zone,90,97,187
9988,2023-01-24,GRIFF,gemGrab,Minecart Madness,17,12,29
9989,2023-01-24,GRIFF,gemGrab,Crystal Arcade,114,102,216
9990,2023-01-24,GRIFF,brawlBall,Center Stage,74,114,188
9991,2023-01-24,GRIFF,brawlBall,Beach Ball,609,761,1370
9992,2023-01-24,GRIFF,bounty,Excel,20,6,26
9993,2023-01-23,GRIFF,knockout,New Perspective,37,29,66
9994,2023-01-23,GRIFF,hotZone,Dueling Beetles,268,202,470
9995,2023-01-23,GRIFF,heist,Snaked Assault,234,269,503
9996,2023-01-23,GRIFF,gemGrab,Minecart Madness,75,96,171
9997,2023-01-23,GRIFF,gemGrab,Double Swoosh,75,45,120
9998,2023-01-23,GRIFF,brawlBall,Center Stage,833,900,1733
9999,2023-01-23,GRIFF,brawlBall,Backyard Bowl,21,24,45
10000,2023-01-23,GRIFF,bounty,Layer Cake,18,19,37
10001,2023-01-22,GRIFF,knockout,X Marks the Spot,16,15,31
10002,2023-01-22,GRIFF,hotZone,Ring of Fire,91,103,194
10003,2023-01-22,GRIFF,heist,Snaked Assault,135,166,301
10004,2023-01-22,GRIFF,gemGrab,Hard Rock Mine,30,15,45
10005,2023-01-22,GRIFF,gemGrab,Double Swoosh,68,59,127
10006,2023-01-22,GRIFF,brawlBall,Super Beach,58,60,118
10007,2023-01-22,GRIFF,brawlBall,Backyard Bowl,233,169,402
10008,2023-01-22,GRIFF,bounty,Layer Cake,18,18,36
10009,2023-01-21,GRIFF,knockout,X Marks the Spot,52,25,77
10010,2023-01-21,GRIFF,hotZone,Ring of Fire,170,184,354
10011,2023-01-21,GRIFF,heist,Tornado Ring,166,195,361
10012,2023-01-21,GRIFF,gemGrab,Hard Rock Mine,140,169,309
10013,2023-01-21,GRIFF,gemGrab,Deep Diner,40,60,100
10014,2023-01-21,GRIFF,brawlBall,Super Beach,952,910,1862
10015,2023-01-21,GRIFF,brawlBall,Sneaky Fields,38,35,73
10016,2023-01-21,GRIFF,bounty,Dry Season,16,9,25
10017,2023-01-20,GRIFF,knockout,Out in the Open,38,32,70
10018,2023-01-20,GRIFF,hotZone,Split,80,93,173
10019,2023-01-20,GRIFF,heist,Tornado Ring,127,137,264
10020,2023-01-20,GRIFF,gemGrab,Undermine,50,29,79
10021,2023-01-20,GRIFF,gemGrab,Deep Diner,200,224,424
10022,2023-01-20,GRIFF,brawlBall,Sneaky Fields,710,719,1429
10023,2023-01-20,GRIFF,brawlBall,Pinhole Punt,35,25,60
10024,2023-01-20,GRIFF,bounty,Dry Season,10,5,15
10025,2023-01-19,GRIFF,knockout,Out in the Open,65,31,96
10026,2023-01-19,GRIFF,hotZone,Split,127,94,221
10027,2023-01-19,GRIFF,heist,Kaboom Canyon,63,65,128
10028,2023-01-19,GRIFF,gemGrab,Undermine,86,74,160
10029,2023-01-19,GRIFF,gemGrab,Gem Fort,32,17,49
10030,2023-01-19,GRIFF,brawlBall,Sunny Soccer,13,16,29
10031,2023-01-19,GRIFF,brawlBall,Pinhole Punt,728,739,1467
10032,2023-01-19,GRIFF,bounty,Shooting Star,17,7,24
10033,2023-01-18,GRIFF,knockout,Goldarm Gulch,9,9,18
10034,2023-01-18,GRIFF,hotZone,Parallel Plays,16,26,42
10035,2023-01-18,GRIFF,heist,Kaboom Canyon,13,15,28
10036,2023-01-18,GRIFF,gemGrab,Gem Fort,42,33,75
10037,2023-01-18,GRIFF,gemGrab,Crystal Arcade,4,3,7
10038,2023-01-18,GRIFF,brawlBall,Sunny Soccer,156,176,332
10039,2023-01-18,GRIFF,brawlBall,Beach Ball,6,6,12
10040,2023-01-18,GRIFF,bounty,Shooting Star,3,2,5
10041,2023-01-17,GRIFF,knockout,Goldarm Gulch,1,4,5
10042,2023-01-17,GRIFF,hotZone,Parallel Plays,13,24,37
10043,2023-01-17,GRIFF,heist,Pit Stop,11,13,24
10044,2023-01-17,GRIFF,gemGrab,Crystal Arcade,11,11,22
10045,2023-01-17,GRIFF,brawlBall,Center Stage,2,5,7
10046,2023-01-17,GRIFF,brawlBall,Beach Ball,48,48,96
10047,2023-01-17,GRIFF,bounty,Hideout,2,0,2
10048,2023-01-16,GRIFF,knockout,Belle's Rock,1,0,1
10049,2023-01-16,GRIFF,hotZone,Quarter Pounder,22,17,39
10050,2023-01-16,GRIFF,heist,Pit Stop,41,40,81
10051,2023-01-16,GRIFF,gemGrab,Minecart Madness,8,3,11
10052,2023-01-16,GRIFF,gemGrab,Double Swoosh,6,8,14
10053,2023-01-16,GRIFF,brawlBall,Center Stage,43,51,94
10054,2023-01-16,GRIFF,brawlBall,Backyard Bowl,2,6,8
10055,2023-01-15,GRIFF,knockout,Belle's Rock,0,1,1
10056,2023-01-15,GRIFF,hotZone,Quarter Pounder,73,125,198
10057,2023-01-15,GRIFF,heist,Bridge Too Far,16,16,32
10058,2023-01-15,GRIFF,gemGrab,Hard Rock Mine,5,2,7
10059,2023-01-15,GRIFF,gemGrab,Double Swoosh,15,2,17
10060,2023-01-15,GRIFF,brawlBall,Super Beach,2,6,8
10061,2023-01-15,GRIFF,brawlBall,Backyard Bowl,41,50,91
10062,2023-01-15,GRIFF,bounty,Canal Grande,2,0,2
10063,2023-01-14,GRIFF,knockout,Flaring Phoenix,2,0,2
10064,2023-01-14,GRIFF,hotZone,Controller Chaos,48,86,134
10065,2023-01-14,GRIFF,heist,Bridge Too Far,6,2,8
10066,2023-01-14,GRIFF,gemGrab,Hard Rock Mine,1,2,3
10067,2023-01-14,GRIFF,gemGrab,Deep Diner,6,5,11
10068,2023-01-14,GRIFF,brawlBall,Super Beach,60,97,157
10069,2023-01-14,GRIFF,brawlBall,Sneaky Fields,9,1,10
10070,2023-01-14,GRIFF,bounty,Canal Grande,1,0,1
10071,2023-01-13,GRIFF,knockout,Flaring Phoenix,4,0,4
10072,2023-01-13,GRIFF,hotZone,Controller Chaos,67,88,155
10073,2023-01-13,GRIFF,heist,Hot Potato,5,2,7
10074,2023-01-13,GRIFF,gemGrab,Deep Diner,16,19,35
10075,2023-01-13,GRIFF,brawlBall,Sneaky Fields,49,62,111
10076,2023-01-13,GRIFF,brawlBall,Pinhole Punt,9,13,22
10077,2023-01-12,GRIFF,knockout,Riverside,1,1,2
10078,2023-01-12,GRIFF,hotZone,Open Zone,13,6,19
10079,2023-01-12,GRIFF,heist,Hot Potato,5,0,5
10080,2023-01-12,GRIFF,gemGrab,Undermine,2,7,9
10081,2023-01-12,GRIFF,gemGrab,Gem Fort,0,1,1
10082,2023-01-12,GRIFF,brawlBall,Sunny Soccer,1,0,1
10083,2023-01-12,GRIFF,brawlBall,Pinhole Punt,24,23,47
10084,2023-01-11,GRIFF,hotZone,Open Zone,3,0,3
10085,2023-01-11,GRIFF,heist,Safe Zone,1,0,1
10086,2023-01-11,GRIFF,gemGrab,Gem Fort,2,0,2
10087,2023-01-11,GRIFF,brawlBall,Sunny Soccer,8,5,13
10088,2023-01-10,GRIFF,knockout,New Perspective,3,0,3
10089,2023-01-10,GRIFF,hotZone,Dueling Beetles,23,34,57
10090,2023-01-10,GRIFF,heist,Safe Zone,8,2,10
10091,2023-01-10,GRIFF,gemGrab,Minecart Madness,1,0,1
10092,2023-01-10,GRIFF,gemGrab,Crystal Arcade,15,51,66
10093,2023-01-10,GRIFF,brawlBall,Center Stage,9,0,9
10094,2023-01-10,GRIFF,brawlBall,Beach Ball,33,27,60
10095,2023-01-09,GRIFF,hotZone,Dueling Beetles,14,23,37
10096,2023-01-09,GRIFF,heist,Snaked Assault,32,40,72
10097,2023-01-09,GRIFF,gemGrab,Minecart Madness,5,1,6
10098,2023-01-09,GRIFF,gemGrab,Double Swoosh,6,15,21
10099,2023-01-09,GRIFF,brawlBall,Center Stage,41,28,69
10100,2023-01-09,GRIFF,brawlBall,Backyard Bowl,3,2,5
10101,2023-01-09,GRIFF,bounty,Layer Cake,2,0,2
10102,2023-01-08,GRIFF,hotZone,Ring of Fire,19,29,48
10103,2023-01-08,GRIFF,heist,Snaked Assault,14,7,21
10104,2023-01-08,GRIFF,gemGrab,Hard Rock Mine,3,5,8
10105,2023-01-08,GRIFF,gemGrab,Double Swoosh,2,1,3
10106,2023-01-08,GRIFF,brawlBall,Super Beach,10,8,18
10107,2023-01-08,GRIFF,brawlBall,Backyard Bowl,21,26,47
10108,2023-01-07,GRIFF,hotZone,Ring of Fire,8,20,28
10109,2023-01-07,GRIFF,heist,Tornado Ring,19,4,23
10110,2023-01-07,GRIFF,gemGrab,Hard Rock Mine,7,2,9
10111,2023-01-07,GRIFF,gemGrab,Deep Diner,4,2,6
10112,2023-01-07,GRIFF,brawlBall,Super Beach,24,22,46
10113,2023-01-07,GRIFF,bounty,Dry Season,2,4,6
10114,2023-01-06,GRIFF,knockout,Out in the Open,2,1,3
10115,2023-01-06,GRIFF,hotZone,Split,9,6,15
10116,2023-01-06,GRIFF,heist,Tornado Ring,23,47,70
10117,2023-01-06,GRIFF,gemGrab,Undermine,3,1,4
10118,2023-01-06,GRIFF,gemGrab,Deep Diner,24,28,52
10119,2023-01-06,GRIFF,brawlBall,Sneaky Fields,31,28,59
10120,2023-01-06,GRIFF,brawlBall,Pinhole Punt,2,6,8
10121,2023-01-05,GRIFF,knockout,Out in the Open,6,1,7
10122,2023-01-05,GRIFF,hotZone,Split,44,62,106
10123,2023-01-05,GRIFF,heist,Kaboom Canyon,5,1,6
10124,2023-01-05,GRIFF,gemGrab,Undermine,5,1,6
10125,2023-01-05,GRIFF,gemGrab,Gem Fort,2,1,3
10126,2023-01-05,GRIFF,brawlBall,Sunny Soccer,0,1,1
10127,2023-01-05,GRIFF,brawlBall,Pinhole Punt,77,76,153
10128,2023-01-04,GRIFF,hotZone,Parallel Plays,9,42,51
10129,2023-01-04,GRIFF,heist,Kaboom Canyon,12,9,21
10130,2023-01-04,GRIFF,gemGrab,Gem Fort,11,23,34
10131,2023-01-04,GRIFF,gemGrab,Crystal Arcade,1,0,1
10132,2023-01-04,GRIFF,brawlBall,Sunny Soccer,69,56,125
10133,2023-01-04,GRIFF,brawlBall,Beach Ball,1,0,1
10134,2023-01-04,GRIFF,bounty,Shooting Star,1,0,1
10135,2023-01-03,GRIFF,hotZone,Parallel Plays,29,57,86
10136,2023-01-03,GRIFF,heist,Pit Stop,13,27,40
10137,2023-01-03,GRIFF,gemGrab,Minecart Madness,2,0,2
10138,2023-01-03,GRIFF,gemGrab,Crystal Arcade,30,57,87
10139,2023-01-03,GRIFF,brawlBall,Center Stage,1,2,3
10140,2023-01-03,GRIFF,brawlBall,Beach Ball,36,35,71
10141,2023-01-03,GRIFF,bounty,Hideout,3,0,3
10142,2023-01-02,GRIFF,knockout,Belle's Rock,2,0,2
10143,2023-01-02,GRIFF,hotZone,Quarter Pounder,37,44,81
10144,2023-01-02,GRIFF,hotZone,Controller Chaos,0,2,2
10145,2023-01-02,GRIFF,heist,Pit Stop,35,26,61
10146,2023-01-02,GRIFF,heist,Kaboom Canyon,1,0,1
10147,2023-01-02,GRIFF,gemGrab,Minecart Madness,11,4,15
10148,2023-01-02,GRIFF,gemGrab,Double Swoosh,14,17,31
10149,2023-01-02,GRIFF,brawlBall,Center Stage,39,35,74
10150,2023-01-02,GRIFF,brawlBall,Backyard Bowl,2,1,3
10151,2023-01-02,GRIFF,bounty,Hideout,2,0,2
10152,2023-01-01,GRIFF,hotZone,Quarter Pounder,19,14,33
10153,2023-01-01,GRIFF,hotZone,Controller Chaos,1,0,1
10154,2023-01-01,GRIFF,heist,Bridge Too Far,0,1,1
10155,2023-01-01,GRIFF,gemGrab,Double Swoosh,7,16,23
10156,2023-01-01,GRIFF,brawlBall,Backyard Bowl,17,22,39
10157,2023-01-01,GRIFF,bounty,Canal Grande,2,0,2
10158,2022-12-31,GRIFF,hotZone,Controller Chaos,0,1,1
10159,2022-12-31,GRIFF,heist,Bridge Too Far,2,0,2
10160,2022-12-31,GRIFF,gemGrab,Hard Rock Mine,1,0,1
10161,2022-12-31,GRIFF,gemGrab,Deep Diner,3,1,4
10162,2022-12-31,GRIFF,brawlBall,Super Beach,3,2,5
10163,2022-12-31,GRIFF,brawlBall,Sneaky Fields,0,1,1
10164,2022-12-31,GRIFF,bounty,Canal Grande,1,0,1
10165,2022-12-30,GRIFF,knockout,Flaring Phoenix,1,0,1
10166,2022-12-30,GRIFF,hotZone,Controller Chaos,5,1,6
10167,2022-12-30,GRIFF,heist,Hot Potato,1,0,1
10168,2022-12-30,GRIFF,gemGrab,Undermine,2,13,15
10169,2022-12-30,GRIFF,gemGrab,Deep Diner,5,7,12
10170,2022-12-30,GRIFF,brawlBall,Sneaky Fields,5,10,15
10171,2022-12-29,GRIFF,hotZone,Open Zone,0,1,1
10172,2022-12-29,GRIFF,heist,Kaboom Canyon,1,0,1
10173,2022-12-29,GRIFF,brawlBall,Pinhole Punt,3,1,4
10174,2022-12-27,GRIFF,hotZone,Controller Chaos,1,0,1
10175,2022-12-27,GRIFF,heist,Safe Zone,1,0,1
10176,2022-12-27,GRIFF,heist,Kaboom Canyon,1,1,2
10177,2022-12-27,GRIFF,gemGrab,Minecart Madness,0,1,1
10178,2022-12-27,GRIFF,brawlBall,Beach Ball,0,2,2
10179,2022-12-26,GRIFF,hotZone,Controller Chaos,0,2,2
10180,2022-12-26,GRIFF,heist,Kaboom Canyon,1,0,1
10181,2022-12-26,GRIFF,brawlBall,Center Stage,4,3,7
10182,2022-12-24,GRIFF,brawlBall,Super Beach,1,0,1
10183,2022-12-22,GRIFF,gemGrab,Gem Fort,1,0,1
10184,2022-12-22,GRIFF,brawlBall,Pinhole Punt,2,0,2
10185,2022-12-21,GRIFF,brawlBall,Sunny Soccer,1,0,1
10186,2022-12-20,GRIFF,brawlBall,Beach Ball,1,1,2
10187,2022-12-19,GRIFF,brawlBall,Center Stage,2,1,3
10188,2022-12-16,GRIFF,hotZone,Controller Chaos,0,1,1
10189,2022-12-16,GRIFF,brawlBall,Sneaky Fields,0,1,1
10190,2022-12-13,GRIFF,gemGrab,Crystal Arcade,1,0,1
10191,2022-12-11,GRIFF,gemGrab,Double Swoosh,0,1,1
10192,2022-12-11,GRIFF,brawlBall,Backyard Bowl,1,2,3
10193,2022-11-11,GRIFF,brawlBall,Sneaky Fields,3,5,8
10194,2022-10-30,GRIFF,hotZone,Dueling Beetles,1,0,1
10195,2022-10-30,GRIFF,brawlBall,Beach Ball,1,0,1
10196,2022-10-28,GRIFF,knockout,Out in the Open,1,0,1
10197,2022-10-28,GRIFF,bounty,Canal Grande,0,2,2
10198,2022-10-15,GRIFF,hotZone,Ring of Fire,1,2,3
10199,2022-10-15,GRIFF,gemGrab,Hard Rock Mine,0,1,1
10200,2023-02-05,GRAY,knockout,X Marks the Spot,475,609,1084
10201,2023-02-05,GRAY,knockout,Goldarm Gulch,172,224,396
10202,2023-02-05,GRAY,hotZone,Ring of Fire,36,35,71
10203,2023-02-05,GRAY,heist,Snaked Assault,4,2,6
10204,2023-02-05,GRAY,heist,Pit Stop,5,0,5
10205,2023-02-05,GRAY,gemGrab,Hard Rock Mine,16,16,32
10206,2023-02-05,GRAY,gemGrab,Double Swoosh,82,88,170
10207,2023-02-05,GRAY,brawlBall,Super Beach,15,8,23
10208,2023-02-05,GRAY,brawlBall,Sneaky Fields,9,5,14
10209,2023-02-05,GRAY,brawlBall,Backyard Bowl,553,713,1266
10210,2023-02-05,GRAY,bounty,Layer Cake,106,133,239
10211,2023-02-04,GRAY,knockout,X Marks the Spot,136,136,272
10212,2023-02-04,GRAY,knockout,Goldarm Gulch,156,228,384
10213,2023-02-04,GRAY,hotZone,Ring of Fire,5,4,9
10214,2023-02-04,GRAY,heist,Tornado Ring,2,1,3
10215,2023-02-04,GRAY,heist,Pit Stop,4,6,10
10216,2023-02-04,GRAY,gemGrab,Hard Rock Mine,20,42,62
10217,2023-02-04,GRAY,gemGrab,Double Swoosh,10,3,13
10218,2023-02-04,GRAY,gemGrab,Deep Diner,13,16,29
10219,2023-02-04,GRAY,brawlBall,Super Beach,131,173,304
10220,2023-02-04,GRAY,brawlBall,Sneaky Fields,9,9,18
10221,2023-02-04,GRAY,bounty,Dry Season,23,47,70
10222,2023-02-03,GRAY,knockout,Out in the Open,480,661,1141
10223,2023-02-03,GRAY,knockout,Goldarm Gulch,768,1014,1782
10224,2023-02-03,GRAY,hotZone,Split,58,68,126
10225,2023-02-03,GRAY,heist,Tornado Ring,3,10,13
10226,2023-02-03,GRAY,heist,Pit Stop,21,9,30
10227,2023-02-03,GRAY,gemGrab,Undermine,18,16,34
10228,2023-02-03,GRAY,gemGrab,Double Swoosh,85,50,135
10229,2023-02-03,GRAY,gemGrab,Deep Diner,114,141,255
10230,2023-02-03,GRAY,brawlBall,Sneaky Fields,293,346,639
10231,2023-02-03,GRAY,brawlBall,Pinhole Punt,17,23,40
10232,2023-02-03,GRAY,bounty,Dry Season,165,221,386
10233,2023-02-02,GRAY,knockout,Out in the Open,261,323,584
10234,2023-02-02,GRAY,hotZone,Split,22,20,42
10235,2023-02-02,GRAY,heist,Kaboom Canyon,3,1,4
10236,2023-02-02,GRAY,gemGrab,Undermine,14,14,28
10237,2023-02-02,GRAY,gemGrab,Gem Fort,4,1,5
10238,2023-02-02,GRAY,brawlBall,Sunny Soccer,7,3,10
10239,2023-02-02,GRAY,brawlBall,Pinhole Punt,103,154,257
10240,2023-02-02,GRAY,bounty,Shooting Star,33,33,66
10241,2023-02-01,GRAY,knockout,Goldarm Gulch,644,1002,1646
10242,2023-02-01,GRAY,hotZone,Parallel Plays,57,138,195
10243,2023-02-01,GRAY,heist,Kaboom Canyon,4,2,6
10244,2023-02-01,GRAY,gemGrab,Gem Fort,64,82,146
10245,2023-02-01,GRAY,gemGrab,Crystal Arcade,36,52,88
10246,2023-02-01,GRAY,brawlBall,Sunny Soccer,371,454,825
10247,2023-02-01,GRAY,brawlBall,Beach Ball,30,27,57
10248,2023-02-01,GRAY,bounty,Shooting Star,72,96,168
10249,2023-01-31,GRAY,knockout,Goldarm Gulch,401,551,952
10250,2023-01-31,GRAY,hotZone,Parallel Plays,22,31,53
10251,2023-01-31,GRAY,heist,Pit Stop,9,6,15
10252,2023-01-31,GRAY,gemGrab,Minecart Madness,15,21,36
10253,2023-01-31,GRAY,gemGrab,Crystal Arcade,58,75,133
10254,2023-01-31,GRAY,brawlBall,Center Stage,2,0,2
10255,2023-01-31,GRAY,brawlBall,Beach Ball,256,325,581
10256,2023-01-31,GRAY,bounty,Hideout,34,42,76
10257,2023-01-30,GRAY,knockout,Belle's Rock,559,818,1377
10258,2023-01-30,GRAY,hotZone,Quarter Pounder,56,98,154
10259,2023-01-30,GRAY,heist,Pit Stop,2,1,3
10260,2023-01-30,GRAY,gemGrab,Minecart Madness,92,108,200
10261,2023-01-30,GRAY,gemGrab,Double Swoosh,47,39,86
10262,2023-01-30,GRAY,brawlBall,Center Stage,277,251,528
10263,2023-01-30,GRAY,brawlBall,Backyard Bowl,66,86,152
10264,2023-01-30,GRAY,bounty,Hideout,49,54,103
10265,2023-01-29,GRAY,knockout,Belle's Rock,661,916,1577
10266,2023-01-29,GRAY,hotZone,Quarter Pounder,40,99,139
10267,2023-01-29,GRAY,heist,Bridge Too Far,13,20,33
10268,2023-01-29,GRAY,gemGrab,Hard Rock Mine,24,30,54
10269,2023-01-29,GRAY,gemGrab,Double Swoosh,71,79,150
10270,2023-01-29,GRAY,brawlBall,Super Beach,9,8,17
10271,2023-01-29,GRAY,brawlBall,Backyard Bowl,693,949,1642
10272,2023-01-29,GRAY,bounty,Canal Grande,55,103,158
10273,2023-01-28,GRAY,knockout,Flaring Phoenix,333,475,808
10274,2023-01-28,GRAY,hotZone,Controller Chaos,36,34,70
10275,2023-01-28,GRAY,heist,Bridge Too Far,31,19,50
10276,2023-01-28,GRAY,gemGrab,Hard Rock Mine,92,110,202
10277,2023-01-28,GRAY,gemGrab,Deep Diner,35,59,94
10278,2023-01-28,GRAY,brawlBall,Super Beach,457,537,994
10279,2023-01-28,GRAY,brawlBall,Sneaky Fields,19,19,38
10280,2023-01-28,GRAY,bounty,Canal Grande,70,79,149
10281,2023-01-27,GRAY,knockout,Flaring Phoenix,191,261,452
10282,2023-01-27,GRAY,hotZone,Controller Chaos,10,9,19
10283,2023-01-27,GRAY,heist,Hot Potato,6,2,8
10284,2023-01-27,GRAY,gemGrab,Undermine,3,8,11
10285,2023-01-27,GRAY,gemGrab,Deep Diner,52,93,145
10286,2023-01-27,GRAY,brawlBall,Sneaky Fields,98,98,196
10287,2023-01-27,GRAY,brawlBall,Pinhole Punt,5,7,12
10288,2023-01-27,GRAY,bounty,Temple Ruins,14,28,42
10289,2023-01-26,GRAY,knockout,Riverside,166,176,342
10290,2023-01-26,GRAY,hotZone,Open Zone,31,52,83
10291,2023-01-26,GRAY,heist,Hot Potato,12,10,22
10292,2023-01-26,GRAY,gemGrab,Undermine,27,35,62
10293,2023-01-26,GRAY,gemGrab,Gem Fort,29,23,52
10294,2023-01-26,GRAY,brawlBall,Sunny Soccer,33,38,71
10295,2023-01-26,GRAY,brawlBall,Pinhole Punt,412,474,886
10296,2023-01-26,GRAY,bounty,Temple Ruins,67,79,146
10297,2023-01-25,GRAY,knockout,Riverside,96,82,178
10298,2023-01-25,GRAY,hotZone,Open Zone,13,30,43
10299,2023-01-25,GRAY,heist,Safe Zone,11,7,18
10300,2023-01-25,GRAY,gemGrab,Gem Fort,33,66,99
10301,2023-01-25,GRAY,gemGrab,Crystal Arcade,41,80,121
10302,2023-01-25,GRAY,brawlBall,Sunny Soccer,275,279,554
10303,2023-01-25,GRAY,brawlBall,Beach Ball,62,61,123
10304,2023-01-25,GRAY,bounty,Excel,44,33,77
10305,2023-01-24,GRAY,knockout,New Perspective,301,400,701
10306,2023-01-24,GRAY,hotZone,Dueling Beetles,35,39,74
10307,2023-01-24,GRAY,heist,Safe Zone,26,34,60
10308,2023-01-24,GRAY,gemGrab,Minecart Madness,37,65,102
10309,2023-01-24,GRAY,gemGrab,Crystal Arcade,80,117,197
10310,2023-01-24,GRAY,brawlBall,Center Stage,43,21,64
10311,2023-01-24,GRAY,brawlBall,Beach Ball,524,603,1127
10312,2023-01-24,GRAY,bounty,Excel,116,138,254
10313,2023-01-23,GRAY,knockout,New Perspective,829,1092,1921
10314,2023-01-23,GRAY,hotZone,Dueling Beetles,75,73,148
10315,2023-01-23,GRAY,heist,Snaked Assault,13,14,27
10316,2023-01-23,GRAY,gemGrab,Minecart Madness,153,240,393
10317,2023-01-23,GRAY,gemGrab,Double Swoosh,29,41,70
10318,2023-01-23,GRAY,brawlBall,Center Stage,460,534,994
10319,2023-01-23,GRAY,brawlBall,Backyard Bowl,28,22,50
10320,2023-01-23,GRAY,bounty,Layer Cake,134,195,329
10321,2023-01-22,GRAY,knockout,X Marks the Spot,368,432,800
10322,2023-01-22,GRAY,hotZone,Ring of Fire,3,5,8
10323,2023-01-22,GRAY,heist,Snaked Assault,7,6,13
10324,2023-01-22,GRAY,gemGrab,Hard Rock Mine,29,29,58
10325,2023-01-22,GRAY,gemGrab,Double Swoosh,44,44,88
10326,2023-01-22,GRAY,brawlBall,Super Beach,39,65,104
10327,2023-01-22,GRAY,brawlBall,Backyard Bowl,318,439,757
10328,2023-01-22,GRAY,bounty,Layer Cake,68,77,145
10329,2023-01-21,GRAY,knockout,X Marks the Spot,1274,1670,2944
10330,2023-01-21,GRAY,hotZone,Ring of Fire,47,78,125
10331,2023-01-21,GRAY,heist,Tornado Ring,17,6,23
10332,2023-01-21,GRAY,gemGrab,Hard Rock Mine,79,100,179
10333,2023-01-21,GRAY,gemGrab,Deep Diner,34,54,88
10334,2023-01-21,GRAY,brawlBall,Super Beach,653,854,1507
10335,2023-01-21,GRAY,brawlBall,Sneaky Fields,15,21,36
10336,2023-01-21,GRAY,bounty,Dry Season,156,165,321
10337,2023-01-20,GRAY,knockout,Out in the Open,558,844,1402
10338,2023-01-20,GRAY,hotZone,Split,61,81,142
10339,2023-01-20,GRAY,heist,Tornado Ring,19,8,27
10340,2023-01-20,GRAY,gemGrab,Undermine,28,21,49
10341,2023-01-20,GRAY,gemGrab,Deep Diner,140,187,327
10342,2023-01-20,GRAY,brawlBall,Sneaky Fields,264,270,534
10343,2023-01-20,GRAY,brawlBall,Pinhole Punt,10,12,22
10344,2023-01-20,GRAY,bounty,Dry Season,119,161,280
10345,2023-01-19,GRAY,knockout,Out in the Open,1052,1525,2577
10346,2023-01-19,GRAY,hotZone,Split,68,57,125
10347,2023-01-19,GRAY,heist,Kaboom Canyon,18,23,41
10348,2023-01-19,GRAY,gemGrab,Undermine,53,78,131
10349,2023-01-19,GRAY,gemGrab,Gem Fort,9,8,17
10350,2023-01-19,GRAY,brawlBall,Sunny Soccer,17,23,40
10351,2023-01-19,GRAY,brawlBall,Pinhole Punt,417,474,891
10352,2023-01-19,GRAY,bounty,Shooting Star,89,120,209
10353,2023-01-18,GRAY,knockout,Goldarm Gulch,109,123,232
10354,2023-01-18,GRAY,hotZone,Parallel Plays,9,7,16
10355,2023-01-18,GRAY,heist,Kaboom Canyon,8,8,16
10356,2023-01-18,GRAY,gemGrab,Gem Fort,20,19,39
10357,2023-01-18,GRAY,gemGrab,Crystal Arcade,2,3,5
10358,2023-01-18,GRAY,brawlBall,Sunny Soccer,163,177,340
10359,2023-01-18,GRAY,brawlBall,Beach Ball,8,10,18
10360,2023-01-18,GRAY,bounty,Shooting Star,57,36,93
10361,2023-01-17,GRAY,knockout,Goldarm Gulch,83,132,215
10362,2023-01-17,GRAY,hotZone,Parallel Plays,4,8,12
10363,2023-01-17,GRAY,gemGrab,Minecart Madness,2,4,6
10364,2023-01-17,GRAY,gemGrab,Crystal Arcade,7,5,12
10365,2023-01-17,GRAY,brawlBall,Center Stage,1,0,1
10366,2023-01-17,GRAY,brawlBall,Beach Ball,30,62,92
10367,2023-01-17,GRAY,bounty,Hideout,4,8,12
10368,2023-01-16,GRAY,knockout,Belle's Rock,44,70,114
10369,2023-01-16,GRAY,hotZone,Quarter Pounder,7,3,10
10370,2023-01-16,GRAY,heist,Pit Stop,2,0,2
10371,2023-01-16,GRAY,gemGrab,Minecart Madness,17,28,45
10372,2023-01-16,GRAY,gemGrab,Double Swoosh,1,1,2
10373,2023-01-16,GRAY,brawlBall,Center Stage,28,34,62
10374,2023-01-16,GRAY,brawlBall,Backyard Bowl,4,1,5
10375,2023-01-16,GRAY,bounty,Hideout,11,11,22
10376,2023-01-15,GRAY,knockout,Belle's Rock,83,95,178
10377,2023-01-15,GRAY,hotZone,Quarter Pounder,21,82,103
10378,2023-01-15,GRAY,heist,Bridge Too Far,3,0,3
10379,2023-01-15,GRAY,gemGrab,Hard Rock Mine,2,4,6
10380,2023-01-15,GRAY,gemGrab,Double Swoosh,8,7,15
10381,2023-01-15,GRAY,brawlBall,Super Beach,3,1,4
10382,2023-01-15,GRAY,brawlBall,Backyard Bowl,49,50,99
10383,2023-01-15,GRAY,bounty,Canal Grande,6,3,9
10384,2023-01-14,GRAY,knockout,Flaring Phoenix,43,60,103
10385,2023-01-14,GRAY,hotZone,Controller Chaos,9,0,9
10386,2023-01-14,GRAY,heist,Bridge Too Far,3,0,3
10387,2023-01-14,GRAY,gemGrab,Hard Rock Mine,3,1,4
10388,2023-01-14,GRAY,gemGrab,Deep Diner,8,6,14
10389,2023-01-14,GRAY,brawlBall,Super Beach,26,27,53
10390,2023-01-14,GRAY,bounty,Canal Grande,4,3,7
10391,2023-01-13,GRAY,knockout,Flaring Phoenix,33,38,71
10392,2023-01-13,GRAY,hotZone,Controller Chaos,3,3,6
10393,2023-01-13,GRAY,gemGrab,Deep Diner,7,23,30
10394,2023-01-13,GRAY,brawlBall,Sneaky Fields,12,42,54
10395,2023-01-13,GRAY,brawlBall,Pinhole Punt,0,1,1
10396,2023-01-13,GRAY,bounty,Temple Ruins,1,1,2
10397,2023-01-12,GRAY,knockout,Riverside,24,16,40
10398,2023-01-12,GRAY,hotZone,Open Zone,8,13,21
10399,2023-01-12,GRAY,heist,Hot Potato,1,0,1
10400,2023-01-12,GRAY,gemGrab,Undermine,7,17,24
10401,2023-01-12,GRAY,gemGrab,Gem Fort,2,8,10
10402,2023-01-12,GRAY,brawlBall,Sunny Soccer,5,6,11
10403,2023-01-12,GRAY,brawlBall,Pinhole Punt,14,14,28
10404,2023-01-11,GRAY,knockout,Riverside,7,8,15
10405,2023-01-11,GRAY,hotZone,Open Zone,2,0,2
10406,2023-01-11,GRAY,heist,Safe Zone,0,3,3
10407,2023-01-11,GRAY,gemGrab,Gem Fort,0,2,2
10408,2023-01-11,GRAY,brawlBall,Sunny Soccer,15,27,42
10409,2023-01-11,GRAY,bounty,Excel,2,0,2
10410,2023-01-10,GRAY,knockout,New Perspective,25,38,63
10411,2023-01-10,GRAY,hotZone,Dueling Beetles,12,30,42
10412,2023-01-10,GRAY,gemGrab,Minecart Madness,1,4,5
10413,2023-01-10,GRAY,gemGrab,Crystal Arcade,13,30,43
10414,2023-01-10,GRAY,brawlBall,Center Stage,4,0,4
10415,2023-01-10,GRAY,brawlBall,Beach Ball,48,54,102
10416,2023-01-10,GRAY,bounty,Excel,6,3,9
10417,2023-01-09,GRAY,knockout,New Perspective,51,60,111
10418,2023-01-09,GRAY,hotZone,Dueling Beetles,10,17,27
10419,2023-01-09,GRAY,gemGrab,Minecart Madness,21,37,58
10420,2023-01-09,GRAY,gemGrab,Double Swoosh,10,32,42
10421,2023-01-09,GRAY,brawlBall,Center Stage,40,28,68
10422,2023-01-09,GRAY,brawlBall,Backyard Bowl,11,35,46
10423,2023-01-09,GRAY,bounty,Layer Cake,12,12,24
10424,2023-01-08,GRAY,knockout,X Marks the Spot,61,100,161
10425,2023-01-08,GRAY,hotZone,Ring of Fire,3,0,3
10426,2023-01-08,GRAY,heist,Snaked Assault,1,12,13
10427,2023-01-08,GRAY,gemGrab,Hard Rock Mine,2,0,2
10428,2023-01-08,GRAY,gemGrab,Double Swoosh,9,14,23
10429,2023-01-08,GRAY,brawlBall,Super Beach,5,2,7
10430,2023-01-08,GRAY,brawlBall,Backyard Bowl,58,67,125
10431,2023-01-08,GRAY,bounty,Layer Cake,4,2,6
10432,2023-01-07,GRAY,knockout,X Marks the Spot,47,89,136
10433,2023-01-07,GRAY,hotZone,Ring of Fire,0,3,3
10434,2023-01-07,GRAY,heist,Tornado Ring,1,0,1
10435,2023-01-07,GRAY,gemGrab,Hard Rock Mine,7,35,42
10436,2023-01-07,GRAY,gemGrab,Deep Diner,10,21,31
10437,2023-01-07,GRAY,brawlBall,Super Beach,38,38,76
10438,2023-01-07,GRAY,brawlBall,Sneaky Fields,0,1,1
10439,2023-01-07,GRAY,bounty,Dry Season,10,4,14
10440,2023-01-06,GRAY,knockout,Out in the Open,86,137,223
10441,2023-01-06,GRAY,hotZone,Split,10,23,33
10442,2023-01-06,GRAY,heist,Tornado Ring,1,0,1
10443,2023-01-06,GRAY,gemGrab,Undermine,9,4,13
10444,2023-01-06,GRAY,gemGrab,Deep Diner,13,23,36
10445,2023-01-06,GRAY,brawlBall,Sneaky Fields,26,22,48
10446,2023-01-06,GRAY,brawlBall,Pinhole Punt,12,9,21
10447,2023-01-06,GRAY,bounty,Dry Season,14,6,20
10448,2023-01-05,GRAY,knockout,Out in the Open,126,201,327
10449,2023-01-05,GRAY,hotZone,Split,46,78,124
10450,2023-01-05,GRAY,heist,Kaboom Canyon,2,0,2
10451,2023-01-05,GRAY,gemGrab,Undermine,12,28,40
10452,2023-01-05,GRAY,gemGrab,Gem Fort,3,0,3
10453,2023-01-05,GRAY,brawlBall,Sunny Soccer,0,2,2
10454,2023-01-05,GRAY,brawlBall,Pinhole Punt,84,132,216
10455,2023-01-05,GRAY,bounty,Shooting Star,9,9,18
10456,2023-01-04,GRAY,knockout,Goldarm Gulch,24,14,38
10457,2023-01-04,GRAY,hotZone,Parallel Plays,2,3,5
10458,2023-01-04,GRAY,heist,Kaboom Canyon,1,5,6
10459,2023-01-04,GRAY,gemGrab,Gem Fort,9,33,42
10460,2023-01-04,GRAY,gemGrab,Crystal Arcade,8,9,17
10461,2023-01-04,GRAY,brawlBall,Sunny Soccer,95,161,256
10462,2023-01-04,GRAY,bounty,Shooting Star,5,8,13
10463,2023-01-03,GRAY,knockout,Goldarm Gulch,15,28,43
10464,2023-01-03,GRAY,hotZone,Parallel Plays,4,0,4
10465,2023-01-03,GRAY,gemGrab,Minecart Madness,3,2,5
10466,2023-01-03,GRAY,gemGrab,Crystal Arcade,15,81,96
10467,2023-01-03,GRAY,brawlBall,Center Stage,7,9,16
10468,2023-01-03,GRAY,brawlBall,Beach Ball,71,124,195
10469,2023-01-03,GRAY,bounty,Hideout,16,14,30
10470,2023-01-02,GRAY,knockout,Belle's Rock,44,49,93
10471,2023-01-02,GRAY,hotZone,Quarter Pounder,16,9,25
10472,2023-01-02,GRAY,heist,Pit Stop,1,0,1
10473,2023-01-02,GRAY,gemGrab,Minecart Madness,13,13,26
10474,2023-01-02,GRAY,gemGrab,Double Swoosh,15,22,37
10475,2023-01-02,GRAY,brawlBall,Center Stage,90,165,255
10476,2023-01-02,GRAY,brawlBall,Backyard Bowl,17,31,48
10477,2023-01-02,GRAY,bounty,Hideout,33,91,124
10478,2023-01-01,GRAY,knockout,Belle's Rock,16,24,40
10479,2023-01-01,GRAY,hotZone,Quarter Pounder,30,41,71
10480,2023-01-01,GRAY,heist,Bridge Too Far,0,1,1
10481,2023-01-01,GRAY,gemGrab,Double Swoosh,9,12,21
10482,2023-01-01,GRAY,brawlBall,Backyard Bowl,39,88,127
10483,2023-01-01,GRAY,bounty,Canal Grande,1,0,1
10484,2022-12-31,GRAY,knockout,Flaring Phoenix,1,1,2
10485,2022-12-31,GRAY,heist,Kaboom Canyon,1,1,2
10486,2022-12-31,GRAY,heist,Bridge Too Far,1,0,1
10487,2022-12-31,GRAY,gemGrab,Hard Rock Mine,9,15,24
10488,2022-12-31,GRAY,gemGrab,Deep Diner,3,4,7
10489,2022-12-31,GRAY,brawlBall,Super Beach,5,5,10
10490,2022-12-31,GRAY,brawlBall,Sneaky Fields,1,0,1
10491,2022-12-31,GRAY,bounty,Canal Grande,0,2,2
10492,2022-12-30,GRAY,knockout,Flaring Phoenix,4,8,12
10493,2022-12-30,GRAY,hotZone,Controller Chaos,2,1,3
10494,2022-12-30,GRAY,heist,Hot Potato,1,0,1
10495,2022-12-30,GRAY,gemGrab,Undermine,1,0,1
10496,2022-12-30,GRAY,gemGrab,Minecart Madness,1,0,1
10497,2022-12-30,GRAY,gemGrab,Deep Diner,7,14,21
10498,2022-12-30,GRAY,brawlBall,Sneaky Fields,15,26,41
10499,2022-12-29,GRAY,hotZone,Open Zone,1,0,1
10500,2022-12-29,GRAY,heist,Kaboom Canyon,0,1,1
10501,2022-12-29,GRAY,gemGrab,Undermine,2,8,10
10502,2022-12-29,GRAY,gemGrab,Minecart Madness,0,1,1
10503,2022-12-29,GRAY,brawlBall,Pinhole Punt,6,7,13
10504,2022-12-28,GRAY,hotZone,Open Zone,2,2,4
10505,2022-12-27,GRAY,knockout,New Perspective,3,0,3
10506,2022-12-27,GRAY,hotZone,Dueling Beetles,0,1,1
10507,2022-12-27,GRAY,hotZone,Controller Chaos,1,0,1
10508,2022-12-27,GRAY,gemGrab,Minecart Madness,0,2,2
10509,2022-12-27,GRAY,brawlBall,Beach Ball,3,10,13
10510,2022-12-27,GRAY,bounty,Excel,0,1,1
10511,2022-12-26,GRAY,hotZone,Controller Chaos,3,2,5
10512,2022-12-26,GRAY,heist,Kaboom Canyon,0,1,1
10513,2022-12-26,GRAY,gemGrab,Minecart Madness,1,2,3
10514,2022-12-26,GRAY,brawlBall,Center Stage,0,1,1
10515,2022-12-25,GRAY,hotZone,Ring of Fire,1,1,2
10516,2022-12-23,GRAY,knockout,Out in the Open,0,1,1
10517,2022-12-22,GRAY,brawlBall,Pinhole Punt,1,2,3
10518,2022-12-20,GRAY,brawlBall,Beach Ball,3,1,4
10519,2022-12-18,GRAY,knockout,Belle's Rock,0,1,1
10520,2022-12-17,GRAY,knockout,Flaring Phoenix,1,0,1
10521,2022-12-13,GRAY,knockout,New Perspective,2,0,2
10522,2022-12-13,GRAY,brawlBall,Beach Ball,2,5,7
10523,2023-02-05,GENE,knockout,X Marks the Spot,129,194,323
10524,2023-02-05,GENE,knockout,Goldarm Gulch,65,68,133
10525,2023-02-05,GENE,hotZone,Ring of Fire,17,4,21
10526,2023-02-05,GENE,heist,Snaked Assault,1,1,2
10527,2023-02-05,GENE,gemGrab,Hard Rock Mine,135,149,284
10528,2023-02-05,GENE,gemGrab,Double Swoosh,694,957,1651
10529,2023-02-05,GENE,brawlBall,Super Beach,1,2,3
10530,2023-02-05,GENE,brawlBall,Sneaky Fields,5,1,6
10531,2023-02-05,GENE,brawlBall,Backyard Bowl,393,409,802
10532,2023-02-05,GENE,bounty,Layer Cake,156,223,379
10533,2023-02-04,GENE,knockout,X Marks the Spot,58,68,126
10534,2023-02-04,GENE,knockout,Goldarm Gulch,62,49,111
10535,2023-02-04,GENE,hotZone,Ring of Fire,5,3,8
10536,2023-02-04,GENE,heist,Tornado Ring,2,0,2
10537,2023-02-04,GENE,gemGrab,Hard Rock Mine,148,105,253
10538,2023-02-04,GENE,gemGrab,Double Swoosh,61,191,252
10539,2023-02-04,GENE,gemGrab,Deep Diner,20,36,56
10540,2023-02-04,GENE,brawlBall,Super Beach,43,26,69
10541,2023-02-04,GENE,brawlBall,Sneaky Fields,3,0,3
10542,2023-02-04,GENE,bounty,Dry Season,44,46,90
10543,2023-02-03,GENE,knockout,Out in the Open,330,340,670
10544,2023-02-03,GENE,knockout,Goldarm Gulch,425,424,849
10545,2023-02-03,GENE,hotZone,Split,6,2,8
10546,2023-02-03,GENE,heist,Tornado Ring,6,2,8
10547,2023-02-03,GENE,heist,Pit Stop,1,0,1
10548,2023-02-03,GENE,gemGrab,Undermine,84,76,160
10549,2023-02-03,GENE,gemGrab,Double Swoosh,443,1294,1737
10550,2023-02-03,GENE,gemGrab,Deep Diner,433,414,847
10551,2023-02-03,GENE,brawlBall,Sneaky Fields,143,105,248
10552,2023-02-03,GENE,brawlBall,Pinhole Punt,9,6,15
10553,2023-02-03,GENE,bounty,Dry Season,554,620,1174
10554,2023-02-02,GENE,knockout,Out in the Open,123,146,269
10555,2023-02-02,GENE,hotZone,Split,6,2,8
10556,2023-02-02,GENE,heist,Kaboom Canyon,1,0,1
10557,2023-02-02,GENE,gemGrab,Undermine,79,71,150
10558,2023-02-02,GENE,gemGrab,Gem Fort,14,21,35
10559,2023-02-02,GENE,brawlBall,Sunny Soccer,0,1,1
10560,2023-02-02,GENE,brawlBall,Pinhole Punt,108,68,176
10561,2023-02-02,GENE,bounty,Shooting Star,55,54,109
10562,2023-02-01,GENE,knockout,Goldarm Gulch,284,266,550
10563,2023-02-01,GENE,hotZone,Parallel Plays,12,2,14
10564,2023-02-01,GENE,gemGrab,Gem Fort,152,170,322
10565,2023-02-01,GENE,gemGrab,Crystal Arcade,94,108,202
10566,2023-02-01,GENE,brawlBall,Sunny Soccer,100,99,199
10567,2023-02-01,GENE,brawlBall,Beach Ball,2,2,4
10568,2023-02-01,GENE,bounty,Shooting Star,153,161,314
10569,2023-01-31,GENE,knockout,Goldarm Gulch,121,122,243
10570,2023-01-31,GENE,hotZone,Parallel Plays,5,7,12
10571,2023-01-31,GENE,heist,Pit Stop,5,1,6
10572,2023-01-31,GENE,gemGrab,Minecart Madness,18,24,42
10573,2023-01-31,GENE,gemGrab,Crystal Arcade,155,191,346
10574,2023-01-31,GENE,brawlBall,Center Stage,7,7,14
10575,2023-01-31,GENE,brawlBall,Beach Ball,73,88,161
10576,2023-01-31,GENE,bounty,Hideout,38,30,68
10577,2023-01-30,GENE,knockout,Belle's Rock,216,238,454
10578,2023-01-30,GENE,hotZone,Quarter Pounder,15,3,18
10579,2023-01-30,GENE,heist,Pit Stop,1,0,1
10580,2023-01-30,GENE,gemGrab,Minecart Madness,176,160,336
10581,2023-01-30,GENE,gemGrab,Double Swoosh,269,359,628
10582,2023-01-30,GENE,brawlBall,Center Stage,99,65,164
10583,2023-01-30,GENE,brawlBall,Backyard Bowl,29,34,63
10584,2023-01-30,GENE,bounty,Hideout,100,105,205
10585,2023-01-29,GENE,knockout,Belle's Rock,275,305,580
10586,2023-01-29,GENE,hotZone,Quarter Pounder,10,10,20
10587,2023-01-29,GENE,heist,Bridge Too Far,9,1,10
10588,2023-01-29,GENE,gemGrab,Hard Rock Mine,58,68,126
10589,2023-01-29,GENE,gemGrab,Double Swoosh,506,534,1040
10590,2023-01-29,GENE,brawlBall,Backyard Bowl,371,395,766
10591,2023-01-29,GENE,bounty,Canal Grande,57,40,97
10592,2023-01-28,GENE,knockout,Flaring Phoenix,123,108,231
10593,2023-01-28,GENE,hotZone,Controller Chaos,10,5,15
10594,2023-01-28,GENE,heist,Bridge Too Far,9,4,13
10595,2023-01-28,GENE,gemGrab,Hard Rock Mine,388,374,762
10596,2023-01-28,GENE,gemGrab,Deep Diner,93,126,219
10597,2023-01-28,GENE,brawlBall,Super Beach,130,86,216
10598,2023-01-28,GENE,brawlBall,Sneaky Fields,7,7,14
10599,2023-01-28,GENE,bounty,Canal Grande,138,161,299
10600,2023-01-27,GENE,knockout,Flaring Phoenix,43,58,101
10601,2023-01-27,GENE,hotZone,Controller Chaos,3,5,8
10602,2023-01-27,GENE,heist,Hot Potato,1,0,1
10603,2023-01-27,GENE,gemGrab,Undermine,16,20,36
10604,2023-01-27,GENE,gemGrab,Deep Diner,123,133,256
10605,2023-01-27,GENE,brawlBall,Sneaky Fields,39,23,62
10606,2023-01-27,GENE,brawlBall,Pinhole Punt,1,1,2
10607,2023-01-27,GENE,bounty,Temple Ruins,30,72,102
10608,2023-01-26,GENE,knockout,Riverside,215,240,455
10609,2023-01-26,GENE,hotZone,Open Zone,29,3,32
10610,2023-01-26,GENE,heist,Hot Potato,1,2,3
10611,2023-01-26,GENE,gemGrab,Undermine,207,185,392
10612,2023-01-26,GENE,gemGrab,Gem Fort,74,87,161
10613,2023-01-26,GENE,brawlBall,Sunny Soccer,5,3,8
10614,2023-01-26,GENE,brawlBall,Pinhole Punt,246,217,463
10615,2023-01-26,GENE,bounty,Temple Ruins,100,152,252
10616,2023-01-25,GENE,knockout,Riverside,114,97,211
10617,2023-01-25,GENE,hotZone,Open Zone,12,6,18
10618,2023-01-25,GENE,heist,Safe Zone,4,2,6
10619,2023-01-25,GENE,gemGrab,Gem Fort,91,77,168
10620,2023-01-25,GENE,gemGrab,Crystal Arcade,140,136,276
10621,2023-01-25,GENE,brawlBall,Sunny Soccer,90,73,163
10622,2023-01-25,GENE,brawlBall,Beach Ball,18,13,31
10623,2023-01-25,GENE,bounty,Excel,68,91,159
10624,2023-01-24,GENE,knockout,New Perspective,112,93,205
10625,2023-01-24,GENE,hotZone,Dueling Beetles,5,8,13
10626,2023-01-24,GENE,heist,Safe Zone,7,3,10
10627,2023-01-24,GENE,gemGrab,Minecart Madness,57,66,123
10628,2023-01-24,GENE,gemGrab,Crystal Arcade,360,279,639
10629,2023-01-24,GENE,brawlBall,Center Stage,6,8,14
10630,2023-01-24,GENE,brawlBall,Beach Ball,158,153,311
10631,2023-01-24,GENE,bounty,Excel,160,244,404
10632,2023-01-23,GENE,knockout,New Perspective,164,179,343
10633,2023-01-23,GENE,hotZone,Dueling Beetles,9,1,10
10634,2023-01-23,GENE,heist,Snaked Assault,18,10,28
10635,2023-01-23,GENE,gemGrab,Minecart Madness,338,369,707
10636,2023-01-23,GENE,gemGrab,Double Swoosh,190,161,351
10637,2023-01-23,GENE,brawlBall,Center Stage,157,152,309
10638,2023-01-23,GENE,brawlBall,Backyard Bowl,30,32,62
10639,2023-01-23,GENE,bounty,Layer Cake,146,228,374
10640,2023-01-22,GENE,knockout,X Marks the Spot,152,178,330
10641,2023-01-22,GENE,hotZone,Ring of Fire,8,1,9
10642,2023-01-22,GENE,gemGrab,Hard Rock Mine,92,87,179
10643,2023-01-22,GENE,gemGrab,Double Swoosh,299,313,612
10644,2023-01-22,GENE,brawlBall,Super Beach,12,12,24
10645,2023-01-22,GENE,brawlBall,Backyard Bowl,173,174,347
10646,2023-01-22,GENE,bounty,Layer Cake,119,150,269
10647,2023-01-21,GENE,knockout,X Marks the Spot,451,562,1013
10648,2023-01-21,GENE,hotZone,Ring of Fire,20,3,23
10649,2023-01-21,GENE,heist,Tornado Ring,5,0,5
10650,2023-01-21,GENE,gemGrab,Hard Rock Mine,583,560,1143
10651,2023-01-21,GENE,gemGrab,Deep Diner,57,82,139
10652,2023-01-21,GENE,brawlBall,Super Beach,166,126,292
10653,2023-01-21,GENE,brawlBall,Sneaky Fields,12,4,16
10654,2023-01-21,GENE,bounty,Dry Season,239,362,601
10655,2023-01-20,GENE,knockout,Out in the Open,331,380,711
10656,2023-01-20,GENE,hotZone,Split,9,1,10
10657,2023-01-20,GENE,heist,Tornado Ring,1,0,1
10658,2023-01-20,GENE,gemGrab,Undermine,109,130,239
10659,2023-01-20,GENE,gemGrab,Deep Diner,362,338,700
10660,2023-01-20,GENE,brawlBall,Sneaky Fields,101,103,204
10661,2023-01-20,GENE,brawlBall,Pinhole Punt,5,7,12
10662,2023-01-20,GENE,bounty,Dry Season,261,316,577
10663,2023-01-19,GENE,knockout,Out in the Open,408,355,763
10664,2023-01-19,GENE,hotZone,Split,5,6,11
10665,2023-01-19,GENE,heist,Kaboom Canyon,6,2,8
10666,2023-01-19,GENE,gemGrab,Undermine,259,248,507
10667,2023-01-19,GENE,gemGrab,Gem Fort,39,33,72
10668,2023-01-19,GENE,brawlBall,Sunny Soccer,3,2,5
10669,2023-01-19,GENE,brawlBall,Pinhole Punt,206,189,395
10670,2023-01-19,GENE,bounty,Shooting Star,132,184,316
10671,2023-01-18,GENE,knockout,Goldarm Gulch,31,40,71
10672,2023-01-18,GENE,hotZone,Parallel Plays,2,2,4
10673,2023-01-18,GENE,heist,Kaboom Canyon,2,0,2
10674,2023-01-18,GENE,gemGrab,Gem Fort,51,47,98
10675,2023-01-18,GENE,gemGrab,Crystal Arcade,20,39,59
10676,2023-01-18,GENE,brawlBall,Sunny Soccer,30,57,87
10677,2023-01-18,GENE,brawlBall,Beach Ball,2,1,3
10678,2023-01-18,GENE,bounty,Shooting Star,65,87,152
10679,2023-01-17,GENE,knockout,Goldarm Gulch,34,31,65
10680,2023-01-17,GENE,hotZone,Parallel Plays,0,3,3
10681,2023-01-17,GENE,heist,Pit Stop,0,1,1
10682,2023-01-17,GENE,gemGrab,Minecart Madness,4,2,6
10683,2023-01-17,GENE,gemGrab,Crystal Arcade,24,31,55
10684,2023-01-17,GENE,brawlBall,Beach Ball,20,15,35
10685,2023-01-17,GENE,bounty,Hideout,14,9,23
10686,2023-01-16,GENE,knockout,Belle's Rock,19,20,39
10687,2023-01-16,GENE,gemGrab,Minecart Madness,25,24,49
10688,2023-01-16,GENE,gemGrab,Double Swoosh,24,55,79
10689,2023-01-16,GENE,brawlBall,Center Stage,7,8,15
10690,2023-01-16,GENE,brawlBall,Backyard Bowl,2,2,4
10691,2023-01-16,GENE,bounty,Hideout,13,17,30
10692,2023-01-15,GENE,knockout,Belle's Rock,42,33,75
10693,2023-01-15,GENE,hotZone,Quarter Pounder,3,0,3
10694,2023-01-15,GENE,heist,Bridge Too Far,1,0,1
10695,2023-01-15,GENE,gemGrab,Hard Rock Mine,30,29,59
10696,2023-01-15,GENE,gemGrab,Double Swoosh,89,71,160
10697,2023-01-15,GENE,brawlBall,Backyard Bowl,54,36,90
10698,2023-01-15,GENE,bounty,Canal Grande,13,10,23
10699,2023-01-14,GENE,knockout,Flaring Phoenix,11,22,33
10700,2023-01-14,GENE,hotZone,Controller Chaos,3,0,3
10701,2023-01-14,GENE,heist,Bridge Too Far,2,1,3
10702,2023-01-14,GENE,gemGrab,Hard Rock Mine,26,11,37
10703,2023-01-14,GENE,gemGrab,Deep Diner,25,32,57
10704,2023-01-14,GENE,brawlBall,Super Beach,11,4,15
10705,2023-01-14,GENE,brawlBall,Sneaky Fields,1,12,13
10706,2023-01-14,GENE,bounty,Canal Grande,8,4,12
10707,2023-01-13,GENE,knockout,Flaring Phoenix,19,11,30
10708,2023-01-13,GENE,gemGrab,Deep Diner,26,57,83
10709,2023-01-13,GENE,brawlBall,Sneaky Fields,8,19,27
10710,2023-01-13,GENE,brawlBall,Pinhole Punt,0,1,1
10711,2023-01-13,GENE,bounty,Temple Ruins,8,0,8
10712,2023-01-12,GENE,knockout,Riverside,17,7,24
10713,2023-01-12,GENE,hotZone,Open Zone,9,11,20
10714,2023-01-12,GENE,gemGrab,Undermine,21,19,40
10715,2023-01-12,GENE,gemGrab,Gem Fort,3,2,5
10716,2023-01-12,GENE,brawlBall,Pinhole Punt,7,3,10
10717,2023-01-11,GENE,knockout,Riverside,2,2,4
10718,2023-01-11,GENE,gemGrab,Gem Fort,14,22,36
10719,2023-01-11,GENE,brawlBall,Sunny Soccer,3,1,4
10720,2023-01-11,GENE,bounty,Excel,6,15,21
10721,2023-01-10,GENE,knockout,New Perspective,3,2,5
10722,2023-01-10,GENE,hotZone,Dueling Beetles,1,0,1
10723,2023-01-10,GENE,gemGrab,Minecart Madness,23,1,24
10724,2023-01-10,GENE,gemGrab,Crystal Arcade,18,14,32
10725,2023-01-10,GENE,brawlBall,Beach Ball,9,12,21
10726,2023-01-10,GENE,bounty,Excel,6,12,18
10727,2023-01-09,GENE,knockout,New Perspective,2,16,18
10728,2023-01-09,GENE,hotZone,Dueling Beetles,1,0,1
10729,2023-01-09,GENE,gemGrab,Minecart Madness,34,22,56
10730,2023-01-09,GENE,gemGrab,Double Swoosh,30,28,58
10731,2023-01-09,GENE,brawlBall,Center Stage,6,6,12
10732,2023-01-09,GENE,brawlBall,Backyard Bowl,0,1,1
10733,2023-01-09,GENE,bounty,Layer Cake,23,62,85
10734,2023-01-08,GENE,knockout,X Marks the Spot,25,41,66
10735,2023-01-08,GENE,hotZone,Ring of Fire,0,1,1
10736,2023-01-08,GENE,heist,Snaked Assault,1,0,1
10737,2023-01-08,GENE,gemGrab,Hard Rock Mine,18,12,30
10738,2023-01-08,GENE,gemGrab,Double Swoosh,29,31,60
10739,2023-01-08,GENE,brawlBall,Super Beach,2,0,2
10740,2023-01-08,GENE,brawlBall,Backyard Bowl,27,29,56
10741,2023-01-08,GENE,bounty,Layer Cake,29,53,82
10742,2023-01-07,GENE,knockout,X Marks the Spot,25,26,51
10743,2023-01-07,GENE,heist,Tornado Ring,1,0,1
10744,2023-01-07,GENE,gemGrab,Hard Rock Mine,38,28,66
10745,2023-01-07,GENE,gemGrab,Deep Diner,28,19,47
10746,2023-01-07,GENE,brawlBall,Super Beach,7,1,8
10747,2023-01-07,GENE,brawlBall,Sneaky Fields,1,0,1
10748,2023-01-07,GENE,bounty,Dry Season,44,60,104
10749,2023-01-06,GENE,knockout,Out in the Open,17,9,26
10750,2023-01-06,GENE,hotZone,Split,2,0,2
10751,2023-01-06,GENE,heist,Tornado Ring,2,0,2
10752,2023-01-06,GENE,gemGrab,Undermine,10,8,18
10753,2023-01-06,GENE,gemGrab,Deep Diner,51,35,86
10754,2023-01-06,GENE,brawlBall,Sneaky Fields,3,1,4
10755,2023-01-06,GENE,brawlBall,Pinhole Punt,0,2,2
10756,2023-01-06,GENE,bounty,Dry Season,77,106,183
10757,2023-01-05,GENE,knockout,Out in the Open,67,50,117
10758,2023-01-05,GENE,heist,Kaboom Canyon,1,0,1
10759,2023-01-05,GENE,gemGrab,Undermine,30,25,55
10760,2023-01-05,GENE,gemGrab,Gem Fort,4,1,5
10761,2023-01-05,GENE,brawlBall,Pinhole Punt,18,20,38
10762,2023-01-05,GENE,bounty,Shooting Star,24,13,37
10763,2023-01-04,GENE,knockout,Goldarm Gulch,18,32,50
10764,2023-01-04,GENE,hotZone,Parallel Plays,1,0,1
10765,2023-01-04,GENE,heist,Kaboom Canyon,1,0,1
10766,2023-01-04,GENE,gemGrab,Gem Fort,34,31,65
10767,2023-01-04,GENE,gemGrab,Crystal Arcade,12,3,15
10768,2023-01-04,GENE,brawlBall,Sunny Soccer,7,7,14
10769,2023-01-04,GENE,bounty,Shooting Star,57,30,87
10770,2023-01-03,GENE,knockout,Goldarm Gulch,6,11,17
10771,2023-01-03,GENE,hotZone,Parallel Plays,2,0,2
10772,2023-01-03,GENE,heist,Pit Stop,1,0,1
10773,2023-01-03,GENE,gemGrab,Minecart Madness,12,26,38
10774,2023-01-03,GENE,gemGrab,Crystal Arcade,72,88,160
10775,2023-01-03,GENE,brawlBall,Beach Ball,7,2,9
10776,2023-01-03,GENE,bounty,Hideout,23,24,47
10777,2023-01-02,GENE,knockout,Belle's Rock,35,28,63
10778,2023-01-02,GENE,hotZone,Quarter Pounder,4,5,9
10779,2023-01-02,GENE,heist,Pit Stop,1,0,1
10780,2023-01-02,GENE,gemGrab,Minecart Madness,48,27,75
10781,2023-01-02,GENE,gemGrab,Double Swoosh,69,83,152
10782,2023-01-02,GENE,brawlBall,Center Stage,23,5,28
10783,2023-01-02,GENE,brawlBall,Backyard Bowl,1,0,1
10784,2023-01-02,GENE,bounty,Hideout,69,48,117
10785,2023-01-01,GENE,knockout,Belle's Rock,30,16,46
10786,2023-01-01,GENE,hotZone,Quarter Pounder,4,14,18
10787,2023-01-01,GENE,hotZone,Controller Chaos,0,1,1
10788,2023-01-01,GENE,gemGrab,Hard Rock Mine,0,1,1
10789,2023-01-01,GENE,gemGrab,Double Swoosh,57,29,86
10790,2023-01-01,GENE,brawlBall,Backyard Bowl,10,20,30
10791,2023-01-01,GENE,bounty,Canal Grande,2,3,5
10792,2022-12-31,GENE,gemGrab,Hard Rock Mine,8,9,17
10793,2022-12-31,GENE,gemGrab,Deep Diner,11,4,15
10794,2022-12-31,GENE,brawlBall,Super Beach,2,0,2
10795,2022-12-31,GENE,bounty,Canal Grande,1,2,3
10796,2022-12-30,GENE,knockout,Flaring Phoenix,2,1,3
10797,2022-12-30,GENE,hotZone,Controller Chaos,0,1,1
10798,2022-12-30,GENE,gemGrab,Undermine,1,1,2
10799,2022-12-30,GENE,gemGrab,Deep Diner,7,8,15
10800,2022-12-29,GENE,gemGrab,Undermine,7,7,14
10801,2022-12-29,GENE,brawlBall,Pinhole Punt,1,0,1
10802,2022-12-27,GENE,gemGrab,Minecart Madness,0,2,2
10803,2022-12-26,GENE,gemGrab,Minecart Madness,0,2,2
10804,2022-12-25,GENE,gemGrab,Double Swoosh,1,0,1
10805,2022-12-23,GENE,knockout,Out in the Open,10,12,22
10806,2022-12-23,GENE,gemGrab,Deep Diner,1,0,1
10807,2022-12-22,GENE,gemGrab,Gem Fort,3,0,3
10808,2022-12-22,GENE,brawlBall,Pinhole Punt,1,0,1
10809,2022-12-21,GENE,bounty,Shooting Star,1,2,3
10810,2022-12-20,GENE,brawlBall,Beach Ball,1,0,1
10811,2022-12-19,GENE,brawlBall,Center Stage,0,1,1
10812,2022-12-17,GENE,knockout,Flaring Phoenix,0,1,1
10813,2022-12-13,GENE,gemGrab,Crystal Arcade,1,0,1
10814,2022-12-13,GENE,brawlBall,Beach Ball,0,1,1
10815,2022-12-10,GENE,knockout,X Marks the Spot,0,1,1
10816,2022-12-10,GENE,gemGrab,Hard Rock Mine,2,1,3
10817,2022-11-01,GENE,knockout,New Perspective,1,2,3
10818,2022-10-30,GENE,knockout,Out in the Open,1,2,3
10819,2022-10-30,GENE,bounty,Canal Grande,0,2,2
10820,2022-10-26,GENE,bounty,Shooting Star,0,1,1
10821,2022-10-15,GENE,gemGrab,Hard Rock Mine,0,2,2
10822,2022-10-10,GENE,knockout,Belle's Rock,0,3,3
10823,2023-02-05,GALE,knockout,X Marks the Spot,22,9,31
10824,2023-02-05,GALE,knockout,Goldarm Gulch,10,2,12
10825,2023-02-05,GALE,hotZone,Ring of Fire,34,22,56
10826,2023-02-05,GALE,heist,Snaked Assault,10,2,12
10827,2023-02-05,GALE,heist,Pit Stop,4,5,9
10828,2023-02-05,GALE,gemGrab,Hard Rock Mine,6,4,10
10829,2023-02-05,GALE,gemGrab,Double Swoosh,83,36,119
10830,2023-02-05,GALE,brawlBall,Super Beach,15,11,26
10831,2023-02-05,GALE,brawlBall,Sneaky Fields,84,56,140
10832,2023-02-05,GALE,brawlBall,Backyard Bowl,220,140,360
10833,2023-02-05,GALE,bounty,Layer Cake,5,3,8
10834,2023-02-04,GALE,knockout,X Marks the Spot,7,0,7
10835,2023-02-04,GALE,knockout,Goldarm Gulch,2,9,11
10836,2023-02-04,GALE,hotZone,Ring of Fire,6,8,14
10837,2023-02-04,GALE,heist,Tornado Ring,1,1,2
10838,2023-02-04,GALE,heist,Pit Stop,5,2,7
10839,2023-02-04,GALE,gemGrab,Hard Rock Mine,7,2,9
10840,2023-02-04,GALE,gemGrab,Double Swoosh,31,7,38
10841,2023-02-04,GALE,gemGrab,Deep Diner,1,0,1
10842,2023-02-04,GALE,brawlBall,Super Beach,84,75,159
10843,2023-02-04,GALE,brawlBall,Sneaky Fields,62,33,95
10844,2023-02-04,GALE,bounty,Dry Season,4,2,6
10845,2023-02-03,GALE,knockout,Out in the Open,28,19,47
10846,2023-02-03,GALE,knockout,Goldarm Gulch,16,5,21
10847,2023-02-03,GALE,hotZone,Split,115,199,314
10848,2023-02-03,GALE,heist,Tornado Ring,16,4,20
10849,2023-02-03,GALE,heist,Pit Stop,16,12,28
10850,2023-02-03,GALE,gemGrab,Undermine,10,12,22
10851,2023-02-03,GALE,gemGrab,Double Swoosh,225,47,272
10852,2023-02-03,GALE,gemGrab,Deep Diner,38,27,65
10853,2023-02-03,GALE,brawlBall,Sneaky Fields,731,539,1270
10854,2023-02-03,GALE,brawlBall,Pinhole Punt,15,7,22
10855,2023-02-03,GALE,bounty,Dry Season,16,2,18
10856,2023-02-02,GALE,knockout,Out in the Open,7,10,17
10857,2023-02-02,GALE,hotZone,Split,87,129,216
10858,2023-02-02,GALE,heist,Kaboom Canyon,4,6,10
10859,2023-02-02,GALE,gemGrab,Undermine,5,4,9
10860,2023-02-02,GALE,gemGrab,Gem Fort,3,0,3
10861,2023-02-02,GALE,brawlBall,Sunny Soccer,1,2,3
10862,2023-02-02,GALE,brawlBall,Pinhole Punt,121,125,246
10863,2023-02-02,GALE,bounty,Shooting Star,2,3,5
10864,2023-02-01,GALE,knockout,Goldarm Gulch,29,18,47
10865,2023-02-01,GALE,hotZone,Parallel Plays,111,145,256
10866,2023-02-01,GALE,heist,Kaboom Canyon,14,12,26
10867,2023-02-01,GALE,gemGrab,Gem Fort,43,29,72
10868,2023-02-01,GALE,gemGrab,Crystal Arcade,15,12,27
10869,2023-02-01,GALE,brawlBall,Sunny Soccer,301,275,576
10870,2023-02-01,GALE,brawlBall,Beach Ball,13,18,31
10871,2023-02-01,GALE,bounty,Shooting Star,5,0,5
10872,2023-01-31,GALE,knockout,Goldarm Gulch,14,12,26
10873,2023-01-31,GALE,hotZone,Parallel Plays,54,67,121
10874,2023-01-31,GALE,heist,Pit Stop,4,1,5
10875,2023-01-31,GALE,gemGrab,Minecart Madness,5,0,5
10876,2023-01-31,GALE,gemGrab,Crystal Arcade,17,20,37
10877,2023-01-31,GALE,brawlBall,Center Stage,3,4,7
10878,2023-01-31,GALE,brawlBall,Beach Ball,144,88,232
10879,2023-01-31,GALE,bounty,Hideout,3,2,5
10880,2023-01-30,GALE,knockout,Belle's Rock,24,9,33
10881,2023-01-30,GALE,hotZone,Quarter Pounder,69,67,136
10882,2023-01-30,GALE,heist,Pit Stop,2,2,4
10883,2023-01-30,GALE,gemGrab,Minecart Madness,25,22,47
10884,2023-01-30,GALE,gemGrab,Double Swoosh,24,17,41
10885,2023-01-30,GALE,brawlBall,Center Stage,350,338,688
10886,2023-01-30,GALE,brawlBall,Backyard Bowl,19,13,32
10887,2023-01-30,GALE,bounty,Hideout,3,0,3
10888,2023-01-29,GALE,knockout,Belle's Rock,38,23,61
10889,2023-01-29,GALE,hotZone,Quarter Pounder,56,36,92
10890,2023-01-29,GALE,heist,Bridge Too Far,4,4,8
10891,2023-01-29,GALE,gemGrab,Hard Rock Mine,8,3,11
10892,2023-01-29,GALE,gemGrab,Double Swoosh,39,30,69
10893,2023-01-29,GALE,brawlBall,Super Beach,3,4,7
10894,2023-01-29,GALE,brawlBall,Backyard Bowl,255,197,452
10895,2023-01-29,GALE,bounty,Canal Grande,5,4,9
10896,2023-01-28,GALE,knockout,Flaring Phoenix,18,5,23
10897,2023-01-28,GALE,hotZone,Controller Chaos,76,85,161
10898,2023-01-28,GALE,heist,Bridge Too Far,13,4,17
10899,2023-01-28,GALE,gemGrab,Hard Rock Mine,27,34,61
10900,2023-01-28,GALE,gemGrab,Deep Diner,9,3,12
10901,2023-01-28,GALE,brawlBall,Super Beach,386,360,746
10902,2023-01-28,GALE,brawlBall,Sneaky Fields,20,8,28
10903,2023-01-28,GALE,bounty,Canal Grande,13,10,23
10904,2023-01-27,GALE,knockout,Flaring Phoenix,11,5,16
10905,2023-01-27,GALE,hotZone,Controller Chaos,16,10,26
10906,2023-01-27,GALE,heist,Hot Potato,5,0,5
10907,2023-01-27,GALE,gemGrab,Undermine,2,2,4
10908,2023-01-27,GALE,gemGrab,Deep Diner,17,7,24
10909,2023-01-27,GALE,brawlBall,Sneaky Fields,144,131,275
10910,2023-01-27,GALE,brawlBall,Pinhole Punt,10,7,17
10911,2023-01-27,GALE,bounty,Temple Ruins,7,1,8
10912,2023-01-26,GALE,knockout,Riverside,16,4,20
10913,2023-01-26,GALE,hotZone,Open Zone,37,11,48
10914,2023-01-26,GALE,heist,Hot Potato,14,8,22
10915,2023-01-26,GALE,gemGrab,Undermine,29,43,72
10916,2023-01-26,GALE,gemGrab,Gem Fort,21,18,39
10917,2023-01-26,GALE,brawlBall,Sunny Soccer,21,36,57
10918,2023-01-26,GALE,brawlBall,Pinhole Punt,389,314,703
10919,2023-01-26,GALE,bounty,Temple Ruins,13,19,32
10920,2023-01-25,GALE,knockout,Riverside,5,3,8
10921,2023-01-25,GALE,hotZone,Open Zone,17,9,26
10922,2023-01-25,GALE,heist,Safe Zone,7,5,12
10923,2023-01-25,GALE,gemGrab,Gem Fort,28,17,45
10924,2023-01-25,GALE,gemGrab,Crystal Arcade,18,6,24
10925,2023-01-25,GALE,brawlBall,Sunny Soccer,237,205,442
10926,2023-01-25,GALE,brawlBall,Beach Ball,33,46,79
10927,2023-01-25,GALE,bounty,Excel,4,11,15
10928,2023-01-24,GALE,knockout,New Perspective,30,16,46
10929,2023-01-24,GALE,hotZone,Dueling Beetles,24,18,42
10930,2023-01-24,GALE,heist,Safe Zone,15,4,19
10931,2023-01-24,GALE,gemGrab,Minecart Madness,14,8,22
10932,2023-01-24,GALE,gemGrab,Crystal Arcade,34,27,61
10933,2023-01-24,GALE,brawlBall,Center Stage,50,69,119
10934,2023-01-24,GALE,brawlBall,Beach Ball,360,283,643
10935,2023-01-24,GALE,bounty,Excel,15,12,27
10936,2023-01-23,GALE,knockout,New Perspective,41,27,68
10937,2023-01-23,GALE,hotZone,Dueling Beetles,61,53,114
10938,2023-01-23,GALE,heist,Snaked Assault,10,5,15
10939,2023-01-23,GALE,gemGrab,Minecart Madness,50,30,80
10940,2023-01-23,GALE,gemGrab,Double Swoosh,14,21,35
10941,2023-01-23,GALE,brawlBall,Center Stage,633,714,1347
10942,2023-01-23,GALE,brawlBall,Backyard Bowl,11,6,17
10943,2023-01-23,GALE,bounty,Layer Cake,12,7,19
10944,2023-01-22,GALE,knockout,X Marks the Spot,12,6,18
10945,2023-01-22,GALE,hotZone,Ring of Fire,11,1,12
10946,2023-01-22,GALE,heist,Snaked Assault,7,6,13
10947,2023-01-22,GALE,gemGrab,Hard Rock Mine,9,5,14
10948,2023-01-22,GALE,gemGrab,Double Swoosh,17,16,33
10949,2023-01-22,GALE,brawlBall,Super Beach,37,15,52
10950,2023-01-22,GALE,brawlBall,Backyard Bowl,104,85,189
10951,2023-01-22,GALE,bounty,Layer Cake,4,3,7
10952,2023-01-21,GALE,knockout,X Marks the Spot,50,34,84
10953,2023-01-21,GALE,hotZone,Ring of Fire,35,15,50
10954,2023-01-21,GALE,heist,Tornado Ring,11,0,11
10955,2023-01-21,GALE,gemGrab,Hard Rock Mine,43,63,106
10956,2023-01-21,GALE,gemGrab,Deep Diner,11,7,18
10957,2023-01-21,GALE,brawlBall,Super Beach,488,413,901
10958,2023-01-21,GALE,brawlBall,Sneaky Fields,18,15,33
10959,2023-01-21,GALE,bounty,Dry Season,10,0,10
10960,2023-01-20,GALE,knockout,Out in the Open,37,40,77
10961,2023-01-20,GALE,hotZone,Split,109,229,338
10962,2023-01-20,GALE,heist,Tornado Ring,12,4,16
10963,2023-01-20,GALE,gemGrab,Undermine,23,18,41
10964,2023-01-20,GALE,gemGrab,Deep Diner,35,33,68
10965,2023-01-20,GALE,brawlBall,Sneaky Fields,359,310,669
10966,2023-01-20,GALE,brawlBall,Pinhole Punt,11,10,21
10967,2023-01-20,GALE,bounty,Dry Season,10,3,13
10968,2023-01-19,GALE,knockout,Out in the Open,47,19,66
10969,2023-01-19,GALE,hotZone,Split,157,232,389
10970,2023-01-19,GALE,heist,Kaboom Canyon,23,26,49
10971,2023-01-19,GALE,gemGrab,Undermine,41,27,68
10972,2023-01-19,GALE,gemGrab,Gem Fort,6,5,11
10973,2023-01-19,GALE,brawlBall,Sunny Soccer,14,15,29
10974,2023-01-19,GALE,brawlBall,Pinhole Punt,416,354,770
10975,2023-01-19,GALE,bounty,Shooting Star,14,5,19
10976,2023-01-18,GALE,knockout,Goldarm Gulch,0,6,6
10977,2023-01-18,GALE,hotZone,Parallel Plays,7,5,12
10978,2023-01-18,GALE,heist,Kaboom Canyon,10,11,21
10979,2023-01-18,GALE,gemGrab,Gem Fort,9,8,17
10980,2023-01-18,GALE,gemGrab,Crystal Arcade,8,3,11
10981,2023-01-18,GALE,brawlBall,Sunny Soccer,116,87,203
10982,2023-01-18,GALE,brawlBall,Beach Ball,2,4,6
10983,2023-01-18,GALE,bounty,Shooting Star,6,1,7
10984,2023-01-17,GALE,knockout,Goldarm Gulch,9,2,11
10985,2023-01-17,GALE,hotZone,Parallel Plays,9,8,17
10986,2023-01-17,GALE,heist,Pit Stop,1,0,1
10987,2023-01-17,GALE,gemGrab,Minecart Madness,1,1,2
10988,2023-01-17,GALE,gemGrab,Crystal Arcade,1,1,2
10989,2023-01-17,GALE,brawlBall,Center Stage,3,3,6
10990,2023-01-17,GALE,brawlBall,Beach Ball,31,27,58
10991,2023-01-16,GALE,hotZone,Quarter Pounder,9,1,10
10992,2023-01-16,GALE,heist,Pit Stop,8,1,9
10993,2023-01-16,GALE,gemGrab,Minecart Madness,3,3,6
10994,2023-01-16,GALE,gemGrab,Double Swoosh,2,3,5
10995,2023-01-16,GALE,brawlBall,Center Stage,38,43,81
10996,2023-01-16,GALE,brawlBall,Backyard Bowl,3,2,5
10997,2023-01-15,GALE,knockout,Belle's Rock,4,1,5
10998,2023-01-15,GALE,hotZone,Quarter Pounder,11,12,23
10999,2023-01-15,GALE,heist,Bridge Too Far,1,0,1
11000,2023-01-15,GALE,gemGrab,Hard Rock Mine,3,0,3
11001,2023-01-15,GALE,gemGrab,Double Swoosh,5,4,9
11002,2023-01-15,GALE,brawlBall,Super Beach,4,1,5
11003,2023-01-15,GALE,brawlBall,Backyard Bowl,31,18,49
11004,2023-01-15,GALE,bounty,Canal Grande,1,0,1
11005,2023-01-14,GALE,knockout,Flaring Phoenix,0,2,2
11006,2023-01-14,GALE,hotZone,Controller Chaos,25,11,36
11007,2023-01-14,GALE,heist,Bridge Too Far,2,2,4
11008,2023-01-14,GALE,gemGrab,Hard Rock Mine,1,0,1
11009,2023-01-14,GALE,brawlBall,Super Beach,29,11,40
11010,2023-01-14,GALE,brawlBall,Sneaky Fields,2,15,17
11011,2023-01-14,GALE,bounty,Canal Grande,0,1,1
11012,2023-01-13,GALE,knockout,Flaring Phoenix,3,0,3
11013,2023-01-13,GALE,hotZone,Controller Chaos,21,26,47
11014,2023-01-13,GALE,heist,Hot Potato,0,4,4
11015,2023-01-13,GALE,gemGrab,Deep Diner,6,3,9
11016,2023-01-13,GALE,brawlBall,Sneaky Fields,36,24,60
11017,2023-01-13,GALE,brawlBall,Pinhole Punt,1,0,1
11018,2023-01-12,GALE,knockout,Riverside,1,0,1
11019,2023-01-12,GALE,hotZone,Open Zone,6,10,16
11020,2023-01-12,GALE,heist,Hot Potato,1,0,1
11021,2023-01-12,GALE,gemGrab,Undermine,4,4,8
11022,2023-01-12,GALE,gemGrab,Gem Fort,2,0,2
11023,2023-01-12,GALE,brawlBall,Sunny Soccer,6,2,8
11024,2023-01-12,GALE,brawlBall,Pinhole Punt,10,9,19
11025,2023-01-11,GALE,hotZone,Open Zone,2,7,9
11026,2023-01-11,GALE,brawlBall,Sunny Soccer,10,8,18
11027,2023-01-10,GALE,hotZone,Dueling Beetles,11,0,11
11028,2023-01-10,GALE,gemGrab,Crystal Arcade,5,0,5
11029,2023-01-10,GALE,brawlBall,Center Stage,6,0,6
11030,2023-01-10,GALE,brawlBall,Beach Ball,15,16,31
11031,2023-01-09,GALE,knockout,New Perspective,1,0,1
11032,2023-01-09,GALE,hotZone,Dueling Beetles,5,0,5
11033,2023-01-09,GALE,heist,Snaked Assault,1,0,1
11034,2023-01-09,GALE,gemGrab,Minecart Madness,5,1,6
11035,2023-01-09,GALE,gemGrab,Double Swoosh,5,0,5
11036,2023-01-09,GALE,brawlBall,Center Stage,37,35,72
11037,2023-01-09,GALE,brawlBall,Backyard Bowl,4,3,7
11038,2023-01-09,GALE,bounty,Layer Cake,2,1,3
11039,2023-01-08,GALE,knockout,X Marks the Spot,2,0,2
11040,2023-01-08,GALE,hotZone,Ring of Fire,8,3,11
11041,2023-01-08,GALE,heist,Snaked Assault,0,1,1
11042,2023-01-08,GALE,gemGrab,Hard Rock Mine,1,0,1
11043,2023-01-08,GALE,gemGrab,Double Swoosh,1,0,1
11044,2023-01-08,GALE,brawlBall,Super Beach,2,2,4
11045,2023-01-08,GALE,brawlBall,Backyard Bowl,22,21,43
11046,2023-01-07,GALE,hotZone,Ring of Fire,3,0,3
11047,2023-01-07,GALE,heist,Tornado Ring,2,0,2
11048,2023-01-07,GALE,gemGrab,Hard Rock Mine,1,0,1
11049,2023-01-07,GALE,brawlBall,Super Beach,14,16,30
11050,2023-01-07,GALE,brawlBall,Sneaky Fields,3,2,5
11051,2023-01-06,GALE,knockout,Out in the Open,1,0,1
11052,2023-01-06,GALE,hotZone,Split,22,18,40
11053,2023-01-06,GALE,heist,Tornado Ring,1,0,1
11054,2023-01-06,GALE,gemGrab,Undermine,4,0,4
11055,2023-01-06,GALE,gemGrab,Deep Diner,6,1,7
11056,2023-01-06,GALE,brawlBall,Sneaky Fields,27,11,38
11057,2023-01-06,GALE,brawlBall,Pinhole Punt,1,0,1
11058,2023-01-05,GALE,knockout,Out in the Open,3,3,6
11059,2023-01-05,GALE,hotZone,Split,111,126,237
11060,2023-01-05,GALE,heist,Kaboom Canyon,2,6,8
11061,2023-01-05,GALE,gemGrab,Undermine,7,0,7
11062,2023-01-05,GALE,gemGrab,Gem Fort,2,0,2
11063,2023-01-05,GALE,brawlBall,Pinhole Punt,56,48,104
11064,2023-01-04,GALE,knockout,Goldarm Gulch,1,0,1
11065,2023-01-04,GALE,hotZone,Parallel Plays,8,2,10
11066,2023-01-04,GALE,heist,Kaboom Canyon,7,7,14
11067,2023-01-04,GALE,gemGrab,Gem Fort,2,0,2
11068,2023-01-04,GALE,gemGrab,Crystal Arcade,2,0,2
11069,2023-01-04,GALE,brawlBall,Sunny Soccer,32,22,54
11070,2023-01-04,GALE,bounty,Shooting Star,2,0,2
11071,2023-01-03,GALE,knockout,Goldarm Gulch,3,0,3
11072,2023-01-03,GALE,hotZone,Parallel Plays,18,25,43
11073,2023-01-03,GALE,heist,Pit Stop,4,0,4
11074,2023-01-03,GALE,gemGrab,Minecart Madness,1,0,1
11075,2023-01-03,GALE,gemGrab,Crystal Arcade,2,0,2
11076,2023-01-03,GALE,brawlBall,Center Stage,1,0,1
11077,2023-01-03,GALE,brawlBall,Beach Ball,37,26,63
11078,2023-01-02,GALE,knockout,Belle's Rock,2,0,2
11079,2023-01-02,GALE,hotZone,Quarter Pounder,14,3,17
11080,2023-01-02,GALE,heist,Pit Stop,1,2,3
11081,2023-01-02,GALE,gemGrab,Minecart Madness,8,9,17
11082,2023-01-02,GALE,gemGrab,Double Swoosh,5,14,19
11083,2023-01-02,GALE,brawlBall,Center Stage,53,38,91
11084,2023-01-02,GALE,brawlBall,Backyard Bowl,1,1,2
11085,2023-01-02,GALE,bounty,Hideout,1,1,2
11086,2023-01-01,GALE,hotZone,Quarter Pounder,8,0,8
11087,2023-01-01,GALE,hotZone,Controller Chaos,1,0,1
11088,2023-01-01,GALE,gemGrab,Double Swoosh,2,0,2
11089,2023-01-01,GALE,brawlBall,Backyard Bowl,17,1,18
11090,2022-12-31,GALE,hotZone,Controller Chaos,1,2,3
11091,2022-12-31,GALE,brawlBall,Super Beach,4,1,5
11092,2022-12-31,GALE,bounty,Canal Grande,1,2,3
11093,2022-12-30,GALE,hotZone,Controller Chaos,3,1,4
11094,2022-12-30,GALE,gemGrab,Undermine,1,0,1
11095,2022-12-30,GALE,brawlBall,Sneaky Fields,0,3,3
11096,2022-12-29,GALE,gemGrab,Undermine,1,0,1
11097,2022-12-29,GALE,gemGrab,Gem Fort,0,1,1
11098,2022-12-29,GALE,brawlBall,Pinhole Punt,2,2,4
11099,2022-12-28,GALE,hotZone,Open Zone,1,0,1
11100,2022-12-27,GALE,hotZone,Dueling Beetles,1,0,1
11101,2022-12-27,GALE,gemGrab,Minecart Madness,2,0,2
11102,2022-12-26,GALE,heist,Kaboom Canyon,1,0,1
11103,2022-12-26,GALE,gemGrab,Minecart Madness,2,0,2
11104,2022-12-26,GALE,brawlBall,Center Stage,0,1,1
11105,2022-12-24,GALE,brawlBall,Super Beach,1,1,2
11106,2022-12-23,GALE,brawlBall,Sneaky Fields,1,0,1
11107,2022-12-22,GALE,heist,Kaboom Canyon,1,0,1
11108,2022-12-22,GALE,gemGrab,Gem Fort,1,0,1
11109,2022-12-22,GALE,brawlBall,Pinhole Punt,2,1,3
11110,2022-12-21,GALE,brawlBall,Sunny Soccer,0,1,1
11111,2022-12-20,GALE,brawlBall,Beach Ball,1,0,1
11112,2022-12-19,GALE,brawlBall,Center Stage,1,0,1
11113,2022-12-17,GALE,brawlBall,Super Beach,1,0,1
11114,2022-12-16,GALE,brawlBall,Sneaky Fields,1,0,1
11115,2022-12-13,GALE,knockout,New Perspective,1,0,1
11116,2022-12-13,GALE,brawlBall,Beach Ball,2,0,2
11117,2022-12-11,GALE,brawlBall,Backyard Bowl,2,1,3
11118,2022-11-11,GALE,knockout,New Perspective,1,0,1
11119,2022-11-11,GALE,brawlBall,Sneaky Fields,1,0,1
11120,2022-10-30,GALE,knockout,Out in the Open,0,2,2
11121,2022-10-15,GALE,gemGrab,Hard Rock Mine,2,0,2
11122,2023-02-05,FRANK,knockout,X Marks the Spot,14,3,17
11123,2023-02-05,FRANK,knockout,Goldarm Gulch,6,9,15
11124,2023-02-05,FRANK,hotZone,Ring of Fire,23,21,44
11125,2023-02-05,FRANK,heist,Snaked Assault,44,53,97
11126,2023-02-05,FRANK,heist,Pit Stop,7,1,8
11127,2023-02-05,FRANK,gemGrab,Hard Rock Mine,13,10,23
11128,2023-02-05,FRANK,gemGrab,Double Swoosh,116,74,190
11129,2023-02-05,FRANK,brawlBall,Super Beach,28,22,50
11130,2023-02-05,FRANK,brawlBall,Sneaky Fields,101,62,163
11131,2023-02-05,FRANK,brawlBall,Backyard Bowl,354,334,688
11132,2023-02-05,FRANK,bounty,Layer Cake,8,6,14
11133,2023-02-04,FRANK,knockout,X Marks the Spot,2,1,3
11134,2023-02-04,FRANK,knockout,Goldarm Gulch,4,5,9
11135,2023-02-04,FRANK,hotZone,Ring of Fire,1,3,4
11136,2023-02-04,FRANK,heist,Tornado Ring,7,6,13
11137,2023-02-04,FRANK,heist,Pit Stop,7,0,7
11138,2023-02-04,FRANK,gemGrab,Hard Rock Mine,7,7,14
11139,2023-02-04,FRANK,gemGrab,Double Swoosh,33,5,38
11140,2023-02-04,FRANK,gemGrab,Deep Diner,3,3,6
11141,2023-02-04,FRANK,brawlBall,Super Beach,177,163,340
11142,2023-02-04,FRANK,brawlBall,Sneaky Fields,87,51,138
11143,2023-02-04,FRANK,bounty,Dry Season,2,1,3
11144,2023-02-03,FRANK,knockout,Out in the Open,13,18,31
11145,2023-02-03,FRANK,knockout,Goldarm Gulch,13,15,28
11146,2023-02-03,FRANK,hotZone,Split,142,199,341
11147,2023-02-03,FRANK,heist,Tornado Ring,65,51,116
11148,2023-02-03,FRANK,heist,Pit Stop,19,18,37
11149,2023-02-03,FRANK,gemGrab,Undermine,8,12,20
11150,2023-02-03,FRANK,gemGrab,Double Swoosh,253,60,313
11151,2023-02-03,FRANK,gemGrab,Deep Diner,34,34,68
11152,2023-02-03,FRANK,brawlBall,Sneaky Fields,1754,1302,3056
11153,2023-02-03,FRANK,brawlBall,Pinhole Punt,25,29,54
11154,2023-02-03,FRANK,bounty,Dry Season,9,6,15
11155,2023-02-02,FRANK,knockout,Out in the Open,10,4,14
11156,2023-02-02,FRANK,hotZone,Split,103,119,222
11157,2023-02-02,FRANK,heist,Kaboom Canyon,4,1,5
11158,2023-02-02,FRANK,gemGrab,Undermine,2,6,8
11159,2023-02-02,FRANK,gemGrab,Gem Fort,3,5,8
11160,2023-02-02,FRANK,brawlBall,Sunny Soccer,6,6,12
11161,2023-02-02,FRANK,brawlBall,Pinhole Punt,157,153,310
11162,2023-02-02,FRANK,bounty,Shooting Star,5,1,6
11163,2023-02-01,FRANK,knockout,Goldarm Gulch,18,11,29
11164,2023-02-01,FRANK,hotZone,Parallel Plays,80,58,138
11165,2023-02-01,FRANK,heist,Kaboom Canyon,6,5,11
11166,2023-02-01,FRANK,gemGrab,Gem Fort,35,34,69
11167,2023-02-01,FRANK,gemGrab,Crystal Arcade,9,4,13
11168,2023-02-01,FRANK,brawlBall,Sunny Soccer,663,559,1222
11169,2023-02-01,FRANK,brawlBall,Beach Ball,20,14,34
11170,2023-02-01,FRANK,bounty,Shooting Star,2,0,2
11171,2023-01-31,FRANK,knockout,Goldarm Gulch,13,11,24
11172,2023-01-31,FRANK,hotZone,Parallel Plays,50,63,113
11173,2023-01-31,FRANK,heist,Pit Stop,14,19,33
11174,2023-01-31,FRANK,gemGrab,Minecart Madness,1,1,2
11175,2023-01-31,FRANK,gemGrab,Crystal Arcade,12,22,34
11176,2023-01-31,FRANK,brawlBall,Center Stage,10,13,23
11177,2023-01-31,FRANK,brawlBall,Beach Ball,262,248,510
11178,2023-01-31,FRANK,bounty,Hideout,4,0,4
11179,2023-01-30,FRANK,knockout,Belle's Rock,25,28,53
11180,2023-01-30,FRANK,hotZone,Quarter Pounder,72,63,135
11181,2023-01-30,FRANK,heist,Pit Stop,55,73,128
11182,2023-01-30,FRANK,gemGrab,Minecart Madness,18,9,27
11183,2023-01-30,FRANK,gemGrab,Double Swoosh,23,15,38
11184,2023-01-30,FRANK,brawlBall,Center Stage,708,666,1374
11185,2023-01-30,FRANK,brawlBall,Backyard Bowl,32,44,76
11186,2023-01-30,FRANK,bounty,Hideout,3,0,3
11187,2023-01-29,FRANK,knockout,Belle's Rock,21,13,34
11188,2023-01-29,FRANK,hotZone,Quarter Pounder,56,33,89
11189,2023-01-29,FRANK,heist,Bridge Too Far,13,7,20
11190,2023-01-29,FRANK,gemGrab,Hard Rock Mine,9,9,18
11191,2023-01-29,FRANK,gemGrab,Double Swoosh,46,36,82
11192,2023-01-29,FRANK,brawlBall,Super Beach,8,8,16
11193,2023-01-29,FRANK,brawlBall,Backyard Bowl,393,325,718
11194,2023-01-29,FRANK,bounty,Canal Grande,7,8,15
11195,2023-01-28,FRANK,knockout,Flaring Phoenix,19,9,28
11196,2023-01-28,FRANK,hotZone,Controller Chaos,94,46,140
11197,2023-01-28,FRANK,heist,Bridge Too Far,21,22,43
11198,2023-01-28,FRANK,gemGrab,Hard Rock Mine,38,18,56
11199,2023-01-28,FRANK,gemGrab,Deep Diner,4,4,8
11200,2023-01-28,FRANK,brawlBall,Super Beach,835,770,1605
11201,2023-01-28,FRANK,brawlBall,Sneaky Fields,40,47,87
11202,2023-01-28,FRANK,bounty,Canal Grande,25,16,41
11203,2023-01-27,FRANK,knockout,Flaring Phoenix,4,4,8
11204,2023-01-27,FRANK,hotZone,Controller Chaos,18,56,74
11205,2023-01-27,FRANK,heist,Hot Potato,10,8,18
11206,2023-01-27,FRANK,gemGrab,Undermine,2,1,3
11207,2023-01-27,FRANK,gemGrab,Deep Diner,10,7,17
11208,2023-01-27,FRANK,brawlBall,Sneaky Fields,273,294,567
11209,2023-01-27,FRANK,brawlBall,Pinhole Punt,5,2,7
11210,2023-01-27,FRANK,bounty,Temple Ruins,2,0,2
11211,2023-01-26,FRANK,knockout,Riverside,6,6,12
11212,2023-01-26,FRANK,hotZone,Open Zone,20,16,36
11213,2023-01-26,FRANK,heist,Hot Potato,22,10,32
11214,2023-01-26,FRANK,gemGrab,Undermine,34,47,81
11215,2023-01-26,FRANK,gemGrab,Gem Fort,12,12,24
11216,2023-01-26,FRANK,brawlBall,Sunny Soccer,46,31,77
11217,2023-01-26,FRANK,brawlBall,Pinhole Punt,577,529,1106
11218,2023-01-26,FRANK,bounty,Temple Ruins,10,8,18
11219,2023-01-25,FRANK,knockout,Riverside,7,3,10
11220,2023-01-25,FRANK,hotZone,Open Zone,8,5,13
11221,2023-01-25,FRANK,heist,Safe Zone,11,1,12
11222,2023-01-25,FRANK,gemGrab,Gem Fort,24,21,45
11223,2023-01-25,FRANK,gemGrab,Crystal Arcade,24,28,52
11224,2023-01-25,FRANK,brawlBall,Sunny Soccer,444,388,832
11225,2023-01-25,FRANK,brawlBall,Beach Ball,64,63,127
11226,2023-01-25,FRANK,bounty,Excel,6,2,8
11227,2023-01-24,FRANK,knockout,New Perspective,14,14,28
11228,2023-01-24,FRANK,hotZone,Dueling Beetles,77,57,134
11229,2023-01-24,FRANK,heist,Safe Zone,14,15,29
11230,2023-01-24,FRANK,gemGrab,Minecart Madness,3,2,5
11231,2023-01-24,FRANK,gemGrab,Crystal Arcade,31,24,55
11232,2023-01-24,FRANK,brawlBall,Center Stage,91,83,174
11233,2023-01-24,FRANK,brawlBall,Beach Ball,727,653,1380
11234,2023-01-24,FRANK,bounty,Excel,15,12,27
11235,2023-01-23,FRANK,knockout,New Perspective,24,23,47
11236,2023-01-23,FRANK,hotZone,Dueling Beetles,85,57,142
11237,2023-01-23,FRANK,heist,Snaked Assault,69,68,137
11238,2023-01-23,FRANK,gemGrab,Minecart Madness,25,13,38
11239,2023-01-23,FRANK,gemGrab,Double Swoosh,17,19,36
11240,2023-01-23,FRANK,brawlBall,Center Stage,1074,1019,2093
11241,2023-01-23,FRANK,brawlBall,Backyard Bowl,24,27,51
11242,2023-01-23,FRANK,bounty,Layer Cake,17,22,39
11243,2023-01-22,FRANK,knockout,X Marks the Spot,11,6,17
11244,2023-01-22,FRANK,hotZone,Ring of Fire,22,25,47
11245,2023-01-22,FRANK,heist,Snaked Assault,18,23,41
11246,2023-01-22,FRANK,gemGrab,Hard Rock Mine,6,6,12
11247,2023-01-22,FRANK,gemGrab,Double Swoosh,41,40,81
11248,2023-01-22,FRANK,brawlBall,Super Beach,85,67,152
11249,2023-01-22,FRANK,brawlBall,Backyard Bowl,161,147,308
11250,2023-01-22,FRANK,bounty,Layer Cake,17,21,38
11251,2023-01-21,FRANK,knockout,X Marks the Spot,38,33,71
11252,2023-01-21,FRANK,hotZone,Ring of Fire,59,70,129
11253,2023-01-21,FRANK,heist,Tornado Ring,48,44,92
11254,2023-01-21,FRANK,gemGrab,Hard Rock Mine,41,27,68
11255,2023-01-21,FRANK,gemGrab,Deep Diner,11,6,17
11256,2023-01-21,FRANK,brawlBall,Super Beach,1104,1042,2146
11257,2023-01-21,FRANK,brawlBall,Sneaky Fields,42,50,92
11258,2023-01-21,FRANK,bounty,Dry Season,8,6,14
11259,2023-01-20,FRANK,knockout,Out in the Open,14,7,21
11260,2023-01-20,FRANK,hotZone,Split,160,248,408
11261,2023-01-20,FRANK,heist,Tornado Ring,51,50,101
11262,2023-01-20,FRANK,gemGrab,Undermine,14,6,20
11263,2023-01-20,FRANK,gemGrab,Deep Diner,23,34,57
11264,2023-01-20,FRANK,brawlBall,Sneaky Fields,999,957,1956
11265,2023-01-20,FRANK,brawlBall,Pinhole Punt,24,26,50
11266,2023-01-20,FRANK,bounty,Dry Season,7,4,11
11267,2023-01-19,FRANK,knockout,Out in the Open,21,12,33
11268,2023-01-19,FRANK,hotZone,Split,182,301,483
11269,2023-01-19,FRANK,heist,Kaboom Canyon,15,4,19
11270,2023-01-19,FRANK,gemGrab,Undermine,48,29,77
11271,2023-01-19,FRANK,gemGrab,Gem Fort,9,8,17
11272,2023-01-19,FRANK,brawlBall,Sunny Soccer,24,17,41
11273,2023-01-19,FRANK,brawlBall,Pinhole Punt,590,505,1095
11274,2023-01-19,FRANK,bounty,Shooting Star,12,25,37
11275,2023-01-18,FRANK,knockout,Goldarm Gulch,6,7,13
11276,2023-01-18,FRANK,hotZone,Parallel Plays,6,2,8
11277,2023-01-18,FRANK,heist,Kaboom Canyon,5,0,5
11278,2023-01-18,FRANK,gemGrab,Gem Fort,15,9,24
11279,2023-01-18,FRANK,gemGrab,Crystal Arcade,0,1,1
11280,2023-01-18,FRANK,brawlBall,Sunny Soccer,197,166,363
11281,2023-01-18,FRANK,brawlBall,Beach Ball,7,7,14
11282,2023-01-18,FRANK,bounty,Shooting Star,6,7,13
11283,2023-01-17,FRANK,knockout,Goldarm Gulch,3,6,9
11284,2023-01-17,FRANK,hotZone,Parallel Plays,5,4,9
11285,2023-01-17,FRANK,heist,Pit Stop,8,17,25
11286,2023-01-17,FRANK,gemGrab,Crystal Arcade,3,1,4
11287,2023-01-17,FRANK,brawlBall,Center Stage,6,4,10
11288,2023-01-17,FRANK,brawlBall,Beach Ball,66,70,136
11289,2023-01-17,FRANK,bounty,Hideout,1,0,1
11290,2023-01-16,FRANK,knockout,Belle's Rock,2,0,2
11291,2023-01-16,FRANK,hotZone,Quarter Pounder,21,17,38
11292,2023-01-16,FRANK,heist,Pit Stop,20,46,66
11293,2023-01-16,FRANK,gemGrab,Minecart Madness,1,0,1
11294,2023-01-16,FRANK,gemGrab,Double Swoosh,1,1,2
11295,2023-01-16,FRANK,brawlBall,Center Stage,56,97,153
11296,2023-01-16,FRANK,brawlBall,Backyard Bowl,5,6,11
11297,2023-01-16,FRANK,bounty,Hideout,2,0,2
11298,2023-01-15,FRANK,knockout,Belle's Rock,3,3,6
11299,2023-01-15,FRANK,hotZone,Quarter Pounder,19,5,24
11300,2023-01-15,FRANK,heist,Bridge Too Far,1,0,1
11301,2023-01-15,FRANK,gemGrab,Hard Rock Mine,5,5,10
11302,2023-01-15,FRANK,gemGrab,Double Swoosh,9,5,14
11303,2023-01-15,FRANK,brawlBall,Super Beach,7,4,11
11304,2023-01-15,FRANK,brawlBall,Backyard Bowl,67,46,113
11305,2023-01-15,FRANK,bounty,Canal Grande,2,5,7
11306,2023-01-14,FRANK,hotZone,Controller Chaos,32,22,54
11307,2023-01-14,FRANK,heist,Bridge Too Far,3,0,3
11308,2023-01-14,FRANK,gemGrab,Hard Rock Mine,2,0,2
11309,2023-01-14,FRANK,gemGrab,Deep Diner,0,1,1
11310,2023-01-14,FRANK,brawlBall,Super Beach,74,65,139
11311,2023-01-14,FRANK,brawlBall,Sneaky Fields,12,2,14
11312,2023-01-14,FRANK,bounty,Canal Grande,4,1,5
11313,2023-01-13,FRANK,knockout,Flaring Phoenix,4,1,5
11314,2023-01-13,FRANK,hotZone,Controller Chaos,27,6,33
11315,2023-01-13,FRANK,heist,Hot Potato,2,0,2
11316,2023-01-13,FRANK,gemGrab,Deep Diner,6,1,7
11317,2023-01-13,FRANK,brawlBall,Sneaky Fields,87,64,151
11318,2023-01-13,FRANK,brawlBall,Pinhole Punt,1,0,1
11319,2023-01-13,FRANK,bounty,Temple Ruins,0,1,1
11320,2023-01-12,FRANK,knockout,Riverside,1,1,2
11321,2023-01-12,FRANK,hotZone,Open Zone,9,0,9
11322,2023-01-12,FRANK,heist,Hot Potato,1,0,1
11323,2023-01-12,FRANK,gemGrab,Undermine,3,2,5
11324,2023-01-12,FRANK,gemGrab,Gem Fort,1,0,1
11325,2023-01-12,FRANK,brawlBall,Sunny Soccer,5,4,9
11326,2023-01-12,FRANK,brawlBall,Pinhole Punt,30,22,52
11327,2023-01-11,FRANK,brawlBall,Sunny Soccer,14,14,28
11328,2023-01-11,FRANK,bounty,Excel,3,3,6
11329,2023-01-10,FRANK,knockout,New Perspective,1,0,1
11330,2023-01-10,FRANK,hotZone,Dueling Beetles,15,5,20
11331,2023-01-10,FRANK,gemGrab,Crystal Arcade,1,0,1
11332,2023-01-10,FRANK,brawlBall,Center Stage,8,24,32
11333,2023-01-10,FRANK,brawlBall,Beach Ball,46,22,68
11334,2023-01-09,FRANK,hotZone,Dueling Beetles,6,2,8
11335,2023-01-09,FRANK,heist,Snaked Assault,9,0,9
11336,2023-01-09,FRANK,gemGrab,Minecart Madness,1,2,3
11337,2023-01-09,FRANK,gemGrab,Double Swoosh,2,1,3
11338,2023-01-09,FRANK,brawlBall,Center Stage,64,70,134
11339,2023-01-09,FRANK,brawlBall,Backyard Bowl,2,7,9
11340,2023-01-09,FRANK,bounty,Layer Cake,5,0,5
11341,2023-01-08,FRANK,knockout,X Marks the Spot,3,0,3
11342,2023-01-08,FRANK,hotZone,Ring of Fire,6,1,7
11343,2023-01-08,FRANK,heist,Snaked Assault,4,0,4
11344,2023-01-08,FRANK,gemGrab,Double Swoosh,7,38,45
11345,2023-01-08,FRANK,brawlBall,Super Beach,2,2,4
11346,2023-01-08,FRANK,brawlBall,Backyard Bowl,16,10,26
11347,2023-01-08,FRANK,bounty,Layer Cake,0,2,2
11348,2023-01-07,FRANK,knockout,X Marks the Spot,1,0,1
11349,2023-01-07,FRANK,hotZone,Ring of Fire,4,1,5
11350,2023-01-07,FRANK,heist,Tornado Ring,10,15,25
11351,2023-01-07,FRANK,gemGrab,Hard Rock Mine,2,0,2
11352,2023-01-07,FRANK,brawlBall,Super Beach,28,33,61
11353,2023-01-07,FRANK,brawlBall,Sneaky Fields,7,18,25
11354,2023-01-07,FRANK,bounty,Dry Season,2,1,3
11355,2023-01-06,FRANK,hotZone,Split,10,5,15
11356,2023-01-06,FRANK,heist,Tornado Ring,20,20,40
11357,2023-01-06,FRANK,gemGrab,Undermine,1,1,2
11358,2023-01-06,FRANK,gemGrab,Deep Diner,5,3,8
11359,2023-01-06,FRANK,brawlBall,Sneaky Fields,54,55,109
11360,2023-01-06,FRANK,brawlBall,Pinhole Punt,2,0,2
11361,2023-01-06,FRANK,bounty,Dry Season,1,0,1
11362,2023-01-05,FRANK,knockout,Out in the Open,1,0,1
11363,2023-01-05,FRANK,hotZone,Split,68,42,110
11364,2023-01-05,FRANK,heist,Kaboom Canyon,3,0,3
11365,2023-01-05,FRANK,gemGrab,Undermine,9,2,11
11366,2023-01-05,FRANK,brawlBall,Sunny Soccer,0,1,1
11367,2023-01-05,FRANK,brawlBall,Pinhole Punt,40,48,88
11368,2023-01-05,FRANK,bounty,Shooting Star,1,1,2
11369,2023-01-04,FRANK,hotZone,Parallel Plays,4,0,4
11370,2023-01-04,FRANK,heist,Kaboom Canyon,2,0,2
11371,2023-01-04,FRANK,gemGrab,Gem Fort,3,3,6
11372,2023-01-04,FRANK,gemGrab,Crystal Arcade,6,12,18
11373,2023-01-04,FRANK,brawlBall,Sunny Soccer,65,38,103
11374,2023-01-04,FRANK,bounty,Shooting Star,1,0,1
11375,2023-01-03,FRANK,knockout,Goldarm Gulch,1,0,1
11376,2023-01-03,FRANK,hotZone,Parallel Plays,7,0,7
11377,2023-01-03,FRANK,heist,Pit Stop,9,0,9
11378,2023-01-03,FRANK,gemGrab,Minecart Madness,1,0,1
11379,2023-01-03,FRANK,gemGrab,Crystal Arcade,1,3,4
11380,2023-01-03,FRANK,brawlBall,Center Stage,4,1,5
11381,2023-01-03,FRANK,brawlBall,Beach Ball,56,19,75
11382,2023-01-02,FRANK,knockout,Belle's Rock,3,0,3
11383,2023-01-02,FRANK,hotZone,Quarter Pounder,17,21,38
11384,2023-01-02,FRANK,heist,Pit Stop,23,26,49
11385,2023-01-02,FRANK,heist,Kaboom Canyon,1,0,1
11386,2023-01-02,FRANK,gemGrab,Minecart Madness,2,1,3
11387,2023-01-02,FRANK,gemGrab,Double Swoosh,10,9,19
11388,2023-01-02,FRANK,brawlBall,Center Stage,51,20,71
11389,2023-01-02,FRANK,brawlBall,Backyard Bowl,4,3,7
11390,2023-01-02,FRANK,bounty,Hideout,3,2,5
11391,2023-01-01,FRANK,hotZone,Quarter Pounder,6,14,20
11392,2023-01-01,FRANK,heist,Bridge Too Far,1,0,1
11393,2023-01-01,FRANK,gemGrab,Double Swoosh,3,0,3
11394,2023-01-01,FRANK,brawlBall,Backyard Bowl,19,31,50
11395,2022-12-31,FRANK,hotZone,Controller Chaos,1,0,1
11396,2022-12-31,FRANK,heist,Bridge Too Far,1,1,2
11397,2022-12-31,FRANK,gemGrab,Hard Rock Mine,1,1,2
11398,2022-12-31,FRANK,brawlBall,Super Beach,5,3,8
11399,2022-12-31,FRANK,brawlBall,Sneaky Fields,1,0,1
11400,2022-12-30,FRANK,hotZone,Controller Chaos,5,0,5
11401,2022-12-30,FRANK,gemGrab,Deep Diner,2,1,3
11402,2022-12-30,FRANK,brawlBall,Sneaky Fields,11,9,20
11403,2022-12-29,FRANK,gemGrab,Gem Fort,0,1,1
11404,2022-12-29,FRANK,brawlBall,Pinhole Punt,4,5,9
11405,2022-12-28,FRANK,brawlBall,Sunny Soccer,1,0,1
11406,2022-12-27,FRANK,hotZone,Controller Chaos,1,0,1
11407,2022-12-27,FRANK,brawlBall,Beach Ball,0,1,1
11408,2022-12-26,FRANK,hotZone,Controller Chaos,0,1,1
11409,2022-12-26,FRANK,brawlBall,Center Stage,0,1,1
11410,2022-12-22,FRANK,brawlBall,Pinhole Punt,1,0,1
11411,2022-12-21,FRANK,brawlBall,Sunny Soccer,1,0,1
11412,2022-12-20,FRANK,brawlBall,Beach Ball,1,1,2
11413,2022-12-19,FRANK,brawlBall,Center Stage,0,3,3
11414,2022-12-16,FRANK,brawlBall,Sneaky Fields,1,0,1
11415,2022-12-13,FRANK,brawlBall,Beach Ball,0,1,1
11416,2022-11-07,FRANK,hotZone,Quarter Pounder,1,0,1
11417,2022-10-28,FRANK,brawlBall,Beach Ball,1,0,1
11418,2022-10-26,FRANK,brawlBall,Sunny Soccer,2,0,2
11419,2022-10-15,FRANK,brawlBall,Super Beach,0,1,1
11420,2023-02-05,FANG,knockout,X Marks the Spot,169,180,349
11421,2023-02-05,FANG,knockout,Goldarm Gulch,22,27,49
11422,2023-02-05,FANG,hotZone,Ring of Fire,76,46,122
11423,2023-02-05,FANG,heist,Snaked Assault,27,24,51
11424,2023-02-05,FANG,gemGrab,Hard Rock Mine,63,62,125
11425,2023-02-05,FANG,gemGrab,Double Swoosh,177,107,284
11426,2023-02-05,FANG,brawlBall,Super Beach,34,29,63
11427,2023-02-05,FANG,brawlBall,Sneaky Fields,25,9,34
11428,2023-02-05,FANG,brawlBall,Backyard Bowl,1137,1347,2484
11429,2023-02-05,FANG,bounty,Layer Cake,64,76,140
11430,2023-02-04,FANG,knockout,X Marks the Spot,37,25,62
11431,2023-02-04,FANG,knockout,Goldarm Gulch,15,24,39
11432,2023-02-04,FANG,hotZone,Ring of Fire,15,14,29
11433,2023-02-04,FANG,heist,Tornado Ring,0,2,2
11434,2023-02-04,FANG,heist,Pit Stop,0,2,2
11435,2023-02-04,FANG,gemGrab,Hard Rock Mine,52,88,140
11436,2023-02-04,FANG,gemGrab,Double Swoosh,25,5,30
11437,2023-02-04,FANG,gemGrab,Deep Diner,8,5,13
11438,2023-02-04,FANG,brawlBall,Super Beach,218,196,414
11439,2023-02-04,FANG,brawlBall,Sneaky Fields,35,23,58
11440,2023-02-04,FANG,bounty,Dry Season,31,40,71
11441,2023-02-03,FANG,knockout,Out in the Open,196,159,355
11442,2023-02-03,FANG,knockout,Goldarm Gulch,157,179,336
11443,2023-02-03,FANG,hotZone,Split,41,12,53
11444,2023-02-03,FANG,heist,Tornado Ring,31,17,48
11445,2023-02-03,FANG,heist,Pit Stop,5,5,10
11446,2023-02-03,FANG,gemGrab,Undermine,55,56,111
11447,2023-02-03,FANG,gemGrab,Double Swoosh,131,118,249
11448,2023-02-03,FANG,gemGrab,Deep Diner,148,128,276
11449,2023-02-03,FANG,brawlBall,Sneaky Fields,891,831,1722
11450,2023-02-03,FANG,brawlBall,Pinhole Punt,42,32,74
11451,2023-02-03,FANG,bounty,Dry Season,257,352,609
11452,2023-02-02,FANG,knockout,Out in the Open,66,40,106
11453,2023-02-02,FANG,hotZone,Split,13,15,28
11454,2023-02-02,FANG,heist,Kaboom Canyon,12,11,23
11455,2023-02-02,FANG,gemGrab,Undermine,32,20,52
11456,2023-02-02,FANG,gemGrab,Gem Fort,6,7,13
11457,2023-02-02,FANG,brawlBall,Sunny Soccer,13,6,19
11458,2023-02-02,FANG,brawlBall,Pinhole Punt,248,272,520
11459,2023-02-02,FANG,bounty,Shooting Star,35,34,69
11460,2023-02-01,FANG,knockout,Goldarm Gulch,303,274,577
11461,2023-02-01,FANG,hotZone,Parallel Plays,78,40,118
11462,2023-02-01,FANG,heist,Kaboom Canyon,31,11,42
11463,2023-02-01,FANG,gemGrab,Gem Fort,149,116,265
11464,2023-02-01,FANG,gemGrab,Crystal Arcade,78,58,136
11465,2023-02-01,FANG,brawlBall,Sunny Soccer,702,681,1383
11466,2023-02-01,FANG,brawlBall,Beach Ball,23,19,42
11467,2023-02-01,FANG,bounty,Shooting Star,80,122,202
11468,2023-01-31,FANG,knockout,Goldarm Gulch,88,91,179
11469,2023-01-31,FANG,hotZone,Parallel Plays,32,42,74
11470,2023-01-31,FANG,heist,Pit Stop,4,2,6
11471,2023-01-31,FANG,gemGrab,Minecart Madness,14,16,30
11472,2023-01-31,FANG,gemGrab,Crystal Arcade,67,74,141
11473,2023-01-31,FANG,brawlBall,Center Stage,17,12,29
11474,2023-01-31,FANG,brawlBall,Beach Ball,332,389,721
11475,2023-01-31,FANG,bounty,Hideout,45,35,80
11476,2023-01-30,FANG,knockout,Belle's Rock,281,382,663
11477,2023-01-30,FANG,hotZone,Quarter Pounder,71,17,88
11478,2023-01-30,FANG,heist,Pit Stop,18,22,40
11479,2023-01-30,FANG,gemGrab,Minecart Madness,93,140,233
11480,2023-01-30,FANG,gemGrab,Double Swoosh,95,81,176
11481,2023-01-30,FANG,brawlBall,Center Stage,577,540,1117
11482,2023-01-30,FANG,brawlBall,Backyard Bowl,130,128,258
11483,2023-01-30,FANG,bounty,Hideout,64,58,122
11484,2023-01-29,FANG,knockout,Belle's Rock,263,272,535
11485,2023-01-29,FANG,hotZone,Quarter Pounder,46,21,67
11486,2023-01-29,FANG,heist,Bridge Too Far,49,18,67
11487,2023-01-29,FANG,gemGrab,Hard Rock Mine,59,34,93
11488,2023-01-29,FANG,gemGrab,Double Swoosh,161,126,287
11489,2023-01-29,FANG,brawlBall,Super Beach,18,11,29
11490,2023-01-29,FANG,brawlBall,Backyard Bowl,1052,1108,2160
11491,2023-01-29,FANG,bounty,Canal Grande,97,115,212
11492,2023-01-28,FANG,knockout,Flaring Phoenix,135,73,208
11493,2023-01-28,FANG,hotZone,Controller Chaos,58,41,99
11494,2023-01-28,FANG,heist,Bridge Too Far,87,57,144
11495,2023-01-28,FANG,gemGrab,Hard Rock Mine,188,144,332
11496,2023-01-28,FANG,gemGrab,Deep Diner,69,55,124
11497,2023-01-28,FANG,brawlBall,Super Beach,1007,962,1969
11498,2023-01-28,FANG,brawlBall,Sneaky Fields,28,24,52
11499,2023-01-28,FANG,bounty,Canal Grande,117,155,272
11500,2023-01-27,FANG,knockout,Flaring Phoenix,49,36,85
11501,2023-01-27,FANG,hotZone,Controller Chaos,22,30,52
11502,2023-01-27,FANG,heist,Hot Potato,12,3,15
11503,2023-01-27,FANG,gemGrab,Undermine,19,19,38
11504,2023-01-27,FANG,gemGrab,Deep Diner,53,51,104
11505,2023-01-27,FANG,brawlBall,Sneaky Fields,256,195,451
11506,2023-01-27,FANG,brawlBall,Pinhole Punt,8,7,15
11507,2023-01-27,FANG,bounty,Temple Ruins,31,18,49
11508,2023-01-26,FANG,knockout,Riverside,212,172,384
11509,2023-01-26,FANG,hotZone,Open Zone,78,31,109
11510,2023-01-26,FANG,heist,Hot Potato,34,28,62
11511,2023-01-26,FANG,gemGrab,Undermine,88,69,157
11512,2023-01-26,FANG,gemGrab,Gem Fort,47,26,73
11513,2023-01-26,FANG,brawlBall,Sunny Soccer,53,54,107
11514,2023-01-26,FANG,brawlBall,Pinhole Punt,871,855,1726
11515,2023-01-26,FANG,bounty,Temple Ruins,53,48,101
11516,2023-01-25,FANG,knockout,Riverside,65,37,102
11517,2023-01-25,FANG,hotZone,Open Zone,34,17,51
11518,2023-01-25,FANG,heist,Safe Zone,57,33,90
11519,2023-01-25,FANG,gemGrab,Gem Fort,55,49,104
11520,2023-01-25,FANG,gemGrab,Crystal Arcade,109,115,224
11521,2023-01-25,FANG,brawlBall,Sunny Soccer,471,521,992
11522,2023-01-25,FANG,brawlBall,Beach Ball,91,79,170
11523,2023-01-25,FANG,bounty,Excel,69,111,180
11524,2023-01-24,FANG,knockout,New Perspective,163,195,358
11525,2023-01-24,FANG,hotZone,Dueling Beetles,61,42,103
11526,2023-01-24,FANG,heist,Safe Zone,45,58,103
11527,2023-01-24,FANG,gemGrab,Minecart Madness,33,25,58
11528,2023-01-24,FANG,gemGrab,Crystal Arcade,152,150,302
11529,2023-01-24,FANG,brawlBall,Center Stage,102,86,188
11530,2023-01-24,FANG,brawlBall,Beach Ball,789,804,1593
11531,2023-01-24,FANG,bounty,Excel,157,265,422
11532,2023-01-23,FANG,knockout,New Perspective,188,179,367
11533,2023-01-23,FANG,hotZone,Dueling Beetles,57,45,102
11534,2023-01-23,FANG,heist,Snaked Assault,17,20,37
11535,2023-01-23,FANG,gemGrab,Minecart Madness,160,220,380
11536,2023-01-23,FANG,gemGrab,Double Swoosh,52,33,85
11537,2023-01-23,FANG,brawlBall,Center Stage,933,864,1797
11538,2023-01-23,FANG,brawlBall,Backyard Bowl,72,73,145
11539,2023-01-23,FANG,bounty,Layer Cake,153,260,413
11540,2023-01-22,FANG,knockout,X Marks the Spot,117,90,207
11541,2023-01-22,FANG,hotZone,Ring of Fire,39,42,81
11542,2023-01-22,FANG,heist,Snaked Assault,19,26,45
11543,2023-01-22,FANG,gemGrab,Hard Rock Mine,28,23,51
11544,2023-01-22,FANG,gemGrab,Double Swoosh,48,36,84
11545,2023-01-22,FANG,brawlBall,Super Beach,89,80,169
11546,2023-01-22,FANG,brawlBall,Backyard Bowl,484,534,1018
11547,2023-01-22,FANG,bounty,Layer Cake,100,121,221
11548,2023-01-21,FANG,knockout,X Marks the Spot,359,329,688
11549,2023-01-21,FANG,hotZone,Ring of Fire,102,61,163
11550,2023-01-21,FANG,heist,Tornado Ring,22,9,31
11551,2023-01-21,FANG,gemGrab,Hard Rock Mine,195,177,372
11552,2023-01-21,FANG,gemGrab,Deep Diner,49,44,93
11553,2023-01-21,FANG,brawlBall,Super Beach,1046,1069,2115
11554,2023-01-21,FANG,brawlBall,Sneaky Fields,48,33,81
11555,2023-01-21,FANG,bounty,Dry Season,168,255,423
11556,2023-01-20,FANG,knockout,Out in the Open,221,194,415
11557,2023-01-20,FANG,hotZone,Split,20,25,45
11558,2023-01-20,FANG,heist,Tornado Ring,20,9,29
11559,2023-01-20,FANG,gemGrab,Undermine,44,34,78
11560,2023-01-20,FANG,gemGrab,Deep Diner,167,160,327
11561,2023-01-20,FANG,brawlBall,Sneaky Fields,726,659,1385
11562,2023-01-20,FANG,brawlBall,Pinhole Punt,54,34,88
11563,2023-01-20,FANG,bounty,Dry Season,120,125,245
11564,2023-01-19,FANG,knockout,Out in the Open,212,137,349
11565,2023-01-19,FANG,hotZone,Split,29,21,50
11566,2023-01-19,FANG,heist,Kaboom Canyon,31,11,42
11567,2023-01-19,FANG,gemGrab,Undermine,110,101,211
11568,2023-01-19,FANG,gemGrab,Gem Fort,30,23,53
11569,2023-01-19,FANG,brawlBall,Sunny Soccer,36,26,62
11570,2023-01-19,FANG,brawlBall,Pinhole Punt,878,882,1760
11571,2023-01-19,FANG,bounty,Shooting Star,110,122,232
11572,2023-01-18,FANG,knockout,Goldarm Gulch,27,22,49
11573,2023-01-18,FANG,hotZone,Parallel Plays,12,14,26
11574,2023-01-18,FANG,heist,Kaboom Canyon,9,9,18
11575,2023-01-18,FANG,gemGrab,Gem Fort,22,29,51
11576,2023-01-18,FANG,gemGrab,Crystal Arcade,15,17,32
11577,2023-01-18,FANG,brawlBall,Sunny Soccer,165,186,351
11578,2023-01-18,FANG,brawlBall,Beach Ball,14,13,27
11579,2023-01-18,FANG,bounty,Shooting Star,45,39,84
11580,2023-01-17,FANG,knockout,Goldarm Gulch,26,23,49
11581,2023-01-17,FANG,hotZone,Parallel Plays,8,1,9
11582,2023-01-17,FANG,heist,Pit Stop,1,0,1
11583,2023-01-17,FANG,gemGrab,Minecart Madness,3,4,7
11584,2023-01-17,FANG,gemGrab,Crystal Arcade,12,10,22
11585,2023-01-17,FANG,brawlBall,Center Stage,2,3,5
11586,2023-01-17,FANG,brawlBall,Beach Ball,65,72,137
11587,2023-01-17,FANG,bounty,Hideout,6,3,9
11588,2023-01-16,FANG,knockout,Belle's Rock,25,13,38
11589,2023-01-16,FANG,hotZone,Quarter Pounder,12,8,20
11590,2023-01-16,FANG,heist,Pit Stop,4,0,4
11591,2023-01-16,FANG,gemGrab,Minecart Madness,6,21,27
11592,2023-01-16,FANG,gemGrab,Double Swoosh,10,2,12
11593,2023-01-16,FANG,brawlBall,Center Stage,52,40,92
11594,2023-01-16,FANG,brawlBall,Backyard Bowl,13,17,30
11595,2023-01-16,FANG,bounty,Hideout,10,8,18
11596,2023-01-15,FANG,knockout,Belle's Rock,36,56,92
11597,2023-01-15,FANG,hotZone,Quarter Pounder,16,4,20
11598,2023-01-15,FANG,heist,Bridge Too Far,3,4,7
11599,2023-01-15,FANG,gemGrab,Hard Rock Mine,10,5,15
11600,2023-01-15,FANG,gemGrab,Double Swoosh,11,12,23
11601,2023-01-15,FANG,brawlBall,Super Beach,13,3,16
11602,2023-01-15,FANG,brawlBall,Backyard Bowl,138,142,280
11603,2023-01-15,FANG,bounty,Canal Grande,15,10,25
11604,2023-01-14,FANG,knockout,Flaring Phoenix,15,6,21
11605,2023-01-14,FANG,hotZone,Controller Chaos,6,4,10
11606,2023-01-14,FANG,heist,Bridge Too Far,9,15,24
11607,2023-01-14,FANG,gemGrab,Hard Rock Mine,10,8,18
11608,2023-01-14,FANG,gemGrab,Deep Diner,9,1,10
11609,2023-01-14,FANG,brawlBall,Super Beach,42,28,70
11610,2023-01-14,FANG,brawlBall,Sneaky Fields,6,2,8
11611,2023-01-14,FANG,bounty,Canal Grande,21,23,44
11612,2023-01-13,FANG,knockout,Flaring Phoenix,6,1,7
11613,2023-01-13,FANG,hotZone,Controller Chaos,13,1,14
11614,2023-01-13,FANG,heist,Hot Potato,1,0,1
11615,2023-01-13,FANG,gemGrab,Deep Diner,13,22,35
11616,2023-01-13,FANG,brawlBall,Sneaky Fields,24,14,38
11617,2023-01-13,FANG,brawlBall,Pinhole Punt,1,0,1
11618,2023-01-13,FANG,bounty,Temple Ruins,5,11,16
11619,2023-01-12,FANG,knockout,Riverside,30,25,55
11620,2023-01-12,FANG,hotZone,Open Zone,10,5,15
11621,2023-01-12,FANG,gemGrab,Undermine,8,2,10
11622,2023-01-12,FANG,gemGrab,Gem Fort,4,1,5
11623,2023-01-12,FANG,brawlBall,Sunny Soccer,2,1,3
11624,2023-01-12,FANG,brawlBall,Pinhole Punt,27,23,50
11625,2023-01-12,FANG,bounty,Temple Ruins,1,0,1
11626,2023-01-11,FANG,knockout,Riverside,3,1,4
11627,2023-01-11,FANG,hotZone,Open Zone,2,0,2
11628,2023-01-11,FANG,heist,Safe Zone,1,0,1
11629,2023-01-11,FANG,gemGrab,Gem Fort,2,10,12
11630,2023-01-11,FANG,brawlBall,Sunny Soccer,14,14,28
11631,2023-01-11,FANG,bounty,Excel,0,11,11
11632,2023-01-10,FANG,knockout,New Perspective,17,19,36
11633,2023-01-10,FANG,hotZone,Dueling Beetles,11,14,25
11634,2023-01-10,FANG,heist,Safe Zone,4,1,5
11635,2023-01-10,FANG,gemGrab,Minecart Madness,5,2,7
11636,2023-01-10,FANG,gemGrab,Crystal Arcade,11,12,23
11637,2023-01-10,FANG,brawlBall,Center Stage,6,3,9
11638,2023-01-10,FANG,brawlBall,Beach Ball,35,40,75
11639,2023-01-10,FANG,bounty,Excel,5,4,9
11640,2023-01-09,FANG,knockout,New Perspective,5,12,17
11641,2023-01-09,FANG,hotZone,Dueling Beetles,7,15,22
11642,2023-01-09,FANG,heist,Snaked Assault,6,3,9
11643,2023-01-09,FANG,gemGrab,Minecart Madness,10,7,17
11644,2023-01-09,FANG,gemGrab,Double Swoosh,8,6,14
11645,2023-01-09,FANG,brawlBall,Center Stage,52,26,78
11646,2023-01-09,FANG,brawlBall,Backyard Bowl,5,14,19
11647,2023-01-09,FANG,bounty,Layer Cake,19,12,31
11648,2023-01-08,FANG,knockout,X Marks the Spot,27,25,52
11649,2023-01-08,FANG,hotZone,Ring of Fire,23,17,40
11650,2023-01-08,FANG,heist,Snaked Assault,7,6,13
11651,2023-01-08,FANG,gemGrab,Hard Rock Mine,2,1,3
11652,2023-01-08,FANG,gemGrab,Double Swoosh,5,1,6
11653,2023-01-08,FANG,brawlBall,Super Beach,5,3,8
11654,2023-01-08,FANG,brawlBall,Backyard Bowl,57,77,134
11655,2023-01-08,FANG,bounty,Layer Cake,7,2,9
11656,2023-01-07,FANG,knockout,X Marks the Spot,10,21,31
11657,2023-01-07,FANG,hotZone,Ring of Fire,6,2,8
11658,2023-01-07,FANG,heist,Tornado Ring,2,0,2
11659,2023-01-07,FANG,gemGrab,Hard Rock Mine,4,1,5
11660,2023-01-07,FANG,gemGrab,Deep Diner,5,1,6
11661,2023-01-07,FANG,brawlBall,Super Beach,31,30,61
11662,2023-01-07,FANG,brawlBall,Sneaky Fields,1,0,1
11663,2023-01-07,FANG,bounty,Dry Season,15,16,31
11664,2023-01-06,FANG,knockout,Out in the Open,7,1,8
11665,2023-01-06,FANG,hotZone,Split,1,5,6
11666,2023-01-06,FANG,heist,Tornado Ring,1,0,1
11667,2023-01-06,FANG,gemGrab,Undermine,1,0,1
11668,2023-01-06,FANG,gemGrab,Deep Diner,12,6,18
11669,2023-01-06,FANG,brawlBall,Sneaky Fields,22,14,36
11670,2023-01-06,FANG,bounty,Dry Season,23,38,61
11671,2023-01-05,FANG,knockout,Out in the Open,22,12,34
11672,2023-01-05,FANG,hotZone,Split,7,0,7
11673,2023-01-05,FANG,heist,Kaboom Canyon,4,0,4
11674,2023-01-05,FANG,gemGrab,Undermine,19,33,52
11675,2023-01-05,FANG,gemGrab,Gem Fort,3,1,4
11676,2023-01-05,FANG,brawlBall,Pinhole Punt,63,20,83
11677,2023-01-05,FANG,bounty,Shooting Star,18,28,46
11678,2023-01-04,FANG,knockout,Goldarm Gulch,12,4,16
11679,2023-01-04,FANG,hotZone,Parallel Plays,1,0,1
11680,2023-01-04,FANG,heist,Kaboom Canyon,6,3,9
11681,2023-01-04,FANG,gemGrab,Gem Fort,9,1,10
11682,2023-01-04,FANG,gemGrab,Crystal Arcade,10,15,25
11683,2023-01-04,FANG,brawlBall,Sunny Soccer,31,54,85
11684,2023-01-04,FANG,bounty,Shooting Star,27,43,70
11685,2023-01-03,FANG,knockout,Goldarm Gulch,13,24,37
11686,2023-01-03,FANG,hotZone,Parallel Plays,4,2,6
11687,2023-01-03,FANG,heist,Pit Stop,1,0,1
11688,2023-01-03,FANG,gemGrab,Minecart Madness,2,0,2
11689,2023-01-03,FANG,gemGrab,Crystal Arcade,13,5,18
11690,2023-01-03,FANG,brawlBall,Center Stage,2,0,2
11691,2023-01-03,FANG,brawlBall,Beach Ball,48,34,82
11692,2023-01-03,FANG,bounty,Hideout,10,5,15
11693,2023-01-02,FANG,knockout,Belle's Rock,17,4,21
11694,2023-01-02,FANG,hotZone,Quarter Pounder,9,4,13
11695,2023-01-02,FANG,heist,Pit Stop,3,0,3
11696,2023-01-02,FANG,gemGrab,Minecart Madness,17,24,41
11697,2023-01-02,FANG,gemGrab,Double Swoosh,8,6,14
11698,2023-01-02,FANG,brawlBall,Center Stage,42,19,61
11699,2023-01-02,FANG,brawlBall,Backyard Bowl,5,1,6
11700,2023-01-02,FANG,bounty,Hideout,26,36,62
11701,2023-01-01,FANG,knockout,Belle's Rock,13,20,33
11702,2023-01-01,FANG,hotZone,Quarter Pounder,2,0,2
11703,2023-01-01,FANG,gemGrab,Hard Rock Mine,2,0,2
11704,2023-01-01,FANG,gemGrab,Double Swoosh,7,1,8
11705,2023-01-01,FANG,brawlBall,Backyard Bowl,29,20,49
11706,2023-01-01,FANG,bounty,Canal Grande,1,1,2
11707,2022-12-31,FANG,gemGrab,Hard Rock Mine,4,1,5
11708,2022-12-31,FANG,gemGrab,Deep Diner,1,2,3
11709,2022-12-31,FANG,brawlBall,Super Beach,5,4,9
11710,2022-12-30,FANG,knockout,Flaring Phoenix,0,1,1
11711,2022-12-30,FANG,hotZone,Controller Chaos,1,0,1
11712,2022-12-30,FANG,gemGrab,Undermine,1,0,1
11713,2022-12-30,FANG,gemGrab,Deep Diner,3,1,4
11714,2022-12-30,FANG,brawlBall,Sneaky Fields,3,1,4
11715,2022-12-29,FANG,hotZone,Open Zone,1,0,1
11716,2022-12-29,FANG,gemGrab,Undermine,1,0,1
11717,2022-12-27,FANG,hotZone,Dueling Beetles,0,1,1
11718,2022-12-26,FANG,hotZone,Controller Chaos,1,0,1
11719,2022-12-24,FANG,bounty,Dry Season,1,1,2
11720,2022-12-23,FANG,knockout,Out in the Open,1,0,1
11721,2022-12-22,FANG,brawlBall,Pinhole Punt,1,5,6
11722,2022-12-21,FANG,brawlBall,Sunny Soccer,0,1,1
11723,2022-12-21,FANG,bounty,Shooting Star,1,0,1
11724,2022-12-20,FANG,brawlBall,Beach Ball,0,1,1
11725,2022-12-19,FANG,brawlBall,Center Stage,2,2,4
11726,2022-12-16,FANG,gemGrab,Undermine,0,1,1
11727,2022-12-16,FANG,brawlBall,Sneaky Fields,1,2,3
11728,2022-12-13,FANG,heist,Safe Zone,0,1,1
11729,2022-12-13,FANG,brawlBall,Beach Ball,2,5,7
11730,2022-11-11,FANG,knockout,New Perspective,0,2,2
11731,2022-10-28,FANG,hotZone,Dueling Beetles,1,0,1
11732,2022-10-26,FANG,brawlBall,Sunny Soccer,1,2,3
11733,2022-10-15,FANG,hotZone,Ring of Fire,1,0,1
11734,2022-10-15,FANG,gemGrab,Hard Rock Mine,1,0,1
11735,2022-10-15,FANG,bounty,Dry Season,0,1,1
11736,2022-10-10,FANG,knockout,Belle's Rock,2,0,2
11737,2023-02-05,EVE,knockout,X Marks the Spot,58,62,120
11738,2023-02-05,EVE,knockout,Goldarm Gulch,10,5,15
11739,2023-02-05,EVE,hotZone,Ring of Fire,37,31,68
11740,2023-02-05,EVE,heist,Snaked Assault,15,2,17
11741,2023-02-05,EVE,heist,Pit Stop,1,0,1
11742,2023-02-05,EVE,gemGrab,Hard Rock Mine,9,9,18
11743,2023-02-05,EVE,gemGrab,Double Swoosh,45,36,81
11744,2023-02-05,EVE,brawlBall,Super Beach,3,0,3
11745,2023-02-05,EVE,brawlBall,Sneaky Fields,1,0,1
11746,2023-02-05,EVE,brawlBall,Backyard Bowl,104,106,210
11747,2023-02-05,EVE,bounty,Layer Cake,19,10,29
11748,2023-02-04,EVE,knockout,X Marks the Spot,20,17,37
11749,2023-02-04,EVE,knockout,Goldarm Gulch,12,10,22
11750,2023-02-04,EVE,hotZone,Ring of Fire,9,17,26
11751,2023-02-04,EVE,heist,Tornado Ring,1,0,1
11752,2023-02-04,EVE,gemGrab,Hard Rock Mine,11,23,34
11753,2023-02-04,EVE,gemGrab,Double Swoosh,8,3,11
11754,2023-02-04,EVE,gemGrab,Deep Diner,4,7,11
11755,2023-02-04,EVE,brawlBall,Super Beach,9,14,23
11756,2023-02-04,EVE,bounty,Dry Season,15,8,23
11757,2023-02-03,EVE,knockout,Out in the Open,211,279,490
11758,2023-02-03,EVE,knockout,Goldarm Gulch,31,31,62
11759,2023-02-03,EVE,hotZone,Split,4,5,9
11760,2023-02-03,EVE,heist,Tornado Ring,15,2,17
11761,2023-02-03,EVE,heist,Pit Stop,7,2,9
11762,2023-02-03,EVE,gemGrab,Undermine,8,7,15
11763,2023-02-03,EVE,gemGrab,Double Swoosh,20,22,42
11764,2023-02-03,EVE,gemGrab,Deep Diner,60,62,122
11765,2023-02-03,EVE,brawlBall,Sneaky Fields,45,61,106
11766,2023-02-03,EVE,brawlBall,Pinhole Punt,1,1,2
11767,2023-02-03,EVE,bounty,Dry Season,58,45,103
11768,2023-02-02,EVE,knockout,Out in the Open,84,83,167
11769,2023-02-02,EVE,hotZone,Split,4,6,10
11770,2023-02-02,EVE,heist,Kaboom Canyon,25,22,47
11771,2023-02-02,EVE,gemGrab,Undermine,9,10,19
11772,2023-02-02,EVE,gemGrab,Gem Fort,3,2,5
11773,2023-02-02,EVE,brawlBall,Pinhole Punt,33,35,68
11774,2023-02-02,EVE,bounty,Shooting Star,19,9,28
11775,2023-02-01,EVE,knockout,Goldarm Gulch,67,55,122
11776,2023-02-01,EVE,hotZone,Parallel Plays,26,10,36
11777,2023-02-01,EVE,heist,Kaboom Canyon,72,89,161
11778,2023-02-01,EVE,gemGrab,Gem Fort,38,31,69
11779,2023-02-01,EVE,gemGrab,Crystal Arcade,34,26,60
11780,2023-02-01,EVE,brawlBall,Sunny Soccer,40,55,95
11781,2023-02-01,EVE,brawlBall,Beach Ball,1,1,2
11782,2023-02-01,EVE,bounty,Shooting Star,28,24,52
11783,2023-01-31,EVE,knockout,Goldarm Gulch,45,35,80
11784,2023-01-31,EVE,hotZone,Parallel Plays,18,29,47
11785,2023-01-31,EVE,heist,Pit Stop,1,0,1
11786,2023-01-31,EVE,gemGrab,Minecart Madness,8,6,14
11787,2023-01-31,EVE,gemGrab,Crystal Arcade,30,28,58
11788,2023-01-31,EVE,brawlBall,Center Stage,0,1,1
11789,2023-01-31,EVE,brawlBall,Beach Ball,22,31,53
11790,2023-01-31,EVE,bounty,Hideout,11,7,18
11791,2023-01-30,EVE,knockout,Belle's Rock,86,81,167
11792,2023-01-30,EVE,hotZone,Quarter Pounder,29,10,39
11793,2023-01-30,EVE,heist,Pit Stop,3,1,4
11794,2023-01-30,EVE,gemGrab,Minecart Madness,21,32,53
11795,2023-01-30,EVE,gemGrab,Double Swoosh,16,18,34
11796,2023-01-30,EVE,brawlBall,Center Stage,36,50,86
11797,2023-01-30,EVE,brawlBall,Backyard Bowl,10,16,26
11798,2023-01-30,EVE,bounty,Hideout,15,21,36
11799,2023-01-29,EVE,knockout,Belle's Rock,54,50,104
11800,2023-01-29,EVE,hotZone,Quarter Pounder,16,9,25
11801,2023-01-29,EVE,heist,Bridge Too Far,176,181,357
11802,2023-01-29,EVE,gemGrab,Hard Rock Mine,11,2,13
11803,2023-01-29,EVE,gemGrab,Double Swoosh,38,47,85
11804,2023-01-29,EVE,brawlBall,Super Beach,1,0,1
11805,2023-01-29,EVE,brawlBall,Backyard Bowl,141,158,299
11806,2023-01-29,EVE,bounty,Canal Grande,230,320,550
11807,2023-01-28,EVE,knockout,Flaring Phoenix,27,23,50
11808,2023-01-28,EVE,hotZone,Controller Chaos,12,6,18
11809,2023-01-28,EVE,heist,Bridge Too Far,442,546,988
11810,2023-01-28,EVE,gemGrab,Hard Rock Mine,26,32,58
11811,2023-01-28,EVE,gemGrab,Deep Diner,14,24,38
11812,2023-01-28,EVE,brawlBall,Super Beach,56,66,122
11813,2023-01-28,EVE,brawlBall,Sneaky Fields,1,0,1
11814,2023-01-28,EVE,bounty,Canal Grande,530,680,1210
11815,2023-01-27,EVE,knockout,Flaring Phoenix,17,9,26
11816,2023-01-27,EVE,hotZone,Controller Chaos,5,5,10
11817,2023-01-27,EVE,heist,Hot Potato,1,0,1
11818,2023-01-27,EVE,gemGrab,Undermine,2,3,5
11819,2023-01-27,EVE,gemGrab,Deep Diner,17,11,28
11820,2023-01-27,EVE,brawlBall,Sneaky Fields,20,19,39
11821,2023-01-27,EVE,brawlBall,Pinhole Punt,1,1,2
11822,2023-01-27,EVE,bounty,Temple Ruins,9,3,12
11823,2023-01-26,EVE,knockout,Riverside,743,1125,1868
11824,2023-01-26,EVE,hotZone,Open Zone,30,15,45
11825,2023-01-26,EVE,heist,Hot Potato,7,4,11
11826,2023-01-26,EVE,gemGrab,Undermine,44,57,101
11827,2023-01-26,EVE,gemGrab,Gem Fort,16,10,26
11828,2023-01-26,EVE,brawlBall,Sunny Soccer,3,2,5
11829,2023-01-26,EVE,brawlBall,Pinhole Punt,127,106,233
11830,2023-01-26,EVE,bounty,Temple Ruins,17,27,44
11831,2023-01-25,EVE,knockout,Riverside,526,700,1226
11832,2023-01-25,EVE,hotZone,Open Zone,10,3,13
11833,2023-01-25,EVE,heist,Safe Zone,112,105,217
11834,2023-01-25,EVE,gemGrab,Gem Fort,18,17,35
11835,2023-01-25,EVE,gemGrab,Crystal Arcade,34,25,59
11836,2023-01-25,EVE,brawlBall,Sunny Soccer,34,69,103
11837,2023-01-25,EVE,brawlBall,Beach Ball,13,15,28
11838,2023-01-25,EVE,bounty,Excel,10,6,16
11839,2023-01-24,EVE,knockout,New Perspective,51,56,107
11840,2023-01-24,EVE,hotZone,Dueling Beetles,18,16,34
11841,2023-01-24,EVE,heist,Safe Zone,149,212,361
11842,2023-01-24,EVE,gemGrab,Minecart Madness,15,15,30
11843,2023-01-24,EVE,gemGrab,Crystal Arcade,31,35,66
11844,2023-01-24,EVE,brawlBall,Center Stage,18,16,34
11845,2023-01-24,EVE,brawlBall,Beach Ball,61,73,134
11846,2023-01-24,EVE,bounty,Excel,26,13,39
11847,2023-01-23,EVE,knockout,New Perspective,59,47,106
11848,2023-01-23,EVE,hotZone,Dueling Beetles,16,10,26
11849,2023-01-23,EVE,heist,Snaked Assault,18,10,28
11850,2023-01-23,EVE,gemGrab,Minecart Madness,45,37,82
11851,2023-01-23,EVE,gemGrab,Double Swoosh,21,12,33
11852,2023-01-23,EVE,brawlBall,Center Stage,80,76,156
11853,2023-01-23,EVE,brawlBall,Backyard Bowl,8,5,13
11854,2023-01-23,EVE,bounty,Layer Cake,31,42,73
11855,2023-01-22,EVE,knockout,X Marks the Spot,41,33,74
11856,2023-01-22,EVE,hotZone,Ring of Fire,16,12,28
11857,2023-01-22,EVE,heist,Snaked Assault,6,6,12
11858,2023-01-22,EVE,gemGrab,Hard Rock Mine,21,16,37
11859,2023-01-22,EVE,gemGrab,Double Swoosh,21,12,33
11860,2023-01-22,EVE,brawlBall,Super Beach,5,9,14
11861,2023-01-22,EVE,brawlBall,Backyard Bowl,70,100,170
11862,2023-01-22,EVE,bounty,Layer Cake,15,27,42
11863,2023-01-21,EVE,knockout,X Marks the Spot,129,172,301
11864,2023-01-21,EVE,hotZone,Ring of Fire,43,34,77
11865,2023-01-21,EVE,heist,Tornado Ring,6,6,12
11866,2023-01-21,EVE,gemGrab,Hard Rock Mine,63,60,123
11867,2023-01-21,EVE,gemGrab,Deep Diner,19,11,30
11868,2023-01-21,EVE,brawlBall,Super Beach,65,78,143
11869,2023-01-21,EVE,brawlBall,Sneaky Fields,1,1,2
11870,2023-01-21,EVE,bounty,Dry Season,86,57,143
11871,2023-01-20,EVE,knockout,Out in the Open,284,359,643
11872,2023-01-20,EVE,hotZone,Split,7,4,11
11873,2023-01-20,EVE,heist,Tornado Ring,11,4,15
11874,2023-01-20,EVE,gemGrab,Undermine,14,19,33
11875,2023-01-20,EVE,gemGrab,Deep Diner,63,57,120
11876,2023-01-20,EVE,brawlBall,Sneaky Fields,39,34,73
11877,2023-01-20,EVE,brawlBall,Pinhole Punt,0,6,6
11878,2023-01-20,EVE,bounty,Dry Season,43,47,90
11879,2023-01-19,EVE,knockout,Out in the Open,289,319,608
11880,2023-01-19,EVE,hotZone,Split,8,8,16
11881,2023-01-19,EVE,heist,Kaboom Canyon,62,74,136
11882,2023-01-19,EVE,gemGrab,Undermine,49,35,84
11883,2023-01-19,EVE,gemGrab,Gem Fort,10,7,17
11884,2023-01-19,EVE,brawlBall,Sunny Soccer,1,2,3
11885,2023-01-19,EVE,brawlBall,Pinhole Punt,110,103,213
11886,2023-01-19,EVE,bounty,Shooting Star,75,62,137
11887,2023-01-18,EVE,knockout,Goldarm Gulch,15,14,29
11888,2023-01-18,EVE,hotZone,Parallel Plays,3,3,6
11889,2023-01-18,EVE,heist,Kaboom Canyon,28,21,49
11890,2023-01-18,EVE,gemGrab,Gem Fort,15,7,22
11891,2023-01-18,EVE,gemGrab,Crystal Arcade,5,4,9
11892,2023-01-18,EVE,brawlBall,Sunny Soccer,26,27,53
11893,2023-01-18,EVE,brawlBall,Beach Ball,2,1,3
11894,2023-01-18,EVE,bounty,Shooting Star,22,31,53
11895,2023-01-17,EVE,knockout,Goldarm Gulch,13,8,21
11896,2023-01-17,EVE,hotZone,Parallel Plays,5,4,9
11897,2023-01-17,EVE,gemGrab,Minecart Madness,1,0,1
11898,2023-01-17,EVE,gemGrab,Crystal Arcade,6,5,11
11899,2023-01-17,EVE,brawlBall,Beach Ball,8,5,13
11900,2023-01-17,EVE,bounty,Hideout,3,2,5
11901,2023-01-16,EVE,knockout,Belle's Rock,4,2,6
11902,2023-01-16,EVE,hotZone,Quarter Pounder,3,0,3
11903,2023-01-16,EVE,gemGrab,Minecart Madness,4,10,14
11904,2023-01-16,EVE,gemGrab,Double Swoosh,1,0,1
11905,2023-01-16,EVE,brawlBall,Center Stage,3,1,4
11906,2023-01-16,EVE,brawlBall,Backyard Bowl,2,0,2
11907,2023-01-16,EVE,bounty,Hideout,2,3,5
11908,2023-01-15,EVE,knockout,Belle's Rock,5,3,8
11909,2023-01-15,EVE,hotZone,Quarter Pounder,6,1,7
11910,2023-01-15,EVE,heist,Bridge Too Far,40,44,84
11911,2023-01-15,EVE,gemGrab,Hard Rock Mine,0,2,2
11912,2023-01-15,EVE,gemGrab,Double Swoosh,2,2,4
11913,2023-01-15,EVE,brawlBall,Backyard Bowl,14,8,22
11914,2023-01-15,EVE,bounty,Canal Grande,42,38,80
11915,2023-01-14,EVE,knockout,Flaring Phoenix,7,14,21
11916,2023-01-14,EVE,hotZone,Controller Chaos,4,0,4
11917,2023-01-14,EVE,heist,Bridge Too Far,95,133,228
11918,2023-01-14,EVE,gemGrab,Deep Diner,2,0,2
11919,2023-01-14,EVE,brawlBall,Super Beach,8,17,25
11920,2023-01-14,EVE,bounty,Canal Grande,57,82,139
11921,2023-01-13,EVE,knockout,Flaring Phoenix,4,0,4
11922,2023-01-13,EVE,hotZone,Controller Chaos,5,1,6
11923,2023-01-13,EVE,gemGrab,Deep Diner,3,6,9
11924,2023-01-13,EVE,brawlBall,Sneaky Fields,6,0,6
11925,2023-01-13,EVE,bounty,Temple Ruins,0,1,1
11926,2023-01-12,EVE,knockout,Riverside,135,244,379
11927,2023-01-12,EVE,hotZone,Open Zone,3,0,3
11928,2023-01-12,EVE,gemGrab,Undermine,1,0,1
11929,2023-01-12,EVE,brawlBall,Sunny Soccer,0,1,1
11930,2023-01-12,EVE,brawlBall,Pinhole Punt,4,21,25
11931,2023-01-11,EVE,knockout,Riverside,50,72,122
11932,2023-01-11,EVE,hotZone,Open Zone,1,0,1
11933,2023-01-11,EVE,heist,Safe Zone,1,1,2
11934,2023-01-11,EVE,gemGrab,Gem Fort,2,1,3
11935,2023-01-11,EVE,brawlBall,Sunny Soccer,2,0,2
11936,2023-01-11,EVE,bounty,Excel,1,0,1
11937,2023-01-10,EVE,knockout,New Perspective,1,2,3
11938,2023-01-10,EVE,hotZone,Dueling Beetles,1,4,5
11939,2023-01-10,EVE,heist,Safe Zone,20,5,25
11940,2023-01-10,EVE,gemGrab,Minecart Madness,1,0,1
11941,2023-01-10,EVE,gemGrab,Crystal Arcade,3,1,4
11942,2023-01-10,EVE,brawlBall,Beach Ball,6,8,14
11943,2023-01-09,EVE,knockout,New Perspective,1,0,1
11944,2023-01-09,EVE,hotZone,Dueling Beetles,2,0,2
11945,2023-01-09,EVE,heist,Snaked Assault,5,2,7
11946,2023-01-09,EVE,gemGrab,Minecart Madness,3,5,8
11947,2023-01-09,EVE,gemGrab,Double Swoosh,1,0,1
11948,2023-01-09,EVE,brawlBall,Center Stage,9,8,17
11949,2023-01-09,EVE,bounty,Layer Cake,2,1,3
11950,2023-01-08,EVE,knockout,X Marks the Spot,4,2,6
11951,2023-01-08,EVE,hotZone,Ring of Fire,3,5,8
11952,2023-01-08,EVE,heist,Snaked Assault,1,0,1
11953,2023-01-08,EVE,brawlBall,Backyard Bowl,5,1,6
11954,2023-01-08,EVE,bounty,Layer Cake,2,1,3
11955,2023-01-07,EVE,knockout,X Marks the Spot,7,5,12
11956,2023-01-07,EVE,hotZone,Ring of Fire,1,0,1
11957,2023-01-07,EVE,brawlBall,Super Beach,2,0,2
11958,2023-01-07,EVE,brawlBall,Sneaky Fields,1,3,4
11959,2023-01-07,EVE,bounty,Dry Season,5,3,8
11960,2023-01-06,EVE,knockout,Out in the Open,19,15,34
11961,2023-01-06,EVE,hotZone,Split,2,0,2
11962,2023-01-06,EVE,heist,Tornado Ring,5,0,5
11963,2023-01-06,EVE,gemGrab,Undermine,3,0,3
11964,2023-01-06,EVE,gemGrab,Deep Diner,3,0,3
11965,2023-01-06,EVE,brawlBall,Sneaky Fields,3,10,13
11966,2023-01-06,EVE,bounty,Dry Season,5,12,17
11967,2023-01-05,EVE,knockout,Out in the Open,39,30,69
11968,2023-01-05,EVE,hotZone,Split,2,1,3
11969,2023-01-05,EVE,heist,Kaboom Canyon,6,5,11
11970,2023-01-05,EVE,gemGrab,Undermine,2,1,3
11971,2023-01-05,EVE,brawlBall,Pinhole Punt,9,18,27
11972,2023-01-05,EVE,bounty,Shooting Star,4,3,7
11973,2023-01-04,EVE,knockout,Goldarm Gulch,3,1,4
11974,2023-01-04,EVE,hotZone,Parallel Plays,1,0,1
11975,2023-01-04,EVE,heist,Kaboom Canyon,14,17,31
11976,2023-01-04,EVE,gemGrab,Gem Fort,1,6,7
11977,2023-01-04,EVE,gemGrab,Crystal Arcade,3,12,15
11978,2023-01-04,EVE,brawlBall,Sunny Soccer,2,0,2
11979,2023-01-04,EVE,bounty,Shooting Star,17,28,45
11980,2023-01-03,EVE,knockout,Goldarm Gulch,4,6,10
11981,2023-01-03,EVE,hotZone,Parallel Plays,1,0,1
11982,2023-01-03,EVE,heist,Pit Stop,1,0,1
11983,2023-01-03,EVE,heist,Kaboom Canyon,0,1,1
11984,2023-01-03,EVE,gemGrab,Crystal Arcade,6,0,6
11985,2023-01-03,EVE,brawlBall,Center Stage,1,4,5
11986,2023-01-03,EVE,brawlBall,Beach Ball,7,2,9
11987,2023-01-03,EVE,bounty,Hideout,3,1,4
11988,2023-01-02,EVE,knockout,Belle's Rock,10,14,24
11989,2023-01-02,EVE,hotZone,Quarter Pounder,3,2,5
11990,2023-01-02,EVE,gemGrab,Minecart Madness,13,0,13
11991,2023-01-02,EVE,brawlBall,Center Stage,7,2,9
11992,2023-01-02,EVE,brawlBall,Backyard Bowl,0,1,1
11993,2023-01-02,EVE,bounty,Hideout,11,1,12
11994,2023-01-01,EVE,knockout,Belle's Rock,1,0,1
11995,2023-01-01,EVE,hotZone,Quarter Pounder,4,0,4
11996,2023-01-01,EVE,heist,Bridge Too Far,9,11,20
11997,2023-01-01,EVE,gemGrab,Double Swoosh,3,0,3
11998,2023-01-01,EVE,brawlBall,Backyard Bowl,10,53,63
11999,2023-01-01,EVE,bounty,Canal Grande,3,5,8
12000,2022-12-31,EVE,heist,Bridge Too Far,4,6,10
12001,2022-12-31,EVE,gemGrab,Hard Rock Mine,2,0,2
12002,2022-12-31,EVE,bounty,Canal Grande,1,0,1
12003,2022-12-30,EVE,gemGrab,Deep Diner,1,0,1
12004,2022-12-28,EVE,hotZone,Controller Chaos,1,0,1
12005,2022-12-27,EVE,knockout,New Perspective,1,0,1
12006,2022-12-23,EVE,knockout,Out in the Open,0,2,2
12007,2022-12-13,EVE,knockout,New Perspective,1,0,1
12008,2022-12-13,EVE,heist,Safe Zone,1,0,1
12009,2022-12-13,EVE,gemGrab,Crystal Arcade,1,7,8
12010,2022-11-11,EVE,brawlBall,Sneaky Fields,1,0,1
12011,2022-10-30,EVE,knockout,Out in the Open,1,0,1
12012,2022-10-28,EVE,knockout,Out in the Open,0,1,1
12013,2022-10-28,EVE,heist,Safe Zone,0,1,1
12014,2022-10-15,EVE,hotZone,Ring of Fire,2,2,4
12015,2023-02-05,EMZ,knockout,X Marks the Spot,26,8,34
12016,2023-02-05,EMZ,knockout,Goldarm Gulch,2,0,2
12017,2023-02-05,EMZ,hotZone,Ring of Fire,86,58,144
12018,2023-02-05,EMZ,heist,Snaked Assault,452,428,880
12019,2023-02-05,EMZ,heist,Pit Stop,65,84,149
12020,2023-02-05,EMZ,gemGrab,Hard Rock Mine,36,18,54
12021,2023-02-05,EMZ,gemGrab,Double Swoosh,567,522,1089
12022,2023-02-05,EMZ,brawlBall,Super Beach,12,11,23
12023,2023-02-05,EMZ,brawlBall,Sneaky Fields,170,209,379
12024,2023-02-05,EMZ,brawlBall,Backyard Bowl,178,156,334
12025,2023-02-05,EMZ,bounty,Layer Cake,10,4,14
12026,2023-02-04,EMZ,knockout,X Marks the Spot,5,3,8
12027,2023-02-04,EMZ,hotZone,Ring of Fire,28,15,43
12028,2023-02-04,EMZ,heist,Tornado Ring,69,71,140
12029,2023-02-04,EMZ,heist,Pit Stop,67,51,118
12030,2023-02-04,EMZ,gemGrab,Hard Rock Mine,29,13,42
12031,2023-02-04,EMZ,gemGrab,Double Swoosh,139,94,233
12032,2023-02-04,EMZ,gemGrab,Deep Diner,8,1,9
12033,2023-02-04,EMZ,brawlBall,Super Beach,125,99,224
12034,2023-02-04,EMZ,brawlBall,Sneaky Fields,106,109,215
12035,2023-02-04,EMZ,bounty,Dry Season,3,1,4
12036,2023-02-03,EMZ,knockout,Out in the Open,51,17,68
12037,2023-02-03,EMZ,knockout,Goldarm Gulch,5,2,7
12038,2023-02-03,EMZ,hotZone,Split,53,13,66
12039,2023-02-03,EMZ,heist,Tornado Ring,1144,1462,2606
12040,2023-02-03,EMZ,heist,Pit Stop,387,386,773
12041,2023-02-03,EMZ,gemGrab,Undermine,53,51,104
12042,2023-02-03,EMZ,gemGrab,Double Swoosh,783,586,1369
12043,2023-02-03,EMZ,gemGrab,Deep Diner,109,79,188
12044,2023-02-03,EMZ,brawlBall,Sneaky Fields,1462,1602,3064
12045,2023-02-03,EMZ,brawlBall,Pinhole Punt,14,10,24
12046,2023-02-03,EMZ,bounty,Dry Season,32,5,37
12047,2023-02-02,EMZ,knockout,Out in the Open,13,14,27
12048,2023-02-02,EMZ,hotZone,Split,25,14,39
12049,2023-02-02,EMZ,heist,Kaboom Canyon,6,5,11
12050,2023-02-02,EMZ,gemGrab,Undermine,55,70,125
12051,2023-02-02,EMZ,gemGrab,Gem Fort,17,8,25
12052,2023-02-02,EMZ,brawlBall,Sunny Soccer,7,8,15
12053,2023-02-02,EMZ,brawlBall,Pinhole Punt,130,159,289
12054,2023-02-02,EMZ,bounty,Shooting Star,3,1,4
12055,2023-02-01,EMZ,knockout,Goldarm Gulch,31,16,47
12056,2023-02-01,EMZ,hotZone,Parallel Plays,170,147,317
12057,2023-02-01,EMZ,heist,Kaboom Canyon,32,9,41
12058,2023-02-01,EMZ,gemGrab,Gem Fort,180,118,298
12059,2023-02-01,EMZ,gemGrab,Crystal Arcade,77,45,122
12060,2023-02-01,EMZ,brawlBall,Sunny Soccer,363,423,786
12061,2023-02-01,EMZ,brawlBall,Beach Ball,9,7,16
12062,2023-02-01,EMZ,bounty,Shooting Star,7,1,8
12063,2023-01-31,EMZ,knockout,Goldarm Gulch,19,8,27
12064,2023-01-31,EMZ,hotZone,Parallel Plays,77,71,148
12065,2023-01-31,EMZ,heist,Pit Stop,31,36,67
12066,2023-01-31,EMZ,gemGrab,Minecart Madness,5,6,11
12067,2023-01-31,EMZ,gemGrab,Crystal Arcade,80,49,129
12068,2023-01-31,EMZ,brawlBall,Center Stage,6,7,13
12069,2023-01-31,EMZ,brawlBall,Beach Ball,204,186,390
12070,2023-01-31,EMZ,bounty,Hideout,5,1,6
12071,2023-01-30,EMZ,knockout,Belle's Rock,22,16,38
12072,2023-01-30,EMZ,hotZone,Quarter Pounder,217,71,288
12073,2023-01-30,EMZ,heist,Pit Stop,145,163,308
12074,2023-01-30,EMZ,gemGrab,Minecart Madness,77,44,121
12075,2023-01-30,EMZ,gemGrab,Double Swoosh,226,244,470
12076,2023-01-30,EMZ,brawlBall,Center Stage,436,558,994
12077,2023-01-30,EMZ,brawlBall,Backyard Bowl,21,9,30
12078,2023-01-30,EMZ,bounty,Hideout,1,3,4
12079,2023-01-29,EMZ,knockout,Belle's Rock,21,1,22
12080,2023-01-29,EMZ,hotZone,Quarter Pounder,149,70,219
12081,2023-01-29,EMZ,heist,Bridge Too Far,22,6,28
12082,2023-01-29,EMZ,gemGrab,Hard Rock Mine,14,19,33
12083,2023-01-29,EMZ,gemGrab,Double Swoosh,395,390,785
12084,2023-01-29,EMZ,brawlBall,Super Beach,4,5,9
12085,2023-01-29,EMZ,brawlBall,Backyard Bowl,214,134,348
12086,2023-01-29,EMZ,bounty,Canal Grande,29,18,47
12087,2023-01-28,EMZ,knockout,Flaring Phoenix,28,16,44
12088,2023-01-28,EMZ,hotZone,Controller Chaos,252,285,537
12089,2023-01-28,EMZ,heist,Bridge Too Far,36,12,48
12090,2023-01-28,EMZ,gemGrab,Hard Rock Mine,109,69,178
12091,2023-01-28,EMZ,gemGrab,Deep Diner,23,29,52
12092,2023-01-28,EMZ,brawlBall,Super Beach,467,564,1031
12093,2023-01-28,EMZ,brawlBall,Sneaky Fields,44,57,101
12094,2023-01-28,EMZ,bounty,Canal Grande,49,30,79
12095,2023-01-27,EMZ,knockout,Flaring Phoenix,8,4,12
12096,2023-01-27,EMZ,hotZone,Controller Chaos,52,81,133
12097,2023-01-27,EMZ,heist,Hot Potato,39,46,85
12098,2023-01-27,EMZ,gemGrab,Undermine,12,8,20
12099,2023-01-27,EMZ,gemGrab,Deep Diner,37,25,62
12100,2023-01-27,EMZ,brawlBall,Sneaky Fields,203,260,463
12101,2023-01-27,EMZ,brawlBall,Pinhole Punt,6,6,12
12102,2023-01-27,EMZ,bounty,Temple Ruins,7,15,22
12103,2023-01-26,EMZ,knockout,Riverside,22,7,29
12104,2023-01-26,EMZ,hotZone,Open Zone,74,36,110
12105,2023-01-26,EMZ,heist,Hot Potato,482,564,1046
12106,2023-01-26,EMZ,gemGrab,Undermine,157,134,291
12107,2023-01-26,EMZ,gemGrab,Gem Fort,46,51,97
12108,2023-01-26,EMZ,brawlBall,Sunny Soccer,22,11,33
12109,2023-01-26,EMZ,brawlBall,Pinhole Punt,494,505,999
12110,2023-01-26,EMZ,bounty,Temple Ruins,35,26,61
12111,2023-01-25,EMZ,knockout,Riverside,16,2,18
12112,2023-01-25,EMZ,hotZone,Open Zone,33,23,56
12113,2023-01-25,EMZ,heist,Safe Zone,30,9,39
12114,2023-01-25,EMZ,gemGrab,Gem Fort,66,62,128
12115,2023-01-25,EMZ,gemGrab,Crystal Arcade,90,71,161
12116,2023-01-25,EMZ,brawlBall,Sunny Soccer,281,311,592
12117,2023-01-25,EMZ,brawlBall,Beach Ball,29,21,50
12118,2023-01-25,EMZ,bounty,Excel,10,2,12
12119,2023-01-24,EMZ,knockout,New Perspective,30,16,46
12120,2023-01-24,EMZ,hotZone,Dueling Beetles,133,87,220
12121,2023-01-24,EMZ,heist,Safe Zone,46,26,72
12122,2023-01-24,EMZ,gemGrab,Minecart Madness,25,5,30
12123,2023-01-24,EMZ,gemGrab,Crystal Arcade,123,105,228
12124,2023-01-24,EMZ,brawlBall,Center Stage,68,78,146
12125,2023-01-24,EMZ,brawlBall,Beach Ball,394,385,779
12126,2023-01-24,EMZ,bounty,Excel,12,6,18
12127,2023-01-23,EMZ,knockout,New Perspective,46,29,75
12128,2023-01-23,EMZ,hotZone,Dueling Beetles,220,88,308
12129,2023-01-23,EMZ,heist,Snaked Assault,574,807,1381
12130,2023-01-23,EMZ,gemGrab,Minecart Madness,107,52,159
12131,2023-01-23,EMZ,gemGrab,Double Swoosh,181,147,328
12132,2023-01-23,EMZ,brawlBall,Center Stage,614,708,1322
12133,2023-01-23,EMZ,brawlBall,Backyard Bowl,15,5,20
12134,2023-01-23,EMZ,bounty,Layer Cake,33,8,41
12135,2023-01-22,EMZ,knockout,X Marks the Spot,17,8,25
12136,2023-01-22,EMZ,hotZone,Ring of Fire,61,53,114
12137,2023-01-22,EMZ,heist,Snaked Assault,312,425,737
12138,2023-01-22,EMZ,gemGrab,Hard Rock Mine,24,15,39
12139,2023-01-22,EMZ,gemGrab,Double Swoosh,196,203,399
12140,2023-01-22,EMZ,brawlBall,Super Beach,43,49,92
12141,2023-01-22,EMZ,brawlBall,Backyard Bowl,96,59,155
12142,2023-01-22,EMZ,bounty,Layer Cake,11,4,15
12143,2023-01-21,EMZ,knockout,X Marks the Spot,55,22,77
12144,2023-01-21,EMZ,hotZone,Ring of Fire,162,109,271
12145,2023-01-21,EMZ,heist,Tornado Ring,534,767,1301
12146,2023-01-21,EMZ,gemGrab,Hard Rock Mine,143,65,208
12147,2023-01-21,EMZ,gemGrab,Deep Diner,47,22,69
12148,2023-01-21,EMZ,brawlBall,Super Beach,677,687,1364
12149,2023-01-21,EMZ,brawlBall,Sneaky Fields,24,33,57
12150,2023-01-21,EMZ,bounty,Dry Season,11,4,15
12151,2023-01-20,EMZ,knockout,Out in the Open,44,14,58
12152,2023-01-20,EMZ,hotZone,Split,52,34,86
12153,2023-01-20,EMZ,heist,Tornado Ring,709,942,1651
12154,2023-01-20,EMZ,gemGrab,Undermine,52,42,94
12155,2023-01-20,EMZ,gemGrab,Deep Diner,157,98,255
12156,2023-01-20,EMZ,brawlBall,Sneaky Fields,762,1001,1763
12157,2023-01-20,EMZ,brawlBall,Pinhole Punt,23,36,59
12158,2023-01-20,EMZ,bounty,Dry Season,11,4,15
12159,2023-01-19,EMZ,knockout,Out in the Open,61,27,88
12160,2023-01-19,EMZ,hotZone,Split,76,44,120
12161,2023-01-19,EMZ,heist,Kaboom Canyon,24,20,44
12162,2023-01-19,EMZ,gemGrab,Undermine,255,271,526
12163,2023-01-19,EMZ,gemGrab,Gem Fort,42,26,68
12164,2023-01-19,EMZ,brawlBall,Sunny Soccer,11,9,20
12165,2023-01-19,EMZ,brawlBall,Pinhole Punt,478,498,976
12166,2023-01-19,EMZ,bounty,Shooting Star,10,4,14
12167,2023-01-18,EMZ,knockout,Goldarm Gulch,5,2,7
12168,2023-01-18,EMZ,hotZone,Parallel Plays,13,8,21
12169,2023-01-18,EMZ,heist,Kaboom Canyon,8,1,9
12170,2023-01-18,EMZ,gemGrab,Gem Fort,40,38,78
12171,2023-01-18,EMZ,gemGrab,Crystal Arcade,12,3,15
12172,2023-01-18,EMZ,brawlBall,Sunny Soccer,125,144,269
12173,2023-01-18,EMZ,brawlBall,Beach Ball,0,4,4
12174,2023-01-18,EMZ,bounty,Shooting Star,6,1,7
12175,2023-01-17,EMZ,knockout,Goldarm Gulch,3,3,6
12176,2023-01-17,EMZ,hotZone,Parallel Plays,13,13,26
12177,2023-01-17,EMZ,heist,Pit Stop,10,7,17
12178,2023-01-17,EMZ,gemGrab,Minecart Madness,1,0,1
12179,2023-01-17,EMZ,gemGrab,Crystal Arcade,14,16,30
12180,2023-01-17,EMZ,brawlBall,Center Stage,1,1,2
12181,2023-01-17,EMZ,brawlBall,Beach Ball,31,24,55
12182,2023-01-17,EMZ,bounty,Hideout,1,0,1
12183,2023-01-16,EMZ,knockout,Belle's Rock,2,0,2
12184,2023-01-16,EMZ,hotZone,Quarter Pounder,18,18,36
12185,2023-01-16,EMZ,heist,Pit Stop,47,68,115
12186,2023-01-16,EMZ,gemGrab,Minecart Madness,3,3,6
12187,2023-01-16,EMZ,gemGrab,Double Swoosh,12,14,26
12188,2023-01-16,EMZ,brawlBall,Center Stage,36,45,81
12189,2023-01-16,EMZ,brawlBall,Backyard Bowl,2,4,6
12190,2023-01-16,EMZ,bounty,Hideout,1,0,1
12191,2023-01-15,EMZ,knockout,Belle's Rock,1,1,2
12192,2023-01-15,EMZ,hotZone,Quarter Pounder,40,20,60
12193,2023-01-15,EMZ,heist,Bridge Too Far,3,0,3
12194,2023-01-15,EMZ,gemGrab,Hard Rock Mine,8,2,10
12195,2023-01-15,EMZ,gemGrab,Double Swoosh,46,38,84
12196,2023-01-15,EMZ,brawlBall,Super Beach,4,3,7
12197,2023-01-15,EMZ,brawlBall,Backyard Bowl,24,5,29
12198,2023-01-15,EMZ,bounty,Canal Grande,5,1,6
12199,2023-01-14,EMZ,knockout,Flaring Phoenix,2,1,3
12200,2023-01-14,EMZ,hotZone,Controller Chaos,76,67,143
12201,2023-01-14,EMZ,heist,Bridge Too Far,3,1,4
12202,2023-01-14,EMZ,gemGrab,Hard Rock Mine,7,1,8
12203,2023-01-14,EMZ,gemGrab,Deep Diner,5,1,6
12204,2023-01-14,EMZ,brawlBall,Super Beach,41,27,68
12205,2023-01-14,EMZ,brawlBall,Sneaky Fields,16,6,22
12206,2023-01-14,EMZ,bounty,Canal Grande,3,3,6
12207,2023-01-13,EMZ,hotZone,Controller Chaos,86,85,171
12208,2023-01-13,EMZ,heist,Hot Potato,18,12,30
12209,2023-01-13,EMZ,gemGrab,Undermine,1,0,1
12210,2023-01-13,EMZ,gemGrab,Deep Diner,10,5,15
12211,2023-01-13,EMZ,brawlBall,Sneaky Fields,65,39,104
12212,2023-01-13,EMZ,bounty,Temple Ruins,2,0,2
12213,2023-01-12,EMZ,knockout,Riverside,1,0,1
12214,2023-01-12,EMZ,hotZone,Open Zone,17,0,17
12215,2023-01-12,EMZ,heist,Hot Potato,17,31,48
12216,2023-01-12,EMZ,gemGrab,Undermine,10,8,18
12217,2023-01-12,EMZ,gemGrab,Gem Fort,2,1,3
12218,2023-01-12,EMZ,brawlBall,Sunny Soccer,6,8,14
12219,2023-01-12,EMZ,brawlBall,Pinhole Punt,22,11,33
12220,2023-01-11,EMZ,hotZone,Open Zone,2,0,2
12221,2023-01-11,EMZ,heist,Safe Zone,1,0,1
12222,2023-01-11,EMZ,gemGrab,Gem Fort,7,9,16
12223,2023-01-11,EMZ,brawlBall,Sunny Soccer,15,14,29
12224,2023-01-10,EMZ,knockout,New Perspective,1,0,1
12225,2023-01-10,EMZ,hotZone,Dueling Beetles,41,8,49
12226,2023-01-10,EMZ,heist,Safe Zone,2,0,2
12227,2023-01-10,EMZ,gemGrab,Minecart Madness,7,6,13
12228,2023-01-10,EMZ,gemGrab,Crystal Arcade,16,4,20
12229,2023-01-10,EMZ,brawlBall,Center Stage,15,55,70
12230,2023-01-10,EMZ,brawlBall,Beach Ball,29,17,46
12231,2023-01-09,EMZ,knockout,New Perspective,4,1,5
12232,2023-01-09,EMZ,hotZone,Dueling Beetles,21,8,29
12233,2023-01-09,EMZ,heist,Snaked Assault,59,78,137
12234,2023-01-09,EMZ,gemGrab,Minecart Madness,10,7,17
12235,2023-01-09,EMZ,gemGrab,Double Swoosh,21,9,30
12236,2023-01-09,EMZ,brawlBall,Center Stage,52,144,196
12237,2023-01-09,EMZ,bounty,Layer Cake,5,0,5
12238,2023-01-08,EMZ,knockout,X Marks the Spot,4,0,4
12239,2023-01-08,EMZ,hotZone,Ring of Fire,11,4,15
12240,2023-01-08,EMZ,heist,Snaked Assault,67,45,112
12241,2023-01-08,EMZ,gemGrab,Hard Rock Mine,5,1,6
12242,2023-01-08,EMZ,gemGrab,Double Swoosh,21,13,34
12243,2023-01-08,EMZ,brawlBall,Super Beach,3,2,5
12244,2023-01-08,EMZ,brawlBall,Backyard Bowl,7,5,12
12245,2023-01-07,EMZ,knockout,X Marks the Spot,1,0,1
12246,2023-01-07,EMZ,hotZone,Ring of Fire,10,1,11
12247,2023-01-07,EMZ,heist,Tornado Ring,70,83,153
12248,2023-01-07,EMZ,gemGrab,Hard Rock Mine,6,1,7
12249,2023-01-07,EMZ,gemGrab,Deep Diner,7,4,11
12250,2023-01-07,EMZ,brawlBall,Super Beach,23,11,34
12251,2023-01-07,EMZ,brawlBall,Sneaky Fields,4,14,18
12252,2023-01-07,EMZ,bounty,Dry Season,1,0,1
12253,2023-01-06,EMZ,knockout,Out in the Open,2,2,4
12254,2023-01-06,EMZ,hotZone,Split,4,0,4
12255,2023-01-06,EMZ,heist,Tornado Ring,164,164,328
12256,2023-01-06,EMZ,gemGrab,Undermine,10,10,20
12257,2023-01-06,EMZ,gemGrab,Deep Diner,10,4,14
12258,2023-01-06,EMZ,brawlBall,Sneaky Fields,47,87,134
12259,2023-01-06,EMZ,brawlBall,Pinhole Punt,2,5,7
12260,2023-01-06,EMZ,bounty,Dry Season,1,0,1
12261,2023-01-05,EMZ,knockout,Out in the Open,5,0,5
12262,2023-01-05,EMZ,hotZone,Split,9,0,9
12263,2023-01-05,EMZ,heist,Kaboom Canyon,4,0,4
12264,2023-01-05,EMZ,gemGrab,Undermine,23,25,48
12265,2023-01-05,EMZ,gemGrab,Gem Fort,3,2,5
12266,2023-01-05,EMZ,brawlBall,Sunny Soccer,1,0,1
12267,2023-01-05,EMZ,brawlBall,Pinhole Punt,66,70,136
12268,2023-01-04,EMZ,knockout,Goldarm Gulch,3,0,3
12269,2023-01-04,EMZ,hotZone,Parallel Plays,12,3,15
12270,2023-01-04,EMZ,heist,Kaboom Canyon,14,0,14
12271,2023-01-04,EMZ,gemGrab,Gem Fort,21,15,36
12272,2023-01-04,EMZ,gemGrab,Crystal Arcade,9,5,14
12273,2023-01-04,EMZ,brawlBall,Sunny Soccer,47,98,145
12274,2023-01-04,EMZ,bounty,Shooting Star,1,0,1
12275,2023-01-03,EMZ,knockout,Goldarm Gulch,1,0,1
12276,2023-01-03,EMZ,hotZone,Parallel Plays,23,10,33
12277,2023-01-03,EMZ,heist,Pit Stop,12,20,32
12278,2023-01-03,EMZ,gemGrab,Minecart Madness,2,0,2
12279,2023-01-03,EMZ,gemGrab,Crystal Arcade,15,3,18
12280,2023-01-03,EMZ,brawlBall,Center Stage,4,10,14
12281,2023-01-03,EMZ,brawlBall,Beach Ball,41,46,87
12282,2023-01-03,EMZ,bounty,Hideout,2,1,3
12283,2023-01-02,EMZ,hotZone,Quarter Pounder,42,4,46
12284,2023-01-02,EMZ,hotZone,Controller Chaos,1,1,2
12285,2023-01-02,EMZ,heist,Pit Stop,42,37,79
12286,2023-01-02,EMZ,heist,Kaboom Canyon,0,1,1
12287,2023-01-02,EMZ,gemGrab,Minecart Madness,7,2,9
12288,2023-01-02,EMZ,gemGrab,Double Swoosh,25,29,54
12289,2023-01-02,EMZ,brawlBall,Center Stage,70,69,139
12290,2023-01-02,EMZ,brawlBall,Backyard Bowl,2,3,5
12291,2023-01-02,EMZ,bounty,Hideout,4,0,4
12292,2023-01-01,EMZ,hotZone,Quarter Pounder,9,1,10
12293,2023-01-01,EMZ,heist,Kaboom Canyon,1,0,1
12294,2023-01-01,EMZ,heist,Bridge Too Far,1,0,1
12295,2023-01-01,EMZ,gemGrab,Double Swoosh,15,17,32
12296,2023-01-01,EMZ,brawlBall,Backyard Bowl,4,5,9
12297,2023-01-01,EMZ,bounty,Canal Grande,1,0,1
12298,2022-12-31,EMZ,hotZone,Controller Chaos,6,3,9
12299,2022-12-31,EMZ,gemGrab,Hard Rock Mine,4,0,4
12300,2022-12-31,EMZ,gemGrab,Deep Diner,2,0,2
12301,2022-12-31,EMZ,brawlBall,Super Beach,4,5,9
12302,2022-12-30,EMZ,knockout,Flaring Phoenix,0,1,1
12303,2022-12-30,EMZ,hotZone,Controller Chaos,4,2,6
12304,2022-12-30,EMZ,heist,Kaboom Canyon,0,1,1
12305,2022-12-30,EMZ,gemGrab,Undermine,1,0,1
12306,2022-12-30,EMZ,gemGrab,Minecart Madness,0,1,1
12307,2022-12-30,EMZ,gemGrab,Deep Diner,1,0,1
12308,2022-12-30,EMZ,brawlBall,Sneaky Fields,10,12,22
12309,2022-12-29,EMZ,hotZone,Open Zone,1,0,1
12310,2022-12-29,EMZ,hotZone,Controller Chaos,0,1,1
12311,2022-12-29,EMZ,heist,Hot Potato,4,1,5
12312,2022-12-29,EMZ,gemGrab,Undermine,7,4,11
12313,2022-12-29,EMZ,gemGrab,Minecart Madness,0,1,1
12314,2022-12-29,EMZ,brawlBall,Pinhole Punt,1,0,1
12315,2022-12-27,EMZ,hotZone,Dueling Beetles,0,1,1
12316,2022-12-27,EMZ,hotZone,Controller Chaos,0,2,2
12317,2022-12-27,EMZ,heist,Kaboom Canyon,1,0,1
12318,2022-12-27,EMZ,brawlBall,Beach Ball,1,1,2
12319,2022-12-26,EMZ,hotZone,Controller Chaos,2,0,2
12320,2022-12-26,EMZ,gemGrab,Minecart Madness,1,2,3
12321,2022-12-26,EMZ,brawlBall,Center Stage,1,1,2
12322,2022-12-25,EMZ,hotZone,Ring of Fire,1,0,1
12323,2022-12-25,EMZ,gemGrab,Double Swoosh,1,1,2
12324,2022-12-22,EMZ,gemGrab,Gem Fort,1,0,1
12325,2022-12-22,EMZ,brawlBall,Pinhole Punt,2,1,3
12326,2022-12-20,EMZ,brawlBall,Beach Ball,0,1,1
12327,2022-12-19,EMZ,brawlBall,Center Stage,2,3,5
12328,2022-12-16,EMZ,brawlBall,Sneaky Fields,1,0,1
12329,2022-12-13,EMZ,hotZone,Dueling Beetles,1,0,1
12330,2022-12-13,EMZ,brawlBall,Beach Ball,1,0,1
12331,2022-12-11,EMZ,gemGrab,Double Swoosh,1,1,2
12332,2022-11-11,EMZ,brawlBall,Sneaky Fields,1,4,5
12333,2022-10-30,EMZ,hotZone,Dueling Beetles,1,0,1
12334,2022-10-30,EMZ,brawlBall,Beach Ball,1,0,1
12335,2022-10-30,EMZ,bounty,Canal Grande,0,1,1
12336,2022-10-28,EMZ,brawlBall,Beach Ball,1,2,3
12337,2022-10-15,EMZ,gemGrab,Hard Rock Mine,3,1,4
12338,2023-02-05,EL PRIMO,knockout,X Marks the Spot,12,3,15
12339,2023-02-05,EL PRIMO,knockout,Goldarm Gulch,0,1,1
12340,2023-02-05,EL PRIMO,hotZone,Ring of Fire,18,11,29
12341,2023-02-05,EL PRIMO,heist,Snaked Assault,186,113,299
12342,2023-02-05,EL PRIMO,heist,Pit Stop,106,140,246
12343,2023-02-05,EL PRIMO,gemGrab,Hard Rock Mine,39,29,68
12344,2023-02-05,EL PRIMO,gemGrab,Double Swoosh,115,66,181
12345,2023-02-05,EL PRIMO,brawlBall,Super Beach,45,39,84
12346,2023-02-05,EL PRIMO,brawlBall,Sneaky Fields,118,129,247
12347,2023-02-05,EL PRIMO,brawlBall,Backyard Bowl,519,397,916
12348,2023-02-05,EL PRIMO,bounty,Layer Cake,30,27,57
12349,2023-02-04,EL PRIMO,knockout,X Marks the Spot,5,1,6
12350,2023-02-04,EL PRIMO,knockout,Goldarm Gulch,2,1,3
12351,2023-02-04,EL PRIMO,hotZone,Ring of Fire,5,4,9
12352,2023-02-04,EL PRIMO,heist,Tornado Ring,16,12,28
12353,2023-02-04,EL PRIMO,heist,Pit Stop,87,111,198
12354,2023-02-04,EL PRIMO,gemGrab,Hard Rock Mine,15,7,22
12355,2023-02-04,EL PRIMO,gemGrab,Double Swoosh,29,3,32
12356,2023-02-04,EL PRIMO,gemGrab,Deep Diner,1,1,2
12357,2023-02-04,EL PRIMO,brawlBall,Super Beach,340,351,691
12358,2023-02-04,EL PRIMO,brawlBall,Sneaky Fields,86,61,147
12359,2023-02-04,EL PRIMO,bounty,Dry Season,2,1,3
12360,2023-02-03,EL PRIMO,knockout,Out in the Open,14,8,22
12361,2023-02-03,EL PRIMO,knockout,Goldarm Gulch,6,5,11
12362,2023-02-03,EL PRIMO,hotZone,Split,71,67,138
12363,2023-02-03,EL PRIMO,heist,Tornado Ring,217,124,341
12364,2023-02-03,EL PRIMO,heist,Pit Stop,435,540,975
12365,2023-02-03,EL PRIMO,gemGrab,Undermine,13,5,18
12366,2023-02-03,EL PRIMO,gemGrab,Double Swoosh,134,41,175
12367,2023-02-03,EL PRIMO,gemGrab,Deep Diner,43,27,70
12368,2023-02-03,EL PRIMO,brawlBall,Sneaky Fields,2771,2438,5209
12369,2023-02-03,EL PRIMO,brawlBall,Pinhole Punt,47,45,92
12370,2023-02-03,EL PRIMO,bounty,Dry Season,16,4,20
12371,2023-02-02,EL PRIMO,knockout,Out in the Open,9,2,11
12372,2023-02-02,EL PRIMO,hotZone,Split,39,48,87
12373,2023-02-02,EL PRIMO,heist,Kaboom Canyon,17,3,20
12374,2023-02-02,EL PRIMO,gemGrab,Undermine,11,6,17
12375,2023-02-02,EL PRIMO,gemGrab,Gem Fort,4,3,7
12376,2023-02-02,EL PRIMO,brawlBall,Sunny Soccer,26,28,54
12377,2023-02-02,EL PRIMO,brawlBall,Pinhole Punt,275,236,511
12378,2023-02-01,EL PRIMO,knockout,Goldarm Gulch,36,20,56
12379,2023-02-01,EL PRIMO,hotZone,Parallel Plays,59,44,103
12380,2023-02-01,EL PRIMO,heist,Kaboom Canyon,32,27,59
12381,2023-02-01,EL PRIMO,gemGrab,Gem Fort,51,38,89
12382,2023-02-01,EL PRIMO,gemGrab,Crystal Arcade,27,16,43
12383,2023-02-01,EL PRIMO,brawlBall,Sunny Soccer,1146,985,2131
12384,2023-02-01,EL PRIMO,brawlBall,Beach Ball,36,31,67
12385,2023-02-01,EL PRIMO,bounty,Shooting Star,3,1,4
12386,2023-01-31,EL PRIMO,knockout,Goldarm Gulch,18,10,28
12387,2023-01-31,EL PRIMO,hotZone,Parallel Plays,14,14,28
12388,2023-01-31,EL PRIMO,heist,Pit Stop,87,102,189
12389,2023-01-31,EL PRIMO,gemGrab,Minecart Madness,3,0,3
12390,2023-01-31,EL PRIMO,gemGrab,Crystal Arcade,37,16,53
12391,2023-01-31,EL PRIMO,brawlBall,Center Stage,19,19,38
12392,2023-01-31,EL PRIMO,brawlBall,Beach Ball,454,359,813
12393,2023-01-30,EL PRIMO,knockout,Belle's Rock,42,18,60
12394,2023-01-30,EL PRIMO,hotZone,Quarter Pounder,65,15,80
12395,2023-01-30,EL PRIMO,heist,Pit Stop,310,335,645
12396,2023-01-30,EL PRIMO,gemGrab,Minecart Madness,35,16,51
12397,2023-01-30,EL PRIMO,gemGrab,Double Swoosh,60,47,107
12398,2023-01-30,EL PRIMO,brawlBall,Center Stage,1264,1233,2497
12399,2023-01-30,EL PRIMO,brawlBall,Backyard Bowl,58,53,111
12400,2023-01-30,EL PRIMO,bounty,Hideout,4,1,5
12401,2023-01-29,EL PRIMO,knockout,Belle's Rock,32,21,53
12402,2023-01-29,EL PRIMO,hotZone,Quarter Pounder,43,7,50
12403,2023-01-29,EL PRIMO,heist,Bridge Too Far,41,13,54
12404,2023-01-29,EL PRIMO,gemGrab,Hard Rock Mine,9,6,15
12405,2023-01-29,EL PRIMO,gemGrab,Double Swoosh,73,41,114
12406,2023-01-29,EL PRIMO,brawlBall,Super Beach,38,37,75
12407,2023-01-29,EL PRIMO,brawlBall,Backyard Bowl,569,420,989
12408,2023-01-29,EL PRIMO,bounty,Canal Grande,22,9,31
12409,2023-01-28,EL PRIMO,knockout,Flaring Phoenix,32,7,39
12410,2023-01-28,EL PRIMO,hotZone,Controller Chaos,76,30,106
12411,2023-01-28,EL PRIMO,heist,Bridge Too Far,85,32,117
12412,2023-01-28,EL PRIMO,gemGrab,Hard Rock Mine,80,83,163
12413,2023-01-28,EL PRIMO,gemGrab,Deep Diner,13,4,17
12414,2023-01-28,EL PRIMO,brawlBall,Super Beach,1307,1190,2497
12415,2023-01-28,EL PRIMO,brawlBall,Sneaky Fields,103,69,172
12416,2023-01-28,EL PRIMO,bounty,Canal Grande,30,12,42
12417,2023-01-27,EL PRIMO,knockout,Flaring Phoenix,16,7,23
12418,2023-01-27,EL PRIMO,hotZone,Controller Chaos,9,6,15
12419,2023-01-27,EL PRIMO,heist,Hot Potato,50,35,85
12420,2023-01-27,EL PRIMO,gemGrab,Undermine,1,2,3
12421,2023-01-27,EL PRIMO,gemGrab,Deep Diner,18,6,24
12422,2023-01-27,EL PRIMO,brawlBall,Sneaky Fields,628,542,1170
12423,2023-01-27,EL PRIMO,brawlBall,Pinhole Punt,13,14,27
12424,2023-01-27,EL PRIMO,bounty,Temple Ruins,4,0,4
12425,2023-01-26,EL PRIMO,knockout,Riverside,18,7,25
12426,2023-01-26,EL PRIMO,hotZone,Open Zone,20,5,25
12427,2023-01-26,EL PRIMO,heist,Hot Potato,176,147,323
12428,2023-01-26,EL PRIMO,gemGrab,Undermine,34,29,63
12429,2023-01-26,EL PRIMO,gemGrab,Gem Fort,32,16,48
12430,2023-01-26,EL PRIMO,brawlBall,Sunny Soccer,89,81,170
12431,2023-01-26,EL PRIMO,brawlBall,Pinhole Punt,907,697,1604
12432,2023-01-26,EL PRIMO,bounty,Temple Ruins,18,2,20
12433,2023-01-25,EL PRIMO,knockout,Riverside,17,4,21
12434,2023-01-25,EL PRIMO,hotZone,Open Zone,6,1,7
12435,2023-01-25,EL PRIMO,heist,Safe Zone,25,21,46
12436,2023-01-25,EL PRIMO,gemGrab,Gem Fort,41,36,77
12437,2023-01-25,EL PRIMO,gemGrab,Crystal Arcade,26,18,44
12438,2023-01-25,EL PRIMO,brawlBall,Sunny Soccer,759,623,1382
12439,2023-01-25,EL PRIMO,brawlBall,Beach Ball,127,103,230
12440,2023-01-25,EL PRIMO,bounty,Excel,16,16,32
12441,2023-01-24,EL PRIMO,knockout,New Perspective,18,9,27
12442,2023-01-24,EL PRIMO,hotZone,Dueling Beetles,39,8,47
12443,2023-01-24,EL PRIMO,heist,Safe Zone,67,47,114
12444,2023-01-24,EL PRIMO,gemGrab,Minecart Madness,19,22,41
12445,2023-01-24,EL PRIMO,gemGrab,Crystal Arcade,45,36,81
12446,2023-01-24,EL PRIMO,brawlBall,Center Stage,184,152,336
12447,2023-01-24,EL PRIMO,brawlBall,Beach Ball,1154,883,2037
12448,2023-01-24,EL PRIMO,bounty,Excel,8,10,18
12449,2023-01-23,EL PRIMO,knockout,New Perspective,42,21,63
12450,2023-01-23,EL PRIMO,hotZone,Dueling Beetles,60,19,79
12451,2023-01-23,EL PRIMO,heist,Snaked Assault,236,166,402
12452,2023-01-23,EL PRIMO,gemGrab,Minecart Madness,62,34,96
12453,2023-01-23,EL PRIMO,gemGrab,Double Swoosh,39,15,54
12454,2023-01-23,EL PRIMO,brawlBall,Center Stage,2101,1960,4061
12455,2023-01-23,EL PRIMO,brawlBall,Backyard Bowl,37,25,62
12456,2023-01-23,EL PRIMO,bounty,Layer Cake,20,20,40
12457,2023-01-22,EL PRIMO,knockout,X Marks the Spot,9,3,12
12458,2023-01-22,EL PRIMO,hotZone,Ring of Fire,25,24,49
12459,2023-01-22,EL PRIMO,heist,Snaked Assault,98,72,170
12460,2023-01-22,EL PRIMO,gemGrab,Hard Rock Mine,21,25,46
12461,2023-01-22,EL PRIMO,gemGrab,Double Swoosh,56,27,83
12462,2023-01-22,EL PRIMO,brawlBall,Super Beach,149,125,274
12463,2023-01-22,EL PRIMO,brawlBall,Backyard Bowl,265,203,468
12464,2023-01-22,EL PRIMO,bounty,Layer Cake,11,7,18
12465,2023-01-21,EL PRIMO,knockout,X Marks the Spot,40,19,59
12466,2023-01-21,EL PRIMO,hotZone,Ring of Fire,31,48,79
12467,2023-01-21,EL PRIMO,heist,Tornado Ring,213,170,383
12468,2023-01-21,EL PRIMO,gemGrab,Hard Rock Mine,101,76,177
12469,2023-01-21,EL PRIMO,gemGrab,Deep Diner,9,8,17
12470,2023-01-21,EL PRIMO,brawlBall,Super Beach,1635,1414,3049
12471,2023-01-21,EL PRIMO,brawlBall,Sneaky Fields,86,87,173
12472,2023-01-21,EL PRIMO,bounty,Dry Season,18,7,25
12473,2023-01-20,EL PRIMO,knockout,Out in the Open,33,13,46
12474,2023-01-20,EL PRIMO,hotZone,Split,77,59,136
12475,2023-01-20,EL PRIMO,heist,Tornado Ring,146,123,269
12476,2023-01-20,EL PRIMO,gemGrab,Undermine,16,5,21
12477,2023-01-20,EL PRIMO,gemGrab,Deep Diner,57,32,89
12478,2023-01-20,EL PRIMO,brawlBall,Sneaky Fields,1926,1716,3642
12479,2023-01-20,EL PRIMO,brawlBall,Pinhole Punt,36,24,60
12480,2023-01-20,EL PRIMO,bounty,Dry Season,7,7,14
12481,2023-01-19,EL PRIMO,knockout,Out in the Open,28,17,45
12482,2023-01-19,EL PRIMO,hotZone,Split,125,74,199
12483,2023-01-19,EL PRIMO,heist,Kaboom Canyon,48,21,69
12484,2023-01-19,EL PRIMO,gemGrab,Undermine,60,28,88
12485,2023-01-19,EL PRIMO,gemGrab,Gem Fort,15,13,28
12486,2023-01-19,EL PRIMO,brawlBall,Sunny Soccer,65,49,114
12487,2023-01-19,EL PRIMO,brawlBall,Pinhole Punt,912,727,1639
12488,2023-01-19,EL PRIMO,bounty,Shooting Star,5,2,7
12489,2023-01-18,EL PRIMO,knockout,Goldarm Gulch,5,5,10
12490,2023-01-18,EL PRIMO,hotZone,Parallel Plays,3,2,5
12491,2023-01-18,EL PRIMO,heist,Kaboom Canyon,6,3,9
12492,2023-01-18,EL PRIMO,gemGrab,Gem Fort,13,12,25
12493,2023-01-18,EL PRIMO,gemGrab,Crystal Arcade,2,2,4
12494,2023-01-18,EL PRIMO,brawlBall,Sunny Soccer,360,337,697
12495,2023-01-18,EL PRIMO,brawlBall,Beach Ball,12,6,18
12496,2023-01-18,EL PRIMO,bounty,Shooting Star,3,0,3
12497,2023-01-17,EL PRIMO,knockout,Goldarm Gulch,6,5,11
12498,2023-01-17,EL PRIMO,hotZone,Parallel Plays,7,3,10
12499,2023-01-17,EL PRIMO,heist,Pit Stop,23,31,54
12500,2023-01-17,EL PRIMO,gemGrab,Minecart Madness,2,0,2
12501,2023-01-17,EL PRIMO,gemGrab,Crystal Arcade,4,4,8
12502,2023-01-17,EL PRIMO,brawlBall,Center Stage,4,8,12
12503,2023-01-17,EL PRIMO,brawlBall,Beach Ball,85,75,160
12504,2023-01-16,EL PRIMO,knockout,Belle's Rock,4,1,5
12505,2023-01-16,EL PRIMO,hotZone,Quarter Pounder,3,0,3
12506,2023-01-16,EL PRIMO,heist,Pit Stop,93,80,173
12507,2023-01-16,EL PRIMO,gemGrab,Minecart Madness,4,0,4
12508,2023-01-16,EL PRIMO,gemGrab,Double Swoosh,1,0,1
12509,2023-01-16,EL PRIMO,brawlBall,Center Stage,119,98,217
12510,2023-01-16,EL PRIMO,brawlBall,Backyard Bowl,12,4,16
12511,2023-01-15,EL PRIMO,knockout,Belle's Rock,2,4,6
12512,2023-01-15,EL PRIMO,hotZone,Quarter Pounder,18,3,21
12513,2023-01-15,EL PRIMO,heist,Bridge Too Far,6,2,8
12514,2023-01-15,EL PRIMO,gemGrab,Hard Rock Mine,5,1,6
12515,2023-01-15,EL PRIMO,gemGrab,Double Swoosh,13,5,18
12516,2023-01-15,EL PRIMO,brawlBall,Super Beach,15,6,21
12517,2023-01-15,EL PRIMO,brawlBall,Backyard Bowl,74,39,113
12518,2023-01-15,EL PRIMO,bounty,Canal Grande,3,1,4
12519,2023-01-14,EL PRIMO,knockout,Flaring Phoenix,1,2,3
12520,2023-01-14,EL PRIMO,hotZone,Controller Chaos,12,1,13
12521,2023-01-14,EL PRIMO,heist,Bridge Too Far,4,0,4
12522,2023-01-14,EL PRIMO,gemGrab,Hard Rock Mine,4,1,5
12523,2023-01-14,EL PRIMO,gemGrab,Deep Diner,1,1,2
12524,2023-01-14,EL PRIMO,brawlBall,Super Beach,93,56,149
12525,2023-01-14,EL PRIMO,brawlBall,Sneaky Fields,19,22,41
12526,2023-01-14,EL PRIMO,bounty,Canal Grande,5,1,6
12527,2023-01-13,EL PRIMO,knockout,Flaring Phoenix,1,3,4
12528,2023-01-13,EL PRIMO,hotZone,Controller Chaos,15,5,20
12529,2023-01-13,EL PRIMO,heist,Hot Potato,6,1,7
12530,2023-01-13,EL PRIMO,gemGrab,Deep Diner,4,1,5
12531,2023-01-13,EL PRIMO,brawlBall,Sneaky Fields,146,166,312
12532,2023-01-13,EL PRIMO,brawlBall,Pinhole Punt,2,0,2
12533,2023-01-12,EL PRIMO,hotZone,Open Zone,1,0,1
12534,2023-01-12,EL PRIMO,heist,Hot Potato,4,2,6
12535,2023-01-12,EL PRIMO,gemGrab,Undermine,2,4,6
12536,2023-01-12,EL PRIMO,gemGrab,Gem Fort,1,0,1
12537,2023-01-12,EL PRIMO,brawlBall,Sunny Soccer,8,18,26
12538,2023-01-12,EL PRIMO,brawlBall,Pinhole Punt,31,17,48
12539,2023-01-11,EL PRIMO,brawlBall,Sunny Soccer,30,19,49
12540,2023-01-11,EL PRIMO,brawlBall,Beach Ball,0,2,2
12541,2023-01-10,EL PRIMO,knockout,New Perspective,1,1,2
12542,2023-01-10,EL PRIMO,hotZone,Dueling Beetles,9,0,9
12543,2023-01-10,EL PRIMO,heist,Safe Zone,8,1,9
12544,2023-01-10,EL PRIMO,gemGrab,Minecart Madness,4,0,4
12545,2023-01-10,EL PRIMO,gemGrab,Crystal Arcade,6,3,9
12546,2023-01-10,EL PRIMO,brawlBall,Center Stage,10,5,15
12547,2023-01-10,EL PRIMO,brawlBall,Beach Ball,60,29,89
12548,2023-01-09,EL PRIMO,knockout,New Perspective,1,1,2
12549,2023-01-09,EL PRIMO,hotZone,Dueling Beetles,6,0,6
12550,2023-01-09,EL PRIMO,heist,Snaked Assault,48,4,52
12551,2023-01-09,EL PRIMO,gemGrab,Minecart Madness,7,1,8
12552,2023-01-09,EL PRIMO,gemGrab,Double Swoosh,1,0,1
12553,2023-01-09,EL PRIMO,brawlBall,Center Stage,98,92,190
12554,2023-01-09,EL PRIMO,brawlBall,Backyard Bowl,4,0,4
12555,2023-01-09,EL PRIMO,bounty,Layer Cake,4,0,4
12556,2023-01-08,EL PRIMO,knockout,X Marks the Spot,4,0,4
12557,2023-01-08,EL PRIMO,hotZone,Ring of Fire,3,0,3
12558,2023-01-08,EL PRIMO,heist,Snaked Assault,18,24,42
12559,2023-01-08,EL PRIMO,gemGrab,Hard Rock Mine,5,0,5
12560,2023-01-08,EL PRIMO,gemGrab,Double Swoosh,3,1,4
12561,2023-01-08,EL PRIMO,brawlBall,Super Beach,6,2,8
12562,2023-01-08,EL PRIMO,brawlBall,Backyard Bowl,39,8,47
12563,2023-01-07,EL PRIMO,knockout,X Marks the Spot,1,0,1
12564,2023-01-07,EL PRIMO,hotZone,Ring of Fire,2,2,4
12565,2023-01-07,EL PRIMO,heist,Tornado Ring,23,2,25
12566,2023-01-07,EL PRIMO,gemGrab,Hard Rock Mine,4,10,14
12567,2023-01-07,EL PRIMO,gemGrab,Deep Diner,6,7,13
12568,2023-01-07,EL PRIMO,brawlBall,Super Beach,32,30,62
12569,2023-01-07,EL PRIMO,brawlBall,Sneaky Fields,7,0,7
12570,2023-01-07,EL PRIMO,bounty,Dry Season,1,0,1
12571,2023-01-06,EL PRIMO,hotZone,Split,12,1,13
12572,2023-01-06,EL PRIMO,heist,Tornado Ring,16,6,22
12573,2023-01-06,EL PRIMO,gemGrab,Undermine,2,0,2
12574,2023-01-06,EL PRIMO,gemGrab,Deep Diner,5,1,6
12575,2023-01-06,EL PRIMO,brawlBall,Sneaky Fields,96,59,155
12576,2023-01-06,EL PRIMO,brawlBall,Pinhole Punt,5,1,6
12577,2023-01-06,EL PRIMO,bounty,Dry Season,1,0,1
12578,2023-01-05,EL PRIMO,knockout,Out in the Open,1,0,1
12579,2023-01-05,EL PRIMO,hotZone,Split,22,6,28
12580,2023-01-05,EL PRIMO,heist,Kaboom Canyon,4,2,6
12581,2023-01-05,EL PRIMO,gemGrab,Undermine,5,1,6
12582,2023-01-05,EL PRIMO,gemGrab,Gem Fort,1,0,1
12583,2023-01-05,EL PRIMO,brawlBall,Sunny Soccer,2,0,2
12584,2023-01-05,EL PRIMO,brawlBall,Pinhole Punt,67,26,93
12585,2023-01-04,EL PRIMO,knockout,Goldarm Gulch,2,0,2
12586,2023-01-04,EL PRIMO,hotZone,Parallel Plays,4,0,4
12587,2023-01-04,EL PRIMO,heist,Kaboom Canyon,8,1,9
12588,2023-01-04,EL PRIMO,gemGrab,Gem Fort,7,5,12
12589,2023-01-04,EL PRIMO,brawlBall,Sunny Soccer,81,65,146
12590,2023-01-04,EL PRIMO,bounty,Shooting Star,1,0,1
12591,2023-01-03,EL PRIMO,knockout,Goldarm Gulch,0,1,1
12592,2023-01-03,EL PRIMO,hotZone,Parallel Plays,8,0,8
12593,2023-01-03,EL PRIMO,heist,Pit Stop,54,71,125
12594,2023-01-03,EL PRIMO,gemGrab,Minecart Madness,2,0,2
12595,2023-01-03,EL PRIMO,gemGrab,Crystal Arcade,3,0,3
12596,2023-01-03,EL PRIMO,brawlBall,Center Stage,2,2,4
12597,2023-01-03,EL PRIMO,brawlBall,Beach Ball,73,35,108
12598,2023-01-03,EL PRIMO,bounty,Hideout,2,0,2
12599,2023-01-02,EL PRIMO,knockout,Belle's Rock,2,0,2
12600,2023-01-02,EL PRIMO,hotZone,Quarter Pounder,9,2,11
12601,2023-01-02,EL PRIMO,hotZone,Controller Chaos,2,1,3
12602,2023-01-02,EL PRIMO,heist,Pit Stop,85,178,263
12603,2023-01-02,EL PRIMO,heist,Kaboom Canyon,1,0,1
12604,2023-01-02,EL PRIMO,gemGrab,Minecart Madness,2,3,5
12605,2023-01-02,EL PRIMO,gemGrab,Double Swoosh,5,1,6
12606,2023-01-02,EL PRIMO,brawlBall,Center Stage,117,83,200
12607,2023-01-02,EL PRIMO,brawlBall,Backyard Bowl,4,0,4
12608,2023-01-02,EL PRIMO,bounty,Hideout,3,1,4
12609,2023-01-01,EL PRIMO,hotZone,Quarter Pounder,2,0,2
12610,2023-01-01,EL PRIMO,heist,Bridge Too Far,1,0,1
12611,2023-01-01,EL PRIMO,gemGrab,Double Swoosh,5,0,5
12612,2023-01-01,EL PRIMO,brawlBall,Backyard Bowl,17,4,21
12613,2022-12-31,EL PRIMO,knockout,Flaring Phoenix,0,1,1
12614,2022-12-31,EL PRIMO,hotZone,Controller Chaos,3,1,4
12615,2022-12-31,EL PRIMO,heist,Bridge Too Far,1,0,1
12616,2022-12-31,EL PRIMO,gemGrab,Minecart Madness,1,1,2
12617,2022-12-31,EL PRIMO,gemGrab,Hard Rock Mine,2,1,3
12618,2022-12-31,EL PRIMO,gemGrab,Deep Diner,1,2,3
12619,2022-12-31,EL PRIMO,brawlBall,Super Beach,11,15,26
12620,2022-12-31,EL PRIMO,brawlBall,Sneaky Fields,2,3,5
12621,2022-12-30,EL PRIMO,knockout,Flaring Phoenix,0,1,1
12622,2022-12-30,EL PRIMO,hotZone,Controller Chaos,1,0,1
12623,2022-12-30,EL PRIMO,gemGrab,Deep Diner,2,1,3
12624,2022-12-30,EL PRIMO,brawlBall,Sneaky Fields,8,8,16
12625,2022-12-29,EL PRIMO,heist,Hot Potato,1,3,4
12626,2022-12-29,EL PRIMO,brawlBall,Pinhole Punt,1,1,2
12627,2022-12-28,EL PRIMO,brawlBall,Sunny Soccer,1,0,1
12628,2022-12-27,EL PRIMO,knockout,New Perspective,1,0,1
12629,2022-12-27,EL PRIMO,brawlBall,Center Stage,1,0,1
12630,2022-12-26,EL PRIMO,heist,Kaboom Canyon,2,0,2
12631,2022-12-26,EL PRIMO,brawlBall,Center Stage,1,0,1
12632,2022-12-23,EL PRIMO,brawlBall,Sneaky Fields,0,1,1
12633,2022-12-22,EL PRIMO,brawlBall,Pinhole Punt,2,0,2
12634,2022-12-21,EL PRIMO,brawlBall,Sunny Soccer,1,0,1
12635,2022-12-20,EL PRIMO,brawlBall,Beach Ball,2,1,3
12636,2022-12-19,EL PRIMO,brawlBall,Center Stage,0,1,1
12637,2022-12-16,EL PRIMO,brawlBall,Sneaky Fields,0,2,2
12638,2022-12-13,EL PRIMO,gemGrab,Crystal Arcade,1,0,1
12639,2022-12-13,EL PRIMO,brawlBall,Beach Ball,1,0,1
12640,2022-12-11,EL PRIMO,brawlBall,Backyard Bowl,0,1,1
12641,2022-11-11,EL PRIMO,brawlBall,Sneaky Fields,1,1,2
12642,2022-10-30,EL PRIMO,hotZone,Dueling Beetles,1,0,1
12643,2022-10-30,EL PRIMO,heist,Safe Zone,1,0,1
12644,2022-10-30,EL PRIMO,bounty,Canal Grande,1,0,1
12645,2022-10-26,EL PRIMO,brawlBall,Sunny Soccer,1,2,3
12646,2023-02-05,EDGAR,knockout,X Marks the Spot,57,31,88
12647,2023-02-05,EDGAR,knockout,Goldarm Gulch,4,1,5
12648,2023-02-05,EDGAR,hotZone,Ring of Fire,20,4,24
12649,2023-02-05,EDGAR,heist,Snaked Assault,150,61,211
12650,2023-02-05,EDGAR,heist,Pit Stop,36,44,80
12651,2023-02-05,EDGAR,gemGrab,Hard Rock Mine,18,6,24
12652,2023-02-05,EDGAR,gemGrab,Double Swoosh,135,48,183
12653,2023-02-05,EDGAR,brawlBall,Super Beach,17,16,33
12654,2023-02-05,EDGAR,brawlBall,Sneaky Fields,17,3,20
12655,2023-02-05,EDGAR,brawlBall,Backyard Bowl,171,96,267
12656,2023-02-05,EDGAR,bounty,Layer Cake,50,26,76
12657,2023-02-04,EDGAR,knockout,X Marks the Spot,12,9,21
12658,2023-02-04,EDGAR,knockout,Goldarm Gulch,2,1,3
12659,2023-02-04,EDGAR,hotZone,Ring of Fire,6,2,8
12660,2023-02-04,EDGAR,heist,Tornado Ring,10,6,16
12661,2023-02-04,EDGAR,heist,Pit Stop,21,36,57
12662,2023-02-04,EDGAR,gemGrab,Hard Rock Mine,6,5,11
12663,2023-02-04,EDGAR,gemGrab,Double Swoosh,47,7,54
12664,2023-02-04,EDGAR,gemGrab,Deep Diner,3,0,3
12665,2023-02-04,EDGAR,brawlBall,Super Beach,97,68,165
12666,2023-02-04,EDGAR,brawlBall,Sneaky Fields,33,4,37
12667,2023-02-04,EDGAR,bounty,Dry Season,3,1,4
12668,2023-02-03,EDGAR,knockout,Out in the Open,82,39,121
12669,2023-02-03,EDGAR,knockout,Goldarm Gulch,11,5,16
12670,2023-02-03,EDGAR,hotZone,Split,117,71,188
12671,2023-02-03,EDGAR,heist,Tornado Ring,155,87,242
12672,2023-02-03,EDGAR,heist,Pit Stop,163,162,325
12673,2023-02-03,EDGAR,gemGrab,Undermine,17,4,21
12674,2023-02-03,EDGAR,gemGrab,Double Swoosh,312,24,336
12675,2023-02-03,EDGAR,gemGrab,Deep Diner,67,47,114
12676,2023-02-03,EDGAR,brawlBall,Sneaky Fields,623,418,1041
12677,2023-02-03,EDGAR,brawlBall,Pinhole Punt,10,4,14
12678,2023-02-03,EDGAR,bounty,Dry Season,30,9,39
12679,2023-02-02,EDGAR,knockout,Out in the Open,37,31,68
12680,2023-02-02,EDGAR,hotZone,Split,48,25,73
12681,2023-02-02,EDGAR,heist,Kaboom Canyon,12,7,19
12682,2023-02-02,EDGAR,gemGrab,Undermine,16,12,28
12683,2023-02-02,EDGAR,gemGrab,Gem Fort,3,4,7
12684,2023-02-02,EDGAR,brawlBall,Sunny Soccer,9,8,17
12685,2023-02-02,EDGAR,brawlBall,Pinhole Punt,108,47,155
12686,2023-02-02,EDGAR,bounty,Shooting Star,8,2,10
12687,2023-02-01,EDGAR,knockout,Goldarm Gulch,163,120,283
12688,2023-02-01,EDGAR,hotZone,Parallel Plays,86,23,109
12689,2023-02-01,EDGAR,heist,Kaboom Canyon,32,21,53
12690,2023-02-01,EDGAR,gemGrab,Gem Fort,52,50,102
12691,2023-02-01,EDGAR,gemGrab,Crystal Arcade,21,7,28
12692,2023-02-01,EDGAR,brawlBall,Sunny Soccer,308,252,560
12693,2023-02-01,EDGAR,brawlBall,Beach Ball,11,8,19
12694,2023-02-01,EDGAR,bounty,Shooting Star,7,3,10
12695,2023-01-31,EDGAR,knockout,Goldarm Gulch,77,52,129
12696,2023-01-31,EDGAR,hotZone,Parallel Plays,32,13,45
12697,2023-01-31,EDGAR,heist,Pit Stop,133,151,284
12698,2023-01-31,EDGAR,gemGrab,Minecart Madness,5,4,9
12699,2023-01-31,EDGAR,gemGrab,Crystal Arcade,29,21,50
12700,2023-01-31,EDGAR,brawlBall,Center Stage,5,4,9
12701,2023-01-31,EDGAR,brawlBall,Beach Ball,137,97,234
12702,2023-01-31,EDGAR,bounty,Hideout,14,1,15
12703,2023-01-30,EDGAR,knockout,Belle's Rock,274,169,443
12704,2023-01-30,EDGAR,hotZone,Quarter Pounder,66,12,78
12705,2023-01-30,EDGAR,heist,Pit Stop,406,530,936
12706,2023-01-30,EDGAR,gemGrab,Minecart Madness,47,25,72
12707,2023-01-30,EDGAR,gemGrab,Double Swoosh,24,14,38
12708,2023-01-30,EDGAR,brawlBall,Center Stage,285,191,476
12709,2023-01-30,EDGAR,brawlBall,Backyard Bowl,18,14,32
12710,2023-01-30,EDGAR,bounty,Hideout,18,4,22
12711,2023-01-29,EDGAR,knockout,Belle's Rock,236,148,384
12712,2023-01-29,EDGAR,hotZone,Quarter Pounder,35,10,45
12713,2023-01-29,EDGAR,heist,Bridge Too Far,26,18,44
12714,2023-01-29,EDGAR,gemGrab,Hard Rock Mine,8,6,14
12715,2023-01-29,EDGAR,gemGrab,Double Swoosh,62,46,108
12716,2023-01-29,EDGAR,brawlBall,Super Beach,8,4,12
12717,2023-01-29,EDGAR,brawlBall,Backyard Bowl,179,87,266
12718,2023-01-29,EDGAR,bounty,Canal Grande,38,17,55
12719,2023-01-28,EDGAR,knockout,Flaring Phoenix,118,70,188
12720,2023-01-28,EDGAR,hotZone,Controller Chaos,46,28,74
12721,2023-01-28,EDGAR,heist,Bridge Too Far,56,13,69
12722,2023-01-28,EDGAR,gemGrab,Hard Rock Mine,57,30,87
12723,2023-01-28,EDGAR,gemGrab,Deep Diner,23,26,49
12724,2023-01-28,EDGAR,brawlBall,Super Beach,370,267,637
12725,2023-01-28,EDGAR,brawlBall,Sneaky Fields,27,12,39
12726,2023-01-28,EDGAR,bounty,Canal Grande,86,73,159
12727,2023-01-27,EDGAR,knockout,Flaring Phoenix,46,24,70
12728,2023-01-27,EDGAR,hotZone,Controller Chaos,7,4,11
12729,2023-01-27,EDGAR,heist,Hot Potato,38,52,90
12730,2023-01-27,EDGAR,gemGrab,Undermine,4,3,7
12731,2023-01-27,EDGAR,gemGrab,Deep Diner,30,15,45
12732,2023-01-27,EDGAR,brawlBall,Sneaky Fields,131,111,242
12733,2023-01-27,EDGAR,brawlBall,Pinhole Punt,3,1,4
12734,2023-01-27,EDGAR,bounty,Temple Ruins,6,4,10
12735,2023-01-26,EDGAR,knockout,Riverside,65,20,85
12736,2023-01-26,EDGAR,hotZone,Open Zone,13,7,20
12737,2023-01-26,EDGAR,heist,Hot Potato,187,161,348
12738,2023-01-26,EDGAR,gemGrab,Undermine,37,23,60
12739,2023-01-26,EDGAR,gemGrab,Gem Fort,29,15,44
12740,2023-01-26,EDGAR,brawlBall,Sunny Soccer,31,38,69
12741,2023-01-26,EDGAR,brawlBall,Pinhole Punt,249,170,419
12742,2023-01-26,EDGAR,bounty,Temple Ruins,38,26,64
12743,2023-01-25,EDGAR,knockout,Riverside,31,20,51
12744,2023-01-25,EDGAR,hotZone,Open Zone,4,1,5
12745,2023-01-25,EDGAR,heist,Safe Zone,33,19,52
12746,2023-01-25,EDGAR,gemGrab,Gem Fort,27,15,42
12747,2023-01-25,EDGAR,gemGrab,Crystal Arcade,21,19,40
12748,2023-01-25,EDGAR,brawlBall,Sunny Soccer,194,150,344
12749,2023-01-25,EDGAR,brawlBall,Beach Ball,33,16,49
12750,2023-01-25,EDGAR,bounty,Excel,46,30,76
12751,2023-01-24,EDGAR,knockout,New Perspective,104,58,162
12752,2023-01-24,EDGAR,hotZone,Dueling Beetles,32,13,45
12753,2023-01-24,EDGAR,heist,Safe Zone,53,18,71
12754,2023-01-24,EDGAR,gemGrab,Minecart Madness,7,5,12
12755,2023-01-24,EDGAR,gemGrab,Crystal Arcade,59,48,107
12756,2023-01-24,EDGAR,brawlBall,Center Stage,46,40,86
12757,2023-01-24,EDGAR,brawlBall,Beach Ball,336,203,539
12758,2023-01-24,EDGAR,bounty,Excel,52,26,78
12759,2023-01-23,EDGAR,knockout,New Perspective,121,63,184
12760,2023-01-23,EDGAR,hotZone,Dueling Beetles,36,12,48
12761,2023-01-23,EDGAR,heist,Snaked Assault,175,109,284
12762,2023-01-23,EDGAR,gemGrab,Minecart Madness,74,32,106
12763,2023-01-23,EDGAR,gemGrab,Double Swoosh,30,12,42
12764,2023-01-23,EDGAR,brawlBall,Center Stage,453,361,814
12765,2023-01-23,EDGAR,brawlBall,Backyard Bowl,13,3,16
12766,2023-01-23,EDGAR,bounty,Layer Cake,82,32,114
12767,2023-01-22,EDGAR,knockout,X Marks the Spot,47,25,72
12768,2023-01-22,EDGAR,hotZone,Ring of Fire,12,4,16
12769,2023-01-22,EDGAR,heist,Snaked Assault,87,57,144
12770,2023-01-22,EDGAR,gemGrab,Hard Rock Mine,26,15,41
12771,2023-01-22,EDGAR,gemGrab,Double Swoosh,36,16,52
12772,2023-01-22,EDGAR,brawlBall,Super Beach,35,12,47
12773,2023-01-22,EDGAR,brawlBall,Backyard Bowl,96,46,142
12774,2023-01-22,EDGAR,bounty,Layer Cake,32,14,46
12775,2023-01-21,EDGAR,knockout,X Marks the Spot,154,65,219
12776,2023-01-21,EDGAR,hotZone,Ring of Fire,19,7,26
12777,2023-01-21,EDGAR,heist,Tornado Ring,133,89,222
12778,2023-01-21,EDGAR,gemGrab,Hard Rock Mine,92,47,139
12779,2023-01-21,EDGAR,gemGrab,Deep Diner,14,8,22
12780,2023-01-21,EDGAR,brawlBall,Super Beach,470,303,773
12781,2023-01-21,EDGAR,brawlBall,Sneaky Fields,29,19,48
12782,2023-01-21,EDGAR,bounty,Dry Season,33,23,56
12783,2023-01-20,EDGAR,knockout,Out in the Open,74,44,118
12784,2023-01-20,EDGAR,hotZone,Split,117,97,214
12785,2023-01-20,EDGAR,heist,Tornado Ring,136,102,238
12786,2023-01-20,EDGAR,gemGrab,Undermine,14,19,33
12787,2023-01-20,EDGAR,gemGrab,Deep Diner,69,50,119
12788,2023-01-20,EDGAR,brawlBall,Sneaky Fields,440,328,768
12789,2023-01-20,EDGAR,brawlBall,Pinhole Punt,24,6,30
12790,2023-01-20,EDGAR,bounty,Dry Season,25,14,39
12791,2023-01-19,EDGAR,knockout,Out in the Open,122,61,183
12792,2023-01-19,EDGAR,hotZone,Split,161,121,282
12793,2023-01-19,EDGAR,heist,Kaboom Canyon,59,32,91
12794,2023-01-19,EDGAR,gemGrab,Undermine,56,23,79
12795,2023-01-19,EDGAR,gemGrab,Gem Fort,12,10,22
12796,2023-01-19,EDGAR,brawlBall,Sunny Soccer,7,5,12
12797,2023-01-19,EDGAR,brawlBall,Pinhole Punt,260,144,404
12798,2023-01-19,EDGAR,bounty,Shooting Star,15,9,24
12799,2023-01-18,EDGAR,knockout,Goldarm Gulch,24,8,32
12800,2023-01-18,EDGAR,hotZone,Parallel Plays,11,3,14
12801,2023-01-18,EDGAR,heist,Kaboom Canyon,18,11,29
12802,2023-01-18,EDGAR,gemGrab,Gem Fort,18,13,31
12803,2023-01-18,EDGAR,gemGrab,Crystal Arcade,3,2,5
12804,2023-01-18,EDGAR,brawlBall,Sunny Soccer,101,75,176
12805,2023-01-18,EDGAR,brawlBall,Beach Ball,5,3,8
12806,2023-01-18,EDGAR,bounty,Shooting Star,7,1,8
12807,2023-01-17,EDGAR,knockout,Goldarm Gulch,29,15,44
12808,2023-01-17,EDGAR,hotZone,Parallel Plays,7,0,7
12809,2023-01-17,EDGAR,heist,Pit Stop,52,58,110
12810,2023-01-17,EDGAR,gemGrab,Minecart Madness,1,1,2
12811,2023-01-17,EDGAR,gemGrab,Crystal Arcade,1,1,2
12812,2023-01-17,EDGAR,brawlBall,Center Stage,4,0,4
12813,2023-01-17,EDGAR,brawlBall,Beach Ball,48,17,65
12814,2023-01-17,EDGAR,bounty,Hideout,1,1,2
12815,2023-01-16,EDGAR,knockout,Belle's Rock,12,6,18
12816,2023-01-16,EDGAR,hotZone,Quarter Pounder,5,1,6
12817,2023-01-16,EDGAR,heist,Pit Stop,121,132,253
12818,2023-01-16,EDGAR,gemGrab,Minecart Madness,10,1,11
12819,2023-01-16,EDGAR,gemGrab,Double Swoosh,1,0,1
12820,2023-01-16,EDGAR,brawlBall,Center Stage,27,23,50
12821,2023-01-16,EDGAR,brawlBall,Backyard Bowl,3,1,4
12822,2023-01-16,EDGAR,bounty,Hideout,3,0,3
12823,2023-01-15,EDGAR,knockout,Belle's Rock,25,16,41
12824,2023-01-15,EDGAR,hotZone,Quarter Pounder,16,2,18
12825,2023-01-15,EDGAR,heist,Bridge Too Far,4,1,5
12826,2023-01-15,EDGAR,gemGrab,Hard Rock Mine,1,0,1
12827,2023-01-15,EDGAR,gemGrab,Double Swoosh,2,2,4
12828,2023-01-15,EDGAR,brawlBall,Super Beach,1,0,1
12829,2023-01-15,EDGAR,brawlBall,Backyard Bowl,12,10,22
12830,2023-01-15,EDGAR,bounty,Canal Grande,2,1,3
12831,2023-01-14,EDGAR,knockout,Flaring Phoenix,10,9,19
12832,2023-01-14,EDGAR,hotZone,Controller Chaos,15,0,15
12833,2023-01-14,EDGAR,heist,Bridge Too Far,3,1,4
12834,2023-01-14,EDGAR,gemGrab,Hard Rock Mine,5,0,5
12835,2023-01-14,EDGAR,gemGrab,Deep Diner,2,0,2
12836,2023-01-14,EDGAR,brawlBall,Super Beach,25,26,51
12837,2023-01-14,EDGAR,brawlBall,Sneaky Fields,1,0,1
12838,2023-01-14,EDGAR,bounty,Canal Grande,3,0,3
12839,2023-01-13,EDGAR,knockout,Flaring Phoenix,8,9,17
12840,2023-01-13,EDGAR,hotZone,Controller Chaos,9,0,9
12841,2023-01-13,EDGAR,heist,Hot Potato,8,8,16
12842,2023-01-13,EDGAR,gemGrab,Deep Diner,3,1,4
12843,2023-01-13,EDGAR,brawlBall,Sneaky Fields,25,36,61
12844,2023-01-13,EDGAR,bounty,Temple Ruins,2,0,2
12845,2023-01-12,EDGAR,knockout,Riverside,8,0,8
12846,2023-01-12,EDGAR,hotZone,Open Zone,2,1,3
12847,2023-01-12,EDGAR,heist,Hot Potato,3,2,5
12848,2023-01-12,EDGAR,brawlBall,Pinhole Punt,6,2,8
12849,2023-01-11,EDGAR,hotZone,Open Zone,1,0,1
12850,2023-01-11,EDGAR,heist,Safe Zone,0,1,1
12851,2023-01-11,EDGAR,gemGrab,Gem Fort,2,0,2
12852,2023-01-11,EDGAR,brawlBall,Sunny Soccer,7,3,10
12853,2023-01-11,EDGAR,bounty,Excel,3,6,9
12854,2023-01-10,EDGAR,knockout,New Perspective,5,3,8
12855,2023-01-10,EDGAR,hotZone,Dueling Beetles,6,1,7
12856,2023-01-10,EDGAR,heist,Safe Zone,1,0,1
12857,2023-01-10,EDGAR,gemGrab,Minecart Madness,3,0,3
12858,2023-01-10,EDGAR,gemGrab,Crystal Arcade,4,0,4
12859,2023-01-10,EDGAR,brawlBall,Center Stage,1,0,1
12860,2023-01-10,EDGAR,brawlBall,Beach Ball,8,4,12
12861,2023-01-10,EDGAR,bounty,Excel,0,1,1
12862,2023-01-09,EDGAR,knockout,New Perspective,6,3,9
12863,2023-01-09,EDGAR,hotZone,Dueling Beetles,4,0,4
12864,2023-01-09,EDGAR,heist,Snaked Assault,34,4,38
12865,2023-01-09,EDGAR,gemGrab,Minecart Madness,6,1,7
12866,2023-01-09,EDGAR,gemGrab,Double Swoosh,3,0,3
12867,2023-01-09,EDGAR,brawlBall,Center Stage,27,36,63
12868,2023-01-09,EDGAR,brawlBall,Backyard Bowl,2,0,2
12869,2023-01-09,EDGAR,bounty,Layer Cake,10,1,11
12870,2023-01-08,EDGAR,knockout,X Marks the Spot,6,0,6
12871,2023-01-08,EDGAR,hotZone,Ring of Fire,1,0,1
12872,2023-01-08,EDGAR,heist,Snaked Assault,12,23,35
12873,2023-01-08,EDGAR,gemGrab,Hard Rock Mine,1,0,1
12874,2023-01-08,EDGAR,gemGrab,Double Swoosh,3,1,4
12875,2023-01-08,EDGAR,brawlBall,Super Beach,0,1,1
12876,2023-01-08,EDGAR,brawlBall,Backyard Bowl,4,1,5
12877,2023-01-08,EDGAR,bounty,Layer Cake,2,1,3
12878,2023-01-07,EDGAR,knockout,X Marks the Spot,0,1,1
12879,2023-01-07,EDGAR,hotZone,Ring of Fire,1,0,1
12880,2023-01-07,EDGAR,heist,Tornado Ring,14,4,18
12881,2023-01-07,EDGAR,gemGrab,Hard Rock Mine,5,2,7
12882,2023-01-07,EDGAR,gemGrab,Deep Diner,1,1,2
12883,2023-01-07,EDGAR,brawlBall,Super Beach,4,3,7
12884,2023-01-07,EDGAR,brawlBall,Sneaky Fields,1,0,1
12885,2023-01-06,EDGAR,knockout,Out in the Open,4,2,6
12886,2023-01-06,EDGAR,hotZone,Split,6,1,7
12887,2023-01-06,EDGAR,heist,Tornado Ring,15,13,28
12888,2023-01-06,EDGAR,gemGrab,Deep Diner,5,1,6
12889,2023-01-06,EDGAR,brawlBall,Sneaky Fields,19,13,32
12890,2023-01-06,EDGAR,brawlBall,Pinhole Punt,2,1,3
12891,2023-01-06,EDGAR,bounty,Dry Season,1,0,1
12892,2023-01-05,EDGAR,knockout,Out in the Open,5,1,6
12893,2023-01-05,EDGAR,hotZone,Split,16,16,32
12894,2023-01-05,EDGAR,heist,Kaboom Canyon,9,0,9
12895,2023-01-05,EDGAR,gemGrab,Undermine,3,1,4
12896,2023-01-05,EDGAR,gemGrab,Gem Fort,1,1,2
12897,2023-01-05,EDGAR,brawlBall,Pinhole Punt,14,5,19
12898,2023-01-05,EDGAR,bounty,Shooting Star,1,0,1
12899,2023-01-04,EDGAR,knockout,Goldarm Gulch,1,1,2
12900,2023-01-04,EDGAR,hotZone,Parallel Plays,3,3,6
12901,2023-01-04,EDGAR,heist,Kaboom Canyon,12,0,12
12902,2023-01-04,EDGAR,gemGrab,Gem Fort,9,20,29
12903,2023-01-04,EDGAR,gemGrab,Crystal Arcade,0,2,2
12904,2023-01-04,EDGAR,brawlBall,Sunny Soccer,10,2,12
12905,2023-01-04,EDGAR,bounty,Shooting Star,2,1,3
12906,2023-01-03,EDGAR,knockout,Goldarm Gulch,7,0,7
12907,2023-01-03,EDGAR,hotZone,Parallel Plays,3,1,4
12908,2023-01-03,EDGAR,heist,Pit Stop,41,33,74
12909,2023-01-03,EDGAR,heist,Kaboom Canyon,1,0,1
12910,2023-01-03,EDGAR,gemGrab,Minecart Madness,2,0,2
12911,2023-01-03,EDGAR,gemGrab,Crystal Arcade,4,0,4
12912,2023-01-03,EDGAR,brawlBall,Center Stage,1,0,1
12913,2023-01-03,EDGAR,brawlBall,Beach Ball,9,3,12
12914,2023-01-03,EDGAR,bounty,Hideout,2,0,2
12915,2023-01-02,EDGAR,knockout,Belle's Rock,10,2,12
12916,2023-01-02,EDGAR,hotZone,Quarter Pounder,12,0,12
12917,2023-01-02,EDGAR,heist,Pit Stop,96,145,241
12918,2023-01-02,EDGAR,gemGrab,Minecart Madness,4,2,6
12919,2023-01-02,EDGAR,brawlBall,Center Stage,24,17,41
12920,2023-01-02,EDGAR,bounty,Hideout,3,1,4
12921,2023-01-01,EDGAR,knockout,Belle's Rock,11,8,19
12922,2023-01-01,EDGAR,hotZone,Quarter Pounder,2,0,2
12923,2023-01-01,EDGAR,heist,Kaboom Canyon,1,0,1
12924,2023-01-01,EDGAR,gemGrab,Double Swoosh,3,1,4
12925,2023-01-01,EDGAR,brawlBall,Backyard Bowl,5,2,7
12926,2022-12-31,EDGAR,hotZone,Controller Chaos,0,2,2
12927,2022-12-31,EDGAR,heist,Kaboom Canyon,1,0,1
12928,2022-12-31,EDGAR,gemGrab,Hard Rock Mine,0,1,1
12929,2022-12-31,EDGAR,gemGrab,Deep Diner,1,0,1
12930,2022-12-31,EDGAR,brawlBall,Super Beach,1,0,1
12931,2022-12-30,EDGAR,hotZone,Controller Chaos,0,1,1
12932,2022-12-30,EDGAR,brawlBall,Sneaky Fields,1,0,1
12933,2022-12-29,EDGAR,heist,Kaboom Canyon,0,1,1
12934,2022-12-29,EDGAR,gemGrab,Minecart Madness,1,0,1
12935,2022-12-29,EDGAR,brawlBall,Pinhole Punt,1,0,1
12936,2022-12-27,EDGAR,hotZone,Dueling Beetles,0,1,1
12937,2022-12-27,EDGAR,brawlBall,Beach Ball,1,1,2
12938,2022-12-26,EDGAR,hotZone,Controller Chaos,0,1,1
12939,2022-12-26,EDGAR,heist,Kaboom Canyon,2,1,3
12940,2022-12-26,EDGAR,gemGrab,Minecart Madness,0,1,1
12941,2022-12-25,EDGAR,hotZone,Ring of Fire,0,1,1
12942,2022-12-24,EDGAR,brawlBall,Super Beach,0,1,1
12943,2022-12-23,EDGAR,knockout,Out in the Open,1,1,2
12944,2022-12-19,EDGAR,brawlBall,Center Stage,1,0,1
12945,2022-12-13,EDGAR,heist,Safe Zone,1,1,2
12946,2022-12-10,EDGAR,gemGrab,Hard Rock Mine,0,1,1
12947,2022-11-11,EDGAR,brawlBall,Sneaky Fields,1,0,1
12948,2022-11-03,EDGAR,bounty,Temple Ruins,0,1,1
12949,2023-02-05,DYNAMIKE,knockout,X Marks the Spot,84,43,127
12950,2023-02-05,DYNAMIKE,knockout,Goldarm Gulch,9,2,11
12951,2023-02-05,DYNAMIKE,hotZone,Ring of Fire,61,13,74
12952,2023-02-05,DYNAMIKE,heist,Snaked Assault,173,94,267
12953,2023-02-05,DYNAMIKE,heist,Pit Stop,119,137,256
12954,2023-02-05,DYNAMIKE,gemGrab,Hard Rock Mine,35,7,42
12955,2023-02-05,DYNAMIKE,gemGrab,Double Swoosh,151,53,204
12956,2023-02-05,DYNAMIKE,brawlBall,Super Beach,84,47,131
12957,2023-02-05,DYNAMIKE,brawlBall,Sneaky Fields,27,17,44
12958,2023-02-05,DYNAMIKE,brawlBall,Backyard Bowl,338,213,551
12959,2023-02-05,DYNAMIKE,bounty,Layer Cake,90,55,145
12960,2023-02-04,DYNAMIKE,knockout,X Marks the Spot,32,15,47
12961,2023-02-04,DYNAMIKE,knockout,Goldarm Gulch,7,6,13
12962,2023-02-04,DYNAMIKE,hotZone,Ring of Fire,10,4,14
12963,2023-02-04,DYNAMIKE,heist,Tornado Ring,23,12,35
12964,2023-02-04,DYNAMIKE,heist,Pit Stop,108,109,217
12965,2023-02-04,DYNAMIKE,gemGrab,Hard Rock Mine,25,14,39
12966,2023-02-04,DYNAMIKE,gemGrab,Double Swoosh,33,4,37
12967,2023-02-04,DYNAMIKE,gemGrab,Deep Diner,29,25,54
12968,2023-02-04,DYNAMIKE,brawlBall,Super Beach,556,510,1066
12969,2023-02-04,DYNAMIKE,brawlBall,Sneaky Fields,33,7,40
12970,2023-02-04,DYNAMIKE,bounty,Dry Season,10,3,13
12971,2023-02-03,DYNAMIKE,knockout,Out in the Open,71,29,100
12972,2023-02-03,DYNAMIKE,knockout,Goldarm Gulch,29,18,47
12973,2023-02-03,DYNAMIKE,hotZone,Split,565,490,1055
12974,2023-02-03,DYNAMIKE,heist,Tornado Ring,208,153,361
12975,2023-02-03,DYNAMIKE,heist,Pit Stop,825,823,1648
12976,2023-02-03,DYNAMIKE,gemGrab,Undermine,19,6,25
12977,2023-02-03,DYNAMIKE,gemGrab,Double Swoosh,286,55,341
12978,2023-02-03,DYNAMIKE,gemGrab,Deep Diner,306,389,695
12979,2023-02-03,DYNAMIKE,brawlBall,Sneaky Fields,990,614,1604
12980,2023-02-03,DYNAMIKE,brawlBall,Pinhole Punt,18,9,27
12981,2023-02-03,DYNAMIKE,bounty,Dry Season,86,42,128
12982,2023-02-02,DYNAMIKE,knockout,Out in the Open,35,35,70
12983,2023-02-02,DYNAMIKE,hotZone,Split,275,235,510
12984,2023-02-02,DYNAMIKE,heist,Kaboom Canyon,14,4,18
12985,2023-02-02,DYNAMIKE,gemGrab,Undermine,16,12,28
12986,2023-02-02,DYNAMIKE,gemGrab,Gem Fort,6,5,11
12987,2023-02-02,DYNAMIKE,brawlBall,Sunny Soccer,31,35,66
12988,2023-02-02,DYNAMIKE,brawlBall,Pinhole Punt,132,71,203
12989,2023-02-02,DYNAMIKE,bounty,Shooting Star,7,2,9
12990,2023-02-01,DYNAMIKE,knockout,Goldarm Gulch,134,81,215
12991,2023-02-01,DYNAMIKE,hotZone,Parallel Plays,275,161,436
12992,2023-02-01,DYNAMIKE,heist,Kaboom Canyon,59,27,86
12993,2023-02-01,DYNAMIKE,gemGrab,Gem Fort,56,33,89
12994,2023-02-01,DYNAMIKE,gemGrab,Crystal Arcade,49,25,74
12995,2023-02-01,DYNAMIKE,brawlBall,Sunny Soccer,1571,1326,2897
12996,2023-02-01,DYNAMIKE,brawlBall,Beach Ball,63,52,115
12997,2023-02-01,DYNAMIKE,bounty,Shooting Star,25,15,40
12998,2023-01-31,DYNAMIKE,knockout,Goldarm Gulch,75,42,117
12999,2023-01-31,DYNAMIKE,hotZone,Parallel Plays,91,47,138
13000,2023-01-31,DYNAMIKE,heist,Pit Stop,167,136,303
13001,2023-01-31,DYNAMIKE,gemGrab,Minecart Madness,8,7,15
13002,2023-01-31,DYNAMIKE,gemGrab,Crystal Arcade,36,18,54
13003,2023-01-31,DYNAMIKE,brawlBall,Center Stage,10,13,23
13004,2023-01-31,DYNAMIKE,brawlBall,Beach Ball,760,702,1462
13005,2023-01-31,DYNAMIKE,bounty,Hideout,15,7,22
13006,2023-01-30,DYNAMIKE,knockout,Belle's Rock,374,205,579
13007,2023-01-30,DYNAMIKE,hotZone,Quarter Pounder,387,432,819
13008,2023-01-30,DYNAMIKE,heist,Pit Stop,620,561,1181
13009,2023-01-30,DYNAMIKE,gemGrab,Minecart Madness,80,51,131
13010,2023-01-30,DYNAMIKE,gemGrab,Double Swoosh,51,33,84
13011,2023-01-30,DYNAMIKE,brawlBall,Center Stage,445,247,692
13012,2023-01-30,DYNAMIKE,brawlBall,Backyard Bowl,42,11,53
13013,2023-01-30,DYNAMIKE,bounty,Hideout,52,19,71
13014,2023-01-29,DYNAMIKE,knockout,Belle's Rock,325,175,500
13015,2023-01-29,DYNAMIKE,hotZone,Quarter Pounder,256,248,504
13016,2023-01-29,DYNAMIKE,heist,Bridge Too Far,35,14,49
13017,2023-01-29,DYNAMIKE,gemGrab,Hard Rock Mine,18,10,28
13018,2023-01-29,DYNAMIKE,gemGrab,Double Swoosh,92,56,148
13019,2023-01-29,DYNAMIKE,brawlBall,Super Beach,26,34,60
13020,2023-01-29,DYNAMIKE,brawlBall,Backyard Bowl,368,204,572
13021,2023-01-29,DYNAMIKE,bounty,Canal Grande,114,60,174
13022,2023-01-28,DYNAMIKE,knockout,Flaring Phoenix,121,81,202
13023,2023-01-28,DYNAMIKE,hotZone,Controller Chaos,298,245,543
13024,2023-01-28,DYNAMIKE,heist,Bridge Too Far,56,16,72
13025,2023-01-28,DYNAMIKE,gemGrab,Hard Rock Mine,81,48,129
13026,2023-01-28,DYNAMIKE,gemGrab,Deep Diner,83,86,169
13027,2023-01-28,DYNAMIKE,brawlBall,Super Beach,2111,1996,4107
13028,2023-01-28,DYNAMIKE,brawlBall,Sneaky Fields,31,21,52
13029,2023-01-28,DYNAMIKE,bounty,Canal Grande,155,66,221
13030,2023-01-27,DYNAMIKE,knockout,Flaring Phoenix,53,27,80
13031,2023-01-27,DYNAMIKE,hotZone,Controller Chaos,51,52,103
13032,2023-01-27,DYNAMIKE,heist,Hot Potato,130,98,228
13033,2023-01-27,DYNAMIKE,gemGrab,Undermine,8,6,14
13034,2023-01-27,DYNAMIKE,gemGrab,Deep Diner,109,96,205
13035,2023-01-27,DYNAMIKE,brawlBall,Sneaky Fields,247,162,409
13036,2023-01-27,DYNAMIKE,brawlBall,Pinhole Punt,5,2,7
13037,2023-01-27,DYNAMIKE,bounty,Temple Ruins,10,1,11
13038,2023-01-26,DYNAMIKE,knockout,Riverside,44,31,75
13039,2023-01-26,DYNAMIKE,hotZone,Open Zone,39,14,53
13040,2023-01-26,DYNAMIKE,heist,Hot Potato,664,760,1424
13041,2023-01-26,DYNAMIKE,gemGrab,Undermine,85,41,126
13042,2023-01-26,DYNAMIKE,gemGrab,Gem Fort,22,13,35
13043,2023-01-26,DYNAMIKE,brawlBall,Sunny Soccer,86,83,169
13044,2023-01-26,DYNAMIKE,brawlBall,Pinhole Punt,535,301,836
13045,2023-01-26,DYNAMIKE,bounty,Temple Ruins,22,12,34
13046,2023-01-25,DYNAMIKE,knockout,Riverside,22,5,27
13047,2023-01-25,DYNAMIKE,hotZone,Open Zone,10,0,10
13048,2023-01-25,DYNAMIKE,heist,Safe Zone,55,26,81
13049,2023-01-25,DYNAMIKE,gemGrab,Gem Fort,35,17,52
13050,2023-01-25,DYNAMIKE,gemGrab,Crystal Arcade,69,23,92
13051,2023-01-25,DYNAMIKE,brawlBall,Sunny Soccer,1163,1141,2304
13052,2023-01-25,DYNAMIKE,brawlBall,Beach Ball,159,114,273
13053,2023-01-25,DYNAMIKE,bounty,Excel,87,27,114
13054,2023-01-24,DYNAMIKE,knockout,New Perspective,107,82,189
13055,2023-01-24,DYNAMIKE,hotZone,Dueling Beetles,134,56,190
13056,2023-01-24,DYNAMIKE,heist,Safe Zone,67,25,92
13057,2023-01-24,DYNAMIKE,gemGrab,Minecart Madness,33,22,55
13058,2023-01-24,DYNAMIKE,gemGrab,Crystal Arcade,107,70,177
13059,2023-01-24,DYNAMIKE,brawlBall,Center Stage,60,32,92
13060,2023-01-24,DYNAMIKE,brawlBall,Beach Ball,1618,1422,3040
13061,2023-01-24,DYNAMIKE,bounty,Excel,117,76,193
13062,2023-01-23,DYNAMIKE,knockout,New Perspective,183,101,284
13063,2023-01-23,DYNAMIKE,hotZone,Dueling Beetles,199,77,276
13064,2023-01-23,DYNAMIKE,heist,Snaked Assault,239,99,338
13065,2023-01-23,DYNAMIKE,gemGrab,Minecart Madness,158,97,255
13066,2023-01-23,DYNAMIKE,gemGrab,Double Swoosh,40,12,52
13067,2023-01-23,DYNAMIKE,brawlBall,Center Stage,719,434,1153
13068,2023-01-23,DYNAMIKE,brawlBall,Backyard Bowl,26,5,31
13069,2023-01-23,DYNAMIKE,bounty,Layer Cake,177,130,307
13070,2023-01-22,DYNAMIKE,knockout,X Marks the Spot,62,31,93
13071,2023-01-22,DYNAMIKE,hotZone,Ring of Fire,29,7,36
13072,2023-01-22,DYNAMIKE,heist,Snaked Assault,91,48,139
13073,2023-01-22,DYNAMIKE,gemGrab,Hard Rock Mine,26,10,36
13074,2023-01-22,DYNAMIKE,gemGrab,Double Swoosh,42,48,90
13075,2023-01-22,DYNAMIKE,brawlBall,Super Beach,221,267,488
13076,2023-01-22,DYNAMIKE,brawlBall,Backyard Bowl,184,68,252
13077,2023-01-22,DYNAMIKE,bounty,Layer Cake,78,25,103
13078,2023-01-21,DYNAMIKE,knockout,X Marks the Spot,193,89,282
13079,2023-01-21,DYNAMIKE,hotZone,Ring of Fire,76,16,92
13080,2023-01-21,DYNAMIKE,heist,Tornado Ring,170,86,256
13081,2023-01-21,DYNAMIKE,gemGrab,Hard Rock Mine,114,67,181
13082,2023-01-21,DYNAMIKE,gemGrab,Deep Diner,80,48,128
13083,2023-01-21,DYNAMIKE,brawlBall,Super Beach,2903,2883,5786
13084,2023-01-21,DYNAMIKE,brawlBall,Sneaky Fields,32,21,53
13085,2023-01-21,DYNAMIKE,bounty,Dry Season,56,15,71
13086,2023-01-20,DYNAMIKE,knockout,Out in the Open,90,39,129
13087,2023-01-20,DYNAMIKE,hotZone,Split,568,595,1163
13088,2023-01-20,DYNAMIKE,heist,Tornado Ring,154,97,251
13089,2023-01-20,DYNAMIKE,gemGrab,Undermine,35,11,46
13090,2023-01-20,DYNAMIKE,gemGrab,Deep Diner,282,306,588
13091,2023-01-20,DYNAMIKE,brawlBall,Sneaky Fields,772,531,1303
13092,2023-01-20,DYNAMIKE,brawlBall,Pinhole Punt,28,8,36
13093,2023-01-20,DYNAMIKE,bounty,Dry Season,39,23,62
13094,2023-01-19,DYNAMIKE,knockout,Out in the Open,117,80,197
13095,2023-01-19,DYNAMIKE,hotZone,Split,965,976,1941
13096,2023-01-19,DYNAMIKE,heist,Kaboom Canyon,64,19,83
13097,2023-01-19,DYNAMIKE,gemGrab,Undermine,99,60,159
13098,2023-01-19,DYNAMIKE,gemGrab,Gem Fort,14,2,16
13099,2023-01-19,DYNAMIKE,brawlBall,Sunny Soccer,75,66,141
13100,2023-01-19,DYNAMIKE,brawlBall,Pinhole Punt,561,339,900
13101,2023-01-19,DYNAMIKE,bounty,Shooting Star,37,17,54
13102,2023-01-18,DYNAMIKE,knockout,Goldarm Gulch,19,11,30
13103,2023-01-18,DYNAMIKE,hotZone,Parallel Plays,20,20,40
13104,2023-01-18,DYNAMIKE,heist,Kaboom Canyon,18,9,27
13105,2023-01-18,DYNAMIKE,gemGrab,Gem Fort,12,12,24
13106,2023-01-18,DYNAMIKE,gemGrab,Crystal Arcade,9,10,19
13107,2023-01-18,DYNAMIKE,brawlBall,Sunny Soccer,550,427,977
13108,2023-01-18,DYNAMIKE,brawlBall,Beach Ball,30,15,45
13109,2023-01-18,DYNAMIKE,bounty,Shooting Star,15,2,17
13110,2023-01-17,DYNAMIKE,knockout,Goldarm Gulch,15,5,20
13111,2023-01-17,DYNAMIKE,hotZone,Parallel Plays,7,9,16
13112,2023-01-17,DYNAMIKE,heist,Pit Stop,67,51,118
13113,2023-01-17,DYNAMIKE,gemGrab,Minecart Madness,1,0,1
13114,2023-01-17,DYNAMIKE,gemGrab,Crystal Arcade,4,5,9
13115,2023-01-17,DYNAMIKE,brawlBall,Center Stage,1,1,2
13116,2023-01-17,DYNAMIKE,brawlBall,Beach Ball,152,154,306
13117,2023-01-17,DYNAMIKE,bounty,Hideout,5,2,7
13118,2023-01-16,DYNAMIKE,knockout,Belle's Rock,25,12,37
13119,2023-01-16,DYNAMIKE,hotZone,Quarter Pounder,34,35,69
13120,2023-01-16,DYNAMIKE,heist,Pit Stop,176,102,278
13121,2023-01-16,DYNAMIKE,gemGrab,Minecart Madness,15,6,21
13122,2023-01-16,DYNAMIKE,gemGrab,Double Swoosh,4,1,5
13123,2023-01-16,DYNAMIKE,brawlBall,Center Stage,39,19,58
13124,2023-01-16,DYNAMIKE,brawlBall,Backyard Bowl,9,10,19
13125,2023-01-16,DYNAMIKE,bounty,Hideout,14,8,22
13126,2023-01-15,DYNAMIKE,knockout,Belle's Rock,25,13,38
13127,2023-01-15,DYNAMIKE,hotZone,Quarter Pounder,60,58,118
13128,2023-01-15,DYNAMIKE,heist,Bridge Too Far,5,2,7
13129,2023-01-15,DYNAMIKE,gemGrab,Hard Rock Mine,3,0,3
13130,2023-01-15,DYNAMIKE,gemGrab,Double Swoosh,4,1,5
13131,2023-01-15,DYNAMIKE,brawlBall,Super Beach,34,40,74
13132,2023-01-15,DYNAMIKE,brawlBall,Backyard Bowl,52,19,71
13133,2023-01-15,DYNAMIKE,bounty,Canal Grande,9,2,11
13134,2023-01-14,DYNAMIKE,knockout,Flaring Phoenix,6,5,11
13135,2023-01-14,DYNAMIKE,hotZone,Controller Chaos,66,23,89
13136,2023-01-14,DYNAMIKE,heist,Bridge Too Far,7,0,7
13137,2023-01-14,DYNAMIKE,gemGrab,Hard Rock Mine,7,0,7
13138,2023-01-14,DYNAMIKE,gemGrab,Deep Diner,14,37,51
13139,2023-01-14,DYNAMIKE,brawlBall,Super Beach,207,187,394
13140,2023-01-14,DYNAMIKE,brawlBall,Sneaky Fields,6,1,7
13141,2023-01-14,DYNAMIKE,bounty,Canal Grande,11,0,11
13142,2023-01-13,DYNAMIKE,knockout,Flaring Phoenix,10,5,15
13143,2023-01-13,DYNAMIKE,hotZone,Controller Chaos,63,39,102
13144,2023-01-13,DYNAMIKE,heist,Hot Potato,31,32,63
13145,2023-01-13,DYNAMIKE,gemGrab,Deep Diner,27,39,66
13146,2023-01-13,DYNAMIKE,brawlBall,Sneaky Fields,43,25,68
13147,2023-01-13,DYNAMIKE,bounty,Temple Ruins,0,8,8
13148,2023-01-12,DYNAMIKE,knockout,Riverside,11,4,15
13149,2023-01-12,DYNAMIKE,hotZone,Open Zone,6,0,6
13150,2023-01-12,DYNAMIKE,heist,Hot Potato,22,34,56
13151,2023-01-12,DYNAMIKE,gemGrab,Undermine,4,1,5
13152,2023-01-12,DYNAMIKE,brawlBall,Sunny Soccer,5,1,6
13153,2023-01-12,DYNAMIKE,brawlBall,Pinhole Punt,11,3,14
13154,2023-01-11,DYNAMIKE,hotZone,Open Zone,1,0,1
13155,2023-01-11,DYNAMIKE,gemGrab,Gem Fort,1,0,1
13156,2023-01-11,DYNAMIKE,brawlBall,Sunny Soccer,40,25,65
13157,2023-01-11,DYNAMIKE,brawlBall,Beach Ball,1,0,1
13158,2023-01-11,DYNAMIKE,bounty,Excel,2,13,15
13159,2023-01-10,DYNAMIKE,knockout,New Perspective,13,3,16
13160,2023-01-10,DYNAMIKE,hotZone,Dueling Beetles,25,3,28
13161,2023-01-10,DYNAMIKE,heist,Safe Zone,4,0,4
13162,2023-01-10,DYNAMIKE,gemGrab,Minecart Madness,5,0,5
13163,2023-01-10,DYNAMIKE,gemGrab,Crystal Arcade,6,2,8
13164,2023-01-10,DYNAMIKE,brawlBall,Center Stage,6,0,6
13165,2023-01-10,DYNAMIKE,brawlBall,Beach Ball,86,99,185
13166,2023-01-10,DYNAMIKE,bounty,Excel,11,33,44
13167,2023-01-09,DYNAMIKE,knockout,New Perspective,5,1,6
13168,2023-01-09,DYNAMIKE,hotZone,Dueling Beetles,16,0,16
13169,2023-01-09,DYNAMIKE,heist,Snaked Assault,24,1,25
13170,2023-01-09,DYNAMIKE,gemGrab,Minecart Madness,20,14,34
13171,2023-01-09,DYNAMIKE,gemGrab,Double Swoosh,8,0,8
13172,2023-01-09,DYNAMIKE,brawlBall,Center Stage,23,6,29
13173,2023-01-09,DYNAMIKE,brawlBall,Backyard Bowl,2,1,3
13174,2023-01-09,DYNAMIKE,bounty,Layer Cake,24,10,34
13175,2023-01-08,DYNAMIKE,knockout,X Marks the Spot,17,4,21
13176,2023-01-08,DYNAMIKE,hotZone,Ring of Fire,5,1,6
13177,2023-01-08,DYNAMIKE,heist,Snaked Assault,18,3,21
13178,2023-01-08,DYNAMIKE,gemGrab,Hard Rock Mine,2,0,2
13179,2023-01-08,DYNAMIKE,gemGrab,Double Swoosh,1,1,2
13180,2023-01-08,DYNAMIKE,brawlBall,Super Beach,32,30,62
13181,2023-01-08,DYNAMIKE,brawlBall,Backyard Bowl,17,3,20
13182,2023-01-08,DYNAMIKE,bounty,Layer Cake,6,2,8
13183,2023-01-07,DYNAMIKE,knockout,X Marks the Spot,5,1,6
13184,2023-01-07,DYNAMIKE,heist,Tornado Ring,16,29,45
13185,2023-01-07,DYNAMIKE,gemGrab,Hard Rock Mine,1,2,3
13186,2023-01-07,DYNAMIKE,gemGrab,Deep Diner,21,17,38
13187,2023-01-07,DYNAMIKE,brawlBall,Super Beach,64,57,121
13188,2023-01-07,DYNAMIKE,brawlBall,Sneaky Fields,4,0,4
13189,2023-01-07,DYNAMIKE,bounty,Dry Season,4,0,4
13190,2023-01-06,DYNAMIKE,knockout,Out in the Open,6,0,6
13191,2023-01-06,DYNAMIKE,hotZone,Split,68,47,115
13192,2023-01-06,DYNAMIKE,heist,Tornado Ring,28,6,34
13193,2023-01-06,DYNAMIKE,gemGrab,Undermine,1,0,1
13194,2023-01-06,DYNAMIKE,gemGrab,Deep Diner,33,45,78
13195,2023-01-06,DYNAMIKE,brawlBall,Sneaky Fields,23,7,30
13196,2023-01-06,DYNAMIKE,brawlBall,Pinhole Punt,2,0,2
13197,2023-01-06,DYNAMIKE,bounty,Dry Season,2,0,2
13198,2023-01-05,DYNAMIKE,knockout,Out in the Open,3,3,6
13199,2023-01-05,DYNAMIKE,hotZone,Split,176,153,329
13200,2023-01-05,DYNAMIKE,heist,Kaboom Canyon,11,1,12
13201,2023-01-05,DYNAMIKE,gemGrab,Undermine,7,9,16
13202,2023-01-05,DYNAMIKE,gemGrab,Gem Fort,3,7,10
13203,2023-01-05,DYNAMIKE,brawlBall,Sunny Soccer,3,5,8
13204,2023-01-05,DYNAMIKE,brawlBall,Pinhole Punt,36,13,49
13205,2023-01-05,DYNAMIKE,bounty,Shooting Star,3,0,3
13206,2023-01-04,DYNAMIKE,knockout,Goldarm Gulch,5,2,7
13207,2023-01-04,DYNAMIKE,hotZone,Parallel Plays,16,3,19
13208,2023-01-04,DYNAMIKE,heist,Kaboom Canyon,15,1,16
13209,2023-01-04,DYNAMIKE,gemGrab,Gem Fort,1,1,2
13210,2023-01-04,DYNAMIKE,gemGrab,Crystal Arcade,3,1,4
13211,2023-01-04,DYNAMIKE,brawlBall,Sunny Soccer,165,170,335
13212,2023-01-04,DYNAMIKE,brawlBall,Beach Ball,1,0,1
13213,2023-01-04,DYNAMIKE,bounty,Shooting Star,3,0,3
13214,2023-01-03,DYNAMIKE,knockout,Goldarm Gulch,1,2,3
13215,2023-01-03,DYNAMIKE,hotZone,Parallel Plays,17,1,18
13216,2023-01-03,DYNAMIKE,hotZone,Controller Chaos,1,0,1
13217,2023-01-03,DYNAMIKE,heist,Pit Stop,77,38,115
13218,2023-01-03,DYNAMIKE,gemGrab,Minecart Madness,3,0,3
13219,2023-01-03,DYNAMIKE,gemGrab,Crystal Arcade,9,1,10
13220,2023-01-03,DYNAMIKE,brawlBall,Center Stage,2,0,2
13221,2023-01-03,DYNAMIKE,brawlBall,Beach Ball,114,98,212
13222,2023-01-03,DYNAMIKE,bounty,Hideout,8,0,8
13223,2023-01-02,DYNAMIKE,knockout,Belle's Rock,28,3,31
13224,2023-01-02,DYNAMIKE,hotZone,Quarter Pounder,47,14,61
13225,2023-01-02,DYNAMIKE,heist,Pit Stop,129,125,254
13226,2023-01-02,DYNAMIKE,gemGrab,Minecart Madness,15,3,18
13227,2023-01-02,DYNAMIKE,gemGrab,Double Swoosh,2,2,4
13228,2023-01-02,DYNAMIKE,brawlBall,Center Stage,44,28,72
13229,2023-01-02,DYNAMIKE,brawlBall,Backyard Bowl,5,1,6
13230,2023-01-02,DYNAMIKE,bounty,Hideout,13,2,15
13231,2023-01-01,DYNAMIKE,knockout,Belle's Rock,3,0,3
13232,2023-01-01,DYNAMIKE,hotZone,Quarter Pounder,18,3,21
13233,2023-01-01,DYNAMIKE,heist,Bridge Too Far,1,0,1
13234,2023-01-01,DYNAMIKE,gemGrab,Double Swoosh,9,1,10
13235,2023-01-01,DYNAMIKE,brawlBall,Backyard Bowl,13,6,19
13236,2023-01-01,DYNAMIKE,bounty,Canal Grande,3,0,3
13237,2022-12-31,DYNAMIKE,hotZone,Controller Chaos,4,4,8
13238,2022-12-31,DYNAMIKE,gemGrab,Hard Rock Mine,2,0,2
13239,2022-12-31,DYNAMIKE,gemGrab,Deep Diner,2,1,3
13240,2022-12-31,DYNAMIKE,brawlBall,Super Beach,23,27,50
13241,2022-12-30,DYNAMIKE,knockout,Flaring Phoenix,1,0,1
13242,2022-12-30,DYNAMIKE,hotZone,Controller Chaos,3,1,4
13243,2022-12-30,DYNAMIKE,heist,Hot Potato,2,2,4
13244,2022-12-30,DYNAMIKE,gemGrab,Minecart Madness,1,0,1
13245,2022-12-30,DYNAMIKE,gemGrab,Deep Diner,2,4,6
13246,2022-12-30,DYNAMIKE,brawlBall,Sneaky Fields,5,2,7
13247,2022-12-29,DYNAMIKE,hotZone,Controller Chaos,1,0,1
13248,2022-12-29,DYNAMIKE,heist,Hot Potato,2,8,10
13249,2022-12-29,DYNAMIKE,gemGrab,Minecart Madness,1,1,2
13250,2022-12-29,DYNAMIKE,gemGrab,Gem Fort,1,0,1
13251,2022-12-28,DYNAMIKE,brawlBall,Sunny Soccer,1,0,1
13252,2022-12-27,DYNAMIKE,hotZone,Dueling Beetles,0,1,1
13253,2022-12-27,DYNAMIKE,hotZone,Controller Chaos,1,0,1
13254,2022-12-27,DYNAMIKE,gemGrab,Minecart Madness,2,0,2
13255,2022-12-27,DYNAMIKE,brawlBall,Beach Ball,2,2,4
13256,2022-12-27,DYNAMIKE,bounty,Excel,1,0,1
13257,2022-12-26,DYNAMIKE,hotZone,Controller Chaos,1,0,1
13258,2022-12-26,DYNAMIKE,heist,Kaboom Canyon,1,0,1
13259,2022-12-26,DYNAMIKE,gemGrab,Minecart Madness,0,1,1
13260,2022-12-25,DYNAMIKE,brawlBall,Backyard Bowl,1,0,1
13261,2022-12-24,DYNAMIKE,brawlBall,Super Beach,4,2,6
13262,2022-12-23,DYNAMIKE,knockout,Out in the Open,1,0,1
13263,2022-12-22,DYNAMIKE,gemGrab,Gem Fort,0,1,1
13264,2022-12-22,DYNAMIKE,brawlBall,Pinhole Punt,2,0,2
13265,2022-12-21,DYNAMIKE,brawlBall,Sunny Soccer,0,1,1
13266,2022-12-20,DYNAMIKE,brawlBall,Beach Ball,2,1,3
13267,2022-12-16,DYNAMIKE,brawlBall,Sneaky Fields,1,3,4
13268,2022-12-13,DYNAMIKE,knockout,New Perspective,1,0,1
13269,2022-12-13,DYNAMIKE,heist,Safe Zone,0,1,1
13270,2022-12-13,DYNAMIKE,gemGrab,Crystal Arcade,1,0,1
13271,2022-12-13,DYNAMIKE,brawlBall,Beach Ball,1,2,3
13272,2022-12-10,DYNAMIKE,knockout,X Marks the Spot,0,1,1
13273,2022-12-10,DYNAMIKE,gemGrab,Hard Rock Mine,4,0,4
13274,2022-11-07,DYNAMIKE,hotZone,Quarter Pounder,0,1,1
13275,2022-11-03,DYNAMIKE,brawlBall,Pinhole Punt,1,1,2
13276,2022-11-01,DYNAMIKE,knockout,New Perspective,1,1,2
13277,2022-10-30,DYNAMIKE,bounty,Canal Grande,1,0,1
13278,2022-10-28,DYNAMIKE,bounty,Canal Grande,1,0,1
13279,2022-10-15,DYNAMIKE,gemGrab,Hard Rock Mine,0,1,1
13280,2023-02-05,DARRYL,knockout,X Marks the Spot,13,10,23
13281,2023-02-05,DARRYL,knockout,Goldarm Gulch,3,6,9
13282,2023-02-05,DARRYL,hotZone,Ring of Fire,22,7,29
13283,2023-02-05,DARRYL,heist,Snaked Assault,215,263,478
13284,2023-02-05,DARRYL,heist,Pit Stop,181,188,369
13285,2023-02-05,DARRYL,gemGrab,Hard Rock Mine,29,39,68
13286,2023-02-05,DARRYL,gemGrab,Double Swoosh,109,67,176
13287,2023-02-05,DARRYL,brawlBall,Super Beach,20,17,37
13288,2023-02-05,DARRYL,brawlBall,Sneaky Fields,43,41,84
13289,2023-02-05,DARRYL,brawlBall,Backyard Bowl,206,169,375
13290,2023-02-05,DARRYL,bounty,Layer Cake,58,58,116
13291,2023-02-04,DARRYL,knockout,X Marks the Spot,2,1,3
13292,2023-02-04,DARRYL,knockout,Goldarm Gulch,4,1,5
13293,2023-02-04,DARRYL,hotZone,Ring of Fire,4,7,11
13294,2023-02-04,DARRYL,heist,Tornado Ring,28,20,48
13295,2023-02-04,DARRYL,heist,Pit Stop,154,195,349
13296,2023-02-04,DARRYL,gemGrab,Hard Rock Mine,17,17,34
13297,2023-02-04,DARRYL,gemGrab,Double Swoosh,29,3,32
13298,2023-02-04,DARRYL,gemGrab,Deep Diner,5,5,10
13299,2023-02-04,DARRYL,brawlBall,Super Beach,151,108,259
13300,2023-02-04,DARRYL,brawlBall,Sneaky Fields,35,29,64
13301,2023-02-03,DARRYL,knockout,Out in the Open,19,9,28
13302,2023-02-03,DARRYL,knockout,Goldarm Gulch,12,11,23
13303,2023-02-03,DARRYL,hotZone,Split,30,32,62
13304,2023-02-03,DARRYL,heist,Tornado Ring,399,408,807
13305,2023-02-03,DARRYL,heist,Pit Stop,616,785,1401
13306,2023-02-03,DARRYL,gemGrab,Undermine,17,26,43
13307,2023-02-03,DARRYL,gemGrab,Double Swoosh,168,36,204
13308,2023-02-03,DARRYL,gemGrab,Deep Diner,51,49,100
13309,2023-02-03,DARRYL,brawlBall,Sneaky Fields,860,820,1680
13310,2023-02-03,DARRYL,brawlBall,Pinhole Punt,21,18,39
13311,2023-02-03,DARRYL,bounty,Dry Season,15,18,33
13312,2023-02-02,DARRYL,knockout,Out in the Open,3,2,5
13313,2023-02-02,DARRYL,hotZone,Split,14,10,24
13314,2023-02-02,DARRYL,heist,Kaboom Canyon,18,39,57
13315,2023-02-02,DARRYL,gemGrab,Undermine,15,7,22
13316,2023-02-02,DARRYL,gemGrab,Gem Fort,8,7,15
13317,2023-02-02,DARRYL,brawlBall,Sunny Soccer,11,7,18
13318,2023-02-02,DARRYL,brawlBall,Pinhole Punt,138,127,265
13319,2023-02-02,DARRYL,bounty,Shooting Star,3,1,4
13320,2023-02-01,DARRYL,knockout,Goldarm Gulch,58,42,100
13321,2023-02-01,DARRYL,hotZone,Parallel Plays,58,33,91
13322,2023-02-01,DARRYL,heist,Kaboom Canyon,57,60,117
13323,2023-02-01,DARRYL,gemGrab,Gem Fort,73,45,118
13324,2023-02-01,DARRYL,gemGrab,Crystal Arcade,30,33,63
13325,2023-02-01,DARRYL,brawlBall,Sunny Soccer,448,496,944
13326,2023-02-01,DARRYL,brawlBall,Beach Ball,20,22,42
13327,2023-02-01,DARRYL,bounty,Shooting Star,2,2,4
13328,2023-01-31,DARRYL,knockout,Goldarm Gulch,17,9,26
13329,2023-01-31,DARRYL,hotZone,Parallel Plays,23,12,35
13330,2023-01-31,DARRYL,heist,Pit Stop,113,77,190
13331,2023-01-31,DARRYL,gemGrab,Minecart Madness,2,1,3
13332,2023-01-31,DARRYL,gemGrab,Crystal Arcade,30,22,52
13333,2023-01-31,DARRYL,brawlBall,Center Stage,4,6,10
13334,2023-01-31,DARRYL,brawlBall,Beach Ball,174,171,345
13335,2023-01-31,DARRYL,bounty,Hideout,1,1,2
13336,2023-01-30,DARRYL,knockout,Belle's Rock,30,11,41
13337,2023-01-30,DARRYL,hotZone,Quarter Pounder,49,17,66
13338,2023-01-30,DARRYL,heist,Pit Stop,458,553,1011
13339,2023-01-30,DARRYL,gemGrab,Minecart Madness,25,24,49
13340,2023-01-30,DARRYL,gemGrab,Double Swoosh,27,26,53
13341,2023-01-30,DARRYL,brawlBall,Center Stage,430,465,895
13342,2023-01-30,DARRYL,brawlBall,Backyard Bowl,20,13,33
13343,2023-01-30,DARRYL,bounty,Hideout,7,2,9
13344,2023-01-29,DARRYL,knockout,Belle's Rock,41,23,64
13345,2023-01-29,DARRYL,hotZone,Quarter Pounder,32,9,41
13346,2023-01-29,DARRYL,heist,Bridge Too Far,69,95,164
13347,2023-01-29,DARRYL,gemGrab,Hard Rock Mine,9,7,16
13348,2023-01-29,DARRYL,gemGrab,Double Swoosh,61,41,102
13349,2023-01-29,DARRYL,brawlBall,Super Beach,9,5,14
13350,2023-01-29,DARRYL,brawlBall,Backyard Bowl,235,196,431
13351,2023-01-29,DARRYL,bounty,Canal Grande,42,38,80
13352,2023-01-28,DARRYL,knockout,Flaring Phoenix,20,15,35
13353,2023-01-28,DARRYL,hotZone,Controller Chaos,39,23,62
13354,2023-01-28,DARRYL,heist,Bridge Too Far,127,111,238
13355,2023-01-28,DARRYL,gemGrab,Hard Rock Mine,75,57,132
13356,2023-01-28,DARRYL,gemGrab,Deep Diner,11,17,28
13357,2023-01-28,DARRYL,brawlBall,Super Beach,532,551,1083
13358,2023-01-28,DARRYL,brawlBall,Sneaky Fields,29,19,48
13359,2023-01-28,DARRYL,bounty,Canal Grande,55,73,128
13360,2023-01-27,DARRYL,knockout,Flaring Phoenix,16,4,20
13361,2023-01-27,DARRYL,hotZone,Controller Chaos,8,5,13
13362,2023-01-27,DARRYL,heist,Hot Potato,59,88,147
13363,2023-01-27,DARRYL,gemGrab,Undermine,3,1,4
13364,2023-01-27,DARRYL,gemGrab,Deep Diner,25,29,54
13365,2023-01-27,DARRYL,brawlBall,Sneaky Fields,199,211,410
13366,2023-01-27,DARRYL,brawlBall,Pinhole Punt,6,3,9
13367,2023-01-27,DARRYL,bounty,Temple Ruins,8,8,16
13368,2023-01-26,DARRYL,knockout,Riverside,23,6,29
13369,2023-01-26,DARRYL,hotZone,Open Zone,16,8,24
13370,2023-01-26,DARRYL,heist,Hot Potato,368,405,773
13371,2023-01-26,DARRYL,gemGrab,Undermine,46,34,80
13372,2023-01-26,DARRYL,gemGrab,Gem Fort,20,17,37
13373,2023-01-26,DARRYL,brawlBall,Sunny Soccer,35,32,67
13374,2023-01-26,DARRYL,brawlBall,Pinhole Punt,435,404,839
13375,2023-01-26,DARRYL,bounty,Temple Ruins,10,17,27
13376,2023-01-25,DARRYL,knockout,Riverside,13,9,22
13377,2023-01-25,DARRYL,hotZone,Open Zone,4,4,8
13378,2023-01-25,DARRYL,heist,Safe Zone,91,72,163
13379,2023-01-25,DARRYL,gemGrab,Gem Fort,26,15,41
13380,2023-01-25,DARRYL,gemGrab,Crystal Arcade,29,16,45
13381,2023-01-25,DARRYL,brawlBall,Sunny Soccer,385,404,789
13382,2023-01-25,DARRYL,brawlBall,Beach Ball,48,59,107
13383,2023-01-25,DARRYL,bounty,Excel,14,11,25
13384,2023-01-24,DARRYL,knockout,New Perspective,28,24,52
13385,2023-01-24,DARRYL,hotZone,Dueling Beetles,24,7,31
13386,2023-01-24,DARRYL,heist,Safe Zone,96,105,201
13387,2023-01-24,DARRYL,gemGrab,Minecart Madness,5,3,8
13388,2023-01-24,DARRYL,gemGrab,Crystal Arcade,53,41,94
13389,2023-01-24,DARRYL,brawlBall,Center Stage,57,60,117
13390,2023-01-24,DARRYL,brawlBall,Beach Ball,424,474,898
13391,2023-01-24,DARRYL,bounty,Excel,17,12,29
13392,2023-01-23,DARRYL,knockout,New Perspective,39,42,81
13393,2023-01-23,DARRYL,hotZone,Dueling Beetles,30,25,55
13394,2023-01-23,DARRYL,heist,Snaked Assault,239,244,483
13395,2023-01-23,DARRYL,gemGrab,Minecart Madness,49,48,97
13396,2023-01-23,DARRYL,gemGrab,Double Swoosh,28,21,49
13397,2023-01-23,DARRYL,brawlBall,Center Stage,811,867,1678
13398,2023-01-23,DARRYL,brawlBall,Backyard Bowl,22,15,37
13399,2023-01-23,DARRYL,bounty,Layer Cake,34,26,60
13400,2023-01-22,DARRYL,knockout,X Marks the Spot,13,9,22
13401,2023-01-22,DARRYL,hotZone,Ring of Fire,14,16,30
13402,2023-01-22,DARRYL,heist,Snaked Assault,161,220,381
13403,2023-01-22,DARRYL,gemGrab,Hard Rock Mine,16,16,32
13404,2023-01-22,DARRYL,gemGrab,Double Swoosh,36,26,62
13405,2023-01-22,DARRYL,brawlBall,Super Beach,62,82,144
13406,2023-01-22,DARRYL,brawlBall,Backyard Bowl,104,93,197
13407,2023-01-22,DARRYL,bounty,Layer Cake,40,50,90
13408,2023-01-21,DARRYL,knockout,X Marks the Spot,54,27,81
13409,2023-01-21,DARRYL,hotZone,Ring of Fire,39,50,89
13410,2023-01-21,DARRYL,heist,Tornado Ring,178,211,389
13411,2023-01-21,DARRYL,gemGrab,Hard Rock Mine,89,89,178
13412,2023-01-21,DARRYL,gemGrab,Deep Diner,15,17,32
13413,2023-01-21,DARRYL,brawlBall,Super Beach,692,664,1356
13414,2023-01-21,DARRYL,brawlBall,Sneaky Fields,32,28,60
13415,2023-01-21,DARRYL,bounty,Dry Season,13,11,24
13416,2023-01-20,DARRYL,knockout,Out in the Open,34,13,47
13417,2023-01-20,DARRYL,hotZone,Split,44,52,96
13418,2023-01-20,DARRYL,heist,Tornado Ring,228,274,502
13419,2023-01-20,DARRYL,gemGrab,Undermine,28,21,49
13420,2023-01-20,DARRYL,gemGrab,Deep Diner,51,32,83
13421,2023-01-20,DARRYL,brawlBall,Sneaky Fields,640,619,1259
13422,2023-01-20,DARRYL,brawlBall,Pinhole Punt,20,15,35
13423,2023-01-20,DARRYL,bounty,Dry Season,9,4,13
13424,2023-01-19,DARRYL,knockout,Out in the Open,22,9,31
13425,2023-01-19,DARRYL,hotZone,Split,64,114,178
13426,2023-01-19,DARRYL,heist,Kaboom Canyon,69,50,119
13427,2023-01-19,DARRYL,gemGrab,Undermine,58,40,98
13428,2023-01-19,DARRYL,gemGrab,Gem Fort,18,22,40
13429,2023-01-19,DARRYL,brawlBall,Sunny Soccer,25,36,61
13430,2023-01-19,DARRYL,brawlBall,Pinhole Punt,480,503,983
13431,2023-01-19,DARRYL,bounty,Shooting Star,8,3,11
13432,2023-01-18,DARRYL,knockout,Goldarm Gulch,6,7,13
13433,2023-01-18,DARRYL,hotZone,Parallel Plays,5,6,11
13434,2023-01-18,DARRYL,heist,Kaboom Canyon,23,14,37
13435,2023-01-18,DARRYL,gemGrab,Gem Fort,13,6,19
13436,2023-01-18,DARRYL,gemGrab,Crystal Arcade,4,0,4
13437,2023-01-18,DARRYL,brawlBall,Sunny Soccer,166,169,335
13438,2023-01-18,DARRYL,brawlBall,Beach Ball,11,9,20
13439,2023-01-18,DARRYL,bounty,Shooting Star,2,0,2
13440,2023-01-17,DARRYL,knockout,Goldarm Gulch,3,9,12
13441,2023-01-17,DARRYL,hotZone,Parallel Plays,3,1,4
13442,2023-01-17,DARRYL,heist,Pit Stop,37,37,74
13443,2023-01-17,DARRYL,gemGrab,Minecart Madness,2,0,2
13444,2023-01-17,DARRYL,gemGrab,Crystal Arcade,3,1,4
13445,2023-01-17,DARRYL,brawlBall,Center Stage,4,2,6
13446,2023-01-17,DARRYL,brawlBall,Beach Ball,44,60,104
13447,2023-01-16,DARRYL,knockout,Belle's Rock,3,2,5
13448,2023-01-16,DARRYL,hotZone,Quarter Pounder,5,1,6
13449,2023-01-16,DARRYL,heist,Pit Stop,132,163,295
13450,2023-01-16,DARRYL,gemGrab,Minecart Madness,6,2,8
13451,2023-01-16,DARRYL,gemGrab,Double Swoosh,3,1,4
13452,2023-01-16,DARRYL,brawlBall,Center Stage,39,36,75
13453,2023-01-16,DARRYL,brawlBall,Backyard Bowl,2,0,2
13454,2023-01-15,DARRYL,knockout,Belle's Rock,4,2,6
13455,2023-01-15,DARRYL,hotZone,Quarter Pounder,3,2,5
13456,2023-01-15,DARRYL,heist,Bridge Too Far,16,13,29
13457,2023-01-15,DARRYL,gemGrab,Hard Rock Mine,2,0,2
13458,2023-01-15,DARRYL,gemGrab,Double Swoosh,3,17,20
13459,2023-01-15,DARRYL,brawlBall,Super Beach,9,2,11
13460,2023-01-15,DARRYL,brawlBall,Backyard Bowl,31,29,60
13461,2023-01-15,DARRYL,bounty,Canal Grande,4,2,6
13462,2023-01-14,DARRYL,knockout,Flaring Phoenix,4,5,9
13463,2023-01-14,DARRYL,hotZone,Controller Chaos,20,17,37
13464,2023-01-14,DARRYL,heist,Bridge Too Far,23,14,37
13465,2023-01-14,DARRYL,gemGrab,Hard Rock Mine,5,6,11
13466,2023-01-14,DARRYL,gemGrab,Deep Diner,2,0,2
13467,2023-01-14,DARRYL,brawlBall,Super Beach,39,24,63
13468,2023-01-14,DARRYL,brawlBall,Sneaky Fields,8,0,8
13469,2023-01-14,DARRYL,bounty,Canal Grande,7,8,15
13470,2023-01-13,DARRYL,knockout,Flaring Phoenix,2,1,3
13471,2023-01-13,DARRYL,hotZone,Controller Chaos,9,1,10
13472,2023-01-13,DARRYL,heist,Hot Potato,15,23,38
13473,2023-01-13,DARRYL,gemGrab,Deep Diner,2,1,3
13474,2023-01-13,DARRYL,brawlBall,Sneaky Fields,45,30,75
13475,2023-01-12,DARRYL,knockout,Riverside,4,0,4
13476,2023-01-12,DARRYL,hotZone,Open Zone,3,1,4
13477,2023-01-12,DARRYL,heist,Hot Potato,4,6,10
13478,2023-01-12,DARRYL,gemGrab,Undermine,0,1,1
13479,2023-01-12,DARRYL,gemGrab,Gem Fort,2,0,2
13480,2023-01-12,DARRYL,brawlBall,Sunny Soccer,2,0,2
13481,2023-01-12,DARRYL,brawlBall,Pinhole Punt,18,15,33
13482,2023-01-12,DARRYL,bounty,Temple Ruins,0,2,2
13483,2023-01-11,DARRYL,gemGrab,Gem Fort,1,0,1
13484,2023-01-11,DARRYL,brawlBall,Sunny Soccer,15,3,18
13485,2023-01-11,DARRYL,brawlBall,Beach Ball,1,1,2
13486,2023-01-11,DARRYL,bounty,Excel,3,9,12
13487,2023-01-10,DARRYL,knockout,New Perspective,3,5,8
13488,2023-01-10,DARRYL,hotZone,Dueling Beetles,8,1,9
13489,2023-01-10,DARRYL,heist,Safe Zone,6,3,9
13490,2023-01-10,DARRYL,gemGrab,Minecart Madness,1,2,3
13491,2023-01-10,DARRYL,gemGrab,Crystal Arcade,2,0,2
13492,2023-01-10,DARRYL,brawlBall,Center Stage,3,5,8
13493,2023-01-10,DARRYL,brawlBall,Beach Ball,20,22,42
13494,2023-01-09,DARRYL,knockout,New Perspective,1,3,4
13495,2023-01-09,DARRYL,hotZone,Dueling Beetles,12,4,16
13496,2023-01-09,DARRYL,heist,Snaked Assault,37,47,84
13497,2023-01-09,DARRYL,gemGrab,Minecart Madness,4,6,10
13498,2023-01-09,DARRYL,gemGrab,Double Swoosh,2,0,2
13499,2023-01-09,DARRYL,brawlBall,Center Stage,31,23,54
13500,2023-01-09,DARRYL,brawlBall,Backyard Bowl,1,7,8
13501,2023-01-09,DARRYL,bounty,Layer Cake,2,1,3
13502,2023-01-08,DARRYL,knockout,X Marks the Spot,4,1,5
13503,2023-01-08,DARRYL,hotZone,Ring of Fire,6,2,8
13504,2023-01-08,DARRYL,heist,Snaked Assault,29,44,73
13505,2023-01-08,DARRYL,gemGrab,Hard Rock Mine,4,7,11
13506,2023-01-08,DARRYL,gemGrab,Double Swoosh,1,1,2
13507,2023-01-08,DARRYL,brawlBall,Super Beach,2,1,3
13508,2023-01-08,DARRYL,brawlBall,Backyard Bowl,19,3,22
13509,2023-01-08,DARRYL,bounty,Layer Cake,1,1,2
13510,2023-01-07,DARRYL,hotZone,Ring of Fire,1,0,1
13511,2023-01-07,DARRYL,heist,Tornado Ring,44,95,139
13512,2023-01-07,DARRYL,gemGrab,Hard Rock Mine,6,11,17
13513,2023-01-07,DARRYL,gemGrab,Deep Diner,1,1,2
13514,2023-01-07,DARRYL,brawlBall,Super Beach,21,22,43
13515,2023-01-07,DARRYL,brawlBall,Sneaky Fields,1,1,2
13516,2023-01-07,DARRYL,bounty,Dry Season,2,0,2
13517,2023-01-06,DARRYL,knockout,Out in the Open,0,1,1
13518,2023-01-06,DARRYL,hotZone,Split,7,18,25
13519,2023-01-06,DARRYL,heist,Tornado Ring,55,62,117
13520,2023-01-06,DARRYL,gemGrab,Undermine,2,0,2
13521,2023-01-06,DARRYL,gemGrab,Deep Diner,5,2,7
13522,2023-01-06,DARRYL,brawlBall,Sneaky Fields,30,44,74
13523,2023-01-06,DARRYL,brawlBall,Pinhole Punt,7,1,8
13524,2023-01-06,DARRYL,bounty,Dry Season,1,0,1
13525,2023-01-05,DARRYL,knockout,Out in the Open,1,1,2
13526,2023-01-05,DARRYL,hotZone,Split,23,8,31
13527,2023-01-05,DARRYL,heist,Kaboom Canyon,9,12,21
13528,2023-01-05,DARRYL,gemGrab,Undermine,3,1,4
13529,2023-01-05,DARRYL,brawlBall,Pinhole Punt,35,37,72
13530,2023-01-05,DARRYL,bounty,Shooting Star,1,1,2
13531,2023-01-04,DARRYL,knockout,Goldarm Gulch,1,0,1
13532,2023-01-04,DARRYL,hotZone,Parallel Plays,1,0,1
13533,2023-01-04,DARRYL,heist,Kaboom Canyon,10,8,18
13534,2023-01-04,DARRYL,gemGrab,Gem Fort,2,0,2
13535,2023-01-04,DARRYL,gemGrab,Crystal Arcade,4,5,9
13536,2023-01-04,DARRYL,brawlBall,Sunny Soccer,59,65,124
13537,2023-01-04,DARRYL,brawlBall,Beach Ball,0,1,1
13538,2023-01-04,DARRYL,bounty,Shooting Star,1,0,1
13539,2023-01-03,DARRYL,knockout,Goldarm Gulch,2,0,2
13540,2023-01-03,DARRYL,hotZone,Parallel Plays,4,0,4
13541,2023-01-03,DARRYL,heist,Pit Stop,52,75,127
13542,2023-01-03,DARRYL,gemGrab,Minecart Madness,1,0,1
13543,2023-01-03,DARRYL,gemGrab,Crystal Arcade,10,4,14
13544,2023-01-03,DARRYL,brawlBall,Center Stage,2,0,2
13545,2023-01-03,DARRYL,brawlBall,Beach Ball,33,20,53
13546,2023-01-03,DARRYL,bounty,Hideout,2,0,2
13547,2023-01-02,DARRYL,knockout,Belle's Rock,5,2,7
13548,2023-01-02,DARRYL,hotZone,Quarter Pounder,9,2,11
13549,2023-01-02,DARRYL,heist,Pit Stop,109,155,264
13550,2023-01-02,DARRYL,gemGrab,Minecart Madness,5,0,5
13551,2023-01-02,DARRYL,gemGrab,Double Swoosh,6,0,6
13552,2023-01-02,DARRYL,brawlBall,Center Stage,48,36,84
13553,2023-01-02,DARRYL,brawlBall,Backyard Bowl,3,1,4
13554,2023-01-02,DARRYL,bounty,Hideout,1,0,1
13555,2023-01-01,DARRYL,hotZone,Quarter Pounder,1,0,1
13556,2023-01-01,DARRYL,heist,Bridge Too Far,4,9,13
13557,2023-01-01,DARRYL,gemGrab,Double Swoosh,5,2,7
13558,2023-01-01,DARRYL,brawlBall,Backyard Bowl,5,4,9
13559,2022-12-31,DARRYL,heist,Kaboom Canyon,0,1,1
13560,2022-12-31,DARRYL,heist,Bridge Too Far,1,1,2
13561,2022-12-31,DARRYL,gemGrab,Hard Rock Mine,1,0,1
13562,2022-12-31,DARRYL,gemGrab,Deep Diner,1,0,1
13563,2022-12-31,DARRYL,brawlBall,Super Beach,3,2,5
13564,2022-12-30,DARRYL,hotZone,Controller Chaos,3,1,4
13565,2022-12-30,DARRYL,heist,Kaboom Canyon,1,0,1
13566,2022-12-30,DARRYL,heist,Hot Potato,0,1,1
13567,2022-12-30,DARRYL,gemGrab,Deep Diner,3,0,3
13568,2022-12-30,DARRYL,brawlBall,Sneaky Fields,3,4,7
13569,2022-12-29,DARRYL,hotZone,Controller Chaos,0,1,1
13570,2022-12-29,DARRYL,heist,Hot Potato,3,0,3
13571,2022-12-29,DARRYL,gemGrab,Gem Fort,0,1,1
13572,2022-12-29,DARRYL,brawlBall,Pinhole Punt,0,12,12
13573,2022-12-27,DARRYL,hotZone,Dueling Beetles,0,1,1
13574,2022-12-27,DARRYL,brawlBall,Beach Ball,0,1,1
13575,2022-12-26,DARRYL,gemGrab,Minecart Madness,1,0,1
13576,2022-12-22,DARRYL,gemGrab,Gem Fort,0,1,1
13577,2022-12-19,DARRYL,brawlBall,Center Stage,1,1,2
13578,2022-12-16,DARRYL,brawlBall,Sneaky Fields,0,1,1
13579,2022-12-13,DARRYL,heist,Safe Zone,1,0,1
13580,2022-12-13,DARRYL,brawlBall,Beach Ball,1,0,1
13581,2022-11-11,DARRYL,brawlBall,Sneaky Fields,0,1,1
13582,2022-11-03,DARRYL,brawlBall,Pinhole Punt,1,0,1
13583,2022-10-28,DARRYL,heist,Safe Zone,1,0,1
13584,2022-10-28,DARRYL,bounty,Canal Grande,1,0,1
13585,2022-10-26,DARRYL,brawlBall,Sunny Soccer,1,0,1
13586,2022-10-15,DARRYL,gemGrab,Hard Rock Mine,1,0,1
13587,2023-02-05,CROW,knockout,X Marks the Spot,107,56,163
13588,2023-02-05,CROW,knockout,Goldarm Gulch,6,8,14
13589,2023-02-05,CROW,hotZone,Ring of Fire,275,241,516
13590,2023-02-05,CROW,heist,Snaked Assault,86,68,154
13591,2023-02-05,CROW,heist,Pit Stop,1,1,2
13592,2023-02-05,CROW,gemGrab,Hard Rock Mine,81,77,158
13593,2023-02-05,CROW,gemGrab,Double Swoosh,686,734,1420
13594,2023-02-05,CROW,brawlBall,Super Beach,26,22,48
13595,2023-02-05,CROW,brawlBall,Sneaky Fields,30,30,60
13596,2023-02-05,CROW,brawlBall,Backyard Bowl,2127,2040,4167
13597,2023-02-05,CROW,bounty,Layer Cake,53,23,76
13598,2023-02-04,CROW,knockout,X Marks the Spot,33,27,60
13599,2023-02-04,CROW,knockout,Goldarm Gulch,8,3,11
13600,2023-02-04,CROW,hotZone,Ring of Fire,58,71,129
13601,2023-02-04,CROW,heist,Tornado Ring,8,3,11
13602,2023-02-04,CROW,heist,Pit Stop,1,1,2
13603,2023-02-04,CROW,gemGrab,Hard Rock Mine,87,67,154
13604,2023-02-04,CROW,gemGrab,Double Swoosh,59,101,160
13605,2023-02-04,CROW,gemGrab,Deep Diner,25,20,45
13606,2023-02-04,CROW,brawlBall,Super Beach,227,172,399
13607,2023-02-04,CROW,brawlBall,Sneaky Fields,29,37,66
13608,2023-02-04,CROW,bounty,Dry Season,28,34,62
13609,2023-02-03,CROW,knockout,Out in the Open,267,147,414
13610,2023-02-03,CROW,knockout,Goldarm Gulch,47,23,70
13611,2023-02-03,CROW,hotZone,Split,42,13,55
13612,2023-02-03,CROW,heist,Tornado Ring,160,195,355
13613,2023-02-03,CROW,heist,Pit Stop,9,7,16
13614,2023-02-03,CROW,gemGrab,Undermine,183,145,328
13615,2023-02-03,CROW,gemGrab,Double Swoosh,342,707,1049
13616,2023-02-03,CROW,gemGrab,Deep Diner,410,314,724
13617,2023-02-03,CROW,brawlBall,Sneaky Fields,949,796,1745
13618,2023-02-03,CROW,brawlBall,Pinhole Punt,83,118,201
13619,2023-02-03,CROW,bounty,Dry Season,230,128,358
13620,2023-02-02,CROW,knockout,Out in the Open,115,58,173
13621,2023-02-02,CROW,hotZone,Split,23,4,27
13622,2023-02-02,CROW,heist,Kaboom Canyon,23,16,39
13623,2023-02-02,CROW,gemGrab,Undermine,111,107,218
13624,2023-02-02,CROW,gemGrab,Gem Fort,27,27,54
13625,2023-02-02,CROW,brawlBall,Sunny Soccer,13,25,38
13626,2023-02-02,CROW,brawlBall,Pinhole Punt,556,597,1153
13627,2023-02-02,CROW,bounty,Shooting Star,24,8,32
13628,2023-02-01,CROW,knockout,Goldarm Gulch,240,129,369
13629,2023-02-01,CROW,hotZone,Parallel Plays,132,83,215
13630,2023-02-01,CROW,heist,Kaboom Canyon,138,167,305
13631,2023-02-01,CROW,gemGrab,Gem Fort,381,398,779
13632,2023-02-01,CROW,gemGrab,Crystal Arcade,169,108,277
13633,2023-02-01,CROW,brawlBall,Sunny Soccer,713,584,1297
13634,2023-02-01,CROW,brawlBall,Beach Ball,43,30,73
13635,2023-02-01,CROW,bounty,Shooting Star,70,25,95
13636,2023-01-31,CROW,knockout,Goldarm Gulch,100,59,159
13637,2023-01-31,CROW,hotZone,Parallel Plays,52,30,82
13638,2023-01-31,CROW,heist,Pit Stop,8,6,14
13639,2023-01-31,CROW,gemGrab,Minecart Madness,28,19,47
13640,2023-01-31,CROW,gemGrab,Crystal Arcade,166,118,284
13641,2023-01-31,CROW,brawlBall,Center Stage,9,16,25
13642,2023-01-31,CROW,brawlBall,Beach Ball,430,433,863
13643,2023-01-31,CROW,bounty,Hideout,21,13,34
13644,2023-01-30,CROW,knockout,Belle's Rock,144,50,194
13645,2023-01-30,CROW,hotZone,Quarter Pounder,281,95,376
13646,2023-01-30,CROW,heist,Pit Stop,13,4,17
13647,2023-01-30,CROW,gemGrab,Minecart Madness,314,284,598
13648,2023-01-30,CROW,gemGrab,Double Swoosh,309,353,662
13649,2023-01-30,CROW,brawlBall,Center Stage,787,688,1475
13650,2023-01-30,CROW,brawlBall,Backyard Bowl,177,193,370
13651,2023-01-30,CROW,bounty,Hideout,52,23,75
13652,2023-01-29,CROW,knockout,Belle's Rock,131,54,185
13653,2023-01-29,CROW,hotZone,Quarter Pounder,151,50,201
13654,2023-01-29,CROW,heist,Bridge Too Far,36,9,45
13655,2023-01-29,CROW,gemGrab,Hard Rock Mine,62,33,95
13656,2023-01-29,CROW,gemGrab,Double Swoosh,472,470,942
13657,2023-01-29,CROW,brawlBall,Super Beach,19,10,29
13658,2023-01-29,CROW,brawlBall,Backyard Bowl,1941,1848,3789
13659,2023-01-29,CROW,bounty,Canal Grande,50,24,74
13660,2023-01-28,CROW,knockout,Flaring Phoenix,110,49,159
13661,2023-01-28,CROW,hotZone,Controller Chaos,82,43,125
13662,2023-01-28,CROW,heist,Bridge Too Far,84,45,129
13663,2023-01-28,CROW,gemGrab,Hard Rock Mine,321,231,552
13664,2023-01-28,CROW,gemGrab,Deep Diner,125,60,185
13665,2023-01-28,CROW,brawlBall,Super Beach,814,696,1510
13666,2023-01-28,CROW,brawlBall,Sneaky Fields,29,18,47
13667,2023-01-28,CROW,bounty,Canal Grande,94,65,159
13668,2023-01-27,CROW,knockout,Flaring Phoenix,69,39,108
13669,2023-01-27,CROW,hotZone,Controller Chaos,25,15,40
13670,2023-01-27,CROW,heist,Hot Potato,19,3,22
13671,2023-01-27,CROW,gemGrab,Undermine,33,31,64
13672,2023-01-27,CROW,gemGrab,Deep Diner,152,96,248
13673,2023-01-27,CROW,brawlBall,Sneaky Fields,174,192,366
13674,2023-01-27,CROW,brawlBall,Pinhole Punt,26,28,54
13675,2023-01-27,CROW,bounty,Temple Ruins,47,76,123
13676,2023-01-26,CROW,knockout,Riverside,178,69,247
13677,2023-01-26,CROW,hotZone,Open Zone,482,501,983
13678,2023-01-26,CROW,heist,Hot Potato,28,12,40
13679,2023-01-26,CROW,gemGrab,Undermine,350,306,656
13680,2023-01-26,CROW,gemGrab,Gem Fort,107,132,239
13681,2023-01-26,CROW,brawlBall,Sunny Soccer,46,47,93
13682,2023-01-26,CROW,brawlBall,Pinhole Punt,1811,1935,3746
13683,2023-01-26,CROW,bounty,Temple Ruins,138,142,280
13684,2023-01-25,CROW,knockout,Riverside,74,30,104
13685,2023-01-25,CROW,hotZone,Open Zone,293,321,614
13686,2023-01-25,CROW,heist,Safe Zone,79,58,137
13687,2023-01-25,CROW,gemGrab,Gem Fort,165,190,355
13688,2023-01-25,CROW,gemGrab,Crystal Arcade,192,103,295
13689,2023-01-25,CROW,brawlBall,Sunny Soccer,463,402,865
13690,2023-01-25,CROW,brawlBall,Beach Ball,110,88,198
13691,2023-01-25,CROW,bounty,Excel,40,17,57
13692,2023-01-24,CROW,knockout,New Perspective,172,75,247
13693,2023-01-24,CROW,hotZone,Dueling Beetles,104,77,181
13694,2023-01-24,CROW,heist,Safe Zone,78,40,118
13695,2023-01-24,CROW,gemGrab,Minecart Madness,95,90,185
13696,2023-01-24,CROW,gemGrab,Crystal Arcade,261,160,421
13697,2023-01-24,CROW,brawlBall,Center Stage,127,110,237
13698,2023-01-24,CROW,brawlBall,Beach Ball,935,849,1784
13699,2023-01-24,CROW,bounty,Excel,60,39,99
13700,2023-01-23,CROW,knockout,New Perspective,289,150,439
13701,2023-01-23,CROW,hotZone,Dueling Beetles,173,78,251
13702,2023-01-23,CROW,heist,Snaked Assault,64,32,96
13703,2023-01-23,CROW,gemGrab,Minecart Madness,497,557,1054
13704,2023-01-23,CROW,gemGrab,Double Swoosh,289,305,594
13705,2023-01-23,CROW,brawlBall,Center Stage,1244,1137,2381
13706,2023-01-23,CROW,brawlBall,Backyard Bowl,146,128,274
13707,2023-01-23,CROW,bounty,Layer Cake,63,37,100
13708,2023-01-22,CROW,knockout,X Marks the Spot,78,73,151
13709,2023-01-22,CROW,hotZone,Ring of Fire,177,212,389
13710,2023-01-22,CROW,heist,Snaked Assault,20,7,27
13711,2023-01-22,CROW,gemGrab,Hard Rock Mine,69,46,115
13712,2023-01-22,CROW,gemGrab,Double Swoosh,312,366,678
13713,2023-01-22,CROW,brawlBall,Super Beach,63,49,112
13714,2023-01-22,CROW,brawlBall,Backyard Bowl,1000,961,1961
13715,2023-01-22,CROW,bounty,Layer Cake,36,17,53
13716,2023-01-21,CROW,knockout,X Marks the Spot,326,171,497
13717,2023-01-21,CROW,hotZone,Ring of Fire,476,520,996
13718,2023-01-21,CROW,heist,Tornado Ring,67,72,139
13719,2023-01-21,CROW,gemGrab,Hard Rock Mine,383,289,672
13720,2023-01-21,CROW,gemGrab,Deep Diner,123,84,207
13721,2023-01-21,CROW,brawlBall,Super Beach,1185,920,2105
13722,2023-01-21,CROW,brawlBall,Sneaky Fields,46,42,88
13723,2023-01-21,CROW,bounty,Dry Season,122,56,178
13724,2023-01-20,CROW,knockout,Out in the Open,291,159,450
13725,2023-01-20,CROW,hotZone,Split,41,10,51
13726,2023-01-20,CROW,heist,Tornado Ring,74,51,125
13727,2023-01-20,CROW,gemGrab,Undermine,209,195,404
13728,2023-01-20,CROW,gemGrab,Deep Diner,386,238,624
13729,2023-01-20,CROW,brawlBall,Sneaky Fields,739,611,1350
13730,2023-01-20,CROW,brawlBall,Pinhole Punt,70,70,140
13731,2023-01-20,CROW,bounty,Dry Season,126,64,190
13732,2023-01-19,CROW,knockout,Out in the Open,319,166,485
13733,2023-01-19,CROW,hotZone,Split,68,25,93
13734,2023-01-19,CROW,heist,Kaboom Canyon,98,110,208
13735,2023-01-19,CROW,gemGrab,Undermine,497,435,932
13736,2023-01-19,CROW,gemGrab,Gem Fort,86,66,152
13737,2023-01-19,CROW,brawlBall,Sunny Soccer,30,27,57
13738,2023-01-19,CROW,brawlBall,Pinhole Punt,1981,2081,4062
13739,2023-01-19,CROW,bounty,Shooting Star,103,43,146
13740,2023-01-18,CROW,knockout,Goldarm Gulch,29,16,45
13741,2023-01-18,CROW,hotZone,Parallel Plays,11,16,27
13742,2023-01-18,CROW,heist,Kaboom Canyon,65,54,119
13743,2023-01-18,CROW,gemGrab,Gem Fort,96,114,210
13744,2023-01-18,CROW,gemGrab,Crystal Arcade,26,14,40
13745,2023-01-18,CROW,brawlBall,Sunny Soccer,199,169,368
13746,2023-01-18,CROW,brawlBall,Beach Ball,19,17,36
13747,2023-01-18,CROW,bounty,Shooting Star,37,22,59
13748,2023-01-17,CROW,knockout,Goldarm Gulch,25,13,38
13749,2023-01-17,CROW,hotZone,Parallel Plays,5,5,10
13750,2023-01-17,CROW,heist,Pit Stop,4,0,4
13751,2023-01-17,CROW,gemGrab,Minecart Madness,5,3,8
13752,2023-01-17,CROW,gemGrab,Crystal Arcade,22,15,37
13753,2023-01-17,CROW,brawlBall,Center Stage,1,3,4
13754,2023-01-17,CROW,brawlBall,Beach Ball,71,72,143
13755,2023-01-17,CROW,bounty,Hideout,11,2,13
13756,2023-01-16,CROW,knockout,Belle's Rock,10,1,11
13757,2023-01-16,CROW,hotZone,Quarter Pounder,27,7,34
13758,2023-01-16,CROW,heist,Pit Stop,5,0,5
13759,2023-01-16,CROW,gemGrab,Minecart Madness,44,52,96
13760,2023-01-16,CROW,gemGrab,Double Swoosh,23,9,32
13761,2023-01-16,CROW,brawlBall,Center Stage,73,72,145
13762,2023-01-16,CROW,brawlBall,Backyard Bowl,34,30,64
13763,2023-01-16,CROW,bounty,Hideout,23,4,27
13764,2023-01-15,CROW,knockout,Belle's Rock,12,6,18
13765,2023-01-15,CROW,hotZone,Quarter Pounder,62,23,85
13766,2023-01-15,CROW,heist,Bridge Too Far,8,0,8
13767,2023-01-15,CROW,gemGrab,Hard Rock Mine,19,12,31
13768,2023-01-15,CROW,gemGrab,Double Swoosh,70,92,162
13769,2023-01-15,CROW,brawlBall,Super Beach,12,3,15
13770,2023-01-15,CROW,brawlBall,Backyard Bowl,326,374,700
13771,2023-01-15,CROW,bounty,Canal Grande,5,2,7
13772,2023-01-14,CROW,knockout,Flaring Phoenix,5,6,11
13773,2023-01-14,CROW,hotZone,Controller Chaos,34,14,48
13774,2023-01-14,CROW,heist,Bridge Too Far,12,1,13
13775,2023-01-14,CROW,gemGrab,Hard Rock Mine,32,4,36
13776,2023-01-14,CROW,gemGrab,Deep Diner,20,13,33
13777,2023-01-14,CROW,brawlBall,Super Beach,81,47,128
13778,2023-01-14,CROW,brawlBall,Sneaky Fields,6,0,6
13779,2023-01-14,CROW,bounty,Canal Grande,11,3,14
13780,2023-01-13,CROW,knockout,Flaring Phoenix,14,7,21
13781,2023-01-13,CROW,hotZone,Controller Chaos,22,5,27
13782,2023-01-13,CROW,heist,Hot Potato,1,0,1
13783,2023-01-13,CROW,gemGrab,Undermine,1,2,3
13784,2023-01-13,CROW,gemGrab,Deep Diner,52,12,64
13785,2023-01-13,CROW,brawlBall,Sneaky Fields,56,65,121
13786,2023-01-13,CROW,brawlBall,Pinhole Punt,4,9,13
13787,2023-01-13,CROW,bounty,Temple Ruins,5,5,10
13788,2023-01-12,CROW,knockout,Riverside,12,2,14
13789,2023-01-12,CROW,hotZone,Open Zone,68,114,182
13790,2023-01-12,CROW,heist,Hot Potato,0,1,1
13791,2023-01-12,CROW,gemGrab,Undermine,21,33,54
13792,2023-01-12,CROW,gemGrab,Gem Fort,3,1,4
13793,2023-01-12,CROW,brawlBall,Sunny Soccer,1,0,1
13794,2023-01-12,CROW,brawlBall,Pinhole Punt,74,55,129
13795,2023-01-12,CROW,bounty,Temple Ruins,1,0,1
13796,2023-01-11,CROW,hotZone,Open Zone,32,28,60
13797,2023-01-11,CROW,gemGrab,Gem Fort,10,3,13
13798,2023-01-11,CROW,brawlBall,Sunny Soccer,15,8,23
13799,2023-01-11,CROW,brawlBall,Beach Ball,1,0,1
13800,2023-01-11,CROW,bounty,Excel,1,0,1
13801,2023-01-10,CROW,knockout,New Perspective,17,1,18
13802,2023-01-10,CROW,hotZone,Dueling Beetles,36,19,55
13803,2023-01-10,CROW,heist,Safe Zone,5,2,7
13804,2023-01-10,CROW,gemGrab,Minecart Madness,30,25,55
13805,2023-01-10,CROW,gemGrab,Crystal Arcade,51,24,75
13806,2023-01-10,CROW,brawlBall,Center Stage,14,24,38
13807,2023-01-10,CROW,brawlBall,Beach Ball,86,51,137
13808,2023-01-10,CROW,bounty,Excel,4,0,4
13809,2023-01-09,CROW,knockout,New Perspective,9,2,11
13810,2023-01-09,CROW,hotZone,Dueling Beetles,10,8,18
13811,2023-01-09,CROW,heist,Snaked Assault,7,3,10
13812,2023-01-09,CROW,gemGrab,Minecart Madness,45,41,86
13813,2023-01-09,CROW,gemGrab,Double Swoosh,44,35,79
13814,2023-01-09,CROW,brawlBall,Center Stage,56,52,108
13815,2023-01-09,CROW,brawlBall,Backyard Bowl,17,2,19
13816,2023-01-09,CROW,bounty,Layer Cake,11,3,14
13817,2023-01-08,CROW,knockout,X Marks the Spot,18,0,18
13818,2023-01-08,CROW,hotZone,Ring of Fire,37,17,54
13819,2023-01-08,CROW,heist,Snaked Assault,3,3,6
13820,2023-01-08,CROW,gemGrab,Hard Rock Mine,5,7,12
13821,2023-01-08,CROW,gemGrab,Double Swoosh,27,48,75
13822,2023-01-08,CROW,brawlBall,Super Beach,6,5,11
13823,2023-01-08,CROW,brawlBall,Backyard Bowl,176,143,319
13824,2023-01-08,CROW,bounty,Layer Cake,2,1,3
13825,2023-01-07,CROW,knockout,X Marks the Spot,5,1,6
13826,2023-01-07,CROW,hotZone,Ring of Fire,34,17,51
13827,2023-01-07,CROW,heist,Tornado Ring,12,4,16
13828,2023-01-07,CROW,gemGrab,Hard Rock Mine,19,6,25
13829,2023-01-07,CROW,gemGrab,Deep Diner,14,23,37
13830,2023-01-07,CROW,brawlBall,Super Beach,25,11,36
13831,2023-01-07,CROW,brawlBall,Sneaky Fields,3,0,3
13832,2023-01-07,CROW,bounty,Dry Season,5,5,10
13833,2023-01-06,CROW,knockout,Out in the Open,22,9,31
13834,2023-01-06,CROW,hotZone,Split,4,0,4
13835,2023-01-06,CROW,heist,Tornado Ring,12,18,30
13836,2023-01-06,CROW,gemGrab,Undermine,14,7,21
13837,2023-01-06,CROW,gemGrab,Deep Diner,49,24,73
13838,2023-01-06,CROW,brawlBall,Sneaky Fields,45,17,62
13839,2023-01-06,CROW,brawlBall,Pinhole Punt,23,26,49
13840,2023-01-06,CROW,bounty,Dry Season,10,1,11
13841,2023-01-05,CROW,knockout,Out in the Open,29,16,45
13842,2023-01-05,CROW,hotZone,Split,18,5,23
13843,2023-01-05,CROW,heist,Kaboom Canyon,16,1,17
13844,2023-01-05,CROW,gemGrab,Undermine,73,47,120
13845,2023-01-05,CROW,gemGrab,Gem Fort,10,11,21
13846,2023-01-05,CROW,brawlBall,Sunny Soccer,1,1,2
13847,2023-01-05,CROW,brawlBall,Pinhole Punt,274,247,521
13848,2023-01-05,CROW,bounty,Shooting Star,12,3,15
13849,2023-01-04,CROW,knockout,Goldarm Gulch,11,6,17
13850,2023-01-04,CROW,hotZone,Parallel Plays,9,1,10
13851,2023-01-04,CROW,heist,Kaboom Canyon,42,45,87
13852,2023-01-04,CROW,gemGrab,Gem Fort,82,88,170
13853,2023-01-04,CROW,gemGrab,Crystal Arcade,18,15,33
13854,2023-01-04,CROW,brawlBall,Sunny Soccer,56,28,84
13855,2023-01-04,CROW,brawlBall,Beach Ball,1,0,1
13856,2023-01-04,CROW,bounty,Shooting Star,22,2,24
13857,2023-01-03,CROW,knockout,Goldarm Gulch,4,0,4
13858,2023-01-03,CROW,hotZone,Parallel Plays,18,5,23
13859,2023-01-03,CROW,heist,Pit Stop,3,0,3
13860,2023-01-03,CROW,gemGrab,Minecart Madness,17,5,22
13861,2023-01-03,CROW,gemGrab,Crystal Arcade,43,11,54
13862,2023-01-03,CROW,brawlBall,Center Stage,3,1,4
13863,2023-01-03,CROW,brawlBall,Beach Ball,101,72,173
13864,2023-01-03,CROW,bounty,Hideout,9,0,9
13865,2023-01-02,CROW,knockout,Belle's Rock,13,1,14
13866,2023-01-02,CROW,hotZone,Quarter Pounder,43,16,59
13867,2023-01-02,CROW,heist,Pit Stop,2,0,2
13868,2023-01-02,CROW,heist,Kaboom Canyon,0,1,1
13869,2023-01-02,CROW,gemGrab,Minecart Madness,86,99,185
13870,2023-01-02,CROW,gemGrab,Double Swoosh,34,21,55
13871,2023-01-02,CROW,brawlBall,Center Stage,92,83,175
13872,2023-01-02,CROW,brawlBall,Backyard Bowl,11,13,24
13873,2023-01-02,CROW,bounty,Hideout,20,2,22
13874,2023-01-01,CROW,knockout,Belle's Rock,2,2,4
13875,2023-01-01,CROW,hotZone,Quarter Pounder,10,1,11
13876,2023-01-01,CROW,heist,Bridge Too Far,1,0,1
13877,2023-01-01,CROW,gemGrab,Hard Rock Mine,1,0,1
13878,2023-01-01,CROW,gemGrab,Double Swoosh,26,18,44
13879,2023-01-01,CROW,brawlBall,Backyard Bowl,98,95,193
13880,2023-01-01,CROW,bounty,Canal Grande,2,0,2
13881,2022-12-31,CROW,hotZone,Controller Chaos,2,0,2
13882,2022-12-31,CROW,gemGrab,Hard Rock Mine,8,5,13
13883,2022-12-31,CROW,gemGrab,Deep Diner,10,2,12
13884,2022-12-31,CROW,brawlBall,Super Beach,2,3,5
13885,2022-12-31,CROW,brawlBall,Sneaky Fields,0,1,1
13886,2022-12-30,CROW,knockout,Flaring Phoenix,0,1,1
13887,2022-12-30,CROW,hotZone,Controller Chaos,7,0,7
13888,2022-12-30,CROW,gemGrab,Undermine,5,1,6
13889,2022-12-30,CROW,gemGrab,Minecart Madness,0,1,1
13890,2022-12-30,CROW,gemGrab,Deep Diner,4,1,5
13891,2022-12-30,CROW,brawlBall,Sneaky Fields,3,1,4
13892,2022-12-29,CROW,hotZone,Open Zone,1,5,6
13893,2022-12-29,CROW,gemGrab,Undermine,2,0,2
13894,2022-12-29,CROW,gemGrab,Gem Fort,1,1,2
13895,2022-12-29,CROW,brawlBall,Pinhole Punt,8,4,12
13896,2022-12-28,CROW,hotZone,Open Zone,8,5,13
13897,2022-12-27,CROW,knockout,New Perspective,1,0,1
13898,2022-12-27,CROW,hotZone,Controller Chaos,1,0,1
13899,2022-12-27,CROW,gemGrab,Minecart Madness,2,0,2
13900,2022-12-27,CROW,brawlBall,Beach Ball,0,1,1
13901,2022-12-26,CROW,gemGrab,Minecart Madness,1,1,2
13902,2022-12-26,CROW,brawlBall,Center Stage,1,0,1
13903,2022-12-25,CROW,gemGrab,Double Swoosh,1,2,3
13904,2022-12-25,CROW,brawlBall,Backyard Bowl,3,0,3
13905,2022-12-24,CROW,brawlBall,Super Beach,0,1,1
13906,2022-12-24,CROW,bounty,Dry Season,0,1,1
13907,2022-12-23,CROW,knockout,Out in the Open,5,0,5
13908,2022-12-22,CROW,heist,Kaboom Canyon,0,1,1
13909,2022-12-22,CROW,gemGrab,Gem Fort,5,0,5
13910,2022-12-22,CROW,brawlBall,Pinhole Punt,4,0,4
13911,2022-12-21,CROW,brawlBall,Sunny Soccer,0,1,1
13912,2022-12-20,CROW,brawlBall,Beach Ball,1,0,1
13913,2022-12-16,CROW,brawlBall,Sneaky Fields,0,2,2
13914,2022-12-13,CROW,knockout,New Perspective,2,0,2
13915,2022-12-13,CROW,heist,Safe Zone,1,0,1
13916,2022-12-13,CROW,gemGrab,Crystal Arcade,0,1,1
13917,2022-12-13,CROW,brawlBall,Beach Ball,2,1,3
13918,2022-12-11,CROW,gemGrab,Double Swoosh,0,1,1
13919,2022-12-10,CROW,gemGrab,Hard Rock Mine,0,1,1
13920,2022-11-03,CROW,bounty,Temple Ruins,0,1,1
13921,2022-11-01,CROW,knockout,New Perspective,1,0,1
13922,2022-10-30,CROW,knockout,Out in the Open,1,0,1
13923,2022-10-28,CROW,brawlBall,Beach Ball,0,2,2
13924,2022-10-28,CROW,bounty,Canal Grande,1,0,1
13925,2022-10-15,CROW,gemGrab,Hard Rock Mine,0,1,1
13926,2023-02-05,COLT,knockout,X Marks the Spot,128,70,198
13927,2023-02-05,COLT,knockout,Goldarm Gulch,12,3,15
13928,2023-02-05,COLT,hotZone,Ring of Fire,39,13,52
13929,2023-02-05,COLT,heist,Snaked Assault,812,985,1797
13930,2023-02-05,COLT,heist,Pit Stop,47,56,103
13931,2023-02-05,COLT,gemGrab,Hard Rock Mine,25,10,35
13932,2023-02-05,COLT,gemGrab,Double Swoosh,98,88,186
13933,2023-02-05,COLT,brawlBall,Super Beach,26,28,54
13934,2023-02-05,COLT,brawlBall,Sneaky Fields,12,11,23
13935,2023-02-05,COLT,brawlBall,Backyard Bowl,1600,1321,2921
13936,2023-02-05,COLT,bounty,Layer Cake,31,16,47
13937,2023-02-04,COLT,knockout,X Marks the Spot,48,27,75
13938,2023-02-04,COLT,knockout,Goldarm Gulch,7,3,10
13939,2023-02-04,COLT,hotZone,Ring of Fire,5,7,12
13940,2023-02-04,COLT,heist,Tornado Ring,98,85,183
13941,2023-02-04,COLT,heist,Pit Stop,43,43,86
13942,2023-02-04,COLT,gemGrab,Hard Rock Mine,25,9,34
13943,2023-02-04,COLT,gemGrab,Double Swoosh,16,6,22
13944,2023-02-04,COLT,gemGrab,Deep Diner,11,5,16
13945,2023-02-04,COLT,brawlBall,Super Beach,227,163,390
13946,2023-02-04,COLT,brawlBall,Sneaky Fields,5,6,11
13947,2023-02-04,COLT,bounty,Dry Season,21,9,30
13948,2023-02-03,COLT,knockout,Out in the Open,230,176,406
13949,2023-02-03,COLT,knockout,Goldarm Gulch,37,33,70
13950,2023-02-03,COLT,hotZone,Split,34,41,75
13951,2023-02-03,COLT,heist,Tornado Ring,1051,1114,2165
13952,2023-02-03,COLT,heist,Pit Stop,312,284,596
13953,2023-02-03,COLT,gemGrab,Undermine,23,10,33
13954,2023-02-03,COLT,gemGrab,Double Swoosh,88,63,151
13955,2023-02-03,COLT,gemGrab,Deep Diner,158,122,280
13956,2023-02-03,COLT,brawlBall,Sneaky Fields,746,572,1318
13957,2023-02-03,COLT,brawlBall,Pinhole Punt,42,34,76
13958,2023-02-03,COLT,bounty,Dry Season,217,122,339
13959,2023-02-02,COLT,knockout,Out in the Open,79,61,140
13960,2023-02-02,COLT,hotZone,Split,31,18,49
13961,2023-02-02,COLT,heist,Kaboom Canyon,98,123,221
13962,2023-02-02,COLT,gemGrab,Undermine,30,23,53
13963,2023-02-02,COLT,gemGrab,Gem Fort,7,3,10
13964,2023-02-02,COLT,brawlBall,Sunny Soccer,10,6,16
13965,2023-02-02,COLT,brawlBall,Pinhole Punt,333,300,633
13966,2023-02-02,COLT,bounty,Shooting Star,40,32,72
13967,2023-02-01,COLT,knockout,Goldarm Gulch,167,111,278
13968,2023-02-01,COLT,hotZone,Parallel Plays,47,23,70
13969,2023-02-01,COLT,heist,Kaboom Canyon,418,460,878
13970,2023-02-01,COLT,gemGrab,Gem Fort,99,48,147
13971,2023-02-01,COLT,gemGrab,Crystal Arcade,73,54,127
13972,2023-02-01,COLT,brawlBall,Sunny Soccer,670,524,1194
13973,2023-02-01,COLT,brawlBall,Beach Ball,34,37,71
13974,2023-02-01,COLT,bounty,Shooting Star,103,60,163
13975,2023-01-31,COLT,knockout,Goldarm Gulch,70,50,120
13976,2023-01-31,COLT,hotZone,Parallel Plays,27,12,39
13977,2023-01-31,COLT,heist,Pit Stop,104,94,198
13978,2023-01-31,COLT,gemGrab,Minecart Madness,12,14,26
13979,2023-01-31,COLT,gemGrab,Crystal Arcade,38,39,77
13980,2023-01-31,COLT,brawlBall,Center Stage,12,6,18
13981,2023-01-31,COLT,brawlBall,Beach Ball,378,328,706
13982,2023-01-31,COLT,bounty,Hideout,36,38,74
13983,2023-01-30,COLT,knockout,Belle's Rock,209,136,345
13984,2023-01-30,COLT,hotZone,Quarter Pounder,74,39,113
13985,2023-01-30,COLT,heist,Pit Stop,385,333,718
13986,2023-01-30,COLT,gemGrab,Minecart Madness,114,94,208
13987,2023-01-30,COLT,gemGrab,Double Swoosh,50,39,89
13988,2023-01-30,COLT,brawlBall,Center Stage,575,528,1103
13989,2023-01-30,COLT,brawlBall,Backyard Bowl,178,122,300
13990,2023-01-30,COLT,bounty,Hideout,108,67,175
13991,2023-01-29,COLT,knockout,Belle's Rock,210,146,356
13992,2023-01-29,COLT,hotZone,Quarter Pounder,49,36,85
13993,2023-01-29,COLT,heist,Bridge Too Far,987,983,1970
13994,2023-01-29,COLT,gemGrab,Hard Rock Mine,13,3,16
13995,2023-01-29,COLT,gemGrab,Double Swoosh,86,69,155
13996,2023-01-29,COLT,brawlBall,Super Beach,17,16,33
13997,2023-01-29,COLT,brawlBall,Backyard Bowl,1643,1431,3074
13998,2023-01-29,COLT,bounty,Canal Grande,17,15,32
13999,2023-01-28,COLT,knockout,Flaring Phoenix,80,77,157
14000,2023-01-28,COLT,hotZone,Controller Chaos,35,24,59
14001,2023-01-28,COLT,heist,Bridge Too Far,2064,2165,4229
14002,2023-01-28,COLT,gemGrab,Hard Rock Mine,83,45,128
14003,2023-01-28,COLT,gemGrab,Deep Diner,58,32,90
14004,2023-01-28,COLT,brawlBall,Super Beach,880,827,1707
14005,2023-01-28,COLT,brawlBall,Sneaky Fields,24,22,46
14006,2023-01-28,COLT,bounty,Canal Grande,52,24,76
14007,2023-01-27,COLT,knockout,Flaring Phoenix,40,27,67
14008,2023-01-27,COLT,hotZone,Controller Chaos,5,4,9
14009,2023-01-27,COLT,heist,Hot Potato,112,117,229
14010,2023-01-27,COLT,gemGrab,Undermine,9,2,11
14011,2023-01-27,COLT,gemGrab,Deep Diner,68,37,105
14012,2023-01-27,COLT,brawlBall,Sneaky Fields,225,208,433
14013,2023-01-27,COLT,brawlBall,Pinhole Punt,13,11,24
14014,2023-01-27,COLT,bounty,Temple Ruins,19,9,28
14015,2023-01-26,COLT,knockout,Riverside,289,234,523
14016,2023-01-26,COLT,hotZone,Open Zone,70,52,122
14017,2023-01-26,COLT,heist,Hot Potato,681,679,1360
14018,2023-01-26,COLT,gemGrab,Undermine,67,40,107
14019,2023-01-26,COLT,gemGrab,Gem Fort,45,42,87
14020,2023-01-26,COLT,brawlBall,Sunny Soccer,46,39,85
14021,2023-01-26,COLT,brawlBall,Pinhole Punt,1003,766,1769
14022,2023-01-26,COLT,bounty,Temple Ruins,49,37,86
14023,2023-01-25,COLT,knockout,Riverside,132,92,224
14024,2023-01-25,COLT,hotZone,Open Zone,37,15,52
14025,2023-01-25,COLT,heist,Safe Zone,547,632,1179
14026,2023-01-25,COLT,gemGrab,Gem Fort,43,38,81
14027,2023-01-25,COLT,gemGrab,Crystal Arcade,75,34,109
14028,2023-01-25,COLT,brawlBall,Sunny Soccer,482,414,896
14029,2023-01-25,COLT,brawlBall,Beach Ball,57,56,113
14030,2023-01-25,COLT,bounty,Excel,39,13,52
14031,2023-01-24,COLT,knockout,New Perspective,101,61,162
14032,2023-01-24,COLT,hotZone,Dueling Beetles,51,55,106
14033,2023-01-24,COLT,heist,Safe Zone,1177,1237,2414
14034,2023-01-24,COLT,gemGrab,Minecart Madness,32,44,76
14035,2023-01-24,COLT,gemGrab,Crystal Arcade,97,69,166
14036,2023-01-24,COLT,brawlBall,Center Stage,109,75,184
14037,2023-01-24,COLT,brawlBall,Beach Ball,862,794,1656
14038,2023-01-24,COLT,bounty,Excel,74,43,117
14039,2023-01-23,COLT,knockout,New Perspective,160,104,264
14040,2023-01-23,COLT,hotZone,Dueling Beetles,68,70,138
14041,2023-01-23,COLT,heist,Snaked Assault,948,1158,2106
14042,2023-01-23,COLT,gemGrab,Minecart Madness,175,115,290
14043,2023-01-23,COLT,gemGrab,Double Swoosh,47,53,100
14044,2023-01-23,COLT,brawlBall,Center Stage,1121,940,2061
14045,2023-01-23,COLT,brawlBall,Backyard Bowl,91,84,175
14046,2023-01-23,COLT,bounty,Layer Cake,56,38,94
14047,2023-01-22,COLT,knockout,X Marks the Spot,87,84,171
14048,2023-01-22,COLT,hotZone,Ring of Fire,27,11,38
14049,2023-01-22,COLT,heist,Snaked Assault,545,588,1133
14050,2023-01-22,COLT,gemGrab,Hard Rock Mine,32,15,47
14051,2023-01-22,COLT,gemGrab,Double Swoosh,30,29,59
14052,2023-01-22,COLT,brawlBall,Super Beach,82,65,147
14053,2023-01-22,COLT,brawlBall,Backyard Bowl,938,794,1732
14054,2023-01-22,COLT,bounty,Layer Cake,28,18,46
14055,2023-01-21,COLT,knockout,X Marks the Spot,316,246,562
14056,2023-01-21,COLT,hotZone,Ring of Fire,73,26,99
14057,2023-01-21,COLT,heist,Tornado Ring,545,558,1103
14058,2023-01-21,COLT,gemGrab,Hard Rock Mine,133,71,204
14059,2023-01-21,COLT,gemGrab,Deep Diner,40,35,75
14060,2023-01-21,COLT,brawlBall,Super Beach,1122,990,2112
14061,2023-01-21,COLT,brawlBall,Sneaky Fields,22,24,46
14062,2023-01-21,COLT,bounty,Dry Season,150,79,229
14063,2023-01-20,COLT,knockout,Out in the Open,214,160,374
14064,2023-01-20,COLT,hotZone,Split,31,26,57
14065,2023-01-20,COLT,heist,Tornado Ring,656,654,1310
14066,2023-01-20,COLT,gemGrab,Undermine,45,22,67
14067,2023-01-20,COLT,gemGrab,Deep Diner,163,129,292
14068,2023-01-20,COLT,brawlBall,Sneaky Fields,615,463,1078
14069,2023-01-20,COLT,brawlBall,Pinhole Punt,42,24,66
14070,2023-01-20,COLT,bounty,Dry Season,109,71,180
14071,2023-01-19,COLT,knockout,Out in the Open,233,216,449
14072,2023-01-19,COLT,hotZone,Split,63,38,101
14073,2023-01-19,COLT,heist,Kaboom Canyon,370,390,760
14074,2023-01-19,COLT,gemGrab,Undermine,80,64,144
14075,2023-01-19,COLT,gemGrab,Gem Fort,34,25,59
14076,2023-01-19,COLT,brawlBall,Sunny Soccer,31,22,53
14077,2023-01-19,COLT,brawlBall,Pinhole Punt,1109,1011,2120
14078,2023-01-19,COLT,bounty,Shooting Star,162,88,250
14079,2023-01-18,COLT,knockout,Goldarm Gulch,33,24,57
14080,2023-01-18,COLT,hotZone,Parallel Plays,4,4,8
14081,2023-01-18,COLT,heist,Kaboom Canyon,182,157,339
14082,2023-01-18,COLT,gemGrab,Gem Fort,30,23,53
14083,2023-01-18,COLT,gemGrab,Crystal Arcade,10,6,16
14084,2023-01-18,COLT,brawlBall,Sunny Soccer,204,229,433
14085,2023-01-18,COLT,brawlBall,Beach Ball,12,12,24
14086,2023-01-18,COLT,bounty,Shooting Star,74,48,122
14087,2023-01-17,COLT,knockout,Goldarm Gulch,19,15,34
14088,2023-01-17,COLT,hotZone,Parallel Plays,6,0,6
14089,2023-01-17,COLT,heist,Pit Stop,45,54,99
14090,2023-01-17,COLT,gemGrab,Minecart Madness,1,2,3
14091,2023-01-17,COLT,gemGrab,Crystal Arcade,8,3,11
14092,2023-01-17,COLT,brawlBall,Center Stage,3,1,4
14093,2023-01-17,COLT,brawlBall,Beach Ball,70,56,126
14094,2023-01-17,COLT,bounty,Hideout,11,11,22
14095,2023-01-16,COLT,knockout,Belle's Rock,10,11,21
14096,2023-01-16,COLT,hotZone,Quarter Pounder,11,1,12
14097,2023-01-16,COLT,heist,Pit Stop,106,93,199
14098,2023-01-16,COLT,gemGrab,Minecart Madness,6,4,10
14099,2023-01-16,COLT,gemGrab,Double Swoosh,2,1,3
14100,2023-01-16,COLT,brawlBall,Center Stage,40,28,68
14101,2023-01-16,COLT,brawlBall,Backyard Bowl,25,11,36
14102,2023-01-16,COLT,bounty,Hideout,16,11,27
14103,2023-01-15,COLT,knockout,Belle's Rock,21,11,32
14104,2023-01-15,COLT,hotZone,Quarter Pounder,10,0,10
14105,2023-01-15,COLT,heist,Bridge Too Far,227,220,447
14106,2023-01-15,COLT,gemGrab,Hard Rock Mine,3,1,4
14107,2023-01-15,COLT,gemGrab,Double Swoosh,6,2,8
14108,2023-01-15,COLT,brawlBall,Super Beach,21,14,35
14109,2023-01-15,COLT,brawlBall,Backyard Bowl,211,133,344
14110,2023-01-15,COLT,bounty,Canal Grande,3,0,3
14111,2023-01-14,COLT,knockout,Flaring Phoenix,10,1,11
14112,2023-01-14,COLT,hotZone,Controller Chaos,6,22,28
14113,2023-01-14,COLT,heist,Bridge Too Far,324,255,579
14114,2023-01-14,COLT,gemGrab,Hard Rock Mine,4,1,5
14115,2023-01-14,COLT,gemGrab,Deep Diner,7,8,15
14116,2023-01-14,COLT,brawlBall,Super Beach,51,36,87
14117,2023-01-14,COLT,brawlBall,Sneaky Fields,9,13,22
14118,2023-01-14,COLT,bounty,Canal Grande,3,1,4
14119,2023-01-13,COLT,knockout,Flaring Phoenix,4,1,5
14120,2023-01-13,COLT,hotZone,Controller Chaos,8,8,16
14121,2023-01-13,COLT,heist,Hot Potato,28,27,55
14122,2023-01-13,COLT,gemGrab,Deep Diner,12,13,25
14123,2023-01-13,COLT,brawlBall,Sneaky Fields,41,54,95
14124,2023-01-13,COLT,brawlBall,Pinhole Punt,3,4,7
14125,2023-01-13,COLT,bounty,Temple Ruins,3,0,3
14126,2023-01-12,COLT,knockout,Riverside,41,11,52
14127,2023-01-12,COLT,hotZone,Open Zone,9,5,14
14128,2023-01-12,COLT,heist,Hot Potato,14,10,24
14129,2023-01-12,COLT,gemGrab,Undermine,3,2,5
14130,2023-01-12,COLT,brawlBall,Sunny Soccer,1,2,3
14131,2023-01-12,COLT,brawlBall,Pinhole Punt,21,15,36
14132,2023-01-11,COLT,knockout,Riverside,4,2,6
14133,2023-01-11,COLT,hotZone,Open Zone,2,1,3
14134,2023-01-11,COLT,heist,Safe Zone,2,3,5
14135,2023-01-11,COLT,gemGrab,Gem Fort,1,0,1
14136,2023-01-11,COLT,brawlBall,Sunny Soccer,15,11,26
14137,2023-01-11,COLT,bounty,Excel,2,5,7
14138,2023-01-10,COLT,knockout,New Perspective,4,2,6
14139,2023-01-10,COLT,hotZone,Dueling Beetles,6,19,25
14140,2023-01-10,COLT,heist,Safe Zone,87,124,211
14141,2023-01-10,COLT,gemGrab,Minecart Madness,5,4,9
14142,2023-01-10,COLT,gemGrab,Crystal Arcade,5,13,18
14143,2023-01-10,COLT,brawlBall,Center Stage,5,3,8
14144,2023-01-10,COLT,brawlBall,Beach Ball,48,21,69
14145,2023-01-10,COLT,bounty,Excel,1,1,2
14146,2023-01-09,COLT,knockout,New Perspective,4,1,5
14147,2023-01-09,COLT,hotZone,Dueling Beetles,6,2,8
14148,2023-01-09,COLT,heist,Snaked Assault,101,105,206
14149,2023-01-09,COLT,gemGrab,Minecart Madness,12,8,20
14150,2023-01-09,COLT,gemGrab,Double Swoosh,3,0,3
14151,2023-01-09,COLT,brawlBall,Center Stage,46,23,69
14152,2023-01-09,COLT,brawlBall,Backyard Bowl,18,8,26
14153,2023-01-09,COLT,bounty,Layer Cake,13,3,16
14154,2023-01-08,COLT,knockout,X Marks the Spot,11,11,22
14155,2023-01-08,COLT,hotZone,Ring of Fire,4,6,10
14156,2023-01-08,COLT,heist,Snaked Assault,96,111,207
14157,2023-01-08,COLT,gemGrab,Hard Rock Mine,1,3,4
14158,2023-01-08,COLT,gemGrab,Double Swoosh,3,0,3
14159,2023-01-08,COLT,brawlBall,Super Beach,8,4,12
14160,2023-01-08,COLT,brawlBall,Backyard Bowl,132,146,278
14161,2023-01-08,COLT,bounty,Layer Cake,1,0,1
14162,2023-01-07,COLT,knockout,X Marks the Spot,6,3,9
14163,2023-01-07,COLT,hotZone,Ring of Fire,2,0,2
14164,2023-01-07,COLT,heist,Tornado Ring,48,24,72
14165,2023-01-07,COLT,gemGrab,Hard Rock Mine,3,0,3
14166,2023-01-07,COLT,gemGrab,Deep Diner,7,3,10
14167,2023-01-07,COLT,brawlBall,Super Beach,19,24,43
14168,2023-01-07,COLT,brawlBall,Sneaky Fields,2,1,3
14169,2023-01-07,COLT,bounty,Dry Season,13,2,15
14170,2023-01-06,COLT,knockout,Out in the Open,16,5,21
14171,2023-01-06,COLT,hotZone,Split,6,32,38
14172,2023-01-06,COLT,heist,Tornado Ring,148,117,265
14173,2023-01-06,COLT,gemGrab,Undermine,5,2,7
14174,2023-01-06,COLT,gemGrab,Deep Diner,12,5,17
14175,2023-01-06,COLT,brawlBall,Sneaky Fields,28,7,35
14176,2023-01-06,COLT,brawlBall,Pinhole Punt,8,6,14
14177,2023-01-06,COLT,bounty,Dry Season,12,6,18
14178,2023-01-05,COLT,knockout,Out in the Open,22,20,42
14179,2023-01-05,COLT,hotZone,Split,15,33,48
14180,2023-01-05,COLT,heist,Kaboom Canyon,48,53,101
14181,2023-01-05,COLT,gemGrab,Undermine,6,1,7
14182,2023-01-05,COLT,gemGrab,Gem Fort,0,2,2
14183,2023-01-05,COLT,brawlBall,Sunny Soccer,1,0,1
14184,2023-01-05,COLT,brawlBall,Pinhole Punt,72,59,131
14185,2023-01-05,COLT,bounty,Shooting Star,9,4,13
14186,2023-01-04,COLT,knockout,Goldarm Gulch,1,0,1
14187,2023-01-04,COLT,hotZone,Parallel Plays,3,0,3
14188,2023-01-04,COLT,heist,Kaboom Canyon,101,67,168
14189,2023-01-04,COLT,gemGrab,Gem Fort,6,6,12
14190,2023-01-04,COLT,gemGrab,Crystal Arcade,6,0,6
14191,2023-01-04,COLT,brawlBall,Sunny Soccer,44,17,61
14192,2023-01-04,COLT,brawlBall,Beach Ball,3,0,3
14193,2023-01-04,COLT,bounty,Shooting Star,32,9,41
14194,2023-01-03,COLT,knockout,Goldarm Gulch,2,2,4
14195,2023-01-03,COLT,heist,Pit Stop,39,55,94
14196,2023-01-03,COLT,heist,Kaboom Canyon,1,2,3
14197,2023-01-03,COLT,gemGrab,Minecart Madness,2,0,2
14198,2023-01-03,COLT,gemGrab,Crystal Arcade,15,1,16
14199,2023-01-03,COLT,brawlBall,Center Stage,4,2,6
14200,2023-01-03,COLT,brawlBall,Beach Ball,78,86,164
14201,2023-01-03,COLT,bounty,Hideout,22,1,23
14202,2023-01-02,COLT,knockout,Belle's Rock,16,15,31
14203,2023-01-02,COLT,hotZone,Quarter Pounder,12,4,16
14204,2023-01-02,COLT,hotZone,Controller Chaos,2,0,2
14205,2023-01-02,COLT,heist,Pit Stop,124,126,250
14206,2023-01-02,COLT,heist,Kaboom Canyon,1,3,4
14207,2023-01-02,COLT,gemGrab,Minecart Madness,16,3,19
14208,2023-01-02,COLT,gemGrab,Double Swoosh,4,1,5
14209,2023-01-02,COLT,brawlBall,Center Stage,62,49,111
14210,2023-01-02,COLT,brawlBall,Backyard Bowl,8,7,15
14211,2023-01-02,COLT,bounty,Hideout,32,12,44
14212,2023-01-01,COLT,knockout,Belle's Rock,7,1,8
14213,2023-01-01,COLT,hotZone,Quarter Pounder,2,2,4
14214,2023-01-01,COLT,heist,Kaboom Canyon,0,2,2
14215,2023-01-01,COLT,heist,Bridge Too Far,35,36,71
14216,2023-01-01,COLT,gemGrab,Double Swoosh,1,2,3
14217,2023-01-01,COLT,brawlBall,Backyard Bowl,46,30,76
14218,2022-12-31,COLT,heist,Kaboom Canyon,1,1,2
14219,2022-12-31,COLT,heist,Bridge Too Far,24,18,42
14220,2022-12-31,COLT,gemGrab,Minecart Madness,0,2,2
14221,2022-12-31,COLT,gemGrab,Deep Diner,4,10,14
14222,2022-12-31,COLT,brawlBall,Super Beach,3,5,8
14223,2022-12-30,COLT,heist,Kaboom Canyon,1,0,1
14224,2022-12-30,COLT,heist,Hot Potato,0,2,2
14225,2022-12-30,COLT,gemGrab,Undermine,1,0,1
14226,2022-12-30,COLT,gemGrab,Minecart Madness,1,0,1
14227,2022-12-30,COLT,gemGrab,Deep Diner,2,0,2
14228,2022-12-30,COLT,brawlBall,Sneaky Fields,6,2,8
14229,2022-12-29,COLT,heist,Kaboom Canyon,3,1,4
14230,2022-12-29,COLT,heist,Hot Potato,4,1,5
14231,2022-12-29,COLT,brawlBall,Pinhole Punt,5,0,5
14232,2022-12-28,COLT,brawlBall,Sunny Soccer,0,1,1
14233,2022-12-27,COLT,knockout,New Perspective,0,1,1
14234,2022-12-27,COLT,heist,Safe Zone,0,1,1
14235,2022-12-27,COLT,heist,Kaboom Canyon,1,1,2
14236,2022-12-27,COLT,gemGrab,Minecart Madness,1,0,1
14237,2022-12-27,COLT,brawlBall,Beach Ball,2,0,2
14238,2022-12-26,COLT,heist,Kaboom Canyon,1,3,4
14239,2022-12-26,COLT,brawlBall,Center Stage,1,0,1
14240,2022-12-25,COLT,brawlBall,Backyard Bowl,4,8,12
14241,2022-12-24,COLT,knockout,X Marks the Spot,1,0,1
14242,2022-12-24,COLT,brawlBall,Super Beach,0,1,1
14243,2022-12-23,COLT,knockout,Out in the Open,1,0,1
14244,2022-12-23,COLT,brawlBall,Sneaky Fields,0,1,1
14245,2022-12-22,COLT,heist,Kaboom Canyon,1,0,1
14246,2022-12-22,COLT,brawlBall,Pinhole Punt,2,0,2
14247,2022-12-19,COLT,brawlBall,Center Stage,1,0,1
14248,2022-12-18,COLT,heist,Bridge Too Far,0,1,1
14249,2022-12-16,COLT,brawlBall,Sneaky Fields,2,1,3
14250,2022-12-16,COLT,bounty,Temple Ruins,1,0,1
14251,2022-12-13,COLT,heist,Safe Zone,4,3,7
14252,2022-12-13,COLT,gemGrab,Crystal Arcade,1,1,2
14253,2022-11-11,COLT,knockout,New Perspective,1,0,1
14254,2022-11-03,COLT,brawlBall,Pinhole Punt,1,1,2
14255,2022-11-03,COLT,bounty,Temple Ruins,1,0,1
14256,2022-11-01,COLT,knockout,New Perspective,2,2,4
14257,2022-10-30,COLT,heist,Safe Zone,0,1,1
14258,2022-10-28,COLT,brawlBall,Beach Ball,1,0,1
14259,2022-10-15,COLT,gemGrab,Hard Rock Mine,1,1,2
14260,2023-02-05,COLETTE,knockout,X Marks the Spot,21,9,30
14261,2023-02-05,COLETTE,knockout,Goldarm Gulch,0,1,1
14262,2023-02-05,COLETTE,hotZone,Ring of Fire,33,15,48
14263,2023-02-05,COLETTE,heist,Snaked Assault,262,379,641
14264,2023-02-05,COLETTE,heist,Pit Stop,12,6,18
14265,2023-02-05,COLETTE,gemGrab,Hard Rock Mine,10,8,18
14266,2023-02-05,COLETTE,gemGrab,Double Swoosh,56,43,99
14267,2023-02-05,COLETTE,brawlBall,Super Beach,9,5,14
14268,2023-02-05,COLETTE,brawlBall,Sneaky Fields,10,3,13
14269,2023-02-05,COLETTE,brawlBall,Backyard Bowl,359,346,705
14270,2023-02-05,COLETTE,bounty,Layer Cake,9,12,21
14271,2023-02-04,COLETTE,knockout,X Marks the Spot,6,3,9
14272,2023-02-04,COLETTE,knockout,Goldarm Gulch,1,2,3
14273,2023-02-04,COLETTE,hotZone,Ring of Fire,8,9,17
14274,2023-02-04,COLETTE,heist,Tornado Ring,12,18,30
14275,2023-02-04,COLETTE,heist,Pit Stop,11,6,17
14276,2023-02-04,COLETTE,gemGrab,Hard Rock Mine,18,21,39
14277,2023-02-04,COLETTE,gemGrab,Double Swoosh,6,2,8
14278,2023-02-04,COLETTE,gemGrab,Deep Diner,6,2,8
14279,2023-02-04,COLETTE,brawlBall,Super Beach,75,75,150
14280,2023-02-04,COLETTE,brawlBall,Sneaky Fields,11,11,22
14281,2023-02-03,COLETTE,knockout,Out in the Open,48,29,77
14282,2023-02-03,COLETTE,knockout,Goldarm Gulch,15,19,34
14283,2023-02-03,COLETTE,hotZone,Split,7,7,14
14284,2023-02-03,COLETTE,heist,Tornado Ring,192,207,399
14285,2023-02-03,COLETTE,heist,Pit Stop,68,54,122
14286,2023-02-03,COLETTE,gemGrab,Undermine,7,12,19
14287,2023-02-03,COLETTE,gemGrab,Double Swoosh,40,21,61
14288,2023-02-03,COLETTE,gemGrab,Deep Diner,45,29,74
14289,2023-02-03,COLETTE,brawlBall,Sneaky Fields,331,368,699
14290,2023-02-03,COLETTE,brawlBall,Pinhole Punt,6,12,18
14291,2023-02-03,COLETTE,bounty,Dry Season,19,8,27
14292,2023-02-02,COLETTE,knockout,Out in the Open,18,11,29
14293,2023-02-02,COLETTE,hotZone,Split,8,5,13
14294,2023-02-02,COLETTE,heist,Kaboom Canyon,65,107,172
14295,2023-02-02,COLETTE,gemGrab,Undermine,16,11,27
14296,2023-02-02,COLETTE,gemGrab,Gem Fort,3,1,4
14297,2023-02-02,COLETTE,brawlBall,Sunny Soccer,10,10,20
14298,2023-02-02,COLETTE,brawlBall,Pinhole Punt,121,135,256
14299,2023-02-02,COLETTE,bounty,Shooting Star,3,1,4
14300,2023-02-01,COLETTE,knockout,Goldarm Gulch,52,23,75
14301,2023-02-01,COLETTE,hotZone,Parallel Plays,38,33,71
14302,2023-02-01,COLETTE,heist,Kaboom Canyon,293,386,679
14303,2023-02-01,COLETTE,gemGrab,Gem Fort,53,42,95
14304,2023-02-01,COLETTE,gemGrab,Crystal Arcade,20,6,26
14305,2023-02-01,COLETTE,brawlBall,Sunny Soccer,238,262,500
14306,2023-02-01,COLETTE,brawlBall,Beach Ball,11,8,19
14307,2023-02-01,COLETTE,bounty,Shooting Star,4,0,4
14308,2023-01-31,COLETTE,knockout,Goldarm Gulch,25,7,32
14309,2023-01-31,COLETTE,hotZone,Parallel Plays,26,22,48
14310,2023-01-31,COLETTE,heist,Pit Stop,16,23,39
14311,2023-01-31,COLETTE,gemGrab,Minecart Madness,2,2,4
14312,2023-01-31,COLETTE,gemGrab,Crystal Arcade,15,12,27
14313,2023-01-31,COLETTE,brawlBall,Center Stage,6,6,12
14314,2023-01-31,COLETTE,brawlBall,Beach Ball,145,158,303
14315,2023-01-31,COLETTE,bounty,Hideout,2,3,5
14316,2023-01-30,COLETTE,knockout,Belle's Rock,14,11,25
14317,2023-01-30,COLETTE,hotZone,Quarter Pounder,51,25,76
14318,2023-01-30,COLETTE,heist,Pit Stop,30,28,58
14319,2023-01-30,COLETTE,gemGrab,Minecart Madness,32,37,69
14320,2023-01-30,COLETTE,gemGrab,Double Swoosh,22,39,61
14321,2023-01-30,COLETTE,brawlBall,Center Stage,265,318,583
14322,2023-01-30,COLETTE,brawlBall,Backyard Bowl,48,38,86
14323,2023-01-30,COLETTE,bounty,Hideout,4,3,7
14324,2023-01-29,COLETTE,knockout,Belle's Rock,24,13,37
14325,2023-01-29,COLETTE,hotZone,Quarter Pounder,39,58,97
14326,2023-01-29,COLETTE,heist,Bridge Too Far,323,417,740
14327,2023-01-29,COLETTE,gemGrab,Hard Rock Mine,10,4,14
14328,2023-01-29,COLETTE,gemGrab,Double Swoosh,44,28,72
14329,2023-01-29,COLETTE,brawlBall,Super Beach,10,17,27
14330,2023-01-29,COLETTE,brawlBall,Backyard Bowl,441,482,923
14331,2023-01-29,COLETTE,bounty,Canal Grande,12,15,27
14332,2023-01-28,COLETTE,knockout,Flaring Phoenix,22,17,39
14333,2023-01-28,COLETTE,hotZone,Controller Chaos,61,67,128
14334,2023-01-28,COLETTE,heist,Bridge Too Far,770,803,1573
14335,2023-01-28,COLETTE,gemGrab,Hard Rock Mine,49,39,88
14336,2023-01-28,COLETTE,gemGrab,Deep Diner,13,14,27
14337,2023-01-28,COLETTE,brawlBall,Super Beach,298,358,656
14338,2023-01-28,COLETTE,brawlBall,Sneaky Fields,12,15,27
14339,2023-01-28,COLETTE,bounty,Canal Grande,12,7,19
14340,2023-01-27,COLETTE,knockout,Flaring Phoenix,11,6,17
14341,2023-01-27,COLETTE,hotZone,Controller Chaos,12,15,27
14342,2023-01-27,COLETTE,heist,Hot Potato,94,102,196
14343,2023-01-27,COLETTE,gemGrab,Undermine,3,5,8
14344,2023-01-27,COLETTE,gemGrab,Deep Diner,22,18,40
14345,2023-01-27,COLETTE,brawlBall,Sneaky Fields,100,86,186
14346,2023-01-27,COLETTE,brawlBall,Pinhole Punt,2,3,5
14347,2023-01-27,COLETTE,bounty,Temple Ruins,5,4,9
14348,2023-01-26,COLETTE,knockout,Riverside,34,25,59
14349,2023-01-26,COLETTE,hotZone,Open Zone,44,29,73
14350,2023-01-26,COLETTE,heist,Hot Potato,189,191,380
14351,2023-01-26,COLETTE,gemGrab,Undermine,46,53,99
14352,2023-01-26,COLETTE,gemGrab,Gem Fort,10,14,24
14353,2023-01-26,COLETTE,brawlBall,Sunny Soccer,15,10,25
14354,2023-01-26,COLETTE,brawlBall,Pinhole Punt,466,479,945
14355,2023-01-26,COLETTE,bounty,Temple Ruins,20,16,36
14356,2023-01-25,COLETTE,knockout,Riverside,22,12,34
14357,2023-01-25,COLETTE,hotZone,Open Zone,17,22,39
14358,2023-01-25,COLETTE,heist,Safe Zone,313,428,741
14359,2023-01-25,COLETTE,gemGrab,Gem Fort,14,11,25
14360,2023-01-25,COLETTE,gemGrab,Crystal Arcade,24,17,41
14361,2023-01-25,COLETTE,brawlBall,Sunny Soccer,149,204,353
14362,2023-01-25,COLETTE,brawlBall,Beach Ball,26,29,55
14363,2023-01-25,COLETTE,bounty,Excel,2,4,6
14364,2023-01-24,COLETTE,knockout,New Perspective,22,12,34
14365,2023-01-24,COLETTE,hotZone,Dueling Beetles,39,35,74
14366,2023-01-24,COLETTE,heist,Safe Zone,540,714,1254
14367,2023-01-24,COLETTE,gemGrab,Minecart Madness,11,5,16
14368,2023-01-24,COLETTE,gemGrab,Crystal Arcade,45,42,87
14369,2023-01-24,COLETTE,brawlBall,Center Stage,45,53,98
14370,2023-01-24,COLETTE,brawlBall,Beach Ball,280,319,599
14371,2023-01-24,COLETTE,bounty,Excel,8,11,19
14372,2023-01-23,COLETTE,knockout,New Perspective,48,34,82
14373,2023-01-23,COLETTE,hotZone,Dueling Beetles,27,35,62
14374,2023-01-23,COLETTE,heist,Snaked Assault,383,481,864
14375,2023-01-23,COLETTE,gemGrab,Minecart Madness,75,114,189
14376,2023-01-23,COLETTE,gemGrab,Double Swoosh,21,34,55
14377,2023-01-23,COLETTE,brawlBall,Center Stage,422,453,875
14378,2023-01-23,COLETTE,brawlBall,Backyard Bowl,21,36,57
14379,2023-01-23,COLETTE,bounty,Layer Cake,8,2,10
14380,2023-01-22,COLETTE,knockout,X Marks the Spot,13,21,34
14381,2023-01-22,COLETTE,hotZone,Ring of Fire,16,24,40
14382,2023-01-22,COLETTE,heist,Snaked Assault,139,187,326
14383,2023-01-22,COLETTE,gemGrab,Hard Rock Mine,20,13,33
14384,2023-01-22,COLETTE,gemGrab,Double Swoosh,23,16,39
14385,2023-01-22,COLETTE,brawlBall,Super Beach,17,19,36
14386,2023-01-22,COLETTE,brawlBall,Backyard Bowl,260,269,529
14387,2023-01-22,COLETTE,bounty,Layer Cake,3,6,9
14388,2023-01-21,COLETTE,knockout,X Marks the Spot,45,35,80
14389,2023-01-21,COLETTE,hotZone,Ring of Fire,50,80,130
14390,2023-01-21,COLETTE,heist,Tornado Ring,110,119,229
14391,2023-01-21,COLETTE,gemGrab,Hard Rock Mine,44,43,87
14392,2023-01-21,COLETTE,gemGrab,Deep Diner,10,8,18
14393,2023-01-21,COLETTE,brawlBall,Super Beach,377,347,724
14394,2023-01-21,COLETTE,brawlBall,Sneaky Fields,10,12,22
14395,2023-01-21,COLETTE,bounty,Dry Season,25,27,52
14396,2023-01-20,COLETTE,knockout,Out in the Open,49,43,92
14397,2023-01-20,COLETTE,hotZone,Split,9,12,21
14398,2023-01-20,COLETTE,heist,Tornado Ring,138,160,298
14399,2023-01-20,COLETTE,gemGrab,Undermine,18,15,33
14400,2023-01-20,COLETTE,gemGrab,Deep Diner,35,29,64
14401,2023-01-20,COLETTE,brawlBall,Sneaky Fields,260,334,594
14402,2023-01-20,COLETTE,brawlBall,Pinhole Punt,19,27,46
14403,2023-01-20,COLETTE,bounty,Dry Season,20,14,34
14404,2023-01-19,COLETTE,knockout,Out in the Open,72,48,120
14405,2023-01-19,COLETTE,hotZone,Split,25,19,44
14406,2023-01-19,COLETTE,heist,Kaboom Canyon,245,367,612
14407,2023-01-19,COLETTE,gemGrab,Undermine,42,53,95
14408,2023-01-19,COLETTE,gemGrab,Gem Fort,4,7,11
14409,2023-01-19,COLETTE,brawlBall,Sunny Soccer,9,10,19
14410,2023-01-19,COLETTE,brawlBall,Pinhole Punt,445,467,912
14411,2023-01-19,COLETTE,bounty,Shooting Star,24,8,32
14412,2023-01-18,COLETTE,knockout,Goldarm Gulch,6,9,15
14413,2023-01-18,COLETTE,hotZone,Parallel Plays,3,0,3
14414,2023-01-18,COLETTE,heist,Kaboom Canyon,130,181,311
14415,2023-01-18,COLETTE,gemGrab,Gem Fort,9,9,18
14416,2023-01-18,COLETTE,gemGrab,Crystal Arcade,4,4,8
14417,2023-01-18,COLETTE,brawlBall,Sunny Soccer,89,118,207
14418,2023-01-18,COLETTE,brawlBall,Beach Ball,2,5,7
14419,2023-01-18,COLETTE,bounty,Shooting Star,2,8,10
14420,2023-01-17,COLETTE,knockout,Goldarm Gulch,8,6,14
14421,2023-01-17,COLETTE,hotZone,Parallel Plays,3,4,7
14422,2023-01-17,COLETTE,heist,Pit Stop,7,2,9
14423,2023-01-17,COLETTE,gemGrab,Minecart Madness,1,0,1
14424,2023-01-17,COLETTE,gemGrab,Crystal Arcade,3,4,7
14425,2023-01-17,COLETTE,brawlBall,Center Stage,3,5,8
14426,2023-01-17,COLETTE,brawlBall,Beach Ball,24,27,51
14427,2023-01-17,COLETTE,bounty,Hideout,1,1,2
14428,2023-01-16,COLETTE,knockout,Belle's Rock,2,1,3
14429,2023-01-16,COLETTE,hotZone,Quarter Pounder,5,0,5
14430,2023-01-16,COLETTE,heist,Pit Stop,7,5,12
14431,2023-01-16,COLETTE,gemGrab,Minecart Madness,3,1,4
14432,2023-01-16,COLETTE,brawlBall,Center Stage,37,60,97
14433,2023-01-16,COLETTE,brawlBall,Backyard Bowl,8,4,12
14434,2023-01-16,COLETTE,bounty,Hideout,5,3,8
14435,2023-01-15,COLETTE,knockout,Belle's Rock,4,8,12
14436,2023-01-15,COLETTE,hotZone,Quarter Pounder,5,5,10
14437,2023-01-15,COLETTE,heist,Bridge Too Far,68,103,171
14438,2023-01-15,COLETTE,gemGrab,Hard Rock Mine,1,0,1
14439,2023-01-15,COLETTE,gemGrab,Double Swoosh,6,4,10
14440,2023-01-15,COLETTE,brawlBall,Super Beach,2,0,2
14441,2023-01-15,COLETTE,brawlBall,Backyard Bowl,48,40,88
14442,2023-01-15,COLETTE,bounty,Canal Grande,2,11,13
14443,2023-01-14,COLETTE,knockout,Flaring Phoenix,4,1,5
14444,2023-01-14,COLETTE,hotZone,Controller Chaos,6,5,11
14445,2023-01-14,COLETTE,heist,Bridge Too Far,145,196,341
14446,2023-01-14,COLETTE,gemGrab,Hard Rock Mine,2,2,4
14447,2023-01-14,COLETTE,brawlBall,Super Beach,19,16,35
14448,2023-01-14,COLETTE,brawlBall,Sneaky Fields,3,3,6
14449,2023-01-14,COLETTE,bounty,Canal Grande,1,2,3
14450,2023-01-13,COLETTE,knockout,Flaring Phoenix,3,5,8
14451,2023-01-13,COLETTE,hotZone,Controller Chaos,9,4,13
14452,2023-01-13,COLETTE,heist,Hot Potato,12,9,21
14453,2023-01-13,COLETTE,gemGrab,Deep Diner,3,1,4
14454,2023-01-13,COLETTE,brawlBall,Sneaky Fields,13,11,24
14455,2023-01-13,COLETTE,brawlBall,Pinhole Punt,3,0,3
14456,2023-01-13,COLETTE,bounty,Temple Ruins,0,1,1
14457,2023-01-12,COLETTE,knockout,Riverside,1,1,2
14458,2023-01-12,COLETTE,hotZone,Open Zone,2,0,2
14459,2023-01-12,COLETTE,heist,Hot Potato,2,2,4
14460,2023-01-12,COLETTE,gemGrab,Undermine,1,1,2
14461,2023-01-12,COLETTE,gemGrab,Gem Fort,1,0,1
14462,2023-01-12,COLETTE,brawlBall,Pinhole Punt,8,14,22
14463,2023-01-11,COLETTE,hotZone,Open Zone,1,5,6
14464,2023-01-11,COLETTE,heist,Safe Zone,0,2,2
14465,2023-01-11,COLETTE,gemGrab,Gem Fort,1,0,1
14466,2023-01-11,COLETTE,brawlBall,Sunny Soccer,4,0,4
14467,2023-01-10,COLETTE,hotZone,Dueling Beetles,6,5,11
14468,2023-01-10,COLETTE,heist,Safe Zone,41,34,75
14469,2023-01-10,COLETTE,gemGrab,Crystal Arcade,2,0,2
14470,2023-01-10,COLETTE,brawlBall,Center Stage,4,3,7
14471,2023-01-10,COLETTE,brawlBall,Beach Ball,15,4,19
14472,2023-01-09,COLETTE,hotZone,Dueling Beetles,6,21,27
14473,2023-01-09,COLETTE,heist,Snaked Assault,50,52,102
14474,2023-01-09,COLETTE,gemGrab,Minecart Madness,4,6,10
14475,2023-01-09,COLETTE,gemGrab,Double Swoosh,0,3,3
14476,2023-01-09,COLETTE,brawlBall,Center Stage,20,32,52
14477,2023-01-09,COLETTE,brawlBall,Backyard Bowl,1,0,1
14478,2023-01-08,COLETTE,knockout,X Marks the Spot,0,1,1
14479,2023-01-08,COLETTE,hotZone,Ring of Fire,4,17,21
14480,2023-01-08,COLETTE,heist,Snaked Assault,20,9,29
14481,2023-01-08,COLETTE,gemGrab,Hard Rock Mine,0,2,2
14482,2023-01-08,COLETTE,gemGrab,Double Swoosh,0,2,2
14483,2023-01-08,COLETTE,brawlBall,Super Beach,2,0,2
14484,2023-01-08,COLETTE,brawlBall,Backyard Bowl,28,53,81
14485,2023-01-08,COLETTE,bounty,Layer Cake,1,0,1
14486,2023-01-07,COLETTE,knockout,X Marks the Spot,0,2,2
14487,2023-01-07,COLETTE,hotZone,Ring of Fire,2,0,2
14488,2023-01-07,COLETTE,heist,Tornado Ring,19,19,38
14489,2023-01-07,COLETTE,gemGrab,Hard Rock Mine,3,5,8
14490,2023-01-07,COLETTE,gemGrab,Deep Diner,2,0,2
14491,2023-01-07,COLETTE,brawlBall,Super Beach,8,3,11
14492,2023-01-06,COLETTE,heist,Tornado Ring,17,45,62
14493,2023-01-06,COLETTE,gemGrab,Deep Diner,2,2,4
14494,2023-01-06,COLETTE,brawlBall,Sneaky Fields,7,6,13
14495,2023-01-06,COLETTE,brawlBall,Pinhole Punt,2,0,2
14496,2023-01-05,COLETTE,knockout,Out in the Open,2,5,7
14497,2023-01-05,COLETTE,hotZone,Split,11,21,32
14498,2023-01-05,COLETTE,heist,Kaboom Canyon,43,60,103
14499,2023-01-05,COLETTE,gemGrab,Undermine,3,0,3
14500,2023-01-05,COLETTE,brawlBall,Pinhole Punt,19,26,45
14501,2023-01-04,COLETTE,hotZone,Parallel Plays,2,4,6
14502,2023-01-04,COLETTE,heist,Kaboom Canyon,105,178,283
14503,2023-01-04,COLETTE,gemGrab,Gem Fort,3,5,8
14504,2023-01-04,COLETTE,gemGrab,Crystal Arcade,1,0,1
14505,2023-01-04,COLETTE,brawlBall,Sunny Soccer,17,36,53
14506,2023-01-03,COLETTE,knockout,Goldarm Gulch,1,1,2
14507,2023-01-03,COLETTE,hotZone,Parallel Plays,5,7,12
14508,2023-01-03,COLETTE,heist,Pit Stop,8,3,11
14509,2023-01-03,COLETTE,gemGrab,Crystal Arcade,1,2,3
14510,2023-01-03,COLETTE,brawlBall,Center Stage,1,1,2
14511,2023-01-03,COLETTE,brawlBall,Beach Ball,15,45,60
14512,2023-01-03,COLETTE,bounty,Hideout,3,0,3
14513,2023-01-02,COLETTE,knockout,Belle's Rock,1,1,2
14514,2023-01-02,COLETTE,hotZone,Quarter Pounder,6,21,27
14515,2023-01-02,COLETTE,heist,Pit Stop,16,7,23
14516,2023-01-02,COLETTE,heist,Kaboom Canyon,0,1,1
14517,2023-01-02,COLETTE,gemGrab,Minecart Madness,5,6,11
14518,2023-01-02,COLETTE,brawlBall,Center Stage,17,11,28
14519,2023-01-02,COLETTE,brawlBall,Backyard Bowl,1,1,2
14520,2023-01-02,COLETTE,bounty,Hideout,4,1,5
14521,2023-01-01,COLETTE,knockout,Belle's Rock,0,1,1
14522,2023-01-01,COLETTE,hotZone,Quarter Pounder,2,10,12
14523,2023-01-01,COLETTE,heist,Kaboom Canyon,1,0,1
14524,2023-01-01,COLETTE,heist,Bridge Too Far,17,7,24
14525,2023-01-01,COLETTE,gemGrab,Double Swoosh,1,1,2
14526,2023-01-01,COLETTE,brawlBall,Backyard Bowl,15,2,17
14527,2022-12-31,COLETTE,heist,Kaboom Canyon,0,1,1
14528,2022-12-31,COLETTE,heist,Bridge Too Far,7,11,18
14529,2022-12-31,COLETTE,gemGrab,Deep Diner,1,0,1
14530,2022-12-31,COLETTE,brawlBall,Super Beach,3,6,9
14531,2022-12-31,COLETTE,brawlBall,Sneaky Fields,1,0,1
14532,2022-12-30,COLETTE,hotZone,Controller Chaos,2,12,14
14533,2022-12-30,COLETTE,heist,Hot Potato,1,1,2
14534,2022-12-30,COLETTE,gemGrab,Undermine,1,0,1
14535,2022-12-30,COLETTE,gemGrab,Deep Diner,1,0,1
14536,2022-12-30,COLETTE,brawlBall,Sneaky Fields,2,2,4
14537,2022-12-29,COLETTE,heist,Kaboom Canyon,0,1,1
14538,2022-12-29,COLETTE,heist,Hot Potato,1,0,1
14539,2022-12-29,COLETTE,gemGrab,Minecart Madness,1,0,1
14540,2022-12-29,COLETTE,brawlBall,Pinhole Punt,2,1,3
14541,2022-12-27,COLETTE,hotZone,Dueling Beetles,1,0,1
14542,2022-12-27,COLETTE,heist,Kaboom Canyon,0,1,1
14543,2022-12-27,COLETTE,brawlBall,Beach Ball,1,0,1
14544,2022-12-26,COLETTE,heist,Kaboom Canyon,0,2,2
14545,2022-12-25,COLETTE,brawlBall,Backyard Bowl,1,0,1
14546,2022-12-24,COLETTE,brawlBall,Super Beach,1,1,2
14547,2022-12-22,COLETTE,heist,Kaboom Canyon,0,1,1
14548,2022-12-22,COLETTE,brawlBall,Pinhole Punt,1,0,1
14549,2022-12-18,COLETTE,heist,Bridge Too Far,1,2,3
14550,2022-12-16,COLETTE,brawlBall,Sneaky Fields,1,0,1
14551,2022-12-13,COLETTE,heist,Safe Zone,0,1,1
14552,2022-10-15,COLETTE,brawlBall,Super Beach,1,0,1
14553,2023-02-05,CHESTER,knockout,X Marks the Spot,40,14,54
14554,2023-02-05,CHESTER,knockout,Goldarm Gulch,6,0,6
14555,2023-02-05,CHESTER,hotZone,Ring of Fire,41,45,86
14556,2023-02-05,CHESTER,heist,Snaked Assault,34,18,52
14557,2023-02-05,CHESTER,heist,Pit Stop,4,2,6
14558,2023-02-05,CHESTER,gemGrab,Hard Rock Mine,22,16,38
14559,2023-02-05,CHESTER,gemGrab,Double Swoosh,167,150,317
14560,2023-02-05,CHESTER,brawlBall,Super Beach,17,9,26
14561,2023-02-05,CHESTER,brawlBall,Sneaky Fields,33,22,55
14562,2023-02-05,CHESTER,brawlBall,Backyard Bowl,312,358,670
14563,2023-02-05,CHESTER,bounty,Layer Cake,23,34,57
14564,2023-02-04,CHESTER,knockout,X Marks the Spot,9,6,15
14565,2023-02-04,CHESTER,knockout,Goldarm Gulch,1,0,1
14566,2023-02-04,CHESTER,hotZone,Ring of Fire,13,21,34
14567,2023-02-04,CHESTER,heist,Tornado Ring,5,4,9
14568,2023-02-04,CHESTER,heist,Pit Stop,1,2,3
14569,2023-02-04,CHESTER,gemGrab,Hard Rock Mine,22,30,52
14570,2023-02-04,CHESTER,gemGrab,Double Swoosh,31,17,48
14571,2023-02-04,CHESTER,gemGrab,Deep Diner,4,2,6
14572,2023-02-04,CHESTER,brawlBall,Super Beach,136,108,244
14573,2023-02-04,CHESTER,brawlBall,Sneaky Fields,21,30,51
14574,2023-02-04,CHESTER,bounty,Dry Season,5,4,9
14575,2023-02-03,CHESTER,knockout,Out in the Open,61,71,132
14576,2023-02-03,CHESTER,knockout,Goldarm Gulch,12,7,19
14577,2023-02-03,CHESTER,hotZone,Split,33,55,88
14578,2023-02-03,CHESTER,heist,Tornado Ring,51,41,92
14579,2023-02-03,CHESTER,heist,Pit Stop,20,8,28
14580,2023-02-03,CHESTER,gemGrab,Undermine,37,30,67
14581,2023-02-03,CHESTER,gemGrab,Double Swoosh,168,110,278
14582,2023-02-03,CHESTER,gemGrab,Deep Diner,103,153,256
14583,2023-02-03,CHESTER,brawlBall,Sneaky Fields,669,605,1274
14584,2023-02-03,CHESTER,brawlBall,Pinhole Punt,20,13,33
14585,2023-02-03,CHESTER,bounty,Dry Season,29,24,53
14586,2023-02-02,CHESTER,knockout,Out in the Open,23,16,39
14587,2023-02-02,CHESTER,hotZone,Split,21,11,32
14588,2023-02-02,CHESTER,heist,Kaboom Canyon,8,4,12
14589,2023-02-02,CHESTER,gemGrab,Undermine,35,25,60
14590,2023-02-02,CHESTER,gemGrab,Gem Fort,5,11,16
14591,2023-02-02,CHESTER,brawlBall,Sunny Soccer,6,2,8
14592,2023-02-02,CHESTER,brawlBall,Pinhole Punt,148,200,348
14593,2023-02-02,CHESTER,bounty,Shooting Star,4,1,5
14594,2023-02-01,CHESTER,knockout,Goldarm Gulch,88,66,154
14595,2023-02-01,CHESTER,hotZone,Parallel Plays,85,70,155
14596,2023-02-01,CHESTER,heist,Kaboom Canyon,10,16,26
14597,2023-02-01,CHESTER,gemGrab,Gem Fort,116,139,255
14598,2023-02-01,CHESTER,gemGrab,Crystal Arcade,50,46,96
14599,2023-02-01,CHESTER,brawlBall,Sunny Soccer,418,437,855
14600,2023-02-01,CHESTER,brawlBall,Beach Ball,29,30,59
14601,2023-02-01,CHESTER,bounty,Shooting Star,12,1,13
14602,2023-01-31,CHESTER,knockout,Goldarm Gulch,47,24,71
14603,2023-01-31,CHESTER,hotZone,Parallel Plays,33,31,64
14604,2023-01-31,CHESTER,heist,Pit Stop,9,14,23
14605,2023-01-31,CHESTER,gemGrab,Minecart Madness,5,3,8
14606,2023-01-31,CHESTER,gemGrab,Crystal Arcade,61,52,113
14607,2023-01-31,CHESTER,brawlBall,Center Stage,8,7,15
14608,2023-01-31,CHESTER,brawlBall,Beach Ball,170,237,407
14609,2023-01-31,CHESTER,bounty,Hideout,5,7,12
14610,2023-01-30,CHESTER,knockout,Belle's Rock,43,47,90
14611,2023-01-30,CHESTER,hotZone,Quarter Pounder,89,55,144
14612,2023-01-30,CHESTER,heist,Pit Stop,26,22,48
14613,2023-01-30,CHESTER,gemGrab,Minecart Madness,36,40,76
14614,2023-01-30,CHESTER,gemGrab,Double Swoosh,65,61,126
14615,2023-01-30,CHESTER,brawlBall,Center Stage,432,485,917
14616,2023-01-30,CHESTER,brawlBall,Backyard Bowl,49,32,81
14617,2023-01-30,CHESTER,bounty,Hideout,11,2,13
14618,2023-01-29,CHESTER,knockout,Belle's Rock,40,22,62
14619,2023-01-29,CHESTER,hotZone,Quarter Pounder,40,37,77
14620,2023-01-29,CHESTER,heist,Bridge Too Far,19,4,23
14621,2023-01-29,CHESTER,gemGrab,Hard Rock Mine,20,23,43
14622,2023-01-29,CHESTER,gemGrab,Double Swoosh,179,200,379
14623,2023-01-29,CHESTER,brawlBall,Super Beach,9,11,20
14624,2023-01-29,CHESTER,brawlBall,Backyard Bowl,383,474,857
14625,2023-01-29,CHESTER,bounty,Canal Grande,41,62,103
14626,2023-01-28,CHESTER,knockout,Flaring Phoenix,47,54,101
14627,2023-01-28,CHESTER,hotZone,Controller Chaos,93,84,177
14628,2023-01-28,CHESTER,heist,Bridge Too Far,31,26,57
14629,2023-01-28,CHESTER,gemGrab,Hard Rock Mine,98,87,185
14630,2023-01-28,CHESTER,gemGrab,Deep Diner,40,43,83
14631,2023-01-28,CHESTER,brawlBall,Super Beach,519,571,1090
14632,2023-01-28,CHESTER,brawlBall,Sneaky Fields,32,29,61
14633,2023-01-28,CHESTER,bounty,Canal Grande,57,72,129
14634,2023-01-27,CHESTER,knockout,Flaring Phoenix,46,30,76
14635,2023-01-27,CHESTER,hotZone,Controller Chaos,19,27,46
14636,2023-01-27,CHESTER,heist,Hot Potato,10,9,19
14637,2023-01-27,CHESTER,gemGrab,Undermine,6,6,12
14638,2023-01-27,CHESTER,gemGrab,Deep Diner,52,58,110
14639,2023-01-27,CHESTER,brawlBall,Sneaky Fields,185,198,383
14640,2023-01-27,CHESTER,brawlBall,Pinhole Punt,2,13,15
14641,2023-01-27,CHESTER,bounty,Temple Ruins,20,16,36
14642,2023-01-26,CHESTER,knockout,Riverside,61,28,89
14643,2023-01-26,CHESTER,hotZone,Open Zone,40,35,75
14644,2023-01-26,CHESTER,heist,Hot Potato,28,18,46
14645,2023-01-26,CHESTER,gemGrab,Undermine,134,138,272
14646,2023-01-26,CHESTER,gemGrab,Gem Fort,67,88,155
14647,2023-01-26,CHESTER,brawlBall,Sunny Soccer,37,29,66
14648,2023-01-26,CHESTER,brawlBall,Pinhole Punt,646,722,1368
14649,2023-01-26,CHESTER,bounty,Temple Ruins,59,87,146
14650,2023-01-25,CHESTER,knockout,Riverside,15,10,25
14651,2023-01-25,CHESTER,hotZone,Open Zone,36,26,62
14652,2023-01-25,CHESTER,heist,Safe Zone,18,9,27
14653,2023-01-25,CHESTER,gemGrab,Gem Fort,55,66,121
14654,2023-01-25,CHESTER,gemGrab,Crystal Arcade,80,111,191
14655,2023-01-25,CHESTER,brawlBall,Sunny Soccer,368,443,811
14656,2023-01-25,CHESTER,brawlBall,Beach Ball,66,83,149
14657,2023-01-25,CHESTER,bounty,Excel,17,16,33
14658,2023-01-24,CHESTER,knockout,New Perspective,71,71,142
14659,2023-01-24,CHESTER,hotZone,Dueling Beetles,43,25,68
14660,2023-01-24,CHESTER,heist,Safe Zone,25,9,34
14661,2023-01-24,CHESTER,gemGrab,Minecart Madness,25,17,42
14662,2023-01-24,CHESTER,gemGrab,Crystal Arcade,119,106,225
14663,2023-01-24,CHESTER,brawlBall,Center Stage,88,70,158
14664,2023-01-24,CHESTER,brawlBall,Beach Ball,588,646,1234
14665,2023-01-24,CHESTER,bounty,Excel,40,24,64
14666,2023-01-23,CHESTER,knockout,New Perspective,126,80,206
14667,2023-01-23,CHESTER,hotZone,Dueling Beetles,79,59,138
14668,2023-01-23,CHESTER,heist,Snaked Assault,49,31,80
14669,2023-01-23,CHESTER,gemGrab,Minecart Madness,121,139,260
14670,2023-01-23,CHESTER,gemGrab,Double Swoosh,74,101,175
14671,2023-01-23,CHESTER,brawlBall,Center Stage,985,1060,2045
14672,2023-01-23,CHESTER,brawlBall,Backyard Bowl,36,33,69
14673,2023-01-23,CHESTER,bounty,Layer Cake,35,34,69
14674,2023-01-22,CHESTER,knockout,X Marks the Spot,37,23,60
14675,2023-01-22,CHESTER,hotZone,Ring of Fire,15,23,38
14676,2023-01-22,CHESTER,heist,Snaked Assault,22,16,38
14677,2023-01-22,CHESTER,gemGrab,Hard Rock Mine,35,26,61
14678,2023-01-22,CHESTER,gemGrab,Double Swoosh,100,123,223
14679,2023-01-22,CHESTER,brawlBall,Super Beach,46,52,98
14680,2023-01-22,CHESTER,brawlBall,Backyard Bowl,246,331,577
14681,2023-01-22,CHESTER,bounty,Layer Cake,16,9,25
14682,2023-01-21,CHESTER,knockout,X Marks the Spot,122,101,223
14683,2023-01-21,CHESTER,hotZone,Ring of Fire,68,44,112
14684,2023-01-21,CHESTER,heist,Tornado Ring,38,49,87
14685,2023-01-21,CHESTER,gemGrab,Hard Rock Mine,155,150,305
14686,2023-01-21,CHESTER,gemGrab,Deep Diner,25,24,49
14687,2023-01-21,CHESTER,brawlBall,Super Beach,852,770,1622
14688,2023-01-21,CHESTER,brawlBall,Sneaky Fields,32,19,51
14689,2023-01-21,CHESTER,bounty,Dry Season,40,38,78
14690,2023-01-20,CHESTER,knockout,Out in the Open,90,112,202
14691,2023-01-20,CHESTER,hotZone,Split,52,58,110
14692,2023-01-20,CHESTER,heist,Tornado Ring,48,51,99
14693,2023-01-20,CHESTER,gemGrab,Undermine,81,74,155
14694,2023-01-20,CHESTER,gemGrab,Deep Diner,159,193,352
14695,2023-01-20,CHESTER,brawlBall,Sneaky Fields,676,598,1274
14696,2023-01-20,CHESTER,brawlBall,Pinhole Punt,23,29,52
14697,2023-01-20,CHESTER,bounty,Dry Season,39,27,66
14698,2023-01-19,CHESTER,knockout,Out in the Open,111,56,167
14699,2023-01-19,CHESTER,hotZone,Split,95,92,187
14700,2023-01-19,CHESTER,heist,Kaboom Canyon,25,21,46
14701,2023-01-19,CHESTER,gemGrab,Undermine,128,134,262
14702,2023-01-19,CHESTER,gemGrab,Gem Fort,30,22,52
14703,2023-01-19,CHESTER,brawlBall,Sunny Soccer,20,13,33
14704,2023-01-19,CHESTER,brawlBall,Pinhole Punt,689,722,1411
14705,2023-01-19,CHESTER,bounty,Shooting Star,11,13,24
14706,2023-01-18,CHESTER,knockout,Goldarm Gulch,28,13,41
14707,2023-01-18,CHESTER,hotZone,Parallel Plays,11,31,42
14708,2023-01-18,CHESTER,heist,Kaboom Canyon,6,4,10
14709,2023-01-18,CHESTER,gemGrab,Gem Fort,39,32,71
14710,2023-01-18,CHESTER,gemGrab,Crystal Arcade,20,10,30
14711,2023-01-18,CHESTER,brawlBall,Sunny Soccer,197,223,420
14712,2023-01-18,CHESTER,brawlBall,Beach Ball,8,4,12
14713,2023-01-18,CHESTER,bounty,Shooting Star,7,7,14
14714,2023-01-17,CHESTER,knockout,Goldarm Gulch,29,23,52
14715,2023-01-17,CHESTER,hotZone,Parallel Plays,5,12,17
14716,2023-01-17,CHESTER,heist,Pit Stop,5,0,5
14717,2023-01-17,CHESTER,gemGrab,Minecart Madness,2,0,2
14718,2023-01-17,CHESTER,gemGrab,Crystal Arcade,8,16,24
14719,2023-01-17,CHESTER,brawlBall,Center Stage,6,8,14
14720,2023-01-17,CHESTER,brawlBall,Beach Ball,79,81,160
14721,2023-01-17,CHESTER,bounty,Hideout,2,0,2
14722,2023-01-16,CHESTER,knockout,Belle's Rock,8,4,12
14723,2023-01-16,CHESTER,hotZone,Quarter Pounder,13,16,29
14724,2023-01-16,CHESTER,heist,Pit Stop,12,4,16
14725,2023-01-16,CHESTER,gemGrab,Minecart Madness,13,10,23
14726,2023-01-16,CHESTER,gemGrab,Double Swoosh,12,10,22
14727,2023-01-16,CHESTER,brawlBall,Center Stage,97,71,168
14728,2023-01-16,CHESTER,brawlBall,Backyard Bowl,8,2,10
14729,2023-01-16,CHESTER,bounty,Hideout,4,21,25
14730,2023-01-15,CHESTER,knockout,Belle's Rock,13,4,17
14731,2023-01-15,CHESTER,hotZone,Quarter Pounder,64,65,129
14732,2023-01-15,CHESTER,heist,Bridge Too Far,7,0,7
14733,2023-01-15,CHESTER,gemGrab,Hard Rock Mine,21,36,57
14734,2023-01-15,CHESTER,gemGrab,Double Swoosh,27,20,47
14735,2023-01-15,CHESTER,brawlBall,Super Beach,18,3,21
14736,2023-01-15,CHESTER,brawlBall,Backyard Bowl,93,113,206
14737,2023-01-15,CHESTER,bounty,Canal Grande,7,11,18
14738,2023-01-14,CHESTER,knockout,Flaring Phoenix,12,3,15
14739,2023-01-14,CHESTER,hotZone,Controller Chaos,40,48,88
14740,2023-01-14,CHESTER,heist,Bridge Too Far,11,1,12
14741,2023-01-14,CHESTER,gemGrab,Hard Rock Mine,15,6,21
14742,2023-01-14,CHESTER,gemGrab,Deep Diner,5,2,7
14743,2023-01-14,CHESTER,brawlBall,Super Beach,75,87,162
14744,2023-01-14,CHESTER,brawlBall,Sneaky Fields,5,4,9
14745,2023-01-14,CHESTER,bounty,Canal Grande,14,47,61
14746,2023-01-13,CHESTER,knockout,Flaring Phoenix,10,5,15
14747,2023-01-13,CHESTER,hotZone,Controller Chaos,33,5,38
14748,2023-01-13,CHESTER,heist,Hot Potato,6,0,6
14749,2023-01-13,CHESTER,gemGrab,Undermine,1,0,1
14750,2023-01-13,CHESTER,gemGrab,Deep Diner,22,5,27
14751,2023-01-13,CHESTER,brawlBall,Sneaky Fields,94,46,140
14752,2023-01-13,CHESTER,brawlBall,Pinhole Punt,3,2,5
14753,2023-01-13,CHESTER,bounty,Temple Ruins,6,1,7
14754,2023-01-12,CHESTER,knockout,Riverside,19,5,24
14755,2023-01-12,CHESTER,hotZone,Open Zone,22,10,32
14756,2023-01-12,CHESTER,heist,Hot Potato,1,0,1
14757,2023-01-12,CHESTER,gemGrab,Undermine,23,21,44
14758,2023-01-12,CHESTER,gemGrab,Gem Fort,2,6,8
14759,2023-01-12,CHESTER,brawlBall,Sunny Soccer,8,19,27
14760,2023-01-12,CHESTER,brawlBall,Pinhole Punt,78,81,159
14761,2023-01-12,CHESTER,bounty,Temple Ruins,2,1,3
14762,2023-01-11,CHESTER,knockout,Riverside,2,0,2
14763,2023-01-11,CHESTER,hotZone,Open Zone,7,2,9
14764,2023-01-11,CHESTER,gemGrab,Gem Fort,19,39,58
14765,2023-01-11,CHESTER,brawlBall,Sunny Soccer,56,44,100
14766,2023-01-11,CHESTER,brawlBall,Beach Ball,4,5,9
14767,2023-01-11,CHESTER,bounty,Excel,2,0,2
14768,2023-01-10,CHESTER,knockout,New Perspective,24,24,48
14769,2023-01-10,CHESTER,hotZone,Dueling Beetles,54,38,92
14770,2023-01-10,CHESTER,heist,Safe Zone,11,5,16
14771,2023-01-10,CHESTER,gemGrab,Minecart Madness,23,22,45
14772,2023-01-10,CHESTER,gemGrab,Crystal Arcade,60,50,110
14773,2023-01-10,CHESTER,brawlBall,Center Stage,32,37,69
14774,2023-01-10,CHESTER,brawlBall,Beach Ball,207,213,420
14775,2023-01-10,CHESTER,bounty,Excel,4,8,12
14776,2023-01-09,CHESTER,knockout,New Perspective,27,20,47
14777,2023-01-09,CHESTER,hotZone,Dueling Beetles,35,21,56
14778,2023-01-09,CHESTER,heist,Snaked Assault,43,47,90
14779,2023-01-09,CHESTER,gemGrab,Minecart Madness,63,98,161
14780,2023-01-09,CHESTER,gemGrab,Double Swoosh,68,53,121
14781,2023-01-09,CHESTER,brawlBall,Center Stage,271,254,525
14782,2023-01-09,CHESTER,brawlBall,Backyard Bowl,16,2,18
14783,2023-01-09,CHESTER,bounty,Layer Cake,21,19,40
14784,2023-01-08,CHESTER,knockout,X Marks the Spot,16,5,21
14785,2023-01-08,CHESTER,hotZone,Ring of Fire,48,73,121
14786,2023-01-08,CHESTER,heist,Snaked Assault,32,66,98
14787,2023-01-08,CHESTER,gemGrab,Hard Rock Mine,23,35,58
14788,2023-01-08,CHESTER,gemGrab,Double Swoosh,45,39,84
14789,2023-01-08,CHESTER,brawlBall,Super Beach,26,20,46
14790,2023-01-08,CHESTER,brawlBall,Backyard Bowl,130,121,251
14791,2023-01-08,CHESTER,bounty,Layer Cake,15,18,33
14792,2023-01-07,CHESTER,knockout,X Marks the Spot,18,18,36
14793,2023-01-07,CHESTER,hotZone,Ring of Fire,25,41,66
14794,2023-01-07,CHESTER,heist,Tornado Ring,29,26,55
14795,2023-01-07,CHESTER,gemGrab,Hard Rock Mine,46,42,88
14796,2023-01-07,CHESTER,gemGrab,Deep Diner,40,47,87
14797,2023-01-07,CHESTER,brawlBall,Super Beach,102,107,209
14798,2023-01-07,CHESTER,brawlBall,Sneaky Fields,31,20,51
14799,2023-01-07,CHESTER,bounty,Dry Season,6,4,10
14800,2023-01-06,CHESTER,knockout,Out in the Open,13,7,20
14801,2023-01-06,CHESTER,hotZone,Split,28,49,77
14802,2023-01-06,CHESTER,heist,Tornado Ring,59,56,115
14803,2023-01-06,CHESTER,gemGrab,Undermine,37,56,93
14804,2023-01-06,CHESTER,gemGrab,Deep Diner,82,99,181
14805,2023-01-06,CHESTER,brawlBall,Sneaky Fields,221,173,394
14806,2023-01-06,CHESTER,brawlBall,Pinhole Punt,30,25,55
14807,2023-01-06,CHESTER,bounty,Dry Season,16,2,18
14808,2023-01-05,CHESTER,knockout,Out in the Open,57,21,78
14809,2023-01-05,CHESTER,hotZone,Split,97,70,167
14810,2023-01-05,CHESTER,heist,Kaboom Canyon,12,14,26
14811,2023-01-05,CHESTER,gemGrab,Undermine,103,101,204
14812,2023-01-05,CHESTER,gemGrab,Gem Fort,14,11,25
14813,2023-01-05,CHESTER,brawlBall,Sunny Soccer,4,1,5
14814,2023-01-05,CHESTER,brawlBall,Pinhole Punt,444,454,898
14815,2023-01-05,CHESTER,bounty,Shooting Star,6,0,6
14816,2023-01-04,CHESTER,knockout,Goldarm Gulch,18,6,24
14817,2023-01-04,CHESTER,hotZone,Parallel Plays,51,70,121
14818,2023-01-04,CHESTER,heist,Kaboom Canyon,28,22,50
14819,2023-01-04,CHESTER,gemGrab,Gem Fort,102,91,193
14820,2023-01-04,CHESTER,gemGrab,Crystal Arcade,22,14,36
14821,2023-01-04,CHESTER,brawlBall,Sunny Soccer,307,376,683
14822,2023-01-04,CHESTER,brawlBall,Beach Ball,1,0,1
14823,2023-01-04,CHESTER,bounty,Shooting Star,17,2,19
14824,2023-01-03,CHESTER,knockout,Goldarm Gulch,21,22,43
14825,2023-01-03,CHESTER,hotZone,Parallel Plays,89,106,195
14826,2023-01-03,CHESTER,hotZone,Controller Chaos,1,1,2
14827,2023-01-03,CHESTER,heist,Pit Stop,30,24,54
14828,2023-01-03,CHESTER,heist,Kaboom Canyon,1,0,1
14829,2023-01-03,CHESTER,gemGrab,Minecart Madness,23,24,47
14830,2023-01-03,CHESTER,gemGrab,Crystal Arcade,119,103,222
14831,2023-01-03,CHESTER,brawlBall,Center Stage,12,13,25
14832,2023-01-03,CHESTER,brawlBall,Beach Ball,266,304,570
14833,2023-01-03,CHESTER,bounty,Hideout,13,8,21
14834,2023-01-02,CHESTER,knockout,Belle's Rock,18,19,37
14835,2023-01-02,CHESTER,hotZone,Quarter Pounder,121,221,342
14836,2023-01-02,CHESTER,hotZone,Controller Chaos,1,1,2
14837,2023-01-02,CHESTER,heist,Pit Stop,26,22,48
14838,2023-01-02,CHESTER,heist,Kaboom Canyon,0,1,1
14839,2023-01-02,CHESTER,gemGrab,Minecart Madness,78,84,162
14840,2023-01-02,CHESTER,gemGrab,Double Swoosh,76,93,169
14841,2023-01-02,CHESTER,brawlBall,Center Stage,343,416,759
14842,2023-01-02,CHESTER,brawlBall,Backyard Bowl,10,21,31
14843,2023-01-02,CHESTER,bounty,Hideout,26,11,37
14844,2023-01-01,CHESTER,knockout,Belle's Rock,8,6,14
14845,2023-01-01,CHESTER,hotZone,Quarter Pounder,67,82,149
14846,2023-01-01,CHESTER,heist,Bridge Too Far,5,0,5
14847,2023-01-01,CHESTER,gemGrab,Hard Rock Mine,1,2,3
14848,2023-01-01,CHESTER,gemGrab,Double Swoosh,54,86,140
14849,2023-01-01,CHESTER,brawlBall,Backyard Bowl,69,105,174
14850,2023-01-01,CHESTER,bounty,Canal Grande,3,11,14
14851,2022-12-31,CHESTER,knockout,Flaring Phoenix,0,1,1
14852,2022-12-31,CHESTER,hotZone,Controller Chaos,7,5,12
14853,2022-12-31,CHESTER,heist,Bridge Too Far,6,2,8
14854,2022-12-31,CHESTER,gemGrab,Hard Rock Mine,10,23,33
14855,2022-12-31,CHESTER,gemGrab,Deep Diner,11,2,13
14856,2022-12-31,CHESTER,brawlBall,Super Beach,22,42,64
14857,2022-12-31,CHESTER,brawlBall,Sneaky Fields,1,2,3
14858,2022-12-31,CHESTER,bounty,Canal Grande,2,3,5
14859,2022-12-30,CHESTER,knockout,Flaring Phoenix,0,1,1
14860,2022-12-30,CHESTER,hotZone,Controller Chaos,17,41,58
14861,2022-12-30,CHESTER,heist,Kaboom Canyon,0,2,2
14862,2022-12-30,CHESTER,heist,Hot Potato,4,1,5
14863,2022-12-30,CHESTER,gemGrab,Undermine,7,2,9
14864,2022-12-30,CHESTER,gemGrab,Minecart Madness,1,3,4
14865,2022-12-30,CHESTER,gemGrab,Deep Diner,21,34,55
14866,2022-12-30,CHESTER,brawlBall,Sneaky Fields,37,38,75
14867,2022-12-29,CHESTER,hotZone,Open Zone,4,2,6
14868,2022-12-29,CHESTER,hotZone,Controller Chaos,0,1,1
14869,2022-12-29,CHESTER,heist,Hot Potato,1,0,1
14870,2022-12-29,CHESTER,gemGrab,Undermine,4,1,5
14871,2022-12-29,CHESTER,gemGrab,Gem Fort,2,1,3
14872,2022-12-29,CHESTER,brawlBall,Pinhole Punt,14,19,33
14873,2022-12-28,CHESTER,hotZone,Open Zone,6,11,17
14874,2022-12-28,CHESTER,hotZone,Controller Chaos,1,1,2
14875,2022-12-28,CHESTER,gemGrab,Crystal Arcade,1,1,2
14876,2022-12-28,CHESTER,brawlBall,Sunny Soccer,2,2,4
14877,2022-12-28,CHESTER,brawlBall,Beach Ball,1,1,2
14878,2022-12-27,CHESTER,hotZone,Controller Chaos,1,1,2
14879,2022-12-27,CHESTER,heist,Safe Zone,0,1,1
14880,2022-12-27,CHESTER,gemGrab,Minecart Madness,1,0,1
14881,2022-12-27,CHESTER,brawlBall,Center Stage,1,2,3
14882,2022-12-27,CHESTER,brawlBall,Beach Ball,7,5,12
14883,2022-12-26,CHESTER,hotZone,Controller Chaos,1,2,3
14884,2022-12-26,CHESTER,gemGrab,Minecart Madness,3,1,4
14885,2022-12-26,CHESTER,brawlBall,Center Stage,4,4,8
14886,2022-12-25,CHESTER,hotZone,Ring of Fire,0,1,1
14887,2022-12-25,CHESTER,gemGrab,Double Swoosh,3,3,6
14888,2022-12-25,CHESTER,brawlBall,Backyard Bowl,3,2,5
14889,2022-12-24,CHESTER,brawlBall,Super Beach,1,3,4
14890,2022-12-24,CHESTER,bounty,Dry Season,0,1,1
14891,2022-12-23,CHESTER,knockout,Out in the Open,2,1,3
14892,2022-12-23,CHESTER,gemGrab,Deep Diner,1,1,2
14893,2022-12-23,CHESTER,brawlBall,Sneaky Fields,1,0,1
14894,2022-12-22,CHESTER,gemGrab,Gem Fort,8,14,22
14895,2022-12-22,CHESTER,brawlBall,Pinhole Punt,0,13,13
14896,2022-12-21,CHESTER,brawlBall,Sunny Soccer,3,4,7
14897,2022-12-20,CHESTER,brawlBall,Beach Ball,2,5,7
14898,2022-12-19,CHESTER,brawlBall,Center Stage,3,9,12
14899,2022-12-17,CHESTER,knockout,Flaring Phoenix,0,1,1
14900,2022-12-17,CHESTER,brawlBall,Super Beach,1,1,2
14901,2022-12-16,CHESTER,hotZone,Controller Chaos,0,1,1
14902,2022-12-16,CHESTER,brawlBall,Sneaky Fields,5,2,7
14903,2022-12-16,CHESTER,bounty,Temple Ruins,1,0,1
14904,2022-12-13,CHESTER,knockout,New Perspective,6,0,6
14905,2022-12-13,CHESTER,hotZone,Dueling Beetles,0,1,1
14906,2022-12-13,CHESTER,heist,Safe Zone,1,0,1
14907,2022-12-13,CHESTER,gemGrab,Crystal Arcade,4,8,12
14908,2022-12-13,CHESTER,brawlBall,Beach Ball,3,6,9
14909,2023-02-05,CARL,knockout,X Marks the Spot,78,105,183
14910,2023-02-05,CARL,knockout,Goldarm Gulch,33,25,58
14911,2023-02-05,CARL,hotZone,Ring of Fire,50,68,118
14912,2023-02-05,CARL,heist,Snaked Assault,39,22,61
14913,2023-02-05,CARL,heist,Pit Stop,18,18,36
14914,2023-02-05,CARL,gemGrab,Hard Rock Mine,41,67,108
14915,2023-02-05,CARL,gemGrab,Double Swoosh,136,172,308
14916,2023-02-05,CARL,brawlBall,Super Beach,22,13,35
14917,2023-02-05,CARL,brawlBall,Sneaky Fields,10,14,24
14918,2023-02-05,CARL,brawlBall,Backyard Bowl,535,536,1071
14919,2023-02-05,CARL,bounty,Layer Cake,75,91,166
14920,2023-02-04,CARL,knockout,X Marks the Spot,17,16,33
14921,2023-02-04,CARL,knockout,Goldarm Gulch,31,21,52
14922,2023-02-04,CARL,hotZone,Ring of Fire,17,22,39
14923,2023-02-04,CARL,heist,Tornado Ring,4,2,6
14924,2023-02-04,CARL,heist,Pit Stop,18,10,28
14925,2023-02-04,CARL,gemGrab,Hard Rock Mine,49,49,98
14926,2023-02-04,CARL,gemGrab,Double Swoosh,23,31,54
14927,2023-02-04,CARL,gemGrab,Deep Diner,12,19,31
14928,2023-02-04,CARL,brawlBall,Super Beach,113,90,203
14929,2023-02-04,CARL,brawlBall,Sneaky Fields,9,9,18
14930,2023-02-04,CARL,bounty,Dry Season,15,18,33
14931,2023-02-03,CARL,knockout,Out in the Open,150,156,306
14932,2023-02-03,CARL,knockout,Goldarm Gulch,211,159,370
14933,2023-02-03,CARL,hotZone,Split,20,30,50
14934,2023-02-03,CARL,heist,Tornado Ring,44,28,72
14935,2023-02-03,CARL,heist,Pit Stop,117,105,222
14936,2023-02-03,CARL,gemGrab,Undermine,24,29,53
14937,2023-02-03,CARL,gemGrab,Double Swoosh,119,203,322
14938,2023-02-03,CARL,gemGrab,Deep Diner,174,241,415
14939,2023-02-03,CARL,brawlBall,Sneaky Fields,343,367,710
14940,2023-02-03,CARL,brawlBall,Pinhole Punt,25,38,63
14941,2023-02-03,CARL,bounty,Dry Season,187,211,398
14942,2023-02-02,CARL,knockout,Out in the Open,80,72,152
14943,2023-02-02,CARL,hotZone,Split,10,7,17
14944,2023-02-02,CARL,heist,Kaboom Canyon,12,13,25
14945,2023-02-02,CARL,gemGrab,Undermine,23,17,40
14946,2023-02-02,CARL,gemGrab,Gem Fort,6,7,13
14947,2023-02-02,CARL,brawlBall,Sunny Soccer,3,1,4
14948,2023-02-02,CARL,brawlBall,Pinhole Punt,236,205,441
14949,2023-02-02,CARL,bounty,Shooting Star,10,11,21
14950,2023-02-01,CARL,knockout,Goldarm Gulch,121,91,212
14951,2023-02-01,CARL,hotZone,Parallel Plays,47,53,100
14952,2023-02-01,CARL,heist,Kaboom Canyon,68,48,116
14953,2023-02-01,CARL,gemGrab,Gem Fort,49,53,102
14954,2023-02-01,CARL,gemGrab,Crystal Arcade,80,169,249
14955,2023-02-01,CARL,brawlBall,Sunny Soccer,455,437,892
14956,2023-02-01,CARL,brawlBall,Beach Ball,26,35,61
14957,2023-02-01,CARL,bounty,Shooting Star,38,40,78
14958,2023-01-31,CARL,knockout,Goldarm Gulch,56,66,122
14959,2023-01-31,CARL,hotZone,Parallel Plays,28,30,58
14960,2023-01-31,CARL,heist,Pit Stop,18,14,32
14961,2023-01-31,CARL,gemGrab,Minecart Madness,18,24,42
14962,2023-01-31,CARL,gemGrab,Crystal Arcade,80,96,176
14963,2023-01-31,CARL,brawlBall,Center Stage,1,3,4
14964,2023-01-31,CARL,brawlBall,Beach Ball,194,176,370
14965,2023-01-31,CARL,bounty,Hideout,18,6,24
14966,2023-01-30,CARL,knockout,Belle's Rock,213,202,415
14967,2023-01-30,CARL,hotZone,Quarter Pounder,103,112,215
14968,2023-01-30,CARL,heist,Pit Stop,62,32,94
14969,2023-01-30,CARL,gemGrab,Minecart Madness,121,158,279
14970,2023-01-30,CARL,gemGrab,Double Swoosh,50,71,121
14971,2023-01-30,CARL,brawlBall,Center Stage,228,155,383
14972,2023-01-30,CARL,brawlBall,Backyard Bowl,48,53,101
14973,2023-01-30,CARL,bounty,Hideout,26,35,61
14974,2023-01-29,CARL,knockout,Belle's Rock,276,242,518
14975,2023-01-29,CARL,hotZone,Quarter Pounder,108,152,260
14976,2023-01-29,CARL,heist,Bridge Too Far,67,68,135
14977,2023-01-29,CARL,gemGrab,Hard Rock Mine,31,38,69
14978,2023-01-29,CARL,gemGrab,Double Swoosh,71,61,132
14979,2023-01-29,CARL,brawlBall,Super Beach,2,2,4
14980,2023-01-29,CARL,brawlBall,Backyard Bowl,584,536,1120
14981,2023-01-29,CARL,bounty,Canal Grande,71,72,143
14982,2023-01-28,CARL,knockout,Flaring Phoenix,56,51,107
14983,2023-01-28,CARL,hotZone,Controller Chaos,36,40,76
14984,2023-01-28,CARL,heist,Bridge Too Far,201,147,348
14985,2023-01-28,CARL,gemGrab,Hard Rock Mine,182,267,449
14986,2023-01-28,CARL,gemGrab,Deep Diner,73,101,174
14987,2023-01-28,CARL,brawlBall,Super Beach,426,429,855
14988,2023-01-28,CARL,brawlBall,Sneaky Fields,14,19,33
14989,2023-01-28,CARL,bounty,Canal Grande,150,206,356
14990,2023-01-27,CARL,knockout,Flaring Phoenix,25,13,38
14991,2023-01-27,CARL,hotZone,Controller Chaos,21,33,54
14992,2023-01-27,CARL,heist,Hot Potato,20,12,32
14993,2023-01-27,CARL,gemGrab,Undermine,9,10,19
14994,2023-01-27,CARL,gemGrab,Deep Diner,59,98,157
14995,2023-01-27,CARL,brawlBall,Sneaky Fields,101,92,193
14996,2023-01-27,CARL,brawlBall,Pinhole Punt,9,18,27
14997,2023-01-27,CARL,bounty,Temple Ruins,14,15,29
14998,2023-01-26,CARL,knockout,Riverside,118,105,223
14999,2023-01-26,CARL,hotZone,Open Zone,86,93,179
15000,2023-01-26,CARL,heist,Hot Potato,50,85,135
15001,2023-01-26,CARL,gemGrab,Undermine,65,58,123
15002,2023-01-26,CARL,gemGrab,Gem Fort,21,15,36
15003,2023-01-26,CARL,brawlBall,Sunny Soccer,22,42,64
15004,2023-01-26,CARL,brawlBall,Pinhole Punt,556,588,1144
15005,2023-01-26,CARL,bounty,Temple Ruins,53,51,104
15006,2023-01-25,CARL,knockout,Riverside,47,32,79
15007,2023-01-25,CARL,hotZone,Open Zone,43,54,97
15008,2023-01-25,CARL,heist,Safe Zone,99,114,213
15009,2023-01-25,CARL,gemGrab,Gem Fort,26,23,49
15010,2023-01-25,CARL,gemGrab,Crystal Arcade,77,138,215
15011,2023-01-25,CARL,brawlBall,Sunny Soccer,272,265,537
15012,2023-01-25,CARL,brawlBall,Beach Ball,37,55,92
15013,2023-01-25,CARL,bounty,Excel,82,161,243
15014,2023-01-24,CARL,knockout,New Perspective,56,36,92
15015,2023-01-24,CARL,hotZone,Dueling Beetles,74,83,157
15016,2023-01-24,CARL,heist,Safe Zone,163,173,336
15017,2023-01-24,CARL,gemGrab,Minecart Madness,61,83,144
15018,2023-01-24,CARL,gemGrab,Crystal Arcade,147,220,367
15019,2023-01-24,CARL,brawlBall,Center Stage,45,45,90
15020,2023-01-24,CARL,brawlBall,Beach Ball,512,610,1122
15021,2023-01-24,CARL,bounty,Excel,114,172,286
15022,2023-01-23,CARL,knockout,New Perspective,114,123,237
15023,2023-01-23,CARL,hotZone,Dueling Beetles,172,232,404
15024,2023-01-23,CARL,heist,Snaked Assault,66,34,100
15025,2023-01-23,CARL,gemGrab,Minecart Madness,284,375,659
15026,2023-01-23,CARL,gemGrab,Double Swoosh,44,58,102
15027,2023-01-23,CARL,brawlBall,Center Stage,417,421,838
15028,2023-01-23,CARL,brawlBall,Backyard Bowl,39,50,89
15029,2023-01-23,CARL,bounty,Layer Cake,97,103,200
15030,2023-01-22,CARL,knockout,X Marks the Spot,52,56,108
15031,2023-01-22,CARL,hotZone,Ring of Fire,42,65,107
15032,2023-01-22,CARL,heist,Snaked Assault,33,27,60
15033,2023-01-22,CARL,gemGrab,Hard Rock Mine,45,57,102
15034,2023-01-22,CARL,gemGrab,Double Swoosh,43,31,74
15035,2023-01-22,CARL,brawlBall,Super Beach,47,58,105
15036,2023-01-22,CARL,brawlBall,Backyard Bowl,310,352,662
15037,2023-01-22,CARL,bounty,Layer Cake,72,67,139
15038,2023-01-21,CARL,knockout,X Marks the Spot,217,160,377
15039,2023-01-21,CARL,hotZone,Ring of Fire,129,159,288
15040,2023-01-21,CARL,heist,Tornado Ring,37,43,80
15041,2023-01-21,CARL,gemGrab,Hard Rock Mine,184,269,453
15042,2023-01-21,CARL,gemGrab,Deep Diner,45,76,121
15043,2023-01-21,CARL,brawlBall,Super Beach,674,740,1414
15044,2023-01-21,CARL,brawlBall,Sneaky Fields,10,6,16
15045,2023-01-21,CARL,bounty,Dry Season,106,108,214
15046,2023-01-20,CARL,knockout,Out in the Open,174,182,356
15047,2023-01-20,CARL,hotZone,Split,15,22,37
15048,2023-01-20,CARL,heist,Tornado Ring,61,42,103
15049,2023-01-20,CARL,gemGrab,Undermine,29,20,49
15050,2023-01-20,CARL,gemGrab,Deep Diner,169,178,347
15051,2023-01-20,CARL,brawlBall,Sneaky Fields,272,248,520
15052,2023-01-20,CARL,brawlBall,Pinhole Punt,24,17,41
15053,2023-01-20,CARL,bounty,Dry Season,79,99,178
15054,2023-01-19,CARL,knockout,Out in the Open,265,259,524
15055,2023-01-19,CARL,hotZone,Split,26,30,56
15056,2023-01-19,CARL,heist,Kaboom Canyon,74,84,158
15057,2023-01-19,CARL,gemGrab,Undermine,122,115,237
15058,2023-01-19,CARL,gemGrab,Gem Fort,14,13,27
15059,2023-01-19,CARL,brawlBall,Sunny Soccer,20,22,42
15060,2023-01-19,CARL,brawlBall,Pinhole Punt,637,754,1391
15061,2023-01-19,CARL,bounty,Shooting Star,43,32,75
15062,2023-01-18,CARL,knockout,Goldarm Gulch,15,9,24
15063,2023-01-18,CARL,hotZone,Parallel Plays,4,4,8
15064,2023-01-18,CARL,heist,Kaboom Canyon,22,31,53
15065,2023-01-18,CARL,gemGrab,Gem Fort,19,7,26
15066,2023-01-18,CARL,gemGrab,Crystal Arcade,12,5,17
15067,2023-01-18,CARL,brawlBall,Sunny Soccer,129,143,272
15068,2023-01-18,CARL,brawlBall,Beach Ball,3,2,5
15069,2023-01-18,CARL,bounty,Shooting Star,12,23,35
15070,2023-01-17,CARL,knockout,Goldarm Gulch,20,13,33
15071,2023-01-17,CARL,hotZone,Parallel Plays,3,7,10
15072,2023-01-17,CARL,heist,Pit Stop,4,1,5
15073,2023-01-17,CARL,gemGrab,Minecart Madness,4,10,14
15074,2023-01-17,CARL,gemGrab,Crystal Arcade,15,18,33
15075,2023-01-17,CARL,brawlBall,Center Stage,2,1,3
15076,2023-01-17,CARL,brawlBall,Beach Ball,56,54,110
15077,2023-01-17,CARL,bounty,Hideout,6,5,11
15078,2023-01-16,CARL,knockout,Belle's Rock,20,19,39
15079,2023-01-16,CARL,hotZone,Quarter Pounder,6,15,21
15080,2023-01-16,CARL,heist,Pit Stop,19,22,41
15081,2023-01-16,CARL,gemGrab,Minecart Madness,23,44,67
15082,2023-01-16,CARL,gemGrab,Double Swoosh,3,2,5
15083,2023-01-16,CARL,brawlBall,Center Stage,25,18,43
15084,2023-01-16,CARL,brawlBall,Backyard Bowl,4,3,7
15085,2023-01-16,CARL,bounty,Hideout,7,13,20
15086,2023-01-15,CARL,knockout,Belle's Rock,27,23,50
15087,2023-01-15,CARL,hotZone,Quarter Pounder,23,70,93
15088,2023-01-15,CARL,heist,Bridge Too Far,17,24,41
15089,2023-01-15,CARL,gemGrab,Hard Rock Mine,13,11,24
15090,2023-01-15,CARL,gemGrab,Double Swoosh,6,5,11
15091,2023-01-15,CARL,brawlBall,Super Beach,9,18,27
15092,2023-01-15,CARL,brawlBall,Backyard Bowl,63,113,176
15093,2023-01-15,CARL,bounty,Canal Grande,12,31,43
15094,2023-01-14,CARL,knockout,Flaring Phoenix,4,5,9
15095,2023-01-14,CARL,hotZone,Controller Chaos,7,11,18
15096,2023-01-14,CARL,heist,Bridge Too Far,30,13,43
15097,2023-01-14,CARL,gemGrab,Hard Rock Mine,14,44,58
15098,2023-01-14,CARL,gemGrab,Deep Diner,17,15,32
15099,2023-01-14,CARL,brawlBall,Super Beach,43,42,85
15100,2023-01-14,CARL,brawlBall,Sneaky Fields,2,0,2
15101,2023-01-14,CARL,bounty,Canal Grande,11,9,20
15102,2023-01-13,CARL,knockout,Flaring Phoenix,11,29,40
15103,2023-01-13,CARL,hotZone,Controller Chaos,15,15,30
15104,2023-01-13,CARL,heist,Hot Potato,4,1,5
15105,2023-01-13,CARL,gemGrab,Undermine,0,1,1
15106,2023-01-13,CARL,gemGrab,Deep Diner,22,37,59
15107,2023-01-13,CARL,brawlBall,Sneaky Fields,17,11,28
15108,2023-01-13,CARL,brawlBall,Pinhole Punt,1,2,3
15109,2023-01-13,CARL,bounty,Temple Ruins,0,4,4
15110,2023-01-12,CARL,knockout,Riverside,13,13,26
15111,2023-01-12,CARL,hotZone,Open Zone,9,28,37
15112,2023-01-12,CARL,heist,Hot Potato,0,2,2
15113,2023-01-12,CARL,gemGrab,Undermine,4,2,6
15114,2023-01-12,CARL,brawlBall,Pinhole Punt,13,21,34
15115,2023-01-11,CARL,knockout,Riverside,2,0,2
15116,2023-01-11,CARL,hotZone,Open Zone,4,6,10
15117,2023-01-11,CARL,gemGrab,Gem Fort,2,0,2
15118,2023-01-11,CARL,brawlBall,Sunny Soccer,8,9,17
15119,2023-01-11,CARL,bounty,Excel,2,0,2
15120,2023-01-10,CARL,knockout,New Perspective,2,4,6
15121,2023-01-10,CARL,hotZone,Dueling Beetles,30,53,83
15122,2023-01-10,CARL,heist,Safe Zone,16,11,27
15123,2023-01-10,CARL,gemGrab,Minecart Madness,11,19,30
15124,2023-01-10,CARL,gemGrab,Crystal Arcade,11,8,19
15125,2023-01-10,CARL,brawlBall,Center Stage,5,1,6
15126,2023-01-10,CARL,brawlBall,Beach Ball,39,55,94
15127,2023-01-10,CARL,bounty,Excel,3,12,15
15128,2023-01-09,CARL,knockout,New Perspective,3,3,6
15129,2023-01-09,CARL,hotZone,Dueling Beetles,17,24,41
15130,2023-01-09,CARL,heist,Snaked Assault,7,3,10
15131,2023-01-09,CARL,gemGrab,Minecart Madness,34,44,78
15132,2023-01-09,CARL,gemGrab,Double Swoosh,5,3,8
15133,2023-01-09,CARL,brawlBall,Center Stage,17,5,22
15134,2023-01-09,CARL,brawlBall,Backyard Bowl,3,12,15
15135,2023-01-09,CARL,bounty,Layer Cake,18,28,46
15136,2023-01-08,CARL,knockout,X Marks the Spot,20,11,31
15137,2023-01-08,CARL,hotZone,Ring of Fire,6,17,23
15138,2023-01-08,CARL,heist,Snaked Assault,5,2,7
15139,2023-01-08,CARL,gemGrab,Hard Rock Mine,4,2,6
15140,2023-01-08,CARL,gemGrab,Double Swoosh,8,4,12
15141,2023-01-08,CARL,brawlBall,Super Beach,2,6,8
15142,2023-01-08,CARL,brawlBall,Backyard Bowl,46,53,99
15143,2023-01-08,CARL,bounty,Layer Cake,6,1,7
15144,2023-01-07,CARL,knockout,X Marks the Spot,6,8,14
15145,2023-01-07,CARL,hotZone,Ring of Fire,5,1,6
15146,2023-01-07,CARL,heist,Tornado Ring,5,0,5
15147,2023-01-07,CARL,gemGrab,Hard Rock Mine,18,14,32
15148,2023-01-07,CARL,gemGrab,Deep Diner,7,6,13
15149,2023-01-07,CARL,brawlBall,Super Beach,16,15,31
15150,2023-01-07,CARL,brawlBall,Sneaky Fields,1,0,1
15151,2023-01-07,CARL,bounty,Dry Season,19,32,51
15152,2023-01-06,CARL,knockout,Out in the Open,17,6,23
15153,2023-01-06,CARL,hotZone,Split,1,1,2
15154,2023-01-06,CARL,heist,Tornado Ring,1,1,2
15155,2023-01-06,CARL,gemGrab,Undermine,4,5,9
15156,2023-01-06,CARL,gemGrab,Deep Diner,32,44,76
15157,2023-01-06,CARL,brawlBall,Sneaky Fields,12,15,27
15158,2023-01-06,CARL,brawlBall,Pinhole Punt,6,7,13
15159,2023-01-06,CARL,bounty,Dry Season,29,44,73
15160,2023-01-05,CARL,knockout,Out in the Open,39,15,54
15161,2023-01-05,CARL,hotZone,Split,5,1,6
15162,2023-01-05,CARL,heist,Kaboom Canyon,10,15,25
15163,2023-01-05,CARL,gemGrab,Undermine,17,36,53
15164,2023-01-05,CARL,gemGrab,Gem Fort,0,1,1
15165,2023-01-05,CARL,brawlBall,Sunny Soccer,0,1,1
15166,2023-01-05,CARL,brawlBall,Pinhole Punt,102,121,223
15167,2023-01-05,CARL,bounty,Shooting Star,3,3,6
15168,2023-01-04,CARL,knockout,Goldarm Gulch,2,3,5
15169,2023-01-04,CARL,hotZone,Parallel Plays,5,0,5
15170,2023-01-04,CARL,heist,Kaboom Canyon,15,15,30
15171,2023-01-04,CARL,gemGrab,Gem Fort,16,49,65
15172,2023-01-04,CARL,gemGrab,Crystal Arcade,5,24,29
15173,2023-01-04,CARL,brawlBall,Sunny Soccer,68,141,209
15174,2023-01-04,CARL,brawlBall,Beach Ball,0,7,7
15175,2023-01-04,CARL,bounty,Shooting Star,12,5,17
15176,2023-01-03,CARL,knockout,Goldarm Gulch,5,2,7
15177,2023-01-03,CARL,hotZone,Parallel Plays,11,5,16
15178,2023-01-03,CARL,hotZone,Controller Chaos,0,1,1
15179,2023-01-03,CARL,heist,Pit Stop,8,19,27
15180,2023-01-03,CARL,gemGrab,Minecart Madness,3,6,9
15181,2023-01-03,CARL,gemGrab,Crystal Arcade,29,59,88
15182,2023-01-03,CARL,brawlBall,Center Stage,1,6,7
15183,2023-01-03,CARL,brawlBall,Beach Ball,55,72,127
15184,2023-01-03,CARL,bounty,Hideout,10,14,24
15185,2023-01-02,CARL,knockout,Belle's Rock,25,32,57
15186,2023-01-02,CARL,hotZone,Quarter Pounder,18,31,49
15187,2023-01-02,CARL,heist,Pit Stop,14,10,24
15188,2023-01-02,CARL,gemGrab,Minecart Madness,40,30,70
15189,2023-01-02,CARL,gemGrab,Double Swoosh,7,2,9
15190,2023-01-02,CARL,brawlBall,Center Stage,39,27,66
15191,2023-01-02,CARL,brawlBall,Backyard Bowl,1,11,12
15192,2023-01-02,CARL,bounty,Hideout,20,3,23
15193,2023-01-01,CARL,knockout,Belle's Rock,15,6,21
15194,2023-01-01,CARL,hotZone,Quarter Pounder,8,5,13
15195,2023-01-01,CARL,heist,Bridge Too Far,1,2,3
15196,2023-01-01,CARL,gemGrab,Minecart Madness,1,0,1
15197,2023-01-01,CARL,gemGrab,Hard Rock Mine,0,1,1
15198,2023-01-01,CARL,gemGrab,Double Swoosh,12,14,26
15199,2023-01-01,CARL,brawlBall,Backyard Bowl,34,8,42
15200,2023-01-01,CARL,bounty,Canal Grande,4,0,4
15201,2022-12-31,CARL,knockout,Flaring Phoenix,0,1,1
15202,2022-12-31,CARL,heist,Bridge Too Far,1,0,1
15203,2022-12-31,CARL,gemGrab,Hard Rock Mine,7,9,16
15204,2022-12-31,CARL,gemGrab,Deep Diner,2,0,2
15205,2022-12-31,CARL,brawlBall,Super Beach,3,0,3
15206,2022-12-31,CARL,bounty,Canal Grande,0,2,2
15207,2022-12-30,CARL,knockout,Flaring Phoenix,1,0,1
15208,2022-12-30,CARL,gemGrab,Deep Diner,9,12,21
15209,2022-12-30,CARL,brawlBall,Sneaky Fields,1,6,7
15210,2022-12-29,CARL,hotZone,Open Zone,0,1,1
15211,2022-12-29,CARL,hotZone,Controller Chaos,1,0,1
15212,2022-12-29,CARL,gemGrab,Undermine,0,1,1
15213,2022-12-29,CARL,brawlBall,Pinhole Punt,0,3,3
15214,2022-12-28,CARL,hotZone,Open Zone,2,0,2
15215,2022-12-28,CARL,brawlBall,Sunny Soccer,0,1,1
15216,2022-12-27,CARL,hotZone,Dueling Beetles,1,0,1
15217,2022-12-27,CARL,heist,Kaboom Canyon,0,1,1
15218,2022-12-27,CARL,gemGrab,Minecart Madness,1,1,2
15219,2022-12-27,CARL,brawlBall,Center Stage,0,1,1
15220,2022-12-27,CARL,brawlBall,Beach Ball,2,1,3
15221,2022-12-25,CARL,brawlBall,Backyard Bowl,1,0,1
15222,2022-12-25,CARL,bounty,Layer Cake,0,1,1
15223,2022-12-23,CARL,knockout,Out in the Open,5,6,11
15224,2022-12-22,CARL,brawlBall,Pinhole Punt,1,0,1
15225,2022-12-19,CARL,brawlBall,Center Stage,1,0,1
15226,2022-12-18,CARL,knockout,Belle's Rock,0,1,1
15227,2022-12-13,CARL,knockout,New Perspective,1,0,1
15228,2022-12-13,CARL,gemGrab,Crystal Arcade,1,0,1
15229,2022-12-13,CARL,brawlBall,Beach Ball,1,0,1
15230,2022-12-11,CARL,brawlBall,Backyard Bowl,0,1,1
15231,2022-12-10,CARL,knockout,X Marks the Spot,1,1,2
15232,2022-12-10,CARL,hotZone,Ring of Fire,1,0,1
15233,2022-12-10,CARL,gemGrab,Hard Rock Mine,0,1,1
15234,2022-11-11,CARL,knockout,New Perspective,1,0,1
15235,2022-11-11,CARL,brawlBall,Sneaky Fields,1,0,1
15236,2022-10-28,CARL,knockout,Out in the Open,3,1,4
15237,2022-10-28,CARL,hotZone,Dueling Beetles,0,2,2
15238,2022-10-28,CARL,heist,Safe Zone,0,1,1
15239,2022-10-10,CARL,knockout,Belle's Rock,0,1,1
15240,2023-02-05,BYRON,knockout,X Marks the Spot,49,53,102
15241,2023-02-05,BYRON,knockout,Goldarm Gulch,1,1,2
15242,2023-02-05,BYRON,hotZone,Ring of Fire,24,12,36
15243,2023-02-05,BYRON,heist,Snaked Assault,6,2,8
15244,2023-02-05,BYRON,heist,Pit Stop,0,1,1
15245,2023-02-05,BYRON,gemGrab,Hard Rock Mine,14,11,25
15246,2023-02-05,BYRON,gemGrab,Double Swoosh,42,27,69
15247,2023-02-05,BYRON,brawlBall,Super Beach,4,6,10
15248,2023-02-05,BYRON,brawlBall,Sneaky Fields,2,5,7
15249,2023-02-05,BYRON,brawlBall,Backyard Bowl,389,433,822
15250,2023-02-05,BYRON,bounty,Layer Cake,28,24,52
15251,2023-02-04,BYRON,knockout,X Marks the Spot,21,17,38
15252,2023-02-04,BYRON,knockout,Goldarm Gulch,1,3,4
15253,2023-02-04,BYRON,hotZone,Ring of Fire,15,3,18
15254,2023-02-04,BYRON,heist,Tornado Ring,2,1,3
15255,2023-02-04,BYRON,gemGrab,Hard Rock Mine,19,9,28
15256,2023-02-04,BYRON,gemGrab,Double Swoosh,4,5,9
15257,2023-02-04,BYRON,gemGrab,Deep Diner,1,2,3
15258,2023-02-04,BYRON,brawlBall,Super Beach,29,25,54
15259,2023-02-04,BYRON,brawlBall,Sneaky Fields,2,2,4
15260,2023-02-04,BYRON,bounty,Dry Season,18,20,38
15261,2023-02-03,BYRON,knockout,Out in the Open,131,134,265
15262,2023-02-03,BYRON,knockout,Goldarm Gulch,13,12,25
15263,2023-02-03,BYRON,hotZone,Split,8,7,15
15264,2023-02-03,BYRON,heist,Tornado Ring,10,2,12
15265,2023-02-03,BYRON,gemGrab,Undermine,15,16,31
15266,2023-02-03,BYRON,gemGrab,Double Swoosh,11,32,43
15267,2023-02-03,BYRON,gemGrab,Deep Diner,93,85,178
15268,2023-02-03,BYRON,brawlBall,Sneaky Fields,101,93,194
15269,2023-02-03,BYRON,brawlBall,Pinhole Punt,13,6,19
15270,2023-02-03,BYRON,bounty,Dry Season,220,245,465
15271,2023-02-02,BYRON,knockout,Out in the Open,69,50,119
15272,2023-02-02,BYRON,hotZone,Split,8,4,12
15273,2023-02-02,BYRON,heist,Kaboom Canyon,3,3,6
15274,2023-02-02,BYRON,gemGrab,Undermine,10,10,20
15275,2023-02-02,BYRON,gemGrab,Gem Fort,5,3,8
15276,2023-02-02,BYRON,brawlBall,Sunny Soccer,1,0,1
15277,2023-02-02,BYRON,brawlBall,Pinhole Punt,84,94,178
15278,2023-02-02,BYRON,bounty,Shooting Star,34,24,58
15279,2023-02-01,BYRON,knockout,Goldarm Gulch,116,89,205
15280,2023-02-01,BYRON,hotZone,Parallel Plays,33,30,63
15281,2023-02-01,BYRON,heist,Kaboom Canyon,15,13,28
15282,2023-02-01,BYRON,gemGrab,Gem Fort,69,44,113
15283,2023-02-01,BYRON,gemGrab,Crystal Arcade,33,44,77
15284,2023-02-01,BYRON,brawlBall,Sunny Soccer,54,64,118
15285,2023-02-01,BYRON,brawlBall,Beach Ball,3,1,4
15286,2023-02-01,BYRON,bounty,Shooting Star,90,88,178
15287,2023-01-31,BYRON,knockout,Goldarm Gulch,59,47,106
15288,2023-01-31,BYRON,hotZone,Parallel Plays,29,35,64
15289,2023-01-31,BYRON,heist,Pit Stop,5,2,7
15290,2023-01-31,BYRON,gemGrab,Minecart Madness,1,7,8
15291,2023-01-31,BYRON,gemGrab,Crystal Arcade,40,36,76
15292,2023-01-31,BYRON,brawlBall,Center Stage,2,0,2
15293,2023-01-31,BYRON,brawlBall,Beach Ball,45,51,96
15294,2023-01-31,BYRON,bounty,Hideout,42,67,109
15295,2023-01-30,BYRON,knockout,Belle's Rock,118,145,263
15296,2023-01-30,BYRON,hotZone,Quarter Pounder,24,24,48
15297,2023-01-30,BYRON,heist,Pit Stop,1,2,3
15298,2023-01-30,BYRON,gemGrab,Minecart Madness,88,61,149
15299,2023-01-30,BYRON,gemGrab,Double Swoosh,21,23,44
15300,2023-01-30,BYRON,brawlBall,Center Stage,61,27,88
15301,2023-01-30,BYRON,brawlBall,Backyard Bowl,37,40,77
15302,2023-01-30,BYRON,bounty,Hideout,63,83,146
15303,2023-01-29,BYRON,knockout,Belle's Rock,143,139,282
15304,2023-01-29,BYRON,hotZone,Quarter Pounder,14,26,40
15305,2023-01-29,BYRON,heist,Bridge Too Far,79,82,161
15306,2023-01-29,BYRON,gemGrab,Hard Rock Mine,19,20,39
15307,2023-01-29,BYRON,gemGrab,Double Swoosh,38,17,55
15308,2023-01-29,BYRON,brawlBall,Super Beach,1,1,2
15309,2023-01-29,BYRON,brawlBall,Backyard Bowl,387,421,808
15310,2023-01-29,BYRON,bounty,Canal Grande,22,11,33
15311,2023-01-28,BYRON,knockout,Flaring Phoenix,60,43,103
15312,2023-01-28,BYRON,hotZone,Controller Chaos,19,7,26
15313,2023-01-28,BYRON,heist,Bridge Too Far,199,150,349
15314,2023-01-28,BYRON,gemGrab,Hard Rock Mine,71,60,131
15315,2023-01-28,BYRON,gemGrab,Deep Diner,46,49,95
15316,2023-01-28,BYRON,brawlBall,Super Beach,91,86,177
15317,2023-01-28,BYRON,brawlBall,Sneaky Fields,4,5,9
15318,2023-01-28,BYRON,bounty,Canal Grande,40,31,71
15319,2023-01-27,BYRON,knockout,Flaring Phoenix,25,23,48
15320,2023-01-27,BYRON,hotZone,Controller Chaos,11,4,15
15321,2023-01-27,BYRON,heist,Hot Potato,3,0,3
15322,2023-01-27,BYRON,gemGrab,Undermine,2,4,6
15323,2023-01-27,BYRON,gemGrab,Deep Diner,41,37,78
15324,2023-01-27,BYRON,brawlBall,Sneaky Fields,41,36,77
15325,2023-01-27,BYRON,brawlBall,Pinhole Punt,1,2,3
15326,2023-01-27,BYRON,bounty,Temple Ruins,24,19,43
15327,2023-01-26,BYRON,knockout,Riverside,266,261,527
15328,2023-01-26,BYRON,hotZone,Open Zone,57,52,109
15329,2023-01-26,BYRON,heist,Hot Potato,9,4,13
15330,2023-01-26,BYRON,gemGrab,Undermine,57,33,90
15331,2023-01-26,BYRON,gemGrab,Gem Fort,13,10,23
15332,2023-01-26,BYRON,brawlBall,Sunny Soccer,8,10,18
15333,2023-01-26,BYRON,brawlBall,Pinhole Punt,232,194,426
15334,2023-01-26,BYRON,bounty,Temple Ruins,44,39,83
15335,2023-01-25,BYRON,knockout,Riverside,129,132,261
15336,2023-01-25,BYRON,hotZone,Open Zone,24,14,38
15337,2023-01-25,BYRON,heist,Safe Zone,47,39,86
15338,2023-01-25,BYRON,gemGrab,Gem Fort,12,11,23
15339,2023-01-25,BYRON,gemGrab,Crystal Arcade,54,47,101
15340,2023-01-25,BYRON,brawlBall,Sunny Soccer,65,57,122
15341,2023-01-25,BYRON,brawlBall,Beach Ball,18,12,30
15342,2023-01-25,BYRON,bounty,Excel,18,24,42
15343,2023-01-24,BYRON,knockout,New Perspective,86,60,146
15344,2023-01-24,BYRON,hotZone,Dueling Beetles,22,15,37
15345,2023-01-24,BYRON,heist,Safe Zone,74,58,132
15346,2023-01-24,BYRON,gemGrab,Minecart Madness,33,24,57
15347,2023-01-24,BYRON,gemGrab,Crystal Arcade,62,74,136
15348,2023-01-24,BYRON,brawlBall,Center Stage,7,4,11
15349,2023-01-24,BYRON,brawlBall,Beach Ball,106,70,176
15350,2023-01-24,BYRON,bounty,Excel,50,38,88
15351,2023-01-23,BYRON,knockout,New Perspective,118,72,190
15352,2023-01-23,BYRON,hotZone,Dueling Beetles,28,25,53
15353,2023-01-23,BYRON,heist,Snaked Assault,11,6,17
15354,2023-01-23,BYRON,gemGrab,Minecart Madness,136,102,238
15355,2023-01-23,BYRON,gemGrab,Double Swoosh,30,13,43
15356,2023-01-23,BYRON,brawlBall,Center Stage,103,112,215
15357,2023-01-23,BYRON,brawlBall,Backyard Bowl,14,19,33
15358,2023-01-23,BYRON,bounty,Layer Cake,29,24,53
15359,2023-01-22,BYRON,knockout,X Marks the Spot,61,52,113
15360,2023-01-22,BYRON,hotZone,Ring of Fire,17,5,22
15361,2023-01-22,BYRON,heist,Snaked Assault,7,0,7
15362,2023-01-22,BYRON,gemGrab,Hard Rock Mine,17,4,21
15363,2023-01-22,BYRON,gemGrab,Double Swoosh,16,11,27
15364,2023-01-22,BYRON,brawlBall,Super Beach,6,3,9
15365,2023-01-22,BYRON,brawlBall,Backyard Bowl,215,238,453
15366,2023-01-22,BYRON,bounty,Layer Cake,15,12,27
15367,2023-01-21,BYRON,knockout,X Marks the Spot,156,126,282
15368,2023-01-21,BYRON,hotZone,Ring of Fire,59,32,91
15369,2023-01-21,BYRON,heist,Tornado Ring,13,6,19
15370,2023-01-21,BYRON,gemGrab,Hard Rock Mine,75,91,166
15371,2023-01-21,BYRON,gemGrab,Deep Diner,19,17,36
15372,2023-01-21,BYRON,brawlBall,Super Beach,133,138,271
15373,2023-01-21,BYRON,brawlBall,Sneaky Fields,1,2,3
15374,2023-01-21,BYRON,bounty,Dry Season,183,195,378
15375,2023-01-20,BYRON,knockout,Out in the Open,170,112,282
15376,2023-01-20,BYRON,hotZone,Split,12,3,15
15377,2023-01-20,BYRON,heist,Tornado Ring,6,1,7
15378,2023-01-20,BYRON,gemGrab,Undermine,48,22,70
15379,2023-01-20,BYRON,gemGrab,Deep Diner,145,95,240
15380,2023-01-20,BYRON,brawlBall,Sneaky Fields,95,71,166
15381,2023-01-20,BYRON,brawlBall,Pinhole Punt,7,5,12
15382,2023-01-20,BYRON,bounty,Dry Season,123,96,219
15383,2023-01-19,BYRON,knockout,Out in the Open,191,186,377
15384,2023-01-19,BYRON,hotZone,Split,23,14,37
15385,2023-01-19,BYRON,heist,Kaboom Canyon,36,56,92
15386,2023-01-19,BYRON,gemGrab,Undermine,77,51,128
15387,2023-01-19,BYRON,gemGrab,Gem Fort,13,10,23
15388,2023-01-19,BYRON,brawlBall,Sunny Soccer,6,2,8
15389,2023-01-19,BYRON,brawlBall,Pinhole Punt,238,186,424
15390,2023-01-19,BYRON,bounty,Shooting Star,166,147,313
15391,2023-01-18,BYRON,knockout,Goldarm Gulch,16,10,26
15392,2023-01-18,BYRON,hotZone,Parallel Plays,1,3,4
15393,2023-01-18,BYRON,heist,Kaboom Canyon,14,19,33
15394,2023-01-18,BYRON,gemGrab,Gem Fort,14,11,25
15395,2023-01-18,BYRON,gemGrab,Crystal Arcade,11,4,15
15396,2023-01-18,BYRON,brawlBall,Sunny Soccer,27,12,39
15397,2023-01-18,BYRON,brawlBall,Beach Ball,1,1,2
15398,2023-01-18,BYRON,bounty,Shooting Star,60,91,151
15399,2023-01-17,BYRON,knockout,Goldarm Gulch,7,6,13
15400,2023-01-17,BYRON,hotZone,Parallel Plays,7,5,12
15401,2023-01-17,BYRON,heist,Pit Stop,1,0,1
15402,2023-01-17,BYRON,gemGrab,Minecart Madness,4,1,5
15403,2023-01-17,BYRON,gemGrab,Crystal Arcade,5,3,8
15404,2023-01-17,BYRON,brawlBall,Beach Ball,13,4,17
15405,2023-01-17,BYRON,bounty,Hideout,8,3,11
15406,2023-01-16,BYRON,knockout,Belle's Rock,13,30,43
15407,2023-01-16,BYRON,hotZone,Quarter Pounder,7,8,15
15408,2023-01-16,BYRON,gemGrab,Minecart Madness,9,8,17
15409,2023-01-16,BYRON,gemGrab,Double Swoosh,0,1,1
15410,2023-01-16,BYRON,brawlBall,Center Stage,2,4,6
15411,2023-01-16,BYRON,brawlBall,Backyard Bowl,3,15,18
15412,2023-01-16,BYRON,bounty,Hideout,14,11,25
15413,2023-01-15,BYRON,knockout,Belle's Rock,3,8,11
15414,2023-01-15,BYRON,hotZone,Quarter Pounder,3,21,24
15415,2023-01-15,BYRON,heist,Bridge Too Far,10,15,25
15416,2023-01-15,BYRON,gemGrab,Hard Rock Mine,6,17,23
15417,2023-01-15,BYRON,gemGrab,Double Swoosh,2,2,4
15418,2023-01-15,BYRON,brawlBall,Backyard Bowl,36,21,57
15419,2023-01-15,BYRON,bounty,Canal Grande,0,1,1
15420,2023-01-14,BYRON,knockout,Flaring Phoenix,10,4,14
15421,2023-01-14,BYRON,hotZone,Controller Chaos,4,0,4
15422,2023-01-14,BYRON,heist,Bridge Too Far,18,11,29
15423,2023-01-14,BYRON,gemGrab,Hard Rock Mine,4,1,5
15424,2023-01-14,BYRON,gemGrab,Deep Diner,3,0,3
15425,2023-01-14,BYRON,brawlBall,Super Beach,18,7,25
15426,2023-01-14,BYRON,brawlBall,Sneaky Fields,1,0,1
15427,2023-01-13,BYRON,knockout,Flaring Phoenix,6,5,11
15428,2023-01-13,BYRON,hotZone,Controller Chaos,2,1,3
15429,2023-01-13,BYRON,heist,Hot Potato,1,0,1
15430,2023-01-13,BYRON,gemGrab,Deep Diner,4,3,7
15431,2023-01-13,BYRON,brawlBall,Sneaky Fields,15,11,26
15432,2023-01-13,BYRON,bounty,Temple Ruins,2,2,4
15433,2023-01-12,BYRON,knockout,Riverside,23,18,41
15434,2023-01-12,BYRON,hotZone,Open Zone,8,18,26
15435,2023-01-12,BYRON,gemGrab,Undermine,1,5,6
15436,2023-01-12,BYRON,gemGrab,Gem Fort,1,0,1
15437,2023-01-12,BYRON,brawlBall,Sunny Soccer,3,1,4
15438,2023-01-12,BYRON,brawlBall,Pinhole Punt,2,2,4
15439,2023-01-11,BYRON,knockout,Riverside,4,2,6
15440,2023-01-11,BYRON,gemGrab,Gem Fort,1,0,1
15441,2023-01-11,BYRON,brawlBall,Sunny Soccer,2,1,3
15442,2023-01-11,BYRON,bounty,Excel,2,0,2
15443,2023-01-10,BYRON,knockout,New Perspective,6,3,9
15444,2023-01-10,BYRON,hotZone,Dueling Beetles,5,9,14
15445,2023-01-10,BYRON,heist,Safe Zone,2,0,2
15446,2023-01-10,BYRON,gemGrab,Minecart Madness,7,5,12
15447,2023-01-10,BYRON,gemGrab,Crystal Arcade,11,30,41
15448,2023-01-10,BYRON,brawlBall,Center Stage,1,0,1
15449,2023-01-10,BYRON,brawlBall,Beach Ball,10,52,62
15450,2023-01-09,BYRON,knockout,New Perspective,1,1,2
15451,2023-01-09,BYRON,hotZone,Dueling Beetles,2,1,3
15452,2023-01-09,BYRON,gemGrab,Minecart Madness,20,13,33
15453,2023-01-09,BYRON,gemGrab,Double Swoosh,4,1,5
15454,2023-01-09,BYRON,brawlBall,Center Stage,6,3,9
15455,2023-01-09,BYRON,brawlBall,Backyard Bowl,1,1,2
15456,2023-01-09,BYRON,bounty,Layer Cake,10,24,34
15457,2023-01-08,BYRON,knockout,X Marks the Spot,6,14,20
15458,2023-01-08,BYRON,hotZone,Ring of Fire,3,0,3
15459,2023-01-08,BYRON,heist,Snaked Assault,1,0,1
15460,2023-01-08,BYRON,brawlBall,Super Beach,1,5,6
15461,2023-01-08,BYRON,brawlBall,Backyard Bowl,17,26,43
15462,2023-01-08,BYRON,bounty,Layer Cake,2,0,2
15463,2023-01-07,BYRON,knockout,X Marks the Spot,3,12,15
15464,2023-01-07,BYRON,gemGrab,Deep Diner,1,0,1
15465,2023-01-07,BYRON,brawlBall,Super Beach,3,20,23
15466,2023-01-07,BYRON,bounty,Dry Season,12,10,22
15467,2023-01-06,BYRON,knockout,Out in the Open,4,4,8
15468,2023-01-06,BYRON,gemGrab,Undermine,1,0,1
15469,2023-01-06,BYRON,gemGrab,Deep Diner,9,44,53
15470,2023-01-06,BYRON,brawlBall,Sneaky Fields,2,2,4
15471,2023-01-06,BYRON,brawlBall,Pinhole Punt,1,3,4
15472,2023-01-06,BYRON,bounty,Dry Season,15,16,31
15473,2023-01-05,BYRON,knockout,Out in the Open,8,7,15
15474,2023-01-05,BYRON,hotZone,Split,1,1,2
15475,2023-01-05,BYRON,heist,Kaboom Canyon,2,2,4
15476,2023-01-05,BYRON,gemGrab,Undermine,1,1,2
15477,2023-01-05,BYRON,gemGrab,Gem Fort,2,0,2
15478,2023-01-05,BYRON,brawlBall,Pinhole Punt,9,32,41
15479,2023-01-05,BYRON,bounty,Shooting Star,7,4,11
15480,2023-01-04,BYRON,knockout,Goldarm Gulch,2,0,2
15481,2023-01-04,BYRON,heist,Kaboom Canyon,7,12,19
15482,2023-01-04,BYRON,gemGrab,Crystal Arcade,1,0,1
15483,2023-01-04,BYRON,brawlBall,Sunny Soccer,3,7,10
15484,2023-01-04,BYRON,bounty,Shooting Star,32,41,73
15485,2023-01-03,BYRON,hotZone,Parallel Plays,2,11,13
15486,2023-01-03,BYRON,gemGrab,Crystal Arcade,1,0,1
15487,2023-01-03,BYRON,brawlBall,Beach Ball,4,3,7
15488,2023-01-03,BYRON,bounty,Hideout,24,27,51
15489,2023-01-02,BYRON,knockout,Belle's Rock,9,10,19
15490,2023-01-02,BYRON,hotZone,Quarter Pounder,4,13,17
15491,2023-01-02,BYRON,hotZone,Controller Chaos,0,1,1
15492,2023-01-02,BYRON,heist,Kaboom Canyon,0,1,1
15493,2023-01-02,BYRON,gemGrab,Minecart Madness,12,39,51
15494,2023-01-02,BYRON,gemGrab,Double Swoosh,3,0,3
15495,2023-01-02,BYRON,brawlBall,Center Stage,2,3,5
15496,2023-01-02,BYRON,brawlBall,Backyard Bowl,3,4,7
15497,2023-01-02,BYRON,bounty,Hideout,9,3,12
15498,2023-01-01,BYRON,knockout,Belle's Rock,7,2,9
15499,2023-01-01,BYRON,hotZone,Quarter Pounder,2,0,2
15500,2023-01-01,BYRON,heist,Bridge Too Far,5,0,5
15501,2023-01-01,BYRON,gemGrab,Minecart Madness,0,1,1
15502,2023-01-01,BYRON,brawlBall,Backyard Bowl,11,8,19
15503,2022-12-31,BYRON,heist,Bridge Too Far,2,1,3
15504,2022-12-31,BYRON,gemGrab,Minecart Madness,1,0,1
15505,2022-12-31,BYRON,gemGrab,Hard Rock Mine,3,14,17
15506,2022-12-31,BYRON,gemGrab,Deep Diner,0,2,2
15507,2022-12-31,BYRON,brawlBall,Super Beach,1,0,1
15508,2022-12-30,BYRON,gemGrab,Deep Diner,1,0,1
15509,2022-12-29,BYRON,brawlBall,Pinhole Punt,0,1,1
15510,2022-12-28,BYRON,hotZone,Open Zone,0,1,1
15511,2022-12-27,BYRON,hotZone,Dueling Beetles,1,0,1
15512,2022-12-27,BYRON,gemGrab,Minecart Madness,1,0,1
15513,2022-12-26,BYRON,gemGrab,Minecart Madness,0,1,1
15514,2022-12-25,BYRON,brawlBall,Backyard Bowl,0,1,1
15515,2022-12-23,BYRON,knockout,Out in the Open,1,0,1
15516,2022-12-13,BYRON,hotZone,Dueling Beetles,1,0,1
15517,2022-12-13,BYRON,heist,Safe Zone,0,1,1
15518,2022-12-10,BYRON,knockout,X Marks the Spot,0,1,1
15519,2022-11-07,BYRON,hotZone,Quarter Pounder,0,1,1
15520,2022-11-01,BYRON,knockout,New Perspective,0,3,3
15521,2022-10-26,BYRON,bounty,Shooting Star,1,0,1
15522,2022-10-15,BYRON,gemGrab,Hard Rock Mine,2,0,2
15523,2022-10-15,BYRON,brawlBall,Super Beach,0,1,1
15524,2022-10-10,BYRON,knockout,Belle's Rock,1,0,1
15525,2023-02-05,BUZZ,knockout,X Marks the Spot,49,20,69
15526,2023-02-05,BUZZ,knockout,Goldarm Gulch,6,6,12
15527,2023-02-05,BUZZ,hotZone,Ring of Fire,39,13,52
15528,2023-02-05,BUZZ,heist,Snaked Assault,151,116,267
15529,2023-02-05,BUZZ,heist,Pit Stop,55,97,152
15530,2023-02-05,BUZZ,gemGrab,Hard Rock Mine,42,44,86
15531,2023-02-05,BUZZ,gemGrab,Double Swoosh,200,198,398
15532,2023-02-05,BUZZ,brawlBall,Super Beach,36,30,66
15533,2023-02-05,BUZZ,brawlBall,Sneaky Fields,105,97,202
15534,2023-02-05,BUZZ,brawlBall,Backyard Bowl,542,424,966
15535,2023-02-05,BUZZ,bounty,Layer Cake,50,76,126
15536,2023-02-04,BUZZ,knockout,X Marks the Spot,19,16,35
15537,2023-02-04,BUZZ,knockout,Goldarm Gulch,4,2,6
15538,2023-02-04,BUZZ,hotZone,Ring of Fire,11,5,16
15539,2023-02-04,BUZZ,heist,Tornado Ring,16,31,47
15540,2023-02-04,BUZZ,heist,Pit Stop,40,72,112
15541,2023-02-04,BUZZ,gemGrab,Hard Rock Mine,46,44,90
15542,2023-02-04,BUZZ,gemGrab,Double Swoosh,34,24,58
15543,2023-02-04,BUZZ,gemGrab,Deep Diner,12,18,30
15544,2023-02-04,BUZZ,brawlBall,Super Beach,343,332,675
15545,2023-02-04,BUZZ,brawlBall,Sneaky Fields,107,91,198
15546,2023-02-04,BUZZ,bounty,Dry Season,6,3,9
15547,2023-02-03,BUZZ,knockout,Out in the Open,67,37,104
15548,2023-02-03,BUZZ,knockout,Goldarm Gulch,45,17,62
15549,2023-02-03,BUZZ,hotZone,Split,72,55,127
15550,2023-02-03,BUZZ,heist,Tornado Ring,245,207,452
15551,2023-02-03,BUZZ,heist,Pit Stop,297,518,815
15552,2023-02-03,BUZZ,gemGrab,Undermine,30,36,66
15553,2023-02-03,BUZZ,gemGrab,Double Swoosh,301,161,462
15554,2023-02-03,BUZZ,gemGrab,Deep Diner,134,105,239
15555,2023-02-03,BUZZ,brawlBall,Sneaky Fields,2257,2003,4260
15556,2023-02-03,BUZZ,brawlBall,Pinhole Punt,36,24,60
15557,2023-02-03,BUZZ,bounty,Dry Season,51,30,81
15558,2023-02-02,BUZZ,knockout,Out in the Open,25,10,35
15559,2023-02-02,BUZZ,hotZone,Split,37,40,77
15560,2023-02-02,BUZZ,heist,Kaboom Canyon,15,4,19
15561,2023-02-02,BUZZ,gemGrab,Undermine,34,13,47
15562,2023-02-02,BUZZ,gemGrab,Gem Fort,12,8,20
15563,2023-02-02,BUZZ,brawlBall,Sunny Soccer,11,16,27
15564,2023-02-02,BUZZ,brawlBall,Pinhole Punt,308,264,572
15565,2023-02-02,BUZZ,bounty,Shooting Star,5,1,6
15566,2023-02-01,BUZZ,knockout,Goldarm Gulch,150,128,278
15567,2023-02-01,BUZZ,hotZone,Parallel Plays,125,84,209
15568,2023-02-01,BUZZ,heist,Kaboom Canyon,36,20,56
15569,2023-02-01,BUZZ,gemGrab,Gem Fort,125,127,252
15570,2023-02-01,BUZZ,gemGrab,Crystal Arcade,58,49,107
15571,2023-02-01,BUZZ,brawlBall,Sunny Soccer,1256,1250,2506
15572,2023-02-01,BUZZ,brawlBall,Beach Ball,41,37,78
15573,2023-02-01,BUZZ,bounty,Shooting Star,9,2,11
15574,2023-01-31,BUZZ,knockout,Goldarm Gulch,60,36,96
15575,2023-01-31,BUZZ,hotZone,Parallel Plays,76,56,132
15576,2023-01-31,BUZZ,heist,Pit Stop,79,89,168
15577,2023-01-31,BUZZ,gemGrab,Minecart Madness,1,9,10
15578,2023-01-31,BUZZ,gemGrab,Crystal Arcade,64,31,95
15579,2023-01-31,BUZZ,brawlBall,Center Stage,20,21,41
15580,2023-01-31,BUZZ,brawlBall,Beach Ball,479,506,985
15581,2023-01-31,BUZZ,bounty,Hideout,12,6,18
15582,2023-01-30,BUZZ,knockout,Belle's Rock,114,82,196
15583,2023-01-30,BUZZ,hotZone,Quarter Pounder,91,86,177
15584,2023-01-30,BUZZ,heist,Pit Stop,344,394,738
15585,2023-01-30,BUZZ,gemGrab,Minecart Madness,59,42,101
15586,2023-01-30,BUZZ,gemGrab,Double Swoosh,70,65,135
15587,2023-01-30,BUZZ,brawlBall,Center Stage,1245,1229,2474
15588,2023-01-30,BUZZ,brawlBall,Backyard Bowl,51,41,92
15589,2023-01-30,BUZZ,bounty,Hideout,15,5,20
15590,2023-01-29,BUZZ,knockout,Belle's Rock,111,58,169
15591,2023-01-29,BUZZ,hotZone,Quarter Pounder,51,28,79
15592,2023-01-29,BUZZ,heist,Bridge Too Far,40,62,102
15593,2023-01-29,BUZZ,gemGrab,Hard Rock Mine,32,62,94
15594,2023-01-29,BUZZ,gemGrab,Double Swoosh,130,102,232
15595,2023-01-29,BUZZ,brawlBall,Super Beach,22,27,49
15596,2023-01-29,BUZZ,brawlBall,Backyard Bowl,603,524,1127
15597,2023-01-29,BUZZ,bounty,Canal Grande,96,78,174
15598,2023-01-28,BUZZ,knockout,Flaring Phoenix,60,46,106
15599,2023-01-28,BUZZ,hotZone,Controller Chaos,66,51,117
15600,2023-01-28,BUZZ,heist,Bridge Too Far,100,109,209
15601,2023-01-28,BUZZ,gemGrab,Hard Rock Mine,174,224,398
15602,2023-01-28,BUZZ,gemGrab,Deep Diner,40,34,74
15603,2023-01-28,BUZZ,brawlBall,Super Beach,1454,1424,2878
15604,2023-01-28,BUZZ,brawlBall,Sneaky Fields,55,57,112
15605,2023-01-28,BUZZ,bounty,Canal Grande,138,119,257
15606,2023-01-27,BUZZ,knockout,Flaring Phoenix,31,27,58
15607,2023-01-27,BUZZ,hotZone,Controller Chaos,20,14,34
15608,2023-01-27,BUZZ,heist,Hot Potato,45,32,77
15609,2023-01-27,BUZZ,gemGrab,Undermine,8,5,13
15610,2023-01-27,BUZZ,gemGrab,Deep Diner,47,47,94
15611,2023-01-27,BUZZ,brawlBall,Sneaky Fields,525,473,998
15612,2023-01-27,BUZZ,brawlBall,Pinhole Punt,8,7,15
15613,2023-01-27,BUZZ,bounty,Temple Ruins,13,7,20
15614,2023-01-26,BUZZ,knockout,Riverside,51,21,72
15615,2023-01-26,BUZZ,hotZone,Open Zone,21,18,39
15616,2023-01-26,BUZZ,heist,Hot Potato,159,208,367
15617,2023-01-26,BUZZ,gemGrab,Undermine,83,97,180
15618,2023-01-26,BUZZ,gemGrab,Gem Fort,55,75,130
15619,2023-01-26,BUZZ,brawlBall,Sunny Soccer,64,70,134
15620,2023-01-26,BUZZ,brawlBall,Pinhole Punt,996,943,1939
15621,2023-01-26,BUZZ,bounty,Temple Ruins,58,48,106
15622,2023-01-25,BUZZ,knockout,Riverside,32,11,43
15623,2023-01-25,BUZZ,hotZone,Open Zone,11,3,14
15624,2023-01-25,BUZZ,heist,Safe Zone,43,54,97
15625,2023-01-25,BUZZ,gemGrab,Gem Fort,49,38,87
15626,2023-01-25,BUZZ,gemGrab,Crystal Arcade,60,63,123
15627,2023-01-25,BUZZ,brawlBall,Sunny Soccer,824,833,1657
15628,2023-01-25,BUZZ,brawlBall,Beach Ball,126,128,254
15629,2023-01-25,BUZZ,bounty,Excel,35,51,86
15630,2023-01-24,BUZZ,knockout,New Perspective,54,46,100
15631,2023-01-24,BUZZ,hotZone,Dueling Beetles,44,37,81
15632,2023-01-24,BUZZ,heist,Safe Zone,99,79,178
15633,2023-01-24,BUZZ,gemGrab,Minecart Madness,16,18,34
15634,2023-01-24,BUZZ,gemGrab,Crystal Arcade,139,145,284
15635,2023-01-24,BUZZ,brawlBall,Center Stage,154,175,329
15636,2023-01-24,BUZZ,brawlBall,Beach Ball,1059,1053,2112
15637,2023-01-24,BUZZ,bounty,Excel,121,167,288
15638,2023-01-23,BUZZ,knockout,New Perspective,107,61,168
15639,2023-01-23,BUZZ,hotZone,Dueling Beetles,73,45,118
15640,2023-01-23,BUZZ,heist,Snaked Assault,129,143,272
15641,2023-01-23,BUZZ,gemGrab,Minecart Madness,77,54,131
15642,2023-01-23,BUZZ,gemGrab,Double Swoosh,70,48,118
15643,2023-01-23,BUZZ,brawlBall,Center Stage,2125,2249,4374
15644,2023-01-23,BUZZ,brawlBall,Backyard Bowl,28,24,52
15645,2023-01-23,BUZZ,bounty,Layer Cake,71,92,163
15646,2023-01-22,BUZZ,knockout,X Marks the Spot,34,25,59
15647,2023-01-22,BUZZ,hotZone,Ring of Fire,20,9,29
15648,2023-01-22,BUZZ,heist,Snaked Assault,79,59,138
15649,2023-01-22,BUZZ,gemGrab,Hard Rock Mine,36,23,59
15650,2023-01-22,BUZZ,gemGrab,Double Swoosh,111,57,168
15651,2023-01-22,BUZZ,brawlBall,Super Beach,137,111,248
15652,2023-01-22,BUZZ,brawlBall,Backyard Bowl,250,215,465
15653,2023-01-22,BUZZ,bounty,Layer Cake,53,42,95
15654,2023-01-21,BUZZ,knockout,X Marks the Spot,116,89,205
15655,2023-01-21,BUZZ,hotZone,Ring of Fire,56,29,85
15656,2023-01-21,BUZZ,heist,Tornado Ring,133,92,225
15657,2023-01-21,BUZZ,gemGrab,Hard Rock Mine,203,154,357
15658,2023-01-21,BUZZ,gemGrab,Deep Diner,32,36,68
15659,2023-01-21,BUZZ,brawlBall,Super Beach,1964,1798,3762
15660,2023-01-21,BUZZ,brawlBall,Sneaky Fields,66,58,124
15661,2023-01-21,BUZZ,bounty,Dry Season,33,39,72
15662,2023-01-20,BUZZ,knockout,Out in the Open,55,35,90
15663,2023-01-20,BUZZ,hotZone,Split,95,65,160
15664,2023-01-20,BUZZ,heist,Tornado Ring,139,185,324
15665,2023-01-20,BUZZ,gemGrab,Undermine,50,38,88
15666,2023-01-20,BUZZ,gemGrab,Deep Diner,151,105,256
15667,2023-01-20,BUZZ,brawlBall,Sneaky Fields,1604,1483,3087
15668,2023-01-20,BUZZ,brawlBall,Pinhole Punt,43,40,83
15669,2023-01-20,BUZZ,bounty,Dry Season,37,21,58
15670,2023-01-19,BUZZ,knockout,Out in the Open,87,68,155
15671,2023-01-19,BUZZ,hotZone,Split,135,115,250
15672,2023-01-19,BUZZ,heist,Kaboom Canyon,29,42,71
15673,2023-01-19,BUZZ,gemGrab,Undermine,124,132,256
15674,2023-01-19,BUZZ,gemGrab,Gem Fort,27,13,40
15675,2023-01-19,BUZZ,brawlBall,Sunny Soccer,36,36,72
15676,2023-01-19,BUZZ,brawlBall,Pinhole Punt,1035,950,1985
15677,2023-01-19,BUZZ,bounty,Shooting Star,19,11,30
15678,2023-01-18,BUZZ,knockout,Goldarm Gulch,13,6,19
15679,2023-01-18,BUZZ,hotZone,Parallel Plays,7,3,10
15680,2023-01-18,BUZZ,heist,Kaboom Canyon,15,14,29
15681,2023-01-18,BUZZ,gemGrab,Gem Fort,31,25,56
15682,2023-01-18,BUZZ,gemGrab,Crystal Arcade,10,5,15
15683,2023-01-18,BUZZ,brawlBall,Sunny Soccer,320,340,660
15684,2023-01-18,BUZZ,brawlBall,Beach Ball,20,24,44
15685,2023-01-18,BUZZ,bounty,Shooting Star,6,2,8
15686,2023-01-17,BUZZ,knockout,Goldarm Gulch,23,20,43
15687,2023-01-17,BUZZ,hotZone,Parallel Plays,19,9,28
15688,2023-01-17,BUZZ,heist,Pit Stop,34,35,69
15689,2023-01-17,BUZZ,gemGrab,Minecart Madness,0,1,1
15690,2023-01-17,BUZZ,gemGrab,Crystal Arcade,14,14,28
15691,2023-01-17,BUZZ,brawlBall,Center Stage,3,6,9
15692,2023-01-17,BUZZ,brawlBall,Beach Ball,107,105,212
15693,2023-01-16,BUZZ,knockout,Belle's Rock,7,5,12
15694,2023-01-16,BUZZ,hotZone,Quarter Pounder,9,10,19
15695,2023-01-16,BUZZ,heist,Pit Stop,118,131,249
15696,2023-01-16,BUZZ,gemGrab,Minecart Madness,4,3,7
15697,2023-01-16,BUZZ,gemGrab,Double Swoosh,14,12,26
15698,2023-01-16,BUZZ,brawlBall,Center Stage,120,102,222
15699,2023-01-16,BUZZ,brawlBall,Backyard Bowl,12,6,18
15700,2023-01-16,BUZZ,bounty,Hideout,3,0,3
15701,2023-01-15,BUZZ,knockout,Belle's Rock,16,7,23
15702,2023-01-15,BUZZ,hotZone,Quarter Pounder,22,19,41
15703,2023-01-15,BUZZ,heist,Bridge Too Far,15,11,26
15704,2023-01-15,BUZZ,gemGrab,Hard Rock Mine,8,10,18
15705,2023-01-15,BUZZ,gemGrab,Double Swoosh,16,12,28
15706,2023-01-15,BUZZ,brawlBall,Super Beach,15,17,32
15707,2023-01-15,BUZZ,brawlBall,Backyard Bowl,68,42,110
15708,2023-01-15,BUZZ,bounty,Canal Grande,11,8,19
15709,2023-01-14,BUZZ,knockout,Flaring Phoenix,0,1,1
15710,2023-01-14,BUZZ,hotZone,Controller Chaos,22,8,30
15711,2023-01-14,BUZZ,heist,Bridge Too Far,19,10,29
15712,2023-01-14,BUZZ,gemGrab,Hard Rock Mine,6,25,31
15713,2023-01-14,BUZZ,gemGrab,Deep Diner,2,3,5
15714,2023-01-14,BUZZ,brawlBall,Super Beach,96,99,195
15715,2023-01-14,BUZZ,brawlBall,Sneaky Fields,13,4,17
15716,2023-01-14,BUZZ,bounty,Canal Grande,16,11,27
15717,2023-01-13,BUZZ,knockout,Flaring Phoenix,11,4,15
15718,2023-01-13,BUZZ,hotZone,Controller Chaos,12,3,15
15719,2023-01-13,BUZZ,heist,Hot Potato,8,16,24
15720,2023-01-13,BUZZ,gemGrab,Deep Diner,25,21,46
15721,2023-01-13,BUZZ,brawlBall,Sneaky Fields,120,113,233
15722,2023-01-13,BUZZ,bounty,Temple Ruins,2,4,6
15723,2023-01-12,BUZZ,knockout,Riverside,2,0,2
15724,2023-01-12,BUZZ,hotZone,Open Zone,2,0,2
15725,2023-01-12,BUZZ,heist,Hot Potato,3,1,4
15726,2023-01-12,BUZZ,gemGrab,Undermine,7,6,13
15727,2023-01-12,BUZZ,gemGrab,Gem Fort,1,0,1
15728,2023-01-12,BUZZ,brawlBall,Sunny Soccer,4,2,6
15729,2023-01-12,BUZZ,brawlBall,Pinhole Punt,38,63,101
15730,2023-01-12,BUZZ,bounty,Temple Ruins,1,0,1
15731,2023-01-11,BUZZ,knockout,Riverside,0,1,1
15732,2023-01-11,BUZZ,hotZone,Open Zone,1,1,2
15733,2023-01-11,BUZZ,gemGrab,Gem Fort,4,2,6
15734,2023-01-11,BUZZ,brawlBall,Sunny Soccer,36,26,62
15735,2023-01-11,BUZZ,brawlBall,Beach Ball,2,0,2
15736,2023-01-11,BUZZ,bounty,Excel,3,0,3
15737,2023-01-10,BUZZ,knockout,New Perspective,1,1,2
15738,2023-01-10,BUZZ,hotZone,Dueling Beetles,12,3,15
15739,2023-01-10,BUZZ,heist,Safe Zone,8,6,14
15740,2023-01-10,BUZZ,gemGrab,Minecart Madness,4,1,5
15741,2023-01-10,BUZZ,gemGrab,Crystal Arcade,14,26,40
15742,2023-01-10,BUZZ,brawlBall,Center Stage,11,2,13
15743,2023-01-10,BUZZ,brawlBall,Beach Ball,59,64,123
15744,2023-01-10,BUZZ,bounty,Excel,3,10,13
15745,2023-01-09,BUZZ,knockout,New Perspective,2,0,2
15746,2023-01-09,BUZZ,hotZone,Dueling Beetles,2,0,2
15747,2023-01-09,BUZZ,heist,Snaked Assault,16,31,47
15748,2023-01-09,BUZZ,gemGrab,Minecart Madness,10,6,16
15749,2023-01-09,BUZZ,gemGrab,Double Swoosh,11,1,12
15750,2023-01-09,BUZZ,brawlBall,Center Stage,136,99,235
15751,2023-01-09,BUZZ,brawlBall,Backyard Bowl,5,20,25
15752,2023-01-09,BUZZ,bounty,Layer Cake,6,8,14
15753,2023-01-08,BUZZ,knockout,X Marks the Spot,5,0,5
15754,2023-01-08,BUZZ,hotZone,Ring of Fire,3,2,5
15755,2023-01-08,BUZZ,heist,Snaked Assault,11,21,32
15756,2023-01-08,BUZZ,gemGrab,Hard Rock Mine,2,1,3
15757,2023-01-08,BUZZ,gemGrab,Double Swoosh,10,2,12
15758,2023-01-08,BUZZ,brawlBall,Super Beach,18,9,27
15759,2023-01-08,BUZZ,brawlBall,Backyard Bowl,37,37,74
15760,2023-01-08,BUZZ,bounty,Layer Cake,2,3,5
15761,2023-01-07,BUZZ,heist,Tornado Ring,20,37,57
15762,2023-01-07,BUZZ,gemGrab,Hard Rock Mine,8,2,10
15763,2023-01-07,BUZZ,gemGrab,Deep Diner,8,9,17
15764,2023-01-07,BUZZ,brawlBall,Super Beach,40,27,67
15765,2023-01-07,BUZZ,brawlBall,Sneaky Fields,4,3,7
15766,2023-01-07,BUZZ,bounty,Dry Season,4,3,7
15767,2023-01-06,BUZZ,knockout,Out in the Open,4,0,4
15768,2023-01-06,BUZZ,hotZone,Split,5,19,24
15769,2023-01-06,BUZZ,heist,Tornado Ring,35,23,58
15770,2023-01-06,BUZZ,gemGrab,Undermine,3,0,3
15771,2023-01-06,BUZZ,gemGrab,Deep Diner,10,7,17
15772,2023-01-06,BUZZ,brawlBall,Sneaky Fields,76,50,126
15773,2023-01-06,BUZZ,brawlBall,Pinhole Punt,4,15,19
15774,2023-01-06,BUZZ,bounty,Dry Season,2,1,3
15775,2023-01-05,BUZZ,knockout,Out in the Open,4,1,5
15776,2023-01-05,BUZZ,hotZone,Split,24,38,62
15777,2023-01-05,BUZZ,heist,Kaboom Canyon,5,0,5
15778,2023-01-05,BUZZ,gemGrab,Undermine,17,12,29
15779,2023-01-05,BUZZ,gemGrab,Gem Fort,1,1,2
15780,2023-01-05,BUZZ,brawlBall,Sunny Soccer,3,1,4
15781,2023-01-05,BUZZ,brawlBall,Pinhole Punt,91,45,136
15782,2023-01-04,BUZZ,knockout,Goldarm Gulch,3,0,3
15783,2023-01-04,BUZZ,hotZone,Parallel Plays,1,2,3
15784,2023-01-04,BUZZ,heist,Kaboom Canyon,10,4,14
15785,2023-01-04,BUZZ,gemGrab,Gem Fort,18,33,51
15786,2023-01-04,BUZZ,gemGrab,Crystal Arcade,6,5,11
15787,2023-01-04,BUZZ,brawlBall,Sunny Soccer,113,136,249
15788,2023-01-04,BUZZ,brawlBall,Beach Ball,1,5,6
15789,2023-01-04,BUZZ,bounty,Shooting Star,1,0,1
15790,2023-01-03,BUZZ,knockout,Goldarm Gulch,1,0,1
15791,2023-01-03,BUZZ,hotZone,Parallel Plays,14,20,34
15792,2023-01-03,BUZZ,hotZone,Controller Chaos,1,0,1
15793,2023-01-03,BUZZ,heist,Pit Stop,50,61,111
15794,2023-01-03,BUZZ,gemGrab,Minecart Madness,2,0,2
15795,2023-01-03,BUZZ,gemGrab,Crystal Arcade,15,20,35
15796,2023-01-03,BUZZ,brawlBall,Center Stage,4,2,6
15797,2023-01-03,BUZZ,brawlBall,Beach Ball,76,56,132
15798,2023-01-02,BUZZ,knockout,Belle's Rock,4,0,4
15799,2023-01-02,BUZZ,hotZone,Quarter Pounder,15,4,19
15800,2023-01-02,BUZZ,heist,Pit Stop,82,158,240
15801,2023-01-02,BUZZ,gemGrab,Minecart Madness,6,3,9
15802,2023-01-02,BUZZ,gemGrab,Double Swoosh,2,2,4
15803,2023-01-02,BUZZ,brawlBall,Center Stage,113,130,243
15804,2023-01-02,BUZZ,brawlBall,Backyard Bowl,3,0,3
15805,2023-01-02,BUZZ,bounty,Hideout,7,0,7
15806,2023-01-01,BUZZ,knockout,Belle's Rock,3,1,4
15807,2023-01-01,BUZZ,hotZone,Quarter Pounder,5,10,15
15808,2023-01-01,BUZZ,heist,Bridge Too Far,3,3,6
15809,2023-01-01,BUZZ,gemGrab,Double Swoosh,6,0,6
15810,2023-01-01,BUZZ,brawlBall,Backyard Bowl,15,1,16
15811,2023-01-01,BUZZ,bounty,Canal Grande,2,0,2
15812,2022-12-31,BUZZ,hotZone,Controller Chaos,4,6,10
15813,2022-12-31,BUZZ,heist,Bridge Too Far,1,1,2
15814,2022-12-31,BUZZ,gemGrab,Hard Rock Mine,5,0,5
15815,2022-12-31,BUZZ,gemGrab,Deep Diner,0,2,2
15816,2022-12-31,BUZZ,brawlBall,Super Beach,14,6,20
15817,2022-12-31,BUZZ,bounty,Canal Grande,2,0,2
15818,2022-12-30,BUZZ,hotZone,Controller Chaos,0,1,1
15819,2022-12-30,BUZZ,gemGrab,Minecart Madness,0,1,1
15820,2022-12-30,BUZZ,gemGrab,Deep Diner,3,2,5
15821,2022-12-30,BUZZ,brawlBall,Sneaky Fields,5,5,10
15822,2022-12-29,BUZZ,heist,Kaboom Canyon,1,0,1
15823,2022-12-29,BUZZ,brawlBall,Pinhole Punt,0,9,9
15824,2022-12-28,BUZZ,brawlBall,Sunny Soccer,0,1,1
15825,2022-12-27,BUZZ,hotZone,Controller Chaos,1,1,2
15826,2022-12-27,BUZZ,brawlBall,Center Stage,0,1,1
15827,2022-12-27,BUZZ,brawlBall,Beach Ball,3,1,4
15828,2022-12-27,BUZZ,bounty,Excel,3,1,4
15829,2022-12-26,BUZZ,hotZone,Controller Chaos,1,0,1
15830,2022-12-26,BUZZ,gemGrab,Minecart Madness,2,0,2
15831,2022-12-26,BUZZ,brawlBall,Center Stage,1,2,3
15832,2022-12-25,BUZZ,gemGrab,Double Swoosh,1,0,1
15833,2022-12-24,BUZZ,brawlBall,Super Beach,1,0,1
15834,2022-12-23,BUZZ,brawlBall,Sneaky Fields,0,1,1
15835,2022-12-22,BUZZ,brawlBall,Pinhole Punt,3,2,5
15836,2022-12-20,BUZZ,brawlBall,Beach Ball,4,4,8
15837,2022-12-19,BUZZ,brawlBall,Center Stage,1,1,2
15838,2022-12-11,BUZZ,brawlBall,Backyard Bowl,1,1,2
15839,2022-11-01,BUZZ,knockout,New Perspective,1,0,1
15840,2022-10-30,BUZZ,brawlBall,Beach Ball,1,0,1
15841,2022-10-15,BUZZ,gemGrab,Hard Rock Mine,1,1,2
15842,2022-10-10,BUZZ,knockout,Belle's Rock,0,1,1
15843,2023-02-05,BUSTER,knockout,X Marks the Spot,25,20,45
15844,2023-02-05,BUSTER,knockout,Goldarm Gulch,5,3,8
15845,2023-02-05,BUSTER,hotZone,Ring of Fire,35,37,72
15846,2023-02-05,BUSTER,heist,Snaked Assault,5,2,7
15847,2023-02-05,BUSTER,heist,Pit Stop,1,0,1
15848,2023-02-05,BUSTER,gemGrab,Hard Rock Mine,13,10,23
15849,2023-02-05,BUSTER,gemGrab,Double Swoosh,112,182,294
15850,2023-02-05,BUSTER,brawlBall,Super Beach,11,12,23
15851,2023-02-05,BUSTER,brawlBall,Sneaky Fields,36,34,70
15852,2023-02-05,BUSTER,brawlBall,Backyard Bowl,87,72,159
15853,2023-02-05,BUSTER,bounty,Layer Cake,13,14,27
15854,2023-02-04,BUSTER,knockout,X Marks the Spot,7,3,10
15855,2023-02-04,BUSTER,knockout,Goldarm Gulch,3,2,5
15856,2023-02-04,BUSTER,hotZone,Ring of Fire,9,4,13
15857,2023-02-04,BUSTER,heist,Pit Stop,1,0,1
15858,2023-02-04,BUSTER,gemGrab,Hard Rock Mine,13,26,39
15859,2023-02-04,BUSTER,gemGrab,Double Swoosh,11,24,35
15860,2023-02-04,BUSTER,gemGrab,Deep Diner,3,3,6
15861,2023-02-04,BUSTER,brawlBall,Super Beach,93,115,208
15862,2023-02-04,BUSTER,brawlBall,Sneaky Fields,29,24,53
15863,2023-02-04,BUSTER,bounty,Dry Season,1,2,3
15864,2023-02-03,BUSTER,knockout,Out in the Open,24,15,39
15865,2023-02-03,BUSTER,knockout,Goldarm Gulch,19,9,28
15866,2023-02-03,BUSTER,hotZone,Split,27,40,67
15867,2023-02-03,BUSTER,heist,Tornado Ring,11,3,14
15868,2023-02-03,BUSTER,heist,Pit Stop,8,6,14
15869,2023-02-03,BUSTER,gemGrab,Undermine,12,12,24
15870,2023-02-03,BUSTER,gemGrab,Double Swoosh,124,163,287
15871,2023-02-03,BUSTER,gemGrab,Deep Diner,42,39,81
15872,2023-02-03,BUSTER,brawlBall,Sneaky Fields,504,499,1003
15873,2023-02-03,BUSTER,brawlBall,Pinhole Punt,12,23,35
15874,2023-02-03,BUSTER,bounty,Dry Season,8,7,15
15875,2023-02-02,BUSTER,knockout,Out in the Open,8,5,13
15876,2023-02-02,BUSTER,hotZone,Split,15,23,38
15877,2023-02-02,BUSTER,heist,Kaboom Canyon,0,2,2
15878,2023-02-02,BUSTER,gemGrab,Undermine,10,11,21
15879,2023-02-02,BUSTER,gemGrab,Gem Fort,5,3,8
15880,2023-02-02,BUSTER,brawlBall,Sunny Soccer,4,3,7
15881,2023-02-02,BUSTER,brawlBall,Pinhole Punt,76,118,194
15882,2023-02-02,BUSTER,bounty,Shooting Star,1,0,1
15883,2023-02-01,BUSTER,knockout,Goldarm Gulch,54,57,111
15884,2023-02-01,BUSTER,hotZone,Parallel Plays,73,71,144
15885,2023-02-01,BUSTER,heist,Kaboom Canyon,7,2,9
15886,2023-02-01,BUSTER,gemGrab,Gem Fort,45,53,98
15887,2023-02-01,BUSTER,gemGrab,Crystal Arcade,31,31,62
15888,2023-02-01,BUSTER,brawlBall,Sunny Soccer,188,190,378
15889,2023-02-01,BUSTER,brawlBall,Beach Ball,14,13,27
15890,2023-02-01,BUSTER,bounty,Shooting Star,2,0,2
15891,2023-01-31,BUSTER,knockout,Goldarm Gulch,33,54,87
15892,2023-01-31,BUSTER,hotZone,Parallel Plays,32,41,73
15893,2023-01-31,BUSTER,heist,Pit Stop,1,1,2
15894,2023-01-31,BUSTER,gemGrab,Minecart Madness,3,3,6
15895,2023-01-31,BUSTER,gemGrab,Crystal Arcade,27,29,56
15896,2023-01-31,BUSTER,brawlBall,Center Stage,4,4,8
15897,2023-01-31,BUSTER,brawlBall,Beach Ball,87,109,196
15898,2023-01-31,BUSTER,bounty,Hideout,5,2,7
15899,2023-01-30,BUSTER,knockout,Belle's Rock,16,12,28
15900,2023-01-30,BUSTER,hotZone,Quarter Pounder,54,87,141
15901,2023-01-30,BUSTER,heist,Pit Stop,5,1,6
15902,2023-01-30,BUSTER,gemGrab,Minecart Madness,17,26,43
15903,2023-01-30,BUSTER,gemGrab,Double Swoosh,63,66,129
15904,2023-01-30,BUSTER,brawlBall,Center Stage,247,258,505
15905,2023-01-30,BUSTER,brawlBall,Backyard Bowl,7,17,24
15906,2023-01-30,BUSTER,bounty,Hideout,1,1,2
15907,2023-01-29,BUSTER,knockout,Belle's Rock,22,19,41
15908,2023-01-29,BUSTER,hotZone,Quarter Pounder,64,83,147
15909,2023-01-29,BUSTER,heist,Bridge Too Far,2,6,8
15910,2023-01-29,BUSTER,gemGrab,Hard Rock Mine,14,9,23
15911,2023-01-29,BUSTER,gemGrab,Double Swoosh,94,139,233
15912,2023-01-29,BUSTER,brawlBall,Super Beach,9,18,27
15913,2023-01-29,BUSTER,brawlBall,Backyard Bowl,83,87,170
15914,2023-01-29,BUSTER,bounty,Canal Grande,20,17,37
15915,2023-01-28,BUSTER,knockout,Flaring Phoenix,24,31,55
15916,2023-01-28,BUSTER,hotZone,Controller Chaos,80,78,158
15917,2023-01-28,BUSTER,heist,Bridge Too Far,5,0,5
15918,2023-01-28,BUSTER,gemGrab,Hard Rock Mine,53,81,134
15919,2023-01-28,BUSTER,gemGrab,Deep Diner,16,12,28
15920,2023-01-28,BUSTER,brawlBall,Super Beach,328,344,672
15921,2023-01-28,BUSTER,brawlBall,Sneaky Fields,28,20,48
15922,2023-01-28,BUSTER,bounty,Canal Grande,70,76,146
15923,2023-01-27,BUSTER,knockout,Flaring Phoenix,18,18,36
15924,2023-01-27,BUSTER,hotZone,Controller Chaos,12,10,22
15925,2023-01-27,BUSTER,heist,Hot Potato,5,0,5
15926,2023-01-27,BUSTER,gemGrab,Undermine,4,7,11
15927,2023-01-27,BUSTER,gemGrab,Deep Diner,27,19,46
15928,2023-01-27,BUSTER,brawlBall,Sneaky Fields,107,120,227
15929,2023-01-27,BUSTER,brawlBall,Pinhole Punt,1,0,1
15930,2023-01-27,BUSTER,bounty,Temple Ruins,17,33,50
15931,2023-01-26,BUSTER,knockout,Riverside,18,4,22
15932,2023-01-26,BUSTER,hotZone,Open Zone,22,16,38
15933,2023-01-26,BUSTER,heist,Hot Potato,6,4,10
15934,2023-01-26,BUSTER,gemGrab,Undermine,64,62,126
15935,2023-01-26,BUSTER,gemGrab,Gem Fort,22,17,39
15936,2023-01-26,BUSTER,brawlBall,Sunny Soccer,8,5,13
15937,2023-01-26,BUSTER,brawlBall,Pinhole Punt,234,309,543
15938,2023-01-26,BUSTER,bounty,Temple Ruins,18,17,35
15939,2023-01-25,BUSTER,knockout,Riverside,1,4,5
15940,2023-01-25,BUSTER,hotZone,Open Zone,5,8,13
15941,2023-01-25,BUSTER,heist,Safe Zone,3,0,3
15942,2023-01-25,BUSTER,gemGrab,Gem Fort,23,29,52
15943,2023-01-25,BUSTER,gemGrab,Crystal Arcade,35,35,70
15944,2023-01-25,BUSTER,brawlBall,Sunny Soccer,203,242,445
15945,2023-01-25,BUSTER,brawlBall,Beach Ball,30,52,82
15946,2023-01-25,BUSTER,bounty,Excel,2,3,5
15947,2023-01-24,BUSTER,knockout,New Perspective,33,59,92
15948,2023-01-24,BUSTER,hotZone,Dueling Beetles,73,71,144
15949,2023-01-24,BUSTER,heist,Safe Zone,7,3,10
15950,2023-01-24,BUSTER,gemGrab,Minecart Madness,4,3,7
15951,2023-01-24,BUSTER,gemGrab,Crystal Arcade,68,61,129
15952,2023-01-24,BUSTER,brawlBall,Center Stage,62,49,111
15953,2023-01-24,BUSTER,brawlBall,Beach Ball,238,229,467
15954,2023-01-24,BUSTER,bounty,Excel,18,13,31
15955,2023-01-23,BUSTER,knockout,New Perspective,58,66,124
15956,2023-01-23,BUSTER,hotZone,Dueling Beetles,108,69,177
15957,2023-01-23,BUSTER,heist,Snaked Assault,6,1,7
15958,2023-01-23,BUSTER,gemGrab,Minecart Madness,53,35,88
15959,2023-01-23,BUSTER,gemGrab,Double Swoosh,37,34,71
15960,2023-01-23,BUSTER,brawlBall,Center Stage,511,542,1053
15961,2023-01-23,BUSTER,brawlBall,Backyard Bowl,1,4,5
15962,2023-01-23,BUSTER,bounty,Layer Cake,28,31,59
15963,2023-01-22,BUSTER,knockout,X Marks the Spot,25,10,35
15964,2023-01-22,BUSTER,hotZone,Ring of Fire,39,36,75
15965,2023-01-22,BUSTER,heist,Snaked Assault,4,0,4
15966,2023-01-22,BUSTER,gemGrab,Hard Rock Mine,13,13,26
15967,2023-01-22,BUSTER,gemGrab,Double Swoosh,54,52,106
15968,2023-01-22,BUSTER,brawlBall,Super Beach,26,26,52
15969,2023-01-22,BUSTER,brawlBall,Backyard Bowl,47,44,91
15970,2023-01-22,BUSTER,bounty,Layer Cake,11,19,30
15971,2023-01-21,BUSTER,knockout,X Marks the Spot,91,58,149
15972,2023-01-21,BUSTER,hotZone,Ring of Fire,126,97,223
15973,2023-01-21,BUSTER,heist,Tornado Ring,9,9,18
15974,2023-01-21,BUSTER,gemGrab,Hard Rock Mine,95,77,172
15975,2023-01-21,BUSTER,gemGrab,Deep Diner,12,15,27
15976,2023-01-21,BUSTER,brawlBall,Super Beach,518,564,1082
15977,2023-01-21,BUSTER,brawlBall,Sneaky Fields,20,15,35
15978,2023-01-21,BUSTER,bounty,Dry Season,13,6,19
15979,2023-01-20,BUSTER,knockout,Out in the Open,38,24,62
15980,2023-01-20,BUSTER,hotZone,Split,62,56,118
15981,2023-01-20,BUSTER,heist,Tornado Ring,9,2,11
15982,2023-01-20,BUSTER,gemGrab,Undermine,21,13,34
15983,2023-01-20,BUSTER,gemGrab,Deep Diner,71,79,150
15984,2023-01-20,BUSTER,brawlBall,Sneaky Fields,463,459,922
15985,2023-01-20,BUSTER,brawlBall,Pinhole Punt,12,10,22
15986,2023-01-20,BUSTER,bounty,Dry Season,6,6,12
15987,2023-01-19,BUSTER,knockout,Out in the Open,48,62,110
15988,2023-01-19,BUSTER,hotZone,Split,84,91,175
15989,2023-01-19,BUSTER,heist,Kaboom Canyon,4,3,7
15990,2023-01-19,BUSTER,gemGrab,Undermine,75,76,151
15991,2023-01-19,BUSTER,gemGrab,Gem Fort,16,22,38
15992,2023-01-19,BUSTER,brawlBall,Sunny Soccer,8,10,18
15993,2023-01-19,BUSTER,brawlBall,Pinhole Punt,303,370,673
15994,2023-01-19,BUSTER,bounty,Shooting Star,11,5,16
15995,2023-01-18,BUSTER,knockout,Goldarm Gulch,8,10,18
15996,2023-01-18,BUSTER,hotZone,Parallel Plays,12,9,21
15997,2023-01-18,BUSTER,heist,Kaboom Canyon,1,1,2
15998,2023-01-18,BUSTER,gemGrab,Gem Fort,15,45,60
15999,2023-01-18,BUSTER,gemGrab,Crystal Arcade,7,2,9
16000,2023-01-18,BUSTER,brawlBall,Sunny Soccer,84,126,210
16001,2023-01-18,BUSTER,brawlBall,Beach Ball,0,2,2
16002,2023-01-18,BUSTER,bounty,Shooting Star,3,0,3
16003,2023-01-17,BUSTER,knockout,Goldarm Gulch,13,25,38
16004,2023-01-17,BUSTER,hotZone,Parallel Plays,7,17,24
16005,2023-01-17,BUSTER,heist,Pit Stop,0,3,3
16006,2023-01-17,BUSTER,gemGrab,Minecart Madness,1,2,3
16007,2023-01-17,BUSTER,gemGrab,Crystal Arcade,12,14,26
16008,2023-01-17,BUSTER,brawlBall,Center Stage,3,9,12
16009,2023-01-17,BUSTER,brawlBall,Beach Ball,25,43,68
16010,2023-01-16,BUSTER,knockout,Belle's Rock,2,0,2
16011,2023-01-16,BUSTER,hotZone,Quarter Pounder,10,8,18
16012,2023-01-16,BUSTER,heist,Pit Stop,1,0,1
16013,2023-01-16,BUSTER,gemGrab,Minecart Madness,3,2,5
16014,2023-01-16,BUSTER,gemGrab,Double Swoosh,5,2,7
16015,2023-01-16,BUSTER,brawlBall,Center Stage,38,30,68
16016,2023-01-16,BUSTER,brawlBall,Backyard Bowl,2,1,3
16017,2023-01-16,BUSTER,bounty,Hideout,2,1,3
16018,2023-01-15,BUSTER,knockout,Belle's Rock,5,6,11
16019,2023-01-15,BUSTER,hotZone,Quarter Pounder,36,7,43
16020,2023-01-15,BUSTER,heist,Bridge Too Far,1,0,1
16021,2023-01-15,BUSTER,gemGrab,Hard Rock Mine,3,4,7
16022,2023-01-15,BUSTER,gemGrab,Double Swoosh,27,31,58
16023,2023-01-15,BUSTER,brawlBall,Super Beach,5,31,36
16024,2023-01-15,BUSTER,brawlBall,Backyard Bowl,27,29,56
16025,2023-01-15,BUSTER,bounty,Canal Grande,10,4,14
16026,2023-01-14,BUSTER,knockout,Flaring Phoenix,7,2,9
16027,2023-01-14,BUSTER,hotZone,Controller Chaos,45,22,67
16028,2023-01-14,BUSTER,heist,Bridge Too Far,2,0,2
16029,2023-01-14,BUSTER,gemGrab,Hard Rock Mine,8,8,16
16030,2023-01-14,BUSTER,gemGrab,Deep Diner,4,3,7
16031,2023-01-14,BUSTER,brawlBall,Super Beach,48,28,76
16032,2023-01-14,BUSTER,brawlBall,Sneaky Fields,15,19,34
16033,2023-01-14,BUSTER,bounty,Canal Grande,9,7,16
16034,2023-01-13,BUSTER,knockout,Flaring Phoenix,7,4,11
16035,2023-01-13,BUSTER,hotZone,Controller Chaos,55,107,162
16036,2023-01-13,BUSTER,gemGrab,Undermine,0,2,2
16037,2023-01-13,BUSTER,gemGrab,Deep Diner,6,13,19
16038,2023-01-13,BUSTER,brawlBall,Sneaky Fields,74,105,179
16039,2023-01-13,BUSTER,brawlBall,Pinhole Punt,2,2,4
16040,2023-01-13,BUSTER,bounty,Temple Ruins,1,2,3
16041,2023-01-12,BUSTER,knockout,Riverside,2,0,2
16042,2023-01-12,BUSTER,hotZone,Open Zone,10,6,16
16043,2023-01-12,BUSTER,gemGrab,Undermine,11,4,15
16044,2023-01-12,BUSTER,gemGrab,Gem Fort,7,9,16
16045,2023-01-12,BUSTER,brawlBall,Sunny Soccer,4,2,6
16046,2023-01-12,BUSTER,brawlBall,Pinhole Punt,32,34,66
16047,2023-01-12,BUSTER,bounty,Temple Ruins,1,0,1
16048,2023-01-11,BUSTER,hotZone,Open Zone,1,0,1
16049,2023-01-11,BUSTER,gemGrab,Gem Fort,20,7,27
16050,2023-01-11,BUSTER,brawlBall,Sunny Soccer,40,36,76
16051,2023-01-11,BUSTER,brawlBall,Beach Ball,1,0,1
16052,2023-01-11,BUSTER,bounty,Excel,1,1,2
16053,2023-01-10,BUSTER,knockout,New Perspective,4,1,5
16054,2023-01-10,BUSTER,hotZone,Dueling Beetles,50,66,116
16055,2023-01-10,BUSTER,heist,Safe Zone,2,0,2
16056,2023-01-10,BUSTER,gemGrab,Minecart Madness,5,4,9
16057,2023-01-10,BUSTER,gemGrab,Crystal Arcade,39,36,75
16058,2023-01-10,BUSTER,brawlBall,Center Stage,18,19,37
16059,2023-01-10,BUSTER,brawlBall,Beach Ball,106,100,206
16060,2023-01-10,BUSTER,bounty,Excel,4,1,5
16061,2023-01-09,BUSTER,knockout,New Perspective,16,2,18
16062,2023-01-09,BUSTER,hotZone,Dueling Beetles,41,34,75
16063,2023-01-09,BUSTER,heist,Snaked Assault,4,0,4
16064,2023-01-09,BUSTER,gemGrab,Minecart Madness,19,48,67
16065,2023-01-09,BUSTER,gemGrab,Double Swoosh,27,31,58
16066,2023-01-09,BUSTER,brawlBall,Center Stage,158,166,324
16067,2023-01-09,BUSTER,brawlBall,Backyard Bowl,1,0,1
16068,2023-01-09,BUSTER,bounty,Layer Cake,10,8,18
16069,2023-01-08,BUSTER,knockout,X Marks the Spot,20,26,46
16070,2023-01-08,BUSTER,hotZone,Ring of Fire,53,29,82
16071,2023-01-08,BUSTER,heist,Snaked Assault,0,1,1
16072,2023-01-08,BUSTER,gemGrab,Hard Rock Mine,10,6,16
16073,2023-01-08,BUSTER,gemGrab,Double Swoosh,27,5,32
16074,2023-01-08,BUSTER,brawlBall,Super Beach,12,24,36
16075,2023-01-08,BUSTER,brawlBall,Backyard Bowl,25,25,50
16076,2023-01-08,BUSTER,bounty,Layer Cake,4,6,10
16077,2023-01-07,BUSTER,knockout,X Marks the Spot,7,7,14
16078,2023-01-07,BUSTER,hotZone,Ring of Fire,34,33,67
16079,2023-01-07,BUSTER,heist,Tornado Ring,3,0,3
16080,2023-01-07,BUSTER,gemGrab,Hard Rock Mine,29,5,34
16081,2023-01-07,BUSTER,gemGrab,Deep Diner,15,9,24
16082,2023-01-07,BUSTER,brawlBall,Super Beach,58,64,122
16083,2023-01-07,BUSTER,brawlBall,Sneaky Fields,9,30,39
16084,2023-01-07,BUSTER,bounty,Dry Season,0,1,1
16085,2023-01-06,BUSTER,knockout,Out in the Open,10,6,16
16086,2023-01-06,BUSTER,hotZone,Split,37,65,102
16087,2023-01-06,BUSTER,heist,Tornado Ring,6,1,7
16088,2023-01-06,BUSTER,gemGrab,Undermine,17,8,25
16089,2023-01-06,BUSTER,gemGrab,Deep Diner,43,84,127
16090,2023-01-06,BUSTER,brawlBall,Sneaky Fields,148,103,251
16091,2023-01-06,BUSTER,brawlBall,Pinhole Punt,12,14,26
16092,2023-01-06,BUSTER,bounty,Dry Season,8,5,13
16093,2023-01-05,BUSTER,knockout,Out in the Open,23,8,31
16094,2023-01-05,BUSTER,hotZone,Split,94,108,202
16095,2023-01-05,BUSTER,heist,Kaboom Canyon,2,0,2
16096,2023-01-05,BUSTER,gemGrab,Undermine,53,28,81
16097,2023-01-05,BUSTER,gemGrab,Gem Fort,10,3,13
16098,2023-01-05,BUSTER,brawlBall,Sunny Soccer,2,4,6
16099,2023-01-05,BUSTER,brawlBall,Pinhole Punt,206,192,398
16100,2023-01-05,BUSTER,bounty,Shooting Star,1,0,1
16101,2023-01-04,BUSTER,knockout,Goldarm Gulch,5,9,14
16102,2023-01-04,BUSTER,hotZone,Parallel Plays,39,54,93
16103,2023-01-04,BUSTER,heist,Kaboom Canyon,4,1,5
16104,2023-01-04,BUSTER,gemGrab,Gem Fort,63,58,121
16105,2023-01-04,BUSTER,gemGrab,Crystal Arcade,9,2,11
16106,2023-01-04,BUSTER,brawlBall,Sunny Soccer,167,106,273
16107,2023-01-04,BUSTER,brawlBall,Beach Ball,3,0,3
16108,2023-01-04,BUSTER,bounty,Shooting Star,4,1,5
16109,2023-01-03,BUSTER,knockout,Goldarm Gulch,13,9,22
16110,2023-01-03,BUSTER,hotZone,Parallel Plays,67,40,107
16111,2023-01-03,BUSTER,hotZone,Controller Chaos,0,1,1
16112,2023-01-03,BUSTER,gemGrab,Minecart Madness,7,3,10
16113,2023-01-03,BUSTER,gemGrab,Crystal Arcade,76,108,184
16114,2023-01-03,BUSTER,brawlBall,Center Stage,9,0,9
16115,2023-01-03,BUSTER,brawlBall,Beach Ball,128,99,227
16116,2023-01-03,BUSTER,bounty,Hideout,4,2,6
16117,2023-01-02,BUSTER,knockout,Belle's Rock,5,0,5
16118,2023-01-02,BUSTER,hotZone,Quarter Pounder,52,85,137
16119,2023-01-02,BUSTER,hotZone,Controller Chaos,0,1,1
16120,2023-01-02,BUSTER,heist,Pit Stop,4,0,4
16121,2023-01-02,BUSTER,gemGrab,Minecart Madness,26,27,53
16122,2023-01-02,BUSTER,gemGrab,Double Swoosh,55,48,103
16123,2023-01-02,BUSTER,brawlBall,Center Stage,218,280,498
16124,2023-01-02,BUSTER,brawlBall,Backyard Bowl,3,2,5
16125,2023-01-02,BUSTER,bounty,Hideout,5,6,11
16126,2023-01-01,BUSTER,knockout,Belle's Rock,5,2,7
16127,2023-01-01,BUSTER,hotZone,Quarter Pounder,27,10,37
16128,2023-01-01,BUSTER,hotZone,Controller Chaos,1,0,1
16129,2023-01-01,BUSTER,heist,Bridge Too Far,1,4,5
16130,2023-01-01,BUSTER,gemGrab,Hard Rock Mine,1,1,2
16131,2023-01-01,BUSTER,gemGrab,Double Swoosh,36,56,92
16132,2023-01-01,BUSTER,brawlBall,Backyard Bowl,19,12,31
16133,2023-01-01,BUSTER,bounty,Canal Grande,5,9,14
16134,2022-12-31,BUSTER,knockout,Flaring Phoenix,0,1,1
16135,2022-12-31,BUSTER,hotZone,Controller Chaos,10,23,33
16136,2022-12-31,BUSTER,heist,Kaboom Canyon,0,1,1
16137,2022-12-31,BUSTER,gemGrab,Hard Rock Mine,7,14,21
16138,2022-12-31,BUSTER,gemGrab,Deep Diner,4,2,6
16139,2022-12-31,BUSTER,brawlBall,Super Beach,10,16,26
16140,2022-12-31,BUSTER,brawlBall,Sneaky Fields,1,1,2
16141,2022-12-30,BUSTER,knockout,Flaring Phoenix,1,1,2
16142,2022-12-30,BUSTER,hotZone,Controller Chaos,8,16,24
16143,2022-12-30,BUSTER,gemGrab,Undermine,5,0,5
16144,2022-12-30,BUSTER,gemGrab,Deep Diner,7,9,16
16145,2022-12-30,BUSTER,brawlBall,Sneaky Fields,5,11,16
16146,2022-12-29,BUSTER,hotZone,Open Zone,1,1,2
16147,2022-12-29,BUSTER,hotZone,Controller Chaos,0,1,1
16148,2022-12-29,BUSTER,gemGrab,Undermine,4,2,6
16149,2022-12-29,BUSTER,gemGrab,Gem Fort,1,1,2
16150,2022-12-29,BUSTER,brawlBall,Pinhole Punt,3,4,7
16151,2022-12-28,BUSTER,hotZone,Open Zone,1,0,1
16152,2022-12-28,BUSTER,brawlBall,Sunny Soccer,0,2,2
16153,2022-12-28,BUSTER,brawlBall,Beach Ball,0,1,1
16154,2022-12-27,BUSTER,heist,Kaboom Canyon,1,0,1
16155,2022-12-27,BUSTER,gemGrab,Minecart Madness,0,1,1
16156,2022-12-27,BUSTER,brawlBall,Center Stage,2,2,4
16157,2022-12-27,BUSTER,brawlBall,Beach Ball,4,12,16
16158,2022-12-26,BUSTER,brawlBall,Center Stage,3,4,7
16159,2022-12-25,BUSTER,hotZone,Ring of Fire,0,2,2
16160,2022-12-25,BUSTER,bounty,Layer Cake,1,1,2
16161,2022-12-24,BUSTER,brawlBall,Super Beach,1,1,2
16162,2022-12-23,BUSTER,knockout,Out in the Open,3,0,3
16163,2022-12-23,BUSTER,gemGrab,Deep Diner,0,1,1
16164,2022-12-23,BUSTER,brawlBall,Sneaky Fields,1,0,1
16165,2022-12-22,BUSTER,gemGrab,Gem Fort,1,0,1
16166,2022-12-22,BUSTER,brawlBall,Pinhole Punt,2,5,7
16167,2022-12-21,BUSTER,brawlBall,Sunny Soccer,1,5,6
16168,2022-12-20,BUSTER,brawlBall,Beach Ball,0,1,1
16169,2022-12-19,BUSTER,brawlBall,Center Stage,1,2,3
16170,2022-12-16,BUSTER,hotZone,Controller Chaos,0,1,1
16171,2022-12-16,BUSTER,brawlBall,Sneaky Fields,8,9,17
16172,2022-12-16,BUSTER,bounty,Temple Ruins,0,4,4
16173,2022-12-13,BUSTER,knockout,New Perspective,2,0,2
16174,2022-12-13,BUSTER,hotZone,Dueling Beetles,0,1,1
16175,2022-12-13,BUSTER,gemGrab,Crystal Arcade,3,8,11
16176,2022-12-11,BUSTER,brawlBall,Backyard Bowl,3,2,5
16177,2022-12-10,BUSTER,gemGrab,Hard Rock Mine,1,1,2
16178,2022-11-11,BUSTER,brawlBall,Sneaky Fields,1,0,1
16179,2022-11-07,BUSTER,hotZone,Quarter Pounder,0,1,1
16180,2023-02-05,BULL,knockout,X Marks the Spot,5,4,9
16181,2023-02-05,BULL,hotZone,Ring of Fire,25,13,38
16182,2023-02-05,BULL,heist,Snaked Assault,248,198,446
16183,2023-02-05,BULL,heist,Pit Stop,275,332,607
16184,2023-02-05,BULL,gemGrab,Hard Rock Mine,29,17,46
16185,2023-02-05,BULL,gemGrab,Double Swoosh,69,54,123
16186,2023-02-05,BULL,brawlBall,Super Beach,22,32,54
16187,2023-02-05,BULL,brawlBall,Sneaky Fields,37,30,67
16188,2023-02-05,BULL,brawlBall,Backyard Bowl,154,160,314
16189,2023-02-05,BULL,bounty,Layer Cake,13,9,22
16190,2023-02-04,BULL,knockout,X Marks the Spot,2,2,4
16191,2023-02-04,BULL,hotZone,Ring of Fire,1,0,1
16192,2023-02-04,BULL,heist,Tornado Ring,40,26,66
16193,2023-02-04,BULL,heist,Pit Stop,216,277,493
16194,2023-02-04,BULL,gemGrab,Hard Rock Mine,22,9,31
16195,2023-02-04,BULL,gemGrab,Double Swoosh,12,9,21
16196,2023-02-04,BULL,brawlBall,Super Beach,108,139,247
16197,2023-02-04,BULL,brawlBall,Sneaky Fields,37,51,88
16198,2023-02-03,BULL,knockout,Out in the Open,7,6,13
16199,2023-02-03,BULL,knockout,Goldarm Gulch,5,2,7
16200,2023-02-03,BULL,hotZone,Split,46,43,89
16201,2023-02-03,BULL,heist,Tornado Ring,561,589,1150
16202,2023-02-03,BULL,heist,Pit Stop,1198,1454,2652
16203,2023-02-03,BULL,gemGrab,Undermine,14,20,34
16204,2023-02-03,BULL,gemGrab,Double Swoosh,69,66,135
16205,2023-02-03,BULL,gemGrab,Deep Diner,40,33,73
16206,2023-02-03,BULL,brawlBall,Sneaky Fields,1294,1400,2694
16207,2023-02-03,BULL,brawlBall,Pinhole Punt,20,14,34
16208,2023-02-03,BULL,bounty,Dry Season,7,4,11
16209,2023-02-02,BULL,knockout,Out in the Open,1,1,2
16210,2023-02-02,BULL,hotZone,Split,38,41,79
16211,2023-02-02,BULL,heist,Kaboom Canyon,12,10,22
16212,2023-02-02,BULL,gemGrab,Undermine,10,8,18
16213,2023-02-02,BULL,gemGrab,Gem Fort,2,5,7
16214,2023-02-02,BULL,brawlBall,Sunny Soccer,11,9,20
16215,2023-02-02,BULL,brawlBall,Pinhole Punt,101,91,192
16216,2023-02-02,BULL,bounty,Shooting Star,1,1,2
16217,2023-02-01,BULL,knockout,Goldarm Gulch,27,15,42
16218,2023-02-01,BULL,hotZone,Parallel Plays,36,18,54
16219,2023-02-01,BULL,heist,Kaboom Canyon,30,14,44
16220,2023-02-01,BULL,gemGrab,Gem Fort,85,90,175
16221,2023-02-01,BULL,gemGrab,Crystal Arcade,18,12,30
16222,2023-02-01,BULL,brawlBall,Sunny Soccer,432,546,978
16223,2023-02-01,BULL,brawlBall,Beach Ball,16,26,42
16224,2023-02-01,BULL,bounty,Shooting Star,2,0,2
16225,2023-01-31,BULL,knockout,Goldarm Gulch,11,5,16
16226,2023-01-31,BULL,hotZone,Parallel Plays,22,9,31
16227,2023-01-31,BULL,heist,Pit Stop,162,214,376
16228,2023-01-31,BULL,gemGrab,Minecart Madness,0,11,11
16229,2023-01-31,BULL,gemGrab,Crystal Arcade,20,6,26
16230,2023-01-31,BULL,brawlBall,Center Stage,20,12,32
16231,2023-01-31,BULL,brawlBall,Beach Ball,206,193,399
16232,2023-01-31,BULL,bounty,Hideout,2,1,3
16233,2023-01-30,BULL,knockout,Belle's Rock,15,9,24
16234,2023-01-30,BULL,hotZone,Quarter Pounder,15,5,20
16235,2023-01-30,BULL,heist,Pit Stop,789,937,1726
16236,2023-01-30,BULL,gemGrab,Minecart Madness,27,19,46
16237,2023-01-30,BULL,gemGrab,Double Swoosh,30,10,40
16238,2023-01-30,BULL,brawlBall,Center Stage,697,705,1402
16239,2023-01-30,BULL,brawlBall,Backyard Bowl,33,30,63
16240,2023-01-30,BULL,bounty,Hideout,4,3,7
16241,2023-01-29,BULL,knockout,Belle's Rock,17,19,36
16242,2023-01-29,BULL,hotZone,Quarter Pounder,13,6,19
16243,2023-01-29,BULL,heist,Bridge Too Far,22,20,42
16244,2023-01-29,BULL,gemGrab,Hard Rock Mine,19,21,40
16245,2023-01-29,BULL,gemGrab,Double Swoosh,61,46,107
16246,2023-01-29,BULL,brawlBall,Super Beach,15,6,21
16247,2023-01-29,BULL,brawlBall,Backyard Bowl,211,196,407
16248,2023-01-29,BULL,bounty,Canal Grande,11,22,33
16249,2023-01-28,BULL,knockout,Flaring Phoenix,9,14,23
16250,2023-01-28,BULL,hotZone,Controller Chaos,16,9,25
16251,2023-01-28,BULL,heist,Bridge Too Far,41,48,89
16252,2023-01-28,BULL,gemGrab,Hard Rock Mine,77,69,146
16253,2023-01-28,BULL,gemGrab,Deep Diner,7,5,12
16254,2023-01-28,BULL,brawlBall,Super Beach,700,735,1435
16255,2023-01-28,BULL,brawlBall,Sneaky Fields,44,40,84
16256,2023-01-28,BULL,bounty,Canal Grande,31,45,76
16257,2023-01-27,BULL,knockout,Flaring Phoenix,6,3,9
16258,2023-01-27,BULL,hotZone,Controller Chaos,4,6,10
16259,2023-01-27,BULL,heist,Hot Potato,71,75,146
16260,2023-01-27,BULL,gemGrab,Undermine,1,1,2
16261,2023-01-27,BULL,gemGrab,Deep Diner,20,6,26
16262,2023-01-27,BULL,brawlBall,Sneaky Fields,376,357,733
16263,2023-01-27,BULL,brawlBall,Pinhole Punt,1,3,4
16264,2023-01-27,BULL,bounty,Temple Ruins,3,1,4
16265,2023-01-26,BULL,knockout,Riverside,9,4,13
16266,2023-01-26,BULL,hotZone,Open Zone,9,8,17
16267,2023-01-26,BULL,heist,Hot Potato,519,511,1030
16268,2023-01-26,BULL,gemGrab,Undermine,60,61,121
16269,2023-01-26,BULL,gemGrab,Gem Fort,26,18,44
16270,2023-01-26,BULL,brawlBall,Sunny Soccer,33,29,62
16271,2023-01-26,BULL,brawlBall,Pinhole Punt,412,455,867
16272,2023-01-26,BULL,bounty,Temple Ruins,8,9,17
16273,2023-01-25,BULL,knockout,Riverside,13,5,18
16274,2023-01-25,BULL,hotZone,Open Zone,5,1,6
16275,2023-01-25,BULL,heist,Safe Zone,39,32,71
16276,2023-01-25,BULL,gemGrab,Gem Fort,29,38,67
16277,2023-01-25,BULL,gemGrab,Crystal Arcade,16,9,25
16278,2023-01-25,BULL,brawlBall,Sunny Soccer,342,328,670
16279,2023-01-25,BULL,brawlBall,Beach Ball,53,68,121
16280,2023-01-25,BULL,bounty,Excel,7,24,31
16281,2023-01-24,BULL,knockout,New Perspective,13,14,27
16282,2023-01-24,BULL,hotZone,Dueling Beetles,10,2,12
16283,2023-01-24,BULL,heist,Safe Zone,56,64,120
16284,2023-01-24,BULL,gemGrab,Minecart Madness,7,4,11
16285,2023-01-24,BULL,gemGrab,Crystal Arcade,45,36,81
16286,2023-01-24,BULL,brawlBall,Center Stage,145,170,315
16287,2023-01-24,BULL,brawlBall,Beach Ball,490,461,951
16288,2023-01-24,BULL,bounty,Excel,14,10,24
16289,2023-01-23,BULL,knockout,New Perspective,24,5,29
16290,2023-01-23,BULL,hotZone,Dueling Beetles,15,2,17
16291,2023-01-23,BULL,heist,Snaked Assault,330,348,678
16292,2023-01-23,BULL,gemGrab,Minecart Madness,43,23,66
16293,2023-01-23,BULL,gemGrab,Double Swoosh,20,19,39
16294,2023-01-23,BULL,brawlBall,Center Stage,1483,1652,3135
16295,2023-01-23,BULL,brawlBall,Backyard Bowl,17,7,24
16296,2023-01-23,BULL,bounty,Layer Cake,11,6,17
16297,2023-01-22,BULL,knockout,X Marks the Spot,2,1,3
16298,2023-01-22,BULL,hotZone,Ring of Fire,6,5,11
16299,2023-01-22,BULL,heist,Snaked Assault,220,175,395
16300,2023-01-22,BULL,gemGrab,Hard Rock Mine,35,35,70
16301,2023-01-22,BULL,gemGrab,Double Swoosh,47,39,86
16302,2023-01-22,BULL,brawlBall,Super Beach,57,58,115
16303,2023-01-22,BULL,brawlBall,Backyard Bowl,92,77,169
16304,2023-01-22,BULL,bounty,Layer Cake,17,23,40
16305,2023-01-21,BULL,knockout,X Marks the Spot,17,13,30
16306,2023-01-21,BULL,hotZone,Ring of Fire,15,5,20
16307,2023-01-21,BULL,heist,Tornado Ring,412,499,911
16308,2023-01-21,BULL,gemGrab,Hard Rock Mine,128,128,256
16309,2023-01-21,BULL,gemGrab,Deep Diner,17,21,38
16310,2023-01-21,BULL,brawlBall,Super Beach,949,949,1898
16311,2023-01-21,BULL,brawlBall,Sneaky Fields,82,87,169
16312,2023-01-21,BULL,bounty,Dry Season,7,2,9
16313,2023-01-20,BULL,knockout,Out in the Open,18,3,21
16314,2023-01-20,BULL,hotZone,Split,41,40,81
16315,2023-01-20,BULL,heist,Tornado Ring,425,446,871
16316,2023-01-20,BULL,gemGrab,Undermine,24,17,41
16317,2023-01-20,BULL,gemGrab,Deep Diner,42,47,89
16318,2023-01-20,BULL,brawlBall,Sneaky Fields,1238,1279,2517
16319,2023-01-20,BULL,brawlBall,Pinhole Punt,17,24,41
16320,2023-01-20,BULL,bounty,Dry Season,4,5,9
16321,2023-01-19,BULL,knockout,Out in the Open,27,22,49
16322,2023-01-19,BULL,hotZone,Split,85,49,134
16323,2023-01-19,BULL,heist,Kaboom Canyon,45,38,83
16324,2023-01-19,BULL,gemGrab,Undermine,96,80,176
16325,2023-01-19,BULL,gemGrab,Gem Fort,22,31,53
16326,2023-01-19,BULL,brawlBall,Sunny Soccer,30,40,70
16327,2023-01-19,BULL,brawlBall,Pinhole Punt,531,529,1060
16328,2023-01-19,BULL,bounty,Shooting Star,3,3,6
16329,2023-01-18,BULL,knockout,Goldarm Gulch,5,3,8
16330,2023-01-18,BULL,hotZone,Parallel Plays,3,2,5
16331,2023-01-18,BULL,heist,Kaboom Canyon,14,8,22
16332,2023-01-18,BULL,gemGrab,Gem Fort,25,19,44
16333,2023-01-18,BULL,gemGrab,Crystal Arcade,3,8,11
16334,2023-01-18,BULL,brawlBall,Sunny Soccer,201,214,415
16335,2023-01-18,BULL,brawlBall,Beach Ball,6,6,12
16336,2023-01-18,BULL,bounty,Shooting Star,1,5,6
16337,2023-01-17,BULL,knockout,Goldarm Gulch,6,2,8
16338,2023-01-17,BULL,hotZone,Parallel Plays,1,2,3
16339,2023-01-17,BULL,heist,Pit Stop,55,60,115
16340,2023-01-17,BULL,gemGrab,Crystal Arcade,1,3,4
16341,2023-01-17,BULL,brawlBall,Center Stage,11,6,17
16342,2023-01-17,BULL,brawlBall,Beach Ball,63,77,140
16343,2023-01-17,BULL,bounty,Hideout,2,3,5
16344,2023-01-16,BULL,knockout,Belle's Rock,0,2,2
16345,2023-01-16,BULL,hotZone,Quarter Pounder,3,0,3
16346,2023-01-16,BULL,heist,Pit Stop,284,251,535
16347,2023-01-16,BULL,gemGrab,Minecart Madness,2,4,6
16348,2023-01-16,BULL,gemGrab,Double Swoosh,2,1,3
16349,2023-01-16,BULL,brawlBall,Center Stage,100,109,209
16350,2023-01-16,BULL,brawlBall,Backyard Bowl,1,1,2
16351,2023-01-15,BULL,knockout,Belle's Rock,1,0,1
16352,2023-01-15,BULL,hotZone,Quarter Pounder,5,13,18
16353,2023-01-15,BULL,heist,Bridge Too Far,6,0,6
16354,2023-01-15,BULL,gemGrab,Hard Rock Mine,5,0,5
16355,2023-01-15,BULL,gemGrab,Double Swoosh,7,9,16
16356,2023-01-15,BULL,brawlBall,Super Beach,9,5,14
16357,2023-01-15,BULL,brawlBall,Backyard Bowl,22,20,42
16358,2023-01-15,BULL,bounty,Canal Grande,3,2,5
16359,2023-01-14,BULL,knockout,Flaring Phoenix,3,0,3
16360,2023-01-14,BULL,hotZone,Controller Chaos,6,1,7
16361,2023-01-14,BULL,heist,Bridge Too Far,6,1,7
16362,2023-01-14,BULL,gemGrab,Hard Rock Mine,2,1,3
16363,2023-01-14,BULL,gemGrab,Deep Diner,1,0,1
16364,2023-01-14,BULL,brawlBall,Super Beach,33,45,78
16365,2023-01-14,BULL,brawlBall,Sneaky Fields,12,3,15
16366,2023-01-13,BULL,hotZone,Controller Chaos,1,1,2
16367,2023-01-13,BULL,heist,Hot Potato,8,20,28
16368,2023-01-13,BULL,gemGrab,Deep Diner,3,8,11
16369,2023-01-13,BULL,brawlBall,Sneaky Fields,86,56,142
16370,2023-01-12,BULL,knockout,Riverside,2,4,6
16371,2023-01-12,BULL,hotZone,Open Zone,1,0,1
16372,2023-01-12,BULL,heist,Hot Potato,8,7,15
16373,2023-01-12,BULL,gemGrab,Undermine,0,1,1
16374,2023-01-12,BULL,gemGrab,Gem Fort,1,0,1
16375,2023-01-12,BULL,brawlBall,Sunny Soccer,1,0,1
16376,2023-01-12,BULL,brawlBall,Pinhole Punt,12,11,23
16377,2023-01-11,BULL,heist,Safe Zone,1,0,1
16378,2023-01-11,BULL,gemGrab,Gem Fort,2,0,2
16379,2023-01-11,BULL,brawlBall,Sunny Soccer,6,4,10
16380,2023-01-11,BULL,bounty,Excel,1,0,1
16381,2023-01-10,BULL,hotZone,Dueling Beetles,1,0,1
16382,2023-01-10,BULL,heist,Safe Zone,3,2,5
16383,2023-01-10,BULL,gemGrab,Minecart Madness,1,0,1
16384,2023-01-10,BULL,gemGrab,Crystal Arcade,5,2,7
16385,2023-01-10,BULL,brawlBall,Center Stage,5,4,9
16386,2023-01-10,BULL,brawlBall,Beach Ball,22,6,28
16387,2023-01-10,BULL,bounty,Excel,1,0,1
16388,2023-01-09,BULL,hotZone,Dueling Beetles,4,1,5
16389,2023-01-09,BULL,heist,Snaked Assault,40,40,80
16390,2023-01-09,BULL,gemGrab,Minecart Madness,2,0,2
16391,2023-01-09,BULL,gemGrab,Double Swoosh,3,0,3
16392,2023-01-09,BULL,brawlBall,Center Stage,45,43,88
16393,2023-01-09,BULL,brawlBall,Backyard Bowl,1,0,1
16394,2023-01-09,BULL,bounty,Layer Cake,4,2,6
16395,2023-01-08,BULL,knockout,X Marks the Spot,1,1,2
16396,2023-01-08,BULL,hotZone,Ring of Fire,2,0,2
16397,2023-01-08,BULL,heist,Snaked Assault,30,36,66
16398,2023-01-08,BULL,gemGrab,Hard Rock Mine,3,1,4
16399,2023-01-08,BULL,gemGrab,Double Swoosh,2,1,3
16400,2023-01-08,BULL,brawlBall,Super Beach,3,0,3
16401,2023-01-08,BULL,brawlBall,Backyard Bowl,10,5,15
16402,2023-01-08,BULL,bounty,Layer Cake,1,1,2
16403,2023-01-07,BULL,hotZone,Ring of Fire,1,0,1
16404,2023-01-07,BULL,heist,Tornado Ring,37,35,72
16405,2023-01-07,BULL,gemGrab,Hard Rock Mine,6,2,8
16406,2023-01-07,BULL,gemGrab,Deep Diner,2,0,2
16407,2023-01-07,BULL,brawlBall,Super Beach,11,5,16
16408,2023-01-07,BULL,brawlBall,Sneaky Fields,2,2,4
16409,2023-01-07,BULL,bounty,Dry Season,2,1,3
16410,2023-01-06,BULL,hotZone,Split,6,3,9
16411,2023-01-06,BULL,heist,Tornado Ring,77,114,191
16412,2023-01-06,BULL,gemGrab,Undermine,1,0,1
16413,2023-01-06,BULL,gemGrab,Deep Diner,4,0,4
16414,2023-01-06,BULL,brawlBall,Sneaky Fields,54,75,129
16415,2023-01-06,BULL,brawlBall,Pinhole Punt,3,6,9
16416,2023-01-06,BULL,bounty,Dry Season,1,0,1
16417,2023-01-05,BULL,knockout,Out in the Open,1,0,1
16418,2023-01-05,BULL,hotZone,Split,18,11,29
16419,2023-01-05,BULL,heist,Kaboom Canyon,2,1,3
16420,2023-01-05,BULL,gemGrab,Undermine,1,2,3
16421,2023-01-05,BULL,gemGrab,Gem Fort,4,6,10
16422,2023-01-05,BULL,brawlBall,Sunny Soccer,1,2,3
16423,2023-01-05,BULL,brawlBall,Pinhole Punt,35,16,51
16424,2023-01-05,BULL,bounty,Shooting Star,1,0,1
16425,2023-01-04,BULL,hotZone,Parallel Plays,2,3,5
16426,2023-01-04,BULL,heist,Kaboom Canyon,13,10,23
16427,2023-01-04,BULL,gemGrab,Gem Fort,3,0,3
16428,2023-01-04,BULL,gemGrab,Crystal Arcade,1,1,2
16429,2023-01-04,BULL,brawlBall,Sunny Soccer,32,15,47
16430,2023-01-03,BULL,hotZone,Parallel Plays,1,0,1
16431,2023-01-03,BULL,heist,Pit Stop,126,138,264
16432,2023-01-03,BULL,gemGrab,Minecart Madness,1,1,2
16433,2023-01-03,BULL,gemGrab,Crystal Arcade,4,0,4
16434,2023-01-03,BULL,brawlBall,Center Stage,2,1,3
16435,2023-01-03,BULL,brawlBall,Beach Ball,9,18,27
16436,2023-01-03,BULL,bounty,Hideout,2,1,3
16437,2023-01-02,BULL,knockout,Belle's Rock,1,0,1
16438,2023-01-02,BULL,hotZone,Quarter Pounder,2,0,2
16439,2023-01-02,BULL,heist,Pit Stop,187,166,353
16440,2023-01-02,BULL,gemGrab,Minecart Madness,5,3,8
16441,2023-01-02,BULL,gemGrab,Double Swoosh,4,1,5
16442,2023-01-02,BULL,brawlBall,Center Stage,77,63,140
16443,2023-01-02,BULL,brawlBall,Backyard Bowl,3,2,5
16444,2023-01-02,BULL,bounty,Hideout,0,1,1
16445,2023-01-01,BULL,hotZone,Quarter Pounder,1,1,2
16446,2023-01-01,BULL,heist,Bridge Too Far,2,0,2
16447,2023-01-01,BULL,gemGrab,Double Swoosh,3,1,4
16448,2023-01-01,BULL,brawlBall,Backyard Bowl,5,3,8
16449,2023-01-01,BULL,bounty,Canal Grande,0,1,1
16450,2022-12-31,BULL,hotZone,Controller Chaos,1,0,1
16451,2022-12-31,BULL,heist,Bridge Too Far,0,1,1
16452,2022-12-31,BULL,brawlBall,Super Beach,5,2,7
16453,2022-12-31,BULL,brawlBall,Sneaky Fields,4,3,7
16454,2022-12-30,BULL,heist,Hot Potato,0,2,2
16455,2022-12-30,BULL,gemGrab,Undermine,1,0,1
16456,2022-12-30,BULL,brawlBall,Sneaky Fields,2,2,4
16457,2022-12-29,BULL,heist,Hot Potato,5,9,14
16458,2022-12-29,BULL,gemGrab,Gem Fort,0,1,1
16459,2022-12-27,BULL,gemGrab,Minecart Madness,1,0,1
16460,2022-12-27,BULL,brawlBall,Beach Ball,1,0,1
16461,2022-12-26,BULL,hotZone,Controller Chaos,0,1,1
16462,2022-12-23,BULL,knockout,Out in the Open,0,1,1
16463,2022-12-22,BULL,brawlBall,Pinhole Punt,0,1,1
16464,2022-12-19,BULL,brawlBall,Center Stage,1,1,2
16465,2022-12-13,BULL,hotZone,Dueling Beetles,1,0,1
16466,2022-10-30,BULL,heist,Safe Zone,0,1,1
16467,2022-10-30,BULL,brawlBall,Beach Ball,0,2,2
16468,2022-10-28,BULL,hotZone,Dueling Beetles,1,0,1
16469,2022-10-15,BULL,gemGrab,Hard Rock Mine,0,1,1
16470,2022-10-15,BULL,brawlBall,Super Beach,0,1,1
16471,2023-02-05,BROCK,knockout,X Marks the Spot,363,293,656
16472,2023-02-05,BROCK,knockout,Goldarm Gulch,114,88,202
16473,2023-02-05,BROCK,hotZone,Ring of Fire,52,19,71
16474,2023-02-05,BROCK,heist,Snaked Assault,138,113,251
16475,2023-02-05,BROCK,heist,Pit Stop,56,9,65
16476,2023-02-05,BROCK,gemGrab,Hard Rock Mine,39,20,59
16477,2023-02-05,BROCK,gemGrab,Double Swoosh,125,82,207
16478,2023-02-05,BROCK,brawlBall,Super Beach,11,15,26
16479,2023-02-05,BROCK,brawlBall,Sneaky Fields,8,7,15
16480,2023-02-05,BROCK,brawlBall,Backyard Bowl,1077,973,2050
16481,2023-02-05,BROCK,bounty,Layer Cake,227,198,425
16482,2023-02-04,BROCK,knockout,X Marks the Spot,126,140,266
16483,2023-02-04,BROCK,knockout,Goldarm Gulch,83,54,137
16484,2023-02-04,BROCK,hotZone,Ring of Fire,7,5,12
16485,2023-02-04,BROCK,heist,Tornado Ring,17,19,36
16486,2023-02-04,BROCK,heist,Pit Stop,43,12,55
16487,2023-02-04,BROCK,gemGrab,Hard Rock Mine,23,14,37
16488,2023-02-04,BROCK,gemGrab,Double Swoosh,27,8,35
16489,2023-02-04,BROCK,gemGrab,Deep Diner,8,7,15
16490,2023-02-04,BROCK,brawlBall,Super Beach,80,62,142
16491,2023-02-04,BROCK,brawlBall,Sneaky Fields,14,2,16
16492,2023-02-04,BROCK,bounty,Dry Season,77,62,139
16493,2023-02-03,BROCK,knockout,Out in the Open,648,595,1243
16494,2023-02-03,BROCK,knockout,Goldarm Gulch,427,332,759
16495,2023-02-03,BROCK,hotZone,Split,35,23,58
16496,2023-02-03,BROCK,heist,Tornado Ring,131,72,203
16497,2023-02-03,BROCK,heist,Pit Stop,244,77,321
16498,2023-02-03,BROCK,gemGrab,Undermine,30,14,44
16499,2023-02-03,BROCK,gemGrab,Double Swoosh,142,44,186
16500,2023-02-03,BROCK,gemGrab,Deep Diner,209,128,337
16501,2023-02-03,BROCK,brawlBall,Sneaky Fields,233,153,386
16502,2023-02-03,BROCK,brawlBall,Pinhole Punt,12,7,19
16503,2023-02-03,BROCK,bounty,Dry Season,752,607,1359
16504,2023-02-02,BROCK,knockout,Out in the Open,316,223,539
16505,2023-02-02,BROCK,hotZone,Split,10,7,17
16506,2023-02-02,BROCK,heist,Kaboom Canyon,35,48,83
16507,2023-02-02,BROCK,gemGrab,Undermine,33,35,68
16508,2023-02-02,BROCK,gemGrab,Gem Fort,6,7,13
16509,2023-02-02,BROCK,brawlBall,Sunny Soccer,3,2,5
16510,2023-02-02,BROCK,brawlBall,Pinhole Punt,113,78,191
16511,2023-02-02,BROCK,bounty,Shooting Star,136,98,234
16512,2023-02-01,BROCK,knockout,Goldarm Gulch,436,349,785
16513,2023-02-01,BROCK,hotZone,Parallel Plays,50,25,75
16514,2023-02-01,BROCK,heist,Kaboom Canyon,215,141,356
16515,2023-02-01,BROCK,gemGrab,Gem Fort,84,55,139
16516,2023-02-01,BROCK,gemGrab,Crystal Arcade,72,50,122
16517,2023-02-01,BROCK,brawlBall,Sunny Soccer,239,204,443
16518,2023-02-01,BROCK,brawlBall,Beach Ball,8,4,12
16519,2023-02-01,BROCK,bounty,Shooting Star,281,264,545
16520,2023-01-31,BROCK,knockout,Goldarm Gulch,193,156,349
16521,2023-01-31,BROCK,hotZone,Parallel Plays,23,9,32
16522,2023-01-31,BROCK,heist,Pit Stop,42,22,64
16523,2023-01-31,BROCK,gemGrab,Minecart Madness,23,14,37
16524,2023-01-31,BROCK,gemGrab,Crystal Arcade,64,58,122
16525,2023-01-31,BROCK,brawlBall,Center Stage,5,4,9
16526,2023-01-31,BROCK,brawlBall,Beach Ball,130,133,263
16527,2023-01-31,BROCK,bounty,Hideout,117,131,248
16528,2023-01-30,BROCK,knockout,Belle's Rock,719,673,1392
16529,2023-01-30,BROCK,hotZone,Quarter Pounder,76,18,94
16530,2023-01-30,BROCK,heist,Pit Stop,75,27,102
16531,2023-01-30,BROCK,gemGrab,Minecart Madness,182,104,286
16532,2023-01-30,BROCK,gemGrab,Double Swoosh,92,59,151
16533,2023-01-30,BROCK,brawlBall,Center Stage,258,200,458
16534,2023-01-30,BROCK,brawlBall,Backyard Bowl,97,118,215
16535,2023-01-30,BROCK,bounty,Hideout,239,176,415
16536,2023-01-29,BROCK,knockout,Belle's Rock,681,588,1269
16537,2023-01-29,BROCK,hotZone,Quarter Pounder,50,33,83
16538,2023-01-29,BROCK,heist,Bridge Too Far,436,339,775
16539,2023-01-29,BROCK,gemGrab,Hard Rock Mine,13,9,22
16540,2023-01-29,BROCK,gemGrab,Double Swoosh,116,89,205
16541,2023-01-29,BROCK,brawlBall,Super Beach,3,3,6
16542,2023-01-29,BROCK,brawlBall,Backyard Bowl,995,964,1959
16543,2023-01-29,BROCK,bounty,Canal Grande,135,129,264
16544,2023-01-28,BROCK,knockout,Flaring Phoenix,243,192,435
16545,2023-01-28,BROCK,hotZone,Controller Chaos,28,5,33
16546,2023-01-28,BROCK,heist,Bridge Too Far,882,751,1633
16547,2023-01-28,BROCK,gemGrab,Hard Rock Mine,102,55,157
16548,2023-01-28,BROCK,gemGrab,Deep Diner,48,23,71
16549,2023-01-28,BROCK,brawlBall,Super Beach,282,209,491
16550,2023-01-28,BROCK,brawlBall,Sneaky Fields,5,4,9
16551,2023-01-28,BROCK,bounty,Canal Grande,229,178,407
16552,2023-01-27,BROCK,knockout,Flaring Phoenix,96,72,168
16553,2023-01-27,BROCK,hotZone,Controller Chaos,11,3,14
16554,2023-01-27,BROCK,heist,Hot Potato,77,35,112
16555,2023-01-27,BROCK,gemGrab,Undermine,9,7,16
16556,2023-01-27,BROCK,gemGrab,Deep Diner,71,41,112
16557,2023-01-27,BROCK,brawlBall,Sneaky Fields,55,36,91
16558,2023-01-27,BROCK,brawlBall,Pinhole Punt,2,1,3
16559,2023-01-27,BROCK,bounty,Temple Ruins,41,24,65
16560,2023-01-26,BROCK,knockout,Riverside,621,409,1030
16561,2023-01-26,BROCK,hotZone,Open Zone,53,25,78
16562,2023-01-26,BROCK,heist,Hot Potato,127,87,214
16563,2023-01-26,BROCK,gemGrab,Undermine,90,48,138
16564,2023-01-26,BROCK,gemGrab,Gem Fort,17,27,44
16565,2023-01-26,BROCK,brawlBall,Sunny Soccer,5,2,7
16566,2023-01-26,BROCK,brawlBall,Pinhole Punt,343,252,595
16567,2023-01-26,BROCK,bounty,Temple Ruins,103,60,163
16568,2023-01-25,BROCK,knockout,Riverside,319,242,561
16569,2023-01-25,BROCK,hotZone,Open Zone,28,8,36
16570,2023-01-25,BROCK,heist,Safe Zone,486,461,947
16571,2023-01-25,BROCK,gemGrab,Gem Fort,29,34,63
16572,2023-01-25,BROCK,gemGrab,Crystal Arcade,51,29,80
16573,2023-01-25,BROCK,brawlBall,Sunny Soccer,127,122,249
16574,2023-01-25,BROCK,brawlBall,Beach Ball,31,33,64
16575,2023-01-25,BROCK,bounty,Excel,158,96,254
16576,2023-01-24,BROCK,knockout,New Perspective,236,163,399
16577,2023-01-24,BROCK,hotZone,Dueling Beetles,51,29,80
16578,2023-01-24,BROCK,heist,Safe Zone,739,650,1389
16579,2023-01-24,BROCK,gemGrab,Minecart Madness,64,45,109
16580,2023-01-24,BROCK,gemGrab,Crystal Arcade,113,60,173
16581,2023-01-24,BROCK,brawlBall,Center Stage,37,26,63
16582,2023-01-24,BROCK,brawlBall,Beach Ball,277,217,494
16583,2023-01-24,BROCK,bounty,Excel,239,173,412
16584,2023-01-23,BROCK,knockout,New Perspective,422,325,747
16585,2023-01-23,BROCK,hotZone,Dueling Beetles,64,19,83
16586,2023-01-23,BROCK,heist,Snaked Assault,191,94,285
16587,2023-01-23,BROCK,gemGrab,Minecart Madness,279,222,501
16588,2023-01-23,BROCK,gemGrab,Double Swoosh,71,78,149
16589,2023-01-23,BROCK,brawlBall,Center Stage,433,289,722
16590,2023-01-23,BROCK,brawlBall,Backyard Bowl,60,64,124
16591,2023-01-23,BROCK,bounty,Layer Cake,298,203,501
16592,2023-01-22,BROCK,knockout,X Marks the Spot,296,254,550
16593,2023-01-22,BROCK,hotZone,Ring of Fire,25,7,32
16594,2023-01-22,BROCK,heist,Snaked Assault,110,54,164
16595,2023-01-22,BROCK,gemGrab,Hard Rock Mine,24,15,39
16596,2023-01-22,BROCK,gemGrab,Double Swoosh,49,29,78
16597,2023-01-22,BROCK,brawlBall,Super Beach,34,29,63
16598,2023-01-22,BROCK,brawlBall,Backyard Bowl,519,485,1004
16599,2023-01-22,BROCK,bounty,Layer Cake,166,143,309
16600,2023-01-21,BROCK,knockout,X Marks the Spot,1016,841,1857
16601,2023-01-21,BROCK,hotZone,Ring of Fire,84,26,110
16602,2023-01-21,BROCK,heist,Tornado Ring,107,83,190
16603,2023-01-21,BROCK,gemGrab,Hard Rock Mine,125,79,204
16604,2023-01-21,BROCK,gemGrab,Deep Diner,32,17,49
16605,2023-01-21,BROCK,brawlBall,Super Beach,282,223,505
16606,2023-01-21,BROCK,brawlBall,Sneaky Fields,5,1,6
16607,2023-01-21,BROCK,bounty,Dry Season,546,490,1036
16608,2023-01-20,BROCK,knockout,Out in the Open,672,597,1269
16609,2023-01-20,BROCK,hotZone,Split,33,14,47
16610,2023-01-20,BROCK,heist,Tornado Ring,100,48,148
16611,2023-01-20,BROCK,gemGrab,Undermine,50,24,74
16612,2023-01-20,BROCK,gemGrab,Deep Diner,179,106,285
16613,2023-01-20,BROCK,brawlBall,Sneaky Fields,159,131,290
16614,2023-01-20,BROCK,brawlBall,Pinhole Punt,23,17,40
16615,2023-01-20,BROCK,bounty,Dry Season,391,259,650
16616,2023-01-19,BROCK,knockout,Out in the Open,844,764,1608
16617,2023-01-19,BROCK,hotZone,Split,47,21,68
16618,2023-01-19,BROCK,heist,Kaboom Canyon,251,208,459
16619,2023-01-19,BROCK,gemGrab,Undermine,129,110,239
16620,2023-01-19,BROCK,gemGrab,Gem Fort,17,24,41
16621,2023-01-19,BROCK,brawlBall,Sunny Soccer,9,3,12
16622,2023-01-19,BROCK,brawlBall,Pinhole Punt,330,274,604
16623,2023-01-19,BROCK,bounty,Shooting Star,389,294,683
16624,2023-01-18,BROCK,knockout,Goldarm Gulch,70,40,110
16625,2023-01-18,BROCK,hotZone,Parallel Plays,9,6,15
16626,2023-01-18,BROCK,heist,Kaboom Canyon,95,120,215
16627,2023-01-18,BROCK,gemGrab,Gem Fort,21,21,42
16628,2023-01-18,BROCK,gemGrab,Crystal Arcade,9,4,13
16629,2023-01-18,BROCK,brawlBall,Sunny Soccer,64,48,112
16630,2023-01-18,BROCK,brawlBall,Beach Ball,3,5,8
16631,2023-01-18,BROCK,bounty,Shooting Star,156,119,275
16632,2023-01-17,BROCK,knockout,Goldarm Gulch,52,32,84
16633,2023-01-17,BROCK,hotZone,Parallel Plays,4,1,5
16634,2023-01-17,BROCK,heist,Pit Stop,6,8,14
16635,2023-01-17,BROCK,gemGrab,Minecart Madness,6,2,8
16636,2023-01-17,BROCK,gemGrab,Crystal Arcade,10,5,15
16637,2023-01-17,BROCK,brawlBall,Center Stage,1,1,2
16638,2023-01-17,BROCK,brawlBall,Beach Ball,21,21,42
16639,2023-01-17,BROCK,bounty,Hideout,22,24,46
16640,2023-01-16,BROCK,knockout,Belle's Rock,53,31,84
16641,2023-01-16,BROCK,hotZone,Quarter Pounder,4,2,6
16642,2023-01-16,BROCK,heist,Pit Stop,9,8,17
16643,2023-01-16,BROCK,gemGrab,Minecart Madness,17,11,28
16644,2023-01-16,BROCK,gemGrab,Double Swoosh,3,5,8
16645,2023-01-16,BROCK,brawlBall,Center Stage,21,26,47
16646,2023-01-16,BROCK,brawlBall,Backyard Bowl,10,7,17
16647,2023-01-16,BROCK,bounty,Hideout,52,35,87
16648,2023-01-15,BROCK,knockout,Belle's Rock,96,80,176
16649,2023-01-15,BROCK,hotZone,Quarter Pounder,18,2,20
16650,2023-01-15,BROCK,heist,Bridge Too Far,107,73,180
16651,2023-01-15,BROCK,gemGrab,Hard Rock Mine,4,1,5
16652,2023-01-15,BROCK,gemGrab,Double Swoosh,7,1,8
16653,2023-01-15,BROCK,brawlBall,Super Beach,2,0,2
16654,2023-01-15,BROCK,brawlBall,Backyard Bowl,100,133,233
16655,2023-01-15,BROCK,bounty,Canal Grande,20,8,28
16656,2023-01-14,BROCK,knockout,Flaring Phoenix,18,9,27
16657,2023-01-14,BROCK,hotZone,Controller Chaos,13,1,14
16658,2023-01-14,BROCK,heist,Bridge Too Far,133,94,227
16659,2023-01-14,BROCK,gemGrab,Hard Rock Mine,10,2,12
16660,2023-01-14,BROCK,gemGrab,Deep Diner,7,2,9
16661,2023-01-14,BROCK,brawlBall,Super Beach,21,8,29
16662,2023-01-14,BROCK,brawlBall,Sneaky Fields,1,1,2
16663,2023-01-14,BROCK,bounty,Canal Grande,32,23,55
16664,2023-01-13,BROCK,knockout,Flaring Phoenix,20,21,41
16665,2023-01-13,BROCK,hotZone,Controller Chaos,6,0,6
16666,2023-01-13,BROCK,heist,Hot Potato,4,1,5
16667,2023-01-13,BROCK,gemGrab,Deep Diner,13,2,15
16668,2023-01-13,BROCK,brawlBall,Sneaky Fields,8,2,10
16669,2023-01-13,BROCK,brawlBall,Pinhole Punt,1,3,4
16670,2023-01-13,BROCK,bounty,Temple Ruins,6,2,8
16671,2023-01-12,BROCK,knockout,Riverside,100,68,168
16672,2023-01-12,BROCK,hotZone,Open Zone,8,0,8
16673,2023-01-12,BROCK,gemGrab,Undermine,4,1,5
16674,2023-01-12,BROCK,brawlBall,Sunny Soccer,1,0,1
16675,2023-01-12,BROCK,brawlBall,Pinhole Punt,9,6,15
16676,2023-01-12,BROCK,bounty,Temple Ruins,1,0,1
16677,2023-01-11,BROCK,knockout,Riverside,15,5,20
16678,2023-01-11,BROCK,hotZone,Open Zone,1,0,1
16679,2023-01-11,BROCK,heist,Safe Zone,2,1,3
16680,2023-01-11,BROCK,gemGrab,Gem Fort,0,1,1
16681,2023-01-11,BROCK,brawlBall,Sunny Soccer,7,0,7
16682,2023-01-11,BROCK,brawlBall,Beach Ball,0,1,1
16683,2023-01-11,BROCK,bounty,Excel,3,0,3
16684,2023-01-10,BROCK,knockout,New Perspective,24,20,44
16685,2023-01-10,BROCK,hotZone,Dueling Beetles,10,16,26
16686,2023-01-10,BROCK,heist,Safe Zone,63,54,117
16687,2023-01-10,BROCK,gemGrab,Minecart Madness,15,8,23
16688,2023-01-10,BROCK,gemGrab,Crystal Arcade,9,9,18
16689,2023-01-10,BROCK,brawlBall,Center Stage,6,2,8
16690,2023-01-10,BROCK,brawlBall,Beach Ball,13,11,24
16691,2023-01-10,BROCK,bounty,Excel,8,1,9
16692,2023-01-09,BROCK,knockout,New Perspective,16,4,20
16693,2023-01-09,BROCK,hotZone,Dueling Beetles,5,0,5
16694,2023-01-09,BROCK,heist,Snaked Assault,19,18,37
16695,2023-01-09,BROCK,gemGrab,Minecart Madness,19,7,26
16696,2023-01-09,BROCK,gemGrab,Double Swoosh,12,4,16
16697,2023-01-09,BROCK,brawlBall,Center Stage,14,11,25
16698,2023-01-09,BROCK,brawlBall,Backyard Bowl,8,2,10
16699,2023-01-09,BROCK,bounty,Layer Cake,37,29,66
16700,2023-01-08,BROCK,knockout,X Marks the Spot,67,55,122
16701,2023-01-08,BROCK,hotZone,Ring of Fire,8,9,17
16702,2023-01-08,BROCK,heist,Snaked Assault,14,9,23
16703,2023-01-08,BROCK,gemGrab,Hard Rock Mine,1,0,1
16704,2023-01-08,BROCK,gemGrab,Double Swoosh,1,2,3
16705,2023-01-08,BROCK,brawlBall,Super Beach,3,5,8
16706,2023-01-08,BROCK,brawlBall,Backyard Bowl,78,74,152
16707,2023-01-08,BROCK,bounty,Layer Cake,18,8,26
16708,2023-01-07,BROCK,knockout,X Marks the Spot,43,23,66
16709,2023-01-07,BROCK,hotZone,Ring of Fire,2,0,2
16710,2023-01-07,BROCK,heist,Tornado Ring,9,5,14
16711,2023-01-07,BROCK,gemGrab,Hard Rock Mine,6,1,7
16712,2023-01-07,BROCK,gemGrab,Deep Diner,6,5,11
16713,2023-01-07,BROCK,brawlBall,Super Beach,4,2,6
16714,2023-01-07,BROCK,brawlBall,Sneaky Fields,1,0,1
16715,2023-01-07,BROCK,bounty,Dry Season,50,62,112
16716,2023-01-06,BROCK,knockout,Out in the Open,45,31,76
16717,2023-01-06,BROCK,hotZone,Split,4,0,4
16718,2023-01-06,BROCK,heist,Tornado Ring,15,2,17
16719,2023-01-06,BROCK,gemGrab,Undermine,2,2,4
16720,2023-01-06,BROCK,gemGrab,Deep Diner,9,5,14
16721,2023-01-06,BROCK,brawlBall,Sneaky Fields,5,5,10
16722,2023-01-06,BROCK,brawlBall,Pinhole Punt,0,1,1
16723,2023-01-06,BROCK,bounty,Dry Season,77,31,108
16724,2023-01-05,BROCK,knockout,Out in the Open,115,100,215
16725,2023-01-05,BROCK,hotZone,Split,9,0,9
16726,2023-01-05,BROCK,heist,Kaboom Canyon,42,28,70
16727,2023-01-05,BROCK,gemGrab,Undermine,6,3,9
16728,2023-01-05,BROCK,gemGrab,Gem Fort,5,1,6
16729,2023-01-05,BROCK,brawlBall,Sunny Soccer,1,0,1
16730,2023-01-05,BROCK,brawlBall,Pinhole Punt,20,10,30
16731,2023-01-05,BROCK,bounty,Shooting Star,53,54,107
16732,2023-01-04,BROCK,knockout,Goldarm Gulch,18,29,47
16733,2023-01-04,BROCK,hotZone,Parallel Plays,0,1,1
16734,2023-01-04,BROCK,heist,Kaboom Canyon,84,145,229
16735,2023-01-04,BROCK,gemGrab,Gem Fort,6,4,10
16736,2023-01-04,BROCK,gemGrab,Crystal Arcade,3,0,3
16737,2023-01-04,BROCK,brawlBall,Sunny Soccer,11,19,30
16738,2023-01-04,BROCK,bounty,Shooting Star,136,131,267
16739,2023-01-03,BROCK,knockout,Goldarm Gulch,14,13,27
16740,2023-01-03,BROCK,hotZone,Parallel Plays,3,0,3
16741,2023-01-03,BROCK,heist,Pit Stop,7,1,8
16742,2023-01-03,BROCK,heist,Kaboom Canyon,2,1,3
16743,2023-01-03,BROCK,gemGrab,Minecart Madness,0,1,1
16744,2023-01-03,BROCK,gemGrab,Crystal Arcade,15,39,54
16745,2023-01-03,BROCK,brawlBall,Center Stage,1,0,1
16746,2023-01-03,BROCK,brawlBall,Beach Ball,22,30,52
16747,2023-01-03,BROCK,bounty,Hideout,54,20,74
16748,2023-01-02,BROCK,knockout,Belle's Rock,55,58,113
16749,2023-01-02,BROCK,hotZone,Quarter Pounder,9,0,9
16750,2023-01-02,BROCK,heist,Pit Stop,8,0,8
16751,2023-01-02,BROCK,heist,Kaboom Canyon,0,2,2
16752,2023-01-02,BROCK,gemGrab,Minecart Madness,26,6,32
16753,2023-01-02,BROCK,gemGrab,Double Swoosh,9,4,13
16754,2023-01-02,BROCK,brawlBall,Center Stage,22,16,38
16755,2023-01-02,BROCK,brawlBall,Backyard Bowl,4,2,6
16756,2023-01-02,BROCK,bounty,Hideout,128,87,215
16757,2023-01-01,BROCK,knockout,Belle's Rock,34,15,49
16758,2023-01-01,BROCK,hotZone,Quarter Pounder,3,1,4
16759,2023-01-01,BROCK,heist,Kaboom Canyon,1,1,2
16760,2023-01-01,BROCK,heist,Bridge Too Far,15,9,24
16761,2023-01-01,BROCK,gemGrab,Double Swoosh,3,1,4
16762,2023-01-01,BROCK,brawlBall,Backyard Bowl,41,30,71
16763,2023-01-01,BROCK,bounty,Canal Grande,5,4,9
16764,2022-12-31,BROCK,knockout,Flaring Phoenix,1,0,1
16765,2022-12-31,BROCK,heist,Bridge Too Far,13,19,32
16766,2022-12-31,BROCK,gemGrab,Hard Rock Mine,1,0,1
16767,2022-12-31,BROCK,gemGrab,Deep Diner,7,12,19
16768,2022-12-31,BROCK,brawlBall,Super Beach,2,3,5
16769,2022-12-30,BROCK,knockout,Flaring Phoenix,3,2,5
16770,2022-12-30,BROCK,heist,Kaboom Canyon,0,1,1
16771,2022-12-30,BROCK,gemGrab,Deep Diner,2,0,2
16772,2022-12-30,BROCK,brawlBall,Sneaky Fields,0,2,2
16773,2022-12-29,BROCK,heist,Kaboom Canyon,1,1,2
16774,2022-12-27,BROCK,knockout,New Perspective,2,3,5
16775,2022-12-27,BROCK,hotZone,Dueling Beetles,0,1,1
16776,2022-12-27,BROCK,heist,Safe Zone,1,1,2
16777,2022-12-27,BROCK,heist,Kaboom Canyon,1,0,1
16778,2022-12-27,BROCK,bounty,Excel,0,1,1
16779,2022-12-26,BROCK,heist,Kaboom Canyon,1,0,1
16780,2022-12-26,BROCK,gemGrab,Minecart Madness,2,0,2
16781,2022-12-25,BROCK,hotZone,Ring of Fire,1,0,1
16782,2022-12-25,BROCK,gemGrab,Double Swoosh,1,1,2
16783,2022-12-25,BROCK,brawlBall,Backyard Bowl,2,10,12
16784,2022-12-24,BROCK,knockout,X Marks the Spot,0,1,1
16785,2022-12-23,BROCK,knockout,Out in the Open,5,9,14
16786,2022-12-22,BROCK,heist,Kaboom Canyon,0,1,1
16787,2022-12-22,BROCK,brawlBall,Pinhole Punt,2,0,2
16788,2022-12-20,BROCK,brawlBall,Beach Ball,4,2,6
16789,2022-12-19,BROCK,brawlBall,Center Stage,1,1,2
16790,2022-12-18,BROCK,heist,Bridge Too Far,1,0,1
16791,2022-12-16,BROCK,bounty,Temple Ruins,2,0,2
16792,2022-12-13,BROCK,heist,Safe Zone,3,2,5
16793,2022-12-13,BROCK,gemGrab,Crystal Arcade,2,1,3
16794,2022-12-10,BROCK,knockout,X Marks the Spot,1,1,2
16795,2022-11-11,BROCK,knockout,New Perspective,0,2,2
16796,2022-11-03,BROCK,brawlBall,Pinhole Punt,1,0,1
16797,2022-11-03,BROCK,bounty,Temple Ruins,1,0,1
16798,2022-11-01,BROCK,knockout,New Perspective,4,4,8
16799,2022-10-28,BROCK,knockout,Out in the Open,1,0,1
16800,2022-10-28,BROCK,heist,Safe Zone,1,1,2
16801,2022-10-28,BROCK,bounty,Canal Grande,0,2,2
16802,2022-10-26,BROCK,bounty,Shooting Star,1,0,1
16803,2022-10-15,BROCK,gemGrab,Hard Rock Mine,1,0,1
16804,2022-10-15,BROCK,brawlBall,Super Beach,1,0,1
16805,2022-10-10,BROCK,knockout,Belle's Rock,3,2,5
16806,2023-02-05,BONNIE,knockout,X Marks the Spot,73,55,128
16807,2023-02-05,BONNIE,knockout,Goldarm Gulch,10,10,20
16808,2023-02-05,BONNIE,hotZone,Ring of Fire,22,7,29
16809,2023-02-05,BONNIE,heist,Snaked Assault,19,12,31
16810,2023-02-05,BONNIE,heist,Pit Stop,6,3,9
16811,2023-02-05,BONNIE,gemGrab,Hard Rock Mine,4,2,6
16812,2023-02-05,BONNIE,gemGrab,Double Swoosh,35,16,51
16813,2023-02-05,BONNIE,brawlBall,Super Beach,2,14,16
16814,2023-02-05,BONNIE,brawlBall,Backyard Bowl,336,370,706
16815,2023-02-05,BONNIE,bounty,Layer Cake,29,30,59
16816,2023-02-04,BONNIE,knockout,X Marks the Spot,19,16,35
16817,2023-02-04,BONNIE,knockout,Goldarm Gulch,11,10,21
16818,2023-02-04,BONNIE,hotZone,Ring of Fire,6,12,18
16819,2023-02-04,BONNIE,heist,Tornado Ring,0,1,1
16820,2023-02-04,BONNIE,heist,Pit Stop,2,0,2
16821,2023-02-04,BONNIE,gemGrab,Hard Rock Mine,5,0,5
16822,2023-02-04,BONNIE,gemGrab,Double Swoosh,3,3,6
16823,2023-02-04,BONNIE,gemGrab,Deep Diner,3,2,5
16824,2023-02-04,BONNIE,brawlBall,Super Beach,26,38,64
16825,2023-02-04,BONNIE,brawlBall,Sneaky Fields,1,5,6
16826,2023-02-04,BONNIE,bounty,Dry Season,10,11,21
16827,2023-02-03,BONNIE,knockout,Out in the Open,97,101,198
16828,2023-02-03,BONNIE,knockout,Goldarm Gulch,73,57,130
16829,2023-02-03,BONNIE,hotZone,Split,7,4,11
16830,2023-02-03,BONNIE,heist,Tornado Ring,13,17,30
16831,2023-02-03,BONNIE,heist,Pit Stop,28,15,43
16832,2023-02-03,BONNIE,gemGrab,Undermine,14,10,24
16833,2023-02-03,BONNIE,gemGrab,Double Swoosh,37,23,60
16834,2023-02-03,BONNIE,gemGrab,Deep Diner,38,17,55
16835,2023-02-03,BONNIE,brawlBall,Sneaky Fields,54,68,122
16836,2023-02-03,BONNIE,brawlBall,Pinhole Punt,3,9,12
16837,2023-02-03,BONNIE,bounty,Dry Season,104,93,197
16838,2023-02-02,BONNIE,knockout,Out in the Open,47,52,99
16839,2023-02-02,BONNIE,hotZone,Split,1,2,3
16840,2023-02-02,BONNIE,heist,Kaboom Canyon,6,6,12
16841,2023-02-02,BONNIE,gemGrab,Undermine,4,6,10
16842,2023-02-02,BONNIE,gemGrab,Gem Fort,2,3,5
16843,2023-02-02,BONNIE,brawlBall,Sunny Soccer,3,6,9
16844,2023-02-02,BONNIE,brawlBall,Pinhole Punt,40,50,90
16845,2023-02-02,BONNIE,bounty,Shooting Star,15,25,40
16846,2023-02-01,BONNIE,knockout,Goldarm Gulch,78,95,173
16847,2023-02-01,BONNIE,hotZone,Parallel Plays,14,8,22
16848,2023-02-01,BONNIE,heist,Kaboom Canyon,67,88,155
16849,2023-02-01,BONNIE,gemGrab,Gem Fort,22,24,46
16850,2023-02-01,BONNIE,gemGrab,Crystal Arcade,17,28,45
16851,2023-02-01,BONNIE,brawlBall,Sunny Soccer,47,73,120
16852,2023-02-01,BONNIE,brawlBall,Beach Ball,1,4,5
16853,2023-02-01,BONNIE,bounty,Shooting Star,27,24,51
16854,2023-01-31,BONNIE,knockout,Goldarm Gulch,41,44,85
16855,2023-01-31,BONNIE,hotZone,Parallel Plays,6,5,11
16856,2023-01-31,BONNIE,heist,Pit Stop,3,1,4
16857,2023-01-31,BONNIE,gemGrab,Minecart Madness,3,2,5
16858,2023-01-31,BONNIE,gemGrab,Crystal Arcade,9,8,17
16859,2023-01-31,BONNIE,brawlBall,Center Stage,2,2,4
16860,2023-01-31,BONNIE,brawlBall,Beach Ball,42,55,97
16861,2023-01-31,BONNIE,bounty,Hideout,21,30,51
16862,2023-01-30,BONNIE,knockout,Belle's Rock,136,176,312
16863,2023-01-30,BONNIE,hotZone,Quarter Pounder,17,28,45
16864,2023-01-30,BONNIE,heist,Pit Stop,5,6,11
16865,2023-01-30,BONNIE,gemGrab,Minecart Madness,52,71,123
16866,2023-01-30,BONNIE,gemGrab,Double Swoosh,15,10,25
16867,2023-01-30,BONNIE,brawlBall,Center Stage,50,28,78
16868,2023-01-30,BONNIE,brawlBall,Backyard Bowl,30,43,73
16869,2023-01-30,BONNIE,bounty,Hideout,31,21,52
16870,2023-01-29,BONNIE,knockout,Belle's Rock,166,237,403
16871,2023-01-29,BONNIE,hotZone,Quarter Pounder,11,4,15
16872,2023-01-29,BONNIE,heist,Bridge Too Far,90,87,177
16873,2023-01-29,BONNIE,gemGrab,Hard Rock Mine,2,12,14
16874,2023-01-29,BONNIE,gemGrab,Double Swoosh,17,13,30
16875,2023-01-29,BONNIE,brawlBall,Super Beach,0,4,4
16876,2023-01-29,BONNIE,brawlBall,Backyard Bowl,309,459,768
16877,2023-01-29,BONNIE,bounty,Canal Grande,8,10,18
16878,2023-01-28,BONNIE,knockout,Flaring Phoenix,49,44,93
16879,2023-01-28,BONNIE,hotZone,Controller Chaos,11,8,19
16880,2023-01-28,BONNIE,heist,Bridge Too Far,263,329,592
16881,2023-01-28,BONNIE,gemGrab,Hard Rock Mine,47,74,121
16882,2023-01-28,BONNIE,gemGrab,Deep Diner,7,9,16
16883,2023-01-28,BONNIE,brawlBall,Super Beach,93,89,182
16884,2023-01-28,BONNIE,brawlBall,Sneaky Fields,0,1,1
16885,2023-01-28,BONNIE,bounty,Canal Grande,14,6,20
16886,2023-01-27,BONNIE,knockout,Flaring Phoenix,24,12,36
16887,2023-01-27,BONNIE,hotZone,Controller Chaos,3,3,6
16888,2023-01-27,BONNIE,heist,Hot Potato,6,1,7
16889,2023-01-27,BONNIE,gemGrab,Undermine,5,2,7
16890,2023-01-27,BONNIE,gemGrab,Deep Diner,14,14,28
16891,2023-01-27,BONNIE,brawlBall,Sneaky Fields,28,36,64
16892,2023-01-27,BONNIE,bounty,Temple Ruins,11,14,25
16893,2023-01-26,BONNIE,knockout,Riverside,124,162,286
16894,2023-01-26,BONNIE,hotZone,Open Zone,41,54,95
16895,2023-01-26,BONNIE,heist,Hot Potato,15,16,31
16896,2023-01-26,BONNIE,gemGrab,Undermine,26,27,53
16897,2023-01-26,BONNIE,gemGrab,Gem Fort,7,6,13
16898,2023-01-26,BONNIE,brawlBall,Sunny Soccer,2,15,17
16899,2023-01-26,BONNIE,brawlBall,Pinhole Punt,170,227,397
16900,2023-01-26,BONNIE,bounty,Temple Ruins,25,22,47
16901,2023-01-25,BONNIE,knockout,Riverside,57,58,115
16902,2023-01-25,BONNIE,hotZone,Open Zone,28,37,65
16903,2023-01-25,BONNIE,heist,Safe Zone,83,116,199
16904,2023-01-25,BONNIE,gemGrab,Gem Fort,8,3,11
16905,2023-01-25,BONNIE,gemGrab,Crystal Arcade,9,17,26
16906,2023-01-25,BONNIE,brawlBall,Sunny Soccer,49,40,89
16907,2023-01-25,BONNIE,brawlBall,Beach Ball,16,9,25
16908,2023-01-25,BONNIE,bounty,Excel,28,80,108
16909,2023-01-24,BONNIE,knockout,New Perspective,59,84,143
16910,2023-01-24,BONNIE,hotZone,Dueling Beetles,10,13,23
16911,2023-01-24,BONNIE,heist,Safe Zone,117,245,362
16912,2023-01-24,BONNIE,gemGrab,Minecart Madness,14,21,35
16913,2023-01-24,BONNIE,gemGrab,Crystal Arcade,25,33,58
16914,2023-01-24,BONNIE,brawlBall,Center Stage,12,15,27
16915,2023-01-24,BONNIE,brawlBall,Beach Ball,117,138,255
16916,2023-01-24,BONNIE,bounty,Excel,30,41,71
16917,2023-01-23,BONNIE,knockout,New Perspective,87,95,182
16918,2023-01-23,BONNIE,hotZone,Dueling Beetles,30,61,91
16919,2023-01-23,BONNIE,heist,Snaked Assault,12,14,26
16920,2023-01-23,BONNIE,gemGrab,Minecart Madness,89,154,243
16921,2023-01-23,BONNIE,gemGrab,Double Swoosh,4,3,7
16922,2023-01-23,BONNIE,brawlBall,Center Stage,80,76,156
16923,2023-01-23,BONNIE,brawlBall,Backyard Bowl,31,31,62
16924,2023-01-23,BONNIE,bounty,Layer Cake,38,50,88
16925,2023-01-22,BONNIE,knockout,X Marks the Spot,35,26,61
16926,2023-01-22,BONNIE,hotZone,Ring of Fire,7,6,13
16927,2023-01-22,BONNIE,heist,Snaked Assault,10,8,18
16928,2023-01-22,BONNIE,gemGrab,Hard Rock Mine,16,5,21
16929,2023-01-22,BONNIE,gemGrab,Double Swoosh,13,8,21
16930,2023-01-22,BONNIE,brawlBall,Super Beach,8,22,30
16931,2023-01-22,BONNIE,brawlBall,Backyard Bowl,131,210,341
16932,2023-01-22,BONNIE,bounty,Layer Cake,18,21,39
16933,2023-01-21,BONNIE,knockout,X Marks the Spot,150,157,307
16934,2023-01-21,BONNIE,hotZone,Ring of Fire,19,18,37
16935,2023-01-21,BONNIE,heist,Tornado Ring,11,7,18
16936,2023-01-21,BONNIE,gemGrab,Hard Rock Mine,48,42,90
16937,2023-01-21,BONNIE,gemGrab,Deep Diner,18,18,36
16938,2023-01-21,BONNIE,brawlBall,Super Beach,129,169,298
16939,2023-01-21,BONNIE,brawlBall,Sneaky Fields,2,17,19
16940,2023-01-21,BONNIE,bounty,Dry Season,74,108,182
16941,2023-01-20,BONNIE,knockout,Out in the Open,101,128,229
16942,2023-01-20,BONNIE,hotZone,Split,1,4,5
16943,2023-01-20,BONNIE,heist,Tornado Ring,16,3,19
16944,2023-01-20,BONNIE,gemGrab,Undermine,17,17,34
16945,2023-01-20,BONNIE,gemGrab,Deep Diner,47,76,123
16946,2023-01-20,BONNIE,brawlBall,Sneaky Fields,66,57,123
16947,2023-01-20,BONNIE,brawlBall,Pinhole Punt,9,5,14
16948,2023-01-20,BONNIE,bounty,Dry Season,58,76,134
16949,2023-01-19,BONNIE,knockout,Out in the Open,148,143,291
16950,2023-01-19,BONNIE,hotZone,Split,10,9,19
16951,2023-01-19,BONNIE,heist,Kaboom Canyon,37,52,89
16952,2023-01-19,BONNIE,gemGrab,Undermine,24,30,54
16953,2023-01-19,BONNIE,gemGrab,Gem Fort,2,1,3
16954,2023-01-19,BONNIE,brawlBall,Sunny Soccer,3,0,3
16955,2023-01-19,BONNIE,brawlBall,Pinhole Punt,137,191,328
16956,2023-01-19,BONNIE,bounty,Shooting Star,44,70,114
16957,2023-01-18,BONNIE,knockout,Goldarm Gulch,15,21,36
16958,2023-01-18,BONNIE,hotZone,Parallel Plays,2,0,2
16959,2023-01-18,BONNIE,heist,Kaboom Canyon,12,31,43
16960,2023-01-18,BONNIE,gemGrab,Gem Fort,1,3,4
16961,2023-01-18,BONNIE,gemGrab,Crystal Arcade,5,3,8
16962,2023-01-18,BONNIE,brawlBall,Sunny Soccer,14,18,32
16963,2023-01-18,BONNIE,brawlBall,Beach Ball,1,3,4
16964,2023-01-18,BONNIE,bounty,Shooting Star,19,21,40
16965,2023-01-17,BONNIE,knockout,Goldarm Gulch,6,7,13
16966,2023-01-17,BONNIE,hotZone,Parallel Plays,1,1,2
16967,2023-01-17,BONNIE,heist,Pit Stop,3,2,5
16968,2023-01-17,BONNIE,gemGrab,Crystal Arcade,5,1,6
16969,2023-01-17,BONNIE,brawlBall,Beach Ball,11,16,27
16970,2023-01-17,BONNIE,bounty,Hideout,4,3,7
16971,2023-01-16,BONNIE,knockout,Belle's Rock,11,3,14
16972,2023-01-16,BONNIE,hotZone,Quarter Pounder,2,0,2
16973,2023-01-16,BONNIE,heist,Pit Stop,2,0,2
16974,2023-01-16,BONNIE,gemGrab,Minecart Madness,1,9,10
16975,2023-01-16,BONNIE,gemGrab,Double Swoosh,1,1,2
16976,2023-01-16,BONNIE,brawlBall,Center Stage,2,2,4
16977,2023-01-16,BONNIE,brawlBall,Backyard Bowl,0,4,4
16978,2023-01-16,BONNIE,bounty,Hideout,2,0,2
16979,2023-01-15,BONNIE,knockout,Belle's Rock,27,50,77
16980,2023-01-15,BONNIE,hotZone,Quarter Pounder,5,3,8
16981,2023-01-15,BONNIE,heist,Bridge Too Far,34,43,77
16982,2023-01-15,BONNIE,gemGrab,Double Swoosh,3,4,7
16983,2023-01-15,BONNIE,brawlBall,Super Beach,4,13,17
16984,2023-01-15,BONNIE,brawlBall,Backyard Bowl,40,42,82
16985,2023-01-15,BONNIE,bounty,Canal Grande,2,1,3
16986,2023-01-14,BONNIE,knockout,Flaring Phoenix,3,4,7
16987,2023-01-14,BONNIE,hotZone,Controller Chaos,4,3,7
16988,2023-01-14,BONNIE,heist,Bridge Too Far,56,88,144
16989,2023-01-14,BONNIE,gemGrab,Hard Rock Mine,2,0,2
16990,2023-01-14,BONNIE,gemGrab,Deep Diner,3,4,7
16991,2023-01-14,BONNIE,brawlBall,Super Beach,12,7,19
16992,2023-01-13,BONNIE,knockout,Flaring Phoenix,6,2,8
16993,2023-01-13,BONNIE,hotZone,Controller Chaos,2,1,3
16994,2023-01-13,BONNIE,gemGrab,Deep Diner,1,0,1
16995,2023-01-13,BONNIE,brawlBall,Sneaky Fields,15,14,29
16996,2023-01-13,BONNIE,brawlBall,Pinhole Punt,1,0,1
16997,2023-01-12,BONNIE,knockout,Riverside,29,46,75
16998,2023-01-12,BONNIE,hotZone,Open Zone,8,1,9
16999,2023-01-12,BONNIE,brawlBall,Pinhole Punt,4,4,8
17000,2023-01-11,BONNIE,knockout,Riverside,2,0,2
17001,2023-01-11,BONNIE,hotZone,Open Zone,2,0,2
17002,2023-01-11,BONNIE,gemGrab,Gem Fort,1,0,1
17003,2023-01-11,BONNIE,brawlBall,Sunny Soccer,1,0,1
17004,2023-01-11,BONNIE,bounty,Excel,0,1,1
17005,2023-01-10,BONNIE,knockout,New Perspective,2,1,3
17006,2023-01-10,BONNIE,hotZone,Dueling Beetles,2,1,3
17007,2023-01-10,BONNIE,heist,Safe Zone,9,54,63
17008,2023-01-10,BONNIE,gemGrab,Minecart Madness,1,1,2
17009,2023-01-10,BONNIE,gemGrab,Crystal Arcade,4,2,6
17010,2023-01-10,BONNIE,brawlBall,Beach Ball,3,3,6
17011,2023-01-09,BONNIE,knockout,New Perspective,3,9,12
17012,2023-01-09,BONNIE,hotZone,Dueling Beetles,2,7,9
17013,2023-01-09,BONNIE,gemGrab,Minecart Madness,2,23,25
17014,2023-01-09,BONNIE,gemGrab,Double Swoosh,5,4,9
17015,2023-01-09,BONNIE,brawlBall,Center Stage,4,2,6
17016,2023-01-09,BONNIE,brawlBall,Backyard Bowl,1,0,1
17017,2023-01-09,BONNIE,bounty,Layer Cake,6,1,7
17018,2023-01-08,BONNIE,knockout,X Marks the Spot,7,7,14
17019,2023-01-08,BONNIE,hotZone,Ring of Fire,2,2,4
17020,2023-01-08,BONNIE,heist,Snaked Assault,6,2,8
17021,2023-01-08,BONNIE,gemGrab,Double Swoosh,1,0,1
17022,2023-01-08,BONNIE,brawlBall,Super Beach,0,2,2
17023,2023-01-08,BONNIE,brawlBall,Backyard Bowl,15,29,44
17024,2023-01-08,BONNIE,bounty,Layer Cake,7,3,10
17025,2023-01-07,BONNIE,knockout,X Marks the Spot,4,7,11
17026,2023-01-07,BONNIE,hotZone,Ring of Fire,0,1,1
17027,2023-01-07,BONNIE,heist,Tornado Ring,0,2,2
17028,2023-01-07,BONNIE,gemGrab,Hard Rock Mine,1,0,1
17029,2023-01-07,BONNIE,brawlBall,Super Beach,3,4,7
17030,2023-01-07,BONNIE,bounty,Dry Season,5,10,15
17031,2023-01-06,BONNIE,knockout,Out in the Open,4,0,4
17032,2023-01-06,BONNIE,hotZone,Split,1,0,1
17033,2023-01-06,BONNIE,heist,Tornado Ring,3,2,5
17034,2023-01-06,BONNIE,gemGrab,Undermine,1,3,4
17035,2023-01-06,BONNIE,gemGrab,Deep Diner,2,0,2
17036,2023-01-06,BONNIE,brawlBall,Sneaky Fields,4,8,12
17037,2023-01-06,BONNIE,brawlBall,Pinhole Punt,3,4,7
17038,2023-01-06,BONNIE,bounty,Dry Season,8,15,23
17039,2023-01-05,BONNIE,knockout,Out in the Open,18,28,46
17040,2023-01-05,BONNIE,hotZone,Split,2,0,2
17041,2023-01-05,BONNIE,heist,Kaboom Canyon,6,5,11
17042,2023-01-05,BONNIE,gemGrab,Undermine,0,2,2
17043,2023-01-05,BONNIE,gemGrab,Gem Fort,1,0,1
17044,2023-01-05,BONNIE,brawlBall,Pinhole Punt,17,30,47
17045,2023-01-05,BONNIE,bounty,Shooting Star,9,5,14
17046,2023-01-04,BONNIE,knockout,Goldarm Gulch,4,2,6
17047,2023-01-04,BONNIE,hotZone,Parallel Plays,1,0,1
17048,2023-01-04,BONNIE,heist,Kaboom Canyon,7,6,13
17049,2023-01-04,BONNIE,gemGrab,Gem Fort,1,0,1
17050,2023-01-04,BONNIE,gemGrab,Crystal Arcade,1,0,1
17051,2023-01-04,BONNIE,brawlBall,Sunny Soccer,0,3,3
17052,2023-01-04,BONNIE,bounty,Shooting Star,23,14,37
17053,2023-01-03,BONNIE,knockout,Goldarm Gulch,1,1,2
17054,2023-01-03,BONNIE,hotZone,Parallel Plays,3,0,3
17055,2023-01-03,BONNIE,gemGrab,Minecart Madness,1,0,1
17056,2023-01-03,BONNIE,gemGrab,Crystal Arcade,6,6,12
17057,2023-01-03,BONNIE,brawlBall,Beach Ball,6,12,18
17058,2023-01-03,BONNIE,bounty,Hideout,13,52,65
17059,2023-01-02,BONNIE,knockout,Belle's Rock,17,34,51
17060,2023-01-02,BONNIE,hotZone,Quarter Pounder,6,0,6
17061,2023-01-02,BONNIE,heist,Pit Stop,3,1,4
17062,2023-01-02,BONNIE,gemGrab,Minecart Madness,12,38,50
17063,2023-01-02,BONNIE,gemGrab,Double Swoosh,1,0,1
17064,2023-01-02,BONNIE,brawlBall,Center Stage,6,2,8
17065,2023-01-02,BONNIE,brawlBall,Backyard Bowl,7,13,20
17066,2023-01-02,BONNIE,bounty,Hideout,24,36,60
17067,2023-01-01,BONNIE,knockout,Belle's Rock,4,5,9
17068,2023-01-01,BONNIE,hotZone,Quarter Pounder,1,0,1
17069,2023-01-01,BONNIE,heist,Bridge Too Far,3,9,12
17070,2023-01-01,BONNIE,gemGrab,Hard Rock Mine,0,1,1
17071,2023-01-01,BONNIE,brawlBall,Backyard Bowl,11,7,18
17072,2022-12-31,BONNIE,heist,Bridge Too Far,2,6,8
17073,2022-12-31,BONNIE,gemGrab,Hard Rock Mine,1,4,5
17074,2022-12-31,BONNIE,brawlBall,Super Beach,2,0,2
17075,2022-12-30,BONNIE,gemGrab,Minecart Madness,1,0,1
17076,2022-12-30,BONNIE,brawlBall,Sneaky Fields,1,0,1
17077,2022-12-29,BONNIE,gemGrab,Minecart Madness,1,1,2
17078,2022-12-26,BONNIE,heist,Kaboom Canyon,0,1,1
17079,2022-12-26,BONNIE,gemGrab,Minecart Madness,1,0,1
17080,2022-12-25,BONNIE,brawlBall,Backyard Bowl,1,0,1
17081,2022-12-24,BONNIE,knockout,X Marks the Spot,1,1,2
17082,2022-12-24,BONNIE,brawlBall,Super Beach,0,1,1
17083,2022-12-23,BONNIE,knockout,Out in the Open,0,1,1
17084,2022-12-19,BONNIE,brawlBall,Center Stage,0,1,1
17085,2022-12-13,BONNIE,brawlBall,Beach Ball,1,0,1
17086,2022-12-11,BONNIE,brawlBall,Backyard Bowl,1,0,1
17087,2022-11-03,BONNIE,brawlBall,Pinhole Punt,1,1,2
17088,2022-10-15,BONNIE,hotZone,Ring of Fire,0,1,1
17089,2022-10-15,BONNIE,bounty,Dry Season,1,0,1
17090,2022-10-10,BONNIE,knockout,Belle's Rock,0,3,3
17091,2023-02-05,BO,knockout,X Marks the Spot,530,666,1196
17092,2023-02-05,BO,knockout,Goldarm Gulch,194,255,449
17093,2023-02-05,BO,hotZone,Ring of Fire,354,193,547
17094,2023-02-05,BO,heist,Snaked Assault,37,17,54
17095,2023-02-05,BO,heist,Pit Stop,6,9,15
17096,2023-02-05,BO,gemGrab,Hard Rock Mine,81,66,147
17097,2023-02-05,BO,gemGrab,Double Swoosh,665,630,1295
17098,2023-02-05,BO,brawlBall,Super Beach,3,10,13
17099,2023-02-05,BO,brawlBall,Sneaky Fields,37,29,66
17100,2023-02-05,BO,brawlBall,Backyard Bowl,409,399,808
17101,2023-02-05,BO,bounty,Layer Cake,143,149,292
17102,2023-02-04,BO,knockout,X Marks the Spot,176,192,368
17103,2023-02-04,BO,knockout,Goldarm Gulch,176,218,394
17104,2023-02-04,BO,hotZone,Ring of Fire,92,78,170
17105,2023-02-04,BO,heist,Tornado Ring,5,3,8
17106,2023-02-04,BO,heist,Pit Stop,3,1,4
17107,2023-02-04,BO,gemGrab,Hard Rock Mine,77,60,137
17108,2023-02-04,BO,gemGrab,Double Swoosh,128,149,277
17109,2023-02-04,BO,gemGrab,Deep Diner,31,23,54
17110,2023-02-04,BO,brawlBall,Super Beach,72,41,113
17111,2023-02-04,BO,brawlBall,Sneaky Fields,36,28,64
17112,2023-02-04,BO,bounty,Dry Season,29,17,46
17113,2023-02-03,BO,knockout,Out in the Open,488,667,1155
17114,2023-02-03,BO,knockout,Goldarm Gulch,773,1048,1821
17115,2023-02-03,BO,hotZone,Split,61,22,83
17116,2023-02-03,BO,heist,Tornado Ring,52,20,72
17117,2023-02-03,BO,heist,Pit Stop,27,7,34
17118,2023-02-03,BO,gemGrab,Undermine,66,65,131
17119,2023-02-03,BO,gemGrab,Double Swoosh,735,685,1420
17120,2023-02-03,BO,gemGrab,Deep Diner,335,228,563
17121,2023-02-03,BO,brawlBall,Sneaky Fields,556,478,1034
17122,2023-02-03,BO,brawlBall,Pinhole Punt,13,19,32
17123,2023-02-03,BO,bounty,Dry Season,275,209,484
17124,2023-02-02,BO,knockout,Out in the Open,284,366,650
17125,2023-02-02,BO,hotZone,Split,21,16,37
17126,2023-02-02,BO,heist,Kaboom Canyon,9,12,21
17127,2023-02-02,BO,gemGrab,Undermine,52,53,105
17128,2023-02-02,BO,gemGrab,Gem Fort,11,14,25
17129,2023-02-02,BO,brawlBall,Sunny Soccer,3,1,4
17130,2023-02-02,BO,brawlBall,Pinhole Punt,112,93,205
17131,2023-02-02,BO,bounty,Shooting Star,35,10,45
17132,2023-02-01,BO,knockout,Goldarm Gulch,713,1008,1721
17133,2023-02-01,BO,hotZone,Parallel Plays,135,52,187
17134,2023-02-01,BO,heist,Kaboom Canyon,35,23,58
17135,2023-02-01,BO,gemGrab,Gem Fort,201,181,382
17136,2023-02-01,BO,gemGrab,Crystal Arcade,146,133,279
17137,2023-02-01,BO,brawlBall,Sunny Soccer,192,204,396
17138,2023-02-01,BO,brawlBall,Beach Ball,8,7,15
17139,2023-02-01,BO,bounty,Shooting Star,98,55,153
17140,2023-01-31,BO,knockout,Goldarm Gulch,452,589,1041
17141,2023-01-31,BO,hotZone,Parallel Plays,47,38,85
17142,2023-01-31,BO,heist,Pit Stop,6,4,10
17143,2023-01-31,BO,gemGrab,Minecart Madness,41,34,75
17144,2023-01-31,BO,gemGrab,Crystal Arcade,132,65,197
17145,2023-01-31,BO,brawlBall,Center Stage,9,5,14
17146,2023-01-31,BO,brawlBall,Beach Ball,110,93,203
17147,2023-01-31,BO,bounty,Hideout,28,21,49
17148,2023-01-30,BO,knockout,Belle's Rock,283,355,638
17149,2023-01-30,BO,hotZone,Quarter Pounder,290,177,467
17150,2023-01-30,BO,heist,Pit Stop,19,22,41
17151,2023-01-30,BO,gemGrab,Minecart Madness,383,268,651
17152,2023-01-30,BO,gemGrab,Double Swoosh,253,218,471
17153,2023-01-30,BO,brawlBall,Center Stage,258,235,493
17154,2023-01-30,BO,brawlBall,Backyard Bowl,45,31,76
17155,2023-01-30,BO,bounty,Hideout,71,51,122
17156,2023-01-29,BO,knockout,Belle's Rock,575,691,1266
17157,2023-01-29,BO,hotZone,Quarter Pounder,254,147,401
17158,2023-01-29,BO,heist,Bridge Too Far,76,62,138
17159,2023-01-29,BO,gemGrab,Hard Rock Mine,33,42,75
17160,2023-01-29,BO,gemGrab,Double Swoosh,375,383,758
17161,2023-01-29,BO,brawlBall,Super Beach,5,7,12
17162,2023-01-29,BO,brawlBall,Backyard Bowl,501,454,955
17163,2023-01-29,BO,bounty,Canal Grande,79,55,134
17164,2023-01-28,BO,knockout,Flaring Phoenix,693,949,1642
17165,2023-01-28,BO,hotZone,Controller Chaos,122,33,155
17166,2023-01-28,BO,heist,Bridge Too Far,158,102,260
17167,2023-01-28,BO,gemGrab,Hard Rock Mine,271,207,478
17168,2023-01-28,BO,gemGrab,Deep Diner,116,71,187
17169,2023-01-28,BO,brawlBall,Super Beach,289,212,501
17170,2023-01-28,BO,brawlBall,Sneaky Fields,13,13,26
17171,2023-01-28,BO,bounty,Canal Grande,158,81,239
17172,2023-01-27,BO,knockout,Flaring Phoenix,382,470,852
17173,2023-01-27,BO,hotZone,Controller Chaos,36,24,60
17174,2023-01-27,BO,heist,Hot Potato,14,13,27
17175,2023-01-27,BO,gemGrab,Undermine,21,11,32
17176,2023-01-27,BO,gemGrab,Deep Diner,128,90,218
17177,2023-01-27,BO,brawlBall,Sneaky Fields,103,93,196
17178,2023-01-27,BO,brawlBall,Pinhole Punt,6,9,15
17179,2023-01-27,BO,bounty,Temple Ruins,27,18,45
17180,2023-01-26,BO,knockout,Riverside,127,81,208
17181,2023-01-26,BO,hotZone,Open Zone,294,188,482
17182,2023-01-26,BO,heist,Hot Potato,47,18,65
17183,2023-01-26,BO,gemGrab,Undermine,149,139,288
17184,2023-01-26,BO,gemGrab,Gem Fort,100,76,176
17185,2023-01-26,BO,brawlBall,Sunny Soccer,8,9,17
17186,2023-01-26,BO,brawlBall,Pinhole Punt,342,318,660
17187,2023-01-26,BO,bounty,Temple Ruins,107,79,186
17188,2023-01-25,BO,knockout,Riverside,64,46,110
17189,2023-01-25,BO,hotZone,Open Zone,139,93,232
17190,2023-01-25,BO,heist,Safe Zone,86,39,125
17191,2023-01-25,BO,gemGrab,Gem Fort,104,99,203
17192,2023-01-25,BO,gemGrab,Crystal Arcade,123,80,203
17193,2023-01-25,BO,brawlBall,Sunny Soccer,174,134,308
17194,2023-01-25,BO,brawlBall,Beach Ball,24,27,51
17195,2023-01-25,BO,bounty,Excel,57,25,82
17196,2023-01-24,BO,knockout,New Perspective,304,429,733
17197,2023-01-24,BO,hotZone,Dueling Beetles,273,161,434
17198,2023-01-24,BO,heist,Safe Zone,142,82,224
17199,2023-01-24,BO,gemGrab,Minecart Madness,145,96,241
17200,2023-01-24,BO,gemGrab,Crystal Arcade,300,267,567
17201,2023-01-24,BO,brawlBall,Center Stage,60,34,94
17202,2023-01-24,BO,brawlBall,Beach Ball,234,188,422
17203,2023-01-24,BO,bounty,Excel,144,123,267
17204,2023-01-23,BO,knockout,New Perspective,1149,1519,2668
17205,2023-01-23,BO,hotZone,Dueling Beetles,379,256,635
17206,2023-01-23,BO,heist,Snaked Assault,47,24,71
17207,2023-01-23,BO,gemGrab,Minecart Madness,621,524,1145
17208,2023-01-23,BO,gemGrab,Double Swoosh,190,232,422
17209,2023-01-23,BO,brawlBall,Center Stage,434,301,735
17210,2023-01-23,BO,brawlBall,Backyard Bowl,23,48,71
17211,2023-01-23,BO,bounty,Layer Cake,177,158,335
17212,2023-01-22,BO,knockout,X Marks the Spot,377,469,846
17213,2023-01-22,BO,hotZone,Ring of Fire,239,158,397
17214,2023-01-22,BO,heist,Snaked Assault,22,13,35
17215,2023-01-22,BO,gemGrab,Hard Rock Mine,84,70,154
17216,2023-01-22,BO,gemGrab,Double Swoosh,234,232,466
17217,2023-01-22,BO,brawlBall,Super Beach,37,28,65
17218,2023-01-22,BO,brawlBall,Backyard Bowl,223,188,411
17219,2023-01-22,BO,bounty,Layer Cake,122,123,245
17220,2023-01-21,BO,knockout,X Marks the Spot,1392,1716,3108
17221,2023-01-21,BO,hotZone,Ring of Fire,541,453,994
17222,2023-01-21,BO,heist,Tornado Ring,43,17,60
17223,2023-01-21,BO,gemGrab,Hard Rock Mine,405,303,708
17224,2023-01-21,BO,gemGrab,Deep Diner,107,88,195
17225,2023-01-21,BO,brawlBall,Super Beach,403,332,735
17226,2023-01-21,BO,brawlBall,Sneaky Fields,10,16,26
17227,2023-01-21,BO,bounty,Dry Season,254,152,406
17228,2023-01-20,BO,knockout,Out in the Open,591,813,1404
17229,2023-01-20,BO,hotZone,Split,79,32,111
17230,2023-01-20,BO,heist,Tornado Ring,48,26,74
17231,2023-01-20,BO,gemGrab,Undermine,110,121,231
17232,2023-01-20,BO,gemGrab,Deep Diner,362,277,639
17233,2023-01-20,BO,brawlBall,Sneaky Fields,235,200,435
17234,2023-01-20,BO,brawlBall,Pinhole Punt,21,21,42
17235,2023-01-20,BO,bounty,Dry Season,146,96,242
17236,2023-01-19,BO,knockout,Out in the Open,1230,1545,2775
17237,2023-01-19,BO,hotZone,Split,81,25,106
17238,2023-01-19,BO,heist,Kaboom Canyon,59,28,87
17239,2023-01-19,BO,gemGrab,Undermine,282,222,504
17240,2023-01-19,BO,gemGrab,Gem Fort,54,61,115
17241,2023-01-19,BO,brawlBall,Sunny Soccer,5,6,11
17242,2023-01-19,BO,brawlBall,Pinhole Punt,368,353,721
17243,2023-01-19,BO,bounty,Shooting Star,129,89,218
17244,2023-01-18,BO,knockout,Goldarm Gulch,100,132,232
17245,2023-01-18,BO,hotZone,Parallel Plays,22,24,46
17246,2023-01-18,BO,heist,Kaboom Canyon,22,4,26
17247,2023-01-18,BO,gemGrab,Gem Fort,45,40,85
17248,2023-01-18,BO,gemGrab,Crystal Arcade,19,11,30
17249,2023-01-18,BO,brawlBall,Sunny Soccer,53,49,102
17250,2023-01-18,BO,brawlBall,Beach Ball,4,7,11
17251,2023-01-18,BO,bounty,Shooting Star,53,44,97
17252,2023-01-17,BO,knockout,Goldarm Gulch,95,129,224
17253,2023-01-17,BO,hotZone,Parallel Plays,9,4,13
17254,2023-01-17,BO,heist,Pit Stop,6,0,6
17255,2023-01-17,BO,gemGrab,Minecart Madness,3,3,6
17256,2023-01-17,BO,gemGrab,Crystal Arcade,25,28,53
17257,2023-01-17,BO,brawlBall,Center Stage,4,1,5
17258,2023-01-17,BO,brawlBall,Beach Ball,12,13,25
17259,2023-01-17,BO,bounty,Hideout,5,1,6
17260,2023-01-16,BO,knockout,Belle's Rock,22,55,77
17261,2023-01-16,BO,hotZone,Quarter Pounder,48,31,79
17262,2023-01-16,BO,heist,Pit Stop,5,0,5
17263,2023-01-16,BO,gemGrab,Minecart Madness,40,27,67
17264,2023-01-16,BO,gemGrab,Double Swoosh,24,17,41
17265,2023-01-16,BO,brawlBall,Center Stage,15,19,34
17266,2023-01-16,BO,brawlBall,Backyard Bowl,5,3,8
17267,2023-01-16,BO,bounty,Hideout,21,11,32
17268,2023-01-15,BO,knockout,Belle's Rock,71,64,135
17269,2023-01-15,BO,hotZone,Quarter Pounder,57,25,82
17270,2023-01-15,BO,heist,Bridge Too Far,18,5,23
17271,2023-01-15,BO,gemGrab,Hard Rock Mine,13,10,23
17272,2023-01-15,BO,gemGrab,Double Swoosh,53,46,99
17273,2023-01-15,BO,brawlBall,Super Beach,11,25,36
17274,2023-01-15,BO,brawlBall,Backyard Bowl,60,60,120
17275,2023-01-15,BO,bounty,Canal Grande,11,9,20
17276,2023-01-14,BO,knockout,Flaring Phoenix,58,98,156
17277,2023-01-14,BO,hotZone,Controller Chaos,31,3,34
17278,2023-01-14,BO,heist,Bridge Too Far,25,25,50
17279,2023-01-14,BO,gemGrab,Hard Rock Mine,22,9,31
17280,2023-01-14,BO,gemGrab,Deep Diner,16,3,19
17281,2023-01-14,BO,brawlBall,Super Beach,23,31,54
17282,2023-01-14,BO,brawlBall,Sneaky Fields,3,0,3
17283,2023-01-14,BO,bounty,Canal Grande,12,11,23
17284,2023-01-13,BO,knockout,Flaring Phoenix,65,72,137
17285,2023-01-13,BO,hotZone,Controller Chaos,24,3,27
17286,2023-01-13,BO,heist,Hot Potato,4,1,5
17287,2023-01-13,BO,gemGrab,Deep Diner,35,18,53
17288,2023-01-13,BO,brawlBall,Sneaky Fields,29,21,50
17289,2023-01-13,BO,bounty,Temple Ruins,5,2,7
17290,2023-01-12,BO,knockout,Riverside,12,5,17
17291,2023-01-12,BO,hotZone,Open Zone,48,9,57
17292,2023-01-12,BO,heist,Hot Potato,3,0,3
17293,2023-01-12,BO,gemGrab,Undermine,13,3,16
17294,2023-01-12,BO,gemGrab,Gem Fort,3,1,4
17295,2023-01-12,BO,brawlBall,Pinhole Punt,13,3,16
17296,2023-01-12,BO,bounty,Temple Ruins,1,0,1
17297,2023-01-11,BO,knockout,Riverside,1,0,1
17298,2023-01-11,BO,hotZone,Open Zone,14,18,32
17299,2023-01-11,BO,heist,Safe Zone,1,2,3
17300,2023-01-11,BO,gemGrab,Gem Fort,10,21,31
17301,2023-01-11,BO,brawlBall,Sunny Soccer,6,3,9
17302,2023-01-11,BO,brawlBall,Beach Ball,0,1,1
17303,2023-01-11,BO,bounty,Excel,3,0,3
17304,2023-01-10,BO,knockout,New Perspective,16,34,50
17305,2023-01-10,BO,hotZone,Dueling Beetles,61,30,91
17306,2023-01-10,BO,heist,Safe Zone,14,26,40
17307,2023-01-10,BO,gemGrab,Minecart Madness,35,7,42
17308,2023-01-10,BO,gemGrab,Crystal Arcade,27,12,39
17309,2023-01-10,BO,brawlBall,Center Stage,1,0,1
17310,2023-01-10,BO,brawlBall,Beach Ball,16,2,18
17311,2023-01-10,BO,bounty,Excel,7,2,9
17312,2023-01-09,BO,knockout,New Perspective,65,82,147
17313,2023-01-09,BO,hotZone,Dueling Beetles,40,32,72
17314,2023-01-09,BO,heist,Snaked Assault,11,0,11
17315,2023-01-09,BO,gemGrab,Minecart Madness,70,45,115
17316,2023-01-09,BO,gemGrab,Double Swoosh,31,26,57
17317,2023-01-09,BO,brawlBall,Center Stage,10,11,21
17318,2023-01-09,BO,brawlBall,Backyard Bowl,1,0,1
17319,2023-01-09,BO,bounty,Layer Cake,25,28,53
17320,2023-01-08,BO,knockout,X Marks the Spot,59,100,159
17321,2023-01-08,BO,hotZone,Ring of Fire,60,44,104
17322,2023-01-08,BO,heist,Snaked Assault,4,0,4
17323,2023-01-08,BO,gemGrab,Hard Rock Mine,5,5,10
17324,2023-01-08,BO,gemGrab,Double Swoosh,17,8,25
17325,2023-01-08,BO,brawlBall,Super Beach,4,0,4
17326,2023-01-08,BO,brawlBall,Backyard Bowl,30,35,65
17327,2023-01-08,BO,bounty,Layer Cake,8,6,14
17328,2023-01-07,BO,knockout,X Marks the Spot,44,43,87
17329,2023-01-07,BO,hotZone,Ring of Fire,36,27,63
17330,2023-01-07,BO,heist,Tornado Ring,8,8,16
17331,2023-01-07,BO,gemGrab,Hard Rock Mine,15,23,38
17332,2023-01-07,BO,gemGrab,Deep Diner,20,25,45
17333,2023-01-07,BO,brawlBall,Super Beach,11,11,22
17334,2023-01-07,BO,brawlBall,Sneaky Fields,1,0,1
17335,2023-01-07,BO,bounty,Dry Season,27,11,38
17336,2023-01-06,BO,knockout,Out in the Open,71,119,190
17337,2023-01-06,BO,hotZone,Split,5,1,6
17338,2023-01-06,BO,heist,Tornado Ring,6,3,9
17339,2023-01-06,BO,gemGrab,Undermine,18,16,34
17340,2023-01-06,BO,gemGrab,Deep Diner,48,29,77
17341,2023-01-06,BO,brawlBall,Sneaky Fields,12,6,18
17342,2023-01-06,BO,brawlBall,Pinhole Punt,4,3,7
17343,2023-01-06,BO,bounty,Dry Season,18,13,31
17344,2023-01-05,BO,knockout,Out in the Open,136,160,296
17345,2023-01-05,BO,hotZone,Split,15,0,15
17346,2023-01-05,BO,heist,Kaboom Canyon,9,0,9
17347,2023-01-05,BO,gemGrab,Undermine,49,63,112
17348,2023-01-05,BO,gemGrab,Gem Fort,2,0,2
17349,2023-01-05,BO,brawlBall,Pinhole Punt,51,67,118
17350,2023-01-05,BO,bounty,Shooting Star,12,2,14
17351,2023-01-04,BO,knockout,Goldarm Gulch,26,35,61
17352,2023-01-04,BO,hotZone,Parallel Plays,12,2,14
17353,2023-01-04,BO,heist,Kaboom Canyon,15,1,16
17354,2023-01-04,BO,gemGrab,Gem Fort,19,9,28
17355,2023-01-04,BO,gemGrab,Crystal Arcade,12,11,23
17356,2023-01-04,BO,brawlBall,Sunny Soccer,6,4,10
17357,2023-01-04,BO,bounty,Shooting Star,30,6,36
17358,2023-01-03,BO,knockout,Goldarm Gulch,25,36,61
17359,2023-01-03,BO,hotZone,Parallel Plays,9,0,9
17360,2023-01-03,BO,hotZone,Controller Chaos,1,0,1
17361,2023-01-03,BO,heist,Pit Stop,4,0,4
17362,2023-01-03,BO,gemGrab,Minecart Madness,18,5,23
17363,2023-01-03,BO,gemGrab,Crystal Arcade,35,8,43
17364,2023-01-03,BO,brawlBall,Beach Ball,21,23,44
17365,2023-01-03,BO,bounty,Hideout,13,0,13
17366,2023-01-02,BO,knockout,Belle's Rock,23,30,53
17367,2023-01-02,BO,hotZone,Quarter Pounder,51,9,60
17368,2023-01-02,BO,hotZone,Controller Chaos,1,0,1
17369,2023-01-02,BO,heist,Pit Stop,1,1,2
17370,2023-01-02,BO,heist,Kaboom Canyon,1,0,1
17371,2023-01-02,BO,gemGrab,Minecart Madness,71,85,156
17372,2023-01-02,BO,gemGrab,Double Swoosh,45,36,81
17373,2023-01-02,BO,brawlBall,Center Stage,19,8,27
17374,2023-01-02,BO,brawlBall,Backyard Bowl,3,0,3
17375,2023-01-02,BO,bounty,Hideout,34,10,44
17376,2023-01-01,BO,knockout,Belle's Rock,10,21,31
17377,2023-01-01,BO,hotZone,Quarter Pounder,13,1,14
17378,2023-01-01,BO,heist,Bridge Too Far,1,0,1
17379,2023-01-01,BO,gemGrab,Hard Rock Mine,0,1,1
17380,2023-01-01,BO,gemGrab,Double Swoosh,15,14,29
17381,2023-01-01,BO,brawlBall,Backyard Bowl,17,13,30
17382,2022-12-31,BO,knockout,Flaring Phoenix,2,2,4
17383,2022-12-31,BO,hotZone,Controller Chaos,2,1,3
17384,2022-12-31,BO,heist,Bridge Too Far,3,1,4
17385,2022-12-31,BO,gemGrab,Minecart Madness,1,0,1
17386,2022-12-31,BO,gemGrab,Hard Rock Mine,7,2,9
17387,2022-12-31,BO,gemGrab,Deep Diner,10,0,10
17388,2022-12-31,BO,brawlBall,Super Beach,0,1,1
17389,2022-12-31,BO,brawlBall,Sneaky Fields,1,0,1
17390,2022-12-30,BO,knockout,Flaring Phoenix,3,4,7
17391,2022-12-30,BO,hotZone,Controller Chaos,3,1,4
17392,2022-12-30,BO,gemGrab,Undermine,2,0,2
17393,2022-12-30,BO,gemGrab,Minecart Madness,0,1,1
17394,2022-12-30,BO,gemGrab,Deep Diner,5,2,7
17395,2022-12-30,BO,brawlBall,Sneaky Fields,2,1,3
17396,2022-12-29,BO,hotZone,Open Zone,5,2,7
17397,2022-12-29,BO,heist,Hot Potato,1,0,1
17398,2022-12-29,BO,gemGrab,Undermine,2,1,3
17399,2022-12-29,BO,gemGrab,Minecart Madness,1,0,1
17400,2022-12-29,BO,gemGrab,Gem Fort,2,2,4
17401,2022-12-29,BO,brawlBall,Pinhole Punt,4,11,15
17402,2022-12-28,BO,hotZone,Open Zone,1,0,1
17403,2022-12-28,BO,hotZone,Controller Chaos,1,0,1
17404,2022-12-28,BO,gemGrab,Crystal Arcade,0,1,1
17405,2022-12-28,BO,brawlBall,Sunny Soccer,0,1,1
17406,2022-12-27,BO,knockout,New Perspective,2,3,5
17407,2022-12-27,BO,hotZone,Dueling Beetles,0,1,1
17408,2022-12-27,BO,hotZone,Controller Chaos,1,0,1
17409,2022-12-27,BO,heist,Safe Zone,0,1,1
17410,2022-12-27,BO,heist,Kaboom Canyon,1,0,1
17411,2022-12-27,BO,gemGrab,Minecart Madness,0,1,1
17412,2022-12-27,BO,bounty,Excel,0,1,1
17413,2022-12-26,BO,heist,Kaboom Canyon,1,0,1
17414,2022-12-25,BO,gemGrab,Double Swoosh,1,0,1
17415,2022-12-25,BO,brawlBall,Backyard Bowl,1,0,1
17416,2022-12-24,BO,bounty,Dry Season,1,0,1
17417,2022-12-23,BO,knockout,Out in the Open,0,1,1
17418,2022-12-22,BO,gemGrab,Gem Fort,1,1,2
17419,2022-12-20,BO,brawlBall,Beach Ball,1,0,1
17420,2022-12-17,BO,knockout,Flaring Phoenix,2,4,6
17421,2022-12-16,BO,bounty,Temple Ruins,1,0,1
17422,2022-12-13,BO,knockout,New Perspective,2,1,3
17423,2022-12-13,BO,gemGrab,Crystal Arcade,3,1,4
17424,2022-12-10,BO,gemGrab,Hard Rock Mine,0,1,1
17425,2022-10-28,BO,bounty,Canal Grande,1,0,1
17426,2022-10-26,BO,bounty,Shooting Star,2,0,2
17427,2022-10-15,BO,gemGrab,Hard Rock Mine,1,2,3
17428,2023-02-05,BIBI,knockout,X Marks the Spot,28,10,38
17429,2023-02-05,BIBI,knockout,Goldarm Gulch,0,2,2
17430,2023-02-05,BIBI,hotZone,Ring of Fire,43,16,59
17431,2023-02-05,BIBI,heist,Snaked Assault,428,450,878
17432,2023-02-05,BIBI,heist,Pit Stop,199,267,466
17433,2023-02-05,BIBI,gemGrab,Hard Rock Mine,35,31,66
17434,2023-02-05,BIBI,gemGrab,Double Swoosh,175,98,273
17435,2023-02-05,BIBI,brawlBall,Super Beach,45,45,90
17436,2023-02-05,BIBI,brawlBall,Sneaky Fields,77,37,114
17437,2023-02-05,BIBI,brawlBall,Backyard Bowl,531,482,1013
17438,2023-02-05,BIBI,bounty,Layer Cake,27,51,78
17439,2023-02-04,BIBI,knockout,X Marks the Spot,9,4,13
17440,2023-02-04,BIBI,hotZone,Ring of Fire,5,6,11
17441,2023-02-04,BIBI,heist,Tornado Ring,96,74,170
17442,2023-02-04,BIBI,heist,Pit Stop,130,155,285
17443,2023-02-04,BIBI,gemGrab,Hard Rock Mine,28,12,40
17444,2023-02-04,BIBI,gemGrab,Double Swoosh,23,11,34
17445,2023-02-04,BIBI,gemGrab,Deep Diner,8,4,12
17446,2023-02-04,BIBI,brawlBall,Super Beach,414,404,818
17447,2023-02-04,BIBI,brawlBall,Sneaky Fields,66,42,108
17448,2023-02-04,BIBI,bounty,Dry Season,3,3,6
17449,2023-02-03,BIBI,knockout,Out in the Open,35,17,52
17450,2023-02-03,BIBI,knockout,Goldarm Gulch,2,3,5
17451,2023-02-03,BIBI,hotZone,Split,160,171,331
17452,2023-02-03,BIBI,heist,Tornado Ring,1056,1133,2189
17453,2023-02-03,BIBI,heist,Pit Stop,659,1085,1744
17454,2023-02-03,BIBI,gemGrab,Undermine,27,15,42
17455,2023-02-03,BIBI,gemGrab,Double Swoosh,140,51,191
17456,2023-02-03,BIBI,gemGrab,Deep Diner,74,92,166
17457,2023-02-03,BIBI,brawlBall,Sneaky Fields,2356,1847,4203
17458,2023-02-03,BIBI,brawlBall,Pinhole Punt,52,34,86
17459,2023-02-03,BIBI,bounty,Dry Season,24,11,35
17460,2023-02-02,BIBI,knockout,Out in the Open,12,5,17
17461,2023-02-02,BIBI,hotZone,Split,95,118,213
17462,2023-02-02,BIBI,heist,Kaboom Canyon,10,5,15
17463,2023-02-02,BIBI,gemGrab,Undermine,19,13,32
17464,2023-02-02,BIBI,gemGrab,Gem Fort,3,8,11
17465,2023-02-02,BIBI,brawlBall,Sunny Soccer,16,7,23
17466,2023-02-02,BIBI,brawlBall,Pinhole Punt,314,287,601
17467,2023-02-02,BIBI,bounty,Shooting Star,6,0,6
17468,2023-02-01,BIBI,knockout,Goldarm Gulch,73,33,106
17469,2023-02-01,BIBI,hotZone,Parallel Plays,262,239,501
17470,2023-02-01,BIBI,heist,Kaboom Canyon,68,84,152
17471,2023-02-01,BIBI,gemGrab,Gem Fort,82,107,189
17472,2023-02-01,BIBI,gemGrab,Crystal Arcade,42,21,63
17473,2023-02-01,BIBI,brawlBall,Sunny Soccer,1282,1281,2563
17474,2023-02-01,BIBI,brawlBall,Beach Ball,37,30,67
17475,2023-02-01,BIBI,bounty,Shooting Star,4,3,7
17476,2023-01-31,BIBI,knockout,Goldarm Gulch,23,20,43
17477,2023-01-31,BIBI,hotZone,Parallel Plays,122,103,225
17478,2023-01-31,BIBI,heist,Pit Stop,183,221,404
17479,2023-01-31,BIBI,gemGrab,Minecart Madness,10,5,15
17480,2023-01-31,BIBI,gemGrab,Crystal Arcade,62,53,115
17481,2023-01-31,BIBI,brawlBall,Center Stage,10,7,17
17482,2023-01-31,BIBI,brawlBall,Beach Ball,482,412,894
17483,2023-01-31,BIBI,bounty,Hideout,3,4,7
17484,2023-01-30,BIBI,knockout,Belle's Rock,57,26,83
17485,2023-01-30,BIBI,hotZone,Quarter Pounder,152,105,257
17486,2023-01-30,BIBI,heist,Pit Stop,761,938,1699
17487,2023-01-30,BIBI,gemGrab,Minecart Madness,56,45,101
17488,2023-01-30,BIBI,gemGrab,Double Swoosh,57,41,98
17489,2023-01-30,BIBI,brawlBall,Center Stage,910,789,1699
17490,2023-01-30,BIBI,brawlBall,Backyard Bowl,64,59,123
17491,2023-01-30,BIBI,bounty,Hideout,5,6,11
17492,2023-01-29,BIBI,knockout,Belle's Rock,52,35,87
17493,2023-01-29,BIBI,hotZone,Quarter Pounder,81,64,145
17494,2023-01-29,BIBI,heist,Bridge Too Far,33,45,78
17495,2023-01-29,BIBI,gemGrab,Hard Rock Mine,29,22,51
17496,2023-01-29,BIBI,gemGrab,Double Swoosh,100,71,171
17497,2023-01-29,BIBI,brawlBall,Super Beach,23,28,51
17498,2023-01-29,BIBI,brawlBall,Backyard Bowl,615,471,1086
17499,2023-01-29,BIBI,bounty,Canal Grande,51,30,81
17500,2023-01-28,BIBI,knockout,Flaring Phoenix,25,18,43
17501,2023-01-28,BIBI,hotZone,Controller Chaos,164,110,274
17502,2023-01-28,BIBI,heist,Bridge Too Far,74,57,131
17503,2023-01-28,BIBI,gemGrab,Hard Rock Mine,110,119,229
17504,2023-01-28,BIBI,gemGrab,Deep Diner,24,14,38
17505,2023-01-28,BIBI,brawlBall,Super Beach,1697,1574,3271
17506,2023-01-28,BIBI,brawlBall,Sneaky Fields,57,40,97
17507,2023-01-28,BIBI,bounty,Canal Grande,64,36,100
17508,2023-01-27,BIBI,knockout,Flaring Phoenix,9,4,13
17509,2023-01-27,BIBI,hotZone,Controller Chaos,35,38,73
17510,2023-01-27,BIBI,heist,Hot Potato,116,148,264
17511,2023-01-27,BIBI,gemGrab,Undermine,5,4,9
17512,2023-01-27,BIBI,gemGrab,Deep Diner,29,21,50
17513,2023-01-27,BIBI,brawlBall,Sneaky Fields,458,435,893
17514,2023-01-27,BIBI,brawlBall,Pinhole Punt,9,9,18
17515,2023-01-27,BIBI,bounty,Temple Ruins,5,13,18
17516,2023-01-26,BIBI,knockout,Riverside,14,6,20
17517,2023-01-26,BIBI,hotZone,Open Zone,36,20,56
17518,2023-01-26,BIBI,heist,Hot Potato,694,721,1415
17519,2023-01-26,BIBI,gemGrab,Undermine,58,51,109
17520,2023-01-26,BIBI,gemGrab,Gem Fort,30,21,51
17521,2023-01-26,BIBI,brawlBall,Sunny Soccer,74,61,135
17522,2023-01-26,BIBI,brawlBall,Pinhole Punt,1025,932,1957
17523,2023-01-26,BIBI,bounty,Temple Ruins,22,9,31
17524,2023-01-25,BIBI,knockout,Riverside,10,6,16
17525,2023-01-25,BIBI,hotZone,Open Zone,13,8,21
17526,2023-01-25,BIBI,heist,Safe Zone,72,113,185
17527,2023-01-25,BIBI,gemGrab,Gem Fort,38,45,83
17528,2023-01-25,BIBI,gemGrab,Crystal Arcade,55,59,114
17529,2023-01-25,BIBI,brawlBall,Sunny Soccer,861,743,1604
17530,2023-01-25,BIBI,brawlBall,Beach Ball,97,83,180
17531,2023-01-25,BIBI,bounty,Excel,27,40,67
17532,2023-01-24,BIBI,knockout,New Perspective,24,9,33
17533,2023-01-24,BIBI,hotZone,Dueling Beetles,82,43,125
17534,2023-01-24,BIBI,heist,Safe Zone,160,181,341
17535,2023-01-24,BIBI,gemGrab,Minecart Madness,19,19,38
17536,2023-01-24,BIBI,gemGrab,Crystal Arcade,80,72,152
17537,2023-01-24,BIBI,brawlBall,Center Stage,128,81,209
17538,2023-01-24,BIBI,brawlBall,Beach Ball,1216,1039,2255
17539,2023-01-24,BIBI,bounty,Excel,51,40,91
17540,2023-01-23,BIBI,knockout,New Perspective,42,26,68
17541,2023-01-23,BIBI,hotZone,Dueling Beetles,101,123,224
17542,2023-01-23,BIBI,heist,Snaked Assault,482,556,1038
17543,2023-01-23,BIBI,gemGrab,Minecart Madness,113,65,178
17544,2023-01-23,BIBI,gemGrab,Double Swoosh,34,23,57
17545,2023-01-23,BIBI,brawlBall,Center Stage,1619,1348,2967
17546,2023-01-23,BIBI,brawlBall,Backyard Bowl,38,23,61
17547,2023-01-23,BIBI,bounty,Layer Cake,60,38,98
17548,2023-01-22,BIBI,knockout,X Marks the Spot,17,8,25
17549,2023-01-22,BIBI,hotZone,Ring of Fire,16,11,27
17550,2023-01-22,BIBI,heist,Snaked Assault,287,284,571
17551,2023-01-22,BIBI,gemGrab,Hard Rock Mine,34,19,53
17552,2023-01-22,BIBI,gemGrab,Double Swoosh,52,38,90
17553,2023-01-22,BIBI,brawlBall,Super Beach,166,159,325
17554,2023-01-22,BIBI,brawlBall,Backyard Bowl,288,260,548
17555,2023-01-22,BIBI,bounty,Layer Cake,25,30,55
17556,2023-01-21,BIBI,knockout,X Marks the Spot,63,34,97
17557,2023-01-21,BIBI,hotZone,Ring of Fire,38,34,72
17558,2023-01-21,BIBI,heist,Tornado Ring,535,614,1149
17559,2023-01-21,BIBI,gemGrab,Hard Rock Mine,129,113,242
17560,2023-01-21,BIBI,gemGrab,Deep Diner,25,10,35
17561,2023-01-21,BIBI,brawlBall,Super Beach,2166,2053,4219
17562,2023-01-21,BIBI,brawlBall,Sneaky Fields,70,65,135
17563,2023-01-21,BIBI,bounty,Dry Season,23,15,38
17564,2023-01-20,BIBI,knockout,Out in the Open,32,19,51
17565,2023-01-20,BIBI,hotZone,Split,179,198,377
17566,2023-01-20,BIBI,heist,Tornado Ring,713,826,1539
17567,2023-01-20,BIBI,gemGrab,Undermine,27,14,41
17568,2023-01-20,BIBI,gemGrab,Deep Diner,99,92,191
17569,2023-01-20,BIBI,brawlBall,Sneaky Fields,1690,1510,3200
17570,2023-01-20,BIBI,brawlBall,Pinhole Punt,38,44,82
17571,2023-01-20,BIBI,bounty,Dry Season,15,14,29
17572,2023-01-19,BIBI,knockout,Out in the Open,35,24,59
17573,2023-01-19,BIBI,hotZone,Split,300,291,591
17574,2023-01-19,BIBI,heist,Kaboom Canyon,71,62,133
17575,2023-01-19,BIBI,gemGrab,Undermine,91,81,172
17576,2023-01-19,BIBI,gemGrab,Gem Fort,18,10,28
17577,2023-01-19,BIBI,brawlBall,Sunny Soccer,54,44,98
17578,2023-01-19,BIBI,brawlBall,Pinhole Punt,1135,962,2097
17579,2023-01-19,BIBI,bounty,Shooting Star,13,5,18
17580,2023-01-18,BIBI,knockout,Goldarm Gulch,4,2,6
17581,2023-01-18,BIBI,hotZone,Parallel Plays,12,11,23
17582,2023-01-18,BIBI,heist,Kaboom Canyon,22,15,37
17583,2023-01-18,BIBI,gemGrab,Gem Fort,15,12,27
17584,2023-01-18,BIBI,gemGrab,Crystal Arcade,5,1,6
17585,2023-01-18,BIBI,brawlBall,Sunny Soccer,396,392,788
17586,2023-01-18,BIBI,brawlBall,Beach Ball,16,15,31
17587,2023-01-18,BIBI,bounty,Shooting Star,5,3,8
17588,2023-01-17,BIBI,knockout,Goldarm Gulch,3,6,9
17589,2023-01-17,BIBI,hotZone,Parallel Plays,11,10,21
17590,2023-01-17,BIBI,heist,Pit Stop,53,74,127
17591,2023-01-17,BIBI,gemGrab,Minecart Madness,1,1,2
17592,2023-01-17,BIBI,gemGrab,Crystal Arcade,11,5,16
17593,2023-01-17,BIBI,brawlBall,Center Stage,7,2,9
17594,2023-01-17,BIBI,brawlBall,Beach Ball,125,105,230
17595,2023-01-17,BIBI,bounty,Hideout,2,3,5
17596,2023-01-16,BIBI,knockout,Belle's Rock,1,3,4
17597,2023-01-16,BIBI,hotZone,Quarter Pounder,13,10,23
17598,2023-01-16,BIBI,heist,Pit Stop,247,295,542
17599,2023-01-16,BIBI,gemGrab,Minecart Madness,10,5,15
17600,2023-01-16,BIBI,gemGrab,Double Swoosh,3,0,3
17601,2023-01-16,BIBI,brawlBall,Center Stage,104,87,191
17602,2023-01-16,BIBI,brawlBall,Backyard Bowl,9,5,14
17603,2023-01-16,BIBI,bounty,Hideout,4,2,6
17604,2023-01-15,BIBI,knockout,Belle's Rock,9,2,11
17605,2023-01-15,BIBI,hotZone,Quarter Pounder,40,8,48
17606,2023-01-15,BIBI,heist,Bridge Too Far,14,15,29
17607,2023-01-15,BIBI,gemGrab,Hard Rock Mine,6,0,6
17608,2023-01-15,BIBI,gemGrab,Double Swoosh,13,4,17
17609,2023-01-15,BIBI,brawlBall,Super Beach,22,23,45
17610,2023-01-15,BIBI,brawlBall,Backyard Bowl,79,39,118
17611,2023-01-15,BIBI,bounty,Canal Grande,8,2,10
17612,2023-01-14,BIBI,hotZone,Controller Chaos,36,39,75
17613,2023-01-14,BIBI,heist,Bridge Too Far,18,17,35
17614,2023-01-14,BIBI,gemGrab,Hard Rock Mine,4,0,4
17615,2023-01-14,BIBI,gemGrab,Deep Diner,2,1,3
17616,2023-01-14,BIBI,brawlBall,Super Beach,129,98,227
17617,2023-01-14,BIBI,brawlBall,Sneaky Fields,12,13,25
17618,2023-01-14,BIBI,bounty,Canal Grande,7,4,11
17619,2023-01-13,BIBI,knockout,Flaring Phoenix,1,1,2
17620,2023-01-13,BIBI,hotZone,Controller Chaos,22,19,41
17621,2023-01-13,BIBI,heist,Hot Potato,25,23,48
17622,2023-01-13,BIBI,gemGrab,Undermine,1,0,1
17623,2023-01-13,BIBI,gemGrab,Deep Diner,11,1,12
17624,2023-01-13,BIBI,brawlBall,Sneaky Fields,83,54,137
17625,2023-01-13,BIBI,brawlBall,Pinhole Punt,3,0,3
17626,2023-01-13,BIBI,bounty,Temple Ruins,2,0,2
17627,2023-01-12,BIBI,knockout,Riverside,1,0,1
17628,2023-01-12,BIBI,hotZone,Open Zone,3,0,3
17629,2023-01-12,BIBI,heist,Hot Potato,19,5,24
17630,2023-01-12,BIBI,gemGrab,Undermine,0,1,1
17631,2023-01-12,BIBI,brawlBall,Sunny Soccer,2,2,4
17632,2023-01-12,BIBI,brawlBall,Pinhole Punt,34,34,68
17633,2023-01-11,BIBI,hotZone,Open Zone,2,0,2
17634,2023-01-11,BIBI,gemGrab,Gem Fort,1,0,1
17635,2023-01-11,BIBI,brawlBall,Sunny Soccer,29,27,56
17636,2023-01-11,BIBI,brawlBall,Beach Ball,0,1,1
17637,2023-01-11,BIBI,bounty,Excel,4,0,4
17638,2023-01-10,BIBI,hotZone,Dueling Beetles,19,5,24
17639,2023-01-10,BIBI,heist,Safe Zone,9,3,12
17640,2023-01-10,BIBI,gemGrab,Minecart Madness,5,0,5
17641,2023-01-10,BIBI,gemGrab,Crystal Arcade,11,8,19
17642,2023-01-10,BIBI,brawlBall,Center Stage,10,0,10
17643,2023-01-10,BIBI,brawlBall,Beach Ball,69,32,101
17644,2023-01-10,BIBI,bounty,Excel,2,0,2
17645,2023-01-09,BIBI,knockout,New Perspective,3,0,3
17646,2023-01-09,BIBI,hotZone,Dueling Beetles,12,2,14
17647,2023-01-09,BIBI,heist,Snaked Assault,44,129,173
17648,2023-01-09,BIBI,gemGrab,Minecart Madness,8,1,9
17649,2023-01-09,BIBI,gemGrab,Double Swoosh,2,1,3
17650,2023-01-09,BIBI,brawlBall,Center Stage,90,50,140
17651,2023-01-09,BIBI,brawlBall,Backyard Bowl,3,3,6
17652,2023-01-09,BIBI,bounty,Layer Cake,4,0,4
17653,2023-01-08,BIBI,knockout,X Marks the Spot,7,0,7
17654,2023-01-08,BIBI,hotZone,Ring of Fire,4,2,6
17655,2023-01-08,BIBI,heist,Snaked Assault,61,52,113
17656,2023-01-08,BIBI,gemGrab,Hard Rock Mine,4,1,5
17657,2023-01-08,BIBI,gemGrab,Double Swoosh,1,0,1
17658,2023-01-08,BIBI,brawlBall,Super Beach,19,17,36
17659,2023-01-08,BIBI,brawlBall,Backyard Bowl,39,14,53
17660,2023-01-08,BIBI,bounty,Layer Cake,2,0,2
17661,2023-01-07,BIBI,hotZone,Ring of Fire,1,0,1
17662,2023-01-07,BIBI,heist,Tornado Ring,48,67,115
17663,2023-01-07,BIBI,gemGrab,Hard Rock Mine,4,2,6
17664,2023-01-07,BIBI,gemGrab,Deep Diner,1,1,2
17665,2023-01-07,BIBI,brawlBall,Super Beach,44,41,85
17666,2023-01-07,BIBI,brawlBall,Sneaky Fields,3,1,4
17667,2023-01-07,BIBI,bounty,Dry Season,2,0,2
17668,2023-01-06,BIBI,hotZone,Split,20,26,46
17669,2023-01-06,BIBI,heist,Tornado Ring,133,132,265
17670,2023-01-06,BIBI,gemGrab,Deep Diner,12,1,13
17671,2023-01-06,BIBI,brawlBall,Sneaky Fields,71,25,96
17672,2023-01-06,BIBI,brawlBall,Pinhole Punt,9,4,13
17673,2023-01-06,BIBI,bounty,Dry Season,4,0,4
17674,2023-01-05,BIBI,knockout,Out in the Open,1,0,1
17675,2023-01-05,BIBI,hotZone,Split,69,60,129
17676,2023-01-05,BIBI,heist,Kaboom Canyon,16,4,20
17677,2023-01-05,BIBI,gemGrab,Undermine,9,3,12
17678,2023-01-05,BIBI,gemGrab,Gem Fort,0,1,1
17679,2023-01-05,BIBI,brawlBall,Sunny Soccer,2,1,3
17680,2023-01-05,BIBI,brawlBall,Pinhole Punt,102,57,159
17681,2023-01-04,BIBI,knockout,Goldarm Gulch,4,2,6
17682,2023-01-04,BIBI,hotZone,Parallel Plays,11,9,20
17683,2023-01-04,BIBI,heist,Kaboom Canyon,12,2,14
17684,2023-01-04,BIBI,gemGrab,Gem Fort,5,1,6
17685,2023-01-04,BIBI,gemGrab,Crystal Arcade,4,1,5
17686,2023-01-04,BIBI,brawlBall,Sunny Soccer,116,57,173
17687,2023-01-04,BIBI,brawlBall,Beach Ball,1,0,1
17688,2023-01-04,BIBI,bounty,Shooting Star,7,3,10
17689,2023-01-03,BIBI,knockout,Goldarm Gulch,3,0,3
17690,2023-01-03,BIBI,hotZone,Parallel Plays,26,6,32
17691,2023-01-03,BIBI,heist,Pit Stop,113,93,206
17692,2023-01-03,BIBI,gemGrab,Minecart Madness,3,0,3
17693,2023-01-03,BIBI,gemGrab,Crystal Arcade,5,3,8
17694,2023-01-03,BIBI,brawlBall,Center Stage,3,1,4
17695,2023-01-03,BIBI,brawlBall,Beach Ball,98,73,171
17696,2023-01-03,BIBI,bounty,Hideout,1,2,3
17697,2023-01-02,BIBI,knockout,Belle's Rock,5,1,6
17698,2023-01-02,BIBI,hotZone,Quarter Pounder,14,3,17
17699,2023-01-02,BIBI,heist,Pit Stop,221,176,397
17700,2023-01-02,BIBI,gemGrab,Minecart Madness,14,0,14
17701,2023-01-02,BIBI,gemGrab,Double Swoosh,2,2,4
17702,2023-01-02,BIBI,brawlBall,Center Stage,73,56,129
17703,2023-01-02,BIBI,brawlBall,Backyard Bowl,6,6,12
17704,2023-01-02,BIBI,bounty,Hideout,5,0,5
17705,2023-01-01,BIBI,knockout,Belle's Rock,4,11,15
17706,2023-01-01,BIBI,hotZone,Quarter Pounder,10,10,20
17707,2023-01-01,BIBI,hotZone,Controller Chaos,0,1,1
17708,2023-01-01,BIBI,heist,Kaboom Canyon,0,1,1
17709,2023-01-01,BIBI,heist,Bridge Too Far,3,0,3
17710,2023-01-01,BIBI,gemGrab,Double Swoosh,1,4,5
17711,2023-01-01,BIBI,brawlBall,Backyard Bowl,16,16,32
17712,2023-01-01,BIBI,bounty,Canal Grande,2,0,2
17713,2022-12-31,BIBI,hotZone,Controller Chaos,3,2,5
17714,2022-12-31,BIBI,heist,Bridge Too Far,1,0,1
17715,2022-12-31,BIBI,gemGrab,Hard Rock Mine,1,0,1
17716,2022-12-31,BIBI,gemGrab,Deep Diner,5,1,6
17717,2022-12-31,BIBI,brawlBall,Super Beach,7,4,11
17718,2022-12-31,BIBI,brawlBall,Sneaky Fields,1,0,1
17719,2022-12-30,BIBI,hotZone,Controller Chaos,3,0,3
17720,2022-12-30,BIBI,heist,Hot Potato,1,2,3
17721,2022-12-30,BIBI,gemGrab,Deep Diner,1,1,2
17722,2022-12-30,BIBI,brawlBall,Sneaky Fields,14,8,22
17723,2022-12-29,BIBI,heist,Hot Potato,6,0,6
17724,2022-12-29,BIBI,brawlBall,Pinhole Punt,3,4,7
17725,2022-12-28,BIBI,brawlBall,Sunny Soccer,4,0,4
17726,2022-12-27,BIBI,heist,Safe Zone,0,1,1
17727,2022-12-27,BIBI,brawlBall,Beach Ball,3,6,9
17728,2022-12-26,BIBI,hotZone,Controller Chaos,1,0,1
17729,2022-12-26,BIBI,heist,Kaboom Canyon,1,0,1
17730,2022-12-25,BIBI,brawlBall,Backyard Bowl,1,0,1
17731,2022-12-24,BIBI,brawlBall,Super Beach,0,2,2
17732,2022-12-22,BIBI,heist,Kaboom Canyon,1,0,1
17733,2022-12-21,BIBI,brawlBall,Sunny Soccer,1,0,1
17734,2022-12-20,BIBI,brawlBall,Beach Ball,2,3,5
17735,2022-12-19,BIBI,brawlBall,Center Stage,2,0,2
17736,2022-12-13,BIBI,heist,Safe Zone,0,1,1
17737,2022-12-13,BIBI,gemGrab,Crystal Arcade,1,1,2
17738,2022-12-13,BIBI,brawlBall,Beach Ball,1,0,1
17739,2022-11-11,BIBI,brawlBall,Sneaky Fields,2,0,2
17740,2022-10-28,BIBI,brawlBall,Beach Ball,1,0,1
17741,2022-10-26,BIBI,brawlBall,Sunny Soccer,0,1,1
17742,2023-02-05,BELLE,knockout,X Marks the Spot,90,106,196
17743,2023-02-05,BELLE,knockout,Goldarm Gulch,30,24,54
17744,2023-02-05,BELLE,hotZone,Ring of Fire,76,52,128
17745,2023-02-05,BELLE,heist,Snaked Assault,9,19,28
17746,2023-02-05,BELLE,heist,Pit Stop,1,0,1
17747,2023-02-05,BELLE,gemGrab,Hard Rock Mine,42,68,110
17748,2023-02-05,BELLE,gemGrab,Double Swoosh,27,16,43
17749,2023-02-05,BELLE,brawlBall,Super Beach,6,7,13
17750,2023-02-05,BELLE,brawlBall,Sneaky Fields,1,0,1
17751,2023-02-05,BELLE,brawlBall,Backyard Bowl,643,729,1372
17752,2023-02-05,BELLE,bounty,Layer Cake,56,72,128
17753,2023-02-04,BELLE,knockout,X Marks the Spot,42,31,73
17754,2023-02-04,BELLE,knockout,Goldarm Gulch,23,18,41
17755,2023-02-04,BELLE,hotZone,Ring of Fire,15,10,25
17756,2023-02-04,BELLE,heist,Tornado Ring,1,0,1
17757,2023-02-04,BELLE,heist,Pit Stop,2,1,3
17758,2023-02-04,BELLE,gemGrab,Hard Rock Mine,26,63,89
17759,2023-02-04,BELLE,gemGrab,Double Swoosh,6,0,6
17760,2023-02-04,BELLE,gemGrab,Deep Diner,2,0,2
17761,2023-02-04,BELLE,brawlBall,Super Beach,33,44,77
17762,2023-02-04,BELLE,brawlBall,Sneaky Fields,1,2,3
17763,2023-02-04,BELLE,bounty,Dry Season,34,38,72
17764,2023-02-03,BELLE,knockout,Out in the Open,215,240,455
17765,2023-02-03,BELLE,knockout,Goldarm Gulch,150,105,255
17766,2023-02-03,BELLE,hotZone,Split,7,2,9
17767,2023-02-03,BELLE,heist,Tornado Ring,11,3,14
17768,2023-02-03,BELLE,heist,Pit Stop,1,1,2
17769,2023-02-03,BELLE,gemGrab,Undermine,15,5,20
17770,2023-02-03,BELLE,gemGrab,Double Swoosh,16,18,34
17771,2023-02-03,BELLE,gemGrab,Deep Diner,87,79,166
17772,2023-02-03,BELLE,brawlBall,Sneaky Fields,93,117,210
17773,2023-02-03,BELLE,brawlBall,Pinhole Punt,5,13,18
17774,2023-02-03,BELLE,bounty,Dry Season,289,294,583
17775,2023-02-02,BELLE,knockout,Out in the Open,83,90,173
17776,2023-02-02,BELLE,hotZone,Split,5,4,9
17777,2023-02-02,BELLE,heist,Kaboom Canyon,14,11,25
17778,2023-02-02,BELLE,gemGrab,Undermine,17,14,31
17779,2023-02-02,BELLE,gemGrab,Gem Fort,2,2,4
17780,2023-02-02,BELLE,brawlBall,Sunny Soccer,1,1,2
17781,2023-02-02,BELLE,brawlBall,Pinhole Punt,72,76,148
17782,2023-02-02,BELLE,bounty,Shooting Star,69,47,116
17783,2023-02-01,BELLE,knockout,Goldarm Gulch,184,173,357
17784,2023-02-01,BELLE,hotZone,Parallel Plays,25,23,48
17785,2023-02-01,BELLE,heist,Kaboom Canyon,52,47,99
17786,2023-02-01,BELLE,gemGrab,Gem Fort,35,25,60
17787,2023-02-01,BELLE,gemGrab,Crystal Arcade,37,36,73
17788,2023-02-01,BELLE,brawlBall,Sunny Soccer,53,51,104
17789,2023-02-01,BELLE,brawlBall,Beach Ball,3,0,3
17790,2023-02-01,BELLE,bounty,Shooting Star,193,185,378
17791,2023-01-31,BELLE,knockout,Goldarm Gulch,76,59,135
17792,2023-01-31,BELLE,hotZone,Parallel Plays,10,7,17
17793,2023-01-31,BELLE,heist,Pit Stop,1,2,3
17794,2023-01-31,BELLE,gemGrab,Minecart Madness,6,15,21
17795,2023-01-31,BELLE,gemGrab,Crystal Arcade,38,30,68
17796,2023-01-31,BELLE,brawlBall,Center Stage,0,1,1
17797,2023-01-31,BELLE,brawlBall,Beach Ball,51,52,103
17798,2023-01-31,BELLE,bounty,Hideout,47,43,90
17799,2023-01-30,BELLE,knockout,Belle's Rock,294,301,595
17800,2023-01-30,BELLE,hotZone,Quarter Pounder,51,121,172
17801,2023-01-30,BELLE,heist,Pit Stop,4,0,4
17802,2023-01-30,BELLE,gemGrab,Minecart Madness,124,193,317
17803,2023-01-30,BELLE,gemGrab,Double Swoosh,18,14,32
17804,2023-01-30,BELLE,brawlBall,Center Stage,43,43,86
17805,2023-01-30,BELLE,brawlBall,Backyard Bowl,40,48,88
17806,2023-01-30,BELLE,bounty,Hideout,102,138,240
17807,2023-01-29,BELLE,knockout,Belle's Rock,318,368,686
17808,2023-01-29,BELLE,hotZone,Quarter Pounder,33,27,60
17809,2023-01-29,BELLE,heist,Bridge Too Far,254,241,495
17810,2023-01-29,BELLE,gemGrab,Hard Rock Mine,13,13,26
17811,2023-01-29,BELLE,gemGrab,Double Swoosh,42,33,75
17812,2023-01-29,BELLE,brawlBall,Super Beach,2,0,2
17813,2023-01-29,BELLE,brawlBall,Backyard Bowl,602,726,1328
17814,2023-01-29,BELLE,bounty,Canal Grande,14,13,27
17815,2023-01-28,BELLE,knockout,Flaring Phoenix,90,81,171
17816,2023-01-28,BELLE,hotZone,Controller Chaos,9,7,16
17817,2023-01-28,BELLE,heist,Bridge Too Far,652,620,1272
17818,2023-01-28,BELLE,gemGrab,Hard Rock Mine,125,142,267
17819,2023-01-28,BELLE,gemGrab,Deep Diner,42,69,111
17820,2023-01-28,BELLE,brawlBall,Super Beach,170,189,359
17821,2023-01-28,BELLE,brawlBall,Sneaky Fields,4,0,4
17822,2023-01-28,BELLE,bounty,Canal Grande,30,27,57
17823,2023-01-27,BELLE,knockout,Flaring Phoenix,31,31,62
17824,2023-01-27,BELLE,hotZone,Controller Chaos,1,4,5
17825,2023-01-27,BELLE,heist,Hot Potato,8,8,16
17826,2023-01-27,BELLE,gemGrab,Undermine,5,1,6
17827,2023-01-27,BELLE,gemGrab,Deep Diner,41,45,86
17828,2023-01-27,BELLE,brawlBall,Sneaky Fields,37,41,78
17829,2023-01-27,BELLE,brawlBall,Pinhole Punt,6,1,7
17830,2023-01-27,BELLE,bounty,Temple Ruins,13,4,17
17831,2023-01-26,BELLE,knockout,Riverside,435,446,881
17832,2023-01-26,BELLE,hotZone,Open Zone,100,135,235
17833,2023-01-26,BELLE,heist,Hot Potato,6,4,10
17834,2023-01-26,BELLE,gemGrab,Undermine,46,59,105
17835,2023-01-26,BELLE,gemGrab,Gem Fort,9,4,13
17836,2023-01-26,BELLE,brawlBall,Sunny Soccer,6,4,10
17837,2023-01-26,BELLE,brawlBall,Pinhole Punt,165,196,361
17838,2023-01-26,BELLE,bounty,Temple Ruins,43,59,102
17839,2023-01-25,BELLE,knockout,Riverside,221,198,419
17840,2023-01-25,BELLE,hotZone,Open Zone,53,62,115
17841,2023-01-25,BELLE,heist,Safe Zone,163,174,337
17842,2023-01-25,BELLE,gemGrab,Gem Fort,12,11,23
17843,2023-01-25,BELLE,gemGrab,Crystal Arcade,58,45,103
17844,2023-01-25,BELLE,brawlBall,Sunny Soccer,36,49,85
17845,2023-01-25,BELLE,brawlBall,Beach Ball,7,7,14
17846,2023-01-25,BELLE,bounty,Excel,32,90,122
17847,2023-01-24,BELLE,knockout,New Perspective,101,113,214
17848,2023-01-24,BELLE,hotZone,Dueling Beetles,41,62,103
17849,2023-01-24,BELLE,heist,Safe Zone,253,263,516
17850,2023-01-24,BELLE,gemGrab,Minecart Madness,42,55,97
17851,2023-01-24,BELLE,gemGrab,Crystal Arcade,87,89,176
17852,2023-01-24,BELLE,brawlBall,Center Stage,7,6,13
17853,2023-01-24,BELLE,brawlBall,Beach Ball,92,86,178
17854,2023-01-24,BELLE,bounty,Excel,61,121,182
17855,2023-01-23,BELLE,knockout,New Perspective,157,168,325
17856,2023-01-23,BELLE,hotZone,Dueling Beetles,72,87,159
17857,2023-01-23,BELLE,heist,Snaked Assault,13,5,18
17858,2023-01-23,BELLE,gemGrab,Minecart Madness,179,233,412
17859,2023-01-23,BELLE,gemGrab,Double Swoosh,11,12,23
17860,2023-01-23,BELLE,brawlBall,Center Stage,83,68,151
17861,2023-01-23,BELLE,brawlBall,Backyard Bowl,58,51,109
17862,2023-01-23,BELLE,bounty,Layer Cake,51,73,124
17863,2023-01-22,BELLE,knockout,X Marks the Spot,102,105,207
17864,2023-01-22,BELLE,hotZone,Ring of Fire,31,36,67
17865,2023-01-22,BELLE,heist,Snaked Assault,13,5,18
17866,2023-01-22,BELLE,gemGrab,Hard Rock Mine,28,11,39
17867,2023-01-22,BELLE,gemGrab,Double Swoosh,15,18,33
17868,2023-01-22,BELLE,brawlBall,Super Beach,24,15,39
17869,2023-01-22,BELLE,brawlBall,Backyard Bowl,316,358,674
17870,2023-01-22,BELLE,bounty,Layer Cake,43,39,82
17871,2023-01-21,BELLE,knockout,X Marks the Spot,366,387,753
17872,2023-01-21,BELLE,hotZone,Ring of Fire,104,96,200
17873,2023-01-21,BELLE,heist,Tornado Ring,11,2,13
17874,2023-01-21,BELLE,gemGrab,Hard Rock Mine,176,196,372
17875,2023-01-21,BELLE,gemGrab,Deep Diner,15,20,35
17876,2023-01-21,BELLE,brawlBall,Super Beach,207,255,462
17877,2023-01-21,BELLE,brawlBall,Sneaky Fields,4,3,7
17878,2023-01-21,BELLE,bounty,Dry Season,238,195,433
17879,2023-01-20,BELLE,knockout,Out in the Open,276,272,548
17880,2023-01-20,BELLE,hotZone,Split,3,5,8
17881,2023-01-20,BELLE,heist,Tornado Ring,6,8,14
17882,2023-01-20,BELLE,gemGrab,Undermine,20,29,49
17883,2023-01-20,BELLE,gemGrab,Deep Diner,92,121,213
17884,2023-01-20,BELLE,brawlBall,Sneaky Fields,75,69,144
17885,2023-01-20,BELLE,brawlBall,Pinhole Punt,17,23,40
17886,2023-01-20,BELLE,bounty,Dry Season,186,190,376
17887,2023-01-19,BELLE,knockout,Out in the Open,319,303,622
17888,2023-01-19,BELLE,hotZone,Split,8,3,11
17889,2023-01-19,BELLE,heist,Kaboom Canyon,71,61,132
17890,2023-01-19,BELLE,gemGrab,Undermine,75,84,159
17891,2023-01-19,BELLE,gemGrab,Gem Fort,8,6,14
17892,2023-01-19,BELLE,brawlBall,Sunny Soccer,3,8,11
17893,2023-01-19,BELLE,brawlBall,Pinhole Punt,207,226,433
17894,2023-01-19,BELLE,bounty,Shooting Star,229,247,476
17895,2023-01-18,BELLE,knockout,Goldarm Gulch,23,38,61
17896,2023-01-18,BELLE,hotZone,Parallel Plays,2,0,2
17897,2023-01-18,BELLE,heist,Kaboom Canyon,35,34,69
17898,2023-01-18,BELLE,gemGrab,Gem Fort,6,8,14
17899,2023-01-18,BELLE,gemGrab,Crystal Arcade,6,7,13
17900,2023-01-18,BELLE,brawlBall,Sunny Soccer,12,17,29
17901,2023-01-18,BELLE,bounty,Shooting Star,108,93,201
17902,2023-01-17,BELLE,knockout,Goldarm Gulch,20,37,57
17903,2023-01-17,BELLE,hotZone,Parallel Plays,5,3,8
17904,2023-01-17,BELLE,gemGrab,Minecart Madness,1,5,6
17905,2023-01-17,BELLE,gemGrab,Crystal Arcade,9,10,19
17906,2023-01-17,BELLE,brawlBall,Beach Ball,8,5,13
17907,2023-01-17,BELLE,bounty,Hideout,7,41,48
17908,2023-01-16,BELLE,knockout,Belle's Rock,34,30,64
17909,2023-01-16,BELLE,hotZone,Quarter Pounder,4,11,15
17910,2023-01-16,BELLE,gemGrab,Minecart Madness,15,26,41
17911,2023-01-16,BELLE,gemGrab,Double Swoosh,0,1,1
17912,2023-01-16,BELLE,brawlBall,Center Stage,4,0,4
17913,2023-01-16,BELLE,brawlBall,Backyard Bowl,10,14,24
17914,2023-01-16,BELLE,bounty,Hideout,28,45,73
17915,2023-01-15,BELLE,knockout,Belle's Rock,41,46,87
17916,2023-01-15,BELLE,hotZone,Quarter Pounder,15,45,60
17917,2023-01-15,BELLE,heist,Bridge Too Far,70,48,118
17918,2023-01-15,BELLE,gemGrab,Hard Rock Mine,7,1,8
17919,2023-01-15,BELLE,gemGrab,Double Swoosh,4,4,8
17920,2023-01-15,BELLE,brawlBall,Super Beach,1,1,2
17921,2023-01-15,BELLE,brawlBall,Backyard Bowl,105,120,225
17922,2023-01-15,BELLE,bounty,Canal Grande,3,9,12
17923,2023-01-14,BELLE,knockout,Flaring Phoenix,6,2,8
17924,2023-01-14,BELLE,hotZone,Controller Chaos,2,2,4
17925,2023-01-14,BELLE,heist,Bridge Too Far,61,97,158
17926,2023-01-14,BELLE,gemGrab,Hard Rock Mine,16,20,36
17927,2023-01-14,BELLE,gemGrab,Deep Diner,2,2,4
17928,2023-01-14,BELLE,brawlBall,Super Beach,2,13,15
17929,2023-01-14,BELLE,brawlBall,Sneaky Fields,3,0,3
17930,2023-01-14,BELLE,bounty,Canal Grande,4,0,4
17931,2023-01-13,BELLE,knockout,Flaring Phoenix,9,1,10
17932,2023-01-13,BELLE,hotZone,Controller Chaos,0,2,2
17933,2023-01-13,BELLE,gemGrab,Deep Diner,3,5,8
17934,2023-01-13,BELLE,brawlBall,Sneaky Fields,7,2,9
17935,2023-01-13,BELLE,bounty,Temple Ruins,0,1,1
17936,2023-01-12,BELLE,knockout,Riverside,45,74,119
17937,2023-01-12,BELLE,hotZone,Open Zone,10,6,16
17938,2023-01-12,BELLE,gemGrab,Undermine,0,1,1
17939,2023-01-12,BELLE,gemGrab,Gem Fort,0,1,1
17940,2023-01-12,BELLE,brawlBall,Pinhole Punt,11,16,27
17941,2023-01-11,BELLE,knockout,Riverside,6,1,7
17942,2023-01-11,BELLE,hotZone,Open Zone,2,1,3
17943,2023-01-11,BELLE,heist,Safe Zone,0,3,3
17944,2023-01-11,BELLE,gemGrab,Gem Fort,1,4,5
17945,2023-01-11,BELLE,brawlBall,Beach Ball,0,1,1
17946,2023-01-11,BELLE,bounty,Excel,1,0,1
17947,2023-01-10,BELLE,knockout,New Perspective,7,21,28
17948,2023-01-10,BELLE,hotZone,Dueling Beetles,13,9,22
17949,2023-01-10,BELLE,heist,Safe Zone,26,23,49
17950,2023-01-10,BELLE,gemGrab,Minecart Madness,7,2,9
17951,2023-01-10,BELLE,gemGrab,Crystal Arcade,20,15,35
17952,2023-01-10,BELLE,brawlBall,Center Stage,0,3,3
17953,2023-01-10,BELLE,brawlBall,Beach Ball,7,3,10
17954,2023-01-10,BELLE,bounty,Excel,1,0,1
17955,2023-01-09,BELLE,knockout,New Perspective,3,13,16
17956,2023-01-09,BELLE,hotZone,Dueling Beetles,7,20,27
17957,2023-01-09,BELLE,heist,Snaked Assault,2,0,2
17958,2023-01-09,BELLE,gemGrab,Minecart Madness,33,20,53
17959,2023-01-09,BELLE,gemGrab,Double Swoosh,1,6,7
17960,2023-01-09,BELLE,brawlBall,Center Stage,1,8,9
17961,2023-01-09,BELLE,brawlBall,Backyard Bowl,6,3,9
17962,2023-01-09,BELLE,bounty,Layer Cake,17,17,34
17963,2023-01-08,BELLE,knockout,X Marks the Spot,16,30,46
17964,2023-01-08,BELLE,hotZone,Ring of Fire,10,26,36
17965,2023-01-08,BELLE,heist,Snaked Assault,1,0,1
17966,2023-01-08,BELLE,gemGrab,Hard Rock Mine,6,2,8
17967,2023-01-08,BELLE,brawlBall,Super Beach,3,13,16
17968,2023-01-08,BELLE,brawlBall,Backyard Bowl,54,63,117
17969,2023-01-08,BELLE,bounty,Layer Cake,7,10,17
17970,2023-01-07,BELLE,knockout,X Marks the Spot,22,23,45
17971,2023-01-07,BELLE,hotZone,Ring of Fire,5,13,18
17972,2023-01-07,BELLE,gemGrab,Hard Rock Mine,8,11,19
17973,2023-01-07,BELLE,gemGrab,Deep Diner,4,5,9
17974,2023-01-07,BELLE,brawlBall,Super Beach,8,4,12
17975,2023-01-07,BELLE,bounty,Dry Season,25,39,64
17976,2023-01-06,BELLE,knockout,Out in the Open,25,23,48
17977,2023-01-06,BELLE,hotZone,Split,2,0,2
17978,2023-01-06,BELLE,heist,Tornado Ring,3,12,15
17979,2023-01-06,BELLE,gemGrab,Undermine,4,10,14
17980,2023-01-06,BELLE,gemGrab,Deep Diner,11,8,19
17981,2023-01-06,BELLE,brawlBall,Sneaky Fields,4,2,6
17982,2023-01-06,BELLE,bounty,Dry Season,39,50,89
17983,2023-01-05,BELLE,knockout,Out in the Open,46,69,115
17984,2023-01-05,BELLE,hotZone,Split,1,0,1
17985,2023-01-05,BELLE,heist,Kaboom Canyon,2,3,5
17986,2023-01-05,BELLE,gemGrab,Undermine,8,14,22
17987,2023-01-05,BELLE,brawlBall,Pinhole Punt,35,41,76
17988,2023-01-05,BELLE,bounty,Shooting Star,32,46,78
17989,2023-01-04,BELLE,knockout,Goldarm Gulch,8,4,12
17990,2023-01-04,BELLE,heist,Kaboom Canyon,19,19,38
17991,2023-01-04,BELLE,gemGrab,Gem Fort,4,1,5
17992,2023-01-04,BELLE,gemGrab,Crystal Arcade,2,0,2
17993,2023-01-04,BELLE,brawlBall,Sunny Soccer,5,1,6
17994,2023-01-04,BELLE,brawlBall,Beach Ball,1,0,1
17995,2023-01-04,BELLE,bounty,Shooting Star,86,76,162
17996,2023-01-03,BELLE,knockout,Goldarm Gulch,4,1,5
17997,2023-01-03,BELLE,hotZone,Parallel Plays,4,1,5
17998,2023-01-03,BELLE,gemGrab,Minecart Madness,8,8,16
17999,2023-01-03,BELLE,gemGrab,Crystal Arcade,14,1,15
18000,2023-01-03,BELLE,brawlBall,Beach Ball,12,6,18
18001,2023-01-03,BELLE,bounty,Hideout,29,48,77
18002,2023-01-02,BELLE,knockout,Belle's Rock,39,64,103
18003,2023-01-02,BELLE,hotZone,Quarter Pounder,4,7,11
18004,2023-01-02,BELLE,gemGrab,Minecart Madness,16,19,35
18005,2023-01-02,BELLE,gemGrab,Double Swoosh,1,0,1
18006,2023-01-02,BELLE,brawlBall,Center Stage,8,1,9
18007,2023-01-02,BELLE,brawlBall,Backyard Bowl,5,10,15
18008,2023-01-02,BELLE,bounty,Hideout,68,98,166
18009,2023-01-01,BELLE,knockout,Belle's Rock,10,7,17
18010,2023-01-01,BELLE,hotZone,Quarter Pounder,9,1,10
18011,2023-01-01,BELLE,heist,Bridge Too Far,15,25,40
18012,2023-01-01,BELLE,gemGrab,Double Swoosh,1,0,1
18013,2023-01-01,BELLE,brawlBall,Backyard Bowl,23,29,52
18014,2022-12-31,BELLE,heist,Kaboom Canyon,0,1,1
18015,2022-12-31,BELLE,heist,Bridge Too Far,6,17,23
18016,2022-12-31,BELLE,gemGrab,Minecart Madness,1,0,1
18017,2022-12-31,BELLE,gemGrab,Hard Rock Mine,2,0,2
18018,2022-12-31,BELLE,gemGrab,Deep Diner,1,0,1
18019,2022-12-30,BELLE,heist,Kaboom Canyon,1,1,2
18020,2022-12-30,BELLE,gemGrab,Undermine,1,0,1
18021,2022-12-30,BELLE,gemGrab,Deep Diner,5,17,22
18022,2022-12-30,BELLE,brawlBall,Sneaky Fields,1,0,1
18023,2022-12-29,BELLE,heist,Kaboom Canyon,0,1,1
18024,2022-12-28,BELLE,hotZone,Open Zone,1,1,2
18025,2022-12-27,BELLE,knockout,New Perspective,1,0,1
18026,2022-12-27,BELLE,heist,Kaboom Canyon,0,1,1
18027,2022-12-27,BELLE,brawlBall,Beach Ball,1,0,1
18028,2022-12-26,BELLE,gemGrab,Minecart Madness,0,2,2
18029,2022-12-25,BELLE,brawlBall,Backyard Bowl,2,0,2
18030,2022-12-23,BELLE,knockout,Out in the Open,0,1,1
18031,2022-12-19,BELLE,brawlBall,Center Stage,1,0,1
18032,2022-12-18,BELLE,heist,Bridge Too Far,1,0,1
18033,2022-12-16,BELLE,brawlBall,Sneaky Fields,0,1,1
18034,2022-12-13,BELLE,heist,Safe Zone,0,2,2
18035,2022-12-11,BELLE,brawlBall,Backyard Bowl,0,1,1
18036,2022-12-10,BELLE,hotZone,Ring of Fire,1,0,1
18037,2022-11-07,BELLE,hotZone,Quarter Pounder,0,1,1
18038,2022-11-01,BELLE,knockout,New Perspective,4,2,6
18039,2022-10-30,BELLE,knockout,Out in the Open,1,0,1
18040,2022-10-28,BELLE,knockout,Out in the Open,1,2,3
18041,2022-10-26,BELLE,bounty,Shooting Star,1,1,2
18042,2022-10-15,BELLE,gemGrab,Hard Rock Mine,2,2,4
18043,2022-10-10,BELLE,knockout,Belle's Rock,4,1,5
18044,2023-02-05,BEA,knockout,X Marks the Spot,93,72,165
18045,2023-02-05,BEA,knockout,Goldarm Gulch,20,6,26
18046,2023-02-05,BEA,hotZone,Ring of Fire,210,300,510
18047,2023-02-05,BEA,heist,Snaked Assault,287,537,824
18048,2023-02-05,BEA,heist,Pit Stop,1,0,1
18049,2023-02-05,BEA,gemGrab,Hard Rock Mine,32,45,77
18050,2023-02-05,BEA,gemGrab,Double Swoosh,106,73,179
18051,2023-02-05,BEA,brawlBall,Super Beach,40,59,99
18052,2023-02-05,BEA,brawlBall,Sneaky Fields,98,181,279
18053,2023-02-05,BEA,brawlBall,Backyard Bowl,2232,2124,4356
18054,2023-02-05,BEA,bounty,Layer Cake,49,35,84
18055,2023-02-04,BEA,knockout,X Marks the Spot,55,41,96
18056,2023-02-04,BEA,knockout,Goldarm Gulch,7,9,16
18057,2023-02-04,BEA,hotZone,Ring of Fire,55,64,119
18058,2023-02-04,BEA,heist,Tornado Ring,30,45,75
18059,2023-02-04,BEA,heist,Pit Stop,2,0,2
18060,2023-02-04,BEA,gemGrab,Hard Rock Mine,74,41,115
18061,2023-02-04,BEA,gemGrab,Double Swoosh,20,16,36
18062,2023-02-04,BEA,gemGrab,Deep Diner,8,4,12
18063,2023-02-04,BEA,brawlBall,Super Beach,382,464,846
18064,2023-02-04,BEA,brawlBall,Sneaky Fields,84,146,230
18065,2023-02-04,BEA,bounty,Dry Season,26,20,46
18066,2023-02-03,BEA,knockout,Out in the Open,240,156,396
18067,2023-02-03,BEA,knockout,Goldarm Gulch,70,72,142
18068,2023-02-03,BEA,hotZone,Split,12,10,22
18069,2023-02-03,BEA,heist,Tornado Ring,323,397,720
18070,2023-02-03,BEA,heist,Pit Stop,13,18,31
18071,2023-02-03,BEA,gemGrab,Undermine,31,24,55
18072,2023-02-03,BEA,gemGrab,Double Swoosh,126,99,225
18073,2023-02-03,BEA,gemGrab,Deep Diner,199,237,436
18074,2023-02-03,BEA,brawlBall,Sneaky Fields,1766,2695,4461
18075,2023-02-03,BEA,brawlBall,Pinhole Punt,94,88,182
18076,2023-02-03,BEA,bounty,Dry Season,311,201,512
18077,2023-02-02,BEA,knockout,Out in the Open,82,40,122
18078,2023-02-02,BEA,hotZone,Split,15,7,22
18079,2023-02-02,BEA,heist,Kaboom Canyon,10,12,22
18080,2023-02-02,BEA,gemGrab,Undermine,28,34,62
18081,2023-02-02,BEA,gemGrab,Gem Fort,4,2,6
18082,2023-02-02,BEA,brawlBall,Sunny Soccer,9,19,28
18083,2023-02-02,BEA,brawlBall,Pinhole Punt,504,508,1012
18084,2023-02-02,BEA,bounty,Shooting Star,61,51,112
18085,2023-02-01,BEA,knockout,Goldarm Gulch,144,82,226
18086,2023-02-01,BEA,hotZone,Parallel Plays,176,366,542
18087,2023-02-01,BEA,heist,Kaboom Canyon,108,144,252
18088,2023-02-01,BEA,gemGrab,Gem Fort,58,78,136
18089,2023-02-01,BEA,gemGrab,Crystal Arcade,81,77,158
18090,2023-02-01,BEA,brawlBall,Sunny Soccer,497,618,1115
18091,2023-02-01,BEA,brawlBall,Beach Ball,27,28,55
18092,2023-02-01,BEA,bounty,Shooting Star,198,130,328
18093,2023-01-31,BEA,knockout,Goldarm Gulch,70,39,109
18094,2023-01-31,BEA,hotZone,Parallel Plays,87,99,186
18095,2023-01-31,BEA,heist,Pit Stop,5,5,10
18096,2023-01-31,BEA,gemGrab,Minecart Madness,5,10,15
18097,2023-01-31,BEA,gemGrab,Crystal Arcade,63,101,164
18098,2023-01-31,BEA,brawlBall,Center Stage,7,5,12
18099,2023-01-31,BEA,brawlBall,Beach Ball,363,432,795
18100,2023-01-31,BEA,bounty,Hideout,33,51,84
18101,2023-01-30,BEA,knockout,Belle's Rock,153,113,266
18102,2023-01-30,BEA,hotZone,Quarter Pounder,372,717,1089
18103,2023-01-30,BEA,heist,Pit Stop,35,37,72
18104,2023-01-30,BEA,gemGrab,Minecart Madness,134,146,280
18105,2023-01-30,BEA,gemGrab,Double Swoosh,38,33,71
18106,2023-01-30,BEA,brawlBall,Center Stage,340,288,628
18107,2023-01-30,BEA,brawlBall,Backyard Bowl,172,190,362
18108,2023-01-30,BEA,bounty,Hideout,84,65,149
18109,2023-01-29,BEA,knockout,Belle's Rock,156,81,237
18110,2023-01-29,BEA,hotZone,Quarter Pounder,453,537,990
18111,2023-01-29,BEA,heist,Bridge Too Far,171,126,297
18112,2023-01-29,BEA,gemGrab,Hard Rock Mine,17,33,50
18113,2023-01-29,BEA,gemGrab,Double Swoosh,56,70,126
18114,2023-01-29,BEA,brawlBall,Super Beach,34,35,69
18115,2023-01-29,BEA,brawlBall,Backyard Bowl,2238,2139,4377
18116,2023-01-29,BEA,bounty,Canal Grande,25,32,57
18117,2023-01-28,BEA,knockout,Flaring Phoenix,74,28,102
18118,2023-01-28,BEA,hotZone,Controller Chaos,119,234,353
18119,2023-01-28,BEA,heist,Bridge Too Far,448,409,857
18120,2023-01-28,BEA,gemGrab,Hard Rock Mine,140,127,267
18121,2023-01-28,BEA,gemGrab,Deep Diner,37,22,59
18122,2023-01-28,BEA,brawlBall,Super Beach,1620,1956,3576
18123,2023-01-28,BEA,brawlBall,Sneaky Fields,94,128,222
18124,2023-01-28,BEA,bounty,Canal Grande,46,46,92
18125,2023-01-27,BEA,knockout,Flaring Phoenix,22,16,38
18126,2023-01-27,BEA,hotZone,Controller Chaos,46,49,95
18127,2023-01-27,BEA,heist,Hot Potato,9,8,17
18128,2023-01-27,BEA,gemGrab,Undermine,6,1,7
18129,2023-01-27,BEA,gemGrab,Deep Diner,58,71,129
18130,2023-01-27,BEA,brawlBall,Sneaky Fields,409,497,906
18131,2023-01-27,BEA,brawlBall,Pinhole Punt,20,14,34
18132,2023-01-27,BEA,bounty,Temple Ruins,17,9,26
18133,2023-01-26,BEA,knockout,Riverside,404,259,663
18134,2023-01-26,BEA,hotZone,Open Zone,361,397,758
18135,2023-01-26,BEA,heist,Hot Potato,79,108,187
18136,2023-01-26,BEA,gemGrab,Undermine,115,117,232
18137,2023-01-26,BEA,gemGrab,Gem Fort,31,14,45
18138,2023-01-26,BEA,brawlBall,Sunny Soccer,24,18,42
18139,2023-01-26,BEA,brawlBall,Pinhole Punt,1413,1560,2973
18140,2023-01-26,BEA,bounty,Temple Ruins,50,35,85
18141,2023-01-25,BEA,knockout,Riverside,231,124,355
18142,2023-01-25,BEA,hotZone,Open Zone,230,255,485
18143,2023-01-25,BEA,heist,Safe Zone,70,97,167
18144,2023-01-25,BEA,gemGrab,Gem Fort,28,20,48
18145,2023-01-25,BEA,gemGrab,Crystal Arcade,74,58,132
18146,2023-01-25,BEA,brawlBall,Sunny Soccer,324,365,689
18147,2023-01-25,BEA,brawlBall,Beach Ball,75,95,170
18148,2023-01-25,BEA,bounty,Excel,32,27,59
18149,2023-01-24,BEA,knockout,New Perspective,150,88,238
18150,2023-01-24,BEA,hotZone,Dueling Beetles,105,158,263
18151,2023-01-24,BEA,heist,Safe Zone,194,153,347
18152,2023-01-24,BEA,gemGrab,Minecart Madness,53,69,122
18153,2023-01-24,BEA,gemGrab,Crystal Arcade,131,135,266
18154,2023-01-24,BEA,brawlBall,Center Stage,51,82,133
18155,2023-01-24,BEA,brawlBall,Beach Ball,764,893,1657
18156,2023-01-24,BEA,bounty,Excel,53,19,72
18157,2023-01-23,BEA,knockout,New Perspective,223,154,377
18158,2023-01-23,BEA,hotZone,Dueling Beetles,353,402,755
18159,2023-01-23,BEA,heist,Snaked Assault,231,471,702
18160,2023-01-23,BEA,gemGrab,Minecart Madness,238,197,435
18161,2023-01-23,BEA,gemGrab,Double Swoosh,43,41,84
18162,2023-01-23,BEA,brawlBall,Center Stage,554,462,1016
18163,2023-01-23,BEA,brawlBall,Backyard Bowl,118,94,212
18164,2023-01-23,BEA,bounty,Layer Cake,58,68,126
18165,2023-01-22,BEA,knockout,X Marks the Spot,74,53,127
18166,2023-01-22,BEA,hotZone,Ring of Fire,145,174,319
18167,2023-01-22,BEA,heist,Snaked Assault,184,253,437
18168,2023-01-22,BEA,gemGrab,Hard Rock Mine,47,31,78
18169,2023-01-22,BEA,gemGrab,Double Swoosh,49,50,99
18170,2023-01-22,BEA,brawlBall,Super Beach,168,142,310
18171,2023-01-22,BEA,brawlBall,Backyard Bowl,1154,1109,2263
18172,2023-01-22,BEA,bounty,Layer Cake,26,13,39
18173,2023-01-21,BEA,knockout,X Marks the Spot,293,190,483
18174,2023-01-21,BEA,hotZone,Ring of Fire,467,554,1021
18175,2023-01-21,BEA,heist,Tornado Ring,120,166,286
18176,2023-01-21,BEA,gemGrab,Hard Rock Mine,199,206,405
18177,2023-01-21,BEA,gemGrab,Deep Diner,39,36,75
18178,2023-01-21,BEA,brawlBall,Super Beach,2165,2483,4648
18179,2023-01-21,BEA,brawlBall,Sneaky Fields,74,111,185
18180,2023-01-21,BEA,bounty,Dry Season,224,174,398
18181,2023-01-20,BEA,knockout,Out in the Open,269,168,437
18182,2023-01-20,BEA,hotZone,Split,10,4,14
18183,2023-01-20,BEA,heist,Tornado Ring,156,221,377
18184,2023-01-20,BEA,gemGrab,Undermine,55,51,106
18185,2023-01-20,BEA,gemGrab,Deep Diner,196,198,394
18186,2023-01-20,BEA,brawlBall,Sneaky Fields,1054,1438,2492
18187,2023-01-20,BEA,brawlBall,Pinhole Punt,48,51,99
18188,2023-01-20,BEA,bounty,Dry Season,178,117,295
18189,2023-01-19,BEA,knockout,Out in the Open,349,263,612
18190,2023-01-19,BEA,hotZone,Split,20,20,40
18191,2023-01-19,BEA,heist,Kaboom Canyon,85,110,195
18192,2023-01-19,BEA,gemGrab,Undermine,127,131,258
18193,2023-01-19,BEA,gemGrab,Gem Fort,18,23,41
18194,2023-01-19,BEA,brawlBall,Sunny Soccer,18,26,44
18195,2023-01-19,BEA,brawlBall,Pinhole Punt,1637,1823,3460
18196,2023-01-19,BEA,bounty,Shooting Star,241,187,428
18197,2023-01-18,BEA,knockout,Goldarm Gulch,18,12,30
18198,2023-01-18,BEA,hotZone,Parallel Plays,5,4,9
18199,2023-01-18,BEA,heist,Kaboom Canyon,34,36,70
18200,2023-01-18,BEA,gemGrab,Gem Fort,13,14,27
18201,2023-01-18,BEA,gemGrab,Crystal Arcade,6,10,16
18202,2023-01-18,BEA,brawlBall,Sunny Soccer,166,157,323
18203,2023-01-18,BEA,brawlBall,Beach Ball,12,9,21
18204,2023-01-18,BEA,bounty,Shooting Star,104,73,177
18205,2023-01-17,BEA,knockout,Goldarm Gulch,15,7,22
18206,2023-01-17,BEA,hotZone,Parallel Plays,12,17,29
18207,2023-01-17,BEA,gemGrab,Minecart Madness,2,6,8
18208,2023-01-17,BEA,gemGrab,Crystal Arcade,18,19,37
18209,2023-01-17,BEA,brawlBall,Center Stage,2,4,6
18210,2023-01-17,BEA,brawlBall,Beach Ball,68,88,156
18211,2023-01-17,BEA,bounty,Hideout,9,2,11
18212,2023-01-16,BEA,knockout,Belle's Rock,14,13,27
18213,2023-01-16,BEA,hotZone,Quarter Pounder,28,82,110
18214,2023-01-16,BEA,heist,Pit Stop,1,1,2
18215,2023-01-16,BEA,gemGrab,Minecart Madness,13,13,26
18216,2023-01-16,BEA,gemGrab,Double Swoosh,3,2,5
18217,2023-01-16,BEA,brawlBall,Center Stage,33,26,59
18218,2023-01-16,BEA,brawlBall,Backyard Bowl,30,41,71
18219,2023-01-16,BEA,bounty,Hideout,27,15,42
18220,2023-01-15,BEA,knockout,Belle's Rock,26,12,38
18221,2023-01-15,BEA,hotZone,Quarter Pounder,138,135,273
18222,2023-01-15,BEA,heist,Bridge Too Far,48,32,80
18223,2023-01-15,BEA,gemGrab,Hard Rock Mine,5,0,5
18224,2023-01-15,BEA,gemGrab,Double Swoosh,6,14,20
18225,2023-01-15,BEA,brawlBall,Super Beach,27,52,79
18226,2023-01-15,BEA,brawlBall,Backyard Bowl,343,322,665
18227,2023-01-15,BEA,bounty,Canal Grande,4,1,5
18228,2023-01-14,BEA,knockout,Flaring Phoenix,5,2,7
18229,2023-01-14,BEA,hotZone,Controller Chaos,43,92,135
18230,2023-01-14,BEA,heist,Bridge Too Far,99,78,177
18231,2023-01-14,BEA,gemGrab,Hard Rock Mine,11,12,23
18232,2023-01-14,BEA,gemGrab,Deep Diner,10,18,28
18233,2023-01-14,BEA,brawlBall,Super Beach,169,194,363
18234,2023-01-14,BEA,brawlBall,Sneaky Fields,35,36,71
18235,2023-01-14,BEA,bounty,Canal Grande,4,0,4
18236,2023-01-13,BEA,knockout,Flaring Phoenix,10,0,10
18237,2023-01-13,BEA,hotZone,Controller Chaos,76,119,195
18238,2023-01-13,BEA,heist,Hot Potato,1,1,2
18239,2023-01-13,BEA,gemGrab,Deep Diner,13,7,20
18240,2023-01-13,BEA,brawlBall,Sneaky Fields,179,185,364
18241,2023-01-13,BEA,brawlBall,Pinhole Punt,8,2,10
18242,2023-01-13,BEA,bounty,Temple Ruins,2,3,5
18243,2023-01-12,BEA,knockout,Riverside,53,25,78
18244,2023-01-12,BEA,hotZone,Open Zone,51,71,122
18245,2023-01-12,BEA,heist,Hot Potato,1,0,1
18246,2023-01-12,BEA,gemGrab,Undermine,7,5,12
18247,2023-01-12,BEA,gemGrab,Gem Fort,3,11,14
18248,2023-01-12,BEA,brawlBall,Sunny Soccer,3,1,4
18249,2023-01-12,BEA,brawlBall,Pinhole Punt,56,71,127
18250,2023-01-12,BEA,bounty,Temple Ruins,0,1,1
18251,2023-01-11,BEA,knockout,Riverside,15,24,39
18252,2023-01-11,BEA,hotZone,Open Zone,28,23,51
18253,2023-01-11,BEA,heist,Safe Zone,1,0,1
18254,2023-01-11,BEA,gemGrab,Gem Fort,1,0,1
18255,2023-01-11,BEA,brawlBall,Sunny Soccer,26,30,56
18256,2023-01-11,BEA,brawlBall,Beach Ball,1,1,2
18257,2023-01-11,BEA,bounty,Excel,1,0,1
18258,2023-01-10,BEA,knockout,New Perspective,7,3,10
18259,2023-01-10,BEA,hotZone,Dueling Beetles,43,29,72
18260,2023-01-10,BEA,heist,Safe Zone,17,20,37
18261,2023-01-10,BEA,gemGrab,Minecart Madness,11,36,47
18262,2023-01-10,BEA,gemGrab,Crystal Arcade,32,45,77
18263,2023-01-10,BEA,brawlBall,Center Stage,5,0,5
18264,2023-01-10,BEA,brawlBall,Beach Ball,85,76,161
18265,2023-01-10,BEA,bounty,Excel,4,21,25
18266,2023-01-09,BEA,knockout,New Perspective,7,4,11
18267,2023-01-09,BEA,hotZone,Dueling Beetles,30,50,80
18268,2023-01-09,BEA,heist,Snaked Assault,16,46,62
18269,2023-01-09,BEA,gemGrab,Minecart Madness,24,26,50
18270,2023-01-09,BEA,gemGrab,Double Swoosh,7,32,39
18271,2023-01-09,BEA,brawlBall,Center Stage,38,20,58
18272,2023-01-09,BEA,brawlBall,Backyard Bowl,25,11,36
18273,2023-01-09,BEA,bounty,Layer Cake,6,4,10
18274,2023-01-08,BEA,knockout,X Marks the Spot,19,18,37
18275,2023-01-08,BEA,hotZone,Ring of Fire,42,67,109
18276,2023-01-08,BEA,heist,Snaked Assault,27,67,94
18277,2023-01-08,BEA,gemGrab,Hard Rock Mine,9,12,21
18278,2023-01-08,BEA,gemGrab,Double Swoosh,5,9,14
18279,2023-01-08,BEA,brawlBall,Super Beach,30,22,52
18280,2023-01-08,BEA,brawlBall,Backyard Bowl,183,254,437
18281,2023-01-08,BEA,bounty,Layer Cake,4,2,6
18282,2023-01-07,BEA,knockout,X Marks the Spot,8,4,12
18283,2023-01-07,BEA,hotZone,Ring of Fire,15,12,27
18284,2023-01-07,BEA,heist,Tornado Ring,4,10,14
18285,2023-01-07,BEA,gemGrab,Hard Rock Mine,13,5,18
18286,2023-01-07,BEA,gemGrab,Deep Diner,14,26,40
18287,2023-01-07,BEA,brawlBall,Super Beach,80,107,187
18288,2023-01-07,BEA,brawlBall,Sneaky Fields,13,15,28
18289,2023-01-07,BEA,bounty,Dry Season,24,9,33
18290,2023-01-06,BEA,knockout,Out in the Open,19,9,28
18291,2023-01-06,BEA,hotZone,Split,2,10,12
18292,2023-01-06,BEA,heist,Tornado Ring,33,83,116
18293,2023-01-06,BEA,gemGrab,Undermine,8,10,18
18294,2023-01-06,BEA,gemGrab,Deep Diner,29,24,53
18295,2023-01-06,BEA,brawlBall,Sneaky Fields,137,221,358
18296,2023-01-06,BEA,brawlBall,Pinhole Punt,18,17,35
18297,2023-01-06,BEA,bounty,Dry Season,18,17,35
18298,2023-01-05,BEA,knockout,Out in the Open,45,53,98
18299,2023-01-05,BEA,hotZone,Split,29,42,71
18300,2023-01-05,BEA,heist,Kaboom Canyon,16,30,46
18301,2023-01-05,BEA,gemGrab,Undermine,28,23,51
18302,2023-01-05,BEA,gemGrab,Gem Fort,2,2,4
18303,2023-01-05,BEA,brawlBall,Sunny Soccer,1,4,5
18304,2023-01-05,BEA,brawlBall,Pinhole Punt,285,290,575
18305,2023-01-05,BEA,bounty,Shooting Star,26,7,33
18306,2023-01-04,BEA,knockout,Goldarm Gulch,2,0,2
18307,2023-01-04,BEA,hotZone,Parallel Plays,12,12,24
18308,2023-01-04,BEA,heist,Kaboom Canyon,31,33,64
18309,2023-01-04,BEA,gemGrab,Gem Fort,16,11,27
18310,2023-01-04,BEA,gemGrab,Crystal Arcade,12,8,20
18311,2023-01-04,BEA,brawlBall,Sunny Soccer,89,94,183
18312,2023-01-04,BEA,brawlBall,Beach Ball,0,4,4
18313,2023-01-04,BEA,bounty,Shooting Star,57,25,82
18314,2023-01-03,BEA,knockout,Goldarm Gulch,1,0,1
18315,2023-01-03,BEA,hotZone,Parallel Plays,24,30,54
18316,2023-01-03,BEA,heist,Pit Stop,1,15,16
18317,2023-01-03,BEA,gemGrab,Minecart Madness,8,0,8
18318,2023-01-03,BEA,gemGrab,Crystal Arcade,34,53,87
18319,2023-01-03,BEA,brawlBall,Center Stage,1,4,5
18320,2023-01-03,BEA,brawlBall,Beach Ball,104,144,248
18321,2023-01-03,BEA,bounty,Hideout,36,5,41
18322,2023-01-02,BEA,knockout,Belle's Rock,11,10,21
18323,2023-01-02,BEA,hotZone,Quarter Pounder,73,121,194
18324,2023-01-02,BEA,heist,Pit Stop,15,40,55
18325,2023-01-02,BEA,gemGrab,Minecart Madness,24,28,52
18326,2023-01-02,BEA,gemGrab,Double Swoosh,11,22,33
18327,2023-01-02,BEA,brawlBall,Center Stage,47,58,105
18328,2023-01-02,BEA,brawlBall,Backyard Bowl,24,12,36
18329,2023-01-02,BEA,bounty,Hideout,39,17,56
18330,2023-01-01,BEA,knockout,Belle's Rock,4,1,5
18331,2023-01-01,BEA,hotZone,Quarter Pounder,69,93,162
18332,2023-01-01,BEA,heist,Bridge Too Far,5,5,10
18333,2023-01-01,BEA,gemGrab,Double Swoosh,6,5,11
18334,2023-01-01,BEA,brawlBall,Backyard Bowl,110,128,238
18335,2023-01-01,BEA,bounty,Canal Grande,2,0,2
18336,2022-12-31,BEA,hotZone,Controller Chaos,4,5,9
18337,2022-12-31,BEA,heist,Bridge Too Far,12,4,16
18338,2022-12-31,BEA,gemGrab,Hard Rock Mine,5,1,6
18339,2022-12-31,BEA,gemGrab,Deep Diner,2,1,3
18340,2022-12-31,BEA,brawlBall,Super Beach,12,9,21
18341,2022-12-31,BEA,bounty,Canal Grande,0,1,1
18342,2022-12-30,BEA,knockout,Flaring Phoenix,0,1,1
18343,2022-12-30,BEA,hotZone,Controller Chaos,2,2,4
18344,2022-12-30,BEA,gemGrab,Undermine,1,1,2
18345,2022-12-30,BEA,gemGrab,Deep Diner,9,17,26
18346,2022-12-30,BEA,brawlBall,Sneaky Fields,10,11,21
18347,2022-12-29,BEA,hotZone,Open Zone,3,2,5
18348,2022-12-29,BEA,gemGrab,Undermine,1,0,1
18349,2022-12-29,BEA,brawlBall,Pinhole Punt,16,5,21
18350,2022-12-28,BEA,hotZone,Open Zone,9,1,10
18351,2022-12-27,BEA,knockout,New Perspective,0,1,1
18352,2022-12-27,BEA,gemGrab,Minecart Madness,0,1,1
18353,2022-12-27,BEA,brawlBall,Center Stage,4,1,5
18354,2022-12-27,BEA,brawlBall,Beach Ball,1,1,2
18355,2022-12-26,BEA,heist,Kaboom Canyon,0,1,1
18356,2022-12-26,BEA,gemGrab,Minecart Madness,1,1,2
18357,2022-12-26,BEA,brawlBall,Center Stage,1,0,1
18358,2022-12-25,BEA,brawlBall,Backyard Bowl,3,1,4
18359,2022-12-25,BEA,bounty,Layer Cake,1,1,2
18360,2022-12-24,BEA,knockout,X Marks the Spot,0,1,1
18361,2022-12-24,BEA,brawlBall,Super Beach,1,3,4
18362,2022-12-24,BEA,bounty,Dry Season,0,1,1
18363,2022-12-23,BEA,knockout,Out in the Open,0,1,1
18364,2022-12-22,BEA,brawlBall,Pinhole Punt,3,0,3
18365,2022-12-21,BEA,brawlBall,Sunny Soccer,2,2,4
18366,2022-12-20,BEA,brawlBall,Beach Ball,1,2,3
18367,2022-12-19,BEA,brawlBall,Center Stage,2,0,2
18368,2022-12-18,BEA,heist,Bridge Too Far,1,0,1
18369,2022-12-17,BEA,knockout,Flaring Phoenix,1,0,1
18370,2022-12-16,BEA,brawlBall,Sneaky Fields,1,1,2
18371,2022-12-13,BEA,knockout,New Perspective,3,13,16
18372,2022-12-13,BEA,heist,Safe Zone,0,1,1
18373,2022-12-13,BEA,gemGrab,Crystal Arcade,0,1,1
18374,2022-11-03,BEA,bounty,Temple Ruins,1,0,1
18375,2022-11-01,BEA,knockout,New Perspective,0,1,1
18376,2022-10-28,BEA,bounty,Canal Grande,1,0,1
18377,2022-10-15,BEA,hotZone,Ring of Fire,1,0,1
18378,2022-10-15,BEA,gemGrab,Hard Rock Mine,2,0,2
18379,2023-02-05,BARLEY,knockout,X Marks the Spot,14,10,24
18380,2023-02-05,BARLEY,hotZone,Ring of Fire,19,4,23
18381,2023-02-05,BARLEY,heist,Snaked Assault,35,19,54
18382,2023-02-05,BARLEY,heist,Pit Stop,169,109,278
18383,2023-02-05,BARLEY,gemGrab,Hard Rock Mine,5,3,8
18384,2023-02-05,BARLEY,gemGrab,Double Swoosh,25,11,36
18385,2023-02-05,BARLEY,brawlBall,Super Beach,7,4,11
18386,2023-02-05,BARLEY,brawlBall,Sneaky Fields,4,1,5
18387,2023-02-05,BARLEY,brawlBall,Backyard Bowl,24,15,39
18388,2023-02-05,BARLEY,bounty,Layer Cake,23,33,56
18389,2023-02-04,BARLEY,knockout,X Marks the Spot,3,1,4
18390,2023-02-04,BARLEY,hotZone,Ring of Fire,4,1,5
18391,2023-02-04,BARLEY,heist,Tornado Ring,4,3,7
18392,2023-02-04,BARLEY,heist,Pit Stop,150,138,288
18393,2023-02-04,BARLEY,gemGrab,Hard Rock Mine,5,5,10
18394,2023-02-04,BARLEY,gemGrab,Double Swoosh,5,0,5
18395,2023-02-04,BARLEY,gemGrab,Deep Diner,4,3,7
18396,2023-02-04,BARLEY,brawlBall,Super Beach,131,149,280
18397,2023-02-04,BARLEY,brawlBall,Sneaky Fields,3,1,4
18398,2023-02-04,BARLEY,bounty,Dry Season,1,0,1
18399,2023-02-03,BARLEY,knockout,Out in the Open,10,7,17
18400,2023-02-03,BARLEY,knockout,Goldarm Gulch,6,1,7
18401,2023-02-03,BARLEY,hotZone,Split,116,151,267
18402,2023-02-03,BARLEY,heist,Tornado Ring,69,59,128
18403,2023-02-03,BARLEY,heist,Pit Stop,724,581,1305
18404,2023-02-03,BARLEY,gemGrab,Undermine,4,0,4
18405,2023-02-03,BARLEY,gemGrab,Double Swoosh,52,5,57
18406,2023-02-03,BARLEY,gemGrab,Deep Diner,182,294,476
18407,2023-02-03,BARLEY,brawlBall,Sneaky Fields,91,80,171
18408,2023-02-03,BARLEY,brawlBall,Pinhole Punt,2,0,2
18409,2023-02-03,BARLEY,bounty,Dry Season,11,8,19
18410,2023-02-02,BARLEY,knockout,Out in the Open,6,3,9
18411,2023-02-02,BARLEY,hotZone,Split,73,66,139
18412,2023-02-02,BARLEY,heist,Kaboom Canyon,3,3,6
18413,2023-02-02,BARLEY,gemGrab,Undermine,3,2,5
18414,2023-02-02,BARLEY,gemGrab,Gem Fort,1,0,1
18415,2023-02-02,BARLEY,brawlBall,Sunny Soccer,4,1,5
18416,2023-02-02,BARLEY,brawlBall,Pinhole Punt,15,7,22
18417,2023-02-02,BARLEY,bounty,Shooting Star,2,0,2
18418,2023-02-01,BARLEY,knockout,Goldarm Gulch,19,19,38
18419,2023-02-01,BARLEY,hotZone,Parallel Plays,224,310,534
18420,2023-02-01,BARLEY,heist,Kaboom Canyon,5,6,11
18421,2023-02-01,BARLEY,gemGrab,Gem Fort,12,13,25
18422,2023-02-01,BARLEY,gemGrab,Crystal Arcade,15,9,24
18423,2023-02-01,BARLEY,brawlBall,Sunny Soccer,206,308,514
18424,2023-02-01,BARLEY,brawlBall,Beach Ball,7,4,11
18425,2023-02-01,BARLEY,bounty,Shooting Star,8,0,8
18426,2023-01-31,BARLEY,knockout,Goldarm Gulch,16,6,22
18427,2023-01-31,BARLEY,hotZone,Parallel Plays,124,160,284
18428,2023-01-31,BARLEY,heist,Pit Stop,84,85,169
18429,2023-01-31,BARLEY,gemGrab,Minecart Madness,2,4,6
18430,2023-01-31,BARLEY,gemGrab,Crystal Arcade,9,9,18
18431,2023-01-31,BARLEY,brawlBall,Beach Ball,74,61,135
18432,2023-01-31,BARLEY,bounty,Hideout,1,2,3
18433,2023-01-30,BARLEY,knockout,Belle's Rock,65,44,109
18434,2023-01-30,BARLEY,hotZone,Quarter Pounder,171,410,581
18435,2023-01-30,BARLEY,heist,Pit Stop,288,257,545
18436,2023-01-30,BARLEY,gemGrab,Minecart Madness,32,20,52
18437,2023-01-30,BARLEY,gemGrab,Double Swoosh,6,6,12
18438,2023-01-30,BARLEY,brawlBall,Center Stage,26,22,48
18439,2023-01-30,BARLEY,brawlBall,Backyard Bowl,2,1,3
18440,2023-01-30,BARLEY,bounty,Hideout,6,5,11
18441,2023-01-29,BARLEY,knockout,Belle's Rock,62,38,100
18442,2023-01-29,BARLEY,hotZone,Quarter Pounder,305,458,763
18443,2023-01-29,BARLEY,heist,Bridge Too Far,13,7,20
18444,2023-01-29,BARLEY,gemGrab,Hard Rock Mine,5,3,8
18445,2023-01-29,BARLEY,gemGrab,Double Swoosh,18,9,27
18446,2023-01-29,BARLEY,brawlBall,Super Beach,18,16,34
18447,2023-01-29,BARLEY,brawlBall,Backyard Bowl,25,9,34
18448,2023-01-29,BARLEY,bounty,Canal Grande,19,6,25
18449,2023-01-28,BARLEY,knockout,Flaring Phoenix,34,24,58
18450,2023-01-28,BARLEY,hotZone,Controller Chaos,50,58,108
18451,2023-01-28,BARLEY,heist,Bridge Too Far,20,14,34
18452,2023-01-28,BARLEY,gemGrab,Hard Rock Mine,16,19,35
18453,2023-01-28,BARLEY,gemGrab,Deep Diner,30,50,80
18454,2023-01-28,BARLEY,brawlBall,Super Beach,449,596,1045
18455,2023-01-28,BARLEY,brawlBall,Sneaky Fields,1,3,4
18456,2023-01-28,BARLEY,bounty,Canal Grande,39,35,74
18457,2023-01-27,BARLEY,knockout,Flaring Phoenix,10,5,15
18458,2023-01-27,BARLEY,hotZone,Controller Chaos,35,17,52
18459,2023-01-27,BARLEY,heist,Hot Potato,62,112,174
18460,2023-01-27,BARLEY,gemGrab,Undermine,4,0,4
18461,2023-01-27,BARLEY,gemGrab,Deep Diner,78,92,170
18462,2023-01-27,BARLEY,brawlBall,Sneaky Fields,45,43,88
18463,2023-01-27,BARLEY,bounty,Temple Ruins,1,1,2
18464,2023-01-26,BARLEY,knockout,Riverside,16,2,18
18465,2023-01-26,BARLEY,hotZone,Open Zone,18,7,25
18466,2023-01-26,BARLEY,heist,Hot Potato,282,364,646
18467,2023-01-26,BARLEY,gemGrab,Undermine,3,10,13
18468,2023-01-26,BARLEY,gemGrab,Gem Fort,3,1,4
18469,2023-01-26,BARLEY,brawlBall,Sunny Soccer,5,4,9
18470,2023-01-26,BARLEY,brawlBall,Pinhole Punt,65,40,105
18471,2023-01-26,BARLEY,bounty,Temple Ruins,6,7,13
18472,2023-01-25,BARLEY,knockout,Riverside,4,3,7
18473,2023-01-25,BARLEY,hotZone,Open Zone,3,0,3
18474,2023-01-25,BARLEY,heist,Safe Zone,22,7,29
18475,2023-01-25,BARLEY,gemGrab,Gem Fort,4,5,9
18476,2023-01-25,BARLEY,gemGrab,Crystal Arcade,2,10,12
18477,2023-01-25,BARLEY,brawlBall,Sunny Soccer,138,134,272
18478,2023-01-25,BARLEY,brawlBall,Beach Ball,13,10,23
18479,2023-01-25,BARLEY,bounty,Excel,16,15,31
18480,2023-01-24,BARLEY,knockout,New Perspective,19,10,29
18481,2023-01-24,BARLEY,hotZone,Dueling Beetles,49,20,69
18482,2023-01-24,BARLEY,heist,Safe Zone,32,16,48
18483,2023-01-24,BARLEY,gemGrab,Minecart Madness,6,13,19
18484,2023-01-24,BARLEY,gemGrab,Crystal Arcade,22,10,32
18485,2023-01-24,BARLEY,brawlBall,Center Stage,6,3,9
18486,2023-01-24,BARLEY,brawlBall,Beach Ball,154,163,317
18487,2023-01-24,BARLEY,bounty,Excel,31,23,54
18488,2023-01-23,BARLEY,knockout,New Perspective,23,7,30
18489,2023-01-23,BARLEY,hotZone,Dueling Beetles,76,82,158
18490,2023-01-23,BARLEY,heist,Snaked Assault,56,25,81
18491,2023-01-23,BARLEY,gemGrab,Minecart Madness,33,25,58
18492,2023-01-23,BARLEY,gemGrab,Double Swoosh,4,2,6
18493,2023-01-23,BARLEY,brawlBall,Center Stage,72,55,127
18494,2023-01-23,BARLEY,bounty,Layer Cake,30,9,39
18495,2023-01-22,BARLEY,knockout,X Marks the Spot,14,7,21
18496,2023-01-22,BARLEY,hotZone,Ring of Fire,5,0,5
18497,2023-01-22,BARLEY,heist,Snaked Assault,35,22,57
18498,2023-01-22,BARLEY,gemGrab,Hard Rock Mine,7,1,8
18499,2023-01-22,BARLEY,gemGrab,Double Swoosh,10,14,24
18500,2023-01-22,BARLEY,brawlBall,Super Beach,34,38,72
18501,2023-01-22,BARLEY,brawlBall,Backyard Bowl,16,5,21
18502,2023-01-22,BARLEY,bounty,Layer Cake,9,5,14
18503,2023-01-21,BARLEY,knockout,X Marks the Spot,17,17,34
18504,2023-01-21,BARLEY,hotZone,Ring of Fire,26,7,33
18505,2023-01-21,BARLEY,heist,Tornado Ring,58,35,93
18506,2023-01-21,BARLEY,gemGrab,Hard Rock Mine,26,13,39
18507,2023-01-21,BARLEY,gemGrab,Deep Diner,44,56,100
18508,2023-01-21,BARLEY,brawlBall,Super Beach,554,895,1449
18509,2023-01-21,BARLEY,brawlBall,Sneaky Fields,7,4,11
18510,2023-01-21,BARLEY,bounty,Dry Season,13,9,22
18511,2023-01-20,BARLEY,knockout,Out in the Open,21,10,31
18512,2023-01-20,BARLEY,hotZone,Split,130,189,319
18513,2023-01-20,BARLEY,heist,Tornado Ring,40,34,74
18514,2023-01-20,BARLEY,gemGrab,Undermine,8,1,9
18515,2023-01-20,BARLEY,gemGrab,Deep Diner,153,227,380
18516,2023-01-20,BARLEY,brawlBall,Sneaky Fields,85,66,151
18517,2023-01-20,BARLEY,brawlBall,Pinhole Punt,5,4,9
18518,2023-01-20,BARLEY,bounty,Dry Season,13,13,26
18519,2023-01-19,BARLEY,knockout,Out in the Open,16,24,40
18520,2023-01-19,BARLEY,hotZone,Split,212,325,537
18521,2023-01-19,BARLEY,heist,Kaboom Canyon,23,14,37
18522,2023-01-19,BARLEY,gemGrab,Undermine,15,5,20
18523,2023-01-19,BARLEY,gemGrab,Gem Fort,1,0,1
18524,2023-01-19,BARLEY,brawlBall,Sunny Soccer,9,3,12
18525,2023-01-19,BARLEY,brawlBall,Pinhole Punt,35,19,54
18526,2023-01-19,BARLEY,bounty,Shooting Star,10,6,16
18527,2023-01-18,BARLEY,knockout,Goldarm Gulch,2,1,3
18528,2023-01-18,BARLEY,hotZone,Parallel Plays,26,55,81
18529,2023-01-18,BARLEY,heist,Kaboom Canyon,9,3,12
18530,2023-01-18,BARLEY,gemGrab,Gem Fort,1,3,4
18531,2023-01-18,BARLEY,gemGrab,Crystal Arcade,1,2,3
18532,2023-01-18,BARLEY,brawlBall,Sunny Soccer,74,64,138
18533,2023-01-18,BARLEY,brawlBall,Beach Ball,2,2,4
18534,2023-01-18,BARLEY,bounty,Shooting Star,0,2,2
18535,2023-01-17,BARLEY,knockout,Goldarm Gulch,2,10,12
18536,2023-01-17,BARLEY,hotZone,Parallel Plays,26,31,57
18537,2023-01-17,BARLEY,heist,Pit Stop,24,20,44
18538,2023-01-17,BARLEY,gemGrab,Minecart Madness,2,0,2
18539,2023-01-17,BARLEY,gemGrab,Crystal Arcade,4,11,15
18540,2023-01-17,BARLEY,brawlBall,Beach Ball,23,10,33
18541,2023-01-16,BARLEY,knockout,Belle's Rock,3,2,5
18542,2023-01-16,BARLEY,hotZone,Quarter Pounder,10,15,25
18543,2023-01-16,BARLEY,heist,Pit Stop,72,110,182
18544,2023-01-16,BARLEY,gemGrab,Minecart Madness,1,2,3
18545,2023-01-16,BARLEY,gemGrab,Double Swoosh,1,0,1
18546,2023-01-16,BARLEY,brawlBall,Center Stage,3,2,5
18547,2023-01-15,BARLEY,knockout,Belle's Rock,4,6,10
18548,2023-01-15,BARLEY,hotZone,Quarter Pounder,47,82,129
18549,2023-01-15,BARLEY,heist,Bridge Too Far,1,0,1
18550,2023-01-15,BARLEY,gemGrab,Double Swoosh,1,1,2
18551,2023-01-15,BARLEY,brawlBall,Super Beach,4,15,19
18552,2023-01-15,BARLEY,brawlBall,Backyard Bowl,2,0,2
18553,2023-01-15,BARLEY,bounty,Canal Grande,1,1,2
18554,2023-01-14,BARLEY,hotZone,Controller Chaos,11,0,11
18555,2023-01-14,BARLEY,heist,Bridge Too Far,1,0,1
18556,2023-01-14,BARLEY,gemGrab,Deep Diner,8,2,10
18557,2023-01-14,BARLEY,brawlBall,Super Beach,26,63,89
18558,2023-01-14,BARLEY,bounty,Canal Grande,3,0,3
18559,2023-01-13,BARLEY,hotZone,Controller Chaos,18,37,55
18560,2023-01-13,BARLEY,heist,Hot Potato,11,5,16
18561,2023-01-13,BARLEY,gemGrab,Deep Diner,10,15,25
18562,2023-01-13,BARLEY,brawlBall,Sneaky Fields,7,17,24
18563,2023-01-12,BARLEY,knockout,Riverside,1,0,1
18564,2023-01-12,BARLEY,hotZone,Open Zone,1,0,1
18565,2023-01-12,BARLEY,heist,Hot Potato,5,4,9
18566,2023-01-11,BARLEY,heist,Safe Zone,0,1,1
18567,2023-01-11,BARLEY,brawlBall,Sunny Soccer,3,7,10
18568,2023-01-10,BARLEY,hotZone,Dueling Beetles,10,17,27
18569,2023-01-10,BARLEY,gemGrab,Crystal Arcade,1,0,1
18570,2023-01-10,BARLEY,brawlBall,Beach Ball,5,8,13
18571,2023-01-09,BARLEY,knockout,New Perspective,1,1,2
18572,2023-01-09,BARLEY,hotZone,Dueling Beetles,5,3,8
18573,2023-01-09,BARLEY,heist,Snaked Assault,5,0,5
18574,2023-01-09,BARLEY,gemGrab,Minecart Madness,1,2,3
18575,2023-01-09,BARLEY,bounty,Layer Cake,2,0,2
18576,2023-01-08,BARLEY,hotZone,Ring of Fire,1,0,1
18577,2023-01-08,BARLEY,heist,Snaked Assault,2,3,5
18578,2023-01-08,BARLEY,gemGrab,Hard Rock Mine,1,0,1
18579,2023-01-08,BARLEY,brawlBall,Super Beach,9,13,22
18580,2023-01-08,BARLEY,brawlBall,Backyard Bowl,1,1,2
18581,2023-01-08,BARLEY,bounty,Layer Cake,1,0,1
18582,2023-01-07,BARLEY,hotZone,Ring of Fire,1,0,1
18583,2023-01-07,BARLEY,heist,Tornado Ring,6,0,6
18584,2023-01-07,BARLEY,gemGrab,Deep Diner,12,36,48
18585,2023-01-07,BARLEY,brawlBall,Super Beach,17,41,58
18586,2023-01-06,BARLEY,hotZone,Split,13,21,34
18587,2023-01-06,BARLEY,heist,Tornado Ring,6,2,8
18588,2023-01-06,BARLEY,gemGrab,Deep Diner,20,58,78
18589,2023-01-06,BARLEY,brawlBall,Sneaky Fields,1,0,1
18590,2023-01-06,BARLEY,bounty,Dry Season,1,0,1
18591,2023-01-05,BARLEY,hotZone,Split,35,37,72
18592,2023-01-05,BARLEY,gemGrab,Undermine,1,0,1
18593,2023-01-05,BARLEY,gemGrab,Gem Fort,2,0,2
18594,2023-01-05,BARLEY,brawlBall,Pinhole Punt,1,0,1
18595,2023-01-04,BARLEY,hotZone,Parallel Plays,23,35,58
18596,2023-01-04,BARLEY,heist,Kaboom Canyon,2,0,2
18597,2023-01-04,BARLEY,brawlBall,Sunny Soccer,26,54,80
18598,2023-01-03,BARLEY,hotZone,Parallel Plays,27,77,104
18599,2023-01-03,BARLEY,heist,Pit Stop,26,63,89
18600,2023-01-03,BARLEY,gemGrab,Crystal Arcade,1,0,1
18601,2023-01-03,BARLEY,brawlBall,Beach Ball,10,6,16
18602,2023-01-03,BARLEY,bounty,Hideout,2,0,2
18603,2023-01-02,BARLEY,knockout,Belle's Rock,4,0,4
18604,2023-01-02,BARLEY,hotZone,Quarter Pounder,47,83,130
18605,2023-01-02,BARLEY,heist,Pit Stop,44,60,104
18606,2023-01-02,BARLEY,gemGrab,Minecart Madness,1,0,1
18607,2023-01-02,BARLEY,brawlBall,Center Stage,1,0,1
18608,2023-01-02,BARLEY,bounty,Hideout,2,1,3
18609,2023-01-01,BARLEY,hotZone,Quarter Pounder,31,48,79
18610,2023-01-01,BARLEY,gemGrab,Double Swoosh,1,0,1
18611,2023-01-01,BARLEY,brawlBall,Backyard Bowl,1,0,1
18612,2022-12-31,BARLEY,hotZone,Controller Chaos,1,0,1
18613,2022-12-31,BARLEY,gemGrab,Minecart Madness,0,2,2
18614,2022-12-31,BARLEY,gemGrab,Hard Rock Mine,1,0,1
18615,2022-12-31,BARLEY,gemGrab,Deep Diner,1,11,12
18616,2022-12-31,BARLEY,brawlBall,Super Beach,1,6,7
18617,2022-12-30,BARLEY,hotZone,Controller Chaos,1,0,1
18618,2022-12-30,BARLEY,heist,Hot Potato,1,0,1
18619,2022-12-30,BARLEY,gemGrab,Minecart Madness,1,0,1
18620,2022-12-30,BARLEY,gemGrab,Deep Diner,3,11,14
18621,2022-12-30,BARLEY,brawlBall,Sneaky Fields,1,0,1
18622,2022-12-29,BARLEY,heist,Hot Potato,2,0,2
18623,2022-12-25,BARLEY,hotZone,Ring of Fire,1,0,1
18624,2022-12-24,BARLEY,brawlBall,Super Beach,1,0,1
18625,2022-12-21,BARLEY,brawlBall,Sunny Soccer,2,0,2
18626,2022-12-13,BARLEY,brawlBall,Beach Ball,1,0,1
18627,2022-11-07,BARLEY,hotZone,Quarter Pounder,0,1,1
18628,2022-11-01,BARLEY,knockout,New Perspective,0,1,1
18629,2023-02-05,ASH,knockout,X Marks the Spot,8,4,12
18630,2023-02-05,ASH,hotZone,Ring of Fire,63,121,184
18631,2023-02-05,ASH,heist,Snaked Assault,26,17,43
18632,2023-02-05,ASH,heist,Pit Stop,1,0,1
18633,2023-02-05,ASH,gemGrab,Hard Rock Mine,73,108,181
18634,2023-02-05,ASH,gemGrab,Double Swoosh,368,518,886
18635,2023-02-05,ASH,brawlBall,Super Beach,26,46,72
18636,2023-02-05,ASH,brawlBall,Sneaky Fields,165,252,417
18637,2023-02-05,ASH,brawlBall,Backyard Bowl,61,65,126
18638,2023-02-05,ASH,bounty,Layer Cake,31,54,85
18639,2023-02-04,ASH,knockout,X Marks the Spot,2,2,4
18640,2023-02-04,ASH,knockout,Goldarm Gulch,1,3,4
18641,2023-02-04,ASH,hotZone,Ring of Fire,22,22,44
18642,2023-02-04,ASH,heist,Tornado Ring,1,0,1
18643,2023-02-04,ASH,heist,Pit Stop,6,6,12
18644,2023-02-04,ASH,gemGrab,Hard Rock Mine,82,93,175
18645,2023-02-04,ASH,gemGrab,Double Swoosh,35,96,131
18646,2023-02-04,ASH,gemGrab,Deep Diner,1,5,6
18647,2023-02-04,ASH,brawlBall,Super Beach,176,228,404
18648,2023-02-04,ASH,brawlBall,Sneaky Fields,159,208,367
18649,2023-02-04,ASH,bounty,Dry Season,3,1,4
18650,2023-02-03,ASH,knockout,Out in the Open,12,11,23
18651,2023-02-03,ASH,knockout,Goldarm Gulch,6,8,14
18652,2023-02-03,ASH,hotZone,Split,50,98,148
18653,2023-02-03,ASH,heist,Tornado Ring,17,15,32
18654,2023-02-03,ASH,heist,Pit Stop,21,14,35
18655,2023-02-03,ASH,gemGrab,Undermine,36,38,74
18656,2023-02-03,ASH,gemGrab,Double Swoosh,170,679,849
18657,2023-02-03,ASH,gemGrab,Deep Diner,73,105,178
18658,2023-02-03,ASH,brawlBall,Sneaky Fields,1653,2350,4003
18659,2023-02-03,ASH,brawlBall,Pinhole Punt,20,31,51
18660,2023-02-03,ASH,bounty,Dry Season,7,3,10
18661,2023-02-02,ASH,knockout,Out in the Open,2,0,2
18662,2023-02-02,ASH,hotZone,Split,29,41,70
18663,2023-02-02,ASH,heist,Kaboom Canyon,1,0,1
18664,2023-02-02,ASH,gemGrab,Undermine,35,55,90
18665,2023-02-02,ASH,gemGrab,Gem Fort,12,18,30
18666,2023-02-02,ASH,brawlBall,Sunny Soccer,8,12,20
18667,2023-02-02,ASH,brawlBall,Pinhole Punt,130,158,288
18668,2023-02-02,ASH,bounty,Shooting Star,3,0,3
18669,2023-02-01,ASH,knockout,Goldarm Gulch,24,18,42
18670,2023-02-01,ASH,hotZone,Parallel Plays,165,322,487
18671,2023-02-01,ASH,heist,Kaboom Canyon,6,0,6
18672,2023-02-01,ASH,gemGrab,Gem Fort,148,194,342
18673,2023-02-01,ASH,gemGrab,Crystal Arcade,111,194,305
18674,2023-02-01,ASH,brawlBall,Sunny Soccer,463,653,1116
18675,2023-02-01,ASH,brawlBall,Beach Ball,18,23,41
18676,2023-02-01,ASH,bounty,Shooting Star,2,1,3
18677,2023-01-31,ASH,knockout,Goldarm Gulch,15,15,30
18678,2023-01-31,ASH,hotZone,Parallel Plays,96,136,232
18679,2023-01-31,ASH,heist,Pit Stop,10,4,14
18680,2023-01-31,ASH,gemGrab,Minecart Madness,0,1,1
18681,2023-01-31,ASH,gemGrab,Crystal Arcade,110,170,280
18682,2023-01-31,ASH,brawlBall,Center Stage,5,8,13
18683,2023-01-31,ASH,brawlBall,Beach Ball,171,258,429
18684,2023-01-31,ASH,bounty,Hideout,1,1,2
18685,2023-01-30,ASH,knockout,Belle's Rock,10,9,19
18686,2023-01-30,ASH,hotZone,Quarter Pounder,37,27,64
18687,2023-01-30,ASH,heist,Pit Stop,8,3,11
18688,2023-01-30,ASH,gemGrab,Minecart Madness,9,20,29
18689,2023-01-30,ASH,gemGrab,Double Swoosh,175,233,408
18690,2023-01-30,ASH,brawlBall,Center Stage,427,575,1002
18691,2023-01-30,ASH,brawlBall,Backyard Bowl,5,5,10
18692,2023-01-30,ASH,bounty,Hideout,2,0,2
18693,2023-01-29,ASH,knockout,Belle's Rock,12,16,28
18694,2023-01-29,ASH,hotZone,Quarter Pounder,31,21,52
18695,2023-01-29,ASH,heist,Bridge Too Far,1,0,1
18696,2023-01-29,ASH,gemGrab,Hard Rock Mine,58,84,142
18697,2023-01-29,ASH,gemGrab,Double Swoosh,234,351,585
18698,2023-01-29,ASH,brawlBall,Super Beach,10,16,26
18699,2023-01-29,ASH,brawlBall,Backyard Bowl,68,79,147
18700,2023-01-29,ASH,bounty,Canal Grande,77,111,188
18701,2023-01-28,ASH,knockout,Flaring Phoenix,11,15,26
18702,2023-01-28,ASH,hotZone,Controller Chaos,114,179,293
18703,2023-01-28,ASH,heist,Bridge Too Far,6,2,8
18704,2023-01-28,ASH,gemGrab,Hard Rock Mine,270,358,628
18705,2023-01-28,ASH,gemGrab,Deep Diner,29,47,76
18706,2023-01-28,ASH,brawlBall,Super Beach,639,889,1528
18707,2023-01-28,ASH,brawlBall,Sneaky Fields,69,98,167
18708,2023-01-28,ASH,bounty,Canal Grande,136,221,357
18709,2023-01-27,ASH,knockout,Flaring Phoenix,8,2,10
18710,2023-01-27,ASH,hotZone,Controller Chaos,39,55,94
18711,2023-01-27,ASH,heist,Hot Potato,7,16,23
18712,2023-01-27,ASH,gemGrab,Undermine,13,9,22
18713,2023-01-27,ASH,gemGrab,Deep Diner,22,26,48
18714,2023-01-27,ASH,brawlBall,Sneaky Fields,324,390,714
18715,2023-01-27,ASH,brawlBall,Pinhole Punt,2,1,3
18716,2023-01-27,ASH,bounty,Temple Ruins,9,4,13
18717,2023-01-26,ASH,knockout,Riverside,1,0,1
18718,2023-01-26,ASH,hotZone,Open Zone,9,7,16
18719,2023-01-26,ASH,heist,Hot Potato,4,3,7
18720,2023-01-26,ASH,gemGrab,Undermine,80,114,194
18721,2023-01-26,ASH,gemGrab,Gem Fort,67,123,190
18722,2023-01-26,ASH,brawlBall,Sunny Soccer,34,49,83
18723,2023-01-26,ASH,brawlBall,Pinhole Punt,331,485,816
18724,2023-01-26,ASH,bounty,Temple Ruins,54,81,135
18725,2023-01-25,ASH,knockout,Riverside,3,4,7
18726,2023-01-25,ASH,hotZone,Open Zone,4,1,5
18727,2023-01-25,ASH,heist,Safe Zone,1,1,2
18728,2023-01-25,ASH,gemGrab,Gem Fort,70,133,203
18729,2023-01-25,ASH,gemGrab,Crystal Arcade,118,198,316
18730,2023-01-25,ASH,brawlBall,Sunny Soccer,279,361,640
18731,2023-01-25,ASH,brawlBall,Beach Ball,45,66,111
18732,2023-01-25,ASH,bounty,Excel,5,4,9
18733,2023-01-24,ASH,knockout,New Perspective,6,9,15
18734,2023-01-24,ASH,hotZone,Dueling Beetles,38,27,65
18735,2023-01-24,ASH,heist,Safe Zone,2,2,4
18736,2023-01-24,ASH,gemGrab,Minecart Madness,3,2,5
18737,2023-01-24,ASH,gemGrab,Crystal Arcade,197,282,479
18738,2023-01-24,ASH,brawlBall,Center Stage,84,106,190
18739,2023-01-24,ASH,brawlBall,Beach Ball,389,501,890
18740,2023-01-24,ASH,bounty,Excel,13,22,35
18741,2023-01-23,ASH,knockout,New Perspective,11,15,26
18742,2023-01-23,ASH,hotZone,Dueling Beetles,39,47,86
18743,2023-01-23,ASH,heist,Snaked Assault,24,14,38
18744,2023-01-23,ASH,gemGrab,Minecart Madness,22,20,42
18745,2023-01-23,ASH,gemGrab,Double Swoosh,106,120,226
18746,2023-01-23,ASH,brawlBall,Center Stage,835,1223,2058
18747,2023-01-23,ASH,brawlBall,Backyard Bowl,2,0,2
18748,2023-01-23,ASH,bounty,Layer Cake,34,40,74
18749,2023-01-22,ASH,knockout,X Marks the Spot,4,3,7
18750,2023-01-22,ASH,hotZone,Ring of Fire,39,72,111
18751,2023-01-22,ASH,heist,Snaked Assault,12,10,22
18752,2023-01-22,ASH,gemGrab,Hard Rock Mine,86,123,209
18753,2023-01-22,ASH,gemGrab,Double Swoosh,120,157,277
18754,2023-01-22,ASH,brawlBall,Super Beach,36,55,91
18755,2023-01-22,ASH,brawlBall,Backyard Bowl,26,23,49
18756,2023-01-22,ASH,bounty,Layer Cake,24,49,73
18757,2023-01-21,ASH,knockout,X Marks the Spot,29,36,65
18758,2023-01-21,ASH,hotZone,Ring of Fire,94,117,211
18759,2023-01-21,ASH,heist,Tornado Ring,18,9,27
18760,2023-01-21,ASH,gemGrab,Hard Rock Mine,324,464,788
18761,2023-01-21,ASH,gemGrab,Deep Diner,19,46,65
18762,2023-01-21,ASH,brawlBall,Super Beach,847,1127,1974
18763,2023-01-21,ASH,brawlBall,Sneaky Fields,58,73,131
18764,2023-01-21,ASH,bounty,Dry Season,10,3,13
18765,2023-01-20,ASH,knockout,Out in the Open,8,5,13
18766,2023-01-20,ASH,hotZone,Split,54,86,140
18767,2023-01-20,ASH,heist,Tornado Ring,19,21,40
18768,2023-01-20,ASH,gemGrab,Undermine,79,141,220
18769,2023-01-20,ASH,gemGrab,Deep Diner,81,97,178
18770,2023-01-20,ASH,brawlBall,Sneaky Fields,915,1328,2243
18771,2023-01-20,ASH,brawlBall,Pinhole Punt,11,25,36
18772,2023-01-20,ASH,bounty,Dry Season,4,3,7
18773,2023-01-19,ASH,knockout,Out in the Open,9,20,29
18774,2023-01-19,ASH,hotZone,Split,113,274,387
18775,2023-01-19,ASH,heist,Kaboom Canyon,7,3,10
18776,2023-01-19,ASH,gemGrab,Undermine,160,181,341
18777,2023-01-19,ASH,gemGrab,Gem Fort,52,104,156
18778,2023-01-19,ASH,brawlBall,Sunny Soccer,15,47,62
18779,2023-01-19,ASH,brawlBall,Pinhole Punt,356,537,893
18780,2023-01-19,ASH,bounty,Shooting Star,5,19,24
18781,2023-01-18,ASH,knockout,Goldarm Gulch,1,3,4
18782,2023-01-18,ASH,hotZone,Parallel Plays,13,22,35
18783,2023-01-18,ASH,heist,Kaboom Canyon,2,0,2
18784,2023-01-18,ASH,gemGrab,Gem Fort,29,41,70
18785,2023-01-18,ASH,gemGrab,Crystal Arcade,14,28,42
18786,2023-01-18,ASH,brawlBall,Sunny Soccer,148,188,336
18787,2023-01-18,ASH,brawlBall,Beach Ball,3,4,7
18788,2023-01-17,ASH,knockout,Goldarm Gulch,2,0,2
18789,2023-01-17,ASH,hotZone,Parallel Plays,21,26,47
18790,2023-01-17,ASH,heist,Pit Stop,2,0,2
18791,2023-01-17,ASH,gemGrab,Minecart Madness,0,2,2
18792,2023-01-17,ASH,gemGrab,Crystal Arcade,22,25,47
18793,2023-01-17,ASH,brawlBall,Center Stage,3,6,9
18794,2023-01-17,ASH,brawlBall,Beach Ball,23,31,54
18795,2023-01-16,ASH,knockout,Belle's Rock,1,0,1
18796,2023-01-16,ASH,hotZone,Quarter Pounder,11,11,22
18797,2023-01-16,ASH,heist,Pit Stop,2,1,3
18798,2023-01-16,ASH,gemGrab,Minecart Madness,1,1,2
18799,2023-01-16,ASH,gemGrab,Double Swoosh,8,12,20
18800,2023-01-16,ASH,brawlBall,Center Stage,57,62,119
18801,2023-01-16,ASH,brawlBall,Backyard Bowl,1,2,3
18802,2023-01-16,ASH,bounty,Hideout,2,1,3
18803,2023-01-15,ASH,hotZone,Quarter Pounder,18,14,32
18804,2023-01-15,ASH,heist,Bridge Too Far,2,0,2
18805,2023-01-15,ASH,gemGrab,Hard Rock Mine,17,18,35
18806,2023-01-15,ASH,gemGrab,Double Swoosh,20,10,30
18807,2023-01-15,ASH,brawlBall,Super Beach,12,31,43
18808,2023-01-15,ASH,brawlBall,Backyard Bowl,10,11,21
18809,2023-01-15,ASH,bounty,Canal Grande,12,40,52
18810,2023-01-14,ASH,knockout,Flaring Phoenix,3,10,13
18811,2023-01-14,ASH,hotZone,Controller Chaos,36,68,104
18812,2023-01-14,ASH,heist,Bridge Too Far,1,0,1
18813,2023-01-14,ASH,gemGrab,Hard Rock Mine,25,30,55
18814,2023-01-14,ASH,gemGrab,Deep Diner,8,3,11
18815,2023-01-14,ASH,brawlBall,Super Beach,68,98,166
18816,2023-01-14,ASH,brawlBall,Sneaky Fields,16,18,34
18817,2023-01-14,ASH,bounty,Canal Grande,7,12,19
18818,2023-01-13,ASH,knockout,Flaring Phoenix,2,0,2
18819,2023-01-13,ASH,hotZone,Controller Chaos,33,58,91
18820,2023-01-13,ASH,gemGrab,Deep Diner,11,7,18
18821,2023-01-13,ASH,brawlBall,Sneaky Fields,110,184,294
18822,2023-01-13,ASH,brawlBall,Pinhole Punt,2,1,3
18823,2023-01-13,ASH,bounty,Temple Ruins,1,1,2
18824,2023-01-12,ASH,hotZone,Open Zone,0,1,1
18825,2023-01-12,ASH,gemGrab,Undermine,14,22,36
18826,2023-01-12,ASH,gemGrab,Gem Fort,5,7,12
18827,2023-01-12,ASH,brawlBall,Sunny Soccer,3,2,5
18828,2023-01-12,ASH,brawlBall,Pinhole Punt,16,26,42
18829,2023-01-11,ASH,gemGrab,Gem Fort,6,14,20
18830,2023-01-11,ASH,brawlBall,Sunny Soccer,13,9,22
18831,2023-01-11,ASH,brawlBall,Beach Ball,0,2,2
18832,2023-01-10,ASH,hotZone,Dueling Beetles,10,5,15
18833,2023-01-10,ASH,gemGrab,Minecart Madness,3,0,3
18834,2023-01-10,ASH,gemGrab,Crystal Arcade,21,54,75
18835,2023-01-10,ASH,brawlBall,Center Stage,11,15,26
18836,2023-01-10,ASH,brawlBall,Beach Ball,24,82,106
18837,2023-01-09,ASH,hotZone,Dueling Beetles,8,1,9
18838,2023-01-09,ASH,heist,Snaked Assault,5,1,6
18839,2023-01-09,ASH,gemGrab,Minecart Madness,5,19,24
18840,2023-01-09,ASH,gemGrab,Double Swoosh,31,60,91
18841,2023-01-09,ASH,brawlBall,Center Stage,35,77,112
18842,2023-01-09,ASH,bounty,Layer Cake,3,18,21
18843,2023-01-08,ASH,knockout,X Marks the Spot,0,4,4
18844,2023-01-08,ASH,hotZone,Ring of Fire,8,5,13
18845,2023-01-08,ASH,heist,Snaked Assault,1,0,1
18846,2023-01-08,ASH,gemGrab,Hard Rock Mine,6,4,10
18847,2023-01-08,ASH,gemGrab,Double Swoosh,7,1,8
18848,2023-01-08,ASH,brawlBall,Super Beach,4,2,6
18849,2023-01-08,ASH,brawlBall,Backyard Bowl,7,5,12
18850,2023-01-08,ASH,bounty,Layer Cake,3,6,9
18851,2023-01-07,ASH,hotZone,Ring of Fire,2,0,2
18852,2023-01-07,ASH,heist,Tornado Ring,1,0,1
18853,2023-01-07,ASH,gemGrab,Hard Rock Mine,13,25,38
18854,2023-01-07,ASH,gemGrab,Deep Diner,4,1,5
18855,2023-01-07,ASH,brawlBall,Super Beach,14,34,48
18856,2023-01-07,ASH,brawlBall,Sneaky Fields,14,32,46
18857,2023-01-06,ASH,hotZone,Split,10,8,18
18858,2023-01-06,ASH,heist,Tornado Ring,2,5,7
18859,2023-01-06,ASH,gemGrab,Undermine,6,3,9
18860,2023-01-06,ASH,gemGrab,Deep Diner,8,15,23
18861,2023-01-06,ASH,brawlBall,Sneaky Fields,96,147,243
18862,2023-01-06,ASH,bounty,Dry Season,0,3,3
18863,2023-01-05,ASH,knockout,Out in the Open,1,0,1
18864,2023-01-05,ASH,hotZone,Split,19,41,60
18865,2023-01-05,ASH,gemGrab,Undermine,22,28,50
18866,2023-01-05,ASH,gemGrab,Gem Fort,4,1,5
18867,2023-01-05,ASH,brawlBall,Sunny Soccer,0,1,1
18868,2023-01-05,ASH,brawlBall,Pinhole Punt,65,66,131
18869,2023-01-04,ASH,knockout,Goldarm Gulch,1,0,1
18870,2023-01-04,ASH,hotZone,Parallel Plays,12,8,20
18871,2023-01-04,ASH,heist,Kaboom Canyon,2,1,3
18872,2023-01-04,ASH,gemGrab,Gem Fort,28,41,69
18873,2023-01-04,ASH,gemGrab,Crystal Arcade,12,38,50
18874,2023-01-04,ASH,brawlBall,Sunny Soccer,45,55,100
18875,2023-01-04,ASH,bounty,Shooting Star,2,1,3
18876,2023-01-03,ASH,knockout,Goldarm Gulch,0,1,1
18877,2023-01-03,ASH,hotZone,Parallel Plays,14,6,20
18878,2023-01-03,ASH,heist,Pit Stop,2,1,3
18879,2023-01-03,ASH,gemGrab,Crystal Arcade,19,28,47
18880,2023-01-03,ASH,brawlBall,Center Stage,1,0,1
18881,2023-01-03,ASH,brawlBall,Beach Ball,22,16,38
18882,2023-01-03,ASH,bounty,Hideout,1,0,1
18883,2023-01-02,ASH,knockout,Belle's Rock,0,5,5
18884,2023-01-02,ASH,hotZone,Quarter Pounder,10,4,14
18885,2023-01-02,ASH,heist,Pit Stop,0,1,1
18886,2023-01-02,ASH,gemGrab,Minecart Madness,3,0,3
18887,2023-01-02,ASH,gemGrab,Double Swoosh,7,12,19
18888,2023-01-02,ASH,brawlBall,Center Stage,60,82,142
18889,2023-01-02,ASH,bounty,Hideout,1,1,2
18890,2023-01-01,ASH,hotZone,Quarter Pounder,2,0,2
18891,2023-01-01,ASH,gemGrab,Hard Rock Mine,4,4,8
18892,2023-01-01,ASH,gemGrab,Double Swoosh,13,20,33
18893,2023-01-01,ASH,brawlBall,Backyard Bowl,0,1,1
18894,2022-12-31,ASH,hotZone,Controller Chaos,1,0,1
18895,2022-12-31,ASH,gemGrab,Hard Rock Mine,2,0,2
18896,2022-12-31,ASH,gemGrab,Deep Diner,1,0,1
18897,2022-12-31,ASH,brawlBall,Super Beach,4,4,8
18898,2022-12-31,ASH,brawlBall,Sneaky Fields,1,1,2
18899,2022-12-30,ASH,hotZone,Controller Chaos,4,3,7
18900,2022-12-30,ASH,gemGrab,Undermine,1,1,2
18901,2022-12-30,ASH,gemGrab,Minecart Madness,1,0,1
18902,2022-12-30,ASH,gemGrab,Deep Diner,1,0,1
18903,2022-12-30,ASH,brawlBall,Sneaky Fields,4,5,9
18904,2022-12-29,ASH,heist,Kaboom Canyon,1,0,1
18905,2022-12-29,ASH,gemGrab,Undermine,0,1,1
18906,2022-12-29,ASH,brawlBall,Pinhole Punt,2,4,6
18907,2022-12-24,ASH,brawlBall,Super Beach,1,0,1
18908,2022-12-22,ASH,gemGrab,Gem Fort,0,1,1
18909,2022-12-21,ASH,brawlBall,Sunny Soccer,1,0,1
18910,2022-12-19,ASH,brawlBall,Center Stage,3,2,5
18911,2022-12-16,ASH,brawlBall,Sneaky Fields,2,5,7
18912,2022-12-13,ASH,gemGrab,Crystal Arcade,0,1,1
18913,2022-12-10,ASH,gemGrab,Hard Rock Mine,1,0,1
18914,2022-11-01,ASH,knockout,New Perspective,1,0,1
18915,2023-02-05,AMBER,knockout,X Marks the Spot,15,13,28
18916,2023-02-05,AMBER,knockout,Goldarm Gulch,1,3,4
18917,2023-02-05,AMBER,hotZone,Ring of Fire,71,70,141
18918,2023-02-05,AMBER,heist,Snaked Assault,83,129,212
18919,2023-02-05,AMBER,heist,Pit Stop,3,2,5
18920,2023-02-05,AMBER,gemGrab,Hard Rock Mine,6,1,7
18921,2023-02-05,AMBER,gemGrab,Double Swoosh,229,343,572
18922,2023-02-05,AMBER,brawlBall,Super Beach,1,2,3
18923,2023-02-05,AMBER,brawlBall,Sneaky Fields,2,3,5
18924,2023-02-05,AMBER,brawlBall,Backyard Bowl,195,232,427
18925,2023-02-05,AMBER,bounty,Layer Cake,8,4,12
18926,2023-02-04,AMBER,knockout,X Marks the Spot,4,2,6
18927,2023-02-04,AMBER,hotZone,Ring of Fire,16,19,35
18928,2023-02-04,AMBER,heist,Tornado Ring,12,20,32
18929,2023-02-04,AMBER,heist,Pit Stop,4,2,6
18930,2023-02-04,AMBER,gemGrab,Hard Rock Mine,11,9,20
18931,2023-02-04,AMBER,gemGrab,Double Swoosh,42,59,101
18932,2023-02-04,AMBER,gemGrab,Deep Diner,2,0,2
18933,2023-02-04,AMBER,brawlBall,Super Beach,27,24,51
18934,2023-02-04,AMBER,brawlBall,Sneaky Fields,4,3,7
18935,2023-02-04,AMBER,bounty,Dry Season,4,4,8
18936,2023-02-03,AMBER,knockout,Out in the Open,23,26,49
18937,2023-02-03,AMBER,knockout,Goldarm Gulch,7,6,13
18938,2023-02-03,AMBER,hotZone,Split,12,8,20
18939,2023-02-03,AMBER,heist,Tornado Ring,50,31,81
18940,2023-02-03,AMBER,heist,Pit Stop,16,7,23
18941,2023-02-03,AMBER,gemGrab,Undermine,33,46,79
18942,2023-02-03,AMBER,gemGrab,Double Swoosh,137,328,465
18943,2023-02-03,AMBER,gemGrab,Deep Diner,33,32,65
18944,2023-02-03,AMBER,brawlBall,Sneaky Fields,126,113,239
18945,2023-02-03,AMBER,brawlBall,Pinhole Punt,7,15,22
18946,2023-02-03,AMBER,bounty,Dry Season,42,40,82
18947,2023-02-02,AMBER,knockout,Out in the Open,7,14,21
18948,2023-02-02,AMBER,hotZone,Split,6,4,10
18949,2023-02-02,AMBER,heist,Kaboom Canyon,9,13,22
18950,2023-02-02,AMBER,gemGrab,Undermine,27,43,70
18951,2023-02-02,AMBER,gemGrab,Gem Fort,6,5,11
18952,2023-02-02,AMBER,brawlBall,Sunny Soccer,1,1,2
18953,2023-02-02,AMBER,brawlBall,Pinhole Punt,61,47,108
18954,2023-02-02,AMBER,bounty,Shooting Star,1,1,2
18955,2023-02-01,AMBER,knockout,Goldarm Gulch,21,24,45
18956,2023-02-01,AMBER,hotZone,Parallel Plays,48,44,92
18957,2023-02-01,AMBER,heist,Kaboom Canyon,72,104,176
18958,2023-02-01,AMBER,gemGrab,Gem Fort,47,58,105
18959,2023-02-01,AMBER,gemGrab,Crystal Arcade,24,29,53
18960,2023-02-01,AMBER,brawlBall,Sunny Soccer,82,89,171
18961,2023-02-01,AMBER,brawlBall,Beach Ball,3,2,5
18962,2023-02-01,AMBER,bounty,Shooting Star,8,2,10
18963,2023-01-31,AMBER,knockout,Goldarm Gulch,16,9,25
18964,2023-01-31,AMBER,hotZone,Parallel Plays,22,42,64
18965,2023-01-31,AMBER,heist,Pit Stop,1,1,2
18966,2023-01-31,AMBER,gemGrab,Minecart Madness,10,7,17
18967,2023-01-31,AMBER,gemGrab,Crystal Arcade,17,14,31
18968,2023-01-31,AMBER,brawlBall,Beach Ball,53,72,125
18969,2023-01-31,AMBER,bounty,Hideout,2,5,7
18970,2023-01-30,AMBER,knockout,Belle's Rock,19,17,36
18971,2023-01-30,AMBER,hotZone,Quarter Pounder,72,74,146
18972,2023-01-30,AMBER,heist,Pit Stop,13,5,18
18973,2023-01-30,AMBER,gemGrab,Minecart Madness,41,48,89
18974,2023-01-30,AMBER,gemGrab,Double Swoosh,98,106,204
18975,2023-01-30,AMBER,brawlBall,Center Stage,119,142,261
18976,2023-01-30,AMBER,brawlBall,Backyard Bowl,26,36,62
18977,2023-01-30,AMBER,bounty,Hideout,1,7,8
18978,2023-01-29,AMBER,knockout,Belle's Rock,15,9,24
18979,2023-01-29,AMBER,hotZone,Quarter Pounder,39,36,75
18980,2023-01-29,AMBER,heist,Bridge Too Far,75,68,143
18981,2023-01-29,AMBER,gemGrab,Hard Rock Mine,8,3,11
18982,2023-01-29,AMBER,gemGrab,Double Swoosh,182,223,405
18983,2023-01-29,AMBER,brawlBall,Super Beach,0,1,1
18984,2023-01-29,AMBER,brawlBall,Backyard Bowl,241,278,519
18985,2023-01-29,AMBER,bounty,Canal Grande,9,3,12
18986,2023-01-28,AMBER,knockout,Flaring Phoenix,9,8,17
18987,2023-01-28,AMBER,hotZone,Controller Chaos,54,90,144
18988,2023-01-28,AMBER,heist,Bridge Too Far,146,162,308
18989,2023-01-28,AMBER,gemGrab,Hard Rock Mine,20,13,33
18990,2023-01-28,AMBER,gemGrab,Deep Diner,5,5,10
18991,2023-01-28,AMBER,brawlBall,Super Beach,121,138,259
18992,2023-01-28,AMBER,brawlBall,Sneaky Fields,4,1,5
18993,2023-01-28,AMBER,bounty,Canal Grande,5,8,13
18994,2023-01-27,AMBER,knockout,Flaring Phoenix,6,3,9
18995,2023-01-27,AMBER,hotZone,Controller Chaos,17,17,34
18996,2023-01-27,AMBER,heist,Hot Potato,12,10,22
18997,2023-01-27,AMBER,gemGrab,Undermine,8,10,18
18998,2023-01-27,AMBER,gemGrab,Deep Diner,20,21,41
18999,2023-01-27,AMBER,brawlBall,Sneaky Fields,41,62,103
19000,2023-01-27,AMBER,brawlBall,Pinhole Punt,1,3,4
19001,2023-01-27,AMBER,bounty,Temple Ruins,8,26,34
19002,2023-01-26,AMBER,knockout,Riverside,24,13,37
19003,2023-01-26,AMBER,hotZone,Open Zone,119,222,341
19004,2023-01-26,AMBER,heist,Hot Potato,33,31,64
19005,2023-01-26,AMBER,gemGrab,Undermine,55,78,133
19006,2023-01-26,AMBER,gemGrab,Gem Fort,8,8,16
19007,2023-01-26,AMBER,brawlBall,Sunny Soccer,6,3,9
19008,2023-01-26,AMBER,brawlBall,Pinhole Punt,187,251,438
19009,2023-01-26,AMBER,bounty,Temple Ruins,23,39,62
19010,2023-01-25,AMBER,knockout,Riverside,14,7,21
19011,2023-01-25,AMBER,hotZone,Open Zone,69,80,149
19012,2023-01-25,AMBER,heist,Safe Zone,23,22,45
19013,2023-01-25,AMBER,gemGrab,Gem Fort,28,39,67
19014,2023-01-25,AMBER,gemGrab,Crystal Arcade,15,13,28
19015,2023-01-25,AMBER,brawlBall,Sunny Soccer,71,86,157
19016,2023-01-25,AMBER,brawlBall,Beach Ball,15,9,24
19017,2023-01-25,AMBER,bounty,Excel,5,0,5
19018,2023-01-24,AMBER,knockout,New Perspective,20,18,38
19019,2023-01-24,AMBER,hotZone,Dueling Beetles,54,61,115
19020,2023-01-24,AMBER,heist,Safe Zone,67,55,122
19021,2023-01-24,AMBER,gemGrab,Minecart Madness,17,16,33
19022,2023-01-24,AMBER,gemGrab,Crystal Arcade,55,55,110
19023,2023-01-24,AMBER,brawlBall,Center Stage,15,22,37
19024,2023-01-24,AMBER,brawlBall,Beach Ball,116,112,228
19025,2023-01-24,AMBER,bounty,Excel,11,8,19
19026,2023-01-23,AMBER,knockout,New Perspective,40,26,66
19027,2023-01-23,AMBER,hotZone,Dueling Beetles,91,112,203
19028,2023-01-23,AMBER,heist,Snaked Assault,106,85,191
19029,2023-01-23,AMBER,gemGrab,Minecart Madness,89,108,197
19030,2023-01-23,AMBER,gemGrab,Double Swoosh,82,142,224
19031,2023-01-23,AMBER,brawlBall,Center Stage,181,182,363
19032,2023-01-23,AMBER,brawlBall,Backyard Bowl,8,38,46
19033,2023-01-23,AMBER,bounty,Layer Cake,13,5,18
19034,2023-01-22,AMBER,knockout,X Marks the Spot,8,3,11
19035,2023-01-22,AMBER,hotZone,Ring of Fire,58,89,147
19036,2023-01-22,AMBER,heist,Snaked Assault,48,39,87
19037,2023-01-22,AMBER,gemGrab,Hard Rock Mine,11,9,20
19038,2023-01-22,AMBER,gemGrab,Double Swoosh,83,133,216
19039,2023-01-22,AMBER,brawlBall,Super Beach,13,7,20
19040,2023-01-22,AMBER,brawlBall,Backyard Bowl,104,128,232
19041,2023-01-22,AMBER,bounty,Layer Cake,7,6,13
19042,2023-01-21,AMBER,knockout,X Marks the Spot,34,21,55
19043,2023-01-21,AMBER,hotZone,Ring of Fire,137,210,347
19044,2023-01-21,AMBER,heist,Tornado Ring,32,20,52
19045,2023-01-21,AMBER,gemGrab,Hard Rock Mine,56,39,95
19046,2023-01-21,AMBER,gemGrab,Deep Diner,24,13,37
19047,2023-01-21,AMBER,brawlBall,Super Beach,110,118,228
19048,2023-01-21,AMBER,brawlBall,Sneaky Fields,2,0,2
19049,2023-01-21,AMBER,bounty,Dry Season,18,12,30
19050,2023-01-20,AMBER,knockout,Out in the Open,35,21,56
19051,2023-01-20,AMBER,hotZone,Split,20,9,29
19052,2023-01-20,AMBER,heist,Tornado Ring,34,35,69
19053,2023-01-20,AMBER,gemGrab,Undermine,24,51,75
19054,2023-01-20,AMBER,gemGrab,Deep Diner,55,37,92
19055,2023-01-20,AMBER,brawlBall,Sneaky Fields,111,101,212
19056,2023-01-20,AMBER,brawlBall,Pinhole Punt,3,4,7
19057,2023-01-20,AMBER,bounty,Dry Season,6,10,16
19058,2023-01-19,AMBER,knockout,Out in the Open,33,19,52
19059,2023-01-19,AMBER,hotZone,Split,19,13,32
19060,2023-01-19,AMBER,heist,Kaboom Canyon,39,73,112
19061,2023-01-19,AMBER,gemGrab,Undermine,94,134,228
19062,2023-01-19,AMBER,gemGrab,Gem Fort,8,21,29
19063,2023-01-19,AMBER,brawlBall,Sunny Soccer,3,3,6
19064,2023-01-19,AMBER,brawlBall,Pinhole Punt,203,255,458
19065,2023-01-19,AMBER,bounty,Shooting Star,15,7,22
19066,2023-01-18,AMBER,knockout,Goldarm Gulch,3,2,5
19067,2023-01-18,AMBER,hotZone,Parallel Plays,5,10,15
19068,2023-01-18,AMBER,heist,Kaboom Canyon,26,41,67
19069,2023-01-18,AMBER,gemGrab,Gem Fort,14,14,28
19070,2023-01-18,AMBER,gemGrab,Crystal Arcade,3,3,6
19071,2023-01-18,AMBER,brawlBall,Sunny Soccer,35,31,66
19072,2023-01-18,AMBER,brawlBall,Beach Ball,1,0,1
19073,2023-01-18,AMBER,bounty,Shooting Star,6,8,14
19074,2023-01-17,AMBER,knockout,Goldarm Gulch,3,5,8
19075,2023-01-17,AMBER,hotZone,Parallel Plays,5,6,11
19076,2023-01-17,AMBER,heist,Pit Stop,1,1,2
19077,2023-01-17,AMBER,gemGrab,Crystal Arcade,4,3,7
19078,2023-01-17,AMBER,brawlBall,Center Stage,0,1,1
19079,2023-01-17,AMBER,brawlBall,Beach Ball,13,11,24
19080,2023-01-17,AMBER,bounty,Hideout,1,0,1
19081,2023-01-16,AMBER,knockout,Belle's Rock,1,1,2
19082,2023-01-16,AMBER,hotZone,Quarter Pounder,12,12,24
19083,2023-01-16,AMBER,heist,Pit Stop,0,2,2
19084,2023-01-16,AMBER,gemGrab,Minecart Madness,2,2,4
19085,2023-01-16,AMBER,gemGrab,Double Swoosh,10,18,28
19086,2023-01-16,AMBER,brawlBall,Center Stage,5,6,11
19087,2023-01-16,AMBER,brawlBall,Backyard Bowl,2,2,4
19088,2023-01-15,AMBER,knockout,Belle's Rock,2,1,3
19089,2023-01-15,AMBER,hotZone,Quarter Pounder,12,6,18
19090,2023-01-15,AMBER,heist,Bridge Too Far,18,42,60
19091,2023-01-15,AMBER,gemGrab,Hard Rock Mine,0,2,2
19092,2023-01-15,AMBER,gemGrab,Double Swoosh,20,38,58
19093,2023-01-15,AMBER,brawlBall,Super Beach,1,1,2
19094,2023-01-15,AMBER,brawlBall,Backyard Bowl,29,29,58
19095,2023-01-14,AMBER,hotZone,Controller Chaos,17,27,44
19096,2023-01-14,AMBER,heist,Bridge Too Far,27,29,56
19097,2023-01-14,AMBER,gemGrab,Hard Rock Mine,1,1,2
19098,2023-01-14,AMBER,gemGrab,Deep Diner,1,2,3
19099,2023-01-14,AMBER,brawlBall,Super Beach,10,2,12
19100,2023-01-14,AMBER,bounty,Canal Grande,1,0,1
19101,2023-01-13,AMBER,knockout,Flaring Phoenix,2,1,3
19102,2023-01-13,AMBER,hotZone,Controller Chaos,19,12,31
19103,2023-01-13,AMBER,heist,Hot Potato,2,0,2
19104,2023-01-13,AMBER,gemGrab,Deep Diner,5,1,6
19105,2023-01-13,AMBER,brawlBall,Sneaky Fields,5,7,12
19106,2023-01-13,AMBER,brawlBall,Pinhole Punt,2,5,7
19107,2023-01-13,AMBER,bounty,Temple Ruins,4,2,6
19108,2023-01-12,AMBER,knockout,Riverside,16,23,39
19109,2023-01-12,AMBER,hotZone,Open Zone,15,36,51
19110,2023-01-12,AMBER,heist,Hot Potato,2,0,2
19111,2023-01-12,AMBER,gemGrab,Undermine,11,15,26
19112,2023-01-12,AMBER,gemGrab,Gem Fort,0,4,4
19113,2023-01-12,AMBER,brawlBall,Pinhole Punt,6,6,12
19114,2023-01-11,AMBER,knockout,Riverside,2,0,2
19115,2023-01-11,AMBER,hotZone,Open Zone,8,14,22
19116,2023-01-11,AMBER,gemGrab,Gem Fort,3,1,4
19117,2023-01-11,AMBER,brawlBall,Sunny Soccer,1,0,1
19118,2023-01-10,AMBER,hotZone,Dueling Beetles,9,9,18
19119,2023-01-10,AMBER,heist,Safe Zone,2,1,3
19120,2023-01-10,AMBER,gemGrab,Minecart Madness,4,6,10
19121,2023-01-10,AMBER,gemGrab,Crystal Arcade,4,0,4
19122,2023-01-10,AMBER,brawlBall,Center Stage,2,2,4
19123,2023-01-10,AMBER,brawlBall,Beach Ball,2,6,8
19124,2023-01-09,AMBER,knockout,New Perspective,0,1,1
19125,2023-01-09,AMBER,hotZone,Dueling Beetles,12,7,19
19126,2023-01-09,AMBER,heist,Snaked Assault,6,6,12
19127,2023-01-09,AMBER,gemGrab,Minecart Madness,5,3,8
19128,2023-01-09,AMBER,gemGrab,Double Swoosh,12,35,47
19129,2023-01-09,AMBER,brawlBall,Center Stage,16,30,46
19130,2023-01-09,AMBER,brawlBall,Backyard Bowl,2,0,2
19131,2023-01-09,AMBER,bounty,Layer Cake,2,0,2
19132,2023-01-08,AMBER,hotZone,Ring of Fire,17,20,37
19133,2023-01-08,AMBER,heist,Snaked Assault,10,6,16
19134,2023-01-08,AMBER,gemGrab,Double Swoosh,4,6,10
19135,2023-01-08,AMBER,brawlBall,Backyard Bowl,25,62,87
19136,2023-01-08,AMBER,bounty,Layer Cake,1,13,14
19137,2023-01-07,AMBER,knockout,X Marks the Spot,2,0,2
19138,2023-01-07,AMBER,hotZone,Ring of Fire,0,2,2
19139,2023-01-07,AMBER,heist,Tornado Ring,3,0,3
19140,2023-01-07,AMBER,gemGrab,Hard Rock Mine,1,1,2
19141,2023-01-07,AMBER,brawlBall,Super Beach,0,2,2
19142,2023-01-07,AMBER,bounty,Dry Season,0,10,10
19143,2023-01-06,AMBER,knockout,Out in the Open,1,0,1
19144,2023-01-06,AMBER,hotZone,Split,1,8,9
19145,2023-01-06,AMBER,heist,Tornado Ring,2,1,3
19146,2023-01-06,AMBER,gemGrab,Undermine,4,12,16
19147,2023-01-06,AMBER,gemGrab,Deep Diner,4,1,5
19148,2023-01-06,AMBER,brawlBall,Sneaky Fields,5,8,13
19149,2023-01-06,AMBER,brawlBall,Pinhole Punt,1,0,1
19150,2023-01-05,AMBER,knockout,Out in the Open,1,2,3
19151,2023-01-05,AMBER,hotZone,Split,4,16,20
19152,2023-01-05,AMBER,heist,Kaboom Canyon,10,29,39
19153,2023-01-05,AMBER,gemGrab,Undermine,16,23,39
19154,2023-01-05,AMBER,brawlBall,Pinhole Punt,6,37,43
19155,2023-01-05,AMBER,bounty,Shooting Star,2,0,2
19156,2023-01-04,AMBER,hotZone,Parallel Plays,6,8,14
19157,2023-01-04,AMBER,heist,Kaboom Canyon,24,18,42
19158,2023-01-04,AMBER,gemGrab,Gem Fort,6,4,10
19159,2023-01-04,AMBER,brawlBall,Sunny Soccer,4,4,8
19160,2023-01-04,AMBER,bounty,Shooting Star,2,0,2
19161,2023-01-03,AMBER,hotZone,Parallel Plays,5,10,15
19162,2023-01-03,AMBER,heist,Pit Stop,2,0,2
19163,2023-01-03,AMBER,gemGrab,Minecart Madness,2,0,2
19164,2023-01-03,AMBER,gemGrab,Crystal Arcade,3,2,5
19165,2023-01-03,AMBER,brawlBall,Center Stage,1,0,1
19166,2023-01-03,AMBER,brawlBall,Beach Ball,13,10,23
19167,2023-01-03,AMBER,bounty,Hideout,0,1,1
19168,2023-01-02,AMBER,knockout,Belle's Rock,2,1,3
19169,2023-01-02,AMBER,hotZone,Quarter Pounder,12,2,14
19170,2023-01-02,AMBER,hotZone,Controller Chaos,1,0,1
19171,2023-01-02,AMBER,heist,Pit Stop,1,0,1
19172,2023-01-02,AMBER,gemGrab,Minecart Madness,11,1,12
19173,2023-01-02,AMBER,gemGrab,Double Swoosh,22,39,61
19174,2023-01-02,AMBER,brawlBall,Center Stage,16,23,39
19175,2023-01-02,AMBER,bounty,Hideout,2,0,2
19176,2023-01-01,AMBER,knockout,Belle's Rock,0,1,1
19177,2023-01-01,AMBER,hotZone,Quarter Pounder,4,11,15
19178,2023-01-01,AMBER,heist,Bridge Too Far,5,5,10
19179,2023-01-01,AMBER,gemGrab,Double Swoosh,16,17,33
19180,2023-01-01,AMBER,brawlBall,Backyard Bowl,11,9,20
19181,2022-12-31,AMBER,hotZone,Controller Chaos,1,0,1
19182,2022-12-31,AMBER,heist,Bridge Too Far,2,1,3
19183,2022-12-31,AMBER,gemGrab,Hard Rock Mine,2,0,2
19184,2022-12-31,AMBER,gemGrab,Deep Diner,4,10,14
19185,2022-12-30,AMBER,hotZone,Controller Chaos,1,0,1
19186,2022-12-30,AMBER,brawlBall,Sneaky Fields,2,0,2
19187,2022-12-29,AMBER,hotZone,Open Zone,0,2,2
19188,2022-12-29,AMBER,gemGrab,Undermine,6,13,19
19189,2022-12-29,AMBER,gemGrab,Gem Fort,1,0,1
19190,2022-12-29,AMBER,brawlBall,Pinhole Punt,1,1,2
19191,2022-12-28,AMBER,hotZone,Open Zone,2,3,5
19192,2022-12-27,AMBER,hotZone,Controller Chaos,1,0,1
19193,2022-12-27,AMBER,brawlBall,Beach Ball,1,0,1
19194,2022-12-26,AMBER,gemGrab,Minecart Madness,0,1,1
19195,2022-12-25,AMBER,hotZone,Ring of Fire,1,0,1
19196,2022-12-25,AMBER,brawlBall,Backyard Bowl,3,2,5
19197,2022-12-24,AMBER,brawlBall,Super Beach,2,1,3
19198,2022-12-18,AMBER,heist,Bridge Too Far,0,1,1
19199,2022-12-16,AMBER,brawlBall,Sneaky Fields,1,0,1
19200,2022-12-10,AMBER,hotZone,Ring of Fire,0,1,1
19201,2023-02-05,8-BIT,knockout,X Marks the Spot,73,114,187
19202,2023-02-05,8-BIT,hotZone,Ring of Fire,22,9,31
19203,2023-02-05,8-BIT,heist,Snaked Assault,128,185,313
19204,2023-02-05,8-BIT,heist,Pit Stop,5,2,7
19205,2023-02-05,8-BIT,gemGrab,Hard Rock Mine,25,38,63
19206,2023-02-05,8-BIT,gemGrab,Double Swoosh,65,39,104
19207,2023-02-05,8-BIT,brawlBall,Super Beach,2,0,2
19208,2023-02-05,8-BIT,brawlBall,Sneaky Fields,3,1,4
19209,2023-02-05,8-BIT,brawlBall,Backyard Bowl,214,315,529
19210,2023-02-05,8-BIT,bounty,Layer Cake,3,5,8
19211,2023-02-04,8-BIT,knockout,X Marks the Spot,39,55,94
19212,2023-02-04,8-BIT,hotZone,Ring of Fire,10,5,15
19213,2023-02-04,8-BIT,heist,Tornado Ring,3,6,9
19214,2023-02-04,8-BIT,heist,Pit Stop,1,0,1
19215,2023-02-04,8-BIT,gemGrab,Hard Rock Mine,48,105,153
19216,2023-02-04,8-BIT,gemGrab,Double Swoosh,19,3,22
19217,2023-02-04,8-BIT,gemGrab,Deep Diner,4,3,7
19218,2023-02-04,8-BIT,brawlBall,Super Beach,8,7,15
19219,2023-02-04,8-BIT,brawlBall,Sneaky Fields,6,0,6
19220,2023-02-04,8-BIT,bounty,Dry Season,3,11,14
19221,2023-02-03,8-BIT,knockout,Out in the Open,37,41,78
19222,2023-02-03,8-BIT,knockout,Goldarm Gulch,5,12,17
19223,2023-02-03,8-BIT,hotZone,Split,9,4,13
19224,2023-02-03,8-BIT,heist,Tornado Ring,32,18,50
19225,2023-02-03,8-BIT,heist,Pit Stop,16,4,20
19226,2023-02-03,8-BIT,gemGrab,Undermine,18,19,37
19227,2023-02-03,8-BIT,gemGrab,Double Swoosh,124,31,155
19228,2023-02-03,8-BIT,gemGrab,Deep Diner,49,52,101
19229,2023-02-03,8-BIT,brawlBall,Sneaky Fields,53,39,92
19230,2023-02-03,8-BIT,brawlBall,Pinhole Punt,10,6,16
19231,2023-02-03,8-BIT,bounty,Dry Season,50,81,131
19232,2023-02-02,8-BIT,knockout,Out in the Open,21,20,41
19233,2023-02-02,8-BIT,hotZone,Split,4,1,5
19234,2023-02-02,8-BIT,heist,Kaboom Canyon,15,24,39
19235,2023-02-02,8-BIT,gemGrab,Undermine,15,30,45
19236,2023-02-02,8-BIT,gemGrab,Gem Fort,2,6,8
19237,2023-02-02,8-BIT,brawlBall,Sunny Soccer,1,0,1
19238,2023-02-02,8-BIT,brawlBall,Pinhole Punt,31,56,87
19239,2023-02-02,8-BIT,bounty,Shooting Star,7,5,12
19240,2023-02-01,8-BIT,knockout,Goldarm Gulch,29,27,56
19241,2023-02-01,8-BIT,hotZone,Parallel Plays,7,4,11
19242,2023-02-01,8-BIT,heist,Kaboom Canyon,74,73,147
19243,2023-02-01,8-BIT,gemGrab,Gem Fort,32,73,105
19244,2023-02-01,8-BIT,gemGrab,Crystal Arcade,30,38,68
19245,2023-02-01,8-BIT,brawlBall,Sunny Soccer,24,40,64
19246,2023-02-01,8-BIT,brawlBall,Beach Ball,0,3,3
19247,2023-02-01,8-BIT,bounty,Shooting Star,20,34,54
19248,2023-01-31,8-BIT,knockout,Goldarm Gulch,15,11,26
19249,2023-01-31,8-BIT,hotZone,Parallel Plays,5,2,7
19250,2023-01-31,8-BIT,heist,Pit Stop,6,12,18
19251,2023-01-31,8-BIT,gemGrab,Minecart Madness,8,6,14
19252,2023-01-31,8-BIT,gemGrab,Crystal Arcade,44,57,101
19253,2023-01-31,8-BIT,brawlBall,Center Stage,2,0,2
19254,2023-01-31,8-BIT,brawlBall,Beach Ball,22,21,43
19255,2023-01-31,8-BIT,bounty,Hideout,3,7,10
19256,2023-01-30,8-BIT,knockout,Belle's Rock,11,11,22
19257,2023-01-30,8-BIT,hotZone,Quarter Pounder,37,29,66
19258,2023-01-30,8-BIT,heist,Pit Stop,4,6,10
19259,2023-01-30,8-BIT,gemGrab,Minecart Madness,17,51,68
19260,2023-01-30,8-BIT,gemGrab,Double Swoosh,31,32,63
19261,2023-01-30,8-BIT,brawlBall,Center Stage,40,37,77
19262,2023-01-30,8-BIT,brawlBall,Backyard Bowl,29,46,75
19263,2023-01-30,8-BIT,bounty,Hideout,5,3,8
19264,2023-01-29,8-BIT,knockout,Belle's Rock,13,8,21
19265,2023-01-29,8-BIT,hotZone,Quarter Pounder,19,12,31
19266,2023-01-29,8-BIT,heist,Bridge Too Far,268,271,539
19267,2023-01-29,8-BIT,gemGrab,Hard Rock Mine,21,23,44
19268,2023-01-29,8-BIT,gemGrab,Double Swoosh,36,42,78
19269,2023-01-29,8-BIT,brawlBall,Super Beach,2,1,3
19270,2023-01-29,8-BIT,brawlBall,Backyard Bowl,223,369,592
19271,2023-01-29,8-BIT,bounty,Canal Grande,0,1,1
19272,2023-01-28,8-BIT,knockout,Flaring Phoenix,38,60,98
19273,2023-01-28,8-BIT,hotZone,Controller Chaos,7,3,10
19274,2023-01-28,8-BIT,heist,Bridge Too Far,615,754,1369
19275,2023-01-28,8-BIT,gemGrab,Hard Rock Mine,167,269,436
19276,2023-01-28,8-BIT,gemGrab,Deep Diner,26,30,56
19277,2023-01-28,8-BIT,brawlBall,Super Beach,35,46,81
19278,2023-01-28,8-BIT,brawlBall,Sneaky Fields,0,4,4
19279,2023-01-28,8-BIT,bounty,Canal Grande,8,3,11
19280,2023-01-27,8-BIT,knockout,Flaring Phoenix,22,27,49
19281,2023-01-27,8-BIT,hotZone,Controller Chaos,3,1,4
19282,2023-01-27,8-BIT,heist,Hot Potato,20,9,29
19283,2023-01-27,8-BIT,gemGrab,Undermine,6,20,26
19284,2023-01-27,8-BIT,gemGrab,Deep Diner,20,39,59
19285,2023-01-27,8-BIT,brawlBall,Sneaky Fields,16,18,34
19286,2023-01-27,8-BIT,brawlBall,Pinhole Punt,2,0,2
19287,2023-01-27,8-BIT,bounty,Temple Ruins,9,14,23
19288,2023-01-26,8-BIT,knockout,Riverside,56,52,108
19289,2023-01-26,8-BIT,hotZone,Open Zone,32,30,62
19290,2023-01-26,8-BIT,heist,Hot Potato,67,62,129
19291,2023-01-26,8-BIT,gemGrab,Undermine,48,57,105
19292,2023-01-26,8-BIT,gemGrab,Gem Fort,22,27,49
19293,2023-01-26,8-BIT,brawlBall,Sunny Soccer,2,2,4
19294,2023-01-26,8-BIT,brawlBall,Pinhole Punt,104,168,272
19295,2023-01-26,8-BIT,bounty,Temple Ruins,12,5,17
19296,2023-01-25,8-BIT,knockout,Riverside,20,27,47
19297,2023-01-25,8-BIT,hotZone,Open Zone,34,30,64
19298,2023-01-25,8-BIT,heist,Safe Zone,102,131,233
19299,2023-01-25,8-BIT,gemGrab,Gem Fort,16,18,34
19300,2023-01-25,8-BIT,gemGrab,Crystal Arcade,27,47,74
19301,2023-01-25,8-BIT,brawlBall,Sunny Soccer,15,33,48
19302,2023-01-25,8-BIT,brawlBall,Beach Ball,4,3,7
19303,2023-01-25,8-BIT,bounty,Excel,5,5,10
19304,2023-01-24,8-BIT,knockout,New Perspective,17,12,29
19305,2023-01-24,8-BIT,hotZone,Dueling Beetles,17,7,24
19306,2023-01-24,8-BIT,heist,Safe Zone,172,253,425
19307,2023-01-24,8-BIT,gemGrab,Minecart Madness,20,14,34
19308,2023-01-24,8-BIT,gemGrab,Crystal Arcade,52,102,154
19309,2023-01-24,8-BIT,brawlBall,Center Stage,2,3,5
19310,2023-01-24,8-BIT,brawlBall,Beach Ball,54,43,97
19311,2023-01-24,8-BIT,bounty,Excel,8,12,20
19312,2023-01-23,8-BIT,knockout,New Perspective,40,60,100
19313,2023-01-23,8-BIT,hotZone,Dueling Beetles,15,9,24
19314,2023-01-23,8-BIT,heist,Snaked Assault,119,113,232
19315,2023-01-23,8-BIT,gemGrab,Minecart Madness,121,151,272
19316,2023-01-23,8-BIT,gemGrab,Double Swoosh,14,13,27
19317,2023-01-23,8-BIT,brawlBall,Center Stage,69,57,126
19318,2023-01-23,8-BIT,brawlBall,Backyard Bowl,10,7,17
19319,2023-01-23,8-BIT,bounty,Layer Cake,6,4,10
19320,2023-01-22,8-BIT,knockout,X Marks the Spot,47,78,125
19321,2023-01-22,8-BIT,hotZone,Ring of Fire,13,8,21
19322,2023-01-22,8-BIT,heist,Snaked Assault,53,93,146
19323,2023-01-22,8-BIT,gemGrab,Hard Rock Mine,28,63,91
19324,2023-01-22,8-BIT,gemGrab,Double Swoosh,19,10,29
19325,2023-01-22,8-BIT,brawlBall,Super Beach,2,2,4
19326,2023-01-22,8-BIT,brawlBall,Backyard Bowl,121,133,254
19327,2023-01-22,8-BIT,bounty,Layer Cake,3,7,10
19328,2023-01-21,8-BIT,knockout,X Marks the Spot,164,253,417
19329,2023-01-21,8-BIT,hotZone,Ring of Fire,53,40,93
19330,2023-01-21,8-BIT,heist,Tornado Ring,43,28,71
19331,2023-01-21,8-BIT,gemGrab,Hard Rock Mine,213,416,629
19332,2023-01-21,8-BIT,gemGrab,Deep Diner,10,17,27
19333,2023-01-21,8-BIT,brawlBall,Super Beach,76,122,198
19334,2023-01-21,8-BIT,brawlBall,Sneaky Fields,2,0,2
19335,2023-01-21,8-BIT,bounty,Dry Season,29,26,55
19336,2023-01-20,8-BIT,knockout,Out in the Open,31,42,73
19337,2023-01-20,8-BIT,hotZone,Split,3,5,8
19338,2023-01-20,8-BIT,heist,Tornado Ring,61,39,100
19339,2023-01-20,8-BIT,gemGrab,Undermine,21,59,80
19340,2023-01-20,8-BIT,gemGrab,Deep Diner,61,57,118
19341,2023-01-20,8-BIT,brawlBall,Sneaky Fields,41,52,93
19342,2023-01-20,8-BIT,brawlBall,Pinhole Punt,2,2,4
19343,2023-01-20,8-BIT,bounty,Dry Season,26,46,72
19344,2023-01-19,8-BIT,knockout,Out in the Open,42,61,103
19345,2023-01-19,8-BIT,hotZone,Split,9,4,13
19346,2023-01-19,8-BIT,heist,Kaboom Canyon,84,82,166
19347,2023-01-19,8-BIT,gemGrab,Undermine,67,122,189
19348,2023-01-19,8-BIT,gemGrab,Gem Fort,17,28,45
19349,2023-01-19,8-BIT,brawlBall,Sunny Soccer,0,2,2
19350,2023-01-19,8-BIT,brawlBall,Pinhole Punt,95,100,195
19351,2023-01-19,8-BIT,bounty,Shooting Star,21,15,36
19352,2023-01-18,8-BIT,knockout,Goldarm Gulch,3,17,20
19353,2023-01-18,8-BIT,hotZone,Parallel Plays,1,1,2
19354,2023-01-18,8-BIT,heist,Kaboom Canyon,42,35,77
19355,2023-01-18,8-BIT,gemGrab,Gem Fort,5,8,13
19356,2023-01-18,8-BIT,gemGrab,Crystal Arcade,10,27,37
19357,2023-01-18,8-BIT,brawlBall,Sunny Soccer,7,7,14
19358,2023-01-18,8-BIT,bounty,Shooting Star,20,19,39
19359,2023-01-17,8-BIT,knockout,Goldarm Gulch,2,0,2
19360,2023-01-17,8-BIT,hotZone,Parallel Plays,1,1,2
19361,2023-01-17,8-BIT,gemGrab,Minecart Madness,1,1,2
19362,2023-01-17,8-BIT,gemGrab,Crystal Arcade,3,6,9
19363,2023-01-17,8-BIT,brawlBall,Center Stage,1,0,1
19364,2023-01-17,8-BIT,brawlBall,Beach Ball,5,1,6
19365,2023-01-17,8-BIT,bounty,Hideout,1,0,1
19366,2023-01-16,8-BIT,knockout,Belle's Rock,3,1,4
19367,2023-01-16,8-BIT,hotZone,Quarter Pounder,3,3,6
19368,2023-01-16,8-BIT,gemGrab,Minecart Madness,8,5,13
19369,2023-01-16,8-BIT,gemGrab,Double Swoosh,1,0,1
19370,2023-01-16,8-BIT,brawlBall,Center Stage,7,5,12
19371,2023-01-16,8-BIT,brawlBall,Backyard Bowl,3,2,5
19372,2023-01-15,8-BIT,hotZone,Quarter Pounder,8,3,11
19373,2023-01-15,8-BIT,heist,Bridge Too Far,76,102,178
19374,2023-01-15,8-BIT,gemGrab,Hard Rock Mine,6,14,20
19375,2023-01-15,8-BIT,gemGrab,Double Swoosh,2,0,2
19376,2023-01-15,8-BIT,brawlBall,Backyard Bowl,34,37,71
19377,2023-01-15,8-BIT,bounty,Canal Grande,2,0,2
19378,2023-01-14,8-BIT,knockout,Flaring Phoenix,0,2,2
19379,2023-01-14,8-BIT,hotZone,Controller Chaos,2,0,2
19380,2023-01-14,8-BIT,heist,Bridge Too Far,103,184,287
19381,2023-01-14,8-BIT,gemGrab,Hard Rock Mine,17,55,72
19382,2023-01-14,8-BIT,gemGrab,Deep Diner,5,5,10
19383,2023-01-14,8-BIT,brawlBall,Super Beach,2,0,2
19384,2023-01-14,8-BIT,bounty,Canal Grande,2,0,2
19385,2023-01-13,8-BIT,heist,Hot Potato,1,0,1
19386,2023-01-13,8-BIT,gemGrab,Deep Diner,5,54,59
19387,2023-01-13,8-BIT,brawlBall,Sneaky Fields,2,0,2
19388,2023-01-13,8-BIT,bounty,Temple Ruins,0,1,1
19389,2023-01-12,8-BIT,knockout,Riverside,8,2,10
19390,2023-01-12,8-BIT,hotZone,Open Zone,4,0,4
19391,2023-01-12,8-BIT,gemGrab,Undermine,1,0,1
19392,2023-01-12,8-BIT,gemGrab,Gem Fort,1,3,4
19393,2023-01-12,8-BIT,brawlBall,Pinhole Punt,2,3,5
19394,2023-01-11,8-BIT,knockout,Riverside,2,0,2
19395,2023-01-11,8-BIT,heist,Safe Zone,1,1,2
19396,2023-01-10,8-BIT,knockout,New Perspective,0,1,1
19397,2023-01-10,8-BIT,hotZone,Dueling Beetles,2,1,3
19398,2023-01-10,8-BIT,heist,Safe Zone,10,3,13
19399,2023-01-10,8-BIT,gemGrab,Minecart Madness,2,11,13
19400,2023-01-10,8-BIT,gemGrab,Crystal Arcade,1,1,2
19401,2023-01-10,8-BIT,brawlBall,Beach Ball,2,5,7
19402,2023-01-09,8-BIT,knockout,New Perspective,0,3,3
19403,2023-01-09,8-BIT,heist,Snaked Assault,14,62,76
19404,2023-01-09,8-BIT,gemGrab,Minecart Madness,5,42,47
19405,2023-01-09,8-BIT,gemGrab,Double Swoosh,2,0,2
19406,2023-01-09,8-BIT,brawlBall,Center Stage,2,1,3
19407,2023-01-09,8-BIT,brawlBall,Backyard Bowl,2,0,2
19408,2023-01-09,8-BIT,bounty,Layer Cake,2,0,2
19409,2023-01-08,8-BIT,knockout,X Marks the Spot,3,0,3
19410,2023-01-08,8-BIT,hotZone,Ring of Fire,1,0,1
19411,2023-01-08,8-BIT,heist,Snaked Assault,6,4,10
19412,2023-01-08,8-BIT,gemGrab,Hard Rock Mine,2,10,12
19413,2023-01-08,8-BIT,brawlBall,Backyard Bowl,10,36,46
19414,2023-01-08,8-BIT,bounty,Layer Cake,1,0,1
19415,2023-01-07,8-BIT,knockout,X Marks the Spot,6,3,9
19416,2023-01-07,8-BIT,hotZone,Ring of Fire,1,3,4
19417,2023-01-07,8-BIT,heist,Tornado Ring,5,22,27
19418,2023-01-07,8-BIT,gemGrab,Hard Rock Mine,9,25,34
19419,2023-01-07,8-BIT,gemGrab,Deep Diner,2,24,26
19420,2023-01-07,8-BIT,bounty,Dry Season,1,0,1
19421,2023-01-06,8-BIT,heist,Tornado Ring,14,24,38
19422,2023-01-06,8-BIT,gemGrab,Undermine,1,0,1
19423,2023-01-06,8-BIT,gemGrab,Deep Diner,10,45,55
19424,2023-01-06,8-BIT,brawlBall,Sneaky Fields,2,1,3
19425,2023-01-06,8-BIT,brawlBall,Pinhole Punt,1,0,1
19426,2023-01-06,8-BIT,bounty,Dry Season,2,0,2
19427,2023-01-05,8-BIT,knockout,Out in the Open,1,2,3
19428,2023-01-05,8-BIT,heist,Kaboom Canyon,10,31,41
19429,2023-01-05,8-BIT,gemGrab,Undermine,3,5,8
19430,2023-01-05,8-BIT,brawlBall,Pinhole Punt,1,2,3
19431,2023-01-05,8-BIT,bounty,Shooting Star,3,0,3
19432,2023-01-04,8-BIT,knockout,Goldarm Gulch,2,10,12
19433,2023-01-04,8-BIT,hotZone,Parallel Plays,2,0,2
19434,2023-01-04,8-BIT,heist,Kaboom Canyon,10,11,21
19435,2023-01-04,8-BIT,gemGrab,Gem Fort,1,1,2
19436,2023-01-04,8-BIT,gemGrab,Crystal Arcade,1,1,2
19437,2023-01-04,8-BIT,brawlBall,Sunny Soccer,4,9,13
19438,2023-01-04,8-BIT,bounty,Shooting Star,2,0,2
19439,2023-01-03,8-BIT,heist,Pit Stop,4,1,5
19440,2023-01-03,8-BIT,gemGrab,Crystal Arcade,11,24,35
19441,2023-01-03,8-BIT,brawlBall,Beach Ball,2,0,2
19442,2023-01-03,8-BIT,bounty,Hideout,3,0,3
19443,2023-01-02,8-BIT,hotZone,Quarter Pounder,3,1,4
19444,2023-01-02,8-BIT,heist,Pit Stop,2,0,2
19445,2023-01-02,8-BIT,heist,Kaboom Canyon,1,0,1
19446,2023-01-02,8-BIT,gemGrab,Minecart Madness,11,12,23
19447,2023-01-02,8-BIT,gemGrab,Double Swoosh,8,22,30
19448,2023-01-02,8-BIT,brawlBall,Center Stage,2,3,5
19449,2023-01-02,8-BIT,bounty,Hideout,2,3,5
19450,2023-01-01,8-BIT,knockout,Belle's Rock,0,1,1
19451,2023-01-01,8-BIT,heist,Bridge Too Far,16,26,42
19452,2023-01-01,8-BIT,gemGrab,Hard Rock Mine,5,3,8
19453,2023-01-01,8-BIT,gemGrab,Double Swoosh,6,12,18
19454,2023-01-01,8-BIT,brawlBall,Backyard Bowl,7,16,23
19455,2022-12-31,8-BIT,heist,Bridge Too Far,6,7,13
19456,2022-12-31,8-BIT,gemGrab,Hard Rock Mine,4,9,13
19457,2022-12-30,8-BIT,hotZone,Controller Chaos,0,1,1
19458,2022-12-30,8-BIT,heist,Kaboom Canyon,2,0,2
19459,2022-12-30,8-BIT,gemGrab,Undermine,0,1,1
19460,2022-12-30,8-BIT,gemGrab,Minecart Madness,1,1,2
19461,2022-12-30,8-BIT,gemGrab,Deep Diner,2,7,9
19462,2022-12-30,8-BIT,brawlBall,Sneaky Fields,1,0,1
19463,2022-12-29,8-BIT,gemGrab,Undermine,1,0,1
19464,2022-12-28,8-BIT,hotZone,Controller Chaos,0,1,1
19465,2022-12-27,8-BIT,heist,Kaboom Canyon,1,0,1
19466,2022-12-27,8-BIT,gemGrab,Minecart Madness,1,0,1
19467,2022-12-26,8-BIT,gemGrab,Minecart Madness,2,0,2
19468,2022-10-30,8-BIT,heist,Safe Zone,1,0,1
19469,2022-10-15,8-BIT,gemGrab,Hard Rock Mine,0,2,2
19470,2022-10-15,8-BIT,brawlBall,Super Beach,1,0,1
